network_method	network_db	network_cutoff	experiment_info	func_module_number	significant	p_value	term_size	query_size	intersection_size	precision	recall	term_id	source	term_name	effective_domain_size	source_order	parents	perc_rank	cumelative_dist	P	N	tp	fp	fn	tn	tot_pop_valid	MCC
M1	cpdb	0	network_modules	1	TRUE	3.2119488539510656e-80	158	85	51	0.6	0.3227848101265823	GO:0140053	GO:BP	mitochondrial gene expression	16175	19653		0	0.045454545454545456	158	16017	51	34	107	15983	16175	0.43619354270306115
M1	cpdb	0	network_modules	1	TRUE	9.06036903032398e-65	127	85	42	0.49411764705882355	0.33070866141732286	GO:0032543	GO:BP	mitochondrial translation	16175	7635		0.047619047619047616	0.09090909090909091	127	16048	42	43	85	16005	16175	0.4004398941834871
M1	cpdb	0	network_modules	1	TRUE	6.618821239967739e-53	93	73	35	0.4794520547945205	0.3763440860215054	REAC:R-HSA-5368287	REAC	Mitochondrial translation	10916	1473		0	0.125	93	10823	35	38	58	10785	10916	0.42042984927728083
M1	cpdb	0	network_modules	1	TRUE	2.5844794760724518e-45	87	73	31	0.4246575342465753	0.3563218390804598	REAC:R-HSA-5419276	REAC	Mitochondrial translation termination	10916	1476		0.14285714285714285	0.375	87	10829	31	42	56	10787	10916	0.38450941900691216
M1	cpdb	0	network_modules	1	TRUE	2.5844794760724518e-45	87	73	31	0.4246575342465753	0.3563218390804598	REAC:R-HSA-5368286	REAC	Mitochondrial translation initiation	10916	1475		0.14285714285714285	0.375	87	10829	31	42	56	10787	10916	0.38450941900691216
M1	cpdb	0	network_modules	1	TRUE	4.475714537550494e-41	87	73	29	0.3972602739726027	0.3333333333333333	REAC:R-HSA-5389840	REAC	Mitochondrial translation elongation	10916	1474		0.42857142857142855	0.5	87	10829	29	44	58	10785	10916	0.35922787693954505
M1	cpdb	0	network_modules	1	TRUE	7.566256403711501e-40	566	85	45	0.5294117647058824	0.07950530035335689	GO:0006412	GO:BP	translation	16175	2170		0.09523809523809523	0.13636363636363635	566	15609	45	40	521	15569	16175	0.19555798733424304
M1	cpdb	0	network_modules	1	TRUE	9.725159575235972e-37	292	73	37	0.5068493150684932	0.1267123287671233	REAC:R-HSA-72766	REAC	Translation	10916	2565		0.5714285714285714	0.625	292	10624	37	36	255	10588	10916	0.24414402852886413
M1	cpdb	0	network_modules	1	TRUE	2.8914376864298555e-13	42	85	11	0.12941176470588237	0.2619047619047619	GO:0000959	GO:BP	mitochondrial RNA metabolic process	16175	267		0.14285714285714285	0.18181818181818182	42	16133	11	74	31	16059	16175	0.18111929089728832
M1	cpdb	0	network_modules	1	TRUE	4.328889973569983e-12	24	85	9	0.10588235294117647	0.375	GO:0070129	GO:BP	regulation of mitochondrial translation	16175	15928		0.19047619047619047	0.22727272727272727	24	16151	9	76	15	16075	16175	0.19713557289540182
M1	cpdb	0	network_modules	1	TRUE	6.398467936651203e-12	9	73	7	0.0958904109589041	0.7777777777777778	REAC:R-HSA-9836573	REAC	Mitochondrial RNA degradation	10916	1462		0.7142857142857143	0.75	9	10907	7	66	2	10841	10916	0.2717698234810938
M1	cpdb	0	network_modules	1	TRUE	1.5320988134412678e-11	27	85	9	0.10588235294117647	0.3333333333333333	GO:0062125	GO:BP	regulation of mitochondrial gene expression	16175	15832		0.23809523809523808	0.2727272727272727	27	16148	9	76	18	16072	16175	0.18554823839353973
M1	cpdb	0	network_modules	1	TRUE	3.381341619086519e-11	153	35	12	0.34285714285714286	0.0784313725490196	KEGG:03010	KEGG	Ribosome	8484	208		0	0.5	153	8331	12	23	141	8308	8484	0.15710310923849558
M1	cpdb	0	network_modules	1	TRUE	1.4265477080359267e-10	21	85	8	0.09411764705882353	0.38095238095238093	GO:0000963	GO:BP	mitochondrial RNA processing	16175	271		0.2857142857142857	0.3181818181818182	21	16154	8	77	13	16077	16175	0.18735468314980183
M1	cpdb	0	network_modules	1	TRUE	2.4133204108544476e-7	16	85	6	0.07058823529411765	0.375	GO:0070131	GO:BP	positive regulation of mitochondrial translation	16175	15930		0.3333333333333333	0.36363636363636365	16	16159	6	79	10	16080	16175	0.16092067213680214
M1	cpdb	0	network_modules	1	TRUE	2.862941953344191e-6	11	85	5	0.058823529411764705	0.45454545454545453	GO:0061668	GO:BP	mitochondrial ribosome assembly	16175	15605		0.38095238095238093	0.4090909090909091	11	16164	5	80	6	16084	16175	0.16210854042604128
M1	cpdb	0	network_modules	1	TRUE	8.154216028898062e-6	47	85	7	0.08235294117647059	0.14893617021276595	GO:0042255	GO:BP	ribosome assembly	16175	10061		0.42857142857142855	0.45454545454545453	47	16128	7	78	40	16050	16175	0.10727913482433435
M1	cpdb	0	network_modules	1	TRUE	2.6514701438788157e-5	16	85	5	0.058823529411764705	0.3125	GO:0006390	GO:BP	mitochondrial transcription	16175	2153		0.47619047619047616	0.5	16	16159	5	80	11	16079	16175	0.13371937762522546
M1	cpdb	0	network_modules	1	TRUE	4.385542937626686e-5	7	85	4	0.047058823529411764	0.5714285714285714	GO:0000965	GO:BP	mitochondrial RNA 3'-end processing	16175	273		0.5238095238095238	0.5454545454545454	7	16168	4	81	3	16087	16175	0.1629398264329313
M1	cpdb	0	network_modules	1	TRUE	9.372361375210945e-5	364	85	13	0.15294117647058825	0.03571428571428571	GO:0007005	GO:BP	mitochondrion organization	16175	2617		0.5714285714285714	0.5909090909090909	364	15811	13	72	351	15739	16175	0.06392153728970619
M1	cpdb	0	network_modules	1	TRUE	2.5011282553221597e-4	3	85	3	0.03529411764705882	1	GO:0000960	GO:BP	regulation of mitochondrial RNA catabolic process	16175	268		0.6190476190476191	0.6818181818181818	3	16172	3	82	0	16090	16175	0.1873903922257342
M1	cpdb	0	network_modules	1	TRUE	2.5011282553221597e-4	3	85	3	0.03529411764705882	1	GO:0000962	GO:BP	positive regulation of mitochondrial RNA catabolic process	16175	270		0.6190476190476191	0.6818181818181818	3	16172	3	82	0	16090	16175	0.1873903922257342
M1	cpdb	0	network_modules	1	TRUE	5.98015108242843e-4	290	85	11	0.12941176470588237	0.03793103448275862	GO:0006417	GO:BP	regulation of translation	16175	2174		0.7142857142857143	0.7272727272727273	290	15885	11	74	279	15811	16175	0.06106484110355237
M1	cpdb	0	network_modules	1	TRUE	7.121233285039321e-4	434	85	13	0.15294117647058825	0.029953917050691243	GO:0010608	GO:BP	post-transcriptional regulation of gene expression	16175	4255		0.7619047619047619	0.7727272727272727	434	15741	13	72	421	15669	16175	0.05672349914707581
M1	cpdb	0	network_modules	1	TRUE	9.966467167293494e-4	4	85	3	0.03529411764705882	0.75	GO:0070126	GO:BP	mitochondrial translational termination	16175	15926		0.8095238095238095	0.8636363636363636	4	16171	3	82	1	16089	16175	0.16200407701585365
M1	cpdb	0	network_modules	1	TRUE	9.966467167293494e-4	4	85	3	0.03529411764705882	0.75	GO:0000957	GO:BP	mitochondrial RNA catabolic process	16175	265		0.8095238095238095	0.8636363636363636	4	16171	3	82	1	16089	16175	0.16200407701585365
M1	cpdb	0	network_modules	1	TRUE	0.002138528853869643	103	73	7	0.0958904109589041	0.06796116504854369	REAC:R-HSA-611105	REAC	Respiratory electron transport	10916	2081		0.8571428571428571	0.875	103	10813	7	66	96	10747	10916	0.073374849600466
M1	cpdb	0	network_modules	1	TRUE	0.002482143442407506	5	85	3	0.03529411764705882	0.6	GO:1902775	GO:BP	mitochondrial large ribosomal subunit assembly	16175	22496		0.9047619047619048	0.9090909090909091	5	16170	3	82	2	16088	16175	0.14464971401462592
M1	cpdb	0	network_modules	1	TRUE	0.0050639806825899985	118	85	7	0.08235294117647059	0.059322033898305086	GO:0045727	GO:BP	positive regulation of translation	16175	11569		0.9523809523809523	0.9545454545454546	118	16057	7	78	111	15979	16175	0.06410589430143152
M1	cpdb	0	network_modules	1	TRUE	0.00709057669917238	22	35	3	0.08571428571428572	0.13636363636363635	KEGG:00220	KEGG	Arginine biosynthesis	8484	21		1	1	22	8462	3	32	19	8430	8484	0.10519517485506276
M1	cpdb	0	network_modules	1	TRUE	0.008621586602741932	7	85	3	0.03529411764705882	0.42857142857142855	GO:0044528	GO:BP	regulation of mitochondrial mRNA stability	16175	11055		1	1	7	16168	3	82	4	16086	16175	0.12182678232478586
M1	cpdb	0	network_modules	1	TRUE	0.009006101262916637	177	73	8	0.1095890410958904	0.04519774011299435	REAC:R-HSA-1428517	REAC	Aerobic respiration and respiratory electron transport	10916	127		1	1	177	10739	8	65	169	10674	10916	0.06066093238850591
M1	cpdb	0	network_modules	3	TRUE	1.187509542556706e-6	774	79	20	0.25316455696202533	0.025839793281653745	GO:0007186	GO:BP	G protein-coupled receptor signaling pathway	16175	2744		0	0.25	774	15401	20	59	754	15342	16175	0.06738608446315923
M1	cpdb	0	network_modules	3	TRUE	1.2346739980500962e-6	365	43	13	0.3023255813953488	0.03561643835616438	KEGG:04080	KEGG	Neuroactive ligand-receptor interaction	8484	263		0	0.5	365	8119	13	30	352	8089	8484	0.09121126580223766
M1	cpdb	0	network_modules	3	TRUE	1.898946901211149e-6	96	79	9	0.11392405063291139	0.09375	GO:0007200	GO:BP	phospholipase C-activating G protein-coupled receptor signaling pathway	16175	2758		0.3333333333333333	0.5	96	16079	9	70	87	16009	16175	0.09849475414159317
M1	cpdb	0	network_modules	3	TRUE	3.2474055424127406e-5	460	58	14	0.2413793103448276	0.030434782608695653	REAC:R-HSA-500792	REAC	GPCR ligand binding	10916	1019		0	0.25	460	10456	14	44	446	10412	10916	0.07247963200984858
M1	cpdb	0	network_modules	3	TRUE	3.776629487105174e-4	328	58	11	0.1896551724137931	0.03353658536585366	REAC:R-HSA-373076	REAC	Class A/1 (Rhodopsin-like receptors)	10916	365		0.3333333333333333	0.5	328	10588	11	47	317	10541	10916	0.06833010841492164
M1	cpdb	0	network_modules	3	TRUE	0.00242000710819232	251	43	8	0.18604651162790697	0.03187250996015936	KEGG:04020	KEGG	Calcium signaling pathway	8484	250		1	1	251	8233	8	35	243	8198	8484	0.06590665337486536
M1	cpdb	0	network_modules	3	TRUE	0.0036375609531474748	625	79	14	0.17721518987341772	0.0224	GO:0008610	GO:BP	lipid biosynthetic process	16175	3206		0.6666666666666666	0.75	625	15550	14	65	611	15485	16175	0.05037087762890077
M1	cpdb	0	network_modules	3	TRUE	0.003879602819446603	55	58	5	0.08620689655172414	0.09090909090909091	REAC:R-HSA-936837	REAC	Ion transport by P-type ATPases	10916	1275		0.6666666666666666	0.75	55	10861	5	53	50	10808	10916	0.08378638454629551
M1	cpdb	0	network_modules	3	TRUE	0.005873951962276926	213	58	8	0.13793103448275862	0.03755868544600939	REAC:R-HSA-416476	REAC	G alpha (q) signalling events	10916	988		1	1	213	10703	8	50	205	10653	10916	0.0625718797479198
M1	cpdb	0	network_modules	3	TRUE	0.00653269690719619	129	79	7	0.08860759493670886	0.05426356589147287	GO:0007204	GO:BP	positive regulation of cytosolic calcium ion concentration	16175	2759		1	1	129	16046	7	72	122	15974	16175	0.06350819710215244
M1	cpdb	0	network_modules	4	TRUE	2.3947105638677967e-72	290	82	54	0.6585365853658537	0.18620689655172415	GO:0007178	GO:BP	cell surface receptor protein serine/threonine kinase signaling pathway	16175	2740		0	0.006289308176100629	290	15885	54	28	236	15857	16175	0.3446134662987666
M1	cpdb	0	network_modules	4	TRUE	1.717784736057429e-69	275	82	52	0.6341463414634146	0.1890909090909091	GO:0141091	GO:BP	transforming growth factor beta receptor superfamily signaling pathway	16175	20020		0.006329113924050633	0.012578616352201259	275	15900	52	30	223	15870	16175	0.3407649136621267
M1	cpdb	0	network_modules	4	TRUE	1.3837604571632833e-62	107	51	38	0.7450980392156863	0.35514018691588783	KEGG:04350	KEGG	TGF-beta signaling pathway	8484	304		0	0.2	107	8377	38	13	69	8364	8484	0.5104555350565565
M1	cpdb	0	network_modules	4	TRUE	4.836247265655233e-56	117	82	37	0.45121951219512196	0.3162393162393162	GO:0030509	GO:BP	BMP signaling pathway	16175	6825		0.012658227848101266	0.018867924528301886	117	16058	37	45	80	16013	16175	0.37399298200260506
M1	cpdb	0	network_modules	4	TRUE	4.300080178991251e-55	123	82	37	0.45121951219512196	0.3008130081300813	GO:0071772	GO:BP	response to BMP	16175	16901		0.0189873417721519	0.031446540880503145	123	16052	37	45	86	16007	16175	0.36452052060872125
M1	cpdb	0	network_modules	4	TRUE	4.300080178991251e-55	123	82	37	0.45121951219512196	0.3008130081300813	GO:0071773	GO:BP	cellular response to BMP stimulus	16175	16902		0.0189873417721519	0.031446540880503145	123	16052	37	45	86	16007	16175	0.36452052060872125
M1	cpdb	0	network_modules	4	TRUE	1.7969979185375484e-54	217	82	42	0.5121951219512195	0.1935483870967742	GO:0090092	GO:BP	regulation of transmembrane receptor protein serine/threonine kinase signaling pathway	16175	18013		0.03164556962025317	0.03773584905660377	217	15958	42	40	175	15918	16175	0.30947251441733403
M1	cpdb	0	network_modules	4	TRUE	8.293120597935714e-50	502	82	49	0.5975609756097561	0.09760956175298804	GO:0071363	GO:BP	cellular response to growth factor stimulus	16175	16615		0.0379746835443038	0.0440251572327044	502	15673	49	33	453	15640	16175	0.23319766163283576
M1	cpdb	0	network_modules	4	TRUE	4.4441900398183746e-49	519	82	49	0.5975609756097561	0.09441233140655106	GO:0070848	GO:BP	response to growth factor	16175	16340		0.04430379746835443	0.050314465408805034	519	15656	49	33	470	15623	16175	0.229045408488966
M1	cpdb	0	network_modules	4	TRUE	9.620914518461137e-48	790	82	54	0.6585365853658537	0.06835443037974684	GO:0007167	GO:BP	enzyme-linked receptor protein signaling pathway	16175	2731		0.05063291139240506	0.05660377358490566	790	15385	54	28	736	15357	16175	0.20192198373247688
M1	cpdb	0	network_modules	4	TRUE	1.1532675764265726e-46	71	82	29	0.35365853658536583	0.4084507042253521	GO:0060395	GO:BP	SMAD protein signal transduction	16175	14598		0.056962025316455694	0.06289308176100629	71	16104	29	53	42	16051	16175	0.3771349256429845
M1	cpdb	0	network_modules	4	TRUE	1.1350125402019747e-41	53	82	25	0.3048780487804878	0.4716981132075472	GO:0060390	GO:BP	regulation of SMAD protein signal transduction	16175	14595		0.06329113924050633	0.06918238993710692	53	16122	25	57	28	16065	16175	0.37671997749842123
M1	cpdb	0	network_modules	4	TRUE	3.336331830730688e-41	122	54	29	0.5370370370370371	0.23770491803278687	REAC:R-HSA-9006936	REAC	Signaling by TGFB family members	10916	2310		0	0.09090909090909091	122	10794	29	25	93	10769	10916	0.3526997634491741
M1	cpdb	0	network_modules	4	TRUE	6.480788909749282e-41	31	54	21	0.3888888888888889	0.6774193548387096	REAC:R-HSA-201451	REAC	Signaling by BMP	10916	2224		0.1	0.18181818181818182	31	10885	21	33	10	10852	10916	0.5115085521728939
M1	cpdb	0	network_modules	4	TRUE	1.6555673157848152e-37	35	82	21	0.25609756097560976	0.6	GO:0060391	GO:BP	positive regulation of SMAD protein signal transduction	16175	14596		0.06962025316455696	0.07547169811320754	35	16140	21	61	14	16079	16175	0.39009223986364083
M1	cpdb	0	network_modules	4	TRUE	4.162105769268668e-36	80	82	25	0.3048780487804878	0.3125	GO:0090100	GO:BP	positive regulation of transmembrane receptor protein serine/threonine kinase signaling pathway	16175	18018		0.0759493670886076	0.08176100628930817	80	16095	25	57	55	16038	16175	0.3051864438996415
M1	cpdb	0	network_modules	4	TRUE	1.1309065992891935e-30	41	82	19	0.23170731707317074	0.4634146341463415	GO:0032924	GO:BP	activin receptor signaling pathway	16175	7915		0.08227848101265822	0.0880503144654088	41	16134	19	63	22	16071	16175	0.32533615953250405
M1	cpdb	0	network_modules	4	TRUE	5.294854650959705e-28	291	51	29	0.5686274509803921	0.09965635738831616	KEGG:04060	KEGG	Cytokine-cytokine receptor interaction	8484	253		0.25	0.4	291	8193	29	22	262	8171	8484	0.22831493813239456
M1	cpdb	0	network_modules	4	TRUE	2.2036188128720557e-23	126	82	21	0.25609756097560976	0.16666666666666666	GO:0090101	GO:BP	negative regulation of transmembrane receptor protein serine/threonine kinase signaling pathway	16175	18019		0.08860759493670886	0.09433962264150944	126	16049	21	61	105	15988	16175	0.20161077741382688
M1	cpdb	0	network_modules	4	TRUE	2.344058738071953e-23	176	82	23	0.2804878048780488	0.13068181818181818	GO:0007179	GO:BP	transforming growth factor beta receptor signaling pathway	16175	2741		0.0949367088607595	0.10062893081761007	176	15999	23	59	153	15940	16175	0.18550722284015728
M1	cpdb	0	network_modules	4	TRUE	1.933709032709408e-22	256	82	25	0.3048780487804878	0.09765625	GO:0090287	GO:BP	regulation of cellular response to growth factor stimulus	16175	18171		0.10126582278481013	0.1069182389937107	256	15919	25	57	231	15862	16175	0.16532157937162292
M1	cpdb	0	network_modules	4	TRUE	6.218843725836644e-22	202	82	23	0.2804878048780488	0.11386138613861387	GO:0071560	GO:BP	cellular response to transforming growth factor beta stimulus	16175	16762		0.10759493670886076	0.11320754716981132	202	15973	23	59	179	15914	16175	0.1722652171540179
M1	cpdb	0	network_modules	4	TRUE	1.241082542472073e-21	208	82	23	0.2804878048780488	0.11057692307692307	GO:0071559	GO:BP	response to transforming growth factor beta	16175	16761		0.11392405063291139	0.11949685534591195	208	15967	23	59	185	15908	16175	0.16955931958027262
M1	cpdb	0	network_modules	4	TRUE	1.5647546082510058e-20	78	82	17	0.2073170731707317	0.21794871794871795	GO:0030510	GO:BP	regulation of BMP signaling pathway	16175	6826		0.12025316455696203	0.12578616352201258	78	16097	17	65	61	16032	16175	0.20865406366484474
M1	cpdb	0	network_modules	4	TRUE	2.4055302831184936e-17	17	54	10	0.18518518518518517	0.5882352941176471	REAC:R-HSA-1502540	REAC	Signaling by Activin	10916	2223		0.2	0.2727272727272727	17	10899	10	44	7	10855	10916	0.3283418509218016
M1	cpdb	0	network_modules	4	TRUE	3.723569224504204e-17	283	82	22	0.2682926829268293	0.07773851590106007	GO:0001501	GO:BP	skeletal system development	16175	318		0.12658227848101267	0.1320754716981132	283	15892	22	60	261	15832	16175	0.13654373130596012
M1	cpdb	0	network_modules	4	TRUE	9.018468999827565e-16	92	82	15	0.18292682926829268	0.16304347826086957	GO:0045667	GO:BP	regulation of osteoblast differentiation	16175	11518		0.13291139240506328	0.13836477987421383	92	16083	15	67	77	16016	16175	0.1682343416561076
M1	cpdb	0	network_modules	4	TRUE	6.292234426615949e-15	143	51	16	0.3137254901960784	0.11188811188811189	KEGG:04550	KEGG	Signaling pathways regulating pluripotency of stem cells	8484	319		0.5	0.6	143	8341	16	35	127	8306	8484	0.17934293468927312
M1	cpdb	0	network_modules	4	TRUE	3.140295884706881e-14	250	82	19	0.23170731707317074	0.076	GO:0007389	GO:BP	pattern specification process	16175	2889		0.13924050632911392	0.14465408805031446	250	15925	19	63	231	15862	16175	0.12513587812980184
M1	cpdb	0	network_modules	4	TRUE	4.2300888050285343e-14	254	82	19	0.23170731707317074	0.07480314960629922	GO:0001503	GO:BP	ossification	16175	320		0.14556962025316456	0.1509433962264151	254	15921	19	63	235	15858	16175	0.12402025425858373
M1	cpdb	0	network_modules	4	TRUE	1.5225631029966616e-13	41	82	11	0.13414634146341464	0.2682926829268293	GO:0003197	GO:BP	endocardial cushion development	16175	1627		0.1518987341772152	0.15723270440251572	41	16134	11	71	30	16063	16175	0.18683739802697202
M1	cpdb	0	network_modules	4	TRUE	1.6205593171498493e-13	159	82	16	0.1951219512195122	0.10062893081761007	GO:0001649	GO:BP	osteoblast differentiation	16175	367		0.15822784810126583	0.16352201257861634	159	16016	16	66	143	15950	16175	0.13406447399904198
M1	cpdb	0	network_modules	4	TRUE	3.651395537927577e-13	44	82	11	0.13414634146341464	0.25	GO:0030514	GO:BP	negative regulation of BMP signaling pathway	16175	6830		0.16455696202531644	0.16981132075471697	44	16131	11	71	33	16060	16175	0.18011808768521595
M1	cpdb	0	network_modules	4	TRUE	7.49047120482585e-13	157	51	15	0.29411764705882354	0.09554140127388536	KEGG:04390	KEGG	Hippo signaling pathway	8484	310		0.75	0.8	157	8327	15	36	142	8291	8484	0.15903732652813243
M1	cpdb	0	network_modules	4	TRUE	7.569924802182123e-13	21	82	9	0.10975609756097561	0.42857142857142855	GO:0032925	GO:BP	regulation of activin receptor signaling pathway	16175	7916		0.17088607594936708	0.1761006289308176	21	16154	9	73	12	16081	16175	0.2150026460793006
M1	cpdb	0	network_modules	4	TRUE	1.058525844326254e-12	48	82	11	0.13414634146341464	0.22916666666666666	GO:0060411	GO:BP	cardiac septum morphogenesis	16175	14612		0.17721518987341772	0.18238993710691823	48	16127	11	71	37	16056	16175	0.17214679778491873
M1	cpdb	0	network_modules	4	TRUE	2.0861063099262875e-12	225	82	17	0.2073170731707317	0.07555555555555556	GO:0003002	GO:BP	regionalization	16175	1453		0.18354430379746836	0.18867924528301888	225	15950	17	65	208	15885	16175	0.11787797367117599
M1	cpdb	0	network_modules	4	TRUE	4.237914403852103e-12	615	82	24	0.2926829268292683	0.03902439024390244	GO:0045597	GO:BP	positive regulation of cell differentiation	16175	11448		0.189873417721519	0.1949685534591195	615	15560	24	58	591	15502	16175	0.09505025532385829
M1	cpdb	0	network_modules	4	TRUE	5.724925703623447e-12	239	82	17	0.2073170731707317	0.07112970711297072	GO:0060485	GO:BP	mesenchyme development	16175	14679		0.1962025316455696	0.20125786163522014	239	15936	17	65	222	15871	16175	0.11391154387374776
M1	cpdb	0	network_modules	4	TRUE	6.901750243364851e-12	39	82	10	0.12195121951219512	0.2564102564102564	GO:0030501	GO:BP	positive regulation of bone mineralization	16175	6822		0.20253164556962025	0.20754716981132076	39	16136	10	72	29	16064	16175	0.17398669830391145
M1	cpdb	0	network_modules	4	TRUE	1.740615088430425e-11	83	82	12	0.14634146341463414	0.14457831325301204	GO:0003206	GO:BP	cardiac chamber morphogenesis	16175	1636		0.2088607594936709	0.2138364779874214	83	16092	12	70	71	16022	16175	0.14107640199645086
M1	cpdb	0	network_modules	4	TRUE	2.0479566094393284e-11	43	82	10	0.12195121951219512	0.23255813953488372	GO:0045778	GO:BP	positive regulation of ossification	16175	11612		0.21518987341772153	0.22012578616352202	43	16132	10	72	33	16060	16175	0.16537451870520814
M1	cpdb	0	network_modules	4	TRUE	2.2501932269486658e-11	62	82	11	0.13414634146341464	0.1774193548387097	GO:0003279	GO:BP	cardiac septum development	16175	1703		0.22151898734177214	0.22641509433962265	62	16113	11	71	51	16042	16175	0.15053493181779254
M1	cpdb	0	network_modules	4	TRUE	6.845902193334586e-11	48	82	10	0.12195121951219512	0.20833333333333334	GO:0070169	GO:BP	positive regulation of biomineral tissue development	16175	15962		0.22784810126582278	0.23270440251572327	48	16127	10	72	38	16055	16175	0.15614305930621572
M1	cpdb	0	network_modules	4	TRUE	8.202318663144056e-11	123	82	13	0.15853658536585366	0.10569105691056911	GO:0017015	GO:BP	regulation of transforming growth factor beta receptor signaling pathway	16175	5276		0.23417721518987342	0.2389937106918239	123	16052	13	69	110	15983	16175	0.12402169058248759
M1	cpdb	0	network_modules	4	TRUE	8.566404305112717e-11	49	82	10	0.12195121951219512	0.20408163265306123	GO:0045669	GO:BP	positive regulation of osteoblast differentiation	16175	11520		0.24050632911392406	0.24528301886792453	49	16126	10	72	39	16054	16175	0.15446603918262825
M1	cpdb	0	network_modules	4	TRUE	1.0145257352569501e-10	125	82	13	0.15853658536585366	0.104	GO:1903844	GO:BP	regulation of cellular response to transforming growth factor beta stimulus	16175	23323		0.2468354430379747	0.25157232704402516	125	16050	13	69	112	15981	16175	0.1229323892353311
M1	cpdb	0	network_modules	4	TRUE	1.262852216239976e-10	512	82	21	0.25609756097560976	0.041015625	GO:0009790	GO:BP	embryo development	16175	3677		0.25316455696202533	0.2578616352201258	512	15663	21	61	491	15602	16175	0.09150984477394353
M1	cpdb	0	network_modules	4	TRUE	1.2811664653513246e-10	34	82	9	0.10975609756097561	0.2647058823529412	GO:0003203	GO:BP	endocardial cushion morphogenesis	16175	1633		0.25949367088607594	0.2641509433962264	34	16141	9	73	25	16068	16175	0.16778709693485444
M1	cpdb	0	network_modules	4	TRUE	1.374567508937038e-10	98	82	12	0.14634146341463414	0.12244897959183673	GO:0003205	GO:BP	cardiac chamber development	16175	1635		0.26582278481012656	0.27044025157232704	98	16077	12	70	86	16007	16175	0.12903911552930378
M1	cpdb	0	network_modules	4	TRUE	4.0710411759624754e-10	24	82	8	0.0975609756097561	0.3333333333333333	GO:0003272	GO:BP	endocardial cushion formation	16175	1696		0.2721518987341772	0.27672955974842767	24	16151	8	74	16	16077	16175	0.17817539817418843
M1	cpdb	0	network_modules	4	TRUE	4.313170191450948e-10	80	82	11	0.13414634146341464	0.1375	GO:0030278	GO:BP	regulation of ossification	16175	6755		0.27848101265822783	0.2830188679245283	80	16095	11	71	69	16024	16175	0.13146380845081776
M1	cpdb	0	network_modules	4	TRUE	6.462110553088403e-10	144	82	13	0.15853658536585366	0.09027777777777778	GO:0001837	GO:BP	epithelial to mesenchymal transition	16175	494		0.2848101265822785	0.2893081761006289	144	16031	13	69	131	15962	16175	0.11371069660195988
M1	cpdb	0	network_modules	4	TRUE	6.517695080408557e-10	40	82	9	0.10975609756097561	0.225	GO:0072132	GO:BP	mesenchyme morphogenesis	16175	17163		0.2911392405063291	0.29559748427672955	40	16135	9	73	31	16062	16175	0.1541876990989592
M1	cpdb	0	network_modules	4	TRUE	7.523473210562227e-10	84	82	11	0.13414634146341464	0.13095238095238096	GO:0090288	GO:BP	negative regulation of cellular response to growth factor stimulus	16175	18172		0.2974683544303797	0.3018867924528302	84	16091	11	71	73	16020	16175	0.12806589179798805
M1	cpdb	0	network_modules	4	TRUE	8.316843197376332e-10	41	82	9	0.10975609756097561	0.21951219512195122	GO:0009953	GO:BP	dorsal/ventral pattern formation	16175	3791		0.3037974683544304	0.3081761006289308	41	16134	9	73	32	16061	16175	0.15221270765058903
M1	cpdb	0	network_modules	4	TRUE	1.2586270505981404e-9	63	82	10	0.12195121951219512	0.15873015873015872	GO:0030500	GO:BP	regulation of bone mineralization	16175	6821		0.310126582278481	0.31446540880503143	63	16112	10	72	53	16040	16175	0.13529350558964726
M1	cpdb	0	network_modules	4	TRUE	2.3810612497323e-9	93	82	11	0.13414634146341464	0.11827956989247312	GO:0051216	GO:BP	cartilage development	16175	13573		0.31645569620253167	0.32075471698113206	93	16082	11	71	82	16011	16175	0.1212202464926211
M1	cpdb	0	network_modules	4	TRUE	3.876065858009226e-9	18	82	7	0.08536585365853659	0.3888888888888889	GO:0061036	GO:BP	positive regulation of cartilage development	16175	15153		0.3227848101265823	0.3270440251572327	18	16157	7	75	11	16082	16175	0.18038548922849487
M1	cpdb	0	network_modules	4	TRUE	3.908011551772729e-9	129	82	12	0.14634146341463414	0.09302325581395349	GO:0061448	GO:BP	connective tissue development	16175	15483		0.3291139240506329	0.3333333333333333	129	16046	12	70	117	15976	16175	0.1110412782602201
M1	cpdb	0	network_modules	4	TRUE	5.50090195665263e-9	170	82	13	0.15853658536585366	0.07647058823529412	GO:0003007	GO:BP	heart morphogenesis	16175	1458		0.33544303797468356	0.33962264150943394	170	16005	13	69	157	15936	16175	0.10361437101929151
M1	cpdb	0	network_modules	4	TRUE	8.505930391709335e-9	434	82	18	0.21951219512195122	0.041474654377880185	GO:0045596	GO:BP	negative regulation of cell differentiation	16175	11447		0.34177215189873417	0.34591194968553457	434	15741	18	64	416	15677	16175	0.08511572880738301
M1	cpdb	0	network_modules	4	TRUE	9.459388885109234e-9	501	82	19	0.23170731707317074	0.03792415169660679	GO:0008285	GO:BP	negative regulation of cell population proliferation	16175	3152		0.34810126582278483	0.3522012578616352	501	15674	19	63	482	15611	16175	0.0827073264398525
M1	cpdb	0	network_modules	4	TRUE	1.0416614329447603e-8	140	82	12	0.14634146341463414	0.08571428571428572	GO:0048738	GO:BP	cardiac muscle tissue development	16175	12995		0.35443037974683544	0.3584905660377358	140	16035	12	70	128	15965	16175	0.10610220431648518
M1	cpdb	0	network_modules	4	TRUE	1.3990813069253823e-8	21	82	7	0.08536585365853659	0.3333333333333333	GO:0061384	GO:BP	heart trabecula morphogenesis	16175	15455		0.36075949367088606	0.36477987421383645	21	16154	7	75	14	16079	16175	0.16665234681084343
M1	cpdb	0	network_modules	4	TRUE	1.595014825454573e-8	36	82	8	0.0975609756097561	0.2222222222222222	GO:0061035	GO:BP	regulation of cartilage development	16175	15152		0.3670886075949367	0.3710691823899371	36	16139	8	74	28	16065	16175	0.14440990144036453
M1	cpdb	0	network_modules	4	TRUE	2.0075145756453394e-8	744	82	22	0.2682926829268293	0.02956989247311828	GO:0072359	GO:BP	circulatory system development	16175	17370		0.37341772151898733	0.37735849056603776	744	15431	22	60	722	15371	16175	0.07574961210186812
M1	cpdb	0	network_modules	4	TRUE	2.2084102277191787e-8	83	82	10	0.12195121951219512	0.12048192771084337	GO:0070167	GO:BP	regulation of biomineral tissue development	16175	15960		0.379746835443038	0.3836477987421384	83	16092	10	72	73	16020	16175	0.11670924872627036
M1	cpdb	0	network_modules	4	TRUE	2.7720215774186878e-8	59	82	9	0.10975609756097561	0.15254237288135594	GO:0002062	GO:BP	chondrocyte differentiation	16175	653		0.3860759493670886	0.389937106918239	59	16116	9	73	50	16043	16175	0.12564008519067424
M1	cpdb	0	network_modules	4	TRUE	2.8180915314852396e-8	85	82	10	0.12195121951219512	0.11764705882352941	GO:0030282	GO:BP	bone mineralization	16175	6757		0.3924050632911392	0.39622641509433965	85	16090	10	72	75	16018	16175	0.11521311681562553
M1	cpdb	0	network_modules	4	TRUE	3.171629732818752e-8	347	82	16	0.1951219512195122	0.04610951008645533	GO:0007507	GO:BP	heart development	16175	2993		0.3987341772151899	0.4025157232704403	347	15828	16	66	331	15762	16175	0.08556132176968641
M1	cpdb	0	network_modules	4	TRUE	3.82381554452131e-8	543	82	19	0.23170731707317074	0.034990791896869246	GO:0009887	GO:BP	animal organ morphogenesis	16175	3747		0.4050632911392405	0.4088050314465409	543	15632	19	63	524	15569	16175	0.07852195221477846
M1	cpdb	0	network_modules	4	TRUE	4.618807545068852e-8	201	82	13	0.15853658536585366	0.06467661691542288	GO:0048762	GO:BP	mesenchymal cell differentiation	16175	13013		0.41139240506329117	0.41509433962264153	201	15974	13	69	188	15905	16175	0.0941472817070022
M1	cpdb	0	network_modules	4	TRUE	5.3075937050697914e-8	626	82	20	0.24390243902439024	0.03194888178913738	GO:0035295	GO:BP	tube development	16175	8953		0.4177215189873418	0.42138364779874216	626	15549	20	62	606	15487	16175	0.0759404614378769
M1	cpdb	0	network_modules	4	TRUE	5.690464426982215e-8	25	82	7	0.08536585365853659	0.28	GO:0061383	GO:BP	trabecula morphogenesis	16175	15454		0.4240506329113924	0.4276729559748428	25	16150	7	75	18	16075	16175	0.15230895507058592
M1	cpdb	0	network_modules	4	TRUE	6.687554644185193e-8	207	82	13	0.15853658536585366	0.06280193236714976	GO:0014706	GO:BP	striated muscle tissue development	16175	4643		0.43037974683544306	0.4339622641509434	207	15968	13	69	194	15899	16175	0.09255464816297938
M1	cpdb	0	network_modules	4	TRUE	7.043462037923152e-8	93	82	10	0.12195121951219512	0.10752688172043011	GO:0010717	GO:BP	regulation of epithelial to mesenchymal transition	16175	4343		0.43670886075949367	0.44025157232704404	93	16082	10	72	83	16010	16175	0.10970674678317979
M1	cpdb	0	network_modules	4	TRUE	1.0085250147804017e-7	504	82	18	0.21951219512195122	0.03571428571428571	GO:0001944	GO:BP	vasculature development	16175	555		0.4430379746835443	0.44654088050314467	504	15671	18	64	486	15607	16175	0.07738229850049286
M1	cpdb	0	network_modules	4	TRUE	1.5177988993365477e-7	221	82	13	0.15853658536585366	0.058823529411764705	GO:0060537	GO:BP	muscle tissue development	16175	14726		0.44936708860759494	0.4528301886792453	221	15954	13	69	208	15885	16175	0.0890821739108646
M1	cpdb	0	network_modules	4	TRUE	1.81782154250012e-7	29	82	7	0.08536585365853659	0.2413793103448276	GO:0060412	GO:BP	ventricular septum morphogenesis	16175	14613		0.45569620253164556	0.4591194968553459	29	16146	7	75	22	16071	16175	0.14101556079664532
M1	cpdb	0	network_modules	4	TRUE	1.8700867120269115e-7	4	54	4	0.07407407407407407	1	REAC:R-HSA-2473224	REAC	Antagonism of Activin by Follistatin	10916	149		0.3	0.36363636363636365	4	10912	4	50	0	10862	10916	0.27154126465802164
M1	cpdb	0	network_modules	4	TRUE	1.8719002096032833e-7	331	82	15	0.18292682926829268	0.045317220543806644	GO:0048729	GO:BP	tissue morphogenesis	16175	12986		0.4620253164556962	0.46540880503144655	331	15844	15	67	316	15777	16175	0.0819108000153681
M1	cpdb	0	network_modules	4	TRUE	2.08414984461504e-7	16	82	6	0.07317073170731707	0.375	GO:0032926	GO:BP	negative regulation of activin receptor signaling pathway	16175	7917		0.46835443037974683	0.4716981132075472	16	16159	6	76	10	16083	16175	0.16390480560256668
M1	cpdb	0	network_modules	4	TRUE	2.254372028361217e-7	49	82	8	0.0975609756097561	0.16326530612244897	GO:0060840	GO:BP	artery development	16175	14985		0.47468354430379744	0.4779874213836478	49	16126	8	74	41	16052	16175	0.1227858704942326
M1	cpdb	0	network_modules	4	TRUE	2.9261322187563726e-7	770	82	21	0.25609756097560976	0.02727272727272727	GO:0048646	GO:BP	anatomical structure formation involved in morphogenesis	16175	12904		0.4810126582278481	0.48427672955974843	770	15405	21	61	749	15344	16175	0.06989537839791611
M1	cpdb	0	network_modules	4	TRUE	3.395296571942264e-7	617	82	19	0.23170731707317074	0.03079416531604538	GO:0051093	GO:BP	negative regulation of developmental process	16175	13488		0.4873417721518987	0.49056603773584906	617	15558	19	63	598	15495	16175	0.07213290370166997
M1	cpdb	0	network_modules	4	TRUE	4.2647148998313884e-7	480	82	17	0.2073170731707317	0.035416666666666666	GO:0001568	GO:BP	blood vessel development	16175	353		0.4936708860759494	0.4968553459119497	480	15695	17	65	463	15630	16175	0.07472677247166264
M1	cpdb	0	network_modules	4	TRUE	4.79259864125046e-7	18	82	6	0.07317073170731707	0.3333333333333333	GO:0060037	GO:BP	pharyngeal system development	16175	14300		0.5	0.5031446540880503	18	16157	6	76	12	16081	16175	0.1542757675462346
M1	cpdb	0	network_modules	4	TRUE	5.256754756223578e-7	795	82	21	0.25609756097560976	0.026415094339622643	GO:0051241	GO:BP	negative regulation of multicellular organismal process	16175	13591		0.5063291139240507	0.5094339622641509	795	15380	21	61	774	15319	16175	0.06833315175437212
M1	cpdb	0	network_modules	4	TRUE	6.035301261867434e-7	247	82	13	0.15853658536585366	0.05263157894736842	GO:0030336	GO:BP	negative regulation of cell migration	16175	6782		0.5126582278481012	0.5157232704402516	247	15928	13	69	234	15859	16175	0.08339635460236208
M1	cpdb	0	network_modules	4	TRUE	6.57535047767997e-7	83	82	9	0.10975609756097561	0.10843373493975904	GO:0030512	GO:BP	negative regulation of transforming growth factor beta receptor signaling pathway	16175	6828		0.5189873417721519	0.5220125786163522	83	16092	9	73	74	16019	16175	0.10452567209118012
M1	cpdb	0	network_modules	4	TRUE	6.610816418360138e-7	12	54	5	0.09259259259259259	0.4166666666666667	REAC:R-HSA-1433617	REAC	Regulation of signaling by NODAL	10916	2050		0.4	0.45454545454545453	12	10904	5	49	7	10855	10916	0.19467545672976003
M1	cpdb	0	network_modules	4	TRUE	7.053014403076708e-7	117	82	10	0.12195121951219512	0.08547008547008547	GO:0031214	GO:BP	biomineral tissue development	16175	7090		0.5253164556962026	0.5283018867924528	117	16058	10	72	107	15986	16175	0.0966328955588453
M1	cpdb	0	network_modules	4	TRUE	1.0819984866896203e-6	259	82	13	0.15853658536585366	0.05019305019305019	GO:2000146	GO:BP	negative regulation of cell motility	16175	25494		0.5316455696202531	0.5345911949685535	259	15916	13	69	246	15847	16175	0.08105028332807838
M1	cpdb	0	network_modules	4	TRUE	2.0764138799000727e-6	40	82	7	0.08536585365853659	0.175	GO:0003281	GO:BP	ventricular septum development	16175	1704		0.5379746835443038	0.5408805031446541	40	16135	7	75	33	16060	16175	0.11913395816743436
M1	cpdb	0	network_modules	4	TRUE	2.618081037953747e-6	781	82	20	0.24390243902439024	0.02560819462227913	GO:0030334	GO:BP	regulation of cell migration	16175	6780		0.5443037974683544	0.5471698113207547	781	15394	20	62	761	15332	16175	0.06513889337223845
M1	cpdb	0	network_modules	4	TRUE	3.1930984309303196e-6	283	82	13	0.15853658536585366	0.045936395759717315	GO:0040013	GO:BP	negative regulation of locomotion	16175	9901		0.5506329113924051	0.5534591194968553	283	15892	13	69	270	15823	16175	0.07678809559671798
M1	cpdb	0	network_modules	4	TRUE	3.3916954102076333e-6	24	82	6	0.07317073170731707	0.25	GO:0060317	GO:BP	cardiac epithelial to mesenchymal transition	16175	14529		0.5569620253164557	0.559748427672956	24	16151	6	76	18	16075	16175	0.13294363432417433
M1	cpdb	0	network_modules	4	TRUE	3.600628517513148e-6	552	82	17	0.2073170731707317	0.030797101449275364	GO:0035239	GO:BP	tube morphogenesis	16175	8921		0.5632911392405063	0.5660377358490566	552	15623	17	65	535	15558	16175	0.06809333504014607
M1	cpdb	0	network_modules	4	TRUE	7.134177422990245e-6	194	82	11	0.13414634146341464	0.05670103092783505	GO:0009792	GO:BP	embryo development ending in birth or egg hatching	16175	3679		0.569620253164557	0.5723270440251572	194	15981	11	71	183	15910	16175	0.08009996267522872
M1	cpdb	0	network_modules	4	TRUE	8.443105144277857e-6	76	82	8	0.0975609756097561	0.10526315789473684	GO:0003231	GO:BP	cardiac ventricle development	16175	1661		0.5759493670886076	0.5786163522012578	76	16099	8	74	68	16025	16175	0.09693178520100575
M1	cpdb	0	network_modules	4	TRUE	9.395537323583008e-6	512	82	16	0.1951219512195122	0.03125	GO:0040007	GO:BP	growth	16175	9895		0.5822784810126582	0.5849056603773585	512	15663	16	66	496	15597	16175	0.06664896992017677
M1	cpdb	0	network_modules	4	TRUE	1.0681353501102553e-5	50	82	7	0.08536585365853659	0.14	GO:0010718	GO:BP	positive regulation of epithelial to mesenchymal transition	16175	4344		0.5886075949367089	0.5911949685534591	50	16125	7	75	43	16050	16175	0.1057947121013421
M1	cpdb	0	network_modules	4	TRUE	1.756021558117053e-5	6	82	4	0.04878048780487805	0.6666666666666666	GO:0003223	GO:BP	ventricular compact myocardium morphogenesis	16175	1653		0.5949367088607594	0.5974842767295597	6	16169	4	78	2	16091	16175	0.179451257028308
M1	cpdb	0	network_modules	4	TRUE	1.9355045186613993e-5	121	82	9	0.10975609756097561	0.0743801652892562	GO:0033002	GO:BP	muscle cell proliferation	16175	7971		0.6012658227848101	0.6037735849056604	121	16054	9	73	112	15981	16175	0.08472657610173541
M1	cpdb	0	network_modules	4	TRUE	2.2471782853104945e-5	272	82	12	0.14634146341463414	0.04411764705882353	GO:0050673	GO:BP	epithelial cell proliferation	16175	13207		0.6075949367088608	0.610062893081761	272	15903	12	70	260	15833	16175	0.0719057523100431
M1	cpdb	0	network_modules	4	TRUE	2.4202995321095037e-5	56	82	7	0.08536585365853659	0.125	GO:0003151	GO:BP	outflow tract morphogenesis	16175	1583		0.6139240506329114	0.6163522012578616	56	16119	7	75	49	16044	16175	0.09953441772153157
M1	cpdb	0	network_modules	4	TRUE	2.695234436207957e-5	23	54	5	0.09259259259259259	0.21739130434782608	REAC:R-HSA-1181150	REAC	Signaling by NODAL	10916	2273		0.5	0.5454545454545454	23	10893	5	49	18	10844	10916	0.13913848750372343
M1	cpdb	0	network_modules	4	TRUE	4.426537701490227e-5	179	82	10	0.12195121951219512	0.055865921787709494	GO:0043009	GO:BP	chordate embryonic development	16175	10479		0.620253164556962	0.6226415094339622	179	15996	10	72	169	15924	16175	0.07566104813284533
M1	cpdb	0	network_modules	4	TRUE	6.258834869821259e-5	19	82	5	0.06097560975609756	0.2631578947368421	GO:0060392	GO:BP	negative regulation of SMAD protein signal transduction	16175	14597		0.6265822784810127	0.6289308176100629	19	16156	5	77	14	16079	16175	0.12462269105285928
M1	cpdb	0	network_modules	4	TRUE	8.988994079420969e-5	12	54	4	0.07407407407407407	0.3333333333333333	REAC:R-HSA-209822	REAC	Glycoprotein hormones	10916	1075		0.6	0.6363636363636364	12	10904	4	50	8	10854	10916	0.15527255519334268
M1	cpdb	0	network_modules	4	TRUE	9.211741169243624e-5	309	82	12	0.14634146341463414	0.038834951456310676	GO:0048598	GO:BP	embryonic morphogenesis	16175	12865		0.6329113924050633	0.6352201257861635	309	15866	12	70	297	15796	16175	0.0663492880418005
M1	cpdb	0	network_modules	4	TRUE	1.0579556495122655e-4	41	82	6	0.07317073170731707	0.14634146341463414	GO:0048844	GO:BP	artery morphogenesis	16175	13088		0.6392405063291139	0.6415094339622641	41	16134	6	76	35	16058	16175	0.10027567208601454
M1	cpdb	0	network_modules	4	TRUE	1.0866282639154322e-4	21	82	5	0.06097560975609756	0.23809523809523808	GO:0003181	GO:BP	atrioventricular valve morphogenesis	16175	1611		0.6455696202531646	0.6540880503144654	21	16154	5	77	16	16077	16175	0.1183020475423862
M1	cpdb	0	network_modules	4	TRUE	1.0866282639154322e-4	21	82	5	0.06097560975609756	0.23809523809523808	GO:0003209	GO:BP	cardiac atrium morphogenesis	16175	1639		0.6455696202531646	0.6540880503144654	21	16154	5	77	16	16077	16175	0.1183020475423862
M1	cpdb	0	network_modules	4	TRUE	1.4580538286304535e-4	9	82	4	0.04878048780487805	0.4444444444444444	GO:0062042	GO:BP	regulation of cardiac epithelial to mesenchymal transition	16175	15800		0.6582278481012658	0.660377358490566	9	16166	4	78	5	16088	16175	0.14597351346511767
M1	cpdb	0	network_modules	4	TRUE	1.6409536345531083e-4	44	82	6	0.07317073170731707	0.13636363636363635	GO:0055008	GO:BP	cardiac muscle tissue morphogenesis	16175	14197		0.6645569620253164	0.6666666666666666	44	16131	6	76	38	16055	16175	0.09655165215946779
M1	cpdb	0	network_modules	4	TRUE	1.7826249300975774e-4	23	82	5	0.06097560975609756	0.21739130434782608	GO:0001541	GO:BP	ovarian follicle development	16175	332		0.6708860759493671	0.6729559748427673	23	16152	5	77	18	16075	16175	0.11281428958151433
M1	cpdb	0	network_modules	4	TRUE	1.804480754428242e-4	14	54	4	0.07407407407407407	0.2857142857142857	REAC:R-HSA-209952	REAC	Peptide hormone biosynthesis	10916	1724		0.7	0.7272727272727273	14	10902	4	50	10	10852	10916	0.14340668149644256
M1	cpdb	0	network_modules	4	TRUE	1.8705255170016125e-4	157	82	9	0.10975609756097561	0.05732484076433121	GO:0060562	GO:BP	epithelial tube morphogenesis	16175	14746		0.6772151898734177	0.6792452830188679	157	16018	9	73	148	15945	16175	0.0728441689384093
M1	cpdb	0	network_modules	4	TRUE	2.242811239570084e-4	24	82	5	0.06097560975609756	0.20833333333333334	GO:0003171	GO:BP	atrioventricular valve development	16175	1601		0.6835443037974683	0.6855345911949685	24	16151	5	77	19	16074	16175	0.11032775239916728
M1	cpdb	0	network_modules	4	TRUE	2.3267008726508658e-4	272	82	11	0.13414634146341464	0.04044117647058824	GO:0048589	GO:BP	developmental growth	16175	12860		0.689873417721519	0.6918238993710691	272	15903	11	71	261	15832	16175	0.06513565554635276
M1	cpdb	0	network_modules	4	TRUE	2.415089334256459e-4	3	82	3	0.036585365853658534	1	GO:0032278	GO:BP	positive regulation of gonadotropin secretion	16175	7459		0.6962025316455697	0.71698113207547165	3	16172	3	79	0	16093	16175	0.19080525894000389
M1	cpdb	0	network_modules	4	TRUE	2.415089334256459e-4	3	82	3	0.036585365853658534	1	GO:0046881	GO:BP	positive regulation of follicle-stimulating hormone secretion	16175	12416		0.6962025316455697	0.71698113207547165	3	16172	3	79	0	16093	16175	0.19080525894000389
M1	cpdb	0	network_modules	4	TRUE	2.415089334256459e-4	3	82	3	0.036585365853658534	1	GO:0046880	GO:BP	regulation of follicle-stimulating hormone secretion	16175	12415		0.6962025316455697	0.71698113207547165	3	16172	3	79	0	16093	16175	0.19080525894000389
M1	cpdb	0	network_modules	4	TRUE	2.415089334256459e-4	3	82	3	0.036585365853658534	1	GO:0046882	GO:BP	negative regulation of follicle-stimulating hormone secretion	16175	12417		0.6962025316455697	0.71698113207547165	3	16172	3	79	0	16093	16175	0.19080525894000389
M1	cpdb	0	network_modules	4	TRUE	2.420717752266721e-4	10	82	4	0.04878048780487805	0.4	GO:0003183	GO:BP	mitral valve morphogenesis	16175	1613		0.7215189873417721	0.7232704402515723	10	16165	4	78	6	16087	16175	0.13830937574701138
M1	cpdb	0	network_modules	4	TRUE	3.18581494910651e-4	49	82	6	0.07317073170731707	0.12244897959183673	GO:0060415	GO:BP	muscle tissue morphogenesis	16175	14616		0.7278481012658228	0.7358490566037735	49	16126	6	76	43	16050	16175	0.09110570180583694
M1	cpdb	0	network_modules	4	TRUE	3.18581494910651e-4	49	82	6	0.07317073170731707	0.12244897959183673	GO:0048644	GO:BP	muscle organ morphogenesis	16175	12902		0.7278481012658228	0.7358490566037735	49	16126	6	76	43	16050	16175	0.09110570180583694
M1	cpdb	0	network_modules	4	TRUE	3.3130517462837426e-4	37	54	5	0.09259259259259259	0.13513513513513514	REAC:R-HSA-2129379	REAC	Molecules associated with elastic fibres	10916	1490		0.8	0.8181818181818182	37	10879	5	49	32	10830	10916	0.1082156248071279
M1	cpdb	0	network_modules	4	TRUE	3.4435574404069843e-4	26	82	5	0.06097560975609756	0.19230769230769232	GO:0003230	GO:BP	cardiac atrium development	16175	1660		0.740506329113924	0.7421383647798742	26	16149	5	77	21	16072	16175	0.10578571693153009
M1	cpdb	0	network_modules	4	TRUE	3.7893160943228827e-4	11	82	4	0.04878048780487805	0.36363636363636365	GO:0003174	GO:BP	mitral valve development	16175	1604		0.7468354430379747	0.7610062893081762	11	16164	4	78	7	16086	16175	0.1317076099870766
M1	cpdb	0	network_modules	4	TRUE	3.7893160943228827e-4	11	82	4	0.04878048780487805	0.36363636363636365	GO:0060841	GO:BP	venous blood vessel development	16175	14986		0.7468354430379747	0.7610062893081762	11	16164	4	78	7	16086	16175	0.1317076099870766
M1	cpdb	0	network_modules	4	TRUE	3.7893160943228827e-4	11	82	4	0.04878048780487805	0.36363636363636365	GO:0032332	GO:BP	positive regulation of chondrocyte differentiation	16175	7491		0.7468354430379747	0.7610062893081762	11	16164	4	78	7	16086	16175	0.1317076099870766
M1	cpdb	0	network_modules	4	TRUE	4.582354737143579e-4	52	82	6	0.07317073170731707	0.11538461538461539	GO:0001701	GO:BP	in utero embryonic development	16175	393		0.7658227848101266	0.7672955974842768	52	16123	6	76	46	16047	16175	0.08821296546910383
M1	cpdb	0	network_modules	4	TRUE	5.104222403268477e-4	28	82	5	0.06097560975609756	0.17857142857142858	GO:0032330	GO:BP	regulation of chondrocyte differentiation	16175	7489		0.7721518987341772	0.7735849056603774	28	16147	5	77	23	16070	16175	0.10173165915391075
M1	cpdb	0	network_modules	4	TRUE	5.817210522751255e-4	88	82	7	0.08536585365853659	0.07954545454545454	GO:0048705	GO:BP	skeletal system morphogenesis	16175	12962		0.7784810126582279	0.779874213836478	88	16087	7	75	81	16012	16175	0.07756011403518327
M1	cpdb	0	network_modules	4	TRUE	5.929682627055441e-4	236	82	10	0.12195121951219512	0.0423728813559322	GO:0050678	GO:BP	regulation of epithelial cell proliferation	16175	13212		0.7848101265822784	0.7861635220125787	236	15939	10	72	226	15867	16175	0.06391339995057105
M1	cpdb	0	network_modules	4	TRUE	6.446649304009575e-4	55	82	6	0.07317073170731707	0.10909090909090909	GO:0003179	GO:BP	heart valve morphogenesis	16175	1609		0.7911392405063291	0.7924528301886793	55	16120	6	76	49	16044	16175	0.085553976449311675
M1	cpdb	0	network_modules	4	TRUE	6.597258859940224e-4	182	82	9	0.10975609756097561	0.04945054945054945	GO:0007517	GO:BP	muscle organ development	16175	2999		0.7974683544303798	0.7987421383647799	182	15993	9	73	173	15920	16175	0.0666632747018919
M1	cpdb	0	network_modules	4	TRUE	6.975041885097621e-4	447	82	13	0.15853658536585366	0.029082774049217	GO:0048514	GO:BP	blood vessel morphogenesis	16175	12799		0.8037974683544303	0.8050314465408805	447	15728	13	69	434	15659	16175	0.057001503323019405
M1	cpdb	0	network_modules	4	TRUE	7.239230001778294e-4	701	82	16	0.1951219512195122	0.02282453637660485	GO:0060429	GO:BP	epithelium development	16175	14627		0.810126582278481	0.8113207547169812	701	15474	16	66	685	15408	16175	0.053210442451965836
M1	cpdb	0	network_modules	4	TRUE	7.796933718474681e-4	135	82	8	0.0975609756097561	0.05925925925925926	GO:0001935	GO:BP	endothelial cell proliferation	16175	549		0.8164556962025317	0.8176100628930818	135	16040	8	74	127	15966	16175	0.07000037497984224
M1	cpdb	0	network_modules	4	TRUE	8.040650568470967e-4	44	54	5	0.09259259259259259	0.11363636363636363	REAC:R-HSA-1566948	REAC	Elastic fibre formation	10916	836		0.9	0.9090909090909091	44	10872	5	49	39	10823	10916	0.09855324798722516
M1	cpdb	0	network_modules	4	TRUE	9.624964301395177e-4	4	82	3	0.036585365853658534	0.75	GO:0046884	GO:BP	follicle-stimulating hormone secretion	16175	12419		0.8227848101265823	0.8238993710691824	4	16171	3	79	1	16092	16175	0.1649666444357397
M1	cpdb	0	network_modules	4	TRUE	0.0010073142502152839	46	54	5	0.09259259259259259	0.10869565217391304	REAC:R-HSA-2173789	REAC	TGF-beta receptor signaling activates SMADs	10916	2428		1	1	46	10870	5	49	41	10821	10916	0.09619642044449077
M1	cpdb	0	network_modules	4	TRUE	0.0012078457068921422	255	82	10	0.12195121951219512	0.0392156862745098	GO:0002009	GO:BP	morphogenesis of an epithelium	16175	612		0.8291139240506329	0.8301886792452831	255	15920	10	72	245	15848	16175	0.06084977302979038
M1	cpdb	0	network_modules	4	TRUE	0.0013045282265691414	99	82	7	0.08536585365853659	0.0707070707070707	GO:0009952	GO:BP	anterior/posterior pattern specification	16175	3790		0.8354430379746836	0.8364779874213837	99	16076	7	75	92	16001	16175	0.07252698311181108
M1	cpdb	0	network_modules	4	TRUE	0.0013207103860468422	138	51	7	0.13725490196078433	0.050724637681159424	KEGG:05418	KEGG	Fluid shear stress and atherosclerosis	8484	495		1	1	138	8346	7	44	131	8302	8484	0.07438096601503998
M1	cpdb	0	network_modules	4	TRUE	0.001411121984834555	34	82	5	0.06097560975609756	0.14705882352941177	GO:0014855	GO:BP	striated muscle cell proliferation	16175	4732		0.8417721518987342	0.8427672955974843	34	16141	5	77	29	16064	16175	0.09175899093301197
M1	cpdb	0	network_modules	4	TRUE	0.0014830172345455903	400	82	12	0.14634146341463414	0.03	GO:0001525	GO:BP	angiogenesis	16175	330		0.8481012658227848	0.8490566037735849	400	15775	12	70	388	15705	16175	0.05589774085465987
M1	cpdb	0	network_modules	4	TRUE	0.0016397878527140643	35	82	5	0.06097560975609756	0.14285714285714285	GO:0045668	GO:BP	negative regulation of osteoblast differentiation	16175	11519		0.8544303797468354	0.8616352201257862	35	16140	5	77	30	16063	16175	0.09034647695421179
M1	cpdb	0	network_modules	4	TRUE	0.0016397878527140643	35	82	5	0.06097560975609756	0.14285714285714285	GO:0055010	GO:BP	ventricular cardiac muscle tissue morphogenesis	16175	14199		0.8544303797468354	0.8616352201257862	35	16140	5	77	30	16063	16175	0.09034647695421179
M1	cpdb	0	network_modules	4	TRUE	0.001896727322377096	36	82	5	0.06097560975609756	0.1388888888888889	GO:0008585	GO:BP	female gonad development	16175	3196		0.8670886075949367	0.8679245283018868	36	16139	5	77	31	16062	16175	0.08899193937379417
M1	cpdb	0	network_modules	4	TRUE	0.0019328830718248146	66	82	6	0.07317073170731707	0.09090909090909091	GO:0003170	GO:BP	heart valve development	16175	1600		0.8734177215189873	0.8742138364779874	66	16109	6	76	60	16033	16175	0.07736488989308332
M1	cpdb	0	network_modules	4	TRUE	0.0021844051203784216	37	82	5	0.06097560975609756	0.13513513513513514	GO:0046545	GO:BP	development of primary female sexual characteristics	16175	12230		0.879746835443038	0.8805031446540881	37	16138	5	77	32	16061	16175	0.0876914511732886
M1	cpdb	0	network_modules	4	TRUE	0.0023974269597443186	5	82	3	0.036585365853658534	0.6	GO:0032927	GO:BP	positive regulation of activin receptor signaling pathway	16175	7918		0.8860759493670886	0.89937106918239	5	16170	3	79	2	16091	16175	0.14730417163337642
M1	cpdb	0	network_modules	4	TRUE	0.0023974269597443186	5	82	3	0.036585365853658534	0.6	GO:0032276	GO:BP	regulation of gonadotropin secretion	16175	7457		0.8860759493670886	0.89937106918239	5	16170	3	79	2	16091	16175	0.14730417163337642
M1	cpdb	0	network_modules	4	TRUE	0.0023974269597443186	5	82	3	0.036585365853658534	0.6	GO:0032277	GO:BP	negative regulation of gonadotropin secretion	16175	7458		0.8860759493670886	0.89937106918239	5	16170	3	79	2	16091	16175	0.14730417163337642
M1	cpdb	0	network_modules	4	TRUE	0.002670299575146691	17	82	4	0.04878048780487805	0.23529411764705882	GO:0038092	GO:BP	nodal signaling pathway	16175	9692		0.9050632911392406	0.9056603773584906	17	16158	4	78	13	16080	16175	0.10514803935081968
M1	cpdb	0	network_modules	4	TRUE	0.003258447814167649	40	82	5	0.06097560975609756	0.125	GO:0009880	GO:BP	embryonic pattern specification	16175	3745		0.9113924050632911	0.9119496855345912	40	16135	5	77	35	16058	16175	0.08408021723590949
M1	cpdb	0	network_modules	4	TRUE	0.0034200133626272906	18	82	4	0.04878048780487805	0.2222222222222222	GO:0022602	GO:BP	ovulation cycle process	16175	6610		0.9177215189873418	0.9182389937106918	18	16157	4	78	14	16079	16175	0.10205632418171402
M1	cpdb	0	network_modules	4	TRUE	0.003696316182114376	41	82	5	0.06097560975609756	0.12195121951219512	GO:0003229	GO:BP	ventricular cardiac muscle tissue development	16175	1659		0.9240506329113924	0.9245283018867925	41	16134	5	77	36	16057	16175	0.08296332689782304
M1	cpdb	0	network_modules	4	TRUE	0.003815944538981304	74	82	6	0.07317073170731707	0.08108108108108109	GO:0001763	GO:BP	morphogenesis of a branching structure	16175	429		0.930379746835443	0.9308176100628931	74	16101	6	76	68	16025	16175	0.07255841090588001
M1	cpdb	0	network_modules	4	TRUE	0.00417920601313924	42	82	5	0.06097560975609756	0.11904761904761904	GO:0046660	GO:BP	female sex differentiation	16175	12293		0.9367088607594937	0.9371069182389937	42	16133	5	77	37	16056	16175	0.08188554128230828
M1	cpdb	0	network_modules	4	TRUE	0.004276833183355582	118	82	7	0.08536585365853659	0.059322033898305086	GO:0007548	GO:BP	sex differentiation	16175	3029		0.9430379746835443	0.9433962264150944	118	16057	7	75	111	15982	16175	0.06548581999248089
M1	cpdb	0	network_modules	4	TRUE	0.004777293703907463	6	82	3	0.036585365853658534	0.5	GO:0061626	GO:BP	pharyngeal arch artery morphogenesis	16175	15595		0.9493670886075949	0.949685534591195	6	16169	3	79	3	16090	16175	0.13424467712498003
M1	cpdb	0	network_modules	4	TRUE	0.008050372645818945	22	82	4	0.04878048780487805	0.18181818181818182	GO:0042698	GO:BP	ovulation cycle	16175	10308		0.9556962025316456	0.9622641509433962	22	16153	4	78	18	16075	16175	0.09184587536677419
M1	cpdb	0	network_modules	4	TRUE	0.008050372645818945	22	82	4	0.04878048780487805	0.18181818181818182	GO:0060043	GO:BP	regulation of cardiac muscle cell proliferation	16175	14306		0.9556962025316456	0.9622641509433962	22	16153	4	78	18	16075	16175	0.09184587536677419
M1	cpdb	0	network_modules	4	TRUE	0.00832965215961764	7	82	3	0.036585365853658534	0.42857142857142855	GO:0035907	GO:BP	dorsal aorta development	16175	9330		0.9683544303797469	0.9937106918238994	7	16168	3	79	4	16089	16175	0.12407808057846476
M1	cpdb	0	network_modules	4	TRUE	0.00832965215961764	7	82	3	0.036585365853658534	0.42857142857142855	GO:0060426	GO:BP	lung vasculature development	16175	14624		0.9683544303797469	0.9937106918238994	7	16168	3	79	4	16089	16175	0.12407808057846476
M1	cpdb	0	network_modules	4	TRUE	0.00832965215961764	7	82	3	0.036585365853658534	0.42857142857142855	GO:0032347	GO:BP	regulation of aldosterone biosynthetic process	16175	7506		0.9683544303797469	0.9937106918238994	7	16168	3	79	4	16089	16175	0.12407808057846476
M1	cpdb	0	network_modules	4	TRUE	0.00832965215961764	7	82	3	0.036585365853658534	0.42857142857142855	GO:0035912	GO:BP	dorsal aorta morphogenesis	16175	9335		0.9683544303797469	0.9937106918238994	7	16168	3	79	4	16089	16175	0.12407808057846476
M1	cpdb	0	network_modules	4	TRUE	0.00832965215961764	7	82	3	0.036585365853658534	0.42857142857142855	GO:0032344	GO:BP	regulation of aldosterone metabolic process	16175	7503		0.9683544303797469	0.9937106918238994	7	16168	3	79	4	16089	16175	0.12407808057846476
M1	cpdb	0	network_modules	4	TRUE	0.009707658993778808	23	82	4	0.04878048780487805	0.17391304347826086	GO:0003148	GO:BP	outflow tract septum morphogenesis	16175	1580		1	1	23	16152	4	78	19	16074	16175	0.0897127041204882
M1	cpdb	0	network_modules	5	TRUE	1.0169581369658263e-13	215	39	15	0.38461538461538464	0.06976744186046512	REAC:R-HSA-6805567	REAC	Keratinization	10916	1288		NA	1	215	10701	15	24	200	10677	10916	0.1572559025529921
M1	cpdb	0	network_modules	6	TRUE	1.2487631264255512e-37	162	76	30	0.39473684210526316	0.18518518518518517	GO:0009060	GO:BP	aerobic respiration	16175	3236		0	0.018867924528301886	162	16013	30	46	132	15967	16175	0.2654630653907163
M1	cpdb	0	network_modules	6	TRUE	3.585579268527865e-37	134	61	30	0.4918032786885246	0.22388059701492538	KEGG:00190	KEGG	Oxidative phosphorylation	8484	18		0	0.058823529411764705	134	8350	30	31	104	8319	8484	0.3249013830840603
M1	cpdb	0	network_modules	6	TRUE	1.536455188315679e-35	188	76	30	0.39473684210526316	0.1595744680851064	GO:0045333	GO:BP	cellular respiration	16175	11360		0.019230769230769232	0.03773584905660377	188	15987	30	46	158	15941	16175	0.2455936924309239
M1	cpdb	0	network_modules	6	TRUE	3.6546603792944445e-35	127	76	27	0.35526315789473684	0.2125984251968504	GO:0006119	GO:BP	oxidative phosphorylation	16175	1977		0.038461538461538464	0.05660377358490566	127	16048	27	49	100	15999	16175	0.2704478611157752
M1	cpdb	0	network_modules	6	TRUE	1.2204500153001158e-33	177	69	30	0.43478260869565216	0.1694915254237288	REAC:R-HSA-1428517	REAC	Aerobic respiration and respiratory electron transport	10916	127		0	0.1	177	10739	30	39	147	10700	10916	0.2643203461124622
M1	cpdb	0	network_modules	6	TRUE	1.6123037114649317e-31	252	76	30	0.39473684210526316	0.11904761904761904	GO:0015980	GO:BP	energy derivation by oxidation of organic compounds	16175	5060		0.057692307692307696	0.07547169811320754	252	15923	30	46	222	15877	16175	0.21035763288265916
M1	cpdb	0	network_modules	6	TRUE	2.174596027550504e-31	202	61	30	0.4918032786885246	0.1485148514851485	KEGG:05415	KEGG	Diabetic cardiomyopathy	8484	492		0.0625	0.11764705882352941	202	8282	30	31	172	8251	8484	0.26123354075854727
M1	cpdb	0	network_modules	6	TRUE	6.954352136231212e-31	372	76	33	0.4342105263157895	0.08870967741935484	GO:0006091	GO:BP	generation of precursor metabolites and energy	16175	1954		0.07692307692307693	0.09433962264150944	372	15803	33	43	339	15760	16175	0.18848476437408943
M1	cpdb	0	network_modules	6	TRUE	2.113519799191139e-28	82	76	21	0.27631578947368424	0.25609756097560976	GO:0019646	GO:BP	aerobic electron transport chain	16175	5967		0.09615384615384616	0.11320754716981132	82	16093	21	55	61	16038	16175	0.262415767510871
M1	cpdb	0	network_modules	6	TRUE	1.1254543627194121e-27	88	76	21	0.27631578947368424	0.23863636363636365	GO:0042775	GO:BP	mitochondrial ATP synthesis coupled electron transport	16175	10360		0.11538461538461539	0.1509433962264151	88	16087	21	55	67	16032	16175	0.2530126092567447
M1	cpdb	0	network_modules	6	TRUE	1.1254543627194121e-27	88	76	21	0.27631578947368424	0.23863636363636365	GO:0042773	GO:BP	ATP synthesis coupled electron transport	16175	10358		0.11538461538461539	0.1509433962264151	88	16087	21	55	67	16032	16175	0.2530126092567447
M1	cpdb	0	network_modules	6	TRUE	1.4121911608312697e-27	107	76	22	0.2894736842105263	0.205607476635514	GO:0022900	GO:BP	electron transport chain	16175	6630		0.15384615384615385	0.16981132075471697	107	16068	22	54	85	16014	16175	0.23974420936562338
M1	cpdb	0	network_modules	6	TRUE	5.584102931289569e-27	221	61	28	0.45901639344262296	0.12669683257918551	KEGG:05208	KEGG	Chemical carcinogenesis - reactive oxygen species	8484	460		0.125	0.17647058823529413	221	8263	28	33	193	8230	8484	0.23132486707920374
M1	cpdb	0	network_modules	6	TRUE	1.7593672589560787e-26	99	76	21	0.27631578947368424	0.21212121212121213	GO:0022904	GO:BP	respiratory electron transport chain	16175	6631		0.17307692307692307	0.18867924528301888	99	16076	21	55	78	16021	16175	0.23802508115964222
M1	cpdb	0	network_modules	6	TRUE	2.2780241722830068e-26	232	61	28	0.45901639344262296	0.1206896551724138	KEGG:04714	KEGG	Thermogenesis	8484	349		0.1875	0.23529411764705882	232	8252	28	33	204	8219	8484	0.2252481583495325
M1	cpdb	0	network_modules	6	TRUE	4.52242333879878e-26	103	69	22	0.3188405797101449	0.21359223300970873	REAC:R-HSA-611105	REAC	Respiratory electron transport	10916	2081		0.1111111111111111	0.2	103	10813	22	47	81	10766	10916	0.2552517394015124
M1	cpdb	0	network_modules	6	TRUE	2.9363790125534105e-23	265	61	27	0.4426229508196721	0.1018867924528302	KEGG:05012	KEGG	Parkinson disease	8484	412		0.25	0.29411764705882354	265	8219	27	34	238	8185	8484	0.20125701917433
M1	cpdb	0	network_modules	6	TRUE	5.414934340271609e-23	271	61	27	0.4426229508196721	0.0996309963099631	KEGG:05020	KEGG	Prion disease	8484	416		0.3125	0.35294117647058826	271	8213	27	34	244	8179	8484	0.19874704097843662
M1	cpdb	0	network_modules	6	TRUE	1.028907643547692e-21	154	61	22	0.36065573770491804	0.14285714285714285	KEGG:04932	KEGG	Non-alcoholic fatty liver disease	8484	389		0.375	0.4117647058823529	154	8330	22	39	132	8291	8484	0.21833072931315772
M1	cpdb	0	network_modules	6	TRUE	1.3407223333196964e-21	305	61	27	0.4426229508196721	0.08852459016393442	KEGG:05016	KEGG	Huntington disease	8484	414		0.4375	0.47058823529411764	305	8179	27	34	278	8145	8484	0.18589915471881968
M1	cpdb	0	network_modules	6	TRUE	1.4509394460591534e-21	382	61	29	0.47540983606557374	0.07591623036649214	KEGG:05010	KEGG	Alzheimer disease	8484	411		0.5	0.5294117647058824	382	8102	29	32	353	8070	8484	0.176628344231136
M1	cpdb	0	network_modules	6	TRUE	1.0872134484033003e-18	65	76	15	0.19736842105263158	0.23076923076923078	GO:0042776	GO:BP	proton motive force-driven mitochondrial ATP synthesis	16175	10361		0.19230769230769232	0.20754716981132076	65	16110	15	61	50	16049	16175	0.20998635738791283
M1	cpdb	0	network_modules	6	TRUE	2.6361025200578787e-18	363	61	26	0.4262295081967213	0.07162534435261708	KEGG:05014	KEGG	Amyotrophic lateral sclerosis	8484	413		0.5625	0.5882352941176471	363	8121	26	35	337	8086	8484	0.16124082860224823
M1	cpdb	0	network_modules	6	TRUE	5.9089330944093026e-18	72	76	15	0.19736842105263158	0.20833333333333334	GO:0015986	GO:BP	proton motive force-driven ATP synthesis	16175	5062		0.21153846153846154	0.22641509433962265	72	16103	15	61	57	16042	16175	0.19911442861841827
M1	cpdb	0	network_modules	6	TRUE	2.1967837198830237e-16	90	76	15	0.19736842105263158	0.16666666666666666	GO:0006754	GO:BP	ATP biosynthetic process	16175	2451		0.23076923076923078	0.24528301886792453	90	16085	15	61	75	16024	16175	0.17716508598079192
M1	cpdb	0	network_modules	6	TRUE	3.1204891104746456e-16	92	76	15	0.19736842105263158	0.16304347826086957	GO:0009145	GO:BP	purine nucleoside triphosphate biosynthetic process	16175	3312		0.25	0.2830188679245283	92	16083	15	61	77	16022	16175	0.17512672317735886
M1	cpdb	0	network_modules	6	TRUE	3.1204891104746456e-16	92	76	15	0.19736842105263158	0.16304347826086957	GO:0009206	GO:BP	purine ribonucleoside triphosphate biosynthetic process	16175	3372		0.25	0.2830188679245283	92	16083	15	61	77	16022	16175	0.17512672317735886
M1	cpdb	0	network_modules	6	TRUE	7.240431914934166e-16	97	76	15	0.19736842105263158	0.15463917525773196	GO:0009201	GO:BP	ribonucleoside triphosphate biosynthetic process	16175	3367		0.28846153846153844	0.3018867924528302	97	16078	15	61	82	16017	16175	0.17030486121662106
M1	cpdb	0	network_modules	6	TRUE	1.8699740024291674e-15	103	76	15	0.19736842105263158	0.14563106796116504	GO:0009142	GO:BP	nucleoside triphosphate biosynthetic process	16175	3309		0.3076923076923077	0.32075471698113206	103	16072	15	61	88	16011	16175	0.1649805408789314
M1	cpdb	0	network_modules	6	TRUE	3.632147436356627e-15	46	76	12	0.15789473684210525	0.2608695652173913	GO:0006120	GO:BP	mitochondrial electron transport, NADH to ubiquinone	16175	1978		0.3269230769230769	0.33962264150943394	46	16129	12	64	34	16065	16175	0.20005210584787855
M1	cpdb	0	network_modules	6	TRUE	5.537818037893306e-14	128	76	15	0.19736842105263158	0.1171875	GO:0009152	GO:BP	purine ribonucleotide biosynthetic process	16175	3319		0.34615384615384615	0.3584905660377358	128	16047	15	61	113	15986	16175	0.14691148100726845
M1	cpdb	0	network_modules	6	TRUE	1.5752027331950862e-13	137	76	15	0.19736842105263158	0.10948905109489052	GO:0009260	GO:BP	ribonucleotide biosynthetic process	16175	3425		0.36538461538461536	0.37735849056603776	137	16038	15	61	122	15977	16175	0.14162662135630597
M1	cpdb	0	network_modules	6	TRUE	3.035933733652782e-13	143	76	15	0.19736842105263158	0.1048951048951049	GO:0046390	GO:BP	ribose phosphate biosynthetic process	16175	12117		0.38461538461538464	0.39622641509433965	143	16032	15	61	128	15971	16175	0.13837726522434227
M1	cpdb	0	network_modules	6	TRUE	4.2843366111639873e-13	220	76	17	0.2236842105263158	0.07727272727272727	GO:0072522	GO:BP	purine-containing compound biosynthetic process	16175	17424		0.40384615384615385	0.41509433962264153	220	15955	17	59	203	15896	16175	0.12461856543865651
M1	cpdb	0	network_modules	6	TRUE	5.187366080137662e-13	364	76	20	0.2631578947368421	0.054945054945054944	GO:0007005	GO:BP	mitochondrion organization	16175	2617		0.4230769230769231	0.4339622641509434	364	15811	20	56	344	15755	16175	0.11148448045318653
M1	cpdb	0	network_modules	6	TRUE	5.521107561719409e-13	184	76	16	0.21052631578947367	0.08695652173913043	GO:0046034	GO:BP	ATP metabolic process	16175	11811		0.4423076923076923	0.4528301886792453	184	15991	16	60	168	15931	16175	0.1290288505325201
M1	cpdb	0	network_modules	6	TRUE	1.7836496725094618e-12	198	76	16	0.21052631578947367	0.08080808080808081	GO:0009205	GO:BP	purine ribonucleoside triphosphate metabolic process	16175	3371		0.46153846153846156	0.4716981132075472	198	15977	16	60	182	15917	16175	0.12389726762332404
M1	cpdb	0	network_modules	6	TRUE	2.2664615516032732e-12	201	76	16	0.21052631578947367	0.07960199004975124	GO:0009144	GO:BP	purine nucleoside triphosphate metabolic process	16175	3311		0.4807692307692308	0.49056603773584906	201	15974	16	60	185	15914	16175	0.12286569837771322
M1	cpdb	0	network_modules	6	TRUE	2.4321830584544345e-12	164	76	15	0.19736842105263158	0.09146341463414634	GO:0006164	GO:BP	purine nucleotide biosynthetic process	16175	1999		0.5	0.5094339622641509	164	16011	15	61	149	15950	16175	0.12840866672346749
M1	cpdb	0	network_modules	6	TRUE	2.868885468454847e-12	204	76	16	0.21052631578947367	0.0784313725490196	GO:0009199	GO:BP	ribonucleoside triphosphate metabolic process	16175	3365		0.5192307692307693	0.5283018867924528	204	15971	16	60	188	15911	16175	0.12185618683791206
M1	cpdb	0	network_modules	6	TRUE	6.599731495537726e-12	215	76	16	0.21052631578947367	0.07441860465116279	GO:0009141	GO:BP	nucleoside triphosphate metabolic process	16175	3308		0.5384615384615384	0.5471698113207547	215	15960	16	60	199	15900	16175	0.11833090363714548
M1	cpdb	0	network_modules	6	TRUE	7.045438629647932e-12	260	76	17	0.2236842105263158	0.06538461538461539	GO:1901293	GO:BP	nucleoside phosphate biosynthetic process	16175	21368		0.5576923076923077	0.5660377358490566	260	15915	17	59	243	15856	16175	0.11342530459835218
M1	cpdb	0	network_modules	6	TRUE	1.6097434486163828e-11	186	76	15	0.19736842105263158	0.08064516129032258	GO:0009165	GO:BP	nucleotide biosynthetic process	16175	3331		0.5769230769230769	0.5849056603773585	186	15989	15	61	171	15928	16175	0.11978210122866324
M1	cpdb	0	network_modules	6	TRUE	1.7417428378607153e-11	57	69	11	0.15942028985507245	0.19298245614035087	REAC:R-HSA-6799198	REAC	Complex I biogenesis	10916	391		0.2222222222222222	0.3	57	10859	11	58	46	10801	10916	0.17064019153681095
M1	cpdb	0	network_modules	6	TRUE	5.673276472558097e-11	87	61	12	0.19672131147540983	0.13793103448275862	KEGG:04260	KEGG	Cardiac muscle contraction	8484	296		0.625	0.6470588235294118	87	8397	12	49	75	8348	8484	0.15751132796811865
M1	cpdb	0	network_modules	6	TRUE	6.5297296476811e-11	469	76	20	0.2631578947368421	0.042643923240938165	GO:0072521	GO:BP	purine-containing compound metabolic process	16175	17423		0.5961538461538461	0.6037735849056604	469	15706	20	56	449	15650	16175	0.09588481219773229
M1	cpdb	0	network_modules	6	TRUE	1.857269431360116e-10	266	76	16	0.21052631578947367	0.06015037593984962	GO:0009150	GO:BP	purine ribonucleotide metabolic process	16175	3317		0.6153846153846154	0.6226415094339622	266	15909	16	60	250	15849	16175	0.1048510562785343
M1	cpdb	0	network_modules	6	TRUE	2.3212561794855748e-10	109	76	12	0.15789473684210525	0.11009174311926606	GO:0097250	GO:BP	mitochondrial respirasome assembly	16175	18559		0.6346153846153846	0.6415094339622641	109	16066	12	64	97	16002	16175	0.12694328431204466
M1	cpdb	0	network_modules	6	TRUE	3.290890197333572e-10	276	76	16	0.21052631578947367	0.057971014492753624	GO:0009259	GO:BP	ribonucleotide metabolic process	16175	3424		0.6538461538461539	0.660377358490566	276	15899	16	60	260	15839	16175	0.10263842692790136
M1	cpdb	0	network_modules	6	TRUE	4.674160603745578e-10	521	76	20	0.2631578947368421	0.03838771593090211	GO:0006753	GO:BP	nucleoside phosphate metabolic process	16175	2450		0.6730769230769231	0.6792452830188679	521	15654	20	56	501	15598	16175	0.08987393120813375
M1	cpdb	0	network_modules	6	TRUE	4.803352120564382e-10	61	76	10	0.13157894736842105	0.16393442622950818	GO:0032981	GO:BP	mitochondrial respiratory chain complex I assembly	16175	7963		0.6923076923076923	0.71698113207547165	61	16114	10	66	51	16048	16175	0.14326563929200709
M1	cpdb	0	network_modules	6	TRUE	4.803352120564382e-10	61	76	10	0.13157894736842105	0.16393442622950818	GO:0010257	GO:BP	NADH dehydrogenase complex assembly	16175	4030		0.6923076923076923	0.71698113207547165	61	16114	10	66	51	16048	16175	0.14326563929200709
M1	cpdb	0	network_modules	6	TRUE	4.846521206027324e-10	283	76	16	0.21052631578947367	0.05653710247349823	GO:0019693	GO:BP	ribose phosphate metabolic process	16175	6010		0.7307692307692307	0.7358490566037735	283	15892	16	60	267	15832	16175	0.1011566304552318
M1	cpdb	0	network_modules	6	TRUE	8.834765453938392e-10	349	76	17	0.2236842105263158	0.04871060171919771	GO:0006163	GO:BP	purine nucleotide metabolic process	16175	1998		0.75	0.7547169811320755	349	15826	17	59	332	15767	16175	0.09557321787036749
M1	cpdb	0	network_modules	6	TRUE	1.1030737912409677e-9	66	76	10	0.13157894736842105	0.15151515151515152	GO:1902600	GO:BP	proton transmembrane transport	16175	22372		0.7692307692307693	0.7735849056603774	66	16109	10	66	56	16043	16175	0.13742024309932743
M1	cpdb	0	network_modules	6	TRUE	1.6665561768159531e-9	558	76	20	0.2631578947368421	0.035842293906810034	GO:0055086	GO:BP	nucleobase-containing small molecule metabolic process	16175	14237		0.7884615384615384	0.7924528301886793	558	15617	20	56	538	15561	16175	0.0860847722126372
M1	cpdb	0	network_modules	6	TRUE	1.9028567069875474e-9	97	76	11	0.14473684210526316	0.1134020618556701	GO:0033108	GO:BP	mitochondrial respiratory chain complex assembly	16175	8042		0.8076923076923077	0.8113207547169812	97	16078	11	65	86	16013	16175	0.12346709710430206
M1	cpdb	0	network_modules	6	TRUE	4.856747811641719e-9	388	76	17	0.2236842105263158	0.04381443298969072	GO:0009117	GO:BP	nucleotide metabolic process	16175	3286		0.8269230769230769	0.8301886792452831	388	15787	17	59	371	15728	16175	0.0896719440069691
M1	cpdb	0	network_modules	6	TRUE	3.356707213204322e-8	148	61	12	0.19672131147540983	0.08108108108108109	KEGG:04723	KEGG	Retrograde endocannabinoid signaling	8484	353		0.6875	0.7058823529411765	148	8336	12	49	136	8287	8484	0.11653230575294743
M1	cpdb	0	network_modules	6	TRUE	3.93705126656683e-8	512	76	18	0.23684210526315788	0.03515625	GO:0090407	GO:BP	organophosphate biosynthetic process	16175	18274		0.8461538461538461	0.8490566037735849	512	15663	18	58	494	15605	16175	0.08052520023954685
M1	cpdb	0	network_modules	6	TRUE	3.63137839372748e-6	514	76	16	0.21052631578947367	0.0311284046692607	GO:1901137	GO:BP	carbohydrate derivative biosynthetic process	16175	21245		0.8653846153846154	0.8679245283018868	514	15661	16	60	498	15601	16175	0.07001702662801705
M1	cpdb	0	network_modules	6	TRUE	5.691163821606731e-6	13	76	5	0.06578947368421052	0.38461538461538464	GO:0006122	GO:BP	mitochondrial electron transport, ubiquinol to cytochrome c	16175	1980		0.8846153846153846	0.8867924528301887	13	16162	5	71	8	16091	16175	0.15756169301101688
M1	cpdb	0	network_modules	6	TRUE	1.3847109311377024e-5	19	61	5	0.08196721311475409	0.2631578947368421	KEGG:00785	KEGG	Lipoic acid metabolism	8484	124		0.75	0.7647058823529411	19	8465	5	56	14	8409	8484	0.14353279759459717
M1	cpdb	0	network_modules	6	TRUE	5.030147767426283e-5	19	76	5	0.06578947368421052	0.2631578947368421	GO:0006123	GO:BP	mitochondrial electron transport, cytochrome c to oxygen	16175	1981		0.9038461538461539	0.9056603773584906	19	16156	5	71	14	16085	16175	0.12961046272242288
M1	cpdb	0	network_modules	6	TRUE	2.6163909598953927e-4	33	61	5	0.08196721311475409	0.15151515151515152	KEGG:01210	KEGG	2-Oxocarboxylic acid metabolism	8484	185		0.8125	0.8235294117647058	33	8451	5	56	28	8395	8484	0.10674493300632054
M1	cpdb	0	network_modules	6	TRUE	5.520703714476661e-4	31	69	5	0.07246376811594203	0.16129032258064516	REAC:R-HSA-8949613	REAC	Cristae formation	10916	414		0.3333333333333333	0.5	31	10885	5	64	26	10821	10916	0.10435098086035918
M1	cpdb	0	network_modules	6	TRUE	5.520703714476661e-4	31	69	5	0.07246376811594203	0.16129032258064516	REAC:R-HSA-389661	REAC	Glyoxylate metabolism and glycine degradation	10916	1081		0.3333333333333333	0.5	31	10885	5	64	26	10821	10916	0.10435098086035918
M1	cpdb	0	network_modules	6	TRUE	0.0010080440223514465	62	69	6	0.08695652173913043	0.0967741935483871	REAC:R-HSA-9707564	REAC	Cytoprotection by HMOX1	10916	426		0.5555555555555556	0.6	62	10854	6	63	56	10791	10916	0.08625991348237104
M1	cpdb	0	network_modules	6	TRUE	0.0013344545633793144	65	69	6	0.08695652173913043	0.09230769230769231	REAC:R-HSA-1268020	REAC	Mitochondrial protein import	10916	1468		0.6666666666666666	0.7	65	10851	6	63	59	10788	10916	0.08397252606360453
M1	cpdb	0	network_modules	6	TRUE	0.0013423171655151337	15	76	4	0.05263157894736842	0.26666666666666666	GO:0007008	GO:BP	outer mitochondrial membrane organization	16175	2620		0.9230769230769231	0.9433962264150944	15	16160	4	72	11	16088	16175	0.11671087752893211
M1	cpdb	0	network_modules	6	TRUE	0.0013423171655151337	15	76	4	0.05263157894736842	0.26666666666666666	GO:0045040	GO:BP	protein insertion into mitochondrial outer membrane	16175	11243		0.9230769230769231	0.9433962264150944	15	16160	4	72	11	16088	16175	0.11671087752893211
M1	cpdb	0	network_modules	6	TRUE	0.0017379777920618928	48	61	5	0.08196721311475409	0.10416666666666667	KEGG:00280	KEGG	Valine, leucine and isoleucine degradation	8484	31		0.875	0.8823529411764706	48	8436	5	56	43	8380	8484	0.08658086218542442
M1	cpdb	0	network_modules	6	TRUE	0.0017731720156879587	18	69	4	0.057971014492753624	0.2222222222222222	REAC:R-HSA-163210	REAC	Formation of ATP by chemiosmotic coupling	10916	944		0.7777777777777778	0.8	18	10898	4	65	14	10833	10916	0.11071389244952914
M1	cpdb	0	network_modules	6	TRUE	0.0027038745051727697	158	69	8	0.11594202898550725	0.05063291139240506	REAC:R-HSA-9609507	REAC	Protein localization	10916	1815		0.8888888888888888	0.9	158	10758	8	61	150	10697	10916	0.06775907225584707
M1	cpdb	0	network_modules	6	TRUE	0.0029676626188741926	27	61	4	0.06557377049180328	0.14814814814814814	KEGG:04966	KEGG	Collecting duct acid secretion	8484	400		0.9375	0.9411764705882353	27	8457	4	57	23	8400	8484	0.09426842036561836
M1	cpdb	0	network_modules	6	TRUE	0.005617430250639783	575	76	13	0.17105263157894737	0.022608695652173914	GO:0098662	GO:BP	inorganic cation transmembrane transport	16175	18818		0.9615384615384616	0.9622641509433962	575	15600	13	63	562	15537	16175	0.050281399156452834
M1	cpdb	0	network_modules	6	TRUE	0.005622825787946017	671	76	14	0.18421052631578946	0.020864381520119227	GO:0034220	GO:BP	monoatomic ion transmembrane transport	16175	8508		0.9807692307692307	0.9811320754716981	671	15504	14	62	657	15442	16175	0.04917834252168139
M1	cpdb	0	network_modules	6	TRUE	0.005836252076721799	577	76	13	0.17105263157894737	0.022530329289428077	GO:0098655	GO:BP	monoatomic cation transmembrane transport	16175	18811		1	1	577	15598	13	63	564	15535	16175	0.050151593370150925
M1	cpdb	0	network_modules	6	TRUE	0.005919531963239844	32	61	4	0.06557377049180328	0.125	KEGG:00640	KEGG	Propanoate metabolism	8484	109		1	1	32	8452	4	57	28	8395	8484	0.08579850599615974
M1	cpdb	0	network_modules	6	TRUE	0.005977298118242465	84	69	6	0.08695652173913043	0.07142857142857142	REAC:R-HSA-5628897	REAC	TP53 Regulates Metabolic Genes	10916	2452		1	1	84	10832	6	63	78	10769	10916	0.07234374665958525
M1	cpdb	0	network_modules	7	TRUE	3.0754718268566447e-34	41	56	20	0.35714285714285715	0.4878048780487805	REAC:R-HSA-383280	REAC	Nuclear Receptor transcription pathway	10916	1616		0	0.029411764705882353	41	10875	20	36	21	10839	10916	0.4148456266887633
M1	cpdb	0	network_modules	7	TRUE	4.472030086483491e-22	113	56	19	0.3392857142857143	0.168141592920354	REAC:R-HSA-1989781	REAC	PPARA activates gene expression	10916	1700		0.030303030303030304	0.058823529411764705	113	10803	19	37	94	10766	10916	0.23336724613303328
M1	cpdb	0	network_modules	7	TRUE	5.348996133473609e-22	114	56	19	0.3392857142857143	0.16666666666666666	REAC:R-HSA-400206	REAC	Regulation of lipid metabolism by PPARalpha	10916	2041		0.06060606060606061	0.08823529411764706	114	10802	19	37	95	10765	10916	0.23228749490730452
M1	cpdb	0	network_modules	7	TRUE	7.395774580805744e-21	67	56	16	0.2857142857142857	0.23880597014925373	REAC:R-HSA-400253	REAC	Circadian Clock	10916	363		0.09090909090909091	0.11764705882352941	67	10849	16	40	51	10809	10916	0.2570461156420378
M1	cpdb	0	network_modules	7	TRUE	1.6761213338214994e-19	178	74	20	0.2702702702702703	0.11235955056179775	GO:0009755	GO:BP	hormone-mediated signaling pathway	16175	3652		0	0.02564102564102564	178	15997	20	54	158	15943	16175	0.16848040742334328
M1	cpdb	0	network_modules	7	TRUE	5.598219478106562e-19	27	56	12	0.21428571428571427	0.4444444444444444	REAC:R-HSA-1368108	REAC	BMAL1:CLOCK,NPAS2 activates circadian gene expression	10916	203		0.12121212121212122	0.14705882352941177	27	10889	12	44	15	10845	10916	0.30620895235084195
M1	cpdb	0	network_modules	7	TRUE	3.89525980009688e-18	539	74	27	0.36486486486486486	0.05009276437847866	GO:0009725	GO:BP	response to hormone	16175	3623		0.02631578947368421	0.05128205128205128	539	15636	27	47	512	15589	16175	0.12523186497963607
M1	cpdb	0	network_modules	7	TRUE	1.457783586366987e-17	451	74	25	0.33783783783783783	0.05543237250554324	GO:0032870	GO:BP	cellular response to hormone stimulus	16175	7867		0.05263157894736842	0.07692307692307693	451	15724	25	49	426	15675	16175	0.12763300865036756
M1	cpdb	0	network_modules	7	TRUE	1.7063952500238887e-17	47	56	13	0.23214285714285715	0.2765957446808511	REAC:R-HSA-9707616	REAC	Heme signaling	10916	1117		0.15151515151515152	0.17647058823529413	47	10869	13	43	34	10826	10916	0.24987547684095107
M1	cpdb	0	network_modules	7	TRUE	4.211012581784828e-16	152	74	17	0.22972972972972974	0.1118421052631579	GO:0141193	GO:BP	nuclear receptor-mediated signaling pathway	16175	20078		0.07894736842105263	0.10256410256410256	152	16023	17	57	135	15966	16175	0.15481698280936615
M1	cpdb	0	network_modules	7	TRUE	2.1319504728264882e-14	18	56	9	0.16071428571428573	0.5	REAC:R-HSA-1368082	REAC	RORA activates gene expression	10916	1909		0.18181818181818182	0.20588235294117646	18	10898	9	47	9	10851	10916	0.2815195142619798
M1	cpdb	0	network_modules	7	TRUE	4.0921562353210817e-13	68	74	12	0.16216216216216217	0.17647058823529413	GO:0032922	GO:BP	circadian regulation of gene expression	16175	7913		0.10526315789473684	0.1282051282051282	68	16107	12	62	56	16045	16175	0.16550608268368122
M1	cpdb	0	network_modules	7	TRUE	5.364359572867066e-13	53	56	11	0.19642857142857142	0.20754716981132076	REAC:R-HSA-2151201	REAC	Transcriptional activation of mitochondrial biogenesis	10916	2548		0.21212121212121213	0.23529411764705882	53	10863	11	45	42	10818	10916	0.1979086668637772
M1	cpdb	0	network_modules	7	TRUE	5.601116707224588e-13	24	56	9	0.16071428571428573	0.375	REAC:R-HSA-4090294	REAC	SUMOylation of intracellular receptors	10916	2175		0.24242424242424243	0.2647058823529412	24	10892	9	47	15	10845	10916	0.24302749684475636
M1	cpdb	0	network_modules	7	TRUE	8.254288284619536e-13	791	74	26	0.35135135135135137	0.03286978508217446	GO:0000122	GO:BP	negative regulation of transcription by RNA polymerase II	16175	48		0.13157894736842105	0.15384615384615385	791	15384	26	48	765	15336	16175	0.09507418324758478
M1	cpdb	0	network_modules	7	TRUE	1.2099829860037532e-12	162	74	15	0.20270270270270271	0.09259259259259259	GO:0007623	GO:BP	circadian rhythm	16175	3080		0.15789473684210525	0.1794871794871795	162	16013	15	59	147	15954	16175	0.1311876149259296
M1	cpdb	0	network_modules	7	TRUE	2.705304522146607e-12	302	74	18	0.24324324324324326	0.059602649006622516	GO:0030522	GO:BP	intracellular receptor signaling pathway	16175	6836		0.18421052631578946	0.20512820512820512	302	15873	18	56	284	15817	16175	0.11247531839877849
M1	cpdb	0	network_modules	7	TRUE	8.222503898146794e-12	184	74	15	0.20270270270270271	0.08152173913043478	GO:0048511	GO:BP	rhythmic process	16175	12796		0.21052631578947367	0.23076923076923078	184	15991	15	59	169	15932	16175	0.1223104438941579
M1	cpdb	0	network_modules	7	TRUE	3.2614245117795863e-10	92	56	11	0.19642857142857142	0.11956521739130435	REAC:R-HSA-1592230	REAC	Mitochondrial biogenesis	10916	1464		0.2727272727272727	0.29411764705882354	92	10824	11	45	81	10779	10916	0.14767738785569462
M1	cpdb	0	network_modules	7	TRUE	8.252361877656915e-10	171	56	13	0.23214285714285715	0.07602339181286549	REAC:R-HSA-3108232	REAC	SUMO E3 ligases SUMOylate target proteins	10916	2163		0.30303030303030304	0.3235294117647059	171	10745	13	43	158	10702	10916	0.12518568930593157
M1	cpdb	0	network_modules	7	TRUE	1.2843225691117617e-9	177	56	13	0.23214285714285715	0.07344632768361582	REAC:R-HSA-2990846	REAC	SUMOylation	10916	2167		0.3333333333333333	0.35294117647058826	177	10739	13	43	164	10696	10916	0.12276746550591634
M1	cpdb	0	network_modules	7	TRUE	3.593717700689977e-9	83	56	10	0.17857142857142858	0.12048192771084337	REAC:R-HSA-381340	REAC	Transcriptional regulation of white adipocyte differentiation	10916	2562		0.36363636363636365	0.4117647058823529	83	10833	10	46	73	10787	10916	0.14133307720446592
M1	cpdb	0	network_modules	7	TRUE	3.593717700689977e-9	83	56	10	0.17857142857142858	0.12048192771084337	REAC:R-HSA-9843745	REAC	Adipogenesis	10916	122		0.36363636363636365	0.4117647058823529	83	10833	10	46	73	10787	10916	0.14133307720446592
M1	cpdb	0	network_modules	7	TRUE	7.000279540359201e-9	40	56	8	0.14285714285714285	0.2	REAC:R-HSA-2426168	REAC	Activation of gene expression by SREBF (SREBP)	10916	101		0.42424242424242425	0.4411764705882353	40	10876	8	48	32	10828	10916	0.16542258168317867
M1	cpdb	0	network_modules	7	TRUE	7.495821178603364e-9	62	56	9	0.16071428571428573	0.14516129032258066	REAC:R-HSA-9707564	REAC	Cytoprotection by HMOX1	10916	426		0.45454545454545453	0.47058823529411764	62	10854	9	47	53	10807	10916	0.14814273771436065
M1	cpdb	0	network_modules	7	TRUE	8.754354209919104e-9	243	74	14	0.1891891891891892	0.05761316872427984	GO:0019216	GO:BP	regulation of lipid metabolic process	16175	5593		0.23684210526315788	0.2564102564102564	243	15932	14	60	229	15872	16175	0.09706414410237972
M1	cpdb	0	network_modules	7	TRUE	2.8696478576042978e-8	520	74	18	0.24324324324324326	0.03461538461538462	GO:0033993	GO:BP	response to lipid	16175	8371		0.2631578947368421	0.28205128205128205	520	15655	18	56	502	15599	16175	0.08113031976350235
M1	cpdb	0	network_modules	7	TRUE	4.528973074846518e-8	98	74	10	0.13513513513513514	0.10204081632653061	GO:0042752	GO:BP	regulation of circadian rhythm	16175	10345		0.2894736842105263	0.3076923076923077	98	16077	10	64	88	16013	16175	0.11276258759511576
M1	cpdb	0	network_modules	7	TRUE	7.380397213880327e-8	408	74	16	0.21621621621621623	0.0392156862745098	GO:0071396	GO:BP	cellular response to lipid	16175	16648		0.3157894736842105	0.3333333333333333	408	15767	16	58	392	15709	16175	0.08257422835806409
M1	cpdb	0	network_modules	7	TRUE	7.666550215687222e-8	53	56	8	0.14285714285714285	0.1509433962264151	REAC:R-HSA-1655829	REAC	Regulation of cholesterol biosynthesis by SREBP (SREBF)	10916	2023		0.48484848484848486	0.5	53	10863	8	48	45	10815	10916	0.1425656243521215
M1	cpdb	0	network_modules	7	TRUE	7.729890626305486e-8	345	74	15	0.20270270270270271	0.043478260869565216	GO:0071407	GO:BP	cellular response to organic cyclic compound	16175	16659		0.34210526315789475	0.358974358974359	345	15830	15	59	330	15771	16175	0.08510548114113735
M1	cpdb	0	network_modules	7	TRUE	2.0440344834329088e-7	437	74	16	0.21621621621621623	0.036613272311212815	GO:0014070	GO:BP	response to organic cyclic compound	16175	4635		0.3684210526315789	0.38461538461538464	437	15738	16	58	421	15680	16175	0.07911112576227947
M1	cpdb	0	network_modules	7	TRUE	6.180733834703353e-7	290	56	13	0.23214285714285715	0.04482758620689655	REAC:R-HSA-9006931	REAC	Signaling by Nuclear Receptors	10916	2289		0.5151515151515151	0.5294117647058824	290	10626	13	43	277	10583	10916	0.0917977153131315
M1	cpdb	0	network_modules	7	TRUE	1.0801513732093708e-6	40	74	7	0.0945945945945946	0.175	GO:0042789	GO:BP	mRNA transcription by RNA polymerase II	16175	10367		0.39473684210526316	0.41025641025641024	40	16135	7	67	33	16068	16175	0.1257421600027756
M1	cpdb	0	network_modules	7	TRUE	1.5174062557767328e-6	152	56	10	0.17857142857142858	0.06578947368421052	REAC:R-HSA-8957322	REAC	Metabolism of steroids	10916	1438		0.5454545454545454	0.5588235294117647	152	10764	10	46	142	10718	10916	0.10089916790085363
M1	cpdb	0	network_modules	7	TRUE	2.5818415643696045e-6	45	74	7	0.0945945945945946	0.15555555555555556	GO:0009299	GO:BP	mRNA transcription	16175	3446		0.42105263157894735	0.4358974358974359	45	16130	7	67	38	16063	16175	0.11817135297309155
M1	cpdb	0	network_modules	7	TRUE	2.8864345293528945e-6	34	50	6	0.12	0.17647058823529413	KEGG:04710	KEGG	Circadian rhythm	8484	345		0	0.14285714285714285	34	8450	6	44	28	8406	8484	0.1413613865516772
M1	cpdb	0	network_modules	7	TRUE	1.551527344459859e-5	8	56	4	0.07142857142857142	0.5	REAC:R-HSA-9029558	REAC	NR1H2 & NR1H3 regulate gene expression linked to lipogenesis	10916	1542		0.5757575757575758	0.5882352941176471	8	10908	4	52	4	10856	10916	0.1875936279943589
M1	cpdb	0	network_modules	7	TRUE	1.85038890438076e-5	75	50	7	0.14	0.09333333333333334	KEGG:03320	KEGG	PPAR signaling pathway	8484	236		0.16666666666666666	0.2857142857142857	75	8409	7	43	68	8366	8484	0.10788644971088257
M1	cpdb	0	network_modules	7	TRUE	2.7821059283110905e-5	9	56	4	0.07142857142857142	0.4444444444444444	REAC:R-HSA-9623433	REAC	NR1H2 & NR1H3 regulate gene expression to control bile acid homeostasis	10916	1544		0.6060606060606061	0.6176470588235294	9	10907	4	52	5	10855	10916	0.1766438812688309
M1	cpdb	0	network_modules	7	TRUE	3.502136195121076e-5	45	56	6	0.10714285714285714	0.13333333333333333	REAC:R-HSA-9024446	REAC	NR1H2 and NR1H3-mediated signaling	10916	1546		0.6363636363636364	0.6470588235294118	45	10871	6	50	39	10821	10916	0.11545829543764366
M1	cpdb	0	network_modules	7	TRUE	6.1547430439702e-5	107	74	8	0.10810810810810811	0.07476635514018691	GO:0030518	GO:BP	nuclear receptor-mediated steroid hormone signaling pathway	16175	6833		0.4473684210526316	0.46153846153846156	107	16068	8	66	99	16002	16175	0.0848783342735816
M1	cpdb	0	network_modules	7	TRUE	7.121615196399892e-5	109	74	8	0.10810810810810811	0.07339449541284404	GO:0043401	GO:BP	steroid hormone receptor signaling pathway	16175	10670		0.47368421052631576	0.48717948717948717	109	16066	8	66	101	16000	16175	0.08399880351873616
M1	cpdb	0	network_modules	7	TRUE	7.686050660805093e-5	292	56	11	0.19642857142857142	0.03767123287671233	REAC:R-HSA-1852241	REAC	Organelle biogenesis and maintenance	10916	1646		0.6666666666666666	0.6764705882352942	292	10624	11	45	281	10579	10916	0.07551528636379276
M1	cpdb	0	network_modules	7	TRUE	1.3218583753372913e-4	166	74	9	0.12162162162162163	0.05421686746987952	GO:0048545	GO:BP	response to steroid hormone	16175	12826		0.5	0.5128205128205128	166	16009	9	65	157	15944	16175	0.0749069984380617
M1	cpdb	0	network_modules	7	TRUE	1.7292992289061438e-4	10	74	4	0.05405405405405406	0.4	GO:0010887	GO:BP	negative regulation of cholesterol storage	16175	4473		0.5263157894736842	0.5384615384615384	10	16165	4	70	6	16095	16175	0.1457398491717915
M1	cpdb	0	network_modules	7	TRUE	1.7331434411618657e-4	37	50	5	0.1	0.13513513513513514	KEGG:05216	KEGG	Thyroid cancer	8484	467		0.3333333333333333	0.42857142857142855	37	8447	5	45	32	8402	8484	0.11175091765406452
M1	cpdb	0	network_modules	7	TRUE	2.2216233604147438e-4	26	74	5	0.06756756756756757	0.19230769230769232	GO:0048384	GO:BP	retinoic acid receptor signaling pathway	16175	12719		0.5526315789473685	0.5641025641025641	26	16149	5	69	21	16080	16175	0.11162355736600015
M1	cpdb	0	network_modules	7	TRUE	2.8304542466261887e-4	72	50	6	0.12	0.08333333333333333	KEGG:05223	KEGG	Non-small cell lung cancer	8484	474		0.5	0.5714285714285714	72	8412	6	44	66	8368	8484	0.0936009346205663
M1	cpdb	0	network_modules	7	TRUE	2.9457035691401334e-4	15	56	4	0.07142857142857142	0.26666666666666666	REAC:R-HSA-193807	REAC	Synthesis of bile acids and bile salts via 27-hydroxycholesterol	10916	2403		0.696969696969697	0.7058823529411765	15	10901	4	52	11	10849	10916	0.13579991712181985
M1	cpdb	0	network_modules	7	TRUE	3.0189550730023534e-4	242	74	10	0.13513513513513514	0.04132231404958678	GO:0062012	GO:BP	regulation of small molecule metabolic process	16175	15781		0.5789473684210527	0.5897435897435898	242	15933	10	64	232	15869	16175	0.06710995799658716
M1	cpdb	0	network_modules	7	TRUE	3.582703350226675e-4	36	56	5	0.08928571428571429	0.1388888888888889	REAC:R-HSA-9029569	REAC	NR1H3 & NR1H2 regulate gene expression linked to cholesterol transport and efflux	10916	1547		0.7272727272727273	0.7352941176470589	36	10880	5	51	31	10829	10916	0.10769952364812824
M1	cpdb	0	network_modules	7	TRUE	3.967205488806658e-4	211	56	9	0.16071428571428573	0.04265402843601896	REAC:R-HSA-9711123	REAC	Cellular response to chemical stress	10916	333		0.7575757575757576	0.7647058823529411	211	10705	9	47	202	10658	10916	0.07374133125352729
M1	cpdb	0	network_modules	7	TRUE	4.6003924827266336e-4	5	56	3	0.05357142857142857	0.6	REAC:R-HSA-9632974	REAC	NR1H2 & NR1H3 regulate gene expression linked to gluconeogenesis 	10916	1541		0.7878787878787878	0.8529411764705882	5	10911	3	53	2	10858	10916	0.17824991487007705
M1	cpdb	0	network_modules	7	TRUE	4.6003924827266336e-4	5	56	3	0.05357142857142857	0.6	REAC:R-HSA-9031528	REAC	NR1H2 & NR1H3 regulate gene expression linked to triglyceride lipolysis in adipose	10916	1543		0.7878787878787878	0.8529411764705882	5	10911	3	53	2	10858	10916	0.17824991487007705
M1	cpdb	0	network_modules	7	TRUE	4.6003924827266336e-4	5	56	3	0.05357142857142857	0.6	REAC:R-HSA-9031525	REAC	NR1H2 & NR1H3 regulate gene expression to limit cholesterol uptake 	10916	1545		0.7878787878787878	0.8529411764705882	5	10911	3	53	2	10858	10916	0.17824991487007705
M1	cpdb	0	network_modules	7	TRUE	5.576357224369282e-4	142	74	8	0.10810810810810811	0.056338028169014086	GO:0071383	GO:BP	cellular response to steroid hormone stimulus	16175	16635		0.6052631578947368	0.6153846153846154	142	16033	8	66	134	15967	16175	0.07218696443066737
M1	cpdb	0	network_modules	7	TRUE	6.528393970758556e-4	18	56	4	0.07142857142857142	0.2222222222222222	REAC:R-HSA-159418	REAC	Recycling of bile acids and salts	10916	1952		0.8787878787878788	0.8823529411764706	18	10898	4	52	14	10846	10916	0.12349846147886595
M1	cpdb	0	network_modules	7	TRUE	6.657523064356798e-4	32	74	5	0.06756756756756757	0.15625	GO:0045923	GO:BP	positive regulation of fatty acid metabolic process	16175	11717		0.631578947368421	0.6410256410256411	32	16143	5	69	27	16074	16175	0.10006886742876218
M1	cpdb	0	network_modules	7	TRUE	7.660390114514067e-4	148	74	8	0.10810810810810811	0.05405405405405406	GO:0120161	GO:BP	regulation of cold-induced thermogenesis	16175	19527		0.6578947368421053	0.6666666666666666	148	16027	8	66	140	15961	16175	0.0704577014454698
M1	cpdb	0	network_modules	7	TRUE	7.984857529583763e-4	101	74	7	0.0945945945945946	0.06930693069306931	GO:0010565	GO:BP	regulation of ketone metabolic process	16175	4218		0.6842105263157895	0.6923076923076923	101	16074	7	67	94	16007	16175	0.07603604675723513
M1	cpdb	0	network_modules	7	TRUE	8.065615586767471e-4	149	74	8	0.10810810810810811	0.053691275167785234	GO:0106106	GO:BP	cold-induced thermogenesis	16175	19254		0.7105263157894737	0.717948717948718	149	16026	8	66	141	15960	16175	0.07017918734724025
M1	cpdb	0	network_modules	7	TRUE	8.129482622286082e-4	14	74	4	0.05405405405405406	0.2857142857142857	GO:0042753	GO:BP	positive regulation of circadian rhythm	16175	10346		0.7368421052631579	0.7435897435897436	14	16161	4	70	10	16091	16175	0.12261779553388863
M1	cpdb	0	network_modules	7	TRUE	8.901706988076472e-4	43	56	5	0.08928571428571429	0.11627906976744186	REAC:R-HSA-5362517	REAC	Signaling by Retinoic Acid	10916	2303		0.9090909090909091	0.9117647058823529	43	10873	5	51	38	10822	10916	0.09784071948241123
M1	cpdb	0	network_modules	7	TRUE	0.0011186659069503241	192	50	8	0.16	0.041666666666666664	KEGG:05202	KEGG	Transcriptional misregulation in cancer	8484	454		0.6666666666666666	0.7142857142857143	192	8292	8	42	184	8250	8484	0.07111772616244627
M1	cpdb	0	network_modules	7	TRUE	0.001181559328590809	92	50	6	0.12	0.06521739130434782	KEGG:05222	KEGG	Small cell lung cancer	8484	473		0.8333333333333334	0.8571428571428571	92	8392	6	44	86	8348	8484	0.08115028654300895
M1	cpdb	0	network_modules	7	TRUE	0.0014557081893569663	161	74	8	0.10810810810810811	0.049689440993788817	GO:1990845	GO:BP	adaptive thermogenesis	16175	25314		0.7631578947368421	0.7692307692307693	161	16014	8	66	153	15948	16175	0.06703181561998713
M1	cpdb	0	network_modules	7	TRUE	0.00146787833729373	16	74	4	0.05405405405405406	0.25	GO:0010885	GO:BP	regulation of cholesterol storage	16175	4471		0.7894736842105263	0.7948717948717948	16	16159	4	70	12	16089	16175	0.11443888648311998
M1	cpdb	0	network_modules	7	TRUE	0.0017534990584971715	165	74	8	0.10810810810810811	0.048484848484848485	GO:0001659	GO:BP	temperature homeostasis	16175	373		0.8157894736842105	0.8205128205128205	165	16010	8	66	157	15944	16175	0.06605575051683008
M1	cpdb	0	network_modules	7	TRUE	0.0017592171299155518	71	74	6	0.08108108108108109	0.08450704225352113	GO:0019218	GO:BP	regulation of steroid metabolic process	16175	5595		0.8421052631578947	0.8461538461538461	71	16104	6	68	65	16036	16175	0.07864758964624256
M1	cpdb	0	network_modules	7	TRUE	0.0018534913882290857	23	56	4	0.07142857142857142	0.17391304347826086	REAC:R-HSA-193368	REAC	Synthesis of bile acids and bile salts via 7alpha-hydroxycholesterol	10916	2404		0.9393939393939394	0.9411764705882353	23	10893	4	52	19	10841	10916	0.10856088222321518
M1	cpdb	0	network_modules	7	TRUE	0.0024509277900103036	18	74	4	0.05405405405405406	0.2222222222222222	GO:0010878	GO:BP	cholesterol storage	16175	4464		0.868421052631579	0.8717948717948718	18	16157	4	70	14	16087	16175	0.10764927279493108
M1	cpdb	0	network_modules	7	TRUE	0.003093678422936081	26	56	4	0.07142857142857142	0.15384615384615385	REAC:R-HSA-211976	REAC	Endogenous sterols	10916	840		0.9696969696969697	0.9705882352941176	26	10890	4	52	22	10838	10916	0.10171505397095769
M1	cpdb	0	network_modules	7	TRUE	0.003198579563818282	242	74	9	0.12162162162162163	0.0371900826446281	GO:0008202	GO:BP	steroid metabolic process	16175	3129		0.8947368421052632	0.8974358974358975	242	15933	9	65	233	15868	16175	0.0595634585694741
M1	cpdb	0	network_modules	7	TRUE	0.004158246016996108	70	50	5	0.1	0.07142857142857142	KEGG:04920	KEGG	Adipocytokine signaling pathway	8484	377		1	1	70	8414	5	45	65	8369	8484	0.07809455548492762
M1	cpdb	0	network_modules	7	TRUE	0.004744166759877933	21	74	4	0.05405405405405406	0.19047619047619047	GO:0010888	GO:BP	negative regulation of lipid storage	16175	4474		0.9210526315789473	0.9230769230769231	21	16154	4	70	17	16084	16175	0.09932392510228266
M1	cpdb	0	network_modules	7	TRUE	0.005778378387391311	22	74	4	0.05405405405405406	0.18181818181818182	GO:0032107	GO:BP	regulation of response to nutrient levels	16175	7368		0.9473684210526315	0.9487179487179487	22	16153	4	70	18	16083	16175	0.09692959112777767
M1	cpdb	0	network_modules	7	TRUE	0.006900013966411548	139	74	7	0.0945945945945946	0.050359712230215826	GO:0046890	GO:BP	regulation of lipid biosynthetic process	16175	12425		0.9736842105263158	0.9743589743589743	139	16036	7	67	132	15969	16175	0.06316583422514975
M1	cpdb	0	network_modules	7	TRUE	0.008244847031894344	33	56	4	0.07142857142857142	0.12121212121212122	REAC:R-HSA-192105	REAC	Synthesis of bile acids and bile salts	10916	2401		1	1	33	10883	4	52	29	10831	10916	0.08947511730448582
M1	cpdb	0	network_modules	7	TRUE	0.0097908533756026	95	74	6	0.08108108108108109	0.06315789473684211	GO:0051147	GO:BP	regulation of muscle cell differentiation	16175	13530		1	1	95	16080	6	68	89	16012	16175	0.06672550953721039
M1	cpdb	0	network_modules	8	TRUE	3.425283144529124e-45	86	50	29	0.58	0.3372093023255814	KEGG:04610	KEGG	Complement and coagulation cascades	8484	320		NA	1	86	8398	29	21	57	8377	8484	0.43802850183390896
M1	cpdb	0	network_modules	8	TRUE	1.5605910356782817e-36	39	60	21	0.35	0.5384615384615384	REAC:R-HSA-140877	REAC	Formation of Fibrin Clot (Clotting Cascade)	10916	945		0	0.03225806451612903	39	10877	21	39	18	10838	10916	0.4316476982418276
M1	cpdb	0	network_modules	8	TRUE	6.651604760037874e-34	179	70	28	0.4	0.1564245810055866	GO:0007596	GO:BP	blood coagulation	16175	3055		0	0.018867924528301886	179	15996	28	42	151	15954	16175	0.24510723307056745
M1	cpdb	0	network_modules	8	TRUE	1.2870816093346245e-33	183	70	28	0.4	0.15300546448087432	GO:0050817	GO:BP	coagulation	16175	13279		0.019230769230769232	0.03773584905660377	183	15992	28	42	155	15950	16175	0.2422898272901919
M1	cpdb	0	network_modules	8	TRUE	1.779785939384324e-33	185	70	28	0.4	0.15135135135135136	GO:0007599	GO:BP	hemostasis	16175	3058		0.038461538461538464	0.05660377358490566	185	15990	28	42	157	15948	16175	0.24091500012344055
M1	cpdb	0	network_modules	8	TRUE	1.1026128559039121e-29	249	70	28	0.4	0.11244979919678715	GO:0050878	GO:BP	regulation of body fluid levels	16175	13323		0.057692307692307696	0.07547169811320754	249	15926	28	42	221	15884	16175	0.20595665396398805
M1	cpdb	0	network_modules	8	TRUE	2.1680335832553873e-27	339	70	29	0.4142857142857143	0.0855457227138643	GO:0042060	GO:BP	wound healing	16175	9947		0.07692307692307693	0.09433962264150944	339	15836	29	41	310	15795	16175	0.18102751946355333
M1	cpdb	0	network_modules	8	TRUE	4.530217353879526e-25	407	70	29	0.4142857142857143	0.07125307125307126	GO:0009611	GO:BP	response to wounding	16175	3539		0.09615384615384616	0.11320754716981132	407	15768	29	41	378	15727	16175	0.16380034509491165
M1	cpdb	0	network_modules	8	TRUE	5.584843962491071e-25	22	60	14	0.23333333333333334	0.6363636363636364	REAC:R-HSA-140875	REAC	Common Pathway of Fibrin Clot Formation	10916	388		0.03333333333333333	0.06451612903225806	22	10894	14	46	8	10848	10916	0.3834498134421029
M1	cpdb	0	network_modules	8	TRUE	7.099530653206709e-25	24	70	14	0.2	0.5833333333333334	GO:0042730	GO:BP	fibrinolysis	16175	10330		0.11538461538461539	0.1320754716981132	24	16151	14	56	10	16095	16175	0.34001934903602865
M1	cpdb	0	network_modules	8	TRUE	2.243660593106351e-22	57	70	16	0.22857142857142856	0.2807017543859649	GO:0030193	GO:BP	regulation of blood coagulation	16175	6704		0.1346153846153846	0.1509433962264151	57	16118	16	54	41	16064	16175	0.2503767972250313
M1	cpdb	0	network_modules	8	TRUE	2.715008355724681e-22	44	70	15	0.21428571428571427	0.3409090909090909	GO:0030195	GO:BP	negative regulation of blood coagulation	16175	6706		0.15384615384615385	0.18867924528301888	44	16131	15	55	29	16076	16175	0.2677939380792353
M1	cpdb	0	network_modules	8	TRUE	2.715008355724681e-22	44	70	15	0.21428571428571427	0.3409090909090909	GO:1900047	GO:BP	negative regulation of hemostasis	16175	20349		0.15384615384615385	0.18867924528301888	44	16131	15	55	29	16076	16175	0.2677939380792353
M1	cpdb	0	network_modules	8	TRUE	3.0232457629737004e-22	124	60	20	0.3333333333333333	0.16129032258064516	REAC:R-HSA-381426	REAC	Regulation of Insulin-like Growth Factor (IGF) transport and uptake by Insulin-like Growth Factor Binding Proteins (IGFBPs)	10916	1981		0.06666666666666667	0.0967741935483871	124	10792	20	40	104	10752	10916	0.2258723339569354
M1	cpdb	0	network_modules	8	TRUE	3.0886243702237245e-22	58	70	16	0.22857142857142856	0.27586206896551724	GO:1900046	GO:BP	regulation of hemostasis	16175	20348		0.19230769230769232	0.20754716981132076	58	16117	16	54	42	16063	16175	0.248148503325145
M1	cpdb	0	network_modules	8	TRUE	4.2245243268007293e-22	59	70	16	0.22857142857142856	0.2711864406779661	GO:0050818	GO:BP	regulation of coagulation	16175	13280		0.21153846153846154	0.22641509433962265	59	16116	16	54	43	16062	16175	0.2459765854651666
M1	cpdb	0	network_modules	8	TRUE	4.595800973146971e-22	23	60	13	0.21666666666666667	0.5652173913043478	REAC:R-HSA-140837	REAC	Intrinsic Pathway of Fibrin Clot Formation	10916	1269		0.1	0.12903225806451613	23	10893	13	47	10	10846	10916	0.3478681383789797
M1	cpdb	0	network_modules	8	TRUE	6.004528942747551e-22	46	70	15	0.21428571428571427	0.32608695652173914	GO:0050819	GO:BP	negative regulation of coagulation	16175	13281		0.23076923076923078	0.24528301886792453	46	16129	15	55	31	16074	16175	0.26177079687833876
M1	cpdb	0	network_modules	8	TRUE	1.3571320257199515e-19	63	70	15	0.21428571428571427	0.23809523809523808	GO:0061045	GO:BP	negative regulation of wound healing	16175	15161		0.25	0.2641509433962264	63	16112	15	55	48	16057	16175	0.2226869252992348
M1	cpdb	0	network_modules	8	TRUE	4.62590004689264e-18	78	70	15	0.21428571428571427	0.19230769230769232	GO:1903035	GO:BP	negative regulation of response to wounding	16175	22715		0.2692307692307692	0.2830188679245283	78	16097	15	55	63	16042	16175	0.19934320650934761
M1	cpdb	0	network_modules	8	TRUE	1.934288476155666e-17	24	70	11	0.15714285714285714	0.4583333333333333	GO:0031639	GO:BP	plasminogen activation	16175	7249		0.28846153846153844	0.3018867924528302	24	16151	11	59	13	16092	16175	0.2666134723088262
M1	cpdb	0	network_modules	8	TRUE	3.0991427355439447e-17	112	70	16	0.22857142857142856	0.14285714285714285	GO:0061041	GO:BP	regulation of wound healing	16175	15157		0.3076923076923077	0.32075471698113206	112	16063	16	54	96	16009	16175	0.17621901935153125
M1	cpdb	0	network_modules	8	TRUE	3.8906623037440955e-17	126	60	17	0.2833333333333333	0.1349206349206349	REAC:R-HSA-114608	REAC	Platelet degranulation 	10916	1764		0.13333333333333333	0.16129032258064516	126	10790	17	43	109	10747	10916	0.18916585260038987
M1	cpdb	0	network_modules	8	TRUE	4.141910114953327e-17	17	70	10	0.14285714285714285	0.5882352941176471	GO:0051917	GO:BP	regulation of fibrinolysis	16175	13993		0.3269230769230769	0.33962264150943394	17	16158	10	60	7	16098	16175	0.2885291606154982
M1	cpdb	0	network_modules	8	TRUE	7.74016347646791e-17	131	60	17	0.2833333333333333	0.1297709923664122	REAC:R-HSA-76005	REAC	Response to elevated platelet cytosolic Ca2+	10916	2090		0.16666666666666666	0.1935483870967742	131	10785	17	43	114	10742	10916	0.18525096947733333
M1	cpdb	0	network_modules	8	TRUE	1.0269264808927021e-16	54	70	13	0.18571428571428572	0.24074074074074073	GO:0031638	GO:BP	zymogen activation	16175	7248		0.34615384615384615	0.3584905660377358	54	16121	13	57	41	16064	16175	0.20844298640978373
M1	cpdb	0	network_modules	8	TRUE	4.814984732516036e-16	132	70	16	0.22857142857142856	0.12121212121212122	GO:1903034	GO:BP	regulation of response to wounding	16175	22714		0.36538461538461536	0.37735849056603776	132	16043	16	54	116	15989	16175	0.16151610577167735
M1	cpdb	0	network_modules	8	TRUE	6.455924267527037e-15	16	70	9	0.12857142857142856	0.5625	GO:0072376	GO:BP	protein activation cascade	16175	17373		0.38461538461538464	0.39622641509433965	16	16159	9	61	7	16098	16175	0.26756910269780415
M1	cpdb	0	network_modules	8	TRUE	1.0953249201013352e-14	16	60	9	0.15	0.5625	REAC:R-HSA-9651496	REAC	Defects of contact activation system (CAS) and kallikrein/kinin system (KKS)	10916	716		0.2	0.25806451612903225	16	10900	9	51	7	10849	10916	0.28864074463058625
M1	cpdb	0	network_modules	8	TRUE	1.0953249201013352e-14	16	60	9	0.15	0.5625	REAC:R-HSA-9671793	REAC	Diseases of hemostasis	10916	766		0.2	0.25806451612903225	16	10900	9	51	7	10849	10916	0.28864074463058625
M1	cpdb	0	network_modules	8	TRUE	2.750359905050236e-13	22	70	9	0.12857142857142856	0.4090909090909091	GO:0050820	GO:BP	positive regulation of coagulation	16175	13282		0.40384615384615385	0.4528301886792453	22	16153	9	61	13	16092	16175	0.2275625100317735
M1	cpdb	0	network_modules	8	TRUE	2.750359905050236e-13	22	70	9	0.12857142857142856	0.4090909090909091	GO:0030194	GO:BP	positive regulation of blood coagulation	16175	6705		0.40384615384615385	0.4528301886792453	22	16153	9	61	13	16092	16175	0.2275625100317735
M1	cpdb	0	network_modules	8	TRUE	2.750359905050236e-13	22	70	9	0.12857142857142856	0.4090909090909091	GO:1900048	GO:BP	positive regulation of hemostasis	16175	20350		0.40384615384615385	0.4528301886792453	22	16153	9	61	13	16092	16175	0.2275625100317735
M1	cpdb	0	network_modules	8	TRUE	3.5481864078885524e-13	198	70	16	0.22857142857142856	0.08080808080808081	GO:0016485	GO:BP	protein processing	16175	5233		0.46153846153846156	0.4716981132075472	198	15977	16	54	182	15923	16175	0.12970302833147584
M1	cpdb	0	network_modules	8	TRUE	4.820652366749641e-13	259	60	18	0.3	0.0694980694980695	REAC:R-HSA-76002	REAC	Platelet activation, signaling and aggregation	10916	1762		0.26666666666666666	0.2903225806451613	259	10657	18	42	241	10615	10916	0.13495092938269945
M1	cpdb	0	network_modules	8	TRUE	9.46846953351655e-13	15	70	8	0.11428571428571428	0.5333333333333333	GO:0072378	GO:BP	blood coagulation, fibrin clot formation	16175	17375		0.4807692307692308	0.49056603773584906	15	16160	8	62	7	16098	16175	0.24552752198231093
M1	cpdb	0	network_modules	8	TRUE	5.044528470057508e-12	10	60	7	0.11666666666666667	0.7	REAC:R-HSA-159740	REAC	Gamma-carboxylation of protein precursors	10916	1031		0.3	0.3225806451612903	10	10906	7	53	3	10853	10916	0.2844426163777882
M1	cpdb	0	network_modules	8	TRUE	1.381347801667558e-11	11	60	7	0.11666666666666667	0.6363636363636364	REAC:R-HSA-159854	REAC	Gamma-carboxylation, transport, and amino-terminal cleavage of proteins	10916	1032		0.3333333333333333	0.3548387096774194	11	10905	7	53	4	10852	10916	0.27100317781349825
M1	cpdb	0	network_modules	8	TRUE	1.621630143344485e-11	483	70	20	0.2857142857142857	0.041407867494824016	GO:0051604	GO:BP	protein maturation	16175	13821		0.5	0.5094339622641509	483	15692	20	50	463	15642	16175	0.0991040502940335
M1	cpdb	0	network_modules	8	TRUE	3.011182701828491e-11	12	70	7	0.1	0.5833333333333334	GO:0051918	GO:BP	negative regulation of fibrinolysis	16175	13994		0.5192307692307693	0.5283018867924528	12	16163	7	63	5	16100	16175	0.24034071887524208
M1	cpdb	0	network_modules	8	TRUE	3.831596762107395e-11	319	70	17	0.24285714285714285	0.05329153605015674	GO:0032102	GO:BP	negative regulation of response to external stimulus	16175	7366		0.5384615384615384	0.5471698113207547	319	15856	17	53	302	15803	16175	0.10580085151080502
M1	cpdb	0	network_modules	8	TRUE	1.5975240622636314e-10	107	60	12	0.2	0.11214953271028037	REAC:R-HSA-8957275	REAC	Post-translational protein phosphorylation	10916	1777		0.36666666666666664	0.3870967741935484	107	10809	12	48	95	10761	10916	0.14352423718132395
M1	cpdb	0	network_modules	8	TRUE	7.134457414731475e-10	9	60	6	0.1	0.6666666666666666	REAC:R-HSA-159763	REAC	Transport of gamma-carboxylated protein precursors from the endoplasmic reticulum to the Golgi apparatus	10916	2594		0.4	0.41935483870967744	9	10907	6	54	3	10853	10916	0.2568826775473982
M1	cpdb	0	network_modules	8	TRUE	1.7760475609777763e-9	10	60	6	0.1	0.6	REAC:R-HSA-159782	REAC	Removal of aminoterminal propeptides from gamma-carboxylated proteins	10916	2057		0.43333333333333335	0.45161290322580644	10	10906	6	54	4	10852	10916	0.24348636142633018
M1	cpdb	0	network_modules	8	TRUE	2.636964281379166e-9	54	70	9	0.12857142857142856	0.16666666666666666	GO:0090303	GO:BP	positive regulation of wound healing	16175	18186		0.5576923076923077	0.5660377358490566	54	16121	9	61	45	16060	16175	0.14313263400070358
M1	cpdb	0	network_modules	8	TRUE	6.125654570564915e-9	59	70	9	0.12857142857142856	0.15254237288135594	GO:1903036	GO:BP	positive regulation of response to wounding	16175	22716		0.5769230769230769	0.5849056603773585	59	16116	9	61	50	16055	16175	0.13661663380500447
M1	cpdb	0	network_modules	8	TRUE	1.432892398189835e-8	13	60	6	0.1	0.46153846153846156	REAC:R-HSA-75205	REAC	Dissolution of Fibrin Clot	10916	780		0.4666666666666667	0.4838709677419355	13	10903	6	54	7	10849	10916	0.21298864057532133
M1	cpdb	0	network_modules	8	TRUE	2.1143704656578185e-7	9	60	5	0.08333333333333333	0.5555555555555556	REAC:R-HSA-9668250	REAC	Defective factor IX causes hemophilia B	10916	692		0.5	0.5161290322580645	9	10907	5	55	4	10852	10916	0.2137129733151887
M1	cpdb	0	network_modules	8	TRUE	3.611221918207777e-7	20	70	6	0.08571428571428572	0.3	GO:0043567	GO:BP	regulation of insulin-like growth factor receptor signaling pathway	16175	10772		0.5961538461538461	0.6037735849056604	20	16155	6	64	14	16091	16175	0.1584846155827268
M1	cpdb	0	network_modules	8	TRUE	4.2434361585096703e-7	60	60	8	0.13333333333333333	0.13333333333333333	REAC:R-HSA-163841	REAC	Gamma carboxylation, hypusinylation, hydroxylation, and arylsulfatase activation	10916	1030		0.5333333333333333	0.5483870967741935	60	10856	8	52	52	10804	10916	0.12854335544092357
M1	cpdb	0	network_modules	8	TRUE	5.955538534197833e-7	4	70	4	0.05714285714285714	1	GO:0051919	GO:BP	positive regulation of fibrinolysis	16175	13995		0.6153846153846154	0.6226415094339622	4	16171	4	66	0	16105	16175	0.23855740486173577
M1	cpdb	0	network_modules	8	TRUE	1.6558552358791785e-6	5	60	4	0.06666666666666667	0.8	REAC:R-HSA-140834	REAC	Extrinsic Pathway of Fibrin Clot Formation	10916	890		0.5666666666666667	0.5806451612903226	5	10911	4	56	1	10855	10916	0.2300390223331733
M1	cpdb	0	network_modules	8	TRUE	5.347336970839726e-6	30	70	6	0.08571428571428572	0.2	GO:0048009	GO:BP	insulin-like growth factor receptor signaling pathway	16175	12465		0.6346153846153846	0.6415094339622641	30	16145	6	64	24	16081	16175	0.12849491234274157
M1	cpdb	0	network_modules	8	TRUE	1.1496020352613632e-5	7	60	4	0.06666666666666667	0.5714285714285714	REAC:R-HSA-9662001	REAC	Defective factor VIII causes hemophilia A	10916	694		0.6	0.6129032258064516	7	10909	4	56	3	10853	10916	0.19389822135400617
M1	cpdb	0	network_modules	8	TRUE	1.4447594615962338e-5	17	70	5	0.07142857142857142	0.29411764705882354	GO:0010755	GO:BP	regulation of plasminogen activation	16175	4376		0.6538461538461539	0.660377358490566	17	16158	5	65	12	16093	16175	0.14319535478105366
M1	cpdb	0	network_modules	8	TRUE	3.900787536527694e-5	41	70	6	0.08571428571428572	0.14634146341463414	GO:0014909	GO:BP	smooth muscle cell migration	16175	4782		0.6730769230769231	0.6792452830188679	41	16134	6	64	35	16070	16175	0.10906021433297389
M1	cpdb	0	network_modules	8	TRUE	6.031022988741446e-5	795	70	17	0.24285714285714285	0.021383647798742137	GO:0051241	GO:BP	negative regulation of multicellular organismal process	16175	13591		0.6923076923076923	0.6981132075471698	795	15380	17	53	778	15327	16175	0.05907408742480412
M1	cpdb	0	network_modules	8	TRUE	6.366611630297773e-5	3	60	3	0.05	1	REAC:R-HSA-9673202	REAC	Defective F9 variant does not activate FX	10916	548		0.6333333333333333	0.7741935483870968	3	10913	3	57	0	10856	10916	0.22302206971743874
M1	cpdb	0	network_modules	8	TRUE	6.366611630297773e-5	3	60	3	0.05	1	REAC:R-HSA-9657689	REAC	Defective SERPING1 causes hereditary angioedema	10916	614		0.6333333333333333	0.7741935483870968	3	10913	3	57	0	10856	10916	0.22302206971743874
M1	cpdb	0	network_modules	8	TRUE	6.366611630297773e-5	3	60	3	0.05	1	REAC:R-HSA-9672396	REAC	Defective cofactor function of FVIIIa variant	10916	691		0.6333333333333333	0.7741935483870968	3	10913	3	57	0	10856	10916	0.22302206971743874
M1	cpdb	0	network_modules	8	TRUE	6.366611630297773e-5	3	60	3	0.05	1	REAC:R-HSA-9672383	REAC	Defective factor IX causes thrombophilia	10916	693		0.6333333333333333	0.7741935483870968	3	10913	3	57	0	10856	10916	0.22302206971743874
M1	cpdb	0	network_modules	8	TRUE	6.366611630297773e-5	3	60	3	0.05	1	REAC:R-HSA-9657688	REAC	Defective factor XII causes hereditary angioedema	10916	695		0.6333333333333333	0.7741935483870968	3	10913	3	57	0	10856	10916	0.22302206971743874
M1	cpdb	0	network_modules	8	TRUE	9.127354125985908e-5	47	70	6	0.08571428571428572	0.1276595744680851	GO:0070613	GO:BP	regulation of protein processing	16175	16212		0.7115384615384616	0.71698113207547165	47	16128	6	64	41	16064	16175	0.10142593681659857
M1	cpdb	0	network_modules	8	TRUE	1.1806326352646952e-4	49	70	6	0.08571428571428572	0.12244897959183673	GO:1903317	GO:BP	regulation of protein maturation	16175	22901		0.7307692307692307	0.7358490566037735	49	16126	6	64	43	16062	16175	0.09919228263546202
M1	cpdb	0	network_modules	8	TRUE	1.3370797470201804e-4	50	70	6	0.08571428571428572	0.12	GO:0014812	GO:BP	muscle cell migration	16175	4692		0.75	0.7547169811320755	50	16125	6	64	44	16061	16175	0.09812497145822953
M1	cpdb	0	network_modules	8	TRUE	1.4375070026126472e-4	3	70	3	0.04285714285714286	1	GO:0002541	GO:BP	activation of plasma proteins involved in acute inflammatory response	16175	1062		0.7692307692307693	0.7735849056603774	3	16172	3	67	0	16105	16175	0.2065903852887041
M1	cpdb	0	network_modules	8	TRUE	2.9752136945663323e-4	781	70	16	0.22857142857142856	0.020486555697823303	GO:0030334	GO:BP	regulation of cell migration	16175	6780		0.7884615384615384	0.7924528301886793	781	15394	16	54	765	15340	16175	0.05544676248430222
M1	cpdb	0	network_modules	8	TRUE	3.1945809580714065e-4	14	60	4	0.06666666666666667	0.2857142857142857	REAC:R-HSA-354194	REAC	GRB2:SOS provides linkage to MAPK signaling for Integrins 	10916	1024		0.8	0.8064516129032258	14	10902	4	56	10	10846	10916	0.13581870372401986
M1	cpdb	0	network_modules	8	TRUE	4.3383791195037585e-4	15	60	4	0.06666666666666667	0.26666666666666666	REAC:R-HSA-372708	REAC	p130Cas linkage to MAPK signaling for integrins	10916	2715		0.8333333333333334	0.8387096774193549	15	10901	4	56	11	10845	10916	0.13103550265688574
M1	cpdb	0	network_modules	8	TRUE	4.441325011880496e-4	510	70	13	0.18571428571428572	0.025490196078431372	GO:0007169	GO:BP	cell surface receptor protein tyrosine kinase signaling pathway	16175	2733		0.8076923076923077	0.8113207547169812	510	15665	13	57	497	15608	16175	0.0581704439734021
M1	cpdb	0	network_modules	8	TRUE	4.905690047087899e-4	101	60	7	0.11666666666666667	0.06930693069306931	REAC:R-HSA-977606	REAC	Regulation of Complement cascade	10916	1971		0.8666666666666667	0.8709677419354839	101	10815	7	53	94	10762	10916	0.083404975088106
M1	cpdb	0	network_modules	8	TRUE	7.135586856075203e-4	35	70	5	0.07142857142857142	0.14285714285714285	GO:0014910	GO:BP	regulation of smooth muscle cell migration	16175	4783		0.8269230769230769	0.8301886792452831	35	16140	5	65	30	16075	16175	0.09827416340510284
M1	cpdb	0	network_modules	8	TRUE	7.455708710157336e-4	38	60	5	0.08333333333333333	0.13157894736842105	REAC:R-HSA-76009	REAC	Platelet Aggregation (Plug Formation)	10916	1761		0.9	0.9032258064516129	38	10878	5	55	33	10823	10916	0.10079171172559342
M1	cpdb	0	network_modules	8	TRUE	9.232576791738335e-4	224	70	9	0.12857142857142856	0.04017857142857143	GO:0006959	GO:BP	humoral immune response	16175	2590		0.8461538461538461	0.8490566037735849	224	15951	9	61	215	15890	16175	0.06472097974406199
M1	cpdb	0	network_modules	8	TRUE	9.282722534935591e-4	111	60	7	0.11666666666666667	0.06306306306306306	REAC:R-HSA-166658	REAC	Complement cascade	10916	390		0.9333333333333333	0.9354838709677419	111	10805	7	53	104	10752	10916	0.07891730523897728
M1	cpdb	0	network_modules	8	TRUE	0.0012584195429124017	6	60	3	0.05	0.5	REAC:R-HSA-6806942	REAC	MET Receptor Activation	10916	1360		0.9666666666666667	0.967741935483871	6	10910	3	57	3	10853	10916	0.1568503844798911
M1	cpdb	0	network_modules	8	TRUE	0.0031745560031963675	192	70	8	0.11428571428571428	0.041666666666666664	GO:0007160	GO:BP	cell-matrix adhesion	16175	2724		0.8653846153846154	0.8679245283018868	192	15983	8	62	184	15921	16175	0.06234463088525287
M1	cpdb	0	network_modules	8	TRUE	0.004541642734577072	26	60	4	0.06666666666666667	0.15384615384615385	REAC:R-HSA-354192	REAC	Integrin signaling	10916	1217		1	1	26	10890	4	56	22	10834	10916	0.09804200871441116
M1	cpdb	0	network_modules	8	TRUE	0.004969046937055777	7	70	3	0.04285714285714286	0.42857142857142855	GO:0010757	GO:BP	negative regulation of plasminogen activation	16175	4378		0.8846153846153846	0.8867924528301887	7	16168	3	67	4	16101	16175	0.13447799959111062
M1	cpdb	0	network_modules	8	TRUE	0.005701391246876823	279	70	9	0.12857142857142856	0.03225806451612903	GO:0031589	GO:BP	cell-substrate adhesion	16175	7233		0.9038461538461539	0.9056603773584906	279	15896	9	61	270	15835	16175	0.05637028224446477
M1	cpdb	0	network_modules	8	TRUE	0.005927987733457478	24	70	4	0.05714285714285714	0.16666666666666666	GO:1902042	GO:BP	negative regulation of extrinsic apoptotic signaling pathway via death domain receptors	16175	21965		0.9230769230769231	0.9245283018867925	24	16151	4	66	20	16085	16175	0.09533309327868722
M1	cpdb	0	network_modules	8	TRUE	0.006243418096434896	450	70	11	0.15714285714285714	0.024444444444444446	GO:0030335	GO:BP	positive regulation of cell migration	16175	6781		0.9423076923076923	0.9433962264150944	450	15725	11	59	439	15666	16175	0.051842300389984566
M1	cpdb	0	network_modules	8	TRUE	0.007034125722155395	25	70	4	0.05714285714285714	0.16	GO:2000352	GO:BP	negative regulation of endothelial cell apoptotic process	16175	25671		0.9615384615384616	0.9622641509433962	25	16150	4	66	21	16084	16175	0.09330610966452312
M1	cpdb	0	network_modules	8	TRUE	0.007925786883280947	8	70	3	0.04285714285714286	0.375	GO:0007597	GO:BP	blood coagulation, intrinsic pathway	16175	3056		0.9807692307692307	0.9811320754716981	8	16167	3	67	5	16100	16175	0.12561322086847246
M1	cpdb	0	network_modules	8	TRUE	0.009461133648571835	470	70	11	0.15714285714285714	0.023404255319148935	GO:2000147	GO:BP	positive regulation of cell motility	16175	25495		1	1	470	15705	11	59	459	15646	16175	0.05027424881727181
M1	cpdb	0	network_modules	9	TRUE	4.23618959473239e-57	590	70	52	0.7428571428571429	0.08813559322033898	GO:0016567	GO:BP	protein ubiquitination	16175	5254		0	0.043478260869565216	590	15585	52	18	538	15567	16175	0.24841201983516367
M1	cpdb	0	network_modules	9	TRUE	3.009587310101674e-54	667	70	52	0.7428571428571429	0.07796101949025487	GO:0032446	GO:BP	protein modification by small protein conjugation	16175	7568		0.045454545454545456	0.08695652173913043	667	15508	52	18	615	15490	16175	0.2326347052034278
M1	cpdb	0	network_modules	9	TRUE	1.431417195248697e-51	749	70	52	0.7428571428571429	0.06942590120160214	GO:0070647	GO:BP	protein modification by small protein conjugation or removal	16175	16231		0.09090909090909091	0.13043478260869565	749	15426	52	18	697	15408	16175	0.21852360887182834
M1	cpdb	0	network_modules	9	TRUE	4.091617871858545e-50	798	70	52	0.7428571428571429	0.06516290726817042	GO:0043687	GO:BP	post-translational protein modification	16175	10838		0.13636363636363635	0.17391304347826086	798	15377	52	18	746	15359	16175	0.21112311107013262
M1	cpdb	0	network_modules	9	TRUE	3.4625187862877775e-42	248	70	35	0.5	0.14112903225806453	GO:0000209	GO:BP	protein polyubiquitination	16175	59		0.18181818181818182	0.21739130434782608	248	15927	35	35	213	15892	16175	0.2600543899403774
M1	cpdb	0	network_modules	9	TRUE	4.768937352905173e-29	308	53	29	0.5471698113207547	0.09415584415584416	REAC:R-HSA-983168	REAC	Antigen processing: Ubiquitination & Proteasome degradation	10916	154		0	0.14285714285714285	308	10608	29	24	279	10584	10916	0.21890899797522992
M1	cpdb	0	network_modules	9	TRUE	2.347152151522382e-26	380	53	29	0.5471698113207547	0.07631578947368421	REAC:R-HSA-983169	REAC	Class I MHC mediated antigen processing & presentation	10916	368		0.16666666666666666	0.2857142857142857	380	10536	29	24	351	10512	10916	0.19524092635438764
M1	cpdb	0	network_modules	9	TRUE	2.1967324123273317e-21	547	70	29	0.4142857142857143	0.05301645338208409	GO:0006511	GO:BP	ubiquitin-dependent protein catabolic process	16175	2235		0.22727272727272727	0.2608695652173913	547	15628	29	41	518	15587	16175	0.1387668799456729
M1	cpdb	0	network_modules	9	TRUE	3.3162976984563723e-21	555	70	29	0.4142857142857143	0.05225225225225225	GO:0019941	GO:BP	modification-dependent protein catabolic process	16175	6072		0.2727272727272727	0.30434782608695654	555	15620	29	41	526	15579	16175	0.1376192708035809
M1	cpdb	0	network_modules	9	TRUE	4.06491485792403e-21	559	70	29	0.4142857142857143	0.0518783542039356	GO:0043632	GO:BP	modification-dependent macromolecule catabolic process	16175	10812		0.3181818181818182	0.34782608695652173	559	15616	29	41	530	15575	16175	0.13705431521522052
M1	cpdb	0	network_modules	9	TRUE	1.3297438412871002e-20	140	33	17	0.5151515151515151	0.12142857142857143	KEGG:04120	KEGG	Ubiquitin mediated proteolysis	8484	270		0	0.3333333333333333	140	8344	17	16	123	8328	8484	0.2445953064981432
M1	cpdb	0	network_modules	9	TRUE	4.2618634040422507e-20	673	70	30	0.42857142857142855	0.04457652303120357	GO:0051603	GO:BP	proteolysis involved in protein catabolic process	16175	13820		0.36363636363636365	0.391304347826087	673	15502	30	40	643	15462	16175	0.1277562398120854
M1	cpdb	0	network_modules	9	TRUE	7.795991340875137e-20	79	70	16	0.22857142857142856	0.20253164556962025	GO:0070936	GO:BP	protein K48-linked ubiquitination	16175	16380		0.4090909090909091	0.43478260869565216	79	16096	16	54	63	16042	16175	0.21153480693250154
M1	cpdb	0	network_modules	9	TRUE	1.0802077248259587e-14	78	53	13	0.24528301886792453	0.16666666666666666	REAC:R-HSA-8852135	REAC	Protein ubiquitination	10916	1818		0.3333333333333333	0.42857142857142855	78	10838	13	40	65	10798	10916	0.19748429695580286
M1	cpdb	0	network_modules	9	TRUE	2.7517634466760153e-10	64	70	10	0.14285714285714285	0.15625	GO:0070534	GO:BP	protein K63-linked ubiquitination	16175	16168		0.45454545454545453	0.4782608695652174	64	16111	10	60	54	16051	16175	0.14586975931996854
M1	cpdb	0	network_modules	9	TRUE	3.475905242524405e-10	30	53	8	0.1509433962264151	0.26666666666666666	REAC:R-HSA-8866652	REAC	Synthesis of active ubiquitin: roles of E1 and E2 enzymes	10916	2400		0.5	0.5714285714285714	30	10886	8	45	22	10841	10916	0.1977268882432294
M1	cpdb	0	network_modules	9	TRUE	1.6836410938453694e-9	470	70	18	0.2571428571428571	0.03829787234042553	GO:0010498	GO:BP	proteasomal protein catabolic process	16175	4177		0.5	0.5217391304347826	470	15705	18	52	452	15653	16175	0.08952473543913426
M1	cpdb	0	network_modules	9	TRUE	4.549933585081428e-9	363	70	16	0.22857142857142856	0.0440771349862259	GO:0043161	GO:BP	proteasome-mediated ubiquitin-dependent protein catabolic process	16175	10561		0.5454545454545454	0.5652173913043478	363	15812	16	54	347	15758	16175	0.09175001502999829
M1	cpdb	0	network_modules	9	TRUE	3.8020271059860486e-6	58	53	7	0.1320754716981132	0.1206896551724138	REAC:R-HSA-8866654	REAC	E3 ubiquitin ligases ubiquitinate target proteins	10916	811		0.6666666666666666	0.7142857142857143	58	10858	7	46	51	10812	10916	0.12179440052143635
M1	cpdb	0	network_modules	9	TRUE	9.057975086053079e-5	91	53	7	0.1320754716981132	0.07692307692307693	REAC:R-HSA-877300	REAC	Interferon gamma signaling	10916	1229		0.8333333333333334	0.8571428571428571	91	10825	7	46	84	10779	10916	0.09506022167741157
M1	cpdb	0	network_modules	9	TRUE	1.1161388944844224e-4	124	70	8	0.11428571428571428	0.06451612903225806	GO:0051092	GO:BP	positive regulation of NF-kappaB transcription factor activity	16175	13487		0.5909090909090909	0.6086956521739131	124	16051	8	62	116	15989	16175	0.08059126119670616
M1	cpdb	0	network_modules	9	TRUE	4.616521653333551e-4	345	70	11	0.15714285714285714	0.03188405797101449	GO:0051090	GO:BP	regulation of DNA-binding transcription factor activity	16175	13485		0.6363636363636364	0.6521739130434783	345	15830	11	59	334	15771	16175	0.06197354597676876
M1	cpdb	0	network_modules	9	TRUE	4.941734393463796e-4	208	70	9	0.12857142857142856	0.04326923076923077	GO:0051091	GO:BP	positive regulation of DNA-binding transcription factor activity	16175	13486		0.6818181818181818	0.6956521739130435	208	15967	9	61	199	15906	16175	0.06770929727553114
M1	cpdb	0	network_modules	9	TRUE	0.0011590248608684536	168	70	8	0.11428571428571428	0.047619047619047616	GO:0031396	GO:BP	regulation of protein ubiquitination	16175	7152		0.7272727272727273	0.7391304347826086	168	16007	8	62	160	15945	16175	0.06756410340338012
M1	cpdb	0	network_modules	9	TRUE	0.0024665704292050426	252	70	9	0.12857142857142856	0.03571428571428571	GO:0043122	GO:BP	regulation of canonical NF-kappaB signal transduction	16175	10541		0.7727272727272727	0.782608695652174	252	15923	9	61	243	15862	16175	0.06015161206515153
M1	cpdb	0	network_modules	9	TRUE	0.0027359282491605966	246	33	7	0.21212121212121213	0.028455284552845527	KEGG:05131	KEGG	Shigellosis	8484	428		0.5	0.6666666666666666	246	8238	7	26	239	8212	8484	0.06819834715489086
M1	cpdb	0	network_modules	9	TRUE	0.0031745560031963675	192	70	8	0.11428571428571428	0.041666666666666664	GO:0043123	GO:BP	positive regulation of canonical NF-kappaB signal transduction	16175	10542		0.8181818181818182	0.8260869565217391	192	15983	8	62	184	15921	16175	0.06234463088525287
M1	cpdb	0	network_modules	9	TRUE	0.0037906314161756773	721	70	14	0.2	0.019417475728155338	GO:0045087	GO:BP	innate immune response	16175	11270		0.8636363636363636	0.8695652173913043	721	15454	14	56	707	15398	16175	0.04965303990904218
M1	cpdb	0	network_modules	9	TRUE	0.0053681650382979935	206	70	8	0.11428571428571428	0.038834951456310676	GO:1903320	GO:BP	regulation of protein modification by small protein conjugation or removal	16175	22904		0.9090909090909091	0.9130434782608695	206	15969	8	62	198	15907	16175	0.05970633991175044
M1	cpdb	0	network_modules	9	TRUE	0.005870630852102296	280	70	9	0.12857142857142856	0.03214285714285714	GO:0007249	GO:BP	canonical NF-kappaB signal transduction	16175	2783		0.9545454545454546	0.9565217391304348	280	15895	9	61	271	15834	16175	0.056240050327180685
M1	cpdb	0	network_modules	9	TRUE	0.0059768057044433725	209	70	8	0.11428571428571428	0.03827751196172249	GO:1901873	GO:BP	regulation of post-translational protein modification	16175	21817		1	1	209	15966	8	62	201	15904	16175	0.059173572731846584
M1	cpdb	0	network_modules	9	TRUE	0.006122741783976168	60	33	4	0.12121212121212122	0.06666666666666667	KEGG:04330	KEGG	Notch signaling pathway	8484	301		1	1	60	8424	4	29	56	8395	8484	0.08511509484319503
M1	cpdb	0	network_modules	9	TRUE	0.006286374419089399	11	53	3	0.05660377358490566	0.2727272727272727	REAC:R-HSA-9683610	REAC	Maturation of nucleoprotein	10916	1397		1	1	11	10905	3	50	8	10855	10916	0.12239440167920843
M1	cpdb	0	network_modules	10	TRUE	2.061222001285243e-6	8	35	4	0.11428571428571428	0.5	REAC:R-HSA-68952	REAC	DNA replication initiation	10916	448		0	0.06666666666666667	8	10908	4	31	4	10877	10916	0.23798172379846555
M1	cpdb	0	network_modules	10	TRUE	1.1366452700606906e-5	791	71	18	0.2535211267605634	0.022756005056890013	GO:0000122	GO:BP	negative regulation of transcription by RNA polymerase II	16175	48		NA	1	791	15384	18	53	773	15331	16175	0.06299826666780771
M1	cpdb	0	network_modules	10	TRUE	5.82474862501789e-5	41	35	5	0.14285714285714285	0.12195121951219512	REAC:R-HSA-5696400	REAC	Dual Incision in GG-NER	10916	807		0.07142857142857142	0.13333333333333333	41	10875	5	30	36	10845	10916	0.1289696207929954
M1	cpdb	0	network_modules	10	TRUE	9.989969591964635e-5	36	21	4	0.19047619047619047	0.1111111111111111	KEGG:03030	KEGG	DNA replication	8484	214		0	0.25	36	8448	4	17	32	8431	8484	0.14271721456051828
M1	cpdb	0	network_modules	10	TRUE	1.7109892882314376e-4	21	35	4	0.11428571428571428	0.19047619047619047	REAC:R-HSA-5651801	REAC	PCNA-Dependent Long Patch Base Excision Repair	10916	1658		0.14285714285714285	0.2	21	10895	4	31	17	10864	10916	0.14543169975716894
M1	cpdb	0	network_modules	10	TRUE	2.2728585852394183e-4	44	21	4	0.19047619047619047	0.09090909090909091	KEGG:03410	KEGG	Base excision repair	8484	237		0.3333333333333333	0.5	44	8440	4	17	40	8423	8484	0.12849980158440072
M1	cpdb	0	network_modules	10	TRUE	3.5836240532295715e-4	25	35	4	0.11428571428571428	0.16	REAC:R-HSA-5696397	REAC	Gap-filling DNA repair synthesis and ligation in GG-NER	10916	1037		0.21428571428571427	0.3333333333333333	25	10891	4	31	21	10860	10916	0.13288006327434482
M1	cpdb	0	network_modules	10	TRUE	3.5836240532295715e-4	25	35	4	0.11428571428571428	0.16	REAC:R-HSA-110373	REAC	Resolution of AP sites via the multiple-nucleotide patch replacement pathway	10916	2073		0.21428571428571427	0.3333333333333333	25	10891	4	31	21	10860	10916	0.13288006327434482
M1	cpdb	0	network_modules	10	TRUE	4.8365586206650313e-4	114	35	6	0.17142857142857143	0.05263157894736842	REAC:R-HSA-9758941	REAC	Gastrulation	10916	1040		0.35714285714285715	0.4	114	10802	6	29	108	10773	10916	0.08981410457396441
M1	cpdb	0	network_modules	10	TRUE	7.675791104327834e-4	30	35	4	0.11428571428571428	0.13333333333333333	REAC:R-HSA-110314	REAC	Recognition of DNA damage by PCNA-containing replication complex	10916	1948		0.42857142857142855	0.4666666666666667	30	10886	4	31	26	10855	10916	0.12083398040632218
M1	cpdb	0	network_modules	10	TRUE	8.501816659318926e-4	61	21	4	0.19047619047619047	0.06557377049180328	KEGG:03420	KEGG	Nucleotide excision repair	8484	238		0.6666666666666666	0.75	61	8423	4	17	57	8406	8484	0.10806363011643282
M1	cpdb	0	network_modules	10	TRUE	0.001002623162808436	32	35	4	0.11428571428571428	0.125	REAC:R-HSA-5656169	REAC	Termination of translesion DNA synthesis	10916	2492		0.5	0.5333333333333333	32	10884	4	31	28	10853	10916	0.1168155443109671
M1	cpdb	0	network_modules	10	TRUE	0.001138324441631362	33	35	4	0.11428571428571428	0.12121212121212122	REAC:R-HSA-68962	REAC	Activation of the pre-replicative complex	10916	107		0.5714285714285714	0.6	33	10883	4	31	29	10852	10916	0.11494264236309804
M1	cpdb	0	network_modules	10	TRUE	0.0016274957947003143	36	35	4	0.11428571428571428	0.1111111111111111	REAC:R-HSA-73933	REAC	Resolution of Abasic Sites (AP sites)	10916	2075		0.6428571428571429	0.6666666666666666	36	10880	4	31	32	10849	10916	0.10979250664138708
M1	cpdb	0	network_modules	10	TRUE	0.002108464463094026	26	21	3	0.14285714285714285	0.11538461538461539	KEGG:04950	KEGG	Maturity onset diabetes of the young	8484	395		1	1	26	8458	3	18	23	8440	8484	0.1259829146245698
M1	cpdb	0	network_modules	10	TRUE	0.002174020494057335	84	35	5	0.14285714285714285	0.05952380952380952	REAC:R-HSA-5696399	REAC	Global Genome Nucleotide Excision Repair (GG-NER)	10916	1047		0.7142857142857143	0.7333333333333333	84	10832	5	30	79	10802	10916	0.08772509305482905
M1	cpdb	0	network_modules	10	TRUE	0.0021857134918956563	12	35	3	0.08571428571428572	0.25	REAC:R-HSA-2892247	REAC	POU5F1 (OCT4), SOX2, NANOG activate genes related to proliferation	10916	1697		0.7857142857142857	0.8	12	10904	3	32	9	10872	10916	0.1448194406305537
M1	cpdb	0	network_modules	10	TRUE	0.0022570769507828095	39	35	4	0.11428571428571428	0.10256410256410256	REAC:R-HSA-110313	REAC	Translesion synthesis by Y family DNA polymerases bypasses lesions on DNA template	10916	2577		0.8571428571428571	0.8666666666666667	39	10877	4	31	35	10846	10916	0.1052385377604579
M1	cpdb	0	network_modules	10	TRUE	0.005231387654810517	48	35	4	0.11428571428571428	0.08333333333333333	REAC:R-HSA-73893	REAC	DNA Damage Bypass	10916	438		0.9285714285714286	0.9333333333333333	48	10868	4	31	44	10837	10916	0.09419328700614985
M1	cpdb	0	network_modules	10	TRUE	0.007768127808974689	109	35	5	0.14285714285714285	0.045871559633027525	REAC:R-HSA-5696398	REAC	Nucleotide Excision Repair	10916	1622		1	1	109	10807	5	30	104	10777	10916	0.07579318168605044
M1	cpdb	0	network_modules	11	TRUE	2.9352877209716643e-54	165	55	39	0.7090909090909091	0.23636363636363636	KEGG:04140	KEGG	Autophagy - animal	8484	277		0	0.1111111111111111	165	8319	39	16	126	8303	8484	0.4034042630773239
M1	cpdb	0	network_modules	11	TRUE	2.4360641878112967e-46	491	70	44	0.6285714285714286	0.08961303462321792	GO:0006914	GO:BP	autophagy	16175	2563		0	0.05555555555555555	491	15684	44	26	447	15658	16175	0.22988030472277232
M1	cpdb	0	network_modules	11	TRUE	2.4360641878112967e-46	491	70	44	0.6285714285714286	0.08961303462321792	GO:0061919	GO:BP	process utilizing autophagic mechanism	16175	15723		0	0.05555555555555555	491	15684	44	26	447	15658	16175	0.22988030472277232
M1	cpdb	0	network_modules	11	TRUE	4.450852876884079e-44	309	70	38	0.5428571428571428	0.12297734627831715	GO:0016236	GO:BP	macroautophagy	16175	5179		0.05714285714285714	0.08333333333333333	309	15866	38	32	271	15834	16175	0.25224757000804243
M1	cpdb	0	network_modules	11	TRUE	3.3954950196014527e-41	104	70	28	0.4	0.2692307692307692	GO:0000045	GO:BP	autophagosome assembly	16175	17		0.08571428571428572	0.1111111111111111	104	16071	28	42	76	16029	16175	0.32463636698820353
M1	cpdb	0	network_modules	11	TRUE	1.1389791844095326e-40	108	70	28	0.4	0.25925925925925924	GO:1905037	GO:BP	autophagosome organization	16175	24312		0.11428571428571428	0.1388888888888889	108	16067	28	42	80	16025	16175	0.31840732165373353
M1	cpdb	0	network_modules	11	TRUE	5.662280522161088e-36	202	70	30	0.42857142857142855	0.1485148514851485	GO:0007033	GO:BP	vacuole organization	16175	2638		0.14285714285714285	0.16666666666666666	202	15973	30	40	172	15933	16175	0.24701538740104237
M1	cpdb	0	network_modules	11	TRUE	5.951886866859238e-36	32	55	20	0.36363636363636365	0.625	KEGG:04136	KEGG	Autophagy - other	8484	273		0.125	0.2222222222222222	32	8452	20	35	12	8417	8484	0.47421831228010863
M1	cpdb	0	network_modules	11	TRUE	7.852774234541235e-30	134	47	23	0.48936170212765956	0.17164179104477612	REAC:R-HSA-1632852	REAC	Macroautophagy	10916	1388		0	0.1111111111111111	134	10782	23	24	111	10758	10916	0.2849130891626066
M1	cpdb	0	network_modules	11	TRUE	1.0802310343630883e-28	149	47	23	0.48936170212765956	0.15436241610738255	REAC:R-HSA-9612973	REAC	Autophagy	10916	193		0.125	0.2222222222222222	149	10767	23	24	126	10743	10916	0.2696008704503798
M1	cpdb	0	network_modules	11	TRUE	1.4545212093369016e-21	19	70	12	0.17142857142857143	0.631578947368421	GO:0044804	GO:BP	nucleophagy	16175	11165		0.17142857142857143	0.19444444444444445	19	16156	12	58	7	16098	16175	0.32769237806086104
M1	cpdb	0	network_modules	11	TRUE	2.0991234589629508e-20	324	70	24	0.34285714285714286	0.07407407407407407	GO:0010506	GO:BP	regulation of autophagy	16175	4181		0.2	0.2222222222222222	324	15851	24	46	300	15805	16175	0.15190809670073804
M1	cpdb	0	network_modules	11	TRUE	2.4815025352240965e-13	156	70	15	0.21428571428571427	0.09615384615384616	GO:0016241	GO:BP	regulation of macroautophagy	16175	5183		0.22857142857142856	0.25	156	16019	15	55	141	15964	16175	0.13804669740579606
M1	cpdb	0	network_modules	11	TRUE	3.31505633596221e-13	159	70	15	0.21428571428571427	0.09433962264150944	GO:0042594	GO:BP	response to starvation	16175	10254		0.2571428571428571	0.2777777777777778	159	16016	15	55	144	15961	16175	0.13662703336313448
M1	cpdb	0	network_modules	11	TRUE	9.46846953351655e-13	15	70	8	0.11428571428571428	0.5333333333333333	GO:0016237	GO:BP	microautophagy	16175	5180		0.2857142857142857	0.3055555555555556	15	16160	8	62	7	16098	16175	0.24552752198231093
M1	cpdb	0	network_modules	11	TRUE	4.477397442882096e-12	103	55	13	0.23636363636363636	0.1262135922330097	KEGG:04137	KEGG	Mitophagy - animal	8484	274		0.25	0.3333333333333333	103	8381	13	42	90	8339	8484	0.16538947495908835
M1	cpdb	0	network_modules	11	TRUE	4.593669043003824e-12	10	70	7	0.1	0.7	GO:0034727	GO:BP	piecemeal microautophagy of the nucleus	16175	8722		0.3142857142857143	0.3333333333333333	10	16165	7	63	3	16102	16175	0.26359173126941027
M1	cpdb	0	network_modules	11	TRUE	3.484961513775395e-11	363	55	19	0.34545454545454546	0.05234159779614325	KEGG:05014	KEGG	Amyotrophic lateral sclerosis	8484	413		0.375	0.4444444444444444	363	8121	19	36	344	8085	8484	0.12080991944980064
M1	cpdb	0	network_modules	11	TRUE	4.147377765728654e-11	138	70	13	0.18571428571428572	0.09420289855072464	GO:0009267	GO:BP	cellular response to starvation	16175	3432		0.34285714285714286	0.3611111111111111	138	16037	13	57	125	15980	16175	0.12700853591501127
M1	cpdb	0	network_modules	11	TRUE	5.477854903878549e-11	55	70	10	0.14285714285714285	0.18181818181818182	GO:0097352	GO:BP	autophagosome maturation	16175	18619		0.37142857142857144	0.3888888888888889	55	16120	10	60	45	16060	16175	0.1579388174448757
M1	cpdb	0	network_modules	11	TRUE	5.7265477749753566e-11	44	47	9	0.19148936170212766	0.20454545454545456	REAC:R-HSA-8854214	REAC	TBC/RABGAPs	10916	2420		0.25	0.3333333333333333	44	10872	9	38	35	10834	10916	0.1945547897475248
M1	cpdb	0	network_modules	11	TRUE	7.937868457688453e-11	145	70	13	0.18571428571428572	0.0896551724137931	GO:0010508	GO:BP	positive regulation of autophagy	16175	4183		0.4	0.4166666666666667	145	16030	13	57	132	15973	16175	0.12362923959660141
M1	cpdb	0	network_modules	11	TRUE	9.489226958475126e-11	187	70	14	0.2	0.0748663101604278	GO:0031669	GO:BP	cellular response to nutrient levels	16175	7272		0.42857142857142855	0.4444444444444444	187	15988	14	56	173	15932	16175	0.11621595223723517
M1	cpdb	0	network_modules	11	TRUE	2.770121072352411e-10	141	55	13	0.23636363636363636	0.09219858156028368	KEGG:05017	KEGG	Spinocerebellar ataxia	8484	415		0.5	0.5555555555555556	141	8343	13	42	128	8301	8484	0.1388482968775346
M1	cpdb	0	network_modules	11	TRUE	5.602861244103486e-10	262	70	15	0.21428571428571427	0.05725190839694656	GO:0031667	GO:BP	response to nutrient levels	16175	7271		0.45714285714285713	0.4722222222222222	262	15913	15	55	247	15858	16175	0.1034532569105489
M1	cpdb	0	network_modules	11	TRUE	4.438067484386185e-9	11	70	6	0.08571428571428572	0.5454545454545454	GO:0006995	GO:BP	cellular response to nitrogen starvation	16175	2610		0.4857142857142857	0.5277777777777778	11	16164	6	64	5	16100	16175	0.2150482603049453
M1	cpdb	0	network_modules	11	TRUE	4.438067484386185e-9	11	70	6	0.08571428571428572	0.5454545454545454	GO:0043562	GO:BP	cellular response to nitrogen levels	16175	10771		0.4857142857142857	0.5277777777777778	11	16164	6	64	5	16100	16175	0.2150482603049453
M1	cpdb	0	network_modules	11	TRUE	2.5931358256890297e-8	120	47	10	0.2127659574468085	0.08333333333333333	REAC:R-HSA-9007101	REAC	Rab regulation of trafficking	10916	1939		0.375	0.4444444444444444	120	10796	10	37	110	10759	10916	0.12725020158829126
M1	cpdb	0	network_modules	11	TRUE	5.9081363300570606e-8	49	70	8	0.11428571428571428	0.16326530612244897	GO:0006497	GO:BP	protein lipidation	16175	2226		0.5428571428571428	0.5555555555555556	49	16126	8	62	41	16064	16175	0.1334677616277414
M1	cpdb	0	network_modules	11	TRUE	7.00950732257115e-8	50	70	8	0.11428571428571428	0.16	GO:0042158	GO:BP	lipoprotein biosynthetic process	16175	9996		0.5714285714285714	0.5833333333333334	50	16125	8	62	42	16063	16175	0.13205701663913522
M1	cpdb	0	network_modules	11	TRUE	1.1648705111089747e-7	17	70	6	0.08571428571428572	0.35294117647058826	GO:0061709	GO:BP	reticulophagy	16175	15625		0.6	0.6388888888888888	17	16158	6	64	11	16094	16175	0.17226211594794255
M1	cpdb	0	network_modules	11	TRUE	1.1648705111089747e-7	17	70	6	0.08571428571428572	0.35294117647058826	GO:1901096	GO:BP	regulation of autophagosome maturation	16175	21208		0.6	0.6388888888888888	17	16158	6	64	11	16094	16175	0.17226211594794255
M1	cpdb	0	network_modules	11	TRUE	2.1064103645755802e-7	57	70	8	0.11428571428571428	0.14035087719298245	GO:0000422	GO:BP	autophagy of mitochondrion	16175	126		0.6571428571428571	0.6666666666666666	57	16118	8	62	49	16056	16175	0.12322810776653653
M1	cpdb	0	network_modules	11	TRUE	2.704226239604577e-7	477	70	16	0.22857142857142856	0.033542976939203356	GO:0009896	GO:BP	positive regulation of catabolic process	16175	3756		0.6857142857142857	0.6944444444444444	477	15698	16	54	461	15644	16175	0.07758226284388346
M1	cpdb	0	network_modules	11	TRUE	4.229865893561944e-7	305	55	14	0.2545454545454545	0.04590163934426229	KEGG:05016	KEGG	Huntington disease	8484	414		0.625	0.6666666666666666	305	8179	14	41	291	8138	8484	0.0948494974343252
M1	cpdb	0	network_modules	11	TRUE	8.035080695198713e-7	67	70	8	0.11428571428571428	0.11940298507462686	GO:0042157	GO:BP	lipoprotein metabolic process	16175	9995		0.7142857142857143	0.7222222222222222	67	16108	8	62	59	16046	16175	0.11306122400111619
M1	cpdb	0	network_modules	11	TRUE	1.1020761890952026e-6	43	70	7	0.1	0.16279069767441862	GO:0000423	GO:BP	mitophagy	16175	127		0.7428571428571429	0.75	43	16132	7	63	36	16069	16175	0.12463298193100254
M1	cpdb	0	network_modules	11	TRUE	4.72149104833895e-6	14	70	5	0.07142857142857142	0.35714285714285715	GO:0034497	GO:BP	protein localization to phagophore assembly site	16175	8664		0.7714285714285715	0.7777777777777778	14	16161	5	65	9	16096	16175	0.1581947562050567
M1	cpdb	0	network_modules	11	TRUE	1.4965128288385767e-5	9	47	4	0.0851063829787234	0.4444444444444444	REAC:R-HSA-8934903	REAC	Receptor Mediated Mitophagy	10916	1944		0.5	0.5555555555555556	9	10907	4	43	5	10864	10916	0.193098141710859
M1	cpdb	0	network_modules	11	TRUE	3.738702440612187e-5	70	70	7	0.1	0.1	GO:0016239	GO:BP	positive regulation of macroautophagy	16175	5181		0.8	0.8055555555555556	70	16105	7	63	63	16042	16175	0.0960881713753493
M1	cpdb	0	network_modules	11	TRUE	5.119078923991983e-5	215	70	10	0.14285714285714285	0.046511627906976744	GO:0032984	GO:BP	protein-containing complex disassembly	16175	7964		0.8285714285714286	0.8333333333333334	215	15960	10	60	205	15900	16175	0.07458732910471531
M1	cpdb	0	network_modules	11	TRUE	5.4227594168970475e-5	382	55	13	0.23636363636363636	0.034031413612565446	KEGG:05010	KEGG	Alzheimer disease	8484	411		0.75	0.7777777777777778	382	8102	13	42	369	8060	8484	0.07453611246241307
M1	cpdb	0	network_modules	11	TRUE	1.7613311570691413e-4	182	55	9	0.16363636363636364	0.04945054945054945	KEGG:04621	KEGG	NOD-like receptor signaling pathway	8484	326		0.875	0.8888888888888888	182	8302	9	46	173	8256	8484	0.07927172598479743
M1	cpdb	0	network_modules	11	TRUE	1.920857586304453e-4	11	70	4	0.05714285714285714	0.36363636363636365	GO:1903059	GO:BP	regulation of protein lipidation	16175	22738		0.8571428571428571	0.8611111111111112	11	16164	4	66	7	16098	16175	0.1427922235282006
M1	cpdb	0	network_modules	11	TRUE	2.6657090758519243e-4	246	55	10	0.18181818181818182	0.04065040650406504	KEGG:05131	KEGG	Shigellosis	8484	428		1	1	246	8238	10	45	236	8193	8484	0.07357031532030837
M1	cpdb	0	network_modules	11	TRUE	7.842177472721327e-4	15	70	4	0.05714285714285714	0.26666666666666666	GO:0050746	GO:BP	regulation of lipoprotein metabolic process	16175	13232		0.8857142857142857	0.8888888888888888	15	16160	4	66	11	16094	16175	0.12175946064802563
M1	cpdb	0	network_modules	11	TRUE	0.001408677852482863	55	47	5	0.10638297872340426	0.09090909090909091	REAC:R-HSA-75893	REAC	TNF signaling	10916	2446		0.625	0.6666666666666666	55	10861	5	42	50	10819	10916	0.0941242671045212
M1	cpdb	0	network_modules	11	TRUE	0.0014285882789017575	5	70	3	0.04285714285714286	0.6	GO:0051697	GO:BP	protein delipidation	16175	13900		0.9142857142857143	0.9166666666666666	5	16170	3	67	2	16103	16175	0.15957039739879494
M1	cpdb	0	network_modules	11	TRUE	0.001969350107408912	27	47	4	0.0851063829787234	0.14814814814814814	REAC:R-HSA-5205647	REAC	Mitophagy	10916	1478		0.75	0.7777777777777778	27	10889	4	43	23	10846	10916	0.10939438605555413
M1	cpdb	0	network_modules	11	TRUE	0.004819740046056607	11	47	3	0.06382978723404255	0.2727272727272727	REAC:R-HSA-1660517	REAC	Synthesis of PIPs at the late endosome membrane	10916	2394		0.875	0.8888888888888888	11	10905	3	44	8	10861	10916	0.1302029665334627
M1	cpdb	0	network_modules	11	TRUE	0.00489390517464549	51	70	5	0.07142857142857142	0.09803921568627451	GO:0044088	GO:BP	regulation of vacuole organization	16175	10910		0.9428571428571428	0.9444444444444444	51	16124	5	65	46	16059	16175	0.08028912355386214
M1	cpdb	0	network_modules	11	TRUE	0.007088679321212755	97	70	6	0.08571428571428572	0.061855670103092786	GO:0043244	GO:BP	regulation of protein-containing complex disassembly	16175	10582		0.9714285714285714	0.9722222222222222	97	16078	6	64	91	16014	16175	0.06807130323306648
M1	cpdb	0	network_modules	11	TRUE	0.008278792115895231	374	70	10	0.14285714285714285	0.026737967914438502	GO:0022411	GO:BP	cellular component disassembly	16175	6602		1	1	374	15801	10	60	364	15741	16175	0.05252379817000924
M1	cpdb	0	network_modules	11	TRUE	0.00898406332684022	80	47	5	0.10638297872340426	0.0625	REAC:R-HSA-9663891	REAC	Selective autophagy	10916	2186		1	1	80	10836	5	42	75	10794	10916	0.07636800504156313
M1	cpdb	0	network_modules	12	TRUE	8.5422243349644e-6	131	39	8	0.20512820512820512	0.061068702290076333	KEGG:04142	KEGG	Lysosome	8484	279		0	0.3333333333333333	131	8353	8	31	123	8322	8484	0.10454774627077862
M1	cpdb	0	network_modules	12	TRUE	1.139789360218391e-5	8	51	4	0.0784313725490196	0.5	REAC:R-HSA-8939242	REAC	RUNX1 regulates transcription of genes involved in differentiation of keratinocytes	10916	1923		0	0.125	8	10908	4	47	4	10861	10916	0.1967110900853052
M1	cpdb	0	network_modules	12	TRUE	3.3479339889154876e-5	42	67	6	0.08955223880597014	0.14285714285714285	GO:0010466	GO:BP	negative regulation of peptidase activity	16175	4159		0	0.09090909090909091	42	16133	6	61	36	16072	16175	0.11019868689440887
M1	cpdb	0	network_modules	12	TRUE	4.664529058873195e-5	22	67	5	0.07462686567164178	0.22727272727272727	GO:0018149	GO:BP	peptide cross-linking	16175	5337		0.1	0.18181818181818182	22	16153	5	62	17	16091	16175	0.12821233904799695
M1	cpdb	0	network_modules	12	TRUE	4.674854616216126e-5	128	51	8	0.1568627450980392	0.0625	REAC:R-HSA-6809371	REAC	Formation of the cornified envelope	10916	969		0.14285714285714285	0.25	128	10788	8	43	120	10745	10916	0.09237106559475737
M1	cpdb	0	network_modules	12	TRUE	7.124973870084876e-5	476	51	13	0.2549019607843137	0.0273109243697479	REAC:R-HSA-6798695	REAC	Neutrophil degranulation	10916	1597		0.2857142857142857	0.375	476	10440	13	38	463	10402	10916	0.07088784957376695
M1	cpdb	0	network_modules	12	TRUE	1.144301333357717e-4	13	51	4	0.0784313725490196	0.3076923076923077	REAC:R-HSA-1679131	REAC	Trafficking and processing of endosomal TLR	10916	2531		0.42857142857142855	0.5	13	10903	4	47	9	10856	10916	0.15343835003400616
M1	cpdb	0	network_modules	12	TRUE	2.7216703433555797e-4	59	67	6	0.08955223880597014	0.1016949152542373	GO:0022617	GO:BP	extracellular matrix disassembly	16175	6624		0.2	0.2727272727272727	59	16116	6	61	53	16055	16175	0.09190155065659211
M1	cpdb	0	network_modules	12	TRUE	3.6680340799652775e-4	102	67	7	0.1044776119402985	0.06862745098039216	GO:0030216	GO:BP	keratinocyte differentiation	16175	6724		0.3	0.36363636363636365	102	16073	7	60	95	16013	16175	0.07998307943336401
M1	cpdb	0	network_modules	12	TRUE	3.922714036825357e-4	103	67	7	0.1044776119402985	0.06796116504854369	GO:0052547	GO:BP	regulation of peptidase activity	16175	14133		0.4	0.45454545454545453	103	16072	7	60	96	16012	16175	0.0795462151890848
M1	cpdb	0	network_modules	12	TRUE	7.359467059290876e-4	37	67	5	0.07462686567164178	0.13513513513513514	GO:0030574	GO:BP	collagen catabolic process	16175	6846		0.5	0.5454545454545454	37	16138	5	62	32	16076	16175	0.09765848323184514
M1	cpdb	0	network_modules	12	TRUE	0.0019155846174842952	130	67	7	0.1044776119402985	0.05384615384615385	GO:0045861	GO:BP	negative regulation of proteolysis	16175	11673		0.6	0.6363636363636364	130	16045	7	60	123	15985	16175	0.0696592631487234
M1	cpdb	0	network_modules	12	TRUE	0.0023871388258431348	215	51	8	0.1568627450980392	0.037209302325581395	REAC:R-HSA-6805567	REAC	Keratinization	10916	1288		0.5714285714285714	0.625	215	10701	8	43	207	10658	10916	0.06763190437017895
M1	cpdb	0	network_modules	12	TRUE	0.0024503140558846536	135	39	6	0.15384615384615385	0.044444444444444446	KEGG:04210	KEGG	Apoptosis	8484	287		0.5	0.6666666666666666	135	8349	6	33	129	8316	8484	0.07490656374374205
M1	cpdb	0	network_modules	12	TRUE	0.002720461065349448	41	39	4	0.10256410256410256	0.0975609756097561	KEGG:04216	KEGG	Ferroptosis	8484	293		1	1	41	8443	4	35	37	8408	8484	0.09576951172035815
M1	cpdb	0	network_modules	12	TRUE	0.0034664859950319896	142	67	7	0.1044776119402985	0.04929577464788732	GO:0009913	GO:BP	epidermal cell differentiation	16175	3769		0.7	0.7272727272727273	142	16033	7	60	135	15973	16175	0.06616297753160745
M1	cpdb	0	network_modules	12	TRUE	0.0036303215467706064	91	67	6	0.08955223880597014	0.06593406593406594	GO:0051346	GO:BP	negative regulation of hydrolase activity	16175	13673		0.8	0.8181818181818182	91	16084	6	61	85	16023	16175	0.07236708649418462
M1	cpdb	0	network_modules	12	TRUE	0.006031630953263018	11	51	3	0.058823529411764705	0.2727272727272727	REAC:R-HSA-1236977	REAC	Endosomal/Vacuolar pathway	10916	842		0.7142857142857143	0.75	11	10905	3	48	8	10857	10916	0.1248450619226793
M1	cpdb	0	network_modules	12	TRUE	0.006112619783993607	33	51	4	0.0784313725490196	0.12121212121212122	REAC:R-HSA-1592389	REAC	Activation of Matrix Metalloproteinases	10916	86		0.8571428571428571	0.875	33	10883	4	47	29	10836	10916	0.094106916045196
M1	cpdb	0	network_modules	12	TRUE	0.00669309506404922	8	67	3	0.04477611940298507	0.375	GO:0097067	GO:BP	cellular response to thyroid hormone stimulus	16175	18473		0.9	0.9090909090909091	8	16167	3	64	5	16103	16175	0.1284469438980851
M1	cpdb	0	network_modules	12	TRUE	0.008416622280151784	123	51	6	0.11764705882352941	0.04878048780487805	REAC:R-HSA-2132295	REAC	MHC class II antigen presentation	10916	1371		1	1	123	10793	6	45	117	10748	10916	0.0690504964888446
M1	cpdb	0	network_modules	12	TRUE	0.008644959578997653	231	67	8	0.11940298507462686	0.03463203463203463	GO:0008544	GO:BP	epidermis development	16175	3192		1	1	231	15944	8	59	223	15885	16175	0.05714109629054942
M1	cpdb	0	network_modules	13	TRUE	8.325479840930655e-108	90	69	55	0.7971014492753623	0.6111111111111112	REAC:R-HSA-156902	REAC	Peptide chain elongation	10916	1723		0	0.02702702702702703	90	10826	55	14	35	10812	10916	0.695786645142577
M1	cpdb	0	network_modules	13	TRUE	3.07106457827006e-106	94	69	55	0.7971014492753623	0.5851063829787234	REAC:R-HSA-156842	REAC	Eukaryotic Translation Elongation	10916	870		0.027777777777777776	0.05405405405405406	94	10822	55	14	39	10808	10916	0.6806312430490955
M1	cpdb	0	network_modules	13	TRUE	9.169110563046034e-105	90	69	54	0.782608695652174	0.6	REAC:R-HSA-192823	REAC	Viral mRNA Translation	10916	2650		0.05555555555555555	0.08108108108108109	90	10826	54	15	36	10811	10916	0.6830037597421422
M1	cpdb	0	network_modules	13	TRUE	3.042932876507075e-103	94	69	54	0.782608695652174	0.574468085106383	REAC:R-HSA-72764	REAC	Eukaryotic Translation Termination	10916	872		0.08333333333333333	0.13513513513513514	94	10822	54	15	40	10807	10916	0.6681209791819341
M1	cpdb	0	network_modules	13	TRUE	3.042932876507075e-103	94	69	54	0.782608695652174	0.574468085106383	REAC:R-HSA-2408557	REAC	Selenocysteine synthesis	10916	2188		0.08333333333333333	0.13513513513513514	94	10822	54	15	40	10807	10916	0.6681209791819341
M1	cpdb	0	network_modules	13	TRUE	1.6072049938844895e-102	96	69	54	0.782608695652174	0.5625	REAC:R-HSA-975956	REAC	Nonsense Mediated Decay (NMD) independent of the Exon Junction Complex (EJC)	10916	1607		0.1388888888888889	0.16216216216216217	96	10820	54	15	42	10805	10916	0.6610293414532423
M1	cpdb	0	network_modules	13	TRUE	1.749224679138419e-100	102	69	54	0.782608695652174	0.5294117647058824	REAC:R-HSA-9633012	REAC	Response of EIF2AK4 (GCN2) to amino acid deficiency	10916	2087		0.16666666666666666	0.21621621621621623	102	10814	54	15	48	10799	10916	0.6410148933945167
M1	cpdb	0	network_modules	13	TRUE	1.749224679138419e-100	102	69	54	0.782608695652174	0.5294117647058824	REAC:R-HSA-72689	REAC	Formation of a pool of free 40S subunits	10916	953		0.16666666666666666	0.21621621621621623	102	10814	54	15	48	10799	10916	0.6410148933945167
M1	cpdb	0	network_modules	13	TRUE	1.871526025523152e-97	112	69	54	0.782608695652174	0.48214285714285715	REAC:R-HSA-156827	REAC	L13a-mediated translational silencing of Ceruloplasmin expression	10916	1293		0.2222222222222222	0.24324324324324326	112	10804	54	15	58	10789	10916	0.6112871631891706
M1	cpdb	0	network_modules	13	TRUE	3.5795626739849854e-97	113	69	54	0.782608695652174	0.4778761061946903	REAC:R-HSA-72706	REAC	GTP hydrolysis and joining of the 60S ribosomal subunit	10916	1027		0.25	0.2972972972972973	113	10803	54	15	59	10788	10916	0.6085323214803606
M1	cpdb	0	network_modules	13	TRUE	3.5795626739849854e-97	113	69	54	0.782608695652174	0.4778761061946903	REAC:R-HSA-1799339	REAC	SRP-dependent cotranslational protein targeting to membrane	10916	2157		0.25	0.2972972972972973	113	10803	54	15	59	10788	10916	0.6085323214803606
M1	cpdb	0	network_modules	13	TRUE	2.3891342794618174e-96	116	69	54	0.782608695652174	0.46551724137931033	REAC:R-HSA-975957	REAC	Nonsense Mediated Decay (NMD) enhanced by the Exon Junction Complex (EJC)	10916	1606		0.3055555555555556	0.35135135135135137	116	10800	54	15	62	10785	10916	0.6004814643467254
M1	cpdb	0	network_modules	13	TRUE	2.3891342794618174e-96	116	69	54	0.782608695652174	0.46551724137931033	REAC:R-HSA-927802	REAC	Nonsense-Mediated Decay (NMD)	10916	1608		0.3055555555555556	0.35135135135135137	116	10800	54	15	62	10785	10916	0.6004814643467254
M1	cpdb	0	network_modules	13	TRUE	4.430914048251183e-96	117	69	54	0.782608695652174	0.46153846153846156	REAC:R-HSA-2408522	REAC	Selenoamino acid metabolism	10916	2187		0.3611111111111111	0.3783783783783784	117	10799	54	15	63	10784	10916	0.5978665250376255
M1	cpdb	0	network_modules	13	TRUE	2.7082472649891048e-95	120	69	54	0.782608695652174	0.45	REAC:R-HSA-72737	REAC	Cap-dependent Translation Initiation	10916	304		0.3888888888888889	0.43243243243243246	120	10796	54	15	66	10781	10916	0.5902176916542159
M1	cpdb	0	network_modules	13	TRUE	2.7082472649891048e-95	120	69	54	0.782608695652174	0.45	REAC:R-HSA-72613	REAC	Eukaryotic Translation Initiation	10916	871		0.3888888888888889	0.43243243243243246	120	10796	54	15	66	10781	10916	0.5902176916542159
M1	cpdb	0	network_modules	13	TRUE	3.599240449270116e-92	133	69	54	0.782608695652174	0.40601503759398494	REAC:R-HSA-168273	REAC	Influenza Viral RNA Transcription and Replication	10916	1186		0.4444444444444444	0.4594594594594595	133	10783	54	15	79	10768	10916	0.5601029405986484
M1	cpdb	0	network_modules	13	TRUE	4.5287762677289e-88	153	69	54	0.782608695652174	0.35294117647058826	REAC:R-HSA-168255	REAC	Influenza Infection	10916	1185		0.4722222222222222	0.4864864864864865	153	10763	54	15	99	10748	10916	0.5214552568474982
M1	cpdb	0	network_modules	13	TRUE	2.4815343458268932e-87	157	69	54	0.782608695652174	0.34394904458598724	REAC:R-HSA-9711097	REAC	Cellular response to starvation	10916	337		0.5	0.5135135135135135	157	10759	54	15	103	10744	10916	0.5146198711659049
M1	cpdb	0	network_modules	13	TRUE	2.0972446039320645e-86	153	64	54	0.84375	0.35294117647058826	KEGG:03010	KEGG	Ribosome	8484	208		0	0.5	153	8331	54	10	99	8321	8484	0.5409673408388014
M1	cpdb	0	network_modules	13	TRUE	5.124520309703879e-86	158	72	51	0.7083333333333334	0.3227848101265823	GO:0002181	GO:BP	cytoplasmic translation	16175	729		0	0.07142857142857142	158	16017	51	21	107	15996	16175	0.47494677126157114
M1	cpdb	0	network_modules	13	TRUE	6.42485995881176e-85	171	69	54	0.782608695652174	0.3157894736842105	REAC:R-HSA-9010553	REAC	Regulation of expression of SLITs and ROBOs	10916	2031		0.5277777777777778	0.5405405405405406	171	10745	54	15	117	10730	10916	0.49260115344522143
M1	cpdb	0	network_modules	13	TRUE	3.474376512560779e-83	182	69	54	0.782608695652174	0.2967032967032967	REAC:R-HSA-6791226	REAC	Major pathway of rRNA processing in the nucleolus and cytosol	10916	1389		0.5555555555555556	0.5675675675675675	182	10734	54	15	128	10719	10916	0.4770997630442722
M1	cpdb	0	network_modules	13	TRUE	1.0247297384245916e-81	192	69	54	0.782608695652174	0.28125	REAC:R-HSA-8868773	REAC	rRNA processing in the nucleus and cytosol	10916	2734		0.5833333333333334	0.5945945945945946	192	10724	54	15	138	10709	10916	0.4641698535166023
M1	cpdb	0	network_modules	13	TRUE	2.467193912459073e-80	202	69	54	0.782608695652174	0.26732673267326734	REAC:R-HSA-72312	REAC	rRNA processing	10916	2732		0.6111111111111112	0.6216216216216216	202	10714	54	15	148	10699	10916	0.4522036640232452
M1	cpdb	0	network_modules	13	TRUE	2.0930565325681566e-78	217	69	54	0.782608695652174	0.2488479262672811	REAC:R-HSA-376176	REAC	Signaling by ROBO receptors	10916	2301		0.6388888888888888	0.6486486486486487	217	10699	54	15	163	10684	10916	0.4358152302407365
M1	cpdb	0	network_modules	13	TRUE	4.550915396039308e-75	231	64	54	0.84375	0.23376623376623376	KEGG:05171	KEGG	Coronavirus disease - COVID-19	8484	452		1	1	231	8253	54	10	177	8243	8484	0.43741203360412145
M1	cpdb	0	network_modules	13	TRUE	7.686397486361747e-73	292	69	55	0.7971014492753623	0.18835616438356165	REAC:R-HSA-72766	REAC	Translation	10916	2565		0.6666666666666666	0.6756756756756757	292	10624	55	14	237	10610	10916	0.38079115708810485
M1	cpdb	0	network_modules	13	TRUE	9.074862910741871e-67	566	72	57	0.7916666666666666	0.10070671378091872	GO:0006412	GO:BP	translation	16175	2170		0.07692307692307693	0.14285714285714285	566	15609	57	15	509	15594	16175	0.27534070696138524
M1	cpdb	0	network_modules	13	TRUE	1.2857025415904321e-64	370	69	54	0.782608695652174	0.14594594594594595	REAC:R-HSA-71291	REAC	Metabolism of amino acids and derivatives	10916	1421		0.6944444444444444	0.7027027027027027	370	10546	54	15	316	10531	10916	0.32999257514774927
M1	cpdb	0	network_modules	13	TRUE	3.107552777317387e-33	37	69	20	0.2898550724637681	0.5405405405405406	REAC:R-HSA-9735869	REAC	SARS-CoV-1 modulates host translation machinery	10916	2116		0.7222222222222222	0.7297297297297297	37	10879	20	49	17	10830	10916	0.39310657463123533
M1	cpdb	0	network_modules	13	TRUE	1.929814289233174e-27	51	69	19	0.2753623188405797	0.37254901960784315	REAC:R-HSA-9754678	REAC	SARS-CoV-2 modulates host translation machinery	10916	2125		0.75	0.7567567567567568	51	10865	19	50	32	10815	10916	0.31659638868858664
M1	cpdb	0	network_modules	13	TRUE	3.027631675029009e-27	52	69	19	0.2753623188405797	0.36538461538461536	REAC:R-HSA-72695	REAC	Formation of the ternary complex, and subsequently, the 43S complex	10916	973		0.7777777777777778	0.7837837837837838	52	10864	19	50	33	10814	10916	0.3134457303022387
M1	cpdb	0	network_modules	13	TRUE	5.37281167046698e-26	59	69	19	0.2753623188405797	0.3220338983050847	REAC:R-HSA-72649	REAC	Translation initiation complex formation	10916	2566		0.8055555555555556	0.8378378378378378	59	10857	19	50	40	10807	10916	0.2936618822772422
M1	cpdb	0	network_modules	13	TRUE	5.37281167046698e-26	59	69	19	0.2753623188405797	0.3220338983050847	REAC:R-HSA-72702	REAC	Ribosomal scanning and start codon recognition	10916	2106		0.8055555555555556	0.8378378378378378	59	10857	19	50	40	10807	10916	0.2936618822772422
M1	cpdb	0	network_modules	13	TRUE	7.828273037387544e-26	60	69	19	0.2753623188405797	0.31666666666666665	REAC:R-HSA-72662	REAC	Activation of the mRNA upon binding of the cap-binding complex and eIFs, and subsequent binding to 43S	10916	105		0.8611111111111112	0.8648648648648649	60	10856	19	50	41	10806	10916	0.29111900603585966
M1	cpdb	0	network_modules	13	TRUE	4.22558151897433e-25	95	69	21	0.30434782608695654	0.22105263157894736	REAC:R-HSA-9692914	REAC	SARS-CoV-1-host interactions	10916	2119		0.8888888888888888	0.8918918918918919	95	10821	21	48	74	10773	10916	0.2538681956606181
M1	cpdb	0	network_modules	13	TRUE	2.69925830023606e-21	140	69	21	0.30434782608695654	0.15	REAC:R-HSA-9678108	REAC	SARS-CoV-1 Infection	10916	2114		0.9166666666666666	0.918918918918919	140	10776	21	48	119	10728	10916	0.2066391918436043
M1	cpdb	0	network_modules	13	TRUE	7.893681244979066e-21	390	72	26	0.3611111111111111	0.06666666666666667	GO:0022613	GO:BP	ribonucleoprotein complex biogenesis	16175	6620		0.15384615384615385	0.21428571428571427	390	15785	26	46	364	15739	16175	0.1469035273889624
M1	cpdb	0	network_modules	13	TRUE	1.1695832798567684e-19	251	72	22	0.3055555555555556	0.08764940239043825	GO:0042254	GO:BP	ribosome biogenesis	16175	10060		0.23076923076923078	0.2857142857142857	251	15924	22	50	229	15874	16175	0.15690933073459207
M1	cpdb	0	network_modules	13	TRUE	1.1485815547410138e-16	197	69	20	0.2898550724637681	0.10152284263959391	REAC:R-HSA-9705683	REAC	SARS-CoV-2-host interactions	10916	2128		0.9444444444444444	0.9459459459459459	197	10719	20	49	177	10670	10916	0.162849154651046
M1	cpdb	0	network_modules	13	TRUE	2.770758548082587e-13	292	69	20	0.2898550724637681	0.0684931506849315	REAC:R-HSA-9694516	REAC	SARS-CoV-2 Infection	10916	2122		0.9722222222222222	0.972972972972973	292	10624	20	49	272	10575	10916	0.13005512481639053
M1	cpdb	0	network_modules	13	TRUE	4.0746735040716346e-13	94	72	13	0.18055555555555555	0.13829787234042554	GO:0042274	GO:BP	ribosomal small subunit biogenesis	16175	10071		0.3076923076923077	0.35714285714285715	94	16081	13	59	81	16022	16175	0.15372314276282423
M1	cpdb	0	network_modules	13	TRUE	1.2817541521727807e-11	459	69	22	0.3188405797101449	0.04793028322440087	REAC:R-HSA-9679506	REAC	SARS-CoV Infections	10916	2112		1	1	459	10457	22	47	437	10410	10916	0.10999608280604267
M1	cpdb	0	network_modules	13	TRUE	2.1243396956434843e-8	169	72	12	0.16666666666666666	0.07100591715976332	GO:0006364	GO:BP	rRNA processing	16175	2140		0.38461538461538464	0.42857142857142855	169	16006	12	60	157	15946	16175	0.10273175101505203
M1	cpdb	0	network_modules	13	TRUE	2.0450411330404288e-7	205	72	12	0.16666666666666666	0.05853658536585366	GO:0016072	GO:BP	rRNA metabolic process	16175	5099		0.46153846153846156	0.5	205	15970	12	60	193	15910	16175	0.09205091973306206
M1	cpdb	0	network_modules	13	TRUE	7.395900861675199e-7	178	72	11	0.1527777777777778	0.06179775280898876	GO:0022618	GO:BP	protein-RNA complex assembly	16175	6625		0.5384615384615384	0.5714285714285714	178	15997	11	61	167	15936	16175	0.09087027216788923
M1	cpdb	0	network_modules	13	TRUE	8.873875259635618e-7	65	72	8	0.1111111111111111	0.12307692307692308	GO:0042273	GO:BP	ribosomal large subunit biogenesis	16175	10070		0.6153846153846154	0.6428571428571429	65	16110	8	64	57	16046	16175	0.11319102924351276
M1	cpdb	0	network_modules	13	TRUE	1.3255590656030518e-6	188	72	11	0.1527777777777778	0.05851063829787234	GO:0071826	GO:BP	protein-RNA complex organization	16175	16929		0.6923076923076923	0.7142857142857143	188	15987	11	61	177	15926	16175	0.08806243640117689
M1	cpdb	0	network_modules	13	TRUE	2.920484253348003e-6	47	72	7	0.09722222222222222	0.14893617021276595	GO:0042255	GO:BP	ribosome assembly	16175	10061		0.7692307692307693	0.7857142857142857	47	16128	7	65	40	16063	16175	0.11716709088620315
M1	cpdb	0	network_modules	13	TRUE	9.170425866642503e-6	15	72	5	0.06944444444444445	0.3333333333333333	GO:0000028	GO:BP	ribosomal small subunit assembly	16175	13		0.8461538461538461	0.8571428571428571	15	16160	5	67	10	16093	16175	0.1505184462629882
M1	cpdb	0	network_modules	13	TRUE	0.005610624065923423	343	72	10	0.1388888888888889	0.029154518950437316	GO:0140694	GO:BP	membraneless organelle assembly	16175	19860		0.9230769230769231	0.9285714285714286	343	15832	10	62	333	15770	16175	0.05462068217685607
M1	cpdb	0	network_modules	13	TRUE	0.00659816841254899	434	72	11	0.1527777777777778	0.02534562211981567	GO:0010608	GO:BP	post-transcriptional regulation of gene expression	16175	4255		1	1	434	15741	11	61	423	15680	16175	0.052117232958589534
M1	cpdb	0	network_modules	14	TRUE	1.3493514567472883e-13	8	54	7	0.12962962962962962	0.875	REAC:R-HSA-5632681	REAC	Ligand-receptor interactions	10916	1315		0	0.07692307692307693	8	10908	7	47	1	10861	10916	0.3358380905028935
M1	cpdb	0	network_modules	14	TRUE	8.628078290330503e-11	265	62	15	0.24193548387096775	0.05660377358490566	GO:0009101	GO:BP	glycoprotein biosynthetic process	16175	3273		0	0.045454545454545456	265	15910	15	47	250	15863	16175	0.11021505598844966
M1	cpdb	0	network_modules	14	TRUE	2.37474464996282e-10	125	54	12	0.2222222222222222	0.096	REAC:R-HSA-1630316	REAC	Glycosaminoglycan metabolism	10916	1076		0.08333333333333333	0.15384615384615385	125	10791	12	42	113	10749	10916	0.13967889863401975
M1	cpdb	0	network_modules	14	TRUE	4.4979772529975137e-10	56	43	9	0.20930232558139536	0.16071428571428573	KEGG:04340	KEGG	Hedgehog signaling pathway	8484	302		0	0.25	56	8428	9	34	47	8394	8484	0.17866479181702685
M1	cpdb	0	network_modules	14	TRUE	9.214008482850073e-10	82	62	10	0.16129032258064516	0.12195121951219512	GO:0030203	GO:BP	glycosaminoglycan metabolic process	16175	6712		0.047619047619047616	0.09090909090909091	82	16093	10	52	72	16041	16175	0.13644740326754815
M1	cpdb	0	network_modules	14	TRUE	1.0717378845848197e-9	315	62	15	0.24193548387096775	0.047619047619047616	GO:0009100	GO:BP	glycoprotein metabolic process	16175	3272		0.09523809523809523	0.13636363636363635	315	15860	15	47	300	15813	16175	0.09986169202099582
M1	cpdb	0	network_modules	14	TRUE	2.4067236617338044e-9	90	62	10	0.16129032258064516	0.1111111111111111	GO:0006022	GO:BP	aminoglycan metabolic process	16175	1895		0.14285714285714285	0.18181818181818182	90	16085	10	52	80	16033	16175	0.1298619065630215
M1	cpdb	0	network_modules	14	TRUE	8.684224808407734e-9	514	62	17	0.27419354838709675	0.033073929961089495	GO:1901137	GO:BP	carbohydrate derivative biosynthetic process	16175	21245		0.19047619047619047	0.22727272727272727	514	15661	17	45	497	15616	16175	0.08572788542238767
M1	cpdb	0	network_modules	14	TRUE	2.544249857337187e-8	288	54	14	0.25925925925925924	0.04861111111111111	REAC:R-HSA-71387	REAC	Metabolism of carbohydrates	10916	1422		0.16666666666666666	0.23076923076923078	288	10628	14	40	274	10588	10916	0.1024491041990787
M1	cpdb	0	network_modules	14	TRUE	6.827157497517562e-8	18	54	6	0.1111111111111111	0.3333333333333333	REAC:R-HSA-5635838	REAC	Activation of SMO	10916	97		0.25	0.3076923076923077	18	10898	6	48	12	10850	10916	0.1902216082077955
M1	cpdb	0	network_modules	14	TRUE	2.8615673394426747e-6	56	62	7	0.11290322580645161	0.125	GO:0008589	GO:BP	regulation of smoothened signaling pathway	16175	3199		0.23809523809523808	0.2727272727272727	56	16119	7	55	49	16064	16175	0.11557643402284189
M1	cpdb	0	network_modules	14	TRUE	5.303363278589292e-6	61	62	7	0.11290322580645161	0.11475409836065574	GO:1903510	GO:BP	mucopolysaccharide metabolic process	16175	23060		0.2857142857142857	0.36363636363636365	61	16114	7	55	54	16059	16175	0.11044278352253833
M1	cpdb	0	network_modules	14	TRUE	5.303363278589292e-6	61	62	7	0.11290322580645161	0.11475409836065574	GO:0030166	GO:BP	proteoglycan biosynthetic process	16175	6693		0.2857142857142857	0.36363636363636365	61	16114	7	55	54	16059	16175	0.11044278352253833
M1	cpdb	0	network_modules	14	TRUE	9.32695175347685e-6	66	62	7	0.11290322580645161	0.10606060606060606	GO:0006024	GO:BP	glycosaminoglycan biosynthetic process	16175	1897		0.38095238095238093	0.4090909090909091	66	16109	7	55	59	16054	16175	0.10589264273996812
M1	cpdb	0	network_modules	14	TRUE	1.0384082872896616e-5	67	62	7	0.11290322580645161	0.1044776119402985	GO:0006023	GO:BP	aminoglycan biosynthetic process	16175	1896		0.42857142857142855	0.45454545454545453	67	16108	7	55	60	16053	16175	0.10504298021633973
M1	cpdb	0	network_modules	14	TRUE	1.3995350714654701e-5	158	62	9	0.14516129032258066	0.056962025316455694	GO:0044272	GO:BP	sulfur compound biosynthetic process	16175	10944		0.47619047619047616	0.5	158	16017	9	53	149	15964	16175	0.08539440684647935
M1	cpdb	0	network_modules	14	TRUE	1.7329412343689226e-5	72	62	7	0.11290322580645161	0.09722222222222222	GO:0006029	GO:BP	proteoglycan metabolic process	16175	1902		0.5238095238095238	0.5454545454545454	72	16103	7	55	65	16048	16175	0.10105772077434629
M1	cpdb	0	network_modules	14	TRUE	1.848821002808522e-5	289	62	11	0.1774193548387097	0.03806228373702422	GO:0006790	GO:BP	sulfur compound metabolic process	16175	2476		0.5714285714285714	0.5909090909090909	289	15886	11	51	278	15835	16175	0.07471344016027007
M1	cpdb	0	network_modules	14	TRUE	1.943337884671638e-5	42	62	6	0.0967741935483871	0.14285714285714285	GO:0071526	GO:BP	semaphorin-plexin signaling pathway	16175	16747		0.6190476190476191	0.6363636363636364	42	16133	6	56	36	16077	16175	0.11479350300845124
M1	cpdb	0	network_modules	14	TRUE	4.726614884852471e-5	83	62	7	0.11290322580645161	0.08433734939759036	GO:0007224	GO:BP	smoothened signaling pathway	16175	2777		0.6666666666666666	0.6818181818181818	83	16092	7	55	76	16037	16175	0.09356495462057131
M1	cpdb	0	network_modules	14	TRUE	6.222921236392551e-5	85	54	7	0.12962962962962962	0.08235294117647059	REAC:R-HSA-5632684	REAC	Hedgehog 'on' state	10916	1113		0.3333333333333333	0.38461538461538464	85	10831	7	47	78	10784	10916	0.09773766845830656
M1	cpdb	0	network_modules	14	TRUE	1.5775446901247712e-4	12	62	4	0.06451612903225806	0.3333333333333333	GO:0097264	GO:BP	self proteolysis	16175	18563		0.7142857142857143	0.7272727272727273	12	16163	4	58	8	16105	16175	0.14529331612168814
M1	cpdb	0	network_modules	14	TRUE	1.5950372918913474e-4	4	54	3	0.05555555555555555	0.75	REAC:R-HSA-5658034	REAC	HHAT G278V doesn't palmitoylate Hh-Np	10916	1101		0.4166666666666667	0.46153846153846156	4	10912	3	51	1	10861	10916	0.20331845935036733
M1	cpdb	0	network_modules	14	TRUE	2.1966638635282393e-4	181	43	8	0.18604651162790697	0.04419889502762431	KEGG:04360	KEGG	Axon guidance	8484	305		0.3333333333333333	0.5	181	8303	8	35	173	8268	8484	0.08135926045110287
M1	cpdb	0	network_modules	14	TRUE	2.5086531600939564e-4	21	43	4	0.09302325581395349	0.19047619047619047	KEGG:00532	KEGG	Glycosaminoglycan biosynthesis - chondroitin sulfate / dermatan sulfate	8484	76		0.6666666666666666	0.75	21	8463	4	39	17	8424	8484	0.13006038091865052
M1	cpdb	0	network_modules	14	TRUE	3.4907697579954347e-4	165	62	8	0.12903225806451613	0.048484848484848485	GO:0007411	GO:BP	axon guidance	16175	2906		0.7619047619047619	0.8181818181818182	165	16010	8	54	157	15956	16175	0.07335762342126359
M1	cpdb	0	network_modules	14	TRUE	3.4907697579954347e-4	165	62	8	0.12903225806451613	0.048484848484848485	GO:0097485	GO:BP	neuron projection guidance	16175	18673		0.7619047619047619	0.8181818181818182	165	16010	8	54	157	15956	16175	0.07335762342126359
M1	cpdb	0	network_modules	14	TRUE	5.435827599113292e-4	18	54	4	0.07407407407407407	0.2222222222222222	REAC:R-HSA-9037629	REAC	Lewis blood group biosynthesis	10916	1314		0.5	0.5384615384615384	18	10898	4	50	14	10848	10916	0.12585922908696306
M1	cpdb	0	network_modules	14	TRUE	6.860169552718957e-4	19	54	4	0.07407407407407407	0.21052631578947367	REAC:R-HSA-416700	REAC	Other semaphorin interactions	10916	1652		0.5833333333333334	0.6153846153846154	19	10897	4	50	15	10847	10916	0.12235304164250388
M1	cpdb	0	network_modules	14	TRUE	0.0010515484404514627	21	54	4	0.07407407407407407	0.19047619047619047	REAC:R-HSA-9033658	REAC	Blood group systems biosynthesis	10916	253		0.6666666666666666	0.6923076923076923	21	10895	4	50	17	10845	10916	0.1160968239416453
M1	cpdb	0	network_modules	14	TRUE	0.0013856421231838345	49	54	5	0.09259259259259259	0.10204081632653061	REAC:R-HSA-1793185	REAC	Chondroitin sulfate/dermatan sulfate metabolism	10916	353		0.75	0.7692307692307693	49	10867	5	49	44	10818	10916	0.09292811352949569
M1	cpdb	0	network_modules	14	TRUE	0.001754169652338093	204	62	8	0.12903225806451613	0.0392156862745098	GO:0070085	GO:BP	glycosylation	16175	15903		0.8571428571428571	0.8636363636363636	204	15971	8	54	196	15917	16175	0.0647141337329787
M1	cpdb	0	network_modules	14	TRUE	0.0022019215929927004	8	54	3	0.05555555555555555	0.375	REAC:R-HSA-5362798	REAC	Release of Hh-Np from the secreting cell	10916	2055		0.8333333333333334	0.8461538461538461	8	10908	3	51	5	10857	10916	0.14283948055661363
M1	cpdb	0	network_modules	14	TRUE	0.0027745716035341163	149	54	7	0.12962962962962962	0.04697986577181208	REAC:R-HSA-5358351	REAC	Signaling by Hedgehog	10916	2258		0.9166666666666666	0.9230769230769231	149	10767	7	47	142	10720	10916	0.0704770797849968
M1	cpdb	0	network_modules	14	TRUE	0.0029527960658248275	57	54	5	0.09259259259259259	0.08771929824561403	REAC:R-HSA-1638091	REAC	Heparan sulfate/heparin (HS-GAG) metabolism	10916	1119		1	1	57	10859	5	49	52	10810	10916	0.08547516955698901
M1	cpdb	0	network_modules	14	TRUE	0.0032717879038822	24	62	4	0.06451612903225806	0.16666666666666666	GO:0045879	GO:BP	negative regulation of smoothened signaling pathway	16175	11683		0.9047619047619048	0.9090909090909091	24	16151	4	58	20	16093	16175	0.10158045498144225
M1	cpdb	0	network_modules	14	TRUE	0.007208869170176625	29	62	4	0.06451612903225806	0.13793103448275862	GO:1902284	GO:BP	neuron projection extension involved in neuron projection guidance	16175	22177		0.9523809523809523	1	29	16146	4	58	25	16088	16175	0.09197058161762683
M1	cpdb	0	network_modules	14	TRUE	0.007208869170176625	29	62	4	0.06451612903225806	0.13793103448275862	GO:0048846	GO:BP	axon extension involved in axon guidance	16175	13090		0.9523809523809523	1	29	16146	4	58	25	16088	16175	0.09197058161762683
M1	cpdb	0	network_modules	14	TRUE	0.008663475817886282	19	43	3	0.06976744186046512	0.15789473684210525	KEGG:00531	KEGG	Glycosaminoglycan degradation	8484	75		1	1	19	8465	3	40	16	8425	8484	0.10196030055270738
M1	cpdb	0	network_modules	15	TRUE	5.589987219043768e-41	164	60	32	0.5333333333333333	0.1951219512195122	REAC:R-HSA-168898	REAC	Toll-like Receptor Cascades	10916	2522		0	0.01818181818181818	164	10752	32	28	132	10724	10916	0.3167574693608906
M1	cpdb	0	network_modules	15	TRUE	2.7765649025434636e-33	143	60	27	0.45	0.1888111888111888	REAC:R-HSA-166016	REAC	Toll Like Receptor 4 (TLR4) Cascade	10916	2516		0.018518518518518517	0.03636363636363636	143	10773	27	33	116	10740	10916	0.2856603043012708
M1	cpdb	0	network_modules	15	TRUE	8.69534969921367e-30	106	50	23	0.46	0.2169811320754717	KEGG:04620	KEGG	Toll-like receptor signaling pathway	8484	325		0	0.037037037037037035	106	8378	23	27	83	8351	8484	0.3102019418687622
M1	cpdb	0	network_modules	15	TRUE	3.5242596044587325e-29	59	65	19	0.2923076923076923	0.3220338983050847	GO:0002224	GO:BP	toll-like receptor signaling pathway	16175	758		0	0.005714285714285714	59	16116	19	46	40	16070	16175	0.3041482359604567
M1	cpdb	0	network_modules	15	TRUE	2.5440543277275305e-26	203	65	24	0.36923076923076925	0.11822660098522167	GO:0002237	GO:BP	response to molecule of bacterial origin	16175	770		0.005747126436781609	0.011428571428571429	203	15972	24	41	179	15931	16175	0.20351899062096518
M1	cpdb	0	network_modules	15	TRUE	4.0920546744645452e-25	227	65	24	0.36923076923076925	0.10572687224669604	GO:0002221	GO:BP	pattern recognition receptor signaling pathway	16175	755		0.011494252873563218	0.017142857142857144	227	15948	24	41	203	15907	16175	0.19180333687538564
M1	cpdb	0	network_modules	15	TRUE	1.116169457536043e-24	60	65	17	0.26153846153846155	0.2833333333333333	GO:0140895	GO:BP	cell surface toll-like receptor signaling pathway	16175	19927		0.017241379310344827	0.022857142857142857	60	16115	17	48	43	16067	16175	0.2693979197220048
M1	cpdb	0	network_modules	15	TRUE	1.8665765826350272e-24	280	65	25	0.38461538461538464	0.08928571428571429	GO:0007249	GO:BP	canonical NF-kappaB signal transduction	16175	2783		0.022988505747126436	0.02857142857142857	280	15895	25	40	255	15855	16175	0.178883558192465
M1	cpdb	0	network_modules	15	TRUE	2.1978307530176127e-24	243	65	24	0.36923076923076925	0.09876543209876543	GO:0002758	GO:BP	innate immune response-activating signaling pathway	16175	1269		0.028735632183908046	0.03428571428571429	243	15932	24	41	219	15891	16175	0.18495785028934425
M1	cpdb	0	network_modules	15	TRUE	4.797189868673859e-24	152	65	21	0.3230769230769231	0.13815789473684212	GO:0071219	GO:BP	cellular response to molecule of bacterial origin	16175	16481		0.034482758620689655	0.04	152	16023	21	44	131	15979	16175	0.20651229267276255
M1	cpdb	0	network_modules	15	TRUE	7.163841161821728e-24	339	65	26	0.4	0.07669616519174041	GO:0002833	GO:BP	positive regulation of response to biotic stimulus	16175	1343		0.040229885057471264	0.045714285714285714	339	15836	26	39	313	15797	16175	0.16808061505074834
M1	cpdb	0	network_modules	15	TRUE	9.528294109425935e-24	67	65	17	0.26153846153846155	0.2537313432835821	GO:0002752	GO:BP	cell surface pattern recognition receptor signaling pathway	16175	1263		0.04597701149425287	0.05142857142857143	67	16108	17	48	50	16060	16175	0.25456414236023694
M1	cpdb	0	network_modules	15	TRUE	1.0217899256678949e-23	443	65	28	0.4307692307692308	0.06320541760722348	GO:0009617	GO:BP	response to bacterium	16175	3543		0.05172413793103448	0.05714285714285714	443	15732	28	37	415	15695	16175	0.156991128787841
M1	cpdb	0	network_modules	15	TRUE	1.5308370224725536e-23	263	65	24	0.36923076923076925	0.09125475285171103	GO:0002218	GO:BP	activation of innate immune response	16175	753		0.05747126436781609	0.06285714285714286	263	15912	24	41	239	15871	16175	0.1772768792700026
M1	cpdb	0	network_modules	15	TRUE	1.682568184791407e-23	451	65	28	0.4307692307692308	0.06208425720620843	GO:0002831	GO:BP	regulation of response to biotic stimulus	16175	1341		0.06321839080459771	0.06857142857142857	451	15724	28	37	423	15687	16175	0.15544126982174078
M1	cpdb	0	network_modules	15	TRUE	5.082261769049463e-23	319	65	25	0.38461538461538464	0.07836990595611286	GO:0045089	GO:BP	positive regulation of innate immune response	16175	11272		0.06896551724137931	0.07428571428571429	319	15856	25	40	294	15816	16175	0.16669680411768725
M1	cpdb	0	network_modules	15	TRUE	5.157569946838688e-23	654	65	31	0.47692307692307695	0.047400611620795105	GO:0031347	GO:BP	regulation of defense response	16175	7138		0.07471264367816093	0.08	654	15521	31	34	623	15487	16175	0.1407599425910226
M1	cpdb	0	network_modules	15	TRUE	6.04285311868249e-23	115	60	20	0.3333333333333333	0.17391304347826086	REAC:R-HSA-181438	REAC	Toll Like Receptor 2 (TLR2) Cascade	10916	2514		0.037037037037037035	0.07272727272727272	115	10801	20	40	95	10761	10916	0.23504695143898943
M1	cpdb	0	network_modules	15	TRUE	6.04285311868249e-23	115	60	20	0.3333333333333333	0.17391304347826086	REAC:R-HSA-168179	REAC	Toll Like Receptor TLR1:TLR2 Cascade	10916	2520		0.037037037037037035	0.07272727272727272	115	10801	20	40	95	10761	10916	0.23504695143898943
M1	cpdb	0	network_modules	15	TRUE	7.275938391779486e-23	172	65	21	0.3230769230769231	0.12209302325581395	GO:0071216	GO:BP	cellular response to biotic stimulus	16175	16478		0.08045977011494253	0.08571428571428572	172	16003	21	44	151	15959	16175	0.19349038509618985
M1	cpdb	0	network_modules	15	TRUE	4.577411981895496e-22	634	65	30	0.46153846153846156	0.0473186119873817	GO:0001817	GO:BP	regulation of cytokine production	16175	474		0.08620689655172414	0.09142857142857143	634	15541	30	35	604	15506	16175	0.13823993988817765
M1	cpdb	0	network_modules	15	TRUE	5.504404068220664e-22	638	65	30	0.46153846153846156	0.047021943573667714	GO:0001816	GO:BP	cytokine production	16175	473		0.09195402298850575	0.09714285714285714	638	15537	30	35	608	15502	16175	0.13774294212121946
M1	cpdb	0	network_modules	15	TRUE	8.579430931599216e-22	85	65	17	0.26153846153846155	0.2	GO:0002220	GO:BP	innate immune response activating cell surface receptor signaling pathway	16175	754		0.09770114942528736	0.10285714285714286	85	16090	17	48	68	16042	16175	0.2251574152852687
M1	cpdb	0	network_modules	15	TRUE	2.2633415037082437e-21	423	65	26	0.4	0.061465721040189124	GO:0031349	GO:BP	positive regulation of defense response	16175	7140		0.10344827586206896	0.10857142857142857	423	15752	26	39	397	15713	16175	0.14880271027324624
M1	cpdb	0	network_modules	15	TRUE	6.021326329814501e-21	386	65	25	0.38461538461538464	0.06476683937823834	GO:0045088	GO:BP	regulation of innate immune response	16175	11271		0.10919540229885058	0.11428571428571428	386	15789	25	40	361	15749	16175	0.150137871393605
M1	cpdb	0	network_modules	15	TRUE	1.952596162315906e-20	721	65	30	0.46153846153846156	0.04160887656033287	GO:0045087	GO:BP	innate immune response	16175	11270		0.11494252873563218	0.12	721	15454	30	35	691	15419	16175	0.12834032976226573
M1	cpdb	0	network_modules	15	TRUE	3.540887139948641e-20	531	65	27	0.4153846153846154	0.05084745762711865	GO:0032103	GO:BP	positive regulation of response to external stimulus	16175	7367		0.1206896551724138	0.12571428571428572	531	15644	27	38	504	15606	16175	0.13637264107392363
M1	cpdb	0	network_modules	15	TRUE	4.677543039105422e-20	30	60	13	0.21666666666666667	0.43333333333333335	REAC:R-HSA-5602358	REAC	Diseases associated with the TLR signaling cascade	10916	753		0.07407407407407407	0.10909090909090909	30	10886	13	47	17	10839	10916	0.3037788955613642
M1	cpdb	0	network_modules	15	TRUE	4.677543039105422e-20	30	60	13	0.21666666666666667	0.43333333333333335	REAC:R-HSA-5260271	REAC	Diseases of Immune System	10916	759		0.07407407407407407	0.10909090909090909	30	10886	13	47	17	10839	10916	0.3037788955613642
M1	cpdb	0	network_modules	15	TRUE	7.715973325902597e-20	756	65	30	0.46153846153846156	0.03968253968253968	GO:0050776	GO:BP	regulation of immune response	16175	13250		0.12643678160919541	0.13142857142857142	756	15419	30	35	726	15384	16175	0.12482529314875769
M1	cpdb	0	network_modules	15	TRUE	9.663990802057507e-20	110	65	17	0.26153846153846155	0.15454545454545454	GO:0032479	GO:BP	regulation of type I interferon production	16175	7590		0.13218390804597702	0.14285714285714285	110	16065	17	48	93	16017	16175	0.19688378846550939
M1	cpdb	0	network_modules	15	TRUE	9.663990802057507e-20	110	65	17	0.26153846153846155	0.15454545454545454	GO:0032606	GO:BP	type I interferon production	16175	7654		0.13218390804597702	0.14285714285714285	110	16065	17	48	93	16017	16175	0.19688378846550939
M1	cpdb	0	network_modules	15	TRUE	1.4589235584405125e-19	627	65	28	0.4307692307692308	0.044657097288676235	GO:0050778	GO:BP	positive regulation of immune response	16175	13252		0.14367816091954022	0.14857142857142858	627	15548	28	37	599	15511	16175	0.12899549713323846
M1	cpdb	0	network_modules	15	TRUE	4.456172993196932e-19	403	65	24	0.36923076923076925	0.05955334987593052	GO:0001819	GO:BP	positive regulation of cytokine production	16175	476		0.14942528735632185	0.15428571428571428	403	15772	24	41	379	15731	16175	0.1403182673000557
M1	cpdb	0	network_modules	15	TRUE	9.450856235788977e-19	416	65	24	0.36923076923076925	0.057692307692307696	GO:0002757	GO:BP	immune response-activating signaling pathway	16175	1268		0.15517241379310345	0.16	416	15759	24	41	392	15718	16175	0.13784283694302613
M1	cpdb	0	network_modules	15	TRUE	1.0088605673798467e-18	475	65	25	0.38461538461538464	0.05263157894736842	GO:0002253	GO:BP	activation of immune response	16175	785		0.16091954022988506	0.1657142857142857	475	15700	25	40	450	15660	16175	0.13365632837486047
M1	cpdb	0	network_modules	15	TRUE	1.055421812256026e-18	103	60	17	0.2833333333333333	0.1650485436893204	REAC:R-HSA-168181	REAC	Toll Like Receptor 7/8 (TLR7/8) Cascade	10916	2518		0.1111111111111111	0.12727272727272726	103	10813	17	43	86	10770	10916	0.21062058533446712
M1	cpdb	0	network_modules	15	TRUE	3.0227537074057274e-18	437	65	24	0.36923076923076925	0.05491990846681922	GO:0002764	GO:BP	immune response-regulating signaling pathway	16175	1275		0.16666666666666666	0.17142857142857143	437	15738	24	41	413	15697	16175	0.13407110420947307
M1	cpdb	0	network_modules	15	TRUE	4.7712640654122985e-18	112	60	17	0.2833333333333333	0.15178571428571427	REAC:R-HSA-168188	REAC	Toll Like Receptor TLR6:TLR2 Cascade	10916	2521		0.12962962962962962	0.16363636363636364	112	10804	17	43	95	10761	10916	0.20145681306404392
M1	cpdb	0	network_modules	15	TRUE	4.7712640654122985e-18	112	60	17	0.2833333333333333	0.15178571428571427	REAC:R-HSA-166058	REAC	MyD88:MAL(TIRAP) cascade initiated on plasma membrane	10916	1502		0.12962962962962962	0.16363636363636364	112	10804	17	43	95	10761	10916	0.20145681306404392
M1	cpdb	0	network_modules	15	TRUE	7.294713535666997e-18	66	65	14	0.2153846153846154	0.21212121212121213	GO:0032481	GO:BP	positive regulation of type I interferon production	16175	7592		0.1724137931034483	0.17714285714285713	66	16109	14	51	52	16058	16175	0.2105499582709643
M1	cpdb	0	network_modules	15	TRUE	1.2885755346851634e-17	594	65	26	0.4	0.04377104377104377	GO:0006954	GO:BP	inflammatory response	16175	2585		0.1781609195402299	0.18285714285714286	594	15581	26	39	568	15542	16175	0.12268735649393023
M1	cpdb	0	network_modules	15	TRUE	2.548890014619985e-17	53	65	13	0.2	0.24528301886792453	GO:0034142	GO:BP	toll-like receptor 4 signaling pathway	16175	8450		0.1839080459770115	0.18857142857142858	53	16122	13	52	40	16070	16175	0.21865614659708443
M1	cpdb	0	network_modules	15	TRUE	3.173724059441969e-17	187	65	18	0.27692307692307694	0.0962566844919786	GO:0032496	GO:BP	response to lipopolysaccharide	16175	7607		0.1896551724137931	0.19428571428571428	187	15988	18	47	169	15941	16175	0.15767908770674705
M1	cpdb	0	network_modules	15	TRUE	4.2881877855913605e-17	102	60	16	0.26666666666666666	0.1568627450980392	REAC:R-HSA-975155	REAC	MyD88 dependent cascade initiated on endosome	10916	1500		0.16666666666666666	0.18181818181818182	102	10814	16	44	86	10770	10916	0.19883318588595847
M1	cpdb	0	network_modules	15	TRUE	5.1482900519453266e-17	192	65	18	0.27692307692307694	0.09375	GO:0043123	GO:BP	positive regulation of canonical NF-kappaB signal transduction	16175	10542		0.19540229885057472	0.2	192	15983	18	47	174	15936	16175	0.15545546887313386
M1	cpdb	0	network_modules	15	TRUE	8.210127860429367e-17	106	60	16	0.26666666666666666	0.1509433962264151	REAC:R-HSA-168138	REAC	Toll Like Receptor 9 (TLR9) Cascade	10916	2519		0.18518518518518517	0.2	106	10810	16	44	90	10766	10916	0.19480382130177887
M1	cpdb	0	network_modules	15	TRUE	1.9760584913724475e-16	82	65	14	0.2153846153846154	0.17073170731707318	GO:0032677	GO:BP	regulation of interleukin-8 production	16175	7723		0.20114942528735633	0.21142857142857144	82	16093	14	51	68	16042	16175	0.18810404958489277
M1	cpdb	0	network_modules	15	TRUE	1.9760584913724475e-16	82	65	14	0.2153846153846154	0.17073170731707318	GO:0032637	GO:BP	interleukin-8 production	16175	7684		0.20114942528735633	0.21142857142857144	82	16093	14	51	68	16042	16175	0.18810404958489277
M1	cpdb	0	network_modules	15	TRUE	2.5850265712822546e-16	252	65	19	0.2923076923076923	0.07539682539682539	GO:0043122	GO:BP	regulation of canonical NF-kappaB signal transduction	16175	10541		0.21264367816091953	0.21714285714285714	252	15923	19	46	233	15877	16175	0.14193638228248573
M1	cpdb	0	network_modules	15	TRUE	3.506172155832535e-16	76	50	14	0.28	0.18421052631578946	KEGG:05133	KEGG	Pertussis	8484	430		0.038461538461538464	0.07407407407407407	76	8408	14	36	62	8372	8484	0.22148904335736722
M1	cpdb	0	network_modules	15	TRUE	4.0596755031835252e-16	142	65	16	0.24615384615384617	0.11267605633802817	GO:0071222	GO:BP	cellular response to lipopolysaccharide	16175	16484		0.21839080459770116	0.22285714285714286	142	16033	16	49	126	15984	16175	0.1616353552264953
M1	cpdb	0	network_modules	15	TRUE	6.899009888643712e-16	102	50	15	0.3	0.14705882352941177	KEGG:04064	KEGG	NF-kappa B signaling pathway	8484	256		0.07692307692307693	0.1111111111111111	102	8382	15	35	87	8347	8484	0.20344794591304455
M1	cpdb	0	network_modules	15	TRUE	9.32984526328963e-16	151	60	17	0.2833333333333333	0.11258278145695365	REAC:R-HSA-446652	REAC	Interleukin-1 family signaling	10916	1231		0.2037037037037037	0.21818181818181817	151	10765	17	43	134	10722	10916	0.1715411047138982
M1	cpdb	0	network_modules	15	TRUE	1.468786146532803e-15	51	65	12	0.18461538461538463	0.23529411764705882	GO:0032648	GO:BP	regulation of interferon-beta production	16175	7695		0.22413793103448276	0.2342857142857143	51	16124	12	53	39	16071	16175	0.2055977204104664
M1	cpdb	0	network_modules	15	TRUE	1.468786146532803e-15	51	65	12	0.18461538461538463	0.23529411764705882	GO:0032608	GO:BP	interferon-beta production	16175	7656		0.22413793103448276	0.2342857142857143	51	16124	12	53	39	16071	16175	0.2055977204104664
M1	cpdb	0	network_modules	15	TRUE	1.6195661328663365e-15	101	60	15	0.25	0.1485148514851485	REAC:R-HSA-975138	REAC	TRAF6 mediated induction of NFkB and MAP kinases upon TLR7/8 or 9 activation	10916	2468		0.2222222222222222	0.23636363636363636	101	10815	15	45	86	10770	10916	0.18693564464254825
M1	cpdb	0	network_modules	15	TRUE	4.367858669590963e-15	175	50	17	0.34	0.09714285714285714	KEGG:05152	KEGG	Tuberculosis	8484	440		0.11538461538461539	0.14814814814814814	175	8309	17	33	158	8276	8484	0.173010942651244
M1	cpdb	0	network_modules	15	TRUE	7.332649892321882e-15	27	65	10	0.15384615384615385	0.37037037037037035	GO:0070498	GO:BP	interleukin-1-mediated signaling pathway	16175	16156		0.23563218390804597	0.24	27	16148	10	55	17	16093	16175	0.23678855636668455
M1	cpdb	0	network_modules	15	TRUE	1.9329165823596108e-14	62	65	12	0.18461538461538463	0.1935483870967742	GO:0032757	GO:BP	positive regulation of interleukin-8 production	16175	7801		0.2413793103448276	0.24571428571428572	62	16113	12	53	50	16060	16175	0.18583395844393302
M1	cpdb	0	network_modules	15	TRUE	3.2899051315101e-14	116	65	14	0.2153846153846154	0.1206896551724138	GO:0032675	GO:BP	regulation of interleukin-6 production	16175	7721		0.2471264367816092	0.2571428571428571	116	16059	14	51	102	16008	16175	0.1567374976138283
M1	cpdb	0	network_modules	15	TRUE	3.2899051315101e-14	116	65	14	0.2153846153846154	0.1206896551724138	GO:0032635	GO:BP	interleukin-6 production	16175	7682		0.2471264367816092	0.2571428571428571	116	16059	14	51	102	16008	16175	0.1567374976138283
M1	cpdb	0	network_modules	15	TRUE	4.616021057864281e-14	18	60	9	0.15	0.5	REAC:R-HSA-5603041	REAC	IRAK4 deficiency (TLR2/4)	10916	1158		0.24074074074074073	0.2545454545454545	18	10898	9	51	9	10847	10916	0.2718223660786442
M1	cpdb	0	network_modules	15	TRUE	2.755497428615334e-13	21	60	9	0.15	0.42857142857142855	REAC:R-HSA-5686938	REAC	Regulation of TLR by endogenous ligand	10916	2010		0.25925925925925924	0.2727272727272727	21	10895	9	51	12	10844	10916	0.2512269841964667
M1	cpdb	0	network_modules	15	TRUE	3.340321630548118e-13	113	60	14	0.23333333333333334	0.12389380530973451	REAC:R-HSA-9020702	REAC	Interleukin-1 signaling	10916	1233		0.2777777777777778	0.2909090909090909	113	10803	14	46	99	10757	10916	0.16378033950118168
M1	cpdb	0	network_modules	15	TRUE	3.701824890357911e-13	78	65	12	0.18461538461538463	0.15384615384615385	GO:0032755	GO:BP	positive regulation of interleukin-6 production	16175	7799		0.25862068965517243	0.26285714285714284	78	16097	12	53	66	16044	16175	0.16485666594134743
M1	cpdb	0	network_modules	15	TRUE	4.209867647837796e-13	265	65	17	0.26153846153846155	0.06415094339622641	GO:0002429	GO:BP	immune response-activating cell surface receptor signaling pathway	16175	952		0.26436781609195403	0.26857142857142857	265	15910	17	48	248	15862	16175	0.12266938801614773
M1	cpdb	0	network_modules	15	TRUE	9.330493998116995e-13	41	65	10	0.15384615384615385	0.24390243902439024	GO:0140894	GO:BP	endolysosomal toll-like receptor signaling pathway	16175	19926		0.27011494252873564	0.2742857142857143	41	16134	10	55	31	16079	16175	0.19114451010941363
M1	cpdb	0	network_modules	15	TRUE	1.1967038570528856e-12	149	65	14	0.2153846153846154	0.09395973154362416	GO:0002753	GO:BP	cytoplasmic pattern recognition receptor signaling pathway	16175	1264		0.27586206896551724	0.28	149	16026	14	51	135	15975	16175	0.13708155054823024
M1	cpdb	0	network_modules	15	TRUE	1.519819587521167e-12	9	60	7	0.11666666666666667	0.7777777777777778	REAC:R-HSA-2562578	REAC	TRIF-mediated programmed cell death	10916	2472		0.2962962962962963	0.3090909090909091	9	10907	7	53	2	10854	10916	0.30005238177960764
M1	cpdb	0	network_modules	15	TRUE	1.5984091286495253e-12	287	65	17	0.26153846153846155	0.059233449477351915	GO:0002768	GO:BP	immune response-regulating cell surface receptor signaling pathway	16175	1279		0.28160919540229884	0.2857142857142857	287	15888	17	48	270	15840	16175	0.11730120727297051
M1	cpdb	0	network_modules	15	TRUE	1.7215250369775728e-12	28	65	9	0.13846153846153847	0.32142857142857145	GO:0032607	GO:BP	interferon-alpha production	16175	7655		0.28735632183908044	0.29714285714285715	28	16147	9	56	19	16091	16175	0.20892652081161953
M1	cpdb	0	network_modules	15	TRUE	1.7215250369775728e-12	28	65	9	0.13846153846153847	0.32142857142857145	GO:0032647	GO:BP	regulation of interferon-alpha production	16175	7694		0.28735632183908044	0.29714285714285715	28	16147	9	56	19	16091	16175	0.20892652081161953
M1	cpdb	0	network_modules	15	TRUE	3.0980986708785826e-12	555	65	21	0.3230769230769231	0.03783783783783784	GO:0071345	GO:BP	cellular response to cytokine stimulus	16175	16597		0.2988505747126437	0.3028571428571429	555	15620	21	44	534	15576	16175	0.10076513993879199
M1	cpdb	0	network_modules	15	TRUE	3.181125140819029e-12	18	65	8	0.12307692307692308	0.4444444444444444	GO:0002755	GO:BP	MyD88-dependent toll-like receptor signaling pathway	16175	1266		0.3045977011494253	0.30857142857142855	18	16157	8	57	10	16100	16175	0.23236385806570242
M1	cpdb	0	network_modules	15	TRUE	3.358489844603899e-12	124	65	13	0.2	0.10483870967741936	GO:0051092	GO:BP	positive regulation of NF-kappaB transcription factor activity	16175	13487		0.3103448275862069	0.3142857142857143	124	16051	13	52	111	15999	16175	0.14007061299416457
M1	cpdb	0	network_modules	15	TRUE	3.39223359330225e-12	419	65	19	0.2923076923076923	0.045346062052505964	GO:0019221	GO:BP	cytokine-mediated signaling pathway	16175	5598		0.3160919540229885	0.32	419	15756	19	46	400	15710	16175	0.10652784890350264
M1	cpdb	0	network_modules	15	TRUE	4.840228598142436e-12	17	60	8	0.13333333333333333	0.47058823529411764	REAC:R-HSA-5602498	REAC	MyD88 deficiency (TLR2/4)	10916	1498		0.3148148148148148	0.32727272727272727	17	10899	8	52	9	10847	10916	0.24844068808264852
M1	cpdb	0	network_modules	15	TRUE	8.31391727551915e-12	50	65	10	0.15384615384615385	0.2	GO:0032615	GO:BP	interleukin-12 production	16175	7663		0.3218390804597701	0.3314285714285714	50	16125	10	55	40	16070	16175	0.1725003395201483
M1	cpdb	0	network_modules	15	TRUE	8.31391727551915e-12	50	65	10	0.15384615384615385	0.2	GO:0032655	GO:BP	regulation of interleukin-12 production	16175	7702		0.3218390804597701	0.3314285714285714	50	16125	10	55	40	16070	16175	0.1725003395201483
M1	cpdb	0	network_modules	15	TRUE	2.7435314869168682e-11	101	50	12	0.24	0.1188118811881188	KEGG:05142	KEGG	Chagas disease	8484	434		0.15384615384615385	0.18518518518518517	101	8383	12	38	89	8345	8484	0.16192901062723827
M1	cpdb	0	network_modules	15	TRUE	3.248239630414879e-11	625	65	21	0.3230769230769231	0.0336	GO:0034097	GO:BP	response to cytokine	16175	8408		0.3333333333333333	0.34285714285714286	625	15550	21	44	604	15506	16175	0.09374198658303941
M1	cpdb	0	network_modules	15	TRUE	3.248239630414879e-11	625	65	21	0.3230769230769231	0.0336	GO:1901652	GO:BP	response to peptide	16175	21619		0.3333333333333333	0.34285714285714286	625	15550	21	44	604	15506	16175	0.09374198658303941
M1	cpdb	0	network_modules	15	TRUE	3.508974973837316e-11	23	65	8	0.12307692307692308	0.34782608695652173	GO:0032727	GO:BP	positive regulation of interferon-alpha production	16175	7772		0.3448275862068966	0.3485714285714286	23	16152	8	57	15	16095	16175	0.20507182791281411
M1	cpdb	0	network_modules	15	TRUE	3.938039301890104e-11	38	65	9	0.13846153846153847	0.23684210526315788	GO:0032728	GO:BP	positive regulation of interferon-beta production	16175	7773		0.3505747126436782	0.35428571428571426	38	16137	9	56	29	16081	16175	0.17858589789136153
M1	cpdb	0	network_modules	15	TRUE	3.9990174116395136e-11	7	65	6	0.09230769230769231	0.8571428571428571	GO:0071220	GO:BP	cellular response to bacterial lipoprotein	16175	16482		0.3563218390804598	0.37142857142857144	7	16168	6	59	1	16109	16175	0.28059054204190287
M1	cpdb	0	network_modules	15	TRUE	3.9990174116395136e-11	7	65	6	0.09230769230769231	0.8571428571428571	GO:0071221	GO:BP	cellular response to bacterial lipopeptide	16175	16483		0.3563218390804598	0.37142857142857144	7	16168	6	59	1	16109	16175	0.28059054204190287
M1	cpdb	0	network_modules	15	TRUE	3.9990174116395136e-11	7	65	6	0.09230769230769231	0.8571428571428571	GO:0070339	GO:BP	response to bacterial lipopeptide	16175	16061		0.3563218390804598	0.37142857142857144	7	16168	6	59	1	16109	16175	0.28059054204190287
M1	cpdb	0	network_modules	15	TRUE	5.325917051637137e-11	214	50	15	0.3	0.07009345794392523	KEGG:05417	KEGG	Lipid and atherosclerosis	8484	494		0.19230769230769232	0.2222222222222222	214	8270	15	35	199	8235	8484	0.1349236547989775
M1	cpdb	0	network_modules	15	TRUE	1.2867999887282816e-10	208	65	14	0.2153846153846154	0.0673076923076923	GO:0051091	GO:BP	positive regulation of DNA-binding transcription factor activity	16175	13486		0.3735632183908046	0.37714285714285717	208	15967	14	51	194	15916	16175	0.11417974675733372
M1	cpdb	0	network_modules	15	TRUE	1.5946039652497662e-10	8	65	6	0.09230769230769231	0.75	GO:0032493	GO:BP	response to bacterial lipoprotein	16175	7604		0.3793103448275862	0.38285714285714284	8	16167	6	59	2	16108	16175	0.2622999120712632
M1	cpdb	0	network_modules	15	TRUE	1.5975240622636314e-10	107	60	12	0.2	0.11214953271028037	REAC:R-HSA-166166	REAC	MyD88-independent TLR4 cascade 	10916	1501		0.3333333333333333	0.36363636363636365	107	10809	12	48	95	10761	10916	0.14352423718132395
M1	cpdb	0	network_modules	15	TRUE	1.5975240622636314e-10	107	60	12	0.2	0.11214953271028037	REAC:R-HSA-937061	REAC	TRIF (TICAM1)-mediated TLR4 signaling 	10916	2471		0.3333333333333333	0.36363636363636365	107	10809	12	48	95	10761	10916	0.14352423718132395
M1	cpdb	0	network_modules	15	TRUE	1.6835205728791198e-10	520	65	19	0.2923076923076923	0.03653846153846154	GO:0033993	GO:BP	response to lipid	16175	8371		0.3850574712643678	0.38857142857142857	520	15655	19	46	501	15609	16175	0.09368377241370293
M1	cpdb	0	network_modules	15	TRUE	1.7369268006243742e-10	128	65	12	0.18461538461538463	0.09375	GO:0032640	GO:BP	tumor necrosis factor production	16175	7687		0.39080459770114945	0.4	128	16047	12	53	116	15994	16175	0.1266754917493596
M1	cpdb	0	network_modules	15	TRUE	1.7369268006243742e-10	128	65	12	0.18461538461538463	0.09375	GO:0032680	GO:BP	regulation of tumor necrosis factor production	16175	7726		0.39080459770114945	0.4	128	16047	12	53	116	15994	16175	0.1266754917493596
M1	cpdb	0	network_modules	15	TRUE	2.325530976395643e-10	16	65	7	0.1076923076923077	0.4375	GO:0034134	GO:BP	toll-like receptor 2 signaling pathway	16175	8442		0.40229885057471265	0.4057142857142857	16	16159	7	58	9	16101	16175	0.21560712668993873
M1	cpdb	0	network_modules	15	TRUE	2.765775687168763e-10	133	65	12	0.18461538461538463	0.09022556390977443	GO:0071706	GO:BP	tumor necrosis factor superfamily cytokine production	16175	16870		0.40804597701149425	0.41714285714285715	133	16042	12	53	121	15989	16175	0.12407349664201359
M1	cpdb	0	network_modules	15	TRUE	2.765775687168763e-10	133	65	12	0.18461538461538463	0.09022556390977443	GO:1903555	GO:BP	regulation of tumor necrosis factor superfamily cytokine production	16175	23102		0.40804597701149425	0.41714285714285715	133	16042	12	53	121	15989	16175	0.12407349664201359
M1	cpdb	0	network_modules	15	TRUE	3.124784566995199e-10	791	65	22	0.3384615384615385	0.02781289506953224	GO:1901701	GO:BP	cellular response to oxygen-containing compound	16175	21654		0.41954022988505746	0.4228571428571429	791	15384	22	43	769	15341	16175	0.08528393974235093
M1	cpdb	0	network_modules	15	TRUE	4.0535071739922556e-10	72	65	10	0.15384615384615385	0.1388888888888889	GO:0032602	GO:BP	chemokine production	16175	7650		0.42528735632183906	0.4342857142857143	72	16103	10	55	62	16048	16175	0.14255063312442712
M1	cpdb	0	network_modules	15	TRUE	4.0535071739922556e-10	72	65	10	0.15384615384615385	0.1388888888888889	GO:0032642	GO:BP	regulation of chemokine production	16175	7689		0.42528735632183906	0.4342857142857143	72	16103	10	55	62	16048	16175	0.14255063312442712
M1	cpdb	0	network_modules	15	TRUE	4.687740919149692e-10	16	60	7	0.11666666666666667	0.4375	REAC:R-HSA-936964	REAC	Activation of IRF3, IRF7 mediated by TBK1, IKKε (IKBKE)	10916	85		0.37037037037037035	0.38181818181818183	16	10900	7	53	9	10847	10916	0.2238653988720344
M1	cpdb	0	network_modules	15	TRUE	4.832904302823514e-10	249	50	15	0.3	0.060240963855421686	KEGG:05132	KEGG	Salmonella infection	8484	429		0.23076923076923078	0.25925925925925924	249	8235	15	35	234	8200	8484	0.12346573357833268
M1	cpdb	0	network_modules	15	TRUE	5.623388835183907e-10	345	65	16	0.24615384615384617	0.0463768115942029	GO:0051090	GO:BP	regulation of DNA-binding transcription factor activity	16175	13485		0.4367816091954023	0.44	345	15830	16	49	329	15781	16175	0.09884326630439377
M1	cpdb	0	network_modules	15	TRUE	1.2001223879436144e-9	138	50	12	0.24	0.08695652173913043	KEGG:05162	KEGG	Measles	8484	443		0.2692307692307692	0.2962962962962963	138	8346	12	38	126	8308	8484	0.13618280890666257
M1	cpdb	0	network_modules	15	TRUE	1.2141419294562229e-9	80	65	10	0.15384615384615385	0.125	GO:0032760	GO:BP	positive regulation of tumor necrosis factor production	16175	7804		0.4425287356321839	0.44571428571428573	80	16095	10	55	70	16040	16175	0.13482118481343341
M1	cpdb	0	network_modules	15	TRUE	1.2753128771363921e-9	302	65	15	0.23076923076923078	0.04966887417218543	GO:0030522	GO:BP	intracellular receptor signaling pathway	16175	6836		0.4482758620689655	0.4514285714285714	302	15873	15	50	287	15823	16175	0.09953084639512423
M1	cpdb	0	network_modules	15	TRUE	1.6867231332509323e-9	142	50	12	0.24	0.08450704225352113	KEGG:04936	KEGG	Alcoholic liver disease	8484	393		0.3076923076923077	0.3333333333333333	142	8342	12	38	130	8304	8484	0.13400024734918206
M1	cpdb	0	network_modules	15	TRUE	2.010883819319229e-9	84	65	10	0.15384615384615385	0.11904761904761904	GO:1903557	GO:BP	positive regulation of tumor necrosis factor superfamily cytokine production	16175	23104		0.4540229885057471	0.45714285714285713	84	16091	10	55	74	16036	16175	0.13136981314632853
M1	cpdb	0	network_modules	15	TRUE	3.333998981260327e-9	60	65	9	0.13846153846153847	0.15	GO:0032729	GO:BP	positive regulation of type II interferon production	16175	7774		0.45977011494252873	0.46285714285714286	60	16115	9	56	51	16059	16175	0.1407984885238957
M1	cpdb	0	network_modules	15	TRUE	3.6464182336705644e-9	89	65	10	0.15384615384615385	0.11235955056179775	GO:0071347	GO:BP	cellular response to interleukin-1	16175	16599		0.46551724137931033	0.4685714285714286	89	16086	10	55	79	16031	16175	0.1273807100808449
M1	cpdb	0	network_modules	15	TRUE	4.089501527025713e-9	90	65	10	0.15384615384615385	0.1111111111111111	GO:0032609	GO:BP	type II interferon production	16175	7657		0.47126436781609193	0.48	90	16085	10	55	80	16030	16175	0.12662220711688166
M1	cpdb	0	network_modules	15	TRUE	4.089501527025713e-9	90	65	10	0.15384615384615385	0.1111111111111111	GO:0032649	GO:BP	regulation of type II interferon production	16175	7696		0.47126436781609193	0.48	90	16085	10	55	80	16030	16175	0.12662220711688166
M1	cpdb	0	network_modules	15	TRUE	5.196670106016567e-9	12	65	6	0.09230769230769231	0.5	GO:0032490	GO:BP	detection of molecule of bacterial origin	16175	7601		0.4827586206896552	0.4857142857142857	12	16163	6	59	6	16104	16175	0.21361655838743762
M1	cpdb	0	network_modules	15	TRUE	7.2423279534594e-9	408	65	16	0.24615384615384617	0.0392156862745098	GO:0071396	GO:BP	cellular response to lipid	16175	16648		0.4885057471264368	0.49142857142857144	408	15767	16	49	392	15718	16175	0.0894958203879142
M1	cpdb	0	network_modules	15	TRUE	8.00867005699219e-9	162	50	12	0.24	0.07407407407407407	KEGG:05161	KEGG	Hepatitis B	8484	442		0.34615384615384615	0.37037037037037035	162	8322	12	38	150	8284	8484	0.12428064696023935
M1	cpdb	0	network_modules	15	TRUE	1.403138714217962e-8	472	60	18	0.3	0.038135593220338986	REAC:R-HSA-449147	REAC	Signaling by Interleukins	10916	2261		0.3888888888888889	0.4	472	10444	18	42	454	10402	10916	0.09384872694252624
M1	cpdb	0	network_modules	15	TRUE	1.432892398189835e-8	13	60	6	0.1	0.46153846153846156	REAC:R-HSA-975110	REAC	TRAF6 mediated IRF7 activation in TLR7/8 or 9 signaling	10916	2466		0.4074074074074074	0.41818181818181815	13	10903	6	54	7	10849	10916	0.21298864057532133
M1	cpdb	0	network_modules	15	TRUE	1.968401733394061e-8	105	65	10	0.15384615384615385	0.09523809523809523	GO:0070555	GO:BP	response to interleukin-1	16175	16175		0.4942528735632184	0.49714285714285716	105	16070	10	55	95	16015	16175	0.1165505878625275
M1	cpdb	0	network_modules	15	TRUE	3.22332327724823e-8	7	65	5	0.07692307692307693	0.7142857142857143	GO:0008063	GO:BP	Toll signaling pathway	16175	3112		0.5	0.5028571428571429	7	16168	5	60	2	16108	16175	0.23360516994678637
M1	cpdb	0	network_modules	15	TRUE	4.143885947510247e-8	15	60	6	0.1	0.4	REAC:R-HSA-975163	REAC	IRAK2 mediated activation of TAK1 complex upon TLR7/8 or 9 stimulation	10916	1157		0.42592592592592593	0.4727272727272727	15	10901	6	54	9	10847	10916	0.1979321235063182
M1	cpdb	0	network_modules	15	TRUE	4.143885947510247e-8	15	60	6	0.1	0.4	REAC:R-HSA-140534	REAC	Caspase activation via Death Receptors in the presence of ligand	10916	313		0.42592592592592593	0.4727272727272727	15	10901	6	54	9	10847	10916	0.1979321235063182
M1	cpdb	0	network_modules	15	TRUE	4.143885947510247e-8	15	60	6	0.1	0.4	REAC:R-HSA-937072	REAC	TRAF6-mediated induction of TAK1 complex within TLR4 complex	10916	2469		0.42592592592592593	0.4727272727272727	15	10901	6	54	9	10847	10916	0.1979321235063182
M1	cpdb	0	network_modules	15	TRUE	4.447703837066075e-8	16	65	6	0.09230769230769231	0.375	GO:0002756	GO:BP	MyD88-independent toll-like receptor signaling pathway	16175	1267		0.5057471264367817	0.5085714285714286	16	16159	6	59	10	16100	16175	0.18452057078487336
M1	cpdb	0	network_modules	15	TRUE	8.568952006574426e-8	8	65	5	0.07692307692307693	0.625	GO:0038172	GO:BP	interleukin-33-mediated signaling pathway	16175	9748		0.5114942528735632	0.5142857142857142	8	16167	5	60	3	16107	16175	0.21834776167498554
M1	cpdb	0	network_modules	15	TRUE	9.165109341321569e-8	56	65	8	0.12307692307692308	0.14285714285714285	GO:0032722	GO:BP	positive regulation of chemokine production	16175	7767		0.5172413793103449	0.52	56	16119	8	57	48	16062	16175	0.12935255726362366
M1	cpdb	0	network_modules	15	TRUE	1.0334011295909682e-7	34	65	7	0.1076923076923077	0.20588235294117646	GO:0032735	GO:BP	positive regulation of interleukin-12 production	16175	7780		0.5229885057471264	0.5257142857142857	34	16141	7	58	27	16083	16175	0.14644432191846082
M1	cpdb	0	network_modules	15	TRUE	1.880786662733992e-7	167	50	11	0.22	0.0658682634730539	KEGG:05164	KEGG	Influenza A	8484	445		0.38461538461538464	0.4074074074074074	167	8317	11	39	156	8278	8484	0.11103059714691339
M1	cpdb	0	network_modules	15	TRUE	2.908524804563981e-7	39	65	7	0.1076923076923077	0.1794871794871795	GO:0031663	GO:BP	lipopolysaccharide-mediated signaling pathway	16175	7267		0.5287356321839081	0.5314285714285715	39	16136	7	58	32	16078	16175	0.1363558241994258
M1	cpdb	0	network_modules	15	TRUE	3.376497898431462e-7	120	60	10	0.16666666666666666	0.08333333333333333	REAC:R-HSA-9705671	REAC	SARS-CoV-2 activates/modulates innate and adaptive immune responses	10916	2123		0.48148148148148145	0.4909090909090909	120	10796	10	50	110	10746	10916	0.11099341743248317
M1	cpdb	0	network_modules	15	TRUE	4.330036509794441e-7	143	65	10	0.15384615384615385	0.06993006993006994	GO:0060759	GO:BP	regulation of response to cytokine stimulus	16175	14927		0.5344827586206896	0.5371428571428571	143	16032	10	55	133	15977	16175	0.09839552628031344
M1	cpdb	0	network_modules	15	TRUE	5.315510910572795e-7	146	65	10	0.15384615384615385	0.0684931506849315	GO:0062207	GO:BP	regulation of pattern recognition receptor signaling pathway	16175	15863		0.5402298850574713	0.5428571428571428	146	16029	10	55	136	15974	16175	0.09726391232972635
M1	cpdb	0	network_modules	15	TRUE	5.773619425144148e-7	72	50	8	0.16	0.1111111111111111	KEGG:05140	KEGG	Leishmaniasis	8484	433		0.4230769230769231	0.4444444444444444	72	8412	8	42	64	8370	8484	0.12717569909379836
M1	cpdb	0	network_modules	15	TRUE	5.996457068982639e-7	22	60	6	0.1	0.2727272727272727	REAC:R-HSA-937041	REAC	IKK complex recruitment mediated by RIP1	10916	1145		0.5	0.509090909090909	22	10894	6	54	16	10840	10916	0.16242657109687134
M1	cpdb	0	network_modules	15	TRUE	8.057469772403502e-7	95	60	9	0.15	0.09473684210526316	REAC:R-HSA-168176	REAC	Toll Like Receptor 5 (TLR5) Cascade	10916	2517		0.5185185185185185	0.5636363636363636	95	10821	9	51	86	10770	10916	0.11309469228318227
M1	cpdb	0	network_modules	15	TRUE	8.057469772403502e-7	95	60	9	0.15	0.09473684210526316	REAC:R-HSA-168142	REAC	Toll Like Receptor 10 (TLR10) Cascade	10916	2513		0.5185185185185185	0.5636363636363636	95	10821	9	51	86	10770	10916	0.11309469228318227
M1	cpdb	0	network_modules	15	TRUE	8.057469772403502e-7	95	60	9	0.15	0.09473684210526316	REAC:R-HSA-975871	REAC	MyD88 cascade initiated on plasma membrane	10916	1497		0.5185185185185185	0.5636363636363636	95	10821	9	51	86	10770	10916	0.11309469228318227
M1	cpdb	0	network_modules	15	TRUE	9.562868722105824e-7	25	65	6	0.09230769230769231	0.24	GO:0098581	GO:BP	detection of external biotic stimulus	16175	18798		0.5459770114942529	0.5485714285714286	25	16150	6	59	19	16091	16175	0.1467578877448462
M1	cpdb	0	network_modules	15	TRUE	1.0596464109684998e-6	334	65	13	0.2	0.038922155688622756	GO:0009615	GO:BP	response to virus	16175	3541		0.5517241379310345	0.5542857142857143	334	15841	13	52	321	15789	16175	0.08011099143996851
M1	cpdb	0	network_modules	15	TRUE	1.1969769927893486e-6	12	65	5	0.07692307692307693	0.4166666666666667	GO:0035666	GO:BP	TRIF-dependent toll-like receptor signaling pathway	16175	9146		0.5574712643678161	0.56	12	16163	5	60	7	16103	16175	0.1777253375302983
M1	cpdb	0	network_modules	15	TRUE	1.3534716379984172e-6	48	65	7	0.1076923076923077	0.14583333333333334	GO:0071496	GO:BP	cellular response to external stimulus	16175	16729		0.5632183908045977	0.5714285714285714	48	16127	7	58	41	16069	16175	0.1222940087005489
M1	cpdb	0	network_modules	15	TRUE	1.3534716379984172e-6	48	65	7	0.1076923076923077	0.14583333333333334	GO:0071260	GO:BP	cellular response to mechanical stimulus	16175	16518		0.5632183908045977	0.5714285714285714	48	16127	7	58	41	16069	16175	0.1222940087005489
M1	cpdb	0	network_modules	15	TRUE	1.4052721078970331e-6	25	60	6	0.1	0.24	REAC:R-HSA-5357769	REAC	Caspase activation via extrinsic apoptotic signalling pathway	10916	315		0.5740740740740741	0.5818181818181818	25	10891	6	54	19	10837	10916	0.15196319076967724
M1	cpdb	0	network_modules	15	TRUE	1.4911518102860154e-6	276	65	12	0.18461538461538463	0.043478260869565216	GO:0002697	GO:BP	regulation of immune effector process	16175	1215		0.5747126436781609	0.5771428571428572	276	15899	12	53	264	15846	16175	0.0821794835017302
M1	cpdb	0	network_modules	15	TRUE	1.5659202050514257e-6	79	65	8	0.12307692307692308	0.10126582278481013	GO:0002367	GO:BP	cytokine production involved in immune response	16175	899		0.5804597701149425	0.5885714285714285	79	16096	8	57	71	16039	16175	0.10768912501618025
M1	cpdb	0	network_modules	15	TRUE	1.5659202050514257e-6	79	65	8	0.12307692307692308	0.10126582278481013	GO:0002718	GO:BP	regulation of cytokine production involved in immune response	16175	1236		0.5804597701149425	0.5885714285714285	79	16096	8	57	71	16039	16175	0.10768912501618025
M1	cpdb	0	network_modules	15	TRUE	1.663733629337842e-6	103	60	9	0.15	0.08737864077669903	REAC:R-HSA-168164	REAC	Toll Like Receptor 3 (TLR3) Cascade	10916	2515		0.5925925925925926	0.6	103	10813	9	51	94	10762	10916	0.10809051445010023
M1	cpdb	0	network_modules	15	TRUE	2.436893931521467e-6	123	65	9	0.13846153846153847	0.07317073170731707	GO:0002700	GO:BP	regulation of production of molecular mediator of immune response	16175	1218		0.5919540229885057	0.5942857142857143	123	16052	9	56	114	15996	16175	0.09568276686132252
M1	cpdb	0	network_modules	15	TRUE	2.712399328422394e-6	228	65	11	0.16923076923076924	0.04824561403508772	GO:0051607	GO:BP	defense response to virus	16175	13823		0.5977011494252874	0.6	228	15947	11	54	217	15893	16175	0.08359030414820129
M1	cpdb	0	network_modules	15	TRUE	3.1596822241601543e-6	89	50	8	0.16	0.0898876404494382	KEGG:05235	KEGG	PD-L1 expression and PD-1 checkpoint pathway in cancer	8484	480		0.46153846153846156	0.48148148148148145	89	8395	8	42	81	8353	8484	0.1129881191456966
M1	cpdb	0	network_modules	15	TRUE	3.700621610902934e-6	299	65	12	0.18461538461538463	0.04013377926421405	GO:0050727	GO:BP	regulation of inflammatory response	16175	13226		0.603448275862069	0.6057142857142858	299	15876	12	53	287	15823	16175	0.07834211651444882
M1	cpdb	0	network_modules	15	TRUE	4.072219550804664e-6	536	65	15	0.23076923076923078	0.027985074626865673	GO:0002252	GO:BP	immune effector process	16175	784		0.6091954022988506	0.6114285714285714	536	15639	15	50	521	15589	16175	0.07013307150845725
M1	cpdb	0	network_modules	15	TRUE	4.787062544966321e-6	32	65	6	0.09230769230769231	0.1875	GO:0009595	GO:BP	detection of biotic stimulus	16175	3526		0.6149425287356322	0.6171428571428571	32	16143	6	59	26	16084	16175	0.12912635055996283
M1	cpdb	0	network_modules	15	TRUE	4.94717295687901e-6	6	60	4	0.06666666666666667	0.6666666666666666	REAC:R-HSA-9013957	REAC	TLR3-mediated TICAM1-dependent programmed cell death	10916	2444		0.6111111111111112	0.6181818181818182	6	10910	4	56	2	10854	10916	0.20971498856110918
M1	cpdb	0	network_modules	15	TRUE	5.53301223371661e-6	244	65	11	0.16923076923076924	0.045081967213114756	GO:0042742	GO:BP	defense response to bacterium	16175	10335		0.6206896551724138	0.6228571428571429	244	15931	11	54	233	15877	16175	0.08032825875682474
M1	cpdb	0	network_modules	15	TRUE	6.22932586208423e-6	182	50	10	0.2	0.054945054945054944	KEGG:04621	KEGG	NOD-like receptor signaling pathway	8484	326		0.5	0.5185185185185185	182	8302	10	40	172	8262	8484	0.09488475526531055
M1	cpdb	0	network_modules	15	TRUE	8.650997627869836e-6	62	65	7	0.1076923076923077	0.11290322580645161	GO:0062208	GO:BP	positive regulation of pattern recognition receptor signaling pathway	16175	15864		0.6264367816091954	0.6285714285714286	62	16113	7	58	55	16055	16175	0.10676139891768961
M1	cpdb	0	network_modules	15	TRUE	1.1315450324311535e-5	90	60	8	0.13333333333333333	0.08888888888888889	REAC:R-HSA-1236974	REAC	ER-Phagosome pathway	10916	824		0.6296296296296297	0.6363636363636364	90	10826	8	52	82	10774	10916	0.10284106004189847
M1	cpdb	0	network_modules	15	TRUE	1.4114808561590773e-5	150	65	9	0.13846153846153847	0.06	GO:0002440	GO:BP	production of molecular mediator of immune response	16175	963		0.632183908045977	0.6342857142857142	150	16025	9	56	141	15969	16175	0.08561120631089235
M1	cpdb	0	network_modules	15	TRUE	1.7197058199858037e-5	19	65	5	0.07692307692307693	0.2631578947368421	GO:1900017	GO:BP	positive regulation of cytokine production involved in inflammatory response	16175	20328		0.6379310344827587	0.64	19	16156	5	60	14	16096	16175	0.1404698375267679
M1	cpdb	0	network_modules	15	TRUE	2.2134200536013747e-5	158	50	9	0.18	0.056962025316455694	KEGG:04217	KEGG	Necroptosis	8484	294		0.5384615384615384	0.5555555555555556	158	8326	9	41	149	8285	8484	0.09191004351495974
M1	cpdb	0	network_modules	15	TRUE	2.807009197146248e-5	49	50	6	0.12	0.12244897959183673	KEGG:05144	KEGG	Malaria	8484	436		0.5769230769230769	0.5925925925925926	49	8435	6	44	43	8391	8484	0.116061251952658
M1	cpdb	0	network_modules	15	TRUE	3.818344336911433e-5	105	60	8	0.13333333333333333	0.0761904761904762	REAC:R-HSA-1236975	REAC	Antigen processing-Cross presentation	10916	153		0.6481481481481481	0.6545454545454545	105	10811	8	52	97	10759	10916	0.09423169296115191
M1	cpdb	0	network_modules	15	TRUE	4.047312782432192e-5	197	60	10	0.16666666666666666	0.050761421319796954	REAC:R-HSA-9705683	REAC	SARS-CoV-2-host interactions	10916	2128		0.6666666666666666	0.6727272727272727	197	10719	10	50	187	10669	10916	0.08299855871666965
M1	cpdb	0	network_modules	15	TRUE	4.4192319388050864e-5	78	65	7	0.1076923076923077	0.08974358974358974	GO:0046330	GO:BP	positive regulation of JNK cascade	16175	12063		0.6436781609195402	0.6457142857142857	78	16097	7	58	71	16039	16175	0.0943240369512058
M1	cpdb	0	network_modules	15	TRUE	5.762160618152738e-5	231	50	10	0.2	0.04329004329004329	KEGG:05171	KEGG	Coronavirus disease - COVID-19	8484	452		0.6153846153846154	0.6296296296296297	231	8253	10	40	221	8213	8484	0.08173931778783781
M1	cpdb	0	network_modules	15	TRUE	6.31714596243494e-5	56	50	6	0.12	0.10714285714285714	KEGG:05134	KEGG	Legionellosis	8484	431		0.6538461538461539	0.6666666666666666	56	8428	6	44	50	8384	8484	0.10782590535325354
M1	cpdb	0	network_modules	15	TRUE	6.366611630297773e-5	3	60	3	0.05	1	REAC:R-HSA-5602571	REAC	TRAF3 deficiency - HSE	10916	2463		0.6851851851851852	0.7090909090909091	3	10913	3	57	0	10856	10916	0.22302206971743874
M1	cpdb	0	network_modules	15	TRUE	6.366611630297773e-5	3	60	3	0.05	1	REAC:R-HSA-5603037	REAC	IRAK4 deficiency (TLR5)	10916	1159		0.6851851851851852	0.7090909090909091	3	10913	3	57	0	10856	10916	0.22302206971743874
M1	cpdb	0	network_modules	15	TRUE	6.736315071391212e-5	208	60	10	0.16666666666666666	0.04807692307692308	REAC:R-HSA-5357801	REAC	Programmed Cell Death	10916	1803		0.7222222222222222	0.7272727272727273	208	10708	10	50	198	10658	10916	0.08026759495553816
M1	cpdb	0	network_modules	15	TRUE	7.934396058968388e-5	50	65	6	0.09230769230769231	0.12	GO:1901224	GO:BP	positive regulation of non-canonical NF-kappaB signal transduction	16175	21318		0.6494252873563219	0.6514285714285715	50	16125	6	59	44	16066	16175	0.10208537442895842
M1	cpdb	0	network_modules	15	TRUE	9.35648293905801e-5	132	65	8	0.12307692307692308	0.06060606060606061	GO:0001959	GO:BP	regulation of cytokine-mediated signaling pathway	16175	568		0.6551724137931034	0.6571428571428571	132	16043	8	57	124	15986	16175	0.08113432464978193
M1	cpdb	0	network_modules	15	TRUE	1.0679565208580069e-4	3	65	3	0.046153846153846156	1	GO:0071725	GO:BP	response to triacyl bacterial lipopeptide	16175	16885		0.6609195402298851	0.6742857142857143	3	16172	3	62	0	16110	16175	0.21442225198906517
M1	cpdb	0	network_modules	15	TRUE	1.0679565208580069e-4	3	65	3	0.046153846153846156	1	GO:0071727	GO:BP	cellular response to triacyl bacterial lipopeptide	16175	16887		0.6609195402298851	0.6742857142857143	3	16172	3	62	0	16110	16175	0.21442225198906517
M1	cpdb	0	network_modules	15	TRUE	1.0679565208580069e-4	3	65	3	0.046153846153846156	1	GO:0070340	GO:BP	detection of bacterial lipopeptide	16175	16062		0.6609195402298851	0.6742857142857143	3	16172	3	62	0	16110	16175	0.21442225198906517
M1	cpdb	0	network_modules	15	TRUE	1.1644817266946685e-4	62	50	6	0.12	0.0967741935483871	KEGG:05321	KEGG	Inflammatory bowel disease	8484	483		0.6923076923076923	0.7037037037037037	62	8422	6	44	56	8378	8484	0.10187297145026106
M1	cpdb	0	network_modules	15	TRUE	1.322846719119807e-4	11	65	4	0.06153846153846154	0.36363636363636365	GO:0140052	GO:BP	cellular response to oxidised low-density lipoprotein particle stimulus	16175	19652		0.6781609195402298	0.68	11	16164	4	61	7	16103	16175	0.14828696013585904
M1	cpdb	0	network_modules	15	TRUE	1.4221268064423334e-4	197	50	9	0.18	0.04568527918781726	KEGG:05130	KEGG	Pathogenic Escherichia coli infection	8484	427		0.7307692307692307	0.7407407407407407	197	8287	9	41	188	8246	8484	0.08015437738382197
M1	cpdb	0	network_modules	15	TRUE	1.5408378954328102e-4	147	50	8	0.16	0.05442176870748299	KEGG:04145	KEGG	Phagosome	8484	281		0.7692307692307693	0.7777777777777778	147	8337	8	42	139	8295	8484	0.08418755612213759
M1	cpdb	0	network_modules	15	TRUE	1.592778868566469e-4	12	60	4	0.06666666666666667	0.3333333333333333	REAC:R-HSA-9013973	REAC	TICAM1-dependent activation of IRF3/IRF7	10916	2442		0.7407407407407407	0.7454545454545455	12	10904	4	56	8	10848	10916	0.14709855522848084
M1	cpdb	0	network_modules	15	TRUE	1.6491467641963534e-4	421	65	12	0.18461538461538463	0.028503562945368172	GO:0002694	GO:BP	regulation of leukocyte activation	16175	1212		0.6839080459770115	0.6857142857142857	421	15754	12	53	409	15701	16175	0.06326825507076603
M1	cpdb	0	network_modules	15	TRUE	1.752177440565163e-4	95	65	7	0.1076923076923077	0.07368421052631578	GO:0002702	GO:BP	positive regulation of production of molecular mediator of immune response	16175	1220		0.6896551724137931	0.6914285714285714	95	16080	7	58	88	16022	16175	0.08464033980403515
M1	cpdb	0	network_modules	15	TRUE	2.243697432559401e-4	108	50	7	0.14	0.06481481481481481	KEGG:05145	KEGG	Toxoplasmosis	8484	437		0.8076923076923077	0.8148148148148148	108	8376	7	43	101	8333	8484	0.08741082649292957
M1	cpdb	0	network_modules	15	TRUE	2.2912422478471527e-4	13	60	4	0.06666666666666667	0.3076923076923077	REAC:R-HSA-1679131	REAC	Trafficking and processing of endosomal TLR	10916	2531		0.7592592592592593	0.7636363636363637	13	10903	4	56	9	10847	10916	0.14113673376648866
M1	cpdb	0	network_modules	15	TRUE	2.321262670923454e-4	275	65	10	0.15384615384615385	0.03636363636363636	GO:0002696	GO:BP	positive regulation of leukocyte activation	16175	1214		0.6954022988505747	0.6971428571428572	275	15900	10	55	265	15845	16175	0.06723818457780041
M1	cpdb	0	network_modules	15	TRUE	2.860782338756377e-4	32	65	5	0.07692307692307693	0.15625	GO:0070266	GO:BP	necroptotic process	16175	16027		0.7011494252873564	0.7028571428571428	32	16143	5	60	27	16083	16175	0.1071339453761427
M1	cpdb	0	network_modules	15	TRUE	2.864490086917578e-4	102	65	7	0.1076923076923077	0.06862745098039216	GO:0038061	GO:BP	non-canonical NF-kappaB signal transduction	16175	9680		0.7068965517241379	0.7085714285714285	102	16073	7	58	95	16015	16175	0.08135492090096888
M1	cpdb	0	network_modules	15	TRUE	3.1945809580714065e-4	14	60	4	0.06666666666666667	0.2857142857142857	REAC:R-HSA-937039	REAC	IRAK1 recruits IKK complex	10916	1154		0.7777777777777778	0.8	14	10902	4	56	10	10846	10916	0.13581870372401986
M1	cpdb	0	network_modules	15	TRUE	3.1945809580714065e-4	14	60	4	0.06666666666666667	0.2857142857142857	REAC:R-HSA-975144	REAC	IRAK1 recruits IKK complex upon TLR7/8 or 9 stimulation	10916	1155		0.7777777777777778	0.8	14	10902	4	56	10	10846	10916	0.13581870372401986
M1	cpdb	0	network_modules	15	TRUE	3.274487661916819e-4	104	65	7	0.1076923076923077	0.0673076923076923	GO:0009612	GO:BP	response to mechanical stimulus	16175	3540		0.7126436781609196	0.7142857142857143	104	16071	7	58	97	16013	16175	0.0804756122995226
M1	cpdb	0	network_modules	15	TRUE	3.699727495193709e-4	459	60	13	0.21666666666666667	0.02832244008714597	REAC:R-HSA-9679506	REAC	SARS-CoV Infections	10916	2112		0.8148148148148148	0.8181818181818182	459	10457	13	47	446	10410	10916	0.06468209638355613
M1	cpdb	0	network_modules	15	TRUE	3.8001237365349675e-4	290	65	10	0.15384615384615385	0.034482758620689655	GO:0050867	GO:BP	positive regulation of cell activation	16175	13315		0.7183908045977011	0.72	290	15885	10	55	280	15830	16175	0.06506316290238587
M1	cpdb	0	network_modules	15	TRUE	4.259543130619779e-4	4	65	3	0.046153846153846156	0.75	GO:0071724	GO:BP	response to diacyl bacterial lipopeptide	16175	16884		0.7241379310344828	0.7371428571428571	4	16171	3	62	1	16109	16175	0.18545110601727055
M1	cpdb	0	network_modules	15	TRUE	4.259543130619779e-4	4	65	3	0.046153846153846156	0.75	GO:0042494	GO:BP	detection of bacterial lipoprotein	16175	10222		0.7241379310344828	0.7371428571428571	4	16171	3	62	1	16109	16175	0.18545110601727055
M1	cpdb	0	network_modules	15	TRUE	4.259543130619779e-4	4	65	3	0.046153846153846156	0.75	GO:0071726	GO:BP	cellular response to diacyl bacterial lipopeptide	16175	16886		0.7241379310344828	0.7371428571428571	4	16171	3	62	1	16109	16175	0.18545110601727055
M1	cpdb	0	network_modules	15	TRUE	4.648066264628161e-4	291	50	10	0.2	0.03436426116838488	KEGG:04060	KEGG	Cytokine-cytokine receptor interaction	8484	253		0.8461538461538461	0.8518518518518519	291	8193	10	40	281	8153	8484	0.07010092859193859
M1	cpdb	0	network_modules	15	TRUE	5.162884587429911e-4	468	65	12	0.18461538461538463	0.02564102564102564	GO:0050865	GO:BP	regulation of cell activation	16175	13313		0.7413793103448276	0.7428571428571429	468	15707	12	53	456	15654	16175	0.058995871286010707
M1	cpdb	0	network_modules	15	TRUE	5.40606544855256e-4	15	65	4	0.06153846153846154	0.26666666666666666	GO:0007252	GO:BP	I-kappaB phosphorylation	16175	2785		0.7471264367816092	0.7485714285714286	15	16160	4	61	11	16099	16175	0.12648501828249958
M1	cpdb	0	network_modules	15	TRUE	5.786873953313496e-4	113	65	7	0.1076923076923077	0.061946902654867256	GO:2001236	GO:BP	regulation of extrinsic apoptotic signaling pathway	16175	26425		0.7528735632183908	0.7542857142857143	113	16062	7	58	106	16004	16175	0.07680163250931951
M1	cpdb	0	network_modules	15	TRUE	6.308831788365689e-4	169	65	8	0.12307692307692308	0.047337278106508875	GO:0050670	GO:BP	regulation of lymphocyte proliferation	16175	13204		0.7586206896551724	0.76	169	16006	8	57	161	15949	16175	0.07035865231996506
M1	cpdb	0	network_modules	15	TRUE	6.599583566629326e-4	170	65	8	0.12307692307692308	0.047058823529411764	GO:0097191	GO:BP	extrinsic apoptotic signaling pathway	16175	18535		0.764367816091954	0.7657142857142857	170	16005	8	57	162	15948	16175	0.07011509290139967
M1	cpdb	0	network_modules	15	TRUE	6.901741669506391e-4	171	65	8	0.12307692307692308	0.04678362573099415	GO:0032944	GO:BP	regulation of mononuclear cell proliferation	16175	7929		0.7701149425287356	0.7714285714285715	171	16004	8	57	163	15947	16175	0.0698735645642454
M1	cpdb	0	network_modules	15	TRUE	6.999540008443657e-4	38	65	5	0.07692307692307693	0.13157894736842105	GO:0097300	GO:BP	programmed necrotic cell death	16175	18585		0.7758620689655172	0.7771428571428571	38	16137	5	60	33	16077	16175	0.0978444311811062
M1	cpdb	0	network_modules	15	TRUE	7.502437540710336e-4	17	60	4	0.06666666666666667	0.23529411764705882	REAC:R-HSA-1810476	REAC	RIP-mediated NFkB activation via ZBP1	10916	1876		0.8333333333333334	0.8363636363636363	17	10899	4	56	13	10843	10916	0.12275229066362867
M1	cpdb	0	network_modules	15	TRUE	7.776673608690235e-4	118	65	7	0.1076923076923077	0.059322033898305086	GO:0046328	GO:BP	regulation of JNK cascade	16175	12061		0.7816091954022989	0.7828571428571428	118	16057	7	58	111	15999	16175	0.07493783712375016
M1	cpdb	0	network_modules	15	TRUE	8.580308015464271e-4	74	65	6	0.09230769230769231	0.08108108108108109	GO:1901222	GO:BP	regulation of non-canonical NF-kappaB signal transduction	16175	21316		0.7873563218390804	0.7885714285714286	74	16101	6	59	68	16042	16175	0.08257955930551182
M1	cpdb	0	network_modules	15	TRUE	8.975523134985972e-4	177	65	8	0.12307692307692308	0.04519774011299435	GO:0002703	GO:BP	regulation of leukocyte mediated immunity	16175	1221		0.7931034482758621	0.7942857142857143	177	15998	8	57	169	15941	16175	0.06846544871960579
M1	cpdb	0	network_modules	15	TRUE	9.3692048191333e-4	17	65	4	0.06153846153846154	0.23529411764705882	GO:0034162	GO:BP	toll-like receptor 9 signaling pathway	16175	8470		0.7988505747126436	0.8	17	16158	4	61	13	16097	16175	0.11857694595299752
M1	cpdb	0	network_modules	15	TRUE	9.450400687445413e-4	699	65	14	0.2153846153846154	0.020028612303290415	GO:0045321	GO:BP	leukocyte activation	16175	11356		0.8045977011494253	0.8057142857142857	699	15476	14	51	685	15425	16175	0.05378264635428731
M1	cpdb	0	network_modules	15	TRUE	9.692050794794277e-4	40	60	5	0.08333333333333333	0.125	REAC:R-HSA-9692916	REAC	SARS-CoV-1 activates/modulates innate immune responses	10916	2115		0.8518518518518519	0.8545454545454545	40	10876	5	55	35	10821	10916	0.09802321377462207
M1	cpdb	0	network_modules	15	TRUE	0.0010364090478355943	136	50	7	0.14	0.051470588235294115	KEGG:05135	KEGG	Yersinia infection	8484	432		0.8846153846153846	0.8888888888888888	136	8348	7	43	129	8305	8484	0.07600185272614116
M1	cpdb	0	network_modules	15	TRUE	0.0012553679625700637	185	65	8	0.12307692307692308	0.043243243243243246	GO:0006909	GO:BP	phagocytosis	16175	2559		0.8103448275862069	0.8114285714285714	185	15990	8	57	177	15933	16175	0.06669005270926229
M1	cpdb	0	network_modules	15	TRUE	0.001388785172251331	334	65	10	0.15384615384615385	0.029940119760479042	GO:0002443	GO:BP	leukocyte mediated immunity	16175	966		0.8160919540229885	0.8228571428571428	334	15841	10	55	324	15786	16175	0.05949536362131461
M1	cpdb	0	network_modules	15	TRUE	0.001388785172251331	334	65	10	0.15384615384615385	0.029940119760479042	GO:0002250	GO:BP	adaptive immune response	16175	782		0.8160919540229885	0.8228571428571428	334	15841	10	55	324	15786	16175	0.05949536362131461
M1	cpdb	0	network_modules	15	TRUE	0.0014973498604513606	292	60	10	0.16666666666666666	0.03424657534246575	REAC:R-HSA-9694516	REAC	SARS-CoV-2 Infection	10916	2122		0.8703703703703703	0.8727272727272727	292	10624	10	50	282	10574	10916	0.06446724057326687
M1	cpdb	0	network_modules	15	TRUE	0.0015166559458075794	19	65	4	0.06153846153846154	0.21052631578947367	GO:0098543	GO:BP	detection of other organism	16175	18795		0.8275862068965517	0.8285714285714286	19	16156	4	61	15	16095	16175	0.11194020892310803
M1	cpdb	0	network_modules	15	TRUE	0.001535926015927532	190	65	8	0.12307692307692308	0.042105263157894736	GO:0070663	GO:BP	regulation of leukocyte proliferation	16175	16244		0.8333333333333334	0.8342857142857143	190	15985	8	57	182	15928	16175	0.06563475201734535
M1	cpdb	0	network_modules	15	TRUE	0.0016622741521735308	192	65	8	0.12307692307692308	0.041666666666666664	GO:0002699	GO:BP	positive regulation of immune effector process	16175	1217		0.8390804597701149	0.84	192	15983	8	57	184	15926	16175	0.06522357419401734
M1	cpdb	0	network_modules	15	TRUE	0.0017621559567114866	45	60	5	0.08333333333333333	0.1111111111111111	REAC:R-HSA-6783783	REAC	Interleukin-10 signaling	10916	1234		0.8888888888888888	0.8909090909090909	45	10871	5	55	40	10816	10916	0.09190696400429531
M1	cpdb	0	network_modules	15	TRUE	0.0018558926740416298	21	60	4	0.06666666666666667	0.19047619047619047	REAC:R-HSA-1606322	REAC	ZBP1(DAI) mediated induction of type I IFNs	10916	2680		0.9074074074074074	0.9090909090909091	21	10895	4	56	17	10839	10916	0.10984316008689037
M1	cpdb	0	network_modules	15	TRUE	0.0019142862684530578	434	65	11	0.16923076923076924	0.02534562211981567	GO:0002521	GO:BP	leukocyte differentiation	16175	1043		0.8448275862068966	0.8457142857142858	434	15741	11	54	423	15687	16175	0.05597573977189748
M1	cpdb	0	network_modules	15	TRUE	0.0020173586479620034	101	50	6	0.12	0.0594059405940594	KEGG:05146	KEGG	Amoebiasis	8484	438		0.9230769230769231	0.9259259259259259	101	8383	6	44	95	8339	8484	0.0767388004433885
M1	cpdb	0	network_modules	15	TRUE	0.002080347114248474	47	65	5	0.07692307692307693	0.10638297872340426	GO:1900015	GO:BP	regulation of cytokine production involved in inflammatory response	16175	20326		0.8505747126436781	0.8571428571428571	47	16128	5	60	42	16068	16175	0.08734691918635072
M1	cpdb	0	network_modules	15	TRUE	0.002080347114248474	47	65	5	0.07692307692307693	0.10638297872340426	GO:0002534	GO:BP	cytokine production involved in inflammatory response	16175	1056		0.8505747126436781	0.8571428571428571	47	16128	5	60	42	16068	16175	0.08734691918635072
M1	cpdb	0	network_modules	15	TRUE	0.0021166862407503905	638	65	13	0.2	0.02037617554858934	GO:0030097	GO:BP	hemopoiesis	16175	6675		0.8620689655172413	0.8628571428571429	638	15537	13	52	625	15485	16175	0.052394649026031935
M1	cpdb	0	network_modules	15	TRUE	0.0021175441554707	6	65	3	0.046153846153846156	0.5	GO:0070391	GO:BP	response to lipoteichoic acid	16175	16092		0.867816091954023	0.8742857142857143	6	16169	3	62	3	16107	16175	0.1510216886096173
M1	cpdb	0	network_modules	15	TRUE	0.0021175441554707	6	65	3	0.046153846153846156	0.5	GO:0071223	GO:BP	cellular response to lipoteichoic acid	16175	16485		0.867816091954023	0.8742857142857143	6	16169	3	62	3	16107	16175	0.1510216886096173
M1	cpdb	0	network_modules	15	TRUE	0.0021936121848322374	7	60	3	0.05	0.42857142857142855	REAC:R-HSA-5688849	REAC	Defective CSF2RB causes SMDP5	10916	512		0.9259259259259259	0.9454545454545454	7	10909	3	57	4	10852	10916	0.14495286513579483
M1	cpdb	0	network_modules	15	TRUE	0.0021936121848322374	7	60	3	0.05	0.42857142857142855	REAC:R-HSA-5688890	REAC	Defective CSF2RA causes SMDP4	10916	511		0.9259259259259259	0.9454545454545454	7	10909	3	57	4	10852	10916	0.14495286513579483
M1	cpdb	0	network_modules	15	TRUE	0.0025929219312801084	141	65	7	0.1076923076923077	0.04964539007092199	GO:0007254	GO:BP	JNK cascade	16175	2787		0.8793103448275862	0.88	141	16034	7	58	134	15976	16175	0.06763147778004946
M1	cpdb	0	network_modules	15	TRUE	0.003033388951125798	208	65	8	0.12307692307692308	0.038461538461538464	GO:0046651	GO:BP	lymphocyte proliferation	16175	12287		0.8850574712643678	0.8857142857142857	208	15967	8	57	200	15910	16175	0.06213849177776655
M1	cpdb	0	network_modules	15	TRUE	0.0031218391583098574	92	65	6	0.09230769230769231	0.06521739130434782	GO:0032612	GO:BP	interleukin-1 production	16175	7660		0.8908045977011494	0.8971428571428571	92	16083	6	59	86	16024	16175	0.0731633265302831
M1	cpdb	0	network_modules	15	TRUE	0.0031218391583098574	92	65	6	0.09230769230769231	0.06521739130434782	GO:0032652	GO:BP	regulation of interleukin-1 production	16175	7699		0.8908045977011494	0.8971428571428571	92	16083	6	59	86	16024	16175	0.0731633265302831
M1	cpdb	0	network_modules	15	TRUE	0.003376228592939551	211	65	8	0.12307692307692308	0.037914691943127965	GO:0032943	GO:BP	mononuclear cell proliferation	16175	7928		0.9022988505747126	0.9028571428571428	211	15964	8	57	203	15907	16175	0.06159713534190368
M1	cpdb	0	network_modules	15	TRUE	0.0034161817410734764	369	65	10	0.15384615384615385	0.02710027100271003	GO:0051249	GO:BP	regulation of lymphocyte activation	16175	13596		0.9080459770114943	0.9085714285714286	369	15806	10	55	359	15751	16175	0.05574555917171642
M1	cpdb	0	network_modules	15	TRUE	0.0040424506621727285	376	65	10	0.15384615384615385	0.026595744680851064	GO:0043410	GO:BP	positive regulation of MAPK cascade	16175	10678		0.9137931034482759	0.9142857142857143	376	15799	10	55	366	15744	16175	0.055054014968478185
M1	cpdb	0	network_modules	15	TRUE	0.004329668158543299	36	50	4	0.08	0.1111111111111111	KEGG:05143	KEGG	African trypanosomiasis	8484	435		0.9615384615384616	0.9629629629629629	36	8448	4	46	32	8402	8484	0.08973498927412087
M1	cpdb	0	network_modules	15	TRUE	0.004345877686762719	301	50	9	0.18	0.029900332225913623	KEGG:04010	KEGG	MAPK signaling pathway	8484	243		1	1	301	8183	9	41	292	8142	8484	0.06015360462518336
M1	cpdb	0	network_modules	15	TRUE	0.0046748911976001685	154	65	7	0.1076923076923077	0.045454545454545456	GO:0002819	GO:BP	regulation of adaptive immune response	16175	1329		0.9195402298850575	0.92	154	16021	7	58	147	15963	16175	0.06421451366686186
M1	cpdb	0	network_modules	15	TRUE	0.0048610358008684485	25	65	4	0.06153846153846154	0.16	GO:0071404	GO:BP	cellular response to low-density lipoprotein particle stimulus	16175	16656		0.9252873563218391	0.9257142857142857	25	16150	4	61	21	16089	16175	0.09700554120519962
M1	cpdb	0	network_modules	15	TRUE	0.005038324507452998	56	65	5	0.07692307692307693	0.08928571428571429	GO:0002720	GO:BP	positive regulation of cytokine production involved in immune response	16175	1238		0.9310344827586207	0.9371428571428572	56	16119	5	60	51	16059	16175	0.07944135464580132
M1	cpdb	0	network_modules	15	TRUE	0.005038324507452998	56	65	5	0.07692307692307693	0.08928571428571429	GO:0032731	GO:BP	positive regulation of interleukin-1 beta production	16175	7776		0.9310344827586207	0.9371428571428572	56	16119	5	60	51	16059	16175	0.07944135464580132
M1	cpdb	0	network_modules	15	TRUE	0.005223538008229571	9	60	3	0.05	0.3333333333333333	REAC:R-HSA-5687613	REAC	Diseases associated with surfactant metabolism	10916	752		0.9629629629629629	0.9636363636363636	9	10907	3	57	6	10850	10916	0.12737356485076975
M1	cpdb	0	network_modules	15	TRUE	0.005727551520921772	26	65	4	0.06153846153846154	0.15384615384615385	GO:0055094	GO:BP	response to lipoprotein particle	16175	14244		0.9425287356321839	0.9428571428571428	26	16149	4	61	22	16088	16175	0.09502667638733212
M1	cpdb	0	network_modules	15	TRUE	0.00589509318095826	8	65	3	0.046153846153846156	0.375	GO:0097527	GO:BP	necroptotic signaling pathway	16175	18687		0.9482758620689655	0.9485714285714286	8	16167	3	62	5	16105	16175	0.13044346088243022
M1	cpdb	0	network_modules	15	TRUE	0.006009082818824906	228	65	8	0.12307692307692308	0.03508771929824561	GO:0001818	GO:BP	negative regulation of cytokine production	16175	475		0.9540229885057471	0.9542857142857143	228	15947	8	57	220	15890	16175	0.058721541640666466
M1	cpdb	0	network_modules	15	TRUE	0.006257607233392577	58	60	5	0.08333333333333333	0.08620689655172414	REAC:R-HSA-5218859	REAC	Regulated Necrosis	10916	1959		0.9814814814814815	0.9818181818181818	58	10858	5	55	53	10803	10916	0.07978503541953988
M1	cpdb	0	network_modules	15	TRUE	0.006703390992768658	27	65	4	0.06153846153846154	0.14814814814814814	GO:0071402	GO:BP	cellular response to lipoprotein particle stimulus	16175	16654		0.9597701149425287	0.96	27	16148	4	61	23	16087	16175	0.09315700915966724
M1	cpdb	0	network_modules	15	TRUE	0.007126981980039718	29	60	4	0.06666666666666667	0.13793103448275862	REAC:R-HSA-5683826	REAC	Surfactant metabolism	10916	2364		1	1	29	10887	4	56	25	10831	10916	0.09244832765350186
M1	cpdb	0	network_modules	15	TRUE	0.007754168360759652	236	65	8	0.12307692307692308	0.03389830508474576	GO:0070661	GO:BP	leukocyte proliferation	16175	16242		0.9655172413793104	0.9657142857142857	236	15939	8	57	228	15882	16175	0.05747015678224484
M1	cpdb	0	network_modules	15	TRUE	0.008378409748259952	62	65	5	0.07692307692307693	0.08064516129032258	GO:0002532	GO:BP	production of molecular mediator involved in inflammatory response	16175	1054		0.9712643678160919	0.9714285714285714	62	16113	5	60	57	16053	16175	0.07513237510719226
M1	cpdb	0	network_modules	15	TRUE	0.008817232373077223	9	65	3	0.046153846153846156	0.3333333333333333	GO:0032621	GO:BP	interleukin-18 production	16175	7668		0.9770114942528736	0.9828571428571429	9	16166	3	62	6	16104	16175	0.12282055038478733
M1	cpdb	0	network_modules	15	TRUE	0.008817232373077223	9	65	3	0.046153846153846156	0.3333333333333333	GO:0032661	GO:BP	regulation of interleukin-18 production	16175	7707		0.9770114942528736	0.9828571428571429	9	16166	3	62	6	16104	16175	0.12282055038478733
M1	cpdb	0	network_modules	15	TRUE	0.009072606341262444	63	65	5	0.07692307692307693	0.07936507936507936	GO:0032732	GO:BP	positive regulation of interleukin-1 production	16175	7777		0.9885057471264368	0.9885714285714285	63	16112	5	60	58	16052	16175	0.07447296724969493
M1	cpdb	0	network_modules	15	TRUE	0.009608166390863176	619	65	12	0.18461538461538463	0.01938610662358643	GO:1901698	GO:BP	response to nitrogen compound	16175	21651		0.9942528735632183	0.9942857142857143	619	15556	12	53	607	15503	16175	0.048455279263558235
M1	cpdb	0	network_modules	15	TRUE	0.009811106705014054	64	65	5	0.07692307692307693	0.078125	GO:0070534	GO:BP	protein K63-linked ubiquitination	16175	16168		1	1	64	16111	5	60	59	16051	16175	0.07382859523752959
M1	cpdb	0	network_modules	16	TRUE	5.457587421391101e-23	44	64	15	0.234375	0.3409090909090909	GO:0140467	GO:BP	integrated stress response signaling	16175	19788		0	0.5	44	16131	15	49	29	16082	16175	0.28032204865839394
M1	cpdb	0	network_modules	16	TRUE	2.1493417773469704e-9	791	64	21	0.328125	0.02654867256637168	GO:0000122	GO:BP	negative regulation of transcription by RNA polymerase II	16175	48		1	1	791	15384	21	43	770	15341	16175	0.08160191731100144
M1	cpdb	0	network_modules	16	TRUE	2.2458555201992998e-7	15	34	5	0.14705882352941177	0.3333333333333333	REAC:R-HSA-9648895	REAC	Response of EIF2AK1 (HRI) to heme deficiency	10916	2086		0	0.08333333333333333	15	10901	5	29	10	10872	10916	0.21982837569089375
M1	cpdb	0	network_modules	16	TRUE	6.165640817197225e-7	39	34	6	0.17647058823529413	0.15384615384615385	REAC:R-HSA-9031628	REAC	NGF-stimulated transcription	10916	1527		0.09090909090909091	0.16666666666666666	39	10877	6	28	33	10849	10916	0.16197625449279615
M1	cpdb	0	network_modules	16	TRUE	9.996102045015091e-6	61	34	6	0.17647058823529413	0.09836065573770492	REAC:R-HSA-198725	REAC	Nuclear Events (kinase and transcription factor activation)	10916	1614		0.18181818181818182	0.25	61	10855	6	28	55	10827	10916	0.1281345601990192
M1	cpdb	0	network_modules	16	TRUE	8.252307809017445e-5	18	34	4	0.11764705882352941	0.2222222222222222	REAC:R-HSA-9818027	REAC	NFE2L2 regulating anti-oxidant/detoxification enzymes	10916	1521		0.2727272727272727	0.3333333333333333	18	10898	4	30	14	10868	10916	0.159804813996938
M1	cpdb	0	network_modules	16	TRUE	9.74922477131649e-5	5	34	3	0.08823529411764706	0.6	REAC:R-HSA-9707587	REAC	Regulation of HMOX1 expression and activity	10916	1976		0.36363636363636365	0.5	5	10911	3	31	2	10880	10916	0.22930489174581487
M1	cpdb	0	network_modules	16	TRUE	9.74922477131649e-5	5	34	3	0.08823529411764706	0.6	REAC:R-HSA-9818035	REAC	NFE2L2 regulating ER-stress associated genes	10916	1518		0.36363636363636365	0.5	5	10911	3	31	2	10880	10916	0.22930489174581487
M1	cpdb	0	network_modules	16	TRUE	1.8594460915421427e-4	192	29	7	0.2413793103448276	0.036458333333333336	KEGG:05202	KEGG	Transcriptional misregulation in cancer	8484	454		0	0.5	192	8292	7	22	185	8270	8484	0.08614054743744141
M1	cpdb	0	network_modules	16	TRUE	2.98783453205014e-4	132	29	6	0.20689655172413793	0.045454545454545456	KEGG:04380	KEGG	Osteoclast differentiation	8484	309		1	1	132	8352	6	23	126	8329	8484	0.09054438866688926
M1	cpdb	0	network_modules	16	TRUE	3.8482860753634744e-4	112	34	6	0.17647058823529413	0.05357142857142857	REAC:R-HSA-187037	REAC	Signaling by NTRK1 (TRKA)	10916	2284		0.5454545454545454	0.5833333333333334	112	10804	6	28	106	10776	10916	0.09219461853503277
M1	cpdb	0	network_modules	16	TRUE	4.6401006777766293e-4	27	34	4	0.11764705882352941	0.14814814814814814	REAC:R-HSA-380994	REAC	ATF4 activates genes in response to endoplasmic reticulum  stress	10916	35		0.6363636363636364	0.6666666666666666	27	10889	4	30	23	10859	10916	0.12960620109278861
M1	cpdb	0	network_modules	16	TRUE	9.403525232284065e-4	32	34	4	0.11764705882352941	0.125	REAC:R-HSA-381042	REAC	PERK regulates gene expression	10916	1664		0.7272727272727273	0.75	32	10884	4	30	28	10854	10916	0.11860466800445132
M1	cpdb	0	network_modules	16	TRUE	9.639349738639586e-4	131	34	6	0.17647058823529413	0.04580152671755725	REAC:R-HSA-166520	REAC	Signaling by NTRKs	10916	2287		0.8181818181818182	0.8333333333333334	131	10785	6	28	125	10757	10916	0.0844285270706082
M1	cpdb	0	network_modules	16	TRUE	0.0031002062731055155	92	34	5	0.14705882352941177	0.05434782608695652	REAC:R-HSA-381119	REAC	Unfolded Protein Response (UPR)	10916	2624		0.9090909090909091	0.9166666666666666	92	10824	5	29	87	10795	10916	0.08476579434924991
M1	cpdb	0	network_modules	16	TRUE	0.0036284195262841316	95	34	5	0.14705882352941177	0.05263157894736842	REAC:R-HSA-9759194	REAC	Nuclear events mediated by NFE2L2	10916	1617		1	1	95	10821	5	29	90	10792	10916	0.08326282224168838
M1	cpdb	0	network_modules	17	TRUE	3.841844467834947e-27	141	35	20	0.5714285714285714	0.14184397163120568	REAC:R-HSA-3214847	REAC	HATs acetylate histones	10916	1087		0	0.25	141	10775	20	15	121	10760	10916	0.280528677392952
M1	cpdb	0	network_modules	17	TRUE	1.0184362337302754e-26	271	35	23	0.6571428571428571	0.08487084870848709	REAC:R-HSA-3247509	REAC	Chromatin modifying enzymes	10916	355		0.3333333333333333	0.75	271	10645	23	12	248	10633	10916	0.23048383123420893
M1	cpdb	0	network_modules	17	TRUE	1.0184362337302754e-26	271	35	23	0.6571428571428571	0.08487084870848709	REAC:R-HSA-4839726	REAC	Chromatin organization	10916	356		0.3333333333333333	0.75	271	10645	23	12	248	10633	10916	0.23048383123420893
M1	cpdb	0	network_modules	17	TRUE	2.1092770987882757e-23	116	24	16	0.6666666666666666	0.13793103448275862	KEGG:03082	KEGG	ATP-dependent chromatin remodeling	8484	219		NA	1	116	8368	16	8	100	8360	8484	0.2994955498632734
M1	cpdb	0	network_modules	17	TRUE	2.683472473881935e-20	36	61	13	0.21311475409836064	0.3611111111111111	GO:1905168	GO:BP	positive regulation of double-strand break repair via homologous recombination	16175	24413		0	0.041666666666666664	36	16139	13	48	23	16091	16175	0.2753417660675996
M1	cpdb	0	network_modules	17	TRUE	2.6827372446989695e-17	57	61	13	0.21311475409836064	0.22807017543859648	GO:0045911	GO:BP	positive regulation of DNA recombination	16175	11705		0.043478260869565216	0.08333333333333333	57	16118	13	48	44	16070	16175	0.2176139507343073
M1	cpdb	0	network_modules	17	TRUE	6.124884190361932e-16	71	61	13	0.21311475409836064	0.18309859154929578	GO:0010569	GO:BP	regulation of double-strand break repair via homologous recombination	16175	4222		0.08695652173913043	0.125	71	16104	13	48	58	16056	16175	0.19426138968804016
M1	cpdb	0	network_modules	17	TRUE	4.61511001543093e-15	435	61	21	0.3442622950819672	0.04827586206896552	GO:0051052	GO:BP	regulation of DNA metabolic process	16175	13462		0.13043478260869565	0.16666666666666666	435	15740	21	40	414	15700	16175	0.1207049158440422
M1	cpdb	0	network_modules	17	TRUE	6.3634362911974354e-15	84	61	13	0.21311475409836064	0.15476190476190477	GO:2000781	GO:BP	positive regulation of double-strand break repair	16175	26037		0.17391304347826086	0.20833333333333334	84	16091	13	48	71	16043	16175	0.17798191720866144
M1	cpdb	0	network_modules	17	TRUE	3.6024239350354067e-13	113	61	13	0.21311475409836064	0.11504424778761062	GO:0000018	GO:BP	regulation of DNA recombination	16175	6		0.21739130434782608	0.25	113	16062	13	48	100	16014	16175	0.15226738314822824
M1	cpdb	0	network_modules	17	TRUE	8.659392232871328e-13	246	61	16	0.26229508196721313	0.06504065040650407	GO:0051054	GO:BP	positive regulation of DNA metabolic process	16175	13464		0.2608695652173913	0.2916666666666667	246	15929	16	45	230	15884	16175	0.12422088132817363
M1	cpdb	0	network_modules	17	TRUE	1.7167258210214884e-12	127	61	13	0.21311475409836064	0.10236220472440945	GO:0045739	GO:BP	positive regulation of DNA repair	16175	11579		0.30434782608695654	0.3333333333333333	127	16048	13	48	114	16000	16175	0.14308897033566925
M1	cpdb	0	network_modules	17	TRUE	1.905494839576701e-12	128	61	13	0.21311475409836064	0.1015625	GO:2000779	GO:BP	regulation of double-strand break repair	16175	26035		0.34782608695652173	0.375	128	16047	13	48	115	15999	16175	0.14249044394903118
M1	cpdb	0	network_modules	17	TRUE	4.2113242292727064e-11	207	61	14	0.22950819672131148	0.06763285024154589	GO:0006282	GO:BP	regulation of DNA repair	16175	2096		0.391304347826087	0.4166666666666667	207	15968	14	47	193	15921	16175	0.11862531718594128
M1	cpdb	0	network_modules	17	TRUE	9.265600187833008e-11	172	61	13	0.21311475409836064	0.0755813953488372	GO:0000724	GO:BP	double-strand break repair via homologous recombination	16175	203		0.43478260869565216	0.4583333333333333	172	16003	13	48	159	15955	16175	0.12145824655771387
M1	cpdb	0	network_modules	17	TRUE	1.248936433335742e-10	176	61	13	0.21311475409836064	0.07386363636363637	GO:0000725	GO:BP	recombinational repair	16175	204		0.4782608695652174	0.5	176	15999	13	48	163	15951	16175	0.11993845251550268
M1	cpdb	0	network_modules	17	TRUE	6.379330486516324e-9	437	61	16	0.26229508196721313	0.036613272311212815	GO:0080135	GO:BP	regulation of cellular response to stress	16175	17817		0.5217391304347826	0.5416666666666666	437	15738	16	45	421	15693	16175	0.08928397278713139
M1	cpdb	0	network_modules	17	TRUE	4.85032223530793e-8	281	61	13	0.21311475409836064	0.046263345195729534	GO:0006310	GO:BP	DNA recombination	16175	2115		0.5652173913043478	0.5833333333333334	281	15894	13	48	268	15846	16175	0.09217695847960639
M1	cpdb	0	network_modules	17	TRUE	1.0089034852849996e-7	298	61	13	0.21311475409836064	0.0436241610738255	GO:0006302	GO:BP	double-strand break repair	16175	2109		0.6086956521739131	0.625	298	15877	13	48	285	15829	16175	0.08907618957891829
M1	cpdb	0	network_modules	17	TRUE	1.1537720517172995e-6	528	61	15	0.2459016393442623	0.028409090909090908	GO:0006281	GO:BP	DNA repair	16175	2095		0.6521739130434783	0.6666666666666666	528	15647	15	46	513	15601	16175	0.07383830602563646
M1	cpdb	0	network_modules	17	TRUE	1.1841960423349273e-6	529	61	15	0.2459016393442623	0.02835538752362949	GO:0006325	GO:BP	chromatin organization	16175	2122		0.6956521739130435	0.7083333333333334	529	15646	15	46	514	15600	16175	0.073749453732524
M1	cpdb	0	network_modules	17	TRUE	1.1359528998253121e-5	30	35	5	0.14285714285714285	0.16666666666666666	REAC:R-HSA-6804758	REAC	Regulation of TP53 Activity through Acetylation	10916	2013		1	1	30	10886	5	30	25	10856	10916	0.1517868064755814
M1	cpdb	0	network_modules	17	TRUE	1.3918953310520037e-5	112	61	8	0.13114754098360656	0.07142857142857142	GO:0006275	GO:BP	regulation of DNA replication	16175	2090		0.7391304347826086	0.75	112	16063	8	53	104	16010	16175	0.09216969734099205
M1	cpdb	0	network_modules	17	TRUE	1.7011217168773426e-5	454	61	13	0.21311475409836064	0.028634361233480177	GO:0006338	GO:BP	chromatin remodeling	16175	2126		0.782608695652174	0.7916666666666666	454	15721	13	48	441	15673	16175	0.06893201501658815
M1	cpdb	0	network_modules	17	TRUE	4.1718731458099896e-5	798	61	16	0.26229508196721313	0.020050125313283207	GO:0006974	GO:BP	DNA damage response	16175	2601		0.8260869565217391	0.8333333333333334	798	15377	16	45	782	15332	16175	0.06050171366259455
M1	cpdb	0	network_modules	17	TRUE	4.6649891185756356e-5	85	61	7	0.11475409836065574	0.08235294117647059	GO:2000278	GO:BP	regulation of DNA biosynthetic process	16175	25603		0.8695652173913043	0.875	85	16090	7	54	78	16036	16175	0.09318167082615975
M1	cpdb	0	network_modules	17	TRUE	7.974451267633306e-5	3	61	3	0.04918032786885246	1	GO:0140889	GO:BP	DNA replication-dependent chromatin disassembly	16175	19924		0.9130434782608695	0.9166666666666666	3	16172	3	58	0	16114	16175	0.2213683475409664
M1	cpdb	0	network_modules	17	TRUE	0.0014448432659092429	140	61	7	0.11475409836065574	0.05	GO:0071897	GO:BP	DNA biosynthetic process	16175	16970		0.9565217391304348	0.9583333333333334	140	16035	7	54	133	15981	16175	0.07047244839154182
M1	cpdb	0	network_modules	17	TRUE	0.0036760050156047883	231	61	8	0.13114754098360656	0.03463203463203463	GO:0006260	GO:BP	DNA replication	16175	2077		1	1	231	15944	8	53	223	15891	16175	0.06060270032933473
M1	cpdb	0	network_modules	18	TRUE	1.533396773528986e-29	215	49	26	0.5306122448979592	0.12093023255813953	REAC:R-HSA-6805567	REAC	Keratinization	10916	1288		NA	1	215	10701	26	23	189	10678	10916	0.2469023097092358
M1	cpdb	0	network_modules	19	TRUE	1.0585664803684383e-4	389	56	11	0.19642857142857142	0.028277634961439587	GO:0007264	GO:BP	small GTPase-mediated signal transduction	16175	2792		0	0.16666666666666666	389	15786	11	45	378	15741	16175	0.06631977519602135
M1	cpdb	0	network_modules	19	TRUE	4.880073420808212e-4	155	40	7	0.175	0.04516129032258064	REAC:R-HSA-9013148	REAC	CDC42 GTPase cycle	10916	269		NA	1	155	10761	7	33	148	10728	10916	0.08242417032299551
M1	cpdb	0	network_modules	19	TRUE	0.0018921401062981379	7	56	3	0.05357142857142857	0.42857142857142855	GO:0032483	GO:BP	regulation of Rab protein signal transduction	16175	7594		0.2	0.3333333333333333	7	16168	3	53	4	16115	16175	0.1505922768309427
M1	cpdb	0	network_modules	19	TRUE	0.0023748395799943886	242	56	8	0.14285714285714285	0.03305785123966942	GO:0051056	GO:BP	regulation of small GTPase mediated signal transduction	16175	13466		0.4	0.5	242	15933	8	48	234	15885	16175	0.06209677109269634
M1	cpdb	0	network_modules	19	TRUE	0.0030199863304530713	8	56	3	0.05357142857142857	0.375	GO:0032482	GO:BP	Rab protein signal transduction	16175	7593		0.6	0.6666666666666666	8	16167	3	53	5	16114	16175	0.14070663794792082
M1	cpdb	0	network_modules	19	TRUE	0.004267860070143096	183	56	7	0.125	0.03825136612021858	GO:0043087	GO:BP	regulation of GTPase activity	16175	10520		0.8	0.8333333333333334	183	15992	7	49	176	15943	16175	0.06335782192368278
M1	cpdb	0	network_modules	19	TRUE	0.0068043797594569055	127	56	6	0.10714285714285714	0.047244094488188976	GO:0043547	GO:BP	positive regulation of GTPase activity	16175	10762		1	1	127	16048	6	50	121	15998	16175	0.06630829275403725
M1	cpdb	0	network_modules	20	TRUE	3.221562689331506e-99	291	64	60	0.9375	0.20618556701030927	GO:0000375	GO:BP	RNA splicing, via transesterification reactions	16175	107		0	0.037037037037037035	291	15884	60	4	231	15880	16175	0.4360162821509273
M1	cpdb	0	network_modules	20	TRUE	5.625468432772188e-98	202	61	58	0.9508196721311475	0.2871287128712871	REAC:R-HSA-72163	REAC	mRNA Splicing - Major Pathway	10916	2707		0	0.07692307692307693	202	10714	58	3	144	10711	10916	0.5185905140975143
M1	cpdb	0	network_modules	20	TRUE	5.684530512226005e-97	209	61	58	0.9508196721311475	0.27751196172248804	REAC:R-HSA-72172	REAC	mRNA Splicing	10916	2706		0.08333333333333333	0.15384615384615385	209	10707	58	3	151	10704	10916	0.5096478689770606
M1	cpdb	0	network_modules	20	TRUE	1.0649874307199294e-96	287	64	59	0.921875	0.20557491289198607	GO:0000377	GO:BP	RNA splicing, via transesterification reactions with bulged adenosine as nucleophile	16175	109		0.038461538461538464	0.1111111111111111	287	15888	59	5	228	15883	16175	0.43164736784366114
M1	cpdb	0	network_modules	20	TRUE	1.0649874307199294e-96	287	64	59	0.921875	0.20557491289198607	GO:0000398	GO:BP	mRNA splicing, via spliceosome	16175	121		0.038461538461538464	0.1111111111111111	287	15888	59	5	228	15883	16175	0.43164736784366114
M1	cpdb	0	network_modules	20	TRUE	6.25624523329894e-91	352	64	59	0.921875	0.16761363636363635	GO:0006397	GO:BP	mRNA processing	16175	2158		0.11538461538461539	0.14814814814814814	352	15823	59	5	293	15818	16175	0.388825130354489
M1	cpdb	0	network_modules	20	TRUE	2.4668687993451736e-90	397	64	60	0.9375	0.15113350125944586	GO:0008380	GO:BP	RNA splicing	16175	3186		0.15384615384615385	0.18518518518518517	397	15778	60	4	337	15774	16175	0.3718789721372352
M1	cpdb	0	network_modules	20	TRUE	5.619089266540189e-89	276	61	58	0.9508196721311475	0.21014492753623187	REAC:R-HSA-72203	REAC	Processing of Capped Intron-Containing Pre-mRNA	10916	1796		0.16666666666666666	0.23076923076923078	276	10640	58	3	218	10637	10916	0.4419583503267336
M1	cpdb	0	network_modules	20	TRUE	3.5049736977688306e-82	174	53	50	0.9433962264150944	0.28735632183908044	KEGG:03040	KEGG	Spliceosome	8484	215		NA	1	174	8310	50	3	124	8307	8484	0.5162647320218665
M1	cpdb	0	network_modules	20	TRUE	8.584395853346872e-77	590	64	59	0.921875	0.1	GO:0016071	GO:BP	mRNA metabolic process	16175	5098		0.19230769230769232	0.2222222222222222	590	15585	59	5	531	15580	16175	0.29766832542792215
M1	cpdb	0	network_modules	20	TRUE	9.192705041554339e-48	73	64	28	0.4375	0.3835616438356164	GO:0000245	GO:BP	spliceosomal complex assembly	16175	69		0.23076923076923078	0.25925925925925924	73	16102	28	36	45	16066	16175	0.40714246866914855
M1	cpdb	0	network_modules	20	TRUE	1.4626658149191934e-46	188	64	34	0.53125	0.18085106382978725	GO:0071826	GO:BP	protein-RNA complex organization	16175	16929		0.2692307692307692	0.2962962962962963	188	15987	34	30	154	15957	16175	0.3055641706647901
M1	cpdb	0	network_modules	20	TRUE	2.3177005784581503e-45	178	64	33	0.515625	0.1853932584269663	GO:0022618	GO:BP	protein-RNA complex assembly	16175	6625		0.3076923076923077	0.3333333333333333	178	15997	33	31	145	15966	16175	0.30486567229555056
M1	cpdb	0	network_modules	20	TRUE	2.8092040619473256e-42	25	64	20	0.3125	0.8	GO:1903241	GO:BP	U2-type prespliceosome assembly	16175	22851		0.34615384615384615	0.37037037037037035	25	16150	20	44	5	16106	16175	0.49889996468646924
M1	cpdb	0	network_modules	20	TRUE	1.5910134347859147e-33	390	64	33	0.515625	0.08461538461538462	GO:0022613	GO:BP	ribonucleoprotein complex biogenesis	16175	6620		0.38461538461538464	0.4074074074074074	390	15785	33	31	357	15754	16175	0.20195475056511614
M1	cpdb	0	network_modules	20	TRUE	4.488745900114851e-27	48	61	18	0.29508196721311475	0.375	REAC:R-HSA-72165	REAC	mRNA Splicing - Minor Pathway	10916	2708		0.25	0.3076923076923077	48	10868	18	43	30	10825	10916	0.32933686605816104
M1	cpdb	0	network_modules	20	TRUE	1.1693151920792503e-21	39	64	14	0.21875	0.358974358974359	GO:0000387	GO:BP	spliceosomal snRNP assembly	16175	114		0.4230769230769231	0.4444444444444444	39	16136	14	50	25	16086	16175	0.2780208339866494
M1	cpdb	0	network_modules	20	TRUE	1.4385473249344774e-13	8	64	7	0.109375	0.875	GO:0036261	GO:BP	7-methylguanosine cap hypermethylation	16175	9522		0.46153846153846156	0.48148148148148145	8	16167	7	57	1	16110	16175	0.30864771119580436
M1	cpdb	0	network_modules	20	TRUE	6.05801852093049e-11	14	64	7	0.109375	0.5	GO:0036260	GO:BP	RNA capping	16175	9521		0.5	0.5185185185185185	14	16161	7	57	7	16104	16175	0.23256401892243672
M1	cpdb	0	network_modules	20	TRUE	2.8150322876789553e-8	65	61	9	0.14754098360655737	0.13846153846153847	REAC:R-HSA-73856	REAC	RNA Polymerase II Transcription Termination	10916	1895		0.3333333333333333	0.38461538461538464	65	10851	9	52	56	10799	10916	0.1379569473518935
M1	cpdb	0	network_modules	20	TRUE	8.996118637436382e-8	18	64	6	0.09375	0.3333333333333333	GO:0045292	GO:BP	mRNA cis splicing, via spliceosome	16175	11346		0.5384615384615384	0.5555555555555556	18	16157	6	58	12	16099	16175	0.1751223993972717
M1	cpdb	0	network_modules	20	TRUE	1.1124091573793801e-7	35	64	7	0.109375	0.2	GO:0000966	GO:BP	RNA 5'-end processing	16175	274		0.5769230769230769	0.5925925925925926	35	16140	7	57	28	16083	16175	0.14542104567622335
M1	cpdb	0	network_modules	20	TRUE	4.4419150769233675e-7	10	61	5	0.08196721311475409	0.5	REAC:R-HSA-111367	REAC	SLBP independent Processing of Histone Pre-mRNAs	10916	2144		0.4166666666666667	0.46153846153846156	10	10906	5	56	5	10850	10916	0.2008352031837667
M1	cpdb	0	network_modules	20	TRUE	8.108688691742947e-7	11	61	5	0.08196721311475409	0.45454545454545453	REAC:R-HSA-77588	REAC	SLBP Dependent Processing of Replication-Dependent Histone Pre-mRNAs	10916	2143		0.5	0.5384615384615384	11	10905	5	56	6	10849	10916	0.19128119085782092
M1	cpdb	0	network_modules	20	TRUE	2.588696290304876e-6	175	64	10	0.15625	0.05714285714285714	GO:0043484	GO:BP	regulation of RNA splicing	16175	10730		0.6153846153846154	0.6296296296296297	175	16000	10	54	165	15946	16175	0.08860342465845315
M1	cpdb	0	network_modules	20	TRUE	4.456421898412907e-6	51	61	7	0.11475409836065574	0.13725490196078433	REAC:R-HSA-191859	REAC	snRNP Assembly	10916	2736		0.5833333333333334	0.7692307692307693	51	10865	7	54	44	10811	10916	0.12101246700378675
M1	cpdb	0	network_modules	20	TRUE	4.456421898412907e-6	51	61	7	0.11475409836065574	0.13725490196078433	REAC:R-HSA-194441	REAC	Metabolism of non-coding RNA	10916	1431		0.5833333333333334	0.7692307692307693	51	10865	7	54	44	10811	10916	0.12101246700378675
M1	cpdb	0	network_modules	20	TRUE	4.456421898412907e-6	51	61	7	0.11475409836065574	0.13725490196078433	REAC:R-HSA-9754678	REAC	SARS-CoV-2 modulates host translation machinery	10916	2125		0.5833333333333334	0.7692307692307693	51	10865	7	54	44	10811	10916	0.12101246700378675
M1	cpdb	0	network_modules	20	TRUE	5.538396661760081e-6	6	64	4	0.0625	0.6666666666666666	GO:0000389	GO:BP	mRNA 3'-splice site recognition	16175	116		0.6538461538461539	0.6666666666666666	6	16169	4	60	2	16109	16175	0.2033530005701321
M1	cpdb	0	network_modules	20	TRUE	2.396722402153733e-5	73	64	7	0.109375	0.0958904109589041	GO:0001510	GO:BP	RNA methylation	16175	324		0.6923076923076923	0.7037037037037037	73	16102	7	57	66	16045	16175	0.09860280125615108
M1	cpdb	0	network_modules	20	TRUE	1.6037949884000982e-4	28	61	5	0.08196721311475409	0.17857142857142858	REAC:R-HSA-75067	REAC	Processing of Capped Intronless Pre-mRNA	10916	1797		0.8333333333333334	0.8461538461538461	28	10888	5	56	23	10832	10916	0.11767733803120846
M1	cpdb	0	network_modules	20	TRUE	1.8200057898343358e-4	30	64	5	0.078125	0.16666666666666666	GO:0006376	GO:BP	mRNA splice site recognition	16175	2146		0.7307692307692307	0.7407407407407407	30	16145	5	59	25	16086	16175	0.11172458496594423
M1	cpdb	0	network_modules	20	TRUE	1.8836847859152685e-4	98	64	7	0.109375	0.07142857142857142	GO:0048024	GO:BP	regulation of mRNA splicing, via spliceosome	16175	12475		0.7692307692307693	0.7777777777777778	98	16077	7	57	91	16020	16175	0.08391240941509538
M1	cpdb	0	network_modules	20	TRUE	3.6091325638604947e-4	14	64	4	0.0625	0.2857142857142857	GO:0000244	GO:BP	spliceosomal tri-snRNP complex assembly	16175	68		0.8076923076923077	0.8148148148148148	14	16161	4	60	10	16101	16175	0.13209869813963582
M1	cpdb	0	network_modules	20	TRUE	3.927699874095345e-4	4	64	3	0.046875	0.75	GO:0000393	GO:BP	spliceosomal conformational changes to generate catalytic conformation	16175	118		0.8461538461538461	0.8518518518518519	4	16171	3	61	1	16110	16175	0.18690401528778552
M1	cpdb	0	network_modules	20	TRUE	5.332207030388974e-4	114	64	7	0.109375	0.06140350877192982	GO:0043414	GO:BP	macromolecule methylation	16175	10681		0.8846153846153846	0.8888888888888888	114	16061	7	57	107	16004	16175	0.07709477049272229
M1	cpdb	0	network_modules	20	TRUE	7.147957347972976e-4	119	64	7	0.109375	0.058823529411764705	GO:0050684	GO:BP	regulation of mRNA processing	16175	13215		0.9230769230769231	0.9259259259259259	119	16056	7	57	112	15999	16175	0.07524151544106907
M1	cpdb	0	network_modules	20	TRUE	9.988125972327654e-4	125	64	7	0.109375	0.056	GO:0032259	GO:BP	methylation	16175	7445		0.9615384615384616	0.9629629629629629	125	16050	7	57	118	15993	16175	0.07316024879875771
M1	cpdb	0	network_modules	20	TRUE	0.0038271912257423915	52	61	5	0.08196721311475409	0.09615384615384616	REAC:R-HSA-6781823	REAC	Formation of TC-NER Pre-Incision Complex	10916	951		0.9166666666666666	0.9230769230769231	52	10864	5	56	47	10808	10916	0.0840532143898454
M1	cpdb	0	network_modules	20	TRUE	0.004243691094648759	155	64	7	0.109375	0.04516129032258064	GO:0009451	GO:BP	RNA modification	16175	3498		1	1	155	16020	7	57	148	15963	16175	0.0645614091969218
M1	cpdb	0	network_modules	20	TRUE	0.009875057546011956	63	61	5	0.08196721311475409	0.07936507936507936	REAC:R-HSA-6782210	REAC	Gap-filling DNA repair synthesis and ligation in TC-NER	10916	1038		1	1	63	10853	5	56	58	10797	10916	0.07540493620456615
M1	cpdb	0	network_modules	21	TRUE	7.372005106278798e-44	632	61	43	0.7049180327868853	0.0680379746835443	GO:0030036	GO:BP	actin cytoskeleton organization	16175	6660		0	0.017857142857142856	632	15543	43	18	589	15525	16175	0.21142432935581007
M1	cpdb	0	network_modules	21	TRUE	1.842670817624158e-43	708	61	44	0.7213114754098361	0.062146892655367235	GO:0030029	GO:BP	actin filament-based process	16175	6653		0.01818181818181818	0.03571428571428571	708	15467	44	17	664	15450	16175	0.2037618798349714
M1	cpdb	0	network_modules	21	TRUE	3.462322808027823e-32	407	61	32	0.5245901639344263	0.07862407862407862	GO:0007015	GO:BP	actin filament organization	16175	2624		0.03636363636363636	0.05357142857142857	407	15768	32	29	375	15739	16175	0.1961980996547548
M1	cpdb	0	network_modules	21	TRUE	3.908110436130797e-25	748	61	33	0.5409836065573771	0.04411764705882353	GO:0097435	GO:BP	supramolecular fiber organization	16175	18657		0.05454545454545454	0.07142857142857142	748	15427	33	28	715	15399	16175	0.1449414123073932
M1	cpdb	0	network_modules	21	TRUE	2.8785614837411667e-18	193	45	19	0.4222222222222222	0.09844559585492228	KEGG:04814	KEGG	Motor proteins	8484	366		0	0.058823529411764705	193	8291	19	26	174	8265	8484	0.19564434813012216
M1	cpdb	0	network_modules	21	TRUE	1.8175043221598866e-15	227	45	18	0.4	0.07929515418502203	KEGG:04810	KEGG	Regulation of actin cytoskeleton	8484	365		0.0625	0.11764705882352941	227	8257	18	27	209	8230	8484	0.16890009738649753
M1	cpdb	0	network_modules	21	TRUE	2.1273657538693348e-14	318	50	19	0.38	0.059748427672955975	REAC:R-HSA-195258	REAC	RHO GTPase Effectors	10916	1846		0	0.02564102564102564	318	10598	19	31	299	10567	10916	0.14152477709636388
M1	cpdb	0	network_modules	21	TRUE	2.955426066164556e-13	170	45	15	0.3333333333333333	0.08823529411764706	KEGG:04530	KEGG	Tight junction	8484	317		0.125	0.17647058823529413	170	8314	15	30	155	8284	8484	0.16326243489524506
M1	cpdb	0	network_modules	21	TRUE	1.0387981380665857e-11	77	45	11	0.24444444444444444	0.14285714285714285	KEGG:05100	KEGG	Bacterial invasion of epithelial cells	8484	423		0.1875	0.23529411764705882	77	8407	11	34	66	8373	8484	0.18123578139173513
M1	cpdb	0	network_modules	21	TRUE	5.90436752576286e-11	197	45	14	0.3111111111111111	0.07106598984771574	KEGG:05130	KEGG	Pathogenic Escherichia coli infection	8484	427		0.25	0.29411764705882354	197	8287	14	31	183	8256	8484	0.13959106683106032
M1	cpdb	0	network_modules	21	TRUE	3.6730468340733435e-10	74	50	10	0.2	0.13513513513513514	REAC:R-HSA-9659379	REAC	Sensory processing of sound	10916	2201		0.02631578947368421	0.05128205128205128	74	10842	10	40	64	10802	10916	0.15973399481462539
M1	cpdb	0	network_modules	21	TRUE	4.245117589306162e-10	110	61	11	0.18032786885245902	0.1	GO:0030048	GO:BP	actin filament-based movement	16175	6667		0.07272727272727272	0.08928571428571429	110	16065	11	50	99	16015	16175	0.12990878037455103
M1	cpdb	0	network_modules	21	TRUE	9.388034344628297e-10	35	50	8	0.16	0.22857142857142856	REAC:R-HSA-5663213	REAC	RHO GTPases Activate WASPs and WAVEs	10916	1852		0.05263157894736842	0.07692307692307693	35	10881	8	42	27	10839	10916	0.1881368432630115
M1	cpdb	0	network_modules	21	TRUE	2.340260198568452e-9	449	50	17	0.34	0.0378619153674833	REAC:R-HSA-9012999	REAC	RHO GTPase cycle	10916	1847		0.07894736842105263	0.10256410256410256	449	10467	17	33	432	10434	10916	0.10208417009427852
M1	cpdb	0	network_modules	21	TRUE	2.7720477419224435e-9	90	50	10	0.2	0.1111111111111111	REAC:R-HSA-2682334	REAC	EPH-Ephrin signaling	10916	818		0.10526315789473684	0.1282051282051282	90	10826	10	40	80	10786	10916	0.14384859082315507
M1	cpdb	0	network_modules	21	TRUE	3.0153999083490864e-9	40	50	8	0.16	0.2	REAC:R-HSA-3928662	REAC	EPHB-mediated forward signaling	10916	821		0.13157894736842105	0.15384615384615385	40	10876	8	42	32	10834	10916	0.1755121226799129
M1	cpdb	0	network_modules	21	TRUE	5.139651254424448e-9	66	50	9	0.18	0.13636363636363635	REAC:R-HSA-9662360	REAC	Sensory processing of sound by inner hair cells of the cochlea	10916	2202		0.15789473684210525	0.1794871794871795	66	10850	9	41	57	10809	10916	0.1522161857899799
M1	cpdb	0	network_modules	21	TRUE	1.883749024083795e-8	50	61	8	0.13114754098360656	0.16	GO:0045010	GO:BP	actin nucleation	16175	11227		0.09090909090909091	0.10714285714285714	50	16125	8	53	42	16072	16175	0.1419298635607731
M1	cpdb	0	network_modules	21	TRUE	2.1864203730954816e-8	150	50	11	0.22	0.07333333333333333	REAC:R-HSA-1500931	REAC	Cell-Cell communication	10916	328		0.18421052631578946	0.20512820512820512	150	10766	11	39	139	10727	10916	0.1201857958557293
M1	cpdb	0	network_modules	21	TRUE	2.7850772633500576e-8	113	50	10	0.2	0.08849557522123894	REAC:R-HSA-9664422	REAC	FCGR3A-mediated phagocytosis	10916	899		0.21052631578947367	0.28205128205128205	113	10803	10	40	103	10763	10916	0.12710160838188145
M1	cpdb	0	network_modules	21	TRUE	2.7850772633500576e-8	113	50	10	0.2	0.08849557522123894	REAC:R-HSA-9664407	REAC	Parasite infection	10916	1716		0.21052631578947367	0.28205128205128205	113	10803	10	40	103	10763	10916	0.12710160838188145
M1	cpdb	0	network_modules	21	TRUE	2.7850772633500576e-8	113	50	10	0.2	0.08849557522123894	REAC:R-HSA-9664417	REAC	Leishmania phagocytosis	10916	1312		0.21052631578947367	0.28205128205128205	113	10803	10	40	103	10763	10916	0.12710160838188145
M1	cpdb	0	network_modules	21	TRUE	3.4352288640697887e-8	215	61	12	0.19672131147540983	0.05581395348837209	GO:0110053	GO:BP	regulation of actin filament organization	16175	19377		0.10909090909090909	0.125	215	15960	12	49	203	15911	16175	0.0985462973931156
M1	cpdb	0	network_modules	21	TRUE	3.6223701509202255e-8	116	50	10	0.2	0.08620689655172414	REAC:R-HSA-2029482	REAC	Regulation of actin dynamics for phagocytic cup formation	10916	2020		0.2894736842105263	0.3076923076923077	116	10800	10	40	106	10760	10916	0.12528289367279952
M1	cpdb	0	network_modules	21	TRUE	7.357467203642277e-8	35	61	7	0.11475409836065574	0.2	GO:0030834	GO:BP	regulation of actin filament depolymerization	16175	6919		0.12727272727272726	0.14285714285714285	35	16140	7	54	28	16086	16175	0.14908109783437173
M1	cpdb	0	network_modules	21	TRUE	8.383404553773222e-8	36	50	7	0.14	0.19444444444444445	REAC:R-HSA-390522	REAC	Striated Muscle Contraction	10916	2356		0.3157894736842105	0.3333333333333333	36	10880	7	43	29	10837	10916	0.16174211990385656
M1	cpdb	0	network_modules	21	TRUE	1.4181047941948326e-7	21	50	6	0.12	0.2857142857142857	REAC:R-HSA-5627123	REAC	RHO GTPases activate PAKs	10916	1856		0.34210526315789475	0.358974358974359	21	10895	6	44	15	10851	10916	0.18279017548924098
M1	cpdb	0	network_modules	21	TRUE	1.520020877857813e-7	308	61	13	0.21311475409836064	0.04220779220779221	GO:0032970	GO:BP	regulation of actin filament-based process	16175	7953		0.14545454545454545	0.16071428571428573	308	15867	13	48	295	15819	16175	0.08736750407082054
M1	cpdb	0	network_modules	21	TRUE	2.010199122261214e-7	40	61	7	0.11475409836065574	0.175	GO:0030042	GO:BP	actin filament depolymerization	16175	6663		0.16363636363636364	0.17857142857142858	40	16135	7	54	33	16081	16175	0.1390912737749791
M1	cpdb	0	network_modules	21	TRUE	2.2576040911180227e-7	318	61	13	0.21311475409836064	0.040880503144654086	GO:1902903	GO:BP	regulation of supramolecular fiber organization	16175	22602		0.18181818181818182	0.19642857142857142	318	15857	13	48	305	15809	16175	0.08573594327356088
M1	cpdb	0	network_modules	21	TRUE	2.3499805866672965e-7	140	50	10	0.2	0.07142857142857142	REAC:R-HSA-2029480	REAC	Fcgamma receptor (FCGR) dependent phagocytosis	10916	939		0.3684210526315789	0.38461538461538464	140	10776	10	40	130	10736	10916	0.1128413368160869
M1	cpdb	0	network_modules	21	TRUE	2.652685750070293e-7	246	45	12	0.26666666666666666	0.04878048780487805	KEGG:05131	KEGG	Shigellosis	8484	428		0.3125	0.35294117647058826	246	8238	12	33	234	8205	8484	0.10343297227367974
M1	cpdb	0	network_modules	21	TRUE	2.891894690383294e-7	42	61	7	0.11475409836065574	0.16666666666666666	GO:0034314	GO:BP	Arp2/3 complex-mediated actin nucleation	16175	8568		0.2	0.21428571428571427	42	16133	7	54	35	16079	16175	0.13559810810808007
M1	cpdb	0	network_modules	21	TRUE	3.101875758026665e-7	144	50	10	0.2	0.06944444444444445	REAC:R-HSA-8856828	REAC	Clathrin-mediated endocytosis	10916	372		0.39473684210526316	0.41025641025641024	144	10772	10	40	134	10732	10916	0.11106585286464021
M1	cpdb	0	network_modules	21	TRUE	5.713213984025562e-7	274	61	12	0.19672131147540983	0.043795620437956206	GO:0032956	GO:BP	regulation of actin cytoskeleton organization	16175	7940		0.21818181818181817	0.23214285714285715	274	15901	12	49	262	15852	16175	0.08571666061225866
M1	cpdb	0	network_modules	21	TRUE	6.19845911465682e-7	793	61	18	0.29508196721311475	0.02269861286254729	GO:0044087	GO:BP	regulation of cellular component biogenesis	16175	10909		0.23636363636363636	0.25	793	15382	18	43	775	15339	16175	0.07011290250129028
M1	cpdb	0	network_modules	21	TRUE	9.719846160941402e-7	27	61	6	0.09836065573770492	0.2222222222222222	GO:0030835	GO:BP	negative regulation of actin filament depolymerization	16175	6920		0.2545454545454545	0.26785714285714285	27	16148	6	55	21	16093	16175	0.14573175061772292
M1	cpdb	0	network_modules	21	TRUE	1.3279819711098076e-6	173	61	10	0.16393442622950818	0.057803468208092484	GO:0031032	GO:BP	actomyosin structure organization	16175	7004		0.2727272727272727	0.2857142857142857	173	16002	10	51	163	15951	16175	0.09165715912966775
M1	cpdb	0	network_modules	21	TRUE	1.4596423431289798e-6	53	50	7	0.14	0.1320754716981132	REAC:R-HSA-9662361	REAC	Sensory processing of sound by outer hair cells of the cochlea	10916	2203		0.42105263157894735	0.4358974358974359	53	10863	7	43	46	10820	10916	0.13188639783151887
M1	cpdb	0	network_modules	21	TRUE	2.437836429545351e-6	96	45	8	0.17777777777777778	0.08333333333333333	KEGG:04666	KEGG	Fc gamma R-mediated phagocytosis	8484	341		0.375	0.4117647058823529	96	8388	8	37	88	8351	8484	0.11492450576445948
M1	cpdb	0	network_modules	21	TRUE	5.5770377953422124e-6	63	61	7	0.11475409836065574	0.1111111111111111	GO:1901879	GO:BP	regulation of protein depolymerization	16175	21823		0.2909090909090909	0.30357142857142855	63	16112	7	54	56	16058	16175	0.10950507866288427
M1	cpdb	0	network_modules	21	TRUE	5.7479494613895575e-6	37	50	6	0.12	0.16216216216216217	REAC:R-HSA-9013424	REAC	RHOV GTPase cycle	10916	1875		0.4473684210526316	0.46153846153846156	37	10879	6	44	31	10835	10916	0.13609930628056582
M1	cpdb	0	network_modules	21	TRUE	5.768575313070769e-6	202	45	10	0.2222222222222222	0.04950495049504951	KEGG:04510	KEGG	Focal adhesion	8484	313		0.4375	0.47058823529411764	202	8282	10	35	192	8247	8484	0.09503587749389551
M1	cpdb	0	network_modules	21	TRUE	7.395767037923049e-6	19	50	5	0.1	0.2631578947368421	REAC:R-HSA-5625900	REAC	RHO GTPases activate CIT	10916	1853		0.47368421052631576	0.48717948717948717	19	10897	5	45	14	10852	10916	0.15990338908087415
M1	cpdb	0	network_modules	21	TRUE	8.31894031654769e-6	18	61	5	0.08196721311475409	0.2777777777777778	GO:0030050	GO:BP	vesicle transport along actin filament	16175	6669		0.3090909090909091	0.32142857142857145	18	16157	5	56	13	16101	16175	0.14920881749023107
M1	cpdb	0	network_modules	21	TRUE	1.1710571070517883e-5	440	61	13	0.21311475409836064	0.029545454545454545	GO:0051493	GO:BP	regulation of cytoskeleton organization	16175	13748		0.32727272727272727	0.3392857142857143	440	15735	13	48	427	15687	16175	0.07031628132612015
M1	cpdb	0	network_modules	21	TRUE	1.4763257738987654e-5	43	50	6	0.12	0.13953488372093023	REAC:R-HSA-445355	REAC	Smooth Muscle Contraction	10916	2336		0.5	0.5128205128205128	43	10873	6	44	37	10829	10916	0.12568701790276124
M1	cpdb	0	network_modules	21	TRUE	1.4935712923000413e-5	113	61	8	0.13114754098360656	0.07079646017699115	GO:0008064	GO:BP	regulation of actin polymerization or depolymerization	16175	3113		0.34545454545454546	0.35714285714285715	113	16062	8	53	105	16009	16175	0.09171814765977322
M1	cpdb	0	network_modules	21	TRUE	1.496153786590447e-5	215	50	10	0.2	0.046511627906976744	REAC:R-HSA-9658195	REAC	Leishmania infection	10916	1310		0.5263157894736842	0.5641025641025641	215	10701	10	40	205	10661	10916	0.08802133827902395
M1	cpdb	0	network_modules	21	TRUE	1.496153786590447e-5	215	50	10	0.2	0.046511627906976744	REAC:R-HSA-9824443	REAC	Parasitic Infection Pathways	10916	1717		0.5263157894736842	0.5641025641025641	215	10701	10	40	205	10661	10916	0.08802133827902395
M1	cpdb	0	network_modules	21	TRUE	1.4966593332126939e-5	20	61	5	0.08196721311475409	0.25	GO:0099515	GO:BP	actin filament-based transport	16175	19105		0.36363636363636365	0.375	20	16155	5	56	15	16099	16175	0.1413441914383507
M1	cpdb	0	network_modules	21	TRUE	1.595010732848987e-5	73	61	7	0.11475409836065574	0.0958904109589041	GO:0097581	GO:BP	lamellipodium organization	16175	18706		0.38181818181818183	0.39285714285714285	73	16102	7	54	66	16048	16175	0.10119269809761781
M1	cpdb	0	network_modules	21	TRUE	1.838077495568919e-5	116	61	8	0.13114754098360656	0.06896551724137931	GO:0030832	GO:BP	regulation of actin filament length	16175	6917		0.4	0.4107142857142857	116	16059	8	53	108	16006	16175	0.09039758602904774
M1	cpdb	0	network_modules	21	TRUE	2.1109186590788655e-5	23	50	5	0.1	0.21739130434782608	REAC:R-HSA-373753	REAC	Nephrin family interactions	10916	1582		0.5789473684210527	0.5897435897435898	23	10893	5	45	18	10848	10916	0.14481970278588222
M1	cpdb	0	network_modules	21	TRUE	3.700017784779625e-5	136	45	8	0.17777777777777778	0.058823529411764705	KEGG:05135	KEGG	Yersinia infection	8484	432		0.5	0.5294117647058824	136	8348	8	37	128	8311	8484	0.09404562634727272
M1	cpdb	0	network_modules	21	TRUE	3.755195293778974e-5	127	61	8	0.13114754098360656	0.06299212598425197	GO:0051494	GO:BP	negative regulation of cytoskeleton organization	16175	13749		0.41818181818181815	0.42857142857142855	127	16048	8	53	119	15995	16175	0.08594960947743112
M1	cpdb	0	network_modules	21	TRUE	3.902472876412079e-5	93	45	7	0.15555555555555556	0.07526881720430108	KEGG:04520	KEGG	Adherens junction	8484	316		0.5625	0.5882352941176471	93	8391	7	38	86	8353	8484	0.10140575313922442
M1	cpdb	0	network_modules	21	TRUE	4.0559328856917205e-5	24	61	5	0.08196721311475409	0.20833333333333334	GO:0051016	GO:BP	barbed-end actin filament capping	16175	13441		0.43636363636363634	0.4642857142857143	24	16151	5	56	19	16095	16175	0.12864968833138613
M1	cpdb	0	network_modules	21	TRUE	4.0559328856917205e-5	24	61	5	0.08196721311475409	0.20833333333333334	GO:0051693	GO:BP	actin filament capping	16175	13896		0.43636363636363634	0.4642857142857143	24	16151	5	56	19	16095	16175	0.12864968833138613
M1	cpdb	0	network_modules	21	TRUE	4.076759551000032e-5	249	45	10	0.2222222222222222	0.040160642570281124	KEGG:05132	KEGG	Salmonella infection	8484	429		0.625	0.6470588235294118	249	8235	10	35	239	8200	8484	0.08344514343746093
M1	cpdb	0	network_modules	21	TRUE	4.245466419217352e-5	129	61	8	0.13114754098360656	0.06201550387596899	GO:1902904	GO:BP	negative regulation of supramolecular fiber organization	16175	22603		0.4727272727272727	0.48214285714285715	129	16046	8	53	121	15993	16175	0.0852005160414308
M1	cpdb	0	network_modules	21	TRUE	4.306131736529337e-5	49	61	6	0.09836065573770492	0.12244897959183673	GO:1901880	GO:BP	negative regulation of protein depolymerization	16175	21824		0.4909090909090909	0.5	49	16126	6	55	43	16071	16175	0.1067288000496341
M1	cpdb	0	network_modules	21	TRUE	5.208933198753214e-5	97	45	7	0.15555555555555556	0.07216494845360824	KEGG:05410	KEGG	Hypertrophic cardiomyopathy	8484	489		0.6875	0.7058823529411765	97	8387	7	38	90	8349	8484	0.09899273577112949
M1	cpdb	0	network_modules	21	TRUE	6.17459648377684e-5	258	61	10	0.16393442622950818	0.03875968992248062	GO:0006936	GO:BP	muscle contraction	16175	2575		0.509090909090909	0.5178571428571429	258	15917	10	51	248	15866	16175	0.07267440611685946
M1	cpdb	0	network_modules	21	TRUE	7.341802363689796e-5	102	45	7	0.15555555555555556	0.06862745098039216	KEGG:05414	KEGG	Dilated cardiomyopathy	8484	491		0.75	0.7647058823529411	102	8382	7	38	95	8344	8484	0.096169873231549
M1	cpdb	0	network_modules	21	TRUE	7.832846371170162e-5	205	45	9	0.2	0.04390243902439024	KEGG:05205	KEGG	Proteoglycans in cancer	8484	457		0.8125	0.8235294117647058	205	8279	9	36	196	8243	8484	0.08361910106828724
M1	cpdb	0	network_modules	21	TRUE	8.746425366021115e-5	93	61	7	0.11475409836065574	0.07526881720430108	GO:0051261	GO:BP	protein depolymerization	16175	13608		0.5272727272727272	0.5357142857142857	93	16082	7	54	86	16028	16175	0.08870342528808557
M1	cpdb	0	network_modules	21	TRUE	9.199079795311165e-5	346	61	11	0.18032786885245902	0.031791907514450865	GO:0034329	GO:BP	cell junction assembly	16175	8571		0.5454545454545454	0.5535714285714286	346	15829	11	50	335	15779	16175	0.06758764184427625
M1	cpdb	0	network_modules	21	TRUE	1.0369663750339501e-4	31	50	5	0.1	0.16129032258064516	REAC:R-HSA-445095	REAC	Interaction between L1 and Ankyrins	10916	1219		0.6052631578947368	0.6153846153846154	31	10885	5	45	26	10840	10916	0.12385305143298925
M1	cpdb	0	network_modules	21	TRUE	1.0916580763682056e-4	57	61	6	0.09836065573770492	0.10526315789473684	GO:0032272	GO:BP	negative regulation of protein polymerization	16175	7453		0.5636363636363636	0.5714285714285714	57	16118	6	55	51	16063	16175	0.09846705583255805
M1	cpdb	0	network_modules	21	TRUE	1.124651133721623e-4	533	61	13	0.21311475409836064	0.024390243902439025	GO:0034330	GO:BP	cell junction organization	16175	8572		0.5818181818181818	0.5892857142857143	533	15642	13	48	520	15594	16175	0.06209585130335375
M1	cpdb	0	network_modules	21	TRUE	1.1722040211465377e-4	97	61	7	0.11475409836065574	0.07216494845360824	GO:0043244	GO:BP	regulation of protein-containing complex disassembly	16175	10582		0.6	0.6071428571428571	97	16078	7	54	90	16024	16175	0.08666896776995538
M1	cpdb	0	network_modules	21	TRUE	1.173048238563039e-4	203	50	9	0.18	0.04433497536945813	REAC:R-HSA-397014	REAC	Muscle contraction	10916	1496		0.631578947368421	0.6410256410256411	203	10713	9	41	194	10672	10916	0.08104438035452863
M1	cpdb	0	network_modules	21	TRUE	1.492939533545372e-4	60	61	6	0.09836065573770492	0.1	GO:0043242	GO:BP	negative regulation of protein-containing complex disassembly	16175	10580		0.6181818181818182	0.625	60	16115	6	55	54	16060	16175	0.09579503449069891
M1	cpdb	0	network_modules	21	TRUE	1.605416204781952e-4	153	61	8	0.13114754098360656	0.05228758169934641	GO:0008154	GO:BP	actin polymerization or depolymerization	16175	3127		0.6363636363636364	0.6428571428571429	153	16022	8	53	145	15969	16175	0.07734869364003934
M1	cpdb	0	network_modules	21	TRUE	2.7780737373456855e-4	303	61	10	0.16393442622950818	0.033003300330033	GO:0003012	GO:BP	muscle system process	16175	1463		0.6545454545454545	0.6607142857142857	303	15872	10	51	293	15821	16175	0.06589347753320647
M1	cpdb	0	network_modules	21	TRUE	3.154702097406117e-4	114	50	7	0.14	0.06140350877192982	REAC:R-HSA-446728	REAC	Cell junction organization	10916	324		0.6578947368421053	0.6666666666666666	114	10802	7	43	107	10759	10916	0.08645074818909794
M1	cpdb	0	network_modules	21	TRUE	3.572245374159672e-4	114	61	7	0.11475409836065574	0.06140350877192982	GO:0031333	GO:BP	negative regulation of protein-containing complex assembly	16175	7124		0.6727272727272727	0.6785714285714286	114	16061	7	54	107	16007	16175	0.07921536969624489
M1	cpdb	0	network_modules	21	TRUE	3.795025051494955e-4	248	45	9	0.2	0.036290322580645164	KEGG:04144	KEGG	Endocytosis	8484	280		0.875	0.8823529411764706	248	8236	9	36	239	8200	8484	0.07402615485182737
M1	cpdb	0	network_modules	21	TRUE	4.6211002407305427e-4	18	50	4	0.08	0.2222222222222222	REAC:R-HSA-446353	REAC	Cell-extracellular matrix interactions	10916	330		0.6842105263157895	0.6923076923076923	18	10898	4	46	14	10852	10916	0.13099321884588808
M1	cpdb	0	network_modules	21	TRUE	5.591177363463459e-4	414	61	11	0.18032786885245902	0.026570048309178744	GO:0061061	GO:BP	muscle structure development	16175	15177		0.6909090909090909	0.6964285714285714	414	15761	11	50	403	15711	16175	0.06028342211877331
M1	cpdb	0	network_modules	21	TRUE	5.833671592824209e-4	19	50	4	0.08	0.21052631578947367	REAC:R-HSA-5627117	REAC	RHO GTPases Activate ROCKs	10916	1850		0.7105263157894737	0.717948717948718	19	10897	4	46	15	10851	10916	0.1273562066231672
M1	cpdb	0	network_modules	21	TRUE	6.561535223163121e-4	17	61	4	0.06557377049180328	0.23529411764705882	GO:0051014	GO:BP	actin filament severing	16175	13440		0.7090909090909091	0.7142857142857143	17	16158	4	57	13	16101	16175	0.12251866059338838
M1	cpdb	0	network_modules	21	TRUE	6.728085152541748e-4	77	61	6	0.09836065573770492	0.07792207792207792	GO:0007044	GO:BP	cell-substrate junction assembly	16175	2648		0.7272727272727273	0.7321428571428571	77	16098	6	55	71	16043	16175	0.08366678603568377
M1	cpdb	0	network_modules	21	TRUE	7.408018239202598e-4	82	50	6	0.12	0.07317073170731707	REAC:R-HSA-6802957	REAC	Oncogenic MAPK signaling	10916	1641		0.7368421052631579	0.7435897435897436	82	10834	6	44	76	10790	10916	0.08837285447439507
M1	cpdb	0	network_modules	21	TRUE	8.96672213959793e-4	418	50	11	0.22	0.02631578947368421	REAC:R-HSA-5663202	REAC	Diseases of signal transduction by growth factor receptors and second messengers	10916	773		0.7631578947368421	0.7692307692307693	418	10498	11	39	407	10459	10916	0.06423109274093253
M1	cpdb	0	network_modules	21	TRUE	0.0010525037715977384	83	61	6	0.09836065573770492	0.07228915662650602	GO:0150115	GO:BP	cell-substrate junction organization	16175	20148		0.7454545454545455	0.75	83	16092	6	55	77	16037	16175	0.08028155945933124
M1	cpdb	0	network_modules	21	TRUE	0.0010972638084886933	45	61	5	0.08196721311475409	0.1111111111111111	GO:0030837	GO:BP	negative regulation of actin filament polymerization	16175	6922		0.7636363636363637	0.7678571428571429	45	16130	5	56	40	16074	16175	0.09249702966498673
M1	cpdb	0	network_modules	21	TRUE	0.0011012662179608781	153	45	7	0.15555555555555556	0.0457516339869281	KEGG:04261	KEGG	Adrenergic signaling in cardiomyocytes	8484	297		0.9375	0.9411764705882353	153	8331	7	38	146	8293	8484	0.07546369854388489
M1	cpdb	0	network_modules	21	TRUE	0.0012275279831971547	46	61	5	0.08196721311475409	0.10869565217391304	GO:1902743	GO:BP	regulation of lamellipodium organization	16175	22469		0.7818181818181819	0.7857142857142857	46	16129	5	56	41	16073	16175	0.09141750885127681
M1	cpdb	0	network_modules	21	TRUE	0.0013148758208500558	23	50	4	0.08	0.17391304347826086	REAC:R-HSA-9013418	REAC	RHOBTB2 GTPase cycle	10916	1863		0.7894736842105263	0.7948717948717948	23	10893	4	46	19	10847	10916	0.11523235718208864
M1	cpdb	0	network_modules	21	TRUE	0.0026452082193813456	97	61	6	0.09836065573770492	0.061855670103092786	GO:0030833	GO:BP	regulation of actin filament polymerization	16175	6918		0.8	0.8035714285714286	97	16078	6	55	91	16023	16175	0.0736049785643134
M1	cpdb	0	network_modules	21	TRUE	0.0026580574652992155	102	50	6	0.12	0.058823529411764705	REAC:R-HSA-6807878	REAC	COPI-mediated anterograde transport	10916	279		0.8157894736842105	0.8205128205128205	102	10814	6	44	96	10770	10916	0.07801804356263742
M1	cpdb	0	network_modules	21	TRUE	0.0027611547865425464	7	61	3	0.04918032786885246	0.42857142857142855	GO:0070358	GO:BP	actin polymerization-dependent cell motility	16175	16075		0.8181818181818182	0.8214285714285714	7	16168	3	58	4	16110	16175	0.14420597346372488
M1	cpdb	0	network_modules	21	TRUE	0.003632441455517487	57	61	5	0.08196721311475409	0.08771929824561403	GO:0030032	GO:BP	lamellipodium assembly	16175	6656		0.8363636363636363	0.8392857142857143	57	16118	5	56	52	16062	16175	0.08144607084659386
M1	cpdb	0	network_modules	21	TRUE	0.003687577563196157	161	61	7	0.11475409836065574	0.043478260869565216	GO:0032271	GO:BP	regulation of protein polymerization	16175	7452		0.8545454545454545	0.8571428571428571	161	16014	7	54	154	15960	16175	0.06495429774271373
M1	cpdb	0	network_modules	21	TRUE	0.004153934757083089	64	50	5	0.1	0.078125	REAC:R-HSA-6802952	REAC	Signaling by BRAF and RAF1 fusions	10916	2225		0.8421052631578947	0.8461538461538461	64	10852	5	45	59	10807	10916	0.08364295507402075
M1	cpdb	0	network_modules	21	TRUE	0.005180027767164954	32	50	4	0.08	0.125	REAC:R-HSA-5626467	REAC	RHO GTPases activate IQGAPs	10916	1854		0.868421052631579	0.8717948717948718	32	10884	4	46	28	10838	10916	0.0966988836891993
M1	cpdb	0	network_modules	21	TRUE	0.005533385724924534	62	61	5	0.08196721311475409	0.08064516129032258	GO:0070527	GO:BP	platelet aggregation	16175	16166		0.8727272727272727	0.875	62	16113	5	56	57	16057	16175	0.07779725985310204
M1	cpdb	0	network_modules	21	TRUE	0.006413088632304011	175	61	7	0.11475409836065574	0.04	GO:0000910	GO:BP	cytokinesis	16175	243		0.8909090909090909	0.8928571428571429	175	16000	7	54	168	15946	16175	0.06181445604249865
M1	cpdb	0	network_modules	21	TRUE	0.0071252519175350176	87	45	5	0.1111111111111111	0.05747126436781609	KEGG:04260	KEGG	Cardiac muscle contraction	8484	296		1	1	87	8397	5	40	82	8357	8484	0.07310442650835525
M1	cpdb	0	network_modules	21	TRUE	0.0072837059159325595	339	61	9	0.14754098360655737	0.02654867256637168	GO:0042060	GO:BP	wound healing	16175	9947		0.9090909090909091	0.9107142857142857	339	15836	9	52	330	15784	16175	0.0543700004755302
M1	cpdb	0	network_modules	21	TRUE	0.007466537682668023	35	50	4	0.08	0.11428571428571428	REAC:R-HSA-6802948	REAC	Signaling by high-kinase activity BRAF mutants	10916	2321		0.8947368421052632	0.9230769230769231	35	10881	4	46	31	10835	10916	0.09214479946394942
M1	cpdb	0	network_modules	21	TRUE	0.007466537682668023	35	50	4	0.08	0.11428571428571428	REAC:R-HSA-9706574	REAC	RHOBTB GTPase Cycle	10916	1861		0.8947368421052632	0.9230769230769231	35	10881	4	46	31	10835	10916	0.09214479946394942
M1	cpdb	0	network_modules	21	TRUE	0.007855705675792283	12	50	3	0.06	0.25	REAC:R-HSA-264870	REAC	Caspase-mediated cleavage of cytoskeletal proteins	10916	316		0.9473684210526315	0.9487179487179487	12	10904	3	47	9	10857	10916	0.12057313767415052
M1	cpdb	0	network_modules	21	TRUE	0.008010738370325603	343	61	9	0.14754098360655737	0.026239067055393587	GO:0140694	GO:BP	membraneless organelle assembly	16175	19860		0.9272727272727272	0.9285714285714286	343	15832	9	52	334	15780	16175	0.05395326151351323
M1	cpdb	0	network_modules	21	TRUE	0.0080966151620101	257	61	8	0.13114754098360656	0.0311284046692607	GO:0032535	GO:BP	regulation of cellular component size	16175	7629		0.9454545454545454	0.9464285714285714	257	15918	8	53	249	15865	16175	0.056711469237402334
M1	cpdb	0	network_modules	21	TRUE	0.008140040730529246	67	61	5	0.08196721311475409	0.07462686567164178	GO:0099518	GO:BP	vesicle cytoskeletal trafficking	16175	19107		0.9636363636363636	0.9642857142857143	67	16108	5	56	62	16052	16175	0.07455358763826486
M1	cpdb	0	network_modules	21	TRUE	0.008296526603450668	118	61	6	0.09836065573770492	0.05084745762711865	GO:0055001	GO:BP	muscle cell development	16175	14190		0.9818181818181818	0.9821428571428571	118	16057	6	55	112	16002	16175	0.06583971525153591
M1	cpdb	0	network_modules	21	TRUE	0.009354736402479965	37	50	4	0.08	0.10810810810810811	REAC:R-HSA-111465	REAC	Apoptotic cleavage of cellular proteins	10916	161		0.9736842105263158	0.9743589743589743	37	10879	4	46	33	10833	10916	0.08941420345057943
M1	cpdb	0	network_modules	21	TRUE	0.009503362048330891	32	61	4	0.06557377049180328	0.125	GO:1902745	GO:BP	positive regulation of lamellipodium organization	16175	22471		1	1	32	16143	4	57	28	16086	16175	0.088057464868065
M1	cpdb	0	network_modules	21	TRUE	0.009525947690641181	264	50	8	0.16	0.030303030303030304	REAC:R-HSA-5673001	REAC	RAF/MAP kinase cascade	10916	1841		1	1	264	10652	8	42	256	10610	10916	0.05997149675882993
M1	cpdb	0	network_modules	22	TRUE	2.17391472395354e-59	774	63	54	0.8571428571428571	0.06976744186046512	GO:0007186	GO:BP	G protein-coupled receptor signaling pathway	16175	2744		0	0.021739130434782608	774	15401	54	9	720	15392	16175	0.2370826282557865
M1	cpdb	0	network_modules	22	TRUE	2.0620963024814144e-49	312	60	42	0.7	0.1346153846153846	REAC:R-HSA-418594	REAC	G alpha (i) signalling events	10916	987		0	0.038461538461538464	312	10604	42	18	270	10586	10916	0.29956089830734295
M1	cpdb	0	network_modules	22	TRUE	1.6806686148056634e-29	217	63	26	0.4126984126984127	0.11981566820276497	GO:0007188	GO:BP	adenylate cyclase-modulating G protein-coupled receptor signaling pathway	16175	2746		0.022222222222222223	0.043478260869565216	217	15958	26	37	191	15921	16175	0.21702070842749102
M1	cpdb	0	network_modules	22	TRUE	5.4291044987443706e-27	365	46	29	0.6304347826086957	0.07945205479452055	KEGG:04080	KEGG	Neuroactive ligand-receptor interaction	8484	263		0	0.02702702702702703	365	8119	29	17	336	8102	8484	0.21374963772012262
M1	cpdb	0	network_modules	22	TRUE	7.573495634688247e-22	460	60	29	0.48333333333333334	0.06304347826086956	REAC:R-HSA-500792	REAC	GPCR ligand binding	10916	1019		0.04	0.07692307692307693	460	10456	29	31	431	10425	10916	0.16325688087537996
M1	cpdb	0	network_modules	22	TRUE	1.1066282976801107e-21	328	60	26	0.43333333333333335	0.07926829268292683	REAC:R-HSA-373076	REAC	Class A/1 (Rhodopsin-like receptors)	10916	365		0.08	0.11538461538461539	328	10588	26	34	302	10554	10916	0.17561967375365153
M1	cpdb	0	network_modules	22	TRUE	2.769060485725154e-21	56	63	15	0.23809523809523808	0.26785714285714285	GO:0007193	GO:BP	adenylate cyclase-inhibiting G protein-coupled receptor signaling pathway	16175	2751		0.044444444444444446	0.06521739130434782	56	16119	15	48	41	16071	16175	0.24978483307057026
M1	cpdb	0	network_modules	22	TRUE	7.315190813184243e-21	48	60	15	0.25	0.3125	REAC:R-HSA-418597	REAC	G alpha (z) signalling events	10916	990		0.12	0.15384615384615385	48	10868	15	45	33	10823	10916	0.27595742783486343
M1	cpdb	0	network_modules	22	TRUE	7.356267004184776e-17	223	46	19	0.41304347826086957	0.08520179372197309	KEGG:04024	KEGG	cAMP signaling pathway	8484	252		0.027777777777777776	0.05405405405405406	223	8261	19	27	204	8234	8484	0.17849710307871067
M1	cpdb	0	network_modules	22	TRUE	3.169472795731278e-15	56	63	12	0.19047619047619047	0.21428571428571427	GO:0007187	GO:BP	G protein-coupled receptor signaling pathway, coupled to cyclic nucleotide second messenger	16175	2745		0.06666666666666667	0.08695652173913043	56	16119	12	51	44	16068	16175	0.19909072555458546
M1	cpdb	0	network_modules	22	TRUE	5.314906033207878e-12	97	46	12	0.2608695652173913	0.12371134020618557	KEGG:04713	KEGG	Circadian entrainment	8484	348		0.05555555555555555	0.08108108108108109	97	8387	12	34	85	8353	8484	0.17323284817791587
M1	cpdb	0	network_modules	22	TRUE	3.263827790842846e-11	156	60	14	0.23333333333333334	0.08974358974358974	REAC:R-HSA-418555	REAC	G alpha (s) signalling events	10916	989		0.16	0.19230769230769232	156	10760	14	46	142	10714	10916	0.1372031107664133
M1	cpdb	0	network_modules	22	TRUE	7.212195102970758e-11	120	46	12	0.2608695652173913	0.1	KEGG:04935	KEGG	Growth hormone synthesis, secretion and action	8484	392		0.08333333333333333	0.10810810810810811	120	8364	12	34	108	8330	8484	0.15426800192889342
M1	cpdb	0	network_modules	22	TRUE	1.4183569451507134e-10	14	60	7	0.11666666666666667	0.5	REAC:R-HSA-170670	REAC	Adenylate cyclase inhibitory pathway	10916	120		0.2	0.23076923076923078	14	10902	7	53	7	10849	10916	0.2396808116437425
M1	cpdb	0	network_modules	22	TRUE	3.2351523319656605e-10	140	63	12	0.19047619047619047	0.08571428571428572	GO:0007189	GO:BP	adenylate cyclase-activating G protein-coupled receptor signaling pathway	16175	2747		0.08888888888888889	0.10869565217391304	140	16035	12	51	128	15984	16175	0.1227396952792711
M1	cpdb	0	network_modules	22	TRUE	4.817764256865068e-10	43	60	9	0.15	0.20930232558139536	REAC:R-HSA-9660821	REAC	ADORA2B mediated anti-inflammatory cytokines production	10916	11		0.24	0.2692307692307692	43	10873	9	51	34	10822	10916	0.17335208589110224
M1	cpdb	0	network_modules	22	TRUE	6.031095077722038e-10	44	60	9	0.15	0.20454545454545456	REAC:R-HSA-9634597	REAC	GPER1 signaling	10916	1020		0.28	0.3076923076923077	44	10872	9	51	35	10821	10916	0.17127124732339566
M1	cpdb	0	network_modules	22	TRUE	1.172425467601804e-9	58	46	9	0.1956521739130435	0.15517241379310345	KEGG:04923	KEGG	Regulation of lipolysis in adipocytes	8484	380		0.1111111111111111	0.13513513513513514	58	8426	9	37	49	8389	8484	0.16918948511333687
M1	cpdb	0	network_modules	22	TRUE	2.182215671602687e-9	89	46	10	0.21739130434782608	0.11235955056179775	KEGG:05032	KEGG	Morphine addiction	8484	420		0.1388888888888889	0.16216216216216217	89	8395	10	36	79	8359	8484	0.14993982081474494
M1	cpdb	0	network_modules	22	TRUE	8.664631923591906e-9	69	63	9	0.14285714285714285	0.13043478260869565	GO:0007218	GO:BP	neuropeptide signaling pathway	16175	2772		0.1111111111111111	0.13043478260869565	69	16106	9	54	60	16052	16175	0.1329711469546848
M1	cpdb	0	network_modules	22	TRUE	1.1321658645162348e-8	437	63	16	0.25396825396825395	0.036613272311212815	GO:0014070	GO:BP	response to organic cyclic compound	16175	4635		0.13333333333333333	0.15217391304347827	437	15738	16	47	421	15691	16175	0.08753000075532272
M1	cpdb	0	network_modules	22	TRUE	1.140457259459437e-8	49	46	8	0.17391304347826086	0.16326530612244897	KEGG:05030	KEGG	Cocaine addiction	8484	418		0.16666666666666666	0.1891891891891892	49	8435	8	38	41	8397	8484	0.16382634016975134
M1	cpdb	0	network_modules	22	TRUE	1.4608322031418627e-8	76	46	9	0.1956521739130435	0.11842105263157894	KEGG:04971	KEGG	Gastric acid secretion	8484	402		0.19444444444444445	0.21621621621621623	76	8408	9	37	67	8371	8484	0.1462976475895792
M1	cpdb	0	network_modules	22	TRUE	3.8293284152182666e-8	213	60	13	0.21666666666666667	0.06103286384976526	REAC:R-HSA-416476	REAC	G alpha (q) signalling events	10916	988		0.32	0.34615384615384615	213	10703	13	47	200	10656	10916	0.10596618949679998
M1	cpdb	0	network_modules	22	TRUE	5.436839882525524e-8	210	46	12	0.2608695652173913	0.05714285714285714	KEGG:04015	KEGG	Rap1 signaling pathway	8484	248		0.2222222222222222	0.24324324324324326	210	8274	12	34	198	8240	8484	0.11220696913301087
M1	cpdb	0	network_modules	22	TRUE	5.586926042607123e-8	88	46	9	0.1956521739130435	0.10227272727272728	KEGG:04540	KEGG	Gap junction	8484	318		0.25	0.2702702702702703	88	8396	9	37	79	8359	8484	0.13502373648272217
M1	cpdb	0	network_modules	22	TRUE	6.033286175388217e-8	122	63	10	0.15873015873015872	0.08196721311475409	GO:0008277	GO:BP	regulation of G protein-coupled receptor signaling pathway	16175	3149		0.15555555555555556	0.17391304347826086	122	16053	10	53	112	16000	16175	0.10926929721567602
M1	cpdb	0	network_modules	22	TRUE	7.27669744595493e-8	345	63	14	0.2222222222222222	0.04057971014492753	GO:0071407	GO:BP	cellular response to organic cyclic compound	16175	16659		0.17777777777777778	0.1956521739130435	345	15830	14	49	331	15781	16175	0.08694701153517749
M1	cpdb	0	network_modules	22	TRUE	1.0507916888354234e-7	131	46	10	0.21739130434782608	0.07633587786259542	KEGG:04728	KEGG	Dopaminergic synapse	8484	358		0.2777777777777778	0.2972972972972973	131	8353	10	36	121	8317	8484	0.12093382926793213
M1	cpdb	0	network_modules	22	TRUE	1.8272509602678267e-7	96	63	9	0.14285714285714285	0.09375	GO:0007200	GO:BP	phospholipase C-activating G protein-coupled receptor signaling pathway	16175	2758		0.2	0.21739130434782608	96	16079	9	54	87	16025	16175	0.11146746410887642
M1	cpdb	0	network_modules	22	TRUE	2.006350366826222e-7	195	60	12	0.2	0.06153846153846154	REAC:R-HSA-375276	REAC	Peptide ligand-binding receptors	10916	1726		0.36	0.38461538461538464	195	10721	12	48	183	10673	10916	0.10222704888075379
M1	cpdb	0	network_modules	22	TRUE	6.178882966255461e-7	115	46	9	0.1956521739130435	0.0782608695652174	KEGG:04724	KEGG	Glutamatergic synapse	8484	354		0.3055555555555556	0.32432432432432434	115	8369	9	37	106	8332	8484	0.11627262868693633
M1	cpdb	0	network_modules	22	TRUE	1.1769288225058416e-6	43	60	7	0.11666666666666667	0.16279069767441862	REAC:R-HSA-991365	REAC	Activation of GABAB receptors	10916	83		0.4	0.46153846153846156	43	10873	7	53	36	10820	10916	0.13379046669083314
M1	cpdb	0	network_modules	22	TRUE	1.1769288225058416e-6	43	60	7	0.11666666666666667	0.16279069767441862	REAC:R-HSA-977444	REAC	GABA B receptor activation	10916	1010		0.4	0.46153846153846156	43	10873	7	53	36	10820	10916	0.13379046669083314
M1	cpdb	0	network_modules	22	TRUE	1.2250332959708485e-6	27	63	6	0.09523809523809523	0.2222222222222222	GO:0007212	GO:BP	G protein-coupled dopamine receptor signaling pathway	16175	2766		0.2222222222222222	0.2391304347826087	27	16148	6	57	21	16091	16175	0.14332761983592937
M1	cpdb	0	network_modules	22	TRUE	1.4165067253734406e-6	516	63	15	0.23809523809523808	0.029069767441860465	GO:0099536	GO:BP	synaptic signaling	16175	19115		0.24444444444444444	0.2608695652173913	516	15659	15	48	501	15611	16175	0.0733684471387752
M1	cpdb	0	network_modules	22	TRUE	4.149295305779993e-6	101	46	8	0.17391304347826086	0.07920792079207921	KEGG:04916	KEGG	Melanogenesis	8484	373		0.3333333333333333	0.35135135135135137	101	8383	8	38	93	8345	8484	0.11029012035724771
M1	cpdb	0	network_modules	22	TRUE	5.43897891872599e-6	69	46	7	0.15217391304347827	0.10144927536231885	KEGG:04924	KEGG	Renin secretion	8484	381		0.3611111111111111	0.3783783783783784	69	8415	7	39	62	8376	8484	0.11841158855430782
M1	cpdb	0	network_modules	22	TRUE	6.172017407909623e-6	54	60	7	0.11666666666666667	0.12962962962962962	REAC:R-HSA-112040	REAC	G-protein mediated events	10916	998		0.48	0.5	54	10862	7	53	47	10809	10916	0.11838116348967483
M1	cpdb	0	network_modules	22	TRUE	6.5180199965423995e-6	487	63	14	0.2222222222222222	0.028747433264887063	GO:0007268	GO:BP	chemical synaptic transmission	16175	2796		0.26666666666666666	0.30434782608695654	487	15688	14	49	473	15639	16175	0.07029924327615873
M1	cpdb	0	network_modules	22	TRUE	6.5180199965423995e-6	487	63	14	0.2222222222222222	0.028747433264887063	GO:0098916	GO:BP	anterograde trans-synaptic signaling	16175	18949		0.26666666666666666	0.30434782608695654	487	15688	14	49	473	15639	16175	0.07029924327615873
M1	cpdb	0	network_modules	22	TRUE	7.426375913049953e-6	492	63	14	0.2222222222222222	0.028455284552845527	GO:0099537	GO:BP	trans-synaptic signaling	16175	19116		0.3111111111111111	0.32608695652173914	492	15683	14	49	478	15634	16175	0.06983971184539131
M1	cpdb	0	network_modules	22	TRUE	7.962912549279335e-6	154	46	9	0.1956521739130435	0.05844155844155844	KEGG:04921	KEGG	Oxytocin signaling pathway	8484	378		0.3888888888888889	0.40540540540540543	154	8330	9	37	145	8293	8484	0.09816941186837387
M1	cpdb	0	network_modules	22	TRUE	8.660487335955634e-6	791	63	17	0.2698412698412698	0.021491782553729456	GO:1901701	GO:BP	cellular response to oxygen-containing compound	16175	21654		0.3333333333333333	0.34782608695652173	791	15384	17	46	774	15338	16175	0.06406025174597166
M1	cpdb	0	network_modules	22	TRUE	1.1051070507341446e-5	38	63	6	0.09523809523809523	0.15789473684210525	GO:1903350	GO:BP	response to dopamine	16175	22933		0.35555555555555557	0.391304347826087	38	16137	6	57	32	16080	16175	0.11997753885376923
M1	cpdb	0	network_modules	22	TRUE	1.1051070507341446e-5	38	63	6	0.09523809523809523	0.15789473684210525	GO:1903351	GO:BP	cellular response to dopamine	16175	22934		0.35555555555555557	0.391304347826087	38	16137	6	57	32	16080	16175	0.11997753885376923
M1	cpdb	0	network_modules	22	TRUE	1.3119573061554166e-5	60	60	7	0.11666666666666667	0.11666666666666667	REAC:R-HSA-977443	REAC	GABA receptor activation	10916	1011		0.52	0.5384615384615384	60	10856	7	53	53	10803	10916	0.1117845738147875
M1	cpdb	0	network_modules	22	TRUE	1.3681542419188973e-5	164	46	9	0.1956521739130435	0.054878048780487805	KEGG:04022	KEGG	cGMP-PKG signaling pathway	8484	251		0.4166666666666667	0.43243243243243246	164	8320	9	37	155	8283	8484	0.0945544378829198
M1	cpdb	0	network_modules	22	TRUE	1.487492801836303e-5	132	60	9	0.15	0.06818181818181818	REAC:R-HSA-9664433	REAC	Leishmania parasite growth and survival	10916	1311		0.56	0.6153846153846154	132	10784	9	51	123	10733	10916	0.0938027810287715
M1	cpdb	0	network_modules	22	TRUE	1.487492801836303e-5	132	60	9	0.15	0.06818181818181818	REAC:R-HSA-9662851	REAC	Anti-inflammatory response favouring Leishmania parasite infection	10916	150		0.56	0.6153846153846154	132	10784	9	51	123	10733	10916	0.0938027810287715
M1	cpdb	0	network_modules	22	TRUE	1.5272438352703808e-5	40	63	6	0.09523809523809523	0.15	GO:0071869	GO:BP	response to catecholamine	16175	16951		0.4	0.4782608695652174	40	16135	6	57	34	16078	16175	0.11679121487180023
M1	cpdb	0	network_modules	22	TRUE	1.5272438352703808e-5	40	63	6	0.09523809523809523	0.15	GO:0071870	GO:BP	cellular response to catecholamine stimulus	16175	16952		0.4	0.4782608695652174	40	16135	6	57	34	16078	16175	0.11679121487180023
M1	cpdb	0	network_modules	22	TRUE	1.5272438352703808e-5	40	63	6	0.09523809523809523	0.15	GO:0071868	GO:BP	cellular response to monoamine stimulus	16175	16950		0.4	0.4782608695652174	40	16135	6	57	34	16078	16175	0.11679121487180023
M1	cpdb	0	network_modules	22	TRUE	1.5272438352703808e-5	40	63	6	0.09523809523809523	0.15	GO:0071867	GO:BP	response to monoamine	16175	16949		0.4	0.4782608695652174	40	16135	6	57	34	16078	16175	0.11679121487180023
M1	cpdb	0	network_modules	22	TRUE	2.3848860329696647e-5	21	63	5	0.07936507936507936	0.23809523809523808	GO:0071880	GO:BP	adenylate cyclase-activating adrenergic receptor signaling pathway	16175	16961		0.4888888888888889	0.5	21	16154	5	58	16	16096	16175	0.1355677582633078
M1	cpdb	0	network_modules	22	TRUE	2.796607038485955e-5	129	46	8	0.17391304347826086	0.06201550387596899	KEGG:04926	KEGG	Relaxin signaling pathway	8484	383		0.4444444444444444	0.4594594594594595	129	8355	8	38	121	8317	8484	0.0957613850964266
M1	cpdb	0	network_modules	22	TRUE	3.203615104762186e-5	89	46	7	0.15217391304347827	0.07865168539325842	KEGG:04727	KEGG	GABAergic synapse	8484	357		0.4722222222222222	0.4864864864864865	89	8395	7	39	82	8356	8484	0.10267719084698321
M1	cpdb	0	network_modules	22	TRUE	3.8723248461798826e-5	42	60	6	0.1	0.14285714285714285	REAC:R-HSA-375280	REAC	Amine ligand-binding receptors	10916	139		0.64	0.6538461538461539	42	10874	6	54	36	10820	10916	0.11546363357162626
M1	cpdb	0	network_modules	22	TRUE	4.1829553681584903e-5	187	46	9	0.1956521739130435	0.0481283422459893	KEGG:05034	KEGG	Alcoholism	8484	422		0.5	0.5135135135135135	187	8297	9	37	178	8260	8484	0.08730817597370384
M1	cpdb	0	network_modules	22	TRUE	4.19805597036395e-5	136	46	8	0.17391304347826086	0.058823529411764705	KEGG:04915	KEGG	Estrogen signaling pathway	8484	372		0.5277777777777778	0.5405405405405406	136	8348	8	38	128	8310	8484	0.09281841554554279
M1	cpdb	0	network_modules	22	TRUE	4.988459315492159e-5	59	46	6	0.13043478260869565	0.1016949152542373	KEGG:04730	KEGG	Long-term depression	8484	359		0.5555555555555556	0.5675675675675675	59	8425	6	40	53	8385	8484	0.10971027138308226
M1	cpdb	0	network_modules	22	TRUE	7.594897450916336e-5	26	63	5	0.07936507936507936	0.19230769230769232	GO:0071875	GO:BP	adrenergic receptor signaling pathway	16175	16957		0.5111111111111111	0.5217391304347826	26	16149	5	58	21	16091	16175	0.12137340386848376
M1	cpdb	0	network_modules	22	TRUE	8.00549217469349e-5	148	46	8	0.17391304347826086	0.05405405405405406	KEGG:04723	KEGG	Retrograde endocannabinoid signaling	8484	353		0.5833333333333334	0.5945945945945946	148	8336	8	38	140	8298	8484	0.08824230874596393
M1	cpdb	0	network_modules	22	TRUE	9.91895047257964e-5	105	46	7	0.15217391304347827	0.06666666666666667	KEGG:04928	KEGG	Parathyroid hormone synthesis, secretion and action	8484	385		0.6111111111111112	0.6216216216216216	105	8379	7	39	98	8340	8484	0.09336175789065548
M1	cpdb	0	network_modules	22	TRUE	1.0300707321599633e-4	153	46	8	0.17391304347826086	0.05228758169934641	KEGG:04934	KEGG	Cushing syndrome	8484	391		0.6388888888888888	0.6486486486486487	153	8331	8	38	145	8293	8484	0.08648751410329988
M1	cpdb	0	network_modules	22	TRUE	1.0895197101712247e-4	11	63	4	0.06349206349206349	0.36363636363636365	GO:1904321	GO:BP	response to forskolin	16175	23708		0.5333333333333333	0.5652173913043478	11	16164	4	59	7	16105	16175	0.15066476812879193
M1	cpdb	0	network_modules	22	TRUE	1.0895197101712247e-4	11	63	4	0.06349206349206349	0.36363636363636365	GO:1904322	GO:BP	cellular response to forskolin	16175	23709		0.5333333333333333	0.5652173913043478	11	16164	4	59	7	16105	16175	0.15066476812879193
M1	cpdb	0	network_modules	22	TRUE	1.6293979577627042e-4	113	46	7	0.15217391304347827	0.061946902654867256	KEGG:04725	KEGG	Cholinergic synapse	8484	355		0.6666666666666666	0.6756756756756757	113	8371	7	39	106	8332	8484	0.08943192561956033
M1	cpdb	0	network_modules	22	TRUE	1.6295117850424482e-4	12	63	4	0.06349206349206349	0.3333333333333333	GO:0008542	GO:BP	visual learning	16175	3190		0.5777777777777777	0.5869565217391305	12	16163	4	59	8	16104	16175	0.14411301000856605
M1	cpdb	0	network_modules	22	TRUE	2.068427333867571e-4	89	60	7	0.11666666666666667	0.07865168539325842	REAC:R-HSA-111885	REAC	Opioid Signalling	10916	1642		0.68	0.6923076923076923	89	10827	7	53	82	10774	10916	0.08970960049670806
M1	cpdb	0	network_modules	22	TRUE	3.0374794223508145e-4	124	46	7	0.15217391304347827	0.056451612903225805	KEGG:04611	KEGG	Platelet activation	8484	321		0.6944444444444444	0.7027027027027027	124	8360	7	39	117	8321	8484	0.08463153345780378
M1	cpdb	0	network_modules	22	TRUE	5.921738463709871e-4	16	63	4	0.06349206349206349	0.25	GO:0007632	GO:BP	visual behavior	16175	3088		0.6	0.6086956521739131	16	16159	4	59	12	16100	16175	0.12432906090333104
M1	cpdb	0	network_modules	22	TRUE	6.316833579346383e-4	5	60	3	0.05	0.6	REAC:R-HSA-390651	REAC	Dopamine receptors	10916	783		0.72	0.7307692307692307	5	10911	3	57	2	10854	10916	0.17213140385266137
M1	cpdb	0	network_modules	22	TRUE	6.394131410748659e-4	39	63	5	0.07936507936507936	0.1282051282051282	GO:0045761	GO:BP	regulation of adenylate cyclase activity	16175	11597		0.6222222222222222	0.6304347826086957	39	16136	5	58	34	16078	16175	0.09811615356123403
M1	cpdb	0	network_modules	22	TRUE	7.24953019388733e-4	107	60	7	0.11666666666666667	0.06542056074766354	REAC:R-HSA-163685	REAC	Integration of energy metabolism	10916	1213		0.76	0.7692307692307693	107	10809	7	53	100	10756	10916	0.08064050034353809
M1	cpdb	0	network_modules	22	TRUE	7.502437540710336e-4	17	60	4	0.06666666666666667	0.23529411764705882	REAC:R-HSA-164378	REAC	PKA activation in glucagon signalling	10916	1687		0.8	0.8076923076923077	17	10899	4	56	13	10843	10916	0.12275229066362867
M1	cpdb	0	network_modules	22	TRUE	9.4113850816038e-4	215	60	9	0.15	0.04186046511627907	REAC:R-HSA-9658195	REAC	Leishmania infection	10916	1310		0.84	0.8846153846153846	215	10701	9	51	206	10650	10916	0.06971577177519724
M1	cpdb	0	network_modules	22	TRUE	9.4113850816038e-4	215	60	9	0.15	0.04186046511627907	REAC:R-HSA-9824443	REAC	Parasitic Infection Pathways	10916	1717		0.84	0.8846153846153846	215	10701	9	51	206	10650	10916	0.06971577177519724
M1	cpdb	0	network_modules	22	TRUE	9.653506881525066e-4	619	63	13	0.20634920634920634	0.0210016155088853	GO:1901698	GO:BP	response to nitrogen compound	16175	21651		0.6444444444444445	0.6521739130434783	619	15556	13	50	606	15506	16175	0.05478507871944886
M1	cpdb	0	network_modules	22	TRUE	0.00118330104688768	101	46	6	0.13043478260869565	0.0594059405940594	KEGG:05142	KEGG	Chagas disease	8484	434		0.7222222222222222	0.7297297297297297	101	8383	6	40	95	8343	8484	0.0806914938076988
M1	cpdb	0	network_modules	22	TRUE	0.0012154944669840663	153	46	7	0.15217391304347827	0.0457516339869281	KEGG:04261	KEGG	Adrenergic signaling in cardiomyocytes	8484	297		0.75	0.7567567567567568	153	8331	7	39	146	8292	8484	0.07442583692191454
M1	cpdb	0	network_modules	22	TRUE	0.0012501343961133185	19	63	4	0.06349206349206349	0.21052631578947367	GO:0008306	GO:BP	associative learning	16175	3162		0.6666666666666666	0.6739130434782609	19	16156	4	59	15	16097	16175	0.11376417417973846
M1	cpdb	0	network_modules	22	TRUE	0.001252166053219069	102	46	6	0.13043478260869565	0.058823529411764705	KEGG:04914	KEGG	Progesterone-mediated oocyte maturation	8484	371		0.7777777777777778	0.7837837837837838	102	8382	6	40	96	8342	8484	0.08021991069688399
M1	cpdb	0	network_modules	22	TRUE	0.0013327142959046257	45	63	5	0.07936507936507936	0.1111111111111111	GO:0031279	GO:BP	regulation of cyclase activity	16175	7103		0.6888888888888889	0.6956521739130435	45	16130	5	58	40	16072	16175	0.09091777918020984
M1	cpdb	0	network_modules	22	TRUE	0.0016784130029957394	223	46	8	0.17391304347826086	0.03587443946188341	KEGG:05163	KEGG	Human cytomegalovirus infection	8484	444		0.8055555555555556	0.8108108108108109	223	8261	8	38	215	8223	8484	0.06813348591326794
M1	cpdb	0	network_modules	22	TRUE	0.0018014330327994251	6	63	3	0.047619047619047616	0.5	GO:0007191	GO:BP	adenylate cyclase-activating dopamine receptor signaling pathway	16175	2749		0.7111111111111111	0.7391304347826086	6	16169	3	60	3	16109	16175	0.15342884818312988
M1	cpdb	0	network_modules	22	TRUE	0.0018014330327994251	6	63	3	0.047619047619047616	0.5	GO:0060134	GO:BP	prepulse inhibition	16175	14380		0.7111111111111111	0.7391304347826086	6	16169	3	60	3	16109	16175	0.15342884818312988
M1	cpdb	0	network_modules	22	TRUE	0.0018511328658193326	48	63	5	0.07936507936507936	0.10416666666666667	GO:0051339	GO:BP	regulation of lyase activity	16175	13666		0.7555555555555555	0.7608695652173914	48	16127	5	58	43	16069	16175	0.08782573286807158
M1	cpdb	0	network_modules	22	TRUE	0.0021296417483197645	90	63	6	0.09523809523809523	0.06666666666666667	GO:0097305	GO:BP	response to alcohol	16175	18586		0.7777777777777778	0.782608695652174	90	16085	6	57	84	16028	16175	0.07538316456282967
M1	cpdb	0	network_modules	22	TRUE	0.002136247557309761	112	46	6	0.13043478260869565	0.05357142857142857	KEGG:04726	KEGG	Serotonergic synapse	8484	356		0.8333333333333334	0.8378378378378378	112	8372	6	40	106	8332	8484	0.07583815973540323
M1	cpdb	0	network_modules	22	TRUE	0.00225901592392426	22	60	4	0.06666666666666667	0.18181818181818182	REAC:R-HSA-392170	REAC	ADP signalling through P2Y purinoceptor 12	10916	13		0.92	0.9230769230769231	22	10894	4	56	18	10838	10916	0.10717076051056344
M1	cpdb	0	network_modules	22	TRUE	0.0025168449320997484	51	63	5	0.07936507936507936	0.09803921568627451	GO:1901655	GO:BP	cellular response to ketone	16175	21622		0.8	0.8043478260869565	51	16124	5	58	46	16066	16175	0.08500453313464557
M1	cpdb	0	network_modules	22	TRUE	0.003157445513287129	120	46	6	0.13043478260869565	0.05	KEGG:04071	KEGG	Sphingolipid signaling pathway	8484	260		0.8611111111111112	0.8648648648648649	120	8364	6	40	114	8324	8484	0.07271206172670425
M1	cpdb	0	network_modules	22	TRUE	0.0033581516551490936	54	63	5	0.07936507936507936	0.09259259259259259	GO:0051937	GO:BP	catecholamine transport	16175	14007		0.8222222222222222	0.8260869565217391	54	16121	5	58	49	16063	16175	0.08241618422531821
M1	cpdb	0	network_modules	22	TRUE	0.0036934084014788866	75	46	5	0.10869565217391304	0.06666666666666667	KEGG:04918	KEGG	Thyroid hormone synthesis	8484	375		0.8888888888888888	0.8918918918918919	75	8409	5	41	70	8368	8484	0.07876421001351215
M1	cpdb	0	network_modules	22	TRUE	0.004807764654347711	58	63	5	0.07936507936507936	0.08620689655172414	GO:0097306	GO:BP	cellular response to alcohol	16175	18587		0.8444444444444444	0.8478260869565217	58	16117	5	58	53	16059	16175	0.07927464763098253
M1	cpdb	0	network_modules	22	TRUE	0.005015994140319651	8	63	3	0.047619047619047616	0.375	GO:0001964	GO:BP	startle response	16175	572		0.8666666666666667	0.9347826086956522	8	16167	3	60	5	16107	16175	0.13253374978910415
M1	cpdb	0	network_modules	22	TRUE	0.005015994140319651	8	63	3	0.047619047619047616	0.375	GO:0060158	GO:BP	phospholipase C-activating dopamine receptor signaling pathway	16175	14396		0.8666666666666667	0.9347826086956522	8	16167	3	60	5	16107	16175	0.13253374978910415
M1	cpdb	0	network_modules	22	TRUE	0.005015994140319651	8	63	3	0.047619047619047616	0.375	GO:0051584	GO:BP	regulation of dopamine uptake involved in synaptic transmission	16175	13801		0.8666666666666667	0.9347826086956522	8	16167	3	60	5	16107	16175	0.13253374978910415
M1	cpdb	0	network_modules	22	TRUE	0.005015994140319651	8	63	3	0.047619047619047616	0.375	GO:0051940	GO:BP	regulation of catecholamine uptake involved in synaptic transmission	16175	14010		0.8666666666666667	0.9347826086956522	8	16167	3	60	5	16107	16175	0.13253374978910415
M1	cpdb	0	network_modules	22	TRUE	0.005237255373605541	59	63	5	0.07936507936507936	0.0847457627118644	GO:0051952	GO:BP	regulation of amine transport	16175	14022		0.9555555555555556	0.9565217391304348	59	16116	5	58	54	16058	16175	0.07853826904198333
M1	cpdb	0	network_modules	22	TRUE	0.0057483154308767435	265	46	8	0.17391304347826086	0.03018867924528302	KEGG:05012	KEGG	Parkinson disease	8484	412		0.9166666666666666	0.918918918918919	265	8219	8	38	257	8181	8484	0.06055970102221529
M1	cpdb	0	network_modules	22	TRUE	0.006169218658237614	28	60	4	0.06666666666666667	0.14285714285714285	REAC:R-HSA-400042	REAC	Adrenaline,noradrenaline inhibits insulin secretion	10916	124		0.96	0.9615384615384616	28	10888	4	56	24	10832	10916	0.09421503180602728
M1	cpdb	0	network_modules	22	TRUE	0.006741958046522174	85	46	5	0.10869565217391304	0.058823529411764705	KEGG:04911	KEGG	Insulin secretion	8484	368		0.9444444444444444	0.9459459459459459	85	8399	5	41	80	8358	8484	0.07315627583917586
M1	cpdb	0	network_modules	22	TRUE	0.006903747736610254	138	46	6	0.13043478260869565	0.043478260869565216	KEGG:04371	KEGG	Apelin signaling pathway	8484	308		0.9722222222222222	0.972972972972973	138	8346	6	40	132	8306	8484	0.06663904821084041
M1	cpdb	0	network_modules	22	TRUE	0.00743299842509159	10	60	3	0.05	0.3	REAC:R-HSA-170660	REAC	Adenylate cyclase activating pathway	10916	119		1	1	10	10906	3	57	7	10849	10916	0.1206175965719561
M1	cpdb	0	network_modules	22	TRUE	0.007857849021272536	64	63	5	0.07936507936507936	0.078125	GO:0015844	GO:BP	monoamine transport	16175	4954		0.9777777777777777	0.9782608695652174	64	16111	5	58	59	16053	16175	0.0751117835434163
M1	cpdb	0	network_modules	22	TRUE	0.009472381145217463	211	46	7	0.15217391304347827	0.03317535545023697	KEGG:05207	KEGG	Chemical carcinogenesis - receptor activation	8484	459		1	1	211	8273	7	39	204	8234	8484	0.060357001245352655
M1	cpdb	0	network_modules	22	TRUE	0.009479634967505495	431	63	10	0.15873015873015872	0.02320185614849188	GO:1901699	GO:BP	cellular response to nitrogen compound	16175	21652		1	1	431	15744	10	53	421	15691	16175	0.05128545385029759
M1	cpdb	0	network_modules	23	TRUE	1.585015671306227e-35	64	40	21	0.525	0.328125	REAC:R-HSA-8873719	REAC	RAB geranylgeranylation	10916	1835		0	0.16666666666666666	64	10852	21	19	43	10833	10916	0.4123785485178276
M1	cpdb	0	network_modules	23	TRUE	1.9363841838947607e-31	263	60	28	0.4666666666666667	0.10646387832699619	GO:0006887	GO:BP	exocytosis	16175	2543		0	0.017241379310344827	263	15912	28	32	235	15880	16175	0.21730495950593723
M1	cpdb	0	network_modules	23	TRUE	4.9248403239110064e-29	120	40	21	0.525	0.175	REAC:R-HSA-9007101	REAC	Rab regulation of trafficking	10916	1939		0.2	0.3333333333333333	120	10796	21	19	99	10777	10916	0.29895502922825945
M1	cpdb	0	network_modules	23	TRUE	9.192515563278524e-28	88	40	19	0.475	0.2159090909090909	REAC:R-HSA-8876198	REAC	RAB GEFs exchange GTP for GDP on RABs	10916	1834		0.4	0.5	88	10828	19	21	69	10807	10916	0.3166672063183581
M1	cpdb	0	network_modules	23	TRUE	4.461549952109213e-23	583	60	29	0.48333333333333334	0.04974271012006861	GO:0032940	GO:BP	secretion by cell	16175	7926		0.017543859649122806	0.034482758620689655	583	15592	29	31	554	15561	16175	0.14642283558207156
M1	cpdb	0	network_modules	23	TRUE	8.311461593380854e-22	646	60	29	0.48333333333333334	0.04489164086687306	GO:0140352	GO:BP	export from cell	16175	19748		0.03508771929824561	0.05172413793103448	646	15529	29	31	617	15498	16175	0.13816807311138699
M1	cpdb	0	network_modules	23	TRUE	9.48026751955132e-22	649	60	29	0.48333333333333334	0.04468412942989214	GO:0046903	GO:BP	secretion	16175	12430		0.05263157894736842	0.06896551724137931	649	15526	29	31	620	15495	16175	0.1378040124109085
M1	cpdb	0	network_modules	23	TRUE	1.7457633067420068e-16	148	60	16	0.26666666666666666	0.10810810810810811	GO:0017157	GO:BP	regulation of exocytosis	16175	5287		0.07017543859649122	0.08620689655172414	148	16027	16	44	132	15983	16175	0.16502633545802006
M1	cpdb	0	network_modules	23	TRUE	1.4676997531977548e-14	404	60	20	0.3333333333333333	0.04950495049504951	GO:1903530	GO:BP	regulation of secretion by cell	16175	23080		0.08771929824561403	0.10344827586206896	404	15771	20	40	384	15731	16175	0.12056953696749687
M1	cpdb	0	network_modules	23	TRUE	1.8656116699891372e-14	409	60	20	0.3333333333333333	0.0488997555012225	GO:0060627	GO:BP	regulation of vesicle-mediated transport	16175	14803		0.10526315789473684	0.1206896551724138	409	15766	20	40	389	15726	16175	0.1197291473273553
M1	cpdb	0	network_modules	23	TRUE	2.7149345315830458e-14	161	60	15	0.25	0.09316770186335403	GO:0045055	GO:BP	regulated exocytosis	16175	11253		0.12280701754385964	0.13793103448275862	161	16014	15	45	146	15969	16175	0.14754926435015264
M1	cpdb	0	network_modules	23	TRUE	8.428626566921256e-14	442	60	20	0.3333333333333333	0.04524886877828054	GO:0051046	GO:BP	regulation of secretion	16175	13456		0.14035087719298245	0.15517241379310345	442	15733	20	40	422	15693	16175	0.1145300675300786
M1	cpdb	0	network_modules	23	TRUE	4.4429262831122253e-10	250	60	14	0.23333333333333334	0.056	GO:0009306	GO:BP	protein secretion	16175	3452		0.15789473684210525	0.1724137931034483	250	15925	14	46	236	15879	16175	0.10777230823039055
M1	cpdb	0	network_modules	23	TRUE	4.692741592598676e-10	251	60	14	0.23333333333333334	0.055776892430278883	GO:0035592	GO:BP	establishment of protein localization to extracellular region	16175	9108		0.17543859649122806	0.1896551724137931	251	15924	14	46	237	15878	16175	0.10753026434429375
M1	cpdb	0	network_modules	23	TRUE	6.837910333275897e-10	258	60	14	0.23333333333333334	0.05426356589147287	GO:0071692	GO:BP	protein localization to extracellular region	16175	16860		0.19298245614035087	0.20689655172413793	258	15917	14	46	244	15871	16175	0.10587403419711607
M1	cpdb	0	network_modules	23	TRUE	9.624809139638045e-10	36	60	8	0.13333333333333333	0.2222222222222222	GO:0006904	GO:BP	vesicle docking involved in exocytosis	16175	2556		0.21052631578947367	0.22413793103448276	36	16139	8	52	28	16087	16175	0.1697631085883209
M1	cpdb	0	network_modules	23	TRUE	3.6674860120996087e-8	55	60	8	0.13333333333333333	0.14545454545454545	GO:0048278	GO:BP	vesicle docking	16175	12620		0.22807017543859648	0.2413793103448276	55	16120	8	52	47	16068	16175	0.1361947738798181
M1	cpdb	0	network_modules	23	TRUE	4.266489468148361e-8	56	60	8	0.13333333333333333	0.14285714285714285	GO:0140029	GO:BP	exocytic process	16175	19642		0.24561403508771928	0.25862068965517243	56	16119	8	52	48	16067	16175	0.134913234114878
M1	cpdb	0	network_modules	23	TRUE	4.553513199352361e-8	87	60	9	0.15	0.10344827586206896	GO:1903305	GO:BP	regulation of regulated secretory pathway	16175	22892		0.2631578947368421	0.27586206896551724	87	16088	9	51	78	16037	16175	0.1206497574937273
M1	cpdb	0	network_modules	23	TRUE	6.370514325018662e-8	519	60	16	0.26666666666666666	0.030828516377649325	GO:0051640	GO:BP	organelle localization	16175	13853		0.2807017543859649	0.29310344827586204	519	15656	16	44	503	15612	16175	0.08122166090478061
M1	cpdb	0	network_modules	23	TRUE	1.885515827092451e-7	195	60	11	0.18333333333333332	0.05641025641025641	GO:1903532	GO:BP	positive regulation of secretion by cell	16175	23082		0.2982456140350877	0.3103448275862069	195	15980	11	49	184	15931	16175	0.09576346866480619
M1	cpdb	0	network_modules	23	TRUE	2.1451468648071276e-7	68	60	8	0.13333333333333333	0.11764705882352941	GO:0045921	GO:BP	positive regulation of exocytosis	16175	11715		0.3157894736842105	0.3275862068965517	68	16107	8	52	60	16055	16175	0.12177771488046216
M1	cpdb	0	network_modules	23	TRUE	2.7239106266745043e-7	70	60	8	0.13333333333333333	0.11428571428571428	GO:0140056	GO:BP	organelle localization by membrane tethering	16175	19654		0.3333333333333333	0.3448275862068966	70	16105	8	52	62	16053	16175	0.11991794131418947
M1	cpdb	0	network_modules	23	TRUE	4.38839704267695e-7	211	60	11	0.18333333333333332	0.052132701421800945	GO:0051047	GO:BP	positive regulation of secretion	16175	13457		0.3508771929824561	0.3620689655172414	211	15964	11	49	200	15915	16175	0.09157523053227423
M1	cpdb	0	network_modules	23	TRUE	4.668371857454362e-7	594	60	16	0.26666666666666666	0.026936026936026935	GO:0051668	GO:BP	localization within membrane	16175	13880		0.3684210526315789	0.3793103448275862	594	15581	16	44	578	15537	16175	0.07459928867046399
M1	cpdb	0	network_modules	23	TRUE	4.7128719497194994e-7	504	60	15	0.25	0.02976190476190476	GO:0072657	GO:BP	protein localization to membrane	16175	17478		0.38596491228070173	0.39655172413793105	504	15671	15	45	489	15626	16175	0.07685452401227531
M1	cpdb	0	network_modules	23	TRUE	8.127663978998607e-7	80	60	8	0.13333333333333333	0.1	GO:0022406	GO:BP	membrane docking	16175	6597		0.40350877192982454	0.41379310344827586	80	16095	8	52	72	16043	16175	0.1116700673840112
M1	cpdb	0	network_modules	23	TRUE	9.280476387992095e-7	50	60	7	0.11666666666666667	0.14	GO:0017156	GO:BP	calcium-ion regulated exocytosis	16175	5286		0.42105263157894735	0.43103448275862066	50	16125	7	53	43	16072	16175	0.12484020224393721
M1	cpdb	0	network_modules	23	TRUE	7.085664935061689e-6	248	22	8	0.36363636363636365	0.03225806451612903	KEGG:04144	KEGG	Endocytosis	8484	280		NA	1	248	8236	8	14	240	8222	8484	0.10121947319855555
M1	cpdb	0	network_modules	23	TRUE	2.534788393662587e-5	239	60	10	0.16666666666666666	0.04184100418410042	GO:0090150	GO:BP	establishment of protein localization to membrane	16175	18059		0.43859649122807015	0.4482758620689655	239	15936	10	50	229	15886	16175	0.0768152688780947
M1	cpdb	0	network_modules	23	TRUE	2.576633154747082e-5	311	60	11	0.18333333333333332	0.03536977491961415	GO:0023061	GO:BP	signal release	16175	6645		0.45614035087719296	0.46551724137931033	311	15864	11	49	300	15815	16175	0.07291938895249199
M1	cpdb	0	network_modules	23	TRUE	2.939103213691934e-5	315	60	11	0.18333333333333332	0.03492063492063492	GO:0016050	GO:BP	vesicle organization	16175	5082		0.47368421052631576	0.4827586206896552	315	15860	11	49	304	15811	16175	0.07235486803155587
M1	cpdb	0	network_modules	23	TRUE	7.582265139716888e-5	3	60	3	0.05	1	GO:0097051	GO:BP	establishment of protein localization to endoplasmic reticulum membrane	16175	18464		0.49122807017543857	0.5	3	16172	3	57	0	16115	16175	0.22321238648003008
M1	cpdb	0	network_modules	23	TRUE	9.265070081163111e-5	145	60	8	0.13333333333333333	0.05517241379310345	GO:0006836	GO:BP	neurotransmitter transport	16175	2506		0.5087719298245614	0.5172413793103449	145	16030	8	52	137	15978	16175	0.08051294780749069
M1	cpdb	0	network_modules	23	TRUE	1.3801741494278336e-4	101	60	7	0.11666666666666667	0.06930693069306931	GO:0099643	GO:BP	signal release from synapse	16175	19183		0.5263157894736842	0.5517241379310345	101	16074	7	53	94	16021	16175	0.08553414515091652
M1	cpdb	0	network_modules	23	TRUE	1.3801741494278336e-4	101	60	7	0.11666666666666667	0.06930693069306931	GO:0007269	GO:BP	neurotransmitter secretion	16175	2797		0.5263157894736842	0.5517241379310345	101	16074	7	53	94	16021	16175	0.08553414515091652
M1	cpdb	0	network_modules	23	TRUE	1.9040854998102655e-4	44	40	5	0.125	0.11363636363636363	REAC:R-HSA-8854214	REAC	TBC/RABGAPs	10916	2420		0.6	0.6666666666666666	44	10872	5	35	39	10837	10916	0.11578511774825986
M1	cpdb	0	network_modules	23	TRUE	2.759216677127716e-4	35	60	5	0.08333333333333333	0.14285714285714285	GO:1903307	GO:BP	positive regulation of regulated secretory pathway	16175	22894		0.5614035087719298	0.5689655172413793	35	16140	5	55	30	16085	16175	0.10658886663605534
M1	cpdb	0	network_modules	23	TRUE	3.0248886966306835e-4	4	60	3	0.05	0.75	GO:0048210	GO:BP	Golgi vesicle fusion to target membrane	16175	12586		0.5789473684210527	0.5862068965517241	4	16171	3	57	1	16114	16175	0.19307365646199193
M1	cpdb	0	network_modules	23	TRUE	4.704663807001883e-4	16	60	4	0.06666666666666667	0.25	GO:0048791	GO:BP	calcium ion-regulated exocytosis of neurotransmitter	16175	13037		0.5964912280701754	0.603448275862069	16	16159	4	56	12	16103	16175	0.12748352022554962
M1	cpdb	0	network_modules	23	TRUE	5.601143039080569e-4	253	60	9	0.15	0.03557312252964427	GO:0072659	GO:BP	protein localization to plasma membrane	16175	17480		0.6140350877192983	0.6206896551724138	253	15922	9	51	244	15871	16175	0.06607103167113665
M1	cpdb	0	network_modules	23	TRUE	9.415972805563228e-4	653	60	13	0.21666666666666667	0.019908116385911178	GO:0051050	GO:BP	positive regulation of transport	16175	13460		0.631578947368421	0.6379310344827587	653	15522	13	47	640	15475	16175	0.0546532644816282
M1	cpdb	0	network_modules	23	TRUE	9.667542337716043e-4	270	60	9	0.15	0.03333333333333333	GO:0016197	GO:BP	endosomal transport	16175	5169		0.6491228070175439	0.6551724137931034	270	15905	9	51	261	15854	16175	0.06349080943757741
M1	cpdb	0	network_modules	23	TRUE	0.0011128384706393087	137	60	7	0.11666666666666667	0.051094890510948905	GO:0098876	GO:BP	vesicle-mediated transport to the plasma membrane	16175	18924		0.6666666666666666	0.6724137931034483	137	16038	7	53	130	15985	16175	0.07204167652679067
M1	cpdb	0	network_modules	23	TRUE	0.0015044602744159839	6	60	3	0.05	0.5	GO:0061669	GO:BP	spontaneous neurotransmitter secretion	16175	15606		0.6842105263157895	0.6896551724137931	6	16169	3	57	3	16112	16175	0.15726192186902072
M1	cpdb	0	network_modules	23	TRUE	0.0015174306882469691	285	60	9	0.15	0.031578947368421054	GO:1990778	GO:BP	protein localization to cell periphery	16175	25286		0.7017543859649122	0.7068965517241379	285	15890	9	51	276	15839	16175	0.06139647927475669
M1	cpdb	0	network_modules	23	TRUE	0.002247540694723792	476	40	10	0.25	0.02100840336134454	REAC:R-HSA-6798695	REAC	Neutrophil degranulation	10916	1597		0.8	0.8333333333333334	476	10440	10	30	466	10410	10916	0.061291868654156006
M1	cpdb	0	network_modules	23	TRUE	0.002545547940726364	98	60	6	0.1	0.061224489795918366	GO:0019882	GO:BP	antigen processing and presentation	16175	6060		0.7192982456140351	0.7241379310344828	98	16077	6	54	92	16023	16175	0.07386617846157716
M1	cpdb	0	network_modules	23	TRUE	0.002625848430236123	7	60	3	0.05	0.42857142857142855	GO:0045054	GO:BP	constitutive secretory pathway	16175	11252		0.7368421052631579	0.7586206896551724	7	16168	3	57	4	16111	16175	0.14541937327756174
M1	cpdb	0	network_modules	23	TRUE	0.002625848430236123	7	60	3	0.05	0.42857142857142855	GO:0018344	GO:BP	protein geranylgeranylation	16175	5411		0.7368421052631579	0.7586206896551724	7	16168	3	57	4	16111	16175	0.14541937327756174
M1	cpdb	0	network_modules	23	TRUE	0.0026865693280670963	24	60	4	0.06666666666666667	0.16666666666666666	GO:0090382	GO:BP	phagosome maturation	16175	18256		0.7719298245614035	0.7758620689655172	24	16151	4	56	20	16095	16175	0.10333158190001307
M1	cpdb	0	network_modules	23	TRUE	0.0027020252926082213	99	60	6	0.1	0.06060606060606061	GO:0006906	GO:BP	vesicle fusion	16175	2557		0.7894736842105263	0.7931034482758621	99	16076	6	54	93	16022	16175	0.07344608830277977
M1	cpdb	0	network_modules	23	TRUE	0.0027826032312175523	157	60	7	0.11666666666666667	0.044585987261146494	GO:0061025	GO:BP	membrane fusion	16175	15142		0.8070175438596491	0.8103448275862069	157	16018	7	53	150	15965	16175	0.06656922820044081
M1	cpdb	0	network_modules	23	TRUE	0.0030385831723553957	101	60	6	0.1	0.0594059405940594	GO:0090174	GO:BP	organelle membrane fusion	16175	18081		0.8245614035087719	0.8275862068965517	101	16074	6	54	95	16020	16175	0.07262400846621465
M1	cpdb	0	network_modules	23	TRUE	0.003648731439101745	58	60	5	0.08333333333333333	0.08620689655172414	GO:0033059	GO:BP	cellular pigmentation	16175	8013		0.8421052631578947	0.8620689655172413	58	16117	5	55	53	16062	16175	0.08140780119719522
M1	cpdb	0	network_modules	23	TRUE	0.003648731439101745	58	60	5	0.08333333333333333	0.08620689655172414	GO:0016079	GO:BP	synaptic vesicle exocytosis	16175	5106		0.8421052631578947	0.8620689655172413	58	16117	5	55	53	16062	16175	0.08140780119719522
M1	cpdb	0	network_modules	23	TRUE	0.004720087566065037	524	60	11	0.18333333333333332	0.02099236641221374	GO:0006886	GO:BP	intracellular protein transport	16175	2542		0.8771929824561403	0.8793103448275862	524	15651	11	49	513	15602	16175	0.0520194416119251
M1	cpdb	0	network_modules	23	TRUE	0.0059690297975390095	64	60	5	0.08333333333333333	0.078125	GO:0032418	GO:BP	lysosome localization	16175	7556		0.8947368421052632	0.9137931034482759	64	16111	5	55	59	16056	16175	0.07715180143709285
M1	cpdb	0	network_modules	23	TRUE	0.0059690297975390095	64	60	5	0.08333333333333333	0.078125	GO:1990849	GO:BP	vacuolar localization	16175	25315		0.8947368421052632	0.9137931034482759	64	16111	5	55	59	16056	16175	0.07715180143709285
M1	cpdb	0	network_modules	23	TRUE	0.006268781005752125	9	60	3	0.05	0.3333333333333333	GO:0060478	GO:BP	acrosomal vesicle exocytosis	16175	14672		0.9298245614035088	0.9310344827586207	9	16166	3	57	6	16109	16175	0.12793582589266936
M1	cpdb	0	network_modules	23	TRUE	0.007158768271905656	181	60	7	0.11666666666666667	0.03867403314917127	GO:0050708	GO:BP	regulation of protein secretion	16175	13223		0.9473684210526315	0.9482758620689655	181	15994	7	53	174	15941	16175	0.06118470597720064
M1	cpdb	0	network_modules	23	TRUE	0.00716283219133603	117	60	6	0.1	0.05128205128205128	GO:0099504	GO:BP	synaptic vesicle cycle	16175	19100		0.9649122807017544	0.9655172413793104	117	16058	6	54	111	16004	16175	0.0667971314381346
M1	cpdb	0	network_modules	23	TRUE	0.008701733735959312	121	60	6	0.1	0.049586776859504134	GO:0099003	GO:BP	vesicle-mediated transport in synapse	16175	18999		0.9824561403508771	0.9827586206896551	121	16054	6	54	115	16000	16175	0.06551683012553441
M1	cpdb	0	network_modules	23	TRUE	0.008892503775845575	32	60	4	0.06666666666666667	0.125	GO:0017158	GO:BP	regulation of calcium ion-dependent exocytosis	16175	5288		1	1	32	16143	4	56	28	16087	16175	0.08883076837234341
M1	cpdb	0	network_modules	23	TRUE	0.009426650306752786	16	40	3	0.075	0.1875	REAC:R-HSA-264642	REAC	Acetylcholine Neurotransmitter Release Cycle	10916	53		1	1	16	10900	3	37	13	10863	10916	0.11656694615548616
M1	cpdb	0	network_modules	24	TRUE	9.66414153286765e-26	791	61	34	0.5573770491803278	0.04298356510745891	GO:0000122	GO:BP	negative regulation of transcription by RNA polymerase II	16175	48		0	0.004081632653061225	791	15384	34	27	757	15357	16175	0.14506203339582255
M1	cpdb	0	network_modules	24	TRUE	4.540862527348327e-23	78	61	17	0.2786885245901639	0.21794871794871795	GO:2000628	GO:BP	regulation of miRNA metabolic process	16175	25910		0.004098360655737705	0.00816326530612245	78	16097	17	44	61	16053	16175	0.24323512890372032
M1	cpdb	0	network_modules	24	TRUE	1.733473850156503e-22	65	61	16	0.26229508196721313	0.24615384615384617	GO:1902893	GO:BP	regulation of miRNA transcription	16175	22593		0.00819672131147541	0.012244897959183673	65	16110	16	45	49	16065	16175	0.2511817198322649
M1	cpdb	0	network_modules	24	TRUE	2.2821736168214835e-22	66	61	16	0.26229508196721313	0.24242424242424243	GO:0061614	GO:BP	miRNA transcription	16175	15585		0.012295081967213115	0.0163265306122449	66	16109	16	45	50	16064	16175	0.24921963174215694
M1	cpdb	0	network_modules	24	TRUE	1.201217302191887e-21	93	61	17	0.2786885245901639	0.1827956989247312	GO:0010586	GO:BP	miRNA metabolic process	16175	4234		0.01639344262295082	0.02040816326530612	93	16082	17	44	76	16038	16175	0.22210660737998383
M1	cpdb	0	network_modules	24	TRUE	6.881965592097785e-20	218	60	23	0.38333333333333336	0.10550458715596331	KEGG:05166	KEGG	Human T-cell leukemia virus 1 infection	8484	447		0	0.011494252873563218	218	8266	23	37	195	8229	8484	0.19075885318100833
M1	cpdb	0	network_modules	24	TRUE	2.51820783863099e-19	171	60	20	0.3333333333333333	0.11695906432748537	REAC:R-HSA-3108232	REAC	SUMO E3 ligases SUMOylate target proteins	10916	2163		0	0.00684931506849315	171	10745	20	40	151	10705	10916	0.19018523018122813
M1	cpdb	0	network_modules	24	TRUE	5.117861865872806e-19	177	60	20	0.3333333333333333	0.11299435028248588	REAC:R-HSA-2990846	REAC	SUMOylation	10916	2167		0.006896551724137931	0.0136986301369863	177	10739	20	40	157	10699	10916	0.18666263820095813
M1	cpdb	0	network_modules	24	TRUE	2.6827372446989695e-17	57	61	13	0.21311475409836064	0.22807017543859648	GO:2000630	GO:BP	positive regulation of miRNA metabolic process	16175	25912		0.020491803278688523	0.024489795918367346	57	16118	13	48	44	16070	16175	0.2176139507343073
M1	cpdb	0	network_modules	24	TRUE	2.7046100667745056e-17	520	61	24	0.39344262295081966	0.046153846153846156	GO:0033993	GO:BP	response to lipid	16175	8371		0.02459016393442623	0.02857142857142857	520	15655	24	37	496	15618	16175	0.12602025794127816
M1	cpdb	0	network_modules	24	TRUE	6.249353325770038e-17	539	61	24	0.39344262295081966	0.04452690166975881	GO:0009725	GO:BP	response to hormone	16175	3623		0.028688524590163935	0.0326530612244898	539	15636	24	37	515	15599	16175	0.12345169723547436
M1	cpdb	0	network_modules	24	TRUE	6.340965972168094e-17	162	60	19	0.31666666666666665	0.11728395061728394	KEGG:05161	KEGG	Hepatitis B	8484	442		0.011627906976744186	0.022988505747126436	162	8322	19	41	143	8281	8484	0.18350067282651414
M1	cpdb	0	network_modules	24	TRUE	8.76333944459612e-17	194	60	20	0.3333333333333333	0.10309278350515463	KEGG:05167	KEGG	Kaposi sarcoma-associated herpesvirus infection	8484	448		0.023255813953488372	0.034482758620689655	194	8290	20	40	174	8250	8484	0.17528876712994235
M1	cpdb	0	network_modules	24	TRUE	1.0437966779315954e-16	701	61	26	0.4262295081967213	0.037089871611982884	GO:0009628	GO:BP	response to abiotic stimulus	16175	3549		0.03278688524590164	0.036734693877551024	701	15474	26	35	675	15439	16175	0.11569708209975597
M1	cpdb	0	network_modules	24	TRUE	1.3425675031533063e-16	95	60	16	0.26666666666666666	0.16842105263157894	KEGG:01522	KEGG	Endocrine resistance	8484	196		0.03488372093023256	0.04597701149425287	95	8389	16	44	79	8345	8484	0.20489842272826558
M1	cpdb	0	network_modules	24	TRUE	1.910353837735521e-16	97	60	16	0.26666666666666666	0.16494845360824742	KEGG:05215	KEGG	Prostate cancer	8484	466		0.046511627906976744	0.05747126436781609	97	8387	16	44	81	8343	8484	0.2026121056112804
M1	cpdb	0	network_modules	24	TRUE	2.492592966318944e-16	121	60	17	0.2833333333333333	0.14049586776859505	KEGG:04919	KEGG	Thyroid hormone signaling pathway	8484	376		0.05813953488372093	0.06896551724137931	121	8363	17	43	104	8320	8484	0.19151843156296566
M1	cpdb	0	network_modules	24	TRUE	2.5707088083754353e-16	48	61	12	0.19672131147540983	0.25	GO:1902895	GO:BP	positive regulation of miRNA transcription	16175	22595		0.036885245901639344	0.04081632653061224	48	16127	12	49	36	16078	16175	0.21915948683162842
M1	cpdb	0	network_modules	24	TRUE	2.0934141829504245e-15	791	61	26	0.4262295081967213	0.03286978508217446	GO:1901701	GO:BP	cellular response to oxygen-containing compound	16175	21654		0.040983606557377046	0.044897959183673466	791	15384	26	35	765	15349	16175	0.10764711504553794
M1	cpdb	0	network_modules	24	TRUE	8.529745368460074e-15	24	60	10	0.16666666666666666	0.4166666666666667	REAC:R-HSA-4090294	REAC	SUMOylation of intracellular receptors	10916	2175		0.013793103448275862	0.02054794520547945	24	10892	10	50	14	10842	10916	0.26105160340323824
M1	cpdb	0	network_modules	24	TRUE	1.0373602555662782e-14	290	60	20	0.3333333333333333	0.06896551724137931	REAC:R-HSA-9006931	REAC	Signaling by Nuclear Receptors	10916	2289		0.020689655172413793	0.0273972602739726	290	10626	20	40	270	10586	10916	0.14181713981813768
M1	cpdb	0	network_modules	24	TRUE	1.860924502664551e-14	155	60	17	0.2833333333333333	0.10967741935483871	KEGG:04218	KEGG	Cellular senescence	8484	295		0.06976744186046512	0.08045977011494253	155	8329	17	43	138	8286	8484	0.1670340450728596
M1	cpdb	0	network_modules	24	TRUE	2.3938293646879096e-14	105	60	15	0.25	0.14285714285714285	KEGG:04659	KEGG	Th17 cell differentiation	8484	337		0.08139534883720931	0.09195402298850575	105	8379	15	45	90	8334	8484	0.1813912063603829
M1	cpdb	0	network_modules	24	TRUE	4.684604149456372e-14	128	61	14	0.22950819672131148	0.109375	GO:0018205	GO:BP	peptidyl-lysine modification	16175	5364		0.045081967213114756	0.04897959183673469	128	16047	14	47	114	16000	16175	0.15387394314087766
M1	cpdb	0	network_modules	24	TRUE	5.830027542654436e-14	418	60	22	0.36666666666666664	0.05263157894736842	REAC:R-HSA-5663202	REAC	Diseases of signal transduction by growth factor receptors and second messengers	10916	773		0.027586206896551724	0.03424657534246575	418	10498	22	38	396	10460	10916	0.1272131205691337
M1	cpdb	0	network_modules	24	TRUE	1.6693501317021367e-13	83	60	13	0.21666666666666667	0.1566265060240964	REAC:R-HSA-381340	REAC	Transcriptional regulation of white adipocyte differentiation	10916	2562		0.034482758620689655	0.04794520547945205	83	10833	13	47	70	10786	10916	0.17892387882985664
M1	cpdb	0	network_modules	24	TRUE	1.6693501317021367e-13	83	60	13	0.21666666666666667	0.1566265060240964	REAC:R-HSA-9843745	REAC	Adipogenesis	10916	122		0.034482758620689655	0.04794520547945205	83	10833	13	47	70	10786	10916	0.17892387882985664
M1	cpdb	0	network_modules	24	TRUE	1.8055401320075298e-13	451	61	20	0.32786885245901637	0.04434589800443459	GO:0032870	GO:BP	cellular response to hormone stimulus	16175	7867		0.04918032786885246	0.053061224489795916	451	15724	20	41	431	15683	16175	0.1121086662344454
M1	cpdb	0	network_modules	24	TRUE	2.470074135432589e-13	76	60	13	0.21666666666666667	0.17105263157894737	KEGG:05220	KEGG	Chronic myeloid leukemia	8484	471		0.09302325581395349	0.11494252873563218	76	8408	13	47	63	8361	8484	0.18604521102388405
M1	cpdb	0	network_modules	24	TRUE	2.470074135432589e-13	76	60	13	0.21666666666666667	0.17105263157894737	KEGG:05212	KEGG	Pancreatic cancer	8484	463		0.09302325581395349	0.11494252873563218	76	8408	13	47	63	8361	8484	0.18604521102388405
M1	cpdb	0	network_modules	24	TRUE	3.43148709472568e-13	615	61	22	0.36065573770491804	0.03577235772357724	GO:0045597	GO:BP	positive regulation of cell differentiation	16175	11448		0.05327868852459016	0.05714285714285714	615	15560	22	39	593	15521	16175	0.10379476244733832
M1	cpdb	0	network_modules	24	TRUE	3.5435747135876647e-13	100	60	14	0.23333333333333334	0.14	KEGG:04933	KEGG	AGE-RAGE signaling pathway in diabetic complications	8484	390		0.11627906976744186	0.12643678160919541	100	8384	14	46	86	8338	8484	0.1732432201793707
M1	cpdb	0	network_modules	24	TRUE	4.997484189542728e-13	408	61	19	0.3114754098360656	0.04656862745098039	GO:0071396	GO:BP	cellular response to lipid	16175	16648		0.05737704918032787	0.061224489795918366	408	15767	19	42	389	15725	16175	0.11231826270130779
M1	cpdb	0	network_modules	24	TRUE	7.386199736451189e-13	638	61	22	0.36065573770491804	0.034482758620689655	GO:0018193	GO:BP	peptidyl-amino acid modification	16175	5353		0.06147540983606557	0.0653061224489796	638	15537	22	39	616	15498	16175	0.10153261504066174
M1	cpdb	0	network_modules	24	TRUE	1.3544444187870369e-12	162	61	14	0.22950819672131148	0.08641975308641975	GO:0007623	GO:BP	circadian rhythm	16175	3080		0.06557377049180328	0.06938775510204082	162	16013	14	47	148	15966	16175	0.13562315076898968
M1	cpdb	0	network_modules	24	TRUE	1.4219747490522503e-12	232	60	17	0.2833333333333333	0.07327586206896551	REAC:R-HSA-157118	REAC	Signaling by NOTCH	10916	2274		0.04827586206896552	0.0547945205479452	232	10684	17	43	215	10641	10916	0.13509130384346008
M1	cpdb	0	network_modules	24	TRUE	1.5274720039078166e-12	201	60	17	0.2833333333333333	0.0845771144278607	KEGG:05203	KEGG	Viral carcinogenesis	8484	455		0.12790697674418605	0.13793103448275862	201	8283	17	43	184	8240	8484	0.1440786579555468
M1	cpdb	0	network_modules	24	TRUE	1.6174254094862663e-12	194	60	16	0.26666666666666666	0.08247422680412371	REAC:R-HSA-2559583	REAC	Cellular Senescence	10916	331		0.05517241379310345	0.06164383561643835	194	10722	16	44	178	10678	10916	0.14004929389250587
M1	cpdb	0	network_modules	24	TRUE	2.677830211945048e-12	519	61	20	0.32786885245901637	0.038535645472061654	GO:0070848	GO:BP	response to growth factor	16175	16340		0.06967213114754098	0.07346938775510205	519	15656	20	41	499	15615	16175	0.103265588019817
M1	cpdb	0	network_modules	24	TRUE	2.9065520037796066e-12	171	61	14	0.22950819672131148	0.08187134502923976	GO:0070482	GO:BP	response to oxygen levels	16175	16143		0.07377049180327869	0.07755102040816327	171	16004	14	47	157	15957	16175	0.1317082646316631
M1	cpdb	0	network_modules	24	TRUE	5.2864965986482736e-12	617	61	21	0.3442622950819672	0.03403565640194489	GO:0051093	GO:BP	negative regulation of developmental process	16175	13488		0.0778688524590164	0.08163265306122448	617	15558	21	40	596	15518	16175	0.09832761905192036
M1	cpdb	0	network_modules	24	TRUE	8.140106770920965e-12	184	61	14	0.22950819672131148	0.07608695652173914	GO:0048511	GO:BP	rhythmic process	16175	12796		0.08196721311475409	0.08571428571428572	184	15991	14	47	170	15944	16175	0.12655561366323315
M1	cpdb	0	network_modules	24	TRUE	8.855427199167122e-12	216	60	16	0.26666666666666666	0.07407407407407407	REAC:R-HSA-8939211	REAC	ESR-mediated signaling	10916	830		0.06206896551724138	0.0684931506849315	216	10700	16	44	200	10656	10916	0.1317862103648341
M1	cpdb	0	network_modules	24	TRUE	1.288942628049109e-11	192	60	16	0.26666666666666666	0.08333333333333333	KEGG:05202	KEGG	Transcriptional misregulation in cancer	8484	454		0.13953488372093023	0.14942528735632185	192	8292	16	44	176	8248	8484	0.13848108067903594
M1	cpdb	0	network_modules	24	TRUE	1.4174048659298961e-11	147	60	14	0.23333333333333334	0.09523809523809523	REAC:R-HSA-9018519	REAC	Estrogen-dependent gene expression	10916	866		0.06896551724137931	0.07534246575342465	147	10769	14	46	133	10723	10916	0.14181352665105346
M1	cpdb	0	network_modules	24	TRUE	1.775769085213629e-11	744	61	22	0.36065573770491804	0.02956989247311828	GO:0072359	GO:BP	circulatory system development	16175	17370		0.0860655737704918	0.08979591836734693	744	15431	22	39	722	15392	16175	0.09241957046865172
M1	cpdb	0	network_modules	24	TRUE	1.808881507439042e-11	66	60	11	0.18333333333333332	0.16666666666666666	REAC:R-HSA-9614085	REAC	FOXO-mediated transcription	10916	923		0.07586206896551724	0.0821917808219178	66	10850	11	49	55	10801	10916	0.17001791554183535
M1	cpdb	0	network_modules	24	TRUE	1.844067797576129e-11	152	61	13	0.21311475409836064	0.08552631578947369	GO:0001666	GO:BP	response to hypoxia	16175	377		0.09016393442622951	0.09387755102040816	152	16023	13	48	139	15975	16175	0.12990989504512412
M1	cpdb	0	network_modules	24	TRUE	1.9064170054902804e-11	118	60	13	0.21666666666666667	0.11016949152542373	REAC:R-HSA-8878166	REAC	Transcriptional regulation by RUNX2	10916	2553		0.08275862068965517	0.08904109589041095	118	10798	13	47	105	10751	10916	0.14799835376841383
M1	cpdb	0	network_modules	24	TRUE	2.1944518753845973e-11	502	61	19	0.3114754098360656	0.037848605577689244	GO:0071363	GO:BP	cellular response to growth factor stimulus	16175	16615		0.0942622950819672	0.09795918367346938	502	15673	19	42	483	15631	16175	0.09949914417163701
M1	cpdb	0	network_modules	24	TRUE	2.3826777990870997e-11	155	61	13	0.21311475409836064	0.08387096774193549	GO:0036293	GO:BP	response to decreased oxygen levels	16175	9544		0.09836065573770492	0.10204081632653061	155	16020	13	48	142	15972	16175	0.12854146953506038
M1	cpdb	0	network_modules	24	TRUE	2.930184771355274e-11	437	61	18	0.29508196721311475	0.041189931350114416	GO:0014070	GO:BP	response to organic cyclic compound	16175	4635		0.10245901639344263	0.10612244897959183	437	15738	18	43	419	15695	16175	0.10172603013826281
M1	cpdb	0	network_modules	24	TRUE	3.699988949162593e-11	95	60	12	0.2	0.12631578947368421	REAC:R-HSA-8878159	REAC	Transcriptional regulation by RUNX3	10916	2554		0.0896551724137931	0.0958904109589041	95	10821	12	48	83	10773	10916	0.15311484467436542
M1	cpdb	0	network_modules	24	TRUE	4.007256523675689e-11	50	60	10	0.16666666666666666	0.2	REAC:R-HSA-2173793	REAC	Transcriptional activity of SMAD2/SMAD3:SMAD4 heterotrimer	10916	2550		0.09655172413793103	0.10273972602739725	50	10866	10	50	40	10816	10916	0.1784557372443514
M1	cpdb	0	network_modules	24	TRUE	4.082307337793337e-11	25	61	8	0.13114754098360656	0.32	GO:1902894	GO:BP	negative regulation of miRNA transcription	16175	22594		0.10655737704918032	0.11020408163265306	25	16150	8	53	17	16097	16175	0.20298445590659916
M1	cpdb	0	network_modules	24	TRUE	4.0987835240830627e-11	86	60	12	0.2	0.13953488372093023	KEGG:05210	KEGG	Colorectal cancer	8484	461		0.1511627906976744	0.16091954022988506	86	8398	12	48	74	8350	8484	0.15996350307216248
M1	cpdb	0	network_modules	24	TRUE	8.330691913822421e-11	27	61	8	0.13114754098360656	0.2962962962962963	GO:2000629	GO:BP	negative regulation of miRNA metabolic process	16175	25911		0.11065573770491803	0.11428571428571428	27	16148	8	53	19	16095	16175	0.19514761943194614
M1	cpdb	0	network_modules	24	TRUE	1.0487195610662423e-10	253	60	16	0.26666666666666666	0.06324110671936758	REAC:R-HSA-1257604	REAC	PIP3 activates AKT signaling	10916	1679		0.10344827586206896	0.1095890410958904	253	10663	16	44	237	10619	10916	0.12030531827090918
M1	cpdb	0	network_modules	24	TRUE	1.3268655448191677e-10	223	60	16	0.26666666666666666	0.07174887892376682	KEGG:05163	KEGG	Human cytomegalovirus infection	8484	444		0.16279069767441862	0.1724137931034483	223	8261	16	44	207	8217	8484	0.12680901188235913
M1	cpdb	0	network_modules	24	TRUE	1.4038298934169926e-10	359	60	18	0.3	0.05013927576601671	REAC:R-HSA-3700989	REAC	Transcriptional Regulation by TP53	10916	2546		0.1103448275862069	0.11643835616438356	359	10557	18	42	341	10515	10916	0.11134762404619694
M1	cpdb	0	network_modules	24	TRUE	1.4460725916129438e-10	178	61	13	0.21311475409836064	0.07303370786516854	GO:0009755	GO:BP	hormone-mediated signaling pathway	16175	3652		0.11475409836065574	0.11836734693877551	178	15997	13	48	165	15949	16175	0.1191972697280831
M1	cpdb	0	network_modules	24	TRUE	1.7230779505521534e-10	345	61	16	0.26229508196721313	0.0463768115942029	GO:0071407	GO:BP	cellular response to organic cyclic compound	16175	16659		0.11885245901639344	0.12244897959183673	345	15830	16	45	329	15785	16175	0.10261552154958938
M1	cpdb	0	network_modules	24	TRUE	4.2043201287152195e-10	302	61	15	0.2459016393442623	0.04966887417218543	GO:0030522	GO:BP	intracellular receptor signaling pathway	16175	6836		0.12295081967213115	0.12653061224489795	302	15873	15	46	287	15827	16175	0.10328609134024767
M1	cpdb	0	network_modules	24	TRUE	5.600951665280893e-10	152	61	12	0.19672131147540983	0.07894736842105263	GO:0141193	GO:BP	nuclear receptor-mediated signaling pathway	16175	20078		0.12704918032786885	0.1306122448979592	152	16023	12	49	140	15974	16175	0.11945585927274817
M1	cpdb	0	network_modules	24	TRUE	7.395232507915137e-10	202	61	13	0.21311475409836064	0.06435643564356436	GO:0071560	GO:BP	cellular response to transforming growth factor beta stimulus	16175	16762		0.13114754098360656	0.1346938775510204	202	15973	13	48	189	15925	16175	0.11115437478145707
M1	cpdb	0	network_modules	24	TRUE	8.121110124991097e-10	29	60	8	0.13333333333333333	0.27586206896551724	REAC:R-HSA-2173795	REAC	Downregulation of SMAD2/3:SMAD4 transcriptional activity	10916	787		0.11724137931034483	0.1232876712328767	29	10887	8	52	21	10835	10916	0.1887336004963247
M1	cpdb	0	network_modules	24	TRUE	9.009798954042713e-10	67	60	10	0.16666666666666666	0.14925373134328357	REAC:R-HSA-400253	REAC	Circadian Clock	10916	363		0.12413793103448276	0.13013698630136986	67	10849	10	50	57	10799	10916	0.1528006403323629
M1	cpdb	0	network_modules	24	TRUE	9.293816071941592e-10	46	60	9	0.15	0.1956521739130435	REAC:R-HSA-2122947	REAC	NOTCH1 Intracellular Domain Regulates Transcription	10916	1532		0.1310344827586207	0.136986301369863	46	10870	9	51	37	10819	10916	0.16731172378833753
M1	cpdb	0	network_modules	24	TRUE	1.0057121088288813e-9	293	60	16	0.26666666666666666	0.05460750853242321	REAC:R-HSA-9006925	REAC	Intracellular signaling by second messengers	10916	1266		0.13793103448275862	0.14383561643835616	293	10623	16	44	277	10579	10916	0.11031685949537545
M1	cpdb	0	network_modules	24	TRUE	1.0764531131490004e-9	208	61	13	0.21311475409836064	0.0625	GO:0071559	GO:BP	response to transforming growth factor beta	16175	16761		0.13524590163934427	0.13877551020408163	208	15967	13	48	195	15919	16175	0.10935746642593884
M1	cpdb	0	network_modules	24	TRUE	1.1435835348609969e-9	463	61	17	0.2786885245901639	0.0367170626349892	GO:0097190	GO:BP	apoptotic signaling pathway	16175	18534		0.13934426229508196	0.14285714285714285	463	15712	17	44	446	15668	16175	0.0922683280922335
M1	cpdb	0	network_modules	24	TRUE	1.5552743672061811e-9	147	60	13	0.21666666666666667	0.08843537414965986	KEGG:05224	KEGG	Breast cancer	8484	475		0.1744186046511628	0.1839080459770115	147	8337	13	47	134	8290	8484	0.12892817878440663
M1	cpdb	0	network_modules	24	TRUE	1.6578864920505529e-09	60	61	9	0.14754098360655737	0.15	GO:0016925	GO:BP	protein sumoylation	16175	5258		0.14344262295081966	0.1469387755102041	60	16115	9	52	51	16063	16175	0.1455696789779156
M1	cpdb	0	network_modules	24	TRUE	1.7760475609777763e-9	10	60	6	0.1	0.6	REAC:R-HSA-450341	REAC	Activation of the AP-1 family of transcription factors	10916	103		0.14482758620689656	0.1506849315068493	10	10906	6	54	4	10852	10916	0.24348636142633018
M1	cpdb	0	network_modules	24	TRUE	3.235147184474167e-9	176	61	12	0.19672131147540983	0.06818181818181818	GO:0007179	GO:BP	transforming growth factor beta receptor signaling pathway	16175	2741		0.14754098360655737	0.1510204081632653	176	15999	12	49	164	15950	16175	0.1102160199612739
M1	cpdb	0	network_modules	24	TRUE	3.3285730396054693e-9	70	60	10	0.16666666666666666	0.14285714285714285	KEGG:04917	KEGG	Prolactin signaling pathway	8484	374		0.18604651162790697	0.19540229885057472	70	8414	10	50	60	8364	8484	0.14779693948615025
M1	cpdb	0	network_modules	24	TRUE	3.599337541100063e-9	157	60	13	0.21666666666666667	0.08280254777070063	KEGG:04110	KEGG	Cell cycle	8484	264		0.19767441860465115	0.20689655172413793	157	8327	13	47	144	8280	8484	0.12409140988615862
M1	cpdb	0	network_modules	24	TRUE	4.10352237417193e-9	231	61	13	0.21311475409836064	0.05627705627705628	GO:0051098	GO:BP	regulation of binding	16175	13493		0.15163934426229508	0.15510204081632653	231	15944	13	48	218	15896	16175	0.1031079981736916
M1	cpdb	0	network_modules	24	TRUE	4.882651335639224e-9	330	60	17	0.2833333333333333	0.051515151515151514	KEGG:05165	KEGG	Human papillomavirus infection	8484	446		0.20930232558139536	0.21839080459770116	330	8154	17	43	313	8111	8484	0.10669424455267565
M1	cpdb	0	network_modules	24	TRUE	4.942125490630171e-9	198	60	14	0.23333333333333334	0.0707070707070707	KEGG:05169	KEGG	Epstein-Barr virus infection	8484	450		0.22093023255813954	0.22988505747126436	198	8286	14	46	184	8240	8484	0.11738742890225914
M1	cpdb	0	network_modules	24	TRUE	5.687966259704618e-9	686	61	19	0.3114754098360656	0.027696793002915453	GO:0008284	GO:BP	positive regulation of cell population proliferation	16175	3151		0.1557377049180328	0.15918367346938775	686	15489	19	42	667	15447	16175	0.08214664449549003
M1	cpdb	0	network_modules	24	TRUE	6.705241191032496e-9	131	60	12	0.2	0.0916030534351145	KEGG:04068	KEGG	FoxO signaling pathway	8484	258		0.23255813953488372	0.2413793103448276	131	8353	12	48	119	8305	8484	0.12632690215346237
M1	cpdb	0	network_modules	24	TRUE	8.089495762856624e-9	71	61	9	0.14754098360655737	0.1267605633802817	GO:0060395	GO:BP	SMAD protein signal transduction	16175	14598		0.1598360655737705	0.16326530612244897	71	16104	9	52	62	16052	16175	0.13323163444964428
M1	cpdb	0	network_modules	24	TRUE	8.274843239852309e-9	798	61	20	0.32786885245901637	0.02506265664160401	GO:0006974	GO:BP	DNA damage response	16175	2601		0.16393442622950818	0.1673469387755102	798	15377	20	41	778	15336	16175	0.07913118070540714
M1	cpdb	0	network_modules	24	TRUE	9.116297741076875e-9	145	61	11	0.18032786885245902	0.07586206896551724	GO:0045444	GO:BP	fat cell differentiation	16175	11377		0.1680327868852459	0.17142857142857143	145	16030	11	50	134	15980	16175	0.11186001666737709
M1	cpdb	0	network_modules	24	TRUE	1.1118016500740763e-8	107	61	10	0.16393442622950818	0.09345794392523364	GO:0030518	GO:BP	nuclear receptor-mediated steroid hormone signaling pathway	16175	6833		0.1721311475409836	0.17551020408163265	107	16068	10	51	97	16017	16175	0.11940339499926894
M1	cpdb	0	network_modules	24	TRUE	1.3412620371930535e-8	109	61	10	0.16393442622950818	0.09174311926605505	GO:0043401	GO:BP	steroid hormone receptor signaling pathway	16175	10670		0.1762295081967213	0.17959183673469387	109	16066	10	51	99	16015	16175	0.11821725489801758
M1	cpdb	0	network_modules	24	TRUE	1.717972813331307e-8	41	60	8	0.13333333333333333	0.1951219512195122	REAC:R-HSA-3899300	REAC	SUMOylation of transcription cofactors	10916	2177		0.15172413793103448	0.15753424657534246	41	10875	8	52	33	10823	10916	0.15748052865189427
M1	cpdb	0	network_modules	24	TRUE	1.8319590506656052e-8	551	61	17	0.2786885245901639	0.030852994555353903	GO:1902532	GO:BP	negative regulation of intracellular signal transduction	16175	22341		0.18032786885245902	0.1836734693877551	551	15624	17	44	534	15580	16175	0.08297246313758042
M1	cpdb	0	network_modules	24	TRUE	2.35912044915346e-8	92	60	10	0.16666666666666666	0.10869565217391304	REAC:R-HSA-170834	REAC	Signaling by TGF-beta Receptor Complex	10916	2308		0.15862068965517243	0.1643835616438356	92	10824	10	50	82	10774	10916	0.1286853346646828
M1	cpdb	0	network_modules	24	TRUE	3.2647117244943435e-8	95	60	10	0.16666666666666666	0.10526315789473684	REAC:R-HSA-975871	REAC	MyD88 cascade initiated on plasma membrane	10916	1497		0.16551724137931034	0.18493150684931506	95	10821	10	50	85	10771	10916	0.12643474308024333
M1	cpdb	0	network_modules	24	TRUE	3.2647117244943435e-8	95	60	10	0.16666666666666666	0.10526315789473684	REAC:R-HSA-168142	REAC	Toll Like Receptor 10 (TLR10) Cascade	10916	2513		0.16551724137931034	0.18493150684931506	95	10821	10	50	85	10771	10916	0.12643474308024333
M1	cpdb	0	network_modules	24	TRUE	3.2647117244943435e-8	95	60	10	0.16666666666666666	0.10526315789473684	REAC:R-HSA-168176	REAC	Toll Like Receptor 5 (TLR5) Cascade	10916	2517		0.16551724137931034	0.18493150684931506	95	10821	10	50	85	10771	10916	0.12643474308024333
M1	cpdb	0	network_modules	24	TRUE	3.70237168896285e-8	275	61	13	0.21311475409836064	0.04727272727272727	GO:0141091	GO:BP	transforming growth factor beta receptor superfamily signaling pathway	16175	20020		0.18442622950819673	0.18775510204081633	275	15900	13	48	262	15852	16175	0.09333605980225
M1	cpdb	0	network_modules	24	TRUE	4.532901950743543e-8	123	61	10	0.16393442622950818	0.08130081300813008	GO:0017015	GO:BP	regulation of transforming growth factor beta receptor signaling pathway	16175	5276		0.1885245901639344	0.19183673469387755	123	16052	10	51	113	16001	16175	0.11072176434942836
M1	cpdb	0	network_modules	24	TRUE	4.609967213278459e-8	28	60	7	0.11666666666666667	0.25	REAC:R-HSA-350054	REAC	Notch-HLH transcription pathway	10916	1610		0.18620689655172415	0.1917808219178082	28	10888	7	53	21	10835	10916	0.1677038337682934
M1	cpdb	0	network_modules	24	TRUE	5.328456267913415e-8	125	61	10	0.16393442622950818	0.08	GO:1903844	GO:BP	regulation of cellular response to transforming growth factor beta stimulus	16175	23323		0.19262295081967212	0.19591836734693877	125	16050	10	51	115	15999	16175	0.10975238525647747
M1	cpdb	0	network_modules	24	TRUE	5.5116168759074375e-8	47	60	8	0.13333333333333333	0.1702127659574468	REAC:R-HSA-9707616	REAC	Heme signaling	10916	1117		0.19310344827586207	0.19863013698630136	47	10869	8	52	39	10817	10916	0.14650200141464786
M1	cpdb	0	network_modules	24	TRUE	5.8772980176737805e-8	172	61	11	0.18032786885245902	0.06395348837209303	GO:0042770	GO:BP	signal transduction in response to DNA damage	16175	10355		0.19672131147540983	0.2	172	16003	11	50	161	15953	16175	0.10179103625382394
M1	cpdb	0	network_modules	24	TRUE	6.031851465815105e-8	158	60	12	0.2	0.0759493670886076	KEGG:05160	KEGG	Hepatitis C	8484	441		0.2441860465116279	0.25287356321839083	158	8326	12	48	146	8278	8484	0.11322748919193905
M1	cpdb	0	network_modules	24	TRUE	6.052950107202407e-8	101	60	10	0.16666666666666666	0.09900990099009901	REAC:R-HSA-975138	REAC	TRAF6 mediated induction of NFkB and MAP kinases upon TLR7/8 or 9 activation	10916	2468		0.2	0.2054794520547945	101	10815	10	50	91	10765	10916	0.12222897617102184
M1	cpdb	0	network_modules	24	TRUE	6.432905326539808e-8	72	60	9	0.15	0.125	REAC:R-HSA-1980143	REAC	Signaling by NOTCH1	10916	2275		0.20689655172413793	0.21232876712328766	72	10844	9	51	63	10793	10916	0.1317058406478492
M1	cpdb	0	network_modules	24	TRUE	6.57946808222816e-8	790	61	19	0.3114754098360656	0.024050632911392405	GO:0007167	GO:BP	enzyme-linked receptor protein signaling pathway	16175	2731		0.20081967213114754	0.20408163265306123	790	15385	19	42	771	15343	16175	0.07497166945131209
M1	cpdb	0	network_modules	24	TRUE	6.682787127196968e-8	102	60	10	0.16666666666666666	0.09803921568627451	REAC:R-HSA-975155	REAC	MyD88 dependent cascade initiated on endosome	10916	1500		0.21379310344827587	0.2191780821917808	102	10814	10	50	92	10764	10916	0.12156317625723384
M1	cpdb	0	network_modules	24	TRUE	7.189448239632315e-8	290	61	13	0.21311475409836064	0.04482758620689655	GO:0007178	GO:BP	cell surface receptor protein serine/threonine kinase signaling pathway	16175	2740		0.20491803278688525	0.20816326530612245	290	15885	13	48	277	15837	16175	0.09050305767309194
M1	cpdb	0	network_modules	24	TRUE	7.302880753661514e-8	129	61	10	0.16393442622950818	0.07751937984496124	GO:0009411	GO:BP	response to UV	16175	3476		0.20901639344262296	0.21224489795918366	129	16046	10	51	119	15995	16175	0.10787980522641476
M1	cpdb	0	network_modules	24	TRUE	7.370382160008525e-8	103	60	10	0.16666666666666666	0.0970873786407767	REAC:R-HSA-168164	REAC	Toll Like Receptor 3 (TLR3) Cascade	10916	2515		0.2206896551724138	0.2328767123287671	103	10813	10	50	93	10763	10916	0.12090677331064609
M1	cpdb	0	network_modules	24	TRUE	7.370382160008525e-8	103	60	10	0.16666666666666666	0.0970873786407767	REAC:R-HSA-168181	REAC	Toll Like Receptor 7/8 (TLR7/8) Cascade	10916	2518		0.2206896551724138	0.2328767123287671	103	10813	10	50	93	10763	10916	0.12090677331064609
M1	cpdb	0	network_modules	24	TRUE	8.399677345947094e-8	140	60	11	0.18333333333333332	0.07857142857142857	REAC:R-HSA-9678108	REAC	SARS-CoV-1 Infection	10916	2114		0.23448275862068965	0.23972602739726026	140	10776	11	49	129	10727	10916	0.11265656325020937
M1	cpdb	0	network_modules	24	TRUE	9.049551452427177e-8	610	61	17	0.2786885245901639	0.027868852459016394	GO:0043066	GO:BP	negative regulation of apoptotic process	16175	10512		0.21311475409836064	0.2163265306122449	610	15565	17	44	593	15521	16175	0.07782907123168022
M1	cpdb	0	network_modules	24	TRUE	9.827195980611982e-8	106	60	10	0.16666666666666666	0.09433962264150944	REAC:R-HSA-168138	REAC	Toll Like Receptor 9 (TLR9) Cascade	10916	2519		0.2413793103448276	0.2465753424657534	106	10810	10	50	96	10760	10916	0.11899173378941191
M1	cpdb	0	network_modules	24	TRUE	1.010799393908169e-7	31	60	7	0.11666666666666667	0.22580645161290322	REAC:R-HSA-450282	REAC	MAPK targets/ Nuclear events mediated by MAP kinases	10916	1349		0.2482758620689655	0.2534246575342466	31	10885	7	53	24	10832	10916	0.15902071162070242
M1	cpdb	0	network_modules	24	TRUE	1.0189305012302994e-7	236	61	12	0.19672131147540983	0.05084745762711865	GO:0043434	GO:BP	response to peptide hormone	16175	10691		0.21721311475409835	0.22040816326530613	236	15939	12	49	224	15890	16175	0.0934554450787632
M1	cpdb	0	network_modules	24	TRUE	1.0702429648889531e-7	237	61	12	0.19672131147540983	0.05063291139240506	GO:0045765	GO:BP	regulation of angiogenesis	16175	11601		0.22131147540983606	0.22448979591836735	237	15938	12	49	225	15889	16175	0.09322934170538046
M1	cpdb	0	network_modules	24	TRUE	1.0794919869941729e-7	107	60	10	0.16666666666666666	0.09345794392523364	REAC:R-HSA-937061	REAC	TRIF (TICAM1)-mediated TLR4 signaling 	10916	2471		0.25517241379310346	0.2671232876712329	107	10809	10	50	97	10759	10916	0.11837074244620961
M1	cpdb	0	network_modules	24	TRUE	1.0794919869941729e-7	107	60	10	0.16666666666666666	0.09345794392523364	REAC:R-HSA-166166	REAC	MyD88-independent TLR4 cascade 	10916	1501		0.25517241379310346	0.2671232876712329	107	10809	10	50	97	10759	10916	0.11837074244620961
M1	cpdb	0	network_modules	24	TRUE	1.0963919901662006e-7	300	61	13	0.21311475409836064	0.043333333333333335	GO:0009314	GO:BP	response to radiation	16175	3460		0.22540983606557377	0.22857142857142856	300	15875	13	48	287	15827	16175	0.08872797803225137
M1	cpdb	0	network_modules	24	TRUE	1.1371583229730781e-7	619	61	17	0.2786885245901639	0.027463651050080775	GO:1901698	GO:BP	response to nitrogen compound	16175	21651		0.22950819672131148	0.23265306122448978	619	15556	17	44	602	15512	16175	0.07710509729836898
M1	cpdb	0	network_modules	24	TRUE	1.1491362159688086e-7	183	61	11	0.18032786885245902	0.060109289617486336	GO:0034599	GO:BP	cellular response to oxidative stress	16175	8684		0.2336065573770492	0.23673469387755103	183	15992	11	50	172	15942	16175	0.0983226471212051
M1	cpdb	0	network_modules	24	TRUE	1.241033856085441e-7	132	60	11	0.18333333333333332	0.08333333333333333	KEGG:04380	KEGG	Osteoclast differentiation	8484	309		0.2558139534883721	0.26436781609195403	132	8352	11	49	121	8303	8484	0.11440926594598769
M1	cpdb	0	network_modules	24	TRUE	1.299009531272153e-7	20	61	6	0.09836065573770492	0.3	GO:0033233	GO:BP	regulation of protein sumoylation	16175	8085		0.23770491803278687	0.24081632653061225	20	16155	6	55	14	16100	16175	0.1700459966798964
M1	cpdb	0	network_modules	24	TRUE	1.3637276943697782e-7	242	61	12	0.19672131147540983	0.049586776859504134	GO:0062012	GO:BP	regulation of small molecule metabolic process	16175	15781		0.24180327868852458	0.24489795918367346	242	15933	12	49	230	15884	16175	0.09211901041477312
M1	cpdb	0	network_modules	24	TRUE	1.43051908320054e-7	243	61	12	0.19672131147540983	0.04938271604938271	GO:1901342	GO:BP	regulation of vasculature development	16175	21401		0.2459016393442623	0.24897959183673468	243	15932	12	49	231	15883	16175	0.0919008849349049
M1	cpdb	0	network_modules	24	TRUE	1.4463235817049005e-7	211	60	13	0.21666666666666667	0.061611374407582936	KEGG:05207	KEGG	Chemical carcinogenesis - receptor activation	8484	459		0.26744186046511625	0.27586206896551724	211	8273	13	47	198	8226	8484	0.10394046176145598
M1	cpdb	0	network_modules	24	TRUE	1.4958227790238218e-7	630	61	17	0.2786885245901639	0.026984126984126985	GO:0043069	GO:BP	negative regulation of programmed cell death	16175	10515		0.25	0.2530612244897959	630	15545	17	44	613	15501	16175	0.07623976297763028
M1	cpdb	0	network_modules	24	TRUE	1.5175273516701702e-7	18	60	6	0.1	0.3333333333333333	REAC:R-HSA-3232118	REAC	SUMOylation of transcription factors	10916	2178		0.2689655172413793	0.273972602739726	18	10898	6	54	12	10844	10916	0.18020778820676323
M1	cpdb	0	network_modules	24	TRUE	1.628223632398207e-7	33	60	7	0.11666666666666667	0.21212121212121213	REAC:R-HSA-2559585	REAC	Oncogene Induced Senescence	10916	1640		0.27586206896551724	0.2808219178082192	33	10883	7	53	26	10830	10916	0.1538926441506989
M1	cpdb	0	network_modules	24	TRUE	1.7025821774160364e-7	112	60	10	0.16666666666666666	0.08928571428571429	REAC:R-HSA-166058	REAC	MyD88:MAL(TIRAP) cascade initiated on plasma membrane	10916	1502		0.2827586206896552	0.2945205479452055	112	10804	10	50	102	10754	10916	0.11538722480196284
M1	cpdb	0	network_modules	24	TRUE	1.7025821774160364e-7	112	60	10	0.16666666666666666	0.08928571428571429	REAC:R-HSA-168188	REAC	Toll Like Receptor TLR6:TLR2 Cascade	10916	2521		0.2827586206896552	0.2945205479452055	112	10804	10	50	102	10754	10916	0.11538722480196284
M1	cpdb	0	network_modules	24	TRUE	1.835630475742322e-7	174	60	12	0.2	0.06896551724137931	KEGG:04310	KEGG	Wnt signaling pathway	8484	299		0.27906976744186046	0.28735632183908044	174	8310	12	48	162	8262	8484	0.10687698115015758
M1	cpdb	0	network_modules	24	TRUE	1.900004772869094e-7	142	61	10	0.16393442622950818	0.07042253521126761	GO:0071383	GO:BP	cellular response to steroid hormone stimulus	16175	16635		0.2540983606557377	0.2571428571428571	142	16033	10	51	132	15982	16175	0.10233471482658874
M1	cpdb	0	network_modules	24	TRUE	2.2144243951521818e-7	115	60	10	0.16666666666666666	0.08695652173913043	REAC:R-HSA-168179	REAC	Toll Like Receptor TLR1:TLR2 Cascade	10916	2520		0.296551724137931	0.3082191780821918	115	10801	10	50	105	10751	10916	0.11368792571256768
M1	cpdb	0	network_modules	24	TRUE	2.2144243951521818e-7	115	60	10	0.16666666666666666	0.08695652173913043	REAC:R-HSA-181438	REAC	Toll Like Receptor 2 (TLR2) Cascade	10916	2514		0.296551724137931	0.3082191780821918	115	10801	10	50	105	10751	10916	0.11368792571256768
M1	cpdb	0	network_modules	24	TRUE	2.7756863161254694e-7	57	60	8	0.13333333333333333	0.14035087719298245	REAC:R-HSA-2894862	REAC	Constitutive Signaling by NOTCH1 HD+PEST Domain Mutants	10916	405		0.3103448275862069	0.3424657534246575	57	10859	8	52	49	10807	10916	0.13214796590423195
M1	cpdb	0	network_modules	24	TRUE	2.7756863161254694e-7	57	60	8	0.13333333333333333	0.14035087719298245	REAC:R-HSA-2644606	REAC	Constitutive Signaling by NOTCH1 PEST Domain Mutants	10916	406		0.3103448275862069	0.3424657534246575	57	10859	8	52	49	10807	10916	0.13214796590423195
M1	cpdb	0	network_modules	24	TRUE	2.7756863161254694e-7	57	60	8	0.13333333333333333	0.14035087719298245	REAC:R-HSA-2894858	REAC	Signaling by NOTCH1 HD+PEST Domain Mutants in Cancer	10916	2277		0.3103448275862069	0.3424657534246575	57	10859	8	52	49	10807	10916	0.13214796590423195
M1	cpdb	0	network_modules	24	TRUE	2.7756863161254694e-7	57	60	8	0.13333333333333333	0.14035087719298245	REAC:R-HSA-2644602	REAC	Signaling by NOTCH1 PEST Domain Mutants in Cancer	10916	2278		0.3103448275862069	0.3424657534246575	57	10859	8	52	49	10807	10916	0.13214796590423195
M1	cpdb	0	network_modules	24	TRUE	2.7756863161254694e-7	57	60	8	0.13333333333333333	0.14035087719298245	REAC:R-HSA-2644603	REAC	Signaling by NOTCH1 in Cancer	10916	2279		0.3103448275862069	0.3424657534246575	57	10859	8	52	49	10807	10916	0.13214796590423195
M1	cpdb	0	network_modules	24	TRUE	3.141169235987672e-7	36	60	7	0.11666666666666667	0.19444444444444445	REAC:R-HSA-2173796	REAC	SMAD2/SMAD3:SMAD4 heterotrimer regulates transcription	10916	2154		0.3448275862068966	0.3493150684931507	36	10880	7	53	29	10827	10916	0.14700493534781753
M1	cpdb	0	network_modules	24	TRUE	3.223681754157297e-7	401	61	14	0.22950819672131148	0.034912718204488775	GO:0043068	GO:BP	positive regulation of programmed cell death	16175	10514		0.2581967213114754	0.2612244897959184	401	15774	14	47	387	15727	16175	0.08100615476588084
M1	cpdb	0	network_modules	24	TRUE	3.535368031115827e-7	160	60	11	0.18333333333333332	0.06875	REAC:R-HSA-5633007	REAC	Regulation of TP53 Activity	10916	2012		0.35172413793103446	0.3561643835616438	160	10756	11	49	149	10707	10916	0.10434508826289565
M1	cpdb	0	network_modules	24	TRUE	3.6933173828558943e-7	59	60	8	0.13333333333333333	0.13559322033898305	REAC:R-HSA-8943724	REAC	Regulation of PTEN gene transcription	10916	1999		0.3586206896551724	0.363013698630137	59	10857	8	52	51	10805	10916	0.1297150468312558
M1	cpdb	0	network_modules	24	TRUE	3.853823999635997e-7	770	61	18	0.29508196721311475	0.023376623376623377	GO:0048646	GO:BP	anatomical structure formation involved in morphogenesis	16175	12904		0.26229508196721313	0.2653061224489796	770	15405	18	43	752	15362	16175	0.0715100823760065
M1	cpdb	0	network_modules	24	TRUE	3.892542087113526e-7	265	61	12	0.19672131147540983	0.045283018867924525	GO:0006979	GO:BP	response to oxidative stress	16175	2604		0.26639344262295084	0.2693877551020408	265	15910	12	49	253	15861	16175	0.08740509691903252
M1	cpdb	0	network_modules	24	TRUE	3.975792848801412e-7	122	60	10	0.16666666666666666	0.08196721311475409	REAC:R-HSA-9006936	REAC	Signaling by TGFB family members	10916	2310		0.36551724137931035	0.3698630136986301	122	10794	10	50	112	10744	10916	0.10996050505756225
M1	cpdb	0	network_modules	24	TRUE	4.0357850656157654e-7	88	60	9	0.15	0.10227272727272728	REAC:R-HSA-9616222	REAC	Transcriptional regulation of granulopoiesis	10916	2559		0.3724137931034483	0.3767123287671233	88	10828	9	51	79	10777	10916	0.11800184558892211
M1	cpdb	0	network_modules	24	TRUE	4.129140495389765e-7	113	60	10	0.16666666666666666	0.08849557522123894	KEGG:04668	KEGG	TNF signaling pathway	8484	342		0.29069767441860467	0.2988505747126437	113	8371	10	50	103	8321	8484	0.11289269739643602
M1	cpdb	0	network_modules	24	TRUE	4.2042203834969494e-7	148	60	11	0.18333333333333332	0.07432432432432433	KEGG:05226	KEGG	Gastric cancer	8484	477		0.3023255813953488	0.3103448275862069	148	8336	11	49	137	8287	8484	0.10693608546017638
M1	cpdb	0	network_modules	24	TRUE	4.2109804557058594e-7	10	60	5	0.08333333333333333	0.5	REAC:R-HSA-9617629	REAC	Regulation of FOXO transcriptional activity by acetylation	10916	1973		0.3793103448275862	0.3835616438356164	10	10906	5	55	5	10851	10916	0.20253010647487216
M1	cpdb	0	network_modules	24	TRUE	4.7086022574596375e-7	38	60	7	0.11666666666666667	0.18421052631578946	REAC:R-HSA-8864260	REAC	Transcriptional regulation by the AP-2 (TFAP2) family of transcription factors	10916	2556		0.38620689655172413	0.3904109589041096	38	10878	7	53	31	10825	10916	0.1428659880237417
M1	cpdb	0	network_modules	24	TRUE	4.788154153541927e-7	338	61	13	0.21311475409836064	0.038461538461538464	GO:0045786	GO:BP	negative regulation of cell cycle	16175	11618		0.27049180327868855	0.27346938775510204	338	15837	13	48	325	15789	16175	0.0826813332223925
M1	cpdb	0	network_modules	24	TRUE	4.821853838835221e-7	45	61	7	0.11475409836065574	0.15555555555555556	GO:0030521	GO:BP	androgen receptor signaling pathway	16175	6835		0.27459016393442626	0.27755102040816326	45	16130	7	54	38	16076	16175	0.13079574859065318
M1	cpdb	0	network_modules	24	TRUE	5.591319934603935e-7	501	61	15	0.2459016393442623	0.029940119760479042	GO:0008285	GO:BP	negative regulation of cell population proliferation	16175	3152		0.2786885245901639	0.2816326530612245	501	15674	15	46	486	15628	16175	0.0763293506219019
M1	cpdb	0	network_modules	24	TRUE	5.974361066702411e-7	153	60	11	0.18333333333333332	0.0718954248366013	KEGG:04934	KEGG	Cushing syndrome	8484	391		0.313953488372093	0.3218390804597701	153	8331	11	49	142	8282	8484	0.10483204710302886
M1	cpdb	0	network_modules	24	TRUE	6.072903246366378e-7	504	61	15	0.2459016393442623	0.02976190476190476	GO:0001944	GO:BP	vasculature development	16175	555		0.2827868852459016	0.2857142857142857	504	15671	15	46	489	15625	16175	0.07604344671348824
M1	cpdb	0	network_modules	24	TRUE	6.341712334822664e-7	63	60	8	0.13333333333333333	0.12698412698412698	REAC:R-HSA-450294	REAC	MAP kinase activation	10916	1345		0.3931034482758621	0.3972602739726027	63	10853	8	52	55	10801	10916	0.12519308439392593
M1	cpdb	0	network_modules	24	TRUE	7.431974824581099e-7	120	60	10	0.16666666666666666	0.08333333333333333	KEGG:04935	KEGG	Growth hormone synthesis, secretion and action	8484	392		0.32558139534883723	0.3333333333333333	120	8364	10	50	110	8314	8484	0.10900667365873731
M1	cpdb	0	network_modules	24	TRUE	7.508397251262252e-7	271	60	13	0.21666666666666667	0.04797047970479705	REAC:R-HSA-3247509	REAC	Chromatin modifying enzymes	10916	355		0.4	0.410958904109589	271	10645	13	47	258	10598	10916	0.09166162647931263
M1	cpdb	0	network_modules	24	TRUE	7.508397251262252e-7	271	60	13	0.21666666666666667	0.04797047970479705	REAC:R-HSA-4839726	REAC	Chromatin organization	10916	356		0.4	0.410958904109589	271	10645	13	47	258	10598	10916	0.09166162647931263
M1	cpdb	0	network_modules	24	TRUE	7.9234088072078e-7	89	60	9	0.15	0.10112359550561797	KEGG:05235	KEGG	PD-L1 expression and PD-1 checkpoint pathway in cancer	8484	480		0.3372093023255814	0.3563218390804598	89	8395	9	51	80	8344	8484	0.11556226597959918
M1	cpdb	0	network_modules	24	TRUE	7.9234088072078e-7	89	60	9	0.15	0.10112359550561797	KEGG:04658	KEGG	Th1 and Th2 cell differentiation	8484	336		0.3372093023255814	0.3563218390804598	89	8395	9	51	80	8344	8484	0.11556226597959918
M1	cpdb	0	network_modules	24	TRUE	8.257844402918875e-7	220	61	11	0.18032786885245902	0.05	GO:0009416	GO:BP	response to light stimulus	16175	3480		0.28688524590163933	0.2897959183673469	220	15955	11	50	209	15905	16175	0.08856308997045334
M1	cpdb	0	network_modules	24	TRUE	8.278721167110677e-7	431	61	14	0.22950819672131148	0.03248259860788863	GO:1901699	GO:BP	cellular response to nitrogen compound	16175	21652		0.29098360655737704	0.2938775510204082	431	15744	14	47	417	15697	16175	0.07750190004078629
M1	cpdb	0	network_modules	24	TRUE	8.281421948377669e-7	41	60	7	0.11666666666666667	0.17073170731707318	REAC:R-HSA-383280	REAC	Nuclear Receptor transcription pathway	10916	1616		0.41379310344827586	0.4178082191780822	41	10875	7	53	34	10822	10916	0.13722486749852578
M1	cpdb	0	network_modules	24	TRUE	8.864181189834809e-7	166	61	10	0.16393442622950818	0.060240963855421686	GO:0048545	GO:BP	response to steroid hormone	16175	12826		0.29508196721311475	0.2979591836734694	166	16009	10	51	156	15958	16175	0.09381347130419657
M1	cpdb	0	network_modules	24	TRUE	9.31744030127798e-7	80	61	8	0.13114754098360656	0.1	GO:0090398	GO:BP	cellular senescence	16175	18269		0.29918032786885246	0.3020408163265306	80	16095	8	53	72	16042	16175	0.11068328261386379
M1	cpdb	0	network_modules	24	TRUE	9.369854278810254e-7	41	60	7	0.11666666666666667	0.17073170731707318	KEGG:05219	KEGG	Bladder cancer	8484	470		0.36046511627906974	0.367816091954023	41	8443	7	53	34	8390	8484	0.13609770416008968
M1	cpdb	0	network_modules	24	TRUE	1.0459082136123293e-6	50	61	7	0.11475409836065574	0.14	GO:0006473	GO:BP	protein acetylation	16175	2210		0.30327868852459017	0.30612244897959184	50	16125	7	54	43	16071	16175	0.12376036974917433
M1	cpdb	0	network_modules	24	TRUE	1.0653752944752138e-6	92	60	9	0.15	0.09782608695652174	KEGG:04657	KEGG	IL-17 signaling pathway	8484	335		0.37209302325581395	0.3793103448275862	92	8392	9	51	83	8341	8484	0.11339465231099057
M1	cpdb	0	network_modules	24	TRUE	1.098828968060497e-6	226	61	11	0.18032786885245902	0.048672566371681415	GO:0062197	GO:BP	cellular response to chemical stress	16175	15861		0.3073770491803279	0.31020408163265306	226	15949	11	50	215	15899	16175	0.08720155660534677
M1	cpdb	0	network_modules	24	TRUE	1.1375183725969982e-6	291	61	12	0.19672131147540983	0.041237113402061855	GO:0030099	GO:BP	myeloid cell differentiation	16175	6677		0.3114754098360656	0.3142857142857143	291	15884	12	49	279	15835	16175	0.08273322818096995
M1	cpdb	0	network_modules	24	TRUE	1.2055456197500084e-6	472	60	16	0.26666666666666666	0.03389830508474576	REAC:R-HSA-449147	REAC	Signaling by Interleukins	10916	2261		0.4206896551724138	0.4246575342465753	472	10444	16	44	456	10400	10916	0.08166504510882878
M1	cpdb	0	network_modules	24	TRUE	1.407172594652865e-6	166	60	11	0.18333333333333332	0.06626506024096386	KEGG:05225	KEGG	Hepatocellular carcinoma	8484	476		0.38372093023255816	0.39080459770114945	166	8318	11	49	155	8269	8484	0.09978844121445284
M1	cpdb	0	network_modules	24	TRUE	1.4828591380074762e-6	67	60	8	0.13333333333333333	0.11940298507462686	KEGG:05221	KEGG	Acute myeloid leukemia	8484	472		0.3953488372093023	0.40229885057471265	67	8417	8	52	59	8365	8484	0.11959792250992102
M1	cpdb	0	network_modules	24	TRUE	1.4996723391374793e-6	129	60	10	0.16666666666666666	0.07751937984496124	KEGG:04926	KEGG	Relaxin signaling pathway	8484	383		0.4069767441860465	0.41379310344827586	129	8355	10	50	119	8305	8484	0.10446035357804594
M1	cpdb	0	network_modules	24	TRUE	1.6838326183060928e-6	71	60	8	0.13333333333333333	0.11267605633802817	REAC:R-HSA-448424	REAC	Interleukin-17 signaling	10916	1238		0.42758620689655175	0.4315068493150685	71	10845	8	52	63	10793	10916	0.11729493506790845
M1	cpdb	0	network_modules	24	TRUE	1.7278936208929893e-6	638	61	16	0.26229508196721313	0.025078369905956112	GO:0030097	GO:BP	hemopoiesis	16175	6675		0.3155737704918033	0.3183673469387755	638	15537	16	45	622	15492	16175	0.0704415914466535
M1	cpdb	0	network_modules	24	TRUE	1.7466952839791312e-6	310	60	14	0.23333333333333334	0.04516129032258064	KEGG:05206	KEGG	MicroRNAs in cancer	8484	458		0.4186046511627907	0.42528735632183906	310	8174	14	46	296	8128	8484	0.08851782181203618
M1	cpdb	0	network_modules	24	TRUE	1.8191047013866943e-6	26	60	6	0.1	0.23076923076923078	REAC:R-HSA-5674400	REAC	Constitutive Signaling by AKT1 E17K in Cancer	10916	400		0.43448275862068964	0.4383561643835616	26	10890	6	54	20	10836	10916	0.1488792957715322
M1	cpdb	0	network_modules	24	TRUE	1.886225761332941e-6	143	60	10	0.16666666666666666	0.06993006993006994	REAC:R-HSA-166016	REAC	Toll Like Receptor 4 (TLR4) Cascade	10916	2516		0.4413793103448276	0.4452054794520548	143	10773	10	50	133	10723	10916	0.10040717313393518
M1	cpdb	0	network_modules	24	TRUE	2.157016054327214e-6	131	61	9	0.14754098360655737	0.06870229007633588	GO:0006109	GO:BP	regulation of carbohydrate metabolic process	16175	1968		0.319672131147541	0.3224489795918367	131	16044	9	52	122	15992	16175	0.09572147010698678
M1	cpdb	0	network_modules	24	TRUE	2.3472081755568516e-6	385	61	13	0.21311475409836064	0.033766233766233764	GO:0043065	GO:BP	positive regulation of apoptotic process	16175	10511		0.3237704918032787	0.32653061224489793	385	15790	13	48	372	15742	16175	0.0764127087406424
M1	cpdb	0	network_modules	24	TRUE	2.419815673362581e-6	90	61	8	0.13114754098360656	0.08888888888888889	GO:0045598	GO:BP	regulation of fat cell differentiation	16175	11449		0.32786885245901637	0.3306122448979592	90	16085	8	53	82	16032	16175	0.10387426707722035
M1	cpdb	0	network_modules	24	TRUE	2.4699306411985597e-6	244	61	11	0.18032786885245902	0.045081967213114756	GO:0097193	GO:BP	intrinsic apoptotic signaling pathway	16175	18537		0.3319672131147541	0.3346938775510204	244	15931	11	50	233	15881	16175	0.08340917032004073
M1	cpdb	0	network_modules	24	TRUE	2.833720457771356e-6	187	61	10	0.16393442622950818	0.053475935828877004	GO:0031669	GO:BP	cellular response to nutrient levels	16175	7272		0.3360655737704918	0.33877551020408164	187	15988	10	51	177	15937	16175	0.08769982804743008
M1	cpdb	0	network_modules	24	TRUE	2.871351334448477e-6	138	60	10	0.16666666666666666	0.07246376811594203	KEGG:05418	KEGG	Fluid shear stress and atherosclerosis	8484	495		0.43023255813953487	0.4482758620689655	138	8346	10	50	128	8296	8484	0.10034330173003647
M1	cpdb	0	network_modules	24	TRUE	2.871351334448477e-6	138	60	10	0.16666666666666666	0.07246376811594203	KEGG:05162	KEGG	Measles	8484	443		0.43023255813953487	0.4482758620689655	138	8346	10	50	128	8296	8484	0.10034330173003647
M1	cpdb	0	network_modules	24	TRUE	3.1558165811928248e-6	104	60	9	0.15	0.08653846153846154	KEGG:04625	KEGG	C-type lectin receptor signaling pathway	8484	330		0.45348837209302323	0.45977011494252873	104	8380	9	51	95	8329	8484	0.10564371115284764
M1	cpdb	0	network_modules	24	TRUE	3.3358378114353097e-6	480	61	14	0.22950819672131148	0.029166666666666667	GO:0001568	GO:BP	blood vessel development	16175	353		0.3401639344262295	0.34285714285714286	480	15695	14	47	466	15648	16175	0.07245576740397568
M1	cpdb	0	network_modules	24	TRUE	3.479340329531557e-6	59	61	7	0.11475409836065574	0.11864406779661017	GO:0072332	GO:BP	intrinsic apoptotic signaling pathway by p53 class mediator	16175	17355		0.3442622950819672	0.3469387755102041	59	16116	7	54	52	16062	16175	0.11339459015121933
M1	cpdb	0	network_modules	24	TRUE	3.7276034593215164e-6	400	61	13	0.21311475409836064	0.0325	GO:0001525	GO:BP	angiogenesis	16175	330		0.3483606557377049	0.3510204081632653	400	15775	13	48	387	15727	16175	0.07463451324297413
M1	cpdb	0	network_modules	24	TRUE	3.7936131162941925e-6	113	60	9	0.15	0.07964601769911504	REAC:R-HSA-1989781	REAC	PPARA activates gene expression	10916	1700		0.4482758620689655	0.4520547945205479	113	10803	9	51	104	10752	10916	0.10257186171384022
M1	cpdb	0	network_modules	24	TRUE	4.051468205377094e-6	107	60	9	0.15	0.08411214953271028	KEGG:04350	KEGG	TGF-beta signaling pathway	8484	304		0.46511627906976744	0.47126436781609193	107	8377	9	51	98	8326	8484	0.1039034189537264
M1	cpdb	0	network_modules	24	TRUE	4.091016185932682e-6	256	61	11	0.18032786885245902	0.04296875	GO:0090287	GO:BP	regulation of cellular response to growth factor stimulus	16175	18171		0.3524590163934426	0.3551020408163265	256	15919	11	50	245	15869	16175	0.08109575675775886
M1	cpdb	0	network_modules	24	TRUE	4.1013767815811135e-6	114	60	9	0.15	0.07894736842105263	REAC:R-HSA-400206	REAC	Regulation of lipid metabolism by PPARalpha	10916	2041		0.45517241379310347	0.4589041095890411	114	10802	9	51	105	10751	10916	0.10205872699978424
M1	cpdb	0	network_modules	24	TRUE	4.326823836065527e-6	34	61	6	0.09836065573770492	0.17647058823529413	GO:0042771	GO:BP	intrinsic apoptotic signaling pathway in response to DNA damage by p53 class mediator	16175	10356		0.35655737704918034	0.35918367346938773	34	16141	6	55	28	16086	16175	0.12931312304379336
M1	cpdb	0	network_modules	24	TRUE	4.612470019549231e-6	30	60	6	0.1	0.2	REAC:R-HSA-9615017	REAC	FOXO-mediated transcription of oxidative stress, metabolic and neuronal genes	10916	926		0.46206896551724136	0.4794520547945205	30	10886	6	54	24	10832	10916	0.13810418057267718
M1	cpdb	0	network_modules	24	TRUE	4.612470019549231e-6	30	60	6	0.1	0.2	REAC:R-HSA-9022692	REAC	Regulation of MECP2 expression and activity	10916	1983		0.46206896551724136	0.4794520547945205	30	10886	6	54	24	10832	10916	0.13810418057267718
M1	cpdb	0	network_modules	24	TRUE	4.612470019549231e-6	30	60	6	0.1	0.2	REAC:R-HSA-8941326	REAC	RUNX2 regulates bone development	10916	1926		0.46206896551724136	0.4794520547945205	30	10886	6	54	24	10832	10916	0.13810418057267718
M1	cpdb	0	network_modules	24	TRUE	4.799000861656428e-6	98	61	8	0.13114754098360656	0.08163265306122448	GO:0042752	GO:BP	regulation of circadian rhythm	16175	10345		0.36065573770491804	0.363265306122449	98	16077	8	53	90	16024	16175	0.09917687933273814
M1	cpdb	0	network_modules	24	TRUE	4.91360141324372e-6	15	60	5	0.08333333333333333	0.3333333333333333	REAC:R-HSA-9735871	REAC	SARS-CoV-1 targets host intracellular signalling and regulatory pathways	10916	2118		0.4827586206896552	0.4863013698630137	15	10901	5	55	10	10846	10916	0.16448381308160195
M1	cpdb	0	network_modules	24	TRUE	5.214785599982055e-6	262	61	11	0.18032786885245902	0.04198473282442748	GO:0031667	GO:BP	response to nutrient levels	16175	7271		0.36475409836065575	0.3673469387755102	262	15913	11	50	251	15863	16175	0.07999611685549936
M1	cpdb	0	network_modules	24	TRUE	5.259962453053569e-6	795	61	17	0.2786885245901639	0.021383647798742137	GO:0051241	GO:BP	negative regulation of multicellular organismal process	16175	13591		0.36885245901639346	0.37142857142857144	795	15380	17	44	778	15336	16175	0.06532832560069092
M1	cpdb	0	network_modules	24	TRUE	6.3618774859257685e-6	148	61	9	0.14754098360655737	0.060810810810810814	GO:0072331	GO:BP	signal transduction by p53 class mediator	16175	17354		0.3729508196721312	0.37551020408163266	148	16027	9	52	139	15975	16175	0.08942492603564045
M1	cpdb	0	network_modules	24	TRUE	6.538435225516282e-6	211	60	11	0.18333333333333332	0.052132701421800945	REAC:R-HSA-9711123	REAC	Cellular response to chemical stress	10916	333		0.4896551724137931	0.4931506849315068	211	10705	11	49	200	10656	10916	0.08855719864495401
M1	cpdb	0	network_modules	24	TRUE	6.790715350997941e-6	459	60	15	0.25	0.032679738562091505	REAC:R-HSA-9679506	REAC	SARS-CoV Infections	10916	2112		0.496551724137931	0.5	459	10457	15	45	444	10412	10916	0.07702942717753519
M1	cpdb	0	network_modules	24	TRUE	7.088964241875056e-6	164	60	10	0.16666666666666666	0.06097560975609756	REAC:R-HSA-168898	REAC	Toll-like Receptor Cascades	10916	2522		0.503448275862069	0.5068493150684932	164	10752	10	50	154	10702	10916	0.09267436447460661
M1	cpdb	0	network_modules	24	TRUE	7.804601249447252e-6	345	61	12	0.19672131147540983	0.034782608695652174	GO:0051090	GO:BP	regulation of DNA-binding transcription factor activity	16175	13485		0.3770491803278688	0.3795918367346939	345	15830	12	49	333	15781	16175	0.07469087540436242
M1	cpdb	0	network_modules	24	TRUE	8.301656746439301e-6	209	61	10	0.16393442622950818	0.04784688995215311	GO:0040029	GO:BP	epigenetic regulation of gene expression	16175	9916		0.38114754098360654	0.3836734693877551	209	15966	10	51	199	15915	16175	0.08227187222120383
M1	cpdb	0	network_modules	24	TRUE	8.31894031654769e-6	18	61	5	0.08196721311475409	0.2777777777777778	GO:0018394	GO:BP	peptidyl-lysine acetylation	16175	5418		0.38524590163934425	0.3877551020408163	18	16157	5	56	13	16101	16175	0.14920881749023107
M1	cpdb	0	network_modules	24	TRUE	9.514178623940713e-6	118	60	9	0.15	0.07627118644067797	KEGG:04722	KEGG	Neurotrophin signaling pathway	8484	352		0.47674418604651164	0.4827586206896552	118	8366	9	51	109	8315	8484	0.09807268501437569
M1	cpdb	0	network_modules	24	TRUE	9.938060113847697e-6	434	61	13	0.21311475409836064	0.029953917050691243	GO:0045596	GO:BP	negative regulation of cell differentiation	16175	11447		0.38934426229508196	0.39183673469387753	434	15741	13	48	421	15693	16175	0.07092841394282719
M1	cpdb	0	network_modules	24	TRUE	1.004015026830556e-5	17	60	5	0.08333333333333333	0.29411764705882354	REAC:R-HSA-9617828	REAC	FOXO-mediated transcription of cell cycle genes	10916	924		0.5103448275862069	0.5136986301369864	17	10899	5	55	12	10844	10916	0.15417439001838362
M1	cpdb	0	network_modules	24	TRUE	1.0236568997700292e-5	119	60	9	0.15	0.07563025210084033	KEGG:04660	KEGG	T cell receptor signaling pathway	8484	338		0.4883720930232558	0.4942528735632184	119	8365	9	51	110	8314	8484	0.0975809945465805
M1	cpdb	0	network_modules	24	TRUE	1.034441139888468e-5	39	61	6	0.09836065573770492	0.15384615384615385	GO:0006476	GO:BP	protein deacetylation	16175	2213		0.39344262295081966	0.39591836734693875	39	16136	6	55	33	16081	16175	0.12037051572985016
M1	cpdb	0	network_modules	24	TRUE	1.1496020352613632e-5	7	60	4	0.06666666666666667	0.5714285714285714	REAC:R-HSA-8941855	REAC	RUNX3 regulates CDKN1A transcription	10916	1933		0.5172413793103449	0.5205479452054794	7	10909	4	56	3	10853	10916	0.19389822135400617
M1	cpdb	0	network_modules	24	TRUE	1.163846295955548e-5	59	60	7	0.11666666666666667	0.11864406779661017	REAC:R-HSA-8986944	REAC	Transcriptional Regulation by MECP2	10916	2544		0.5241379310344828	0.5273972602739726	59	10857	7	53	52	10804	10916	0.11281561670749118
M1	cpdb	0	network_modules	24	TRUE	1.1700344863510175e-5	626	61	15	0.2459016393442623	0.023961661341853034	GO:0035295	GO:BP	tube development	16175	8953		0.3975409836065574	0.4	626	15549	15	46	611	15503	16175	0.06609350026701348
M1	cpdb	0	network_modules	24	TRUE	1.1907194888099743e-5	217	61	10	0.16393442622950818	0.04608294930875576	GO:0090092	GO:BP	regulation of transmembrane receptor protein serine/threonine kinase signaling pathway	16175	18013		0.4016393442622951	0.40408163265306124	217	15958	10	51	207	15907	16175	0.08049682973727885
M1	cpdb	0	network_modules	24	TRUE	1.2343640458933368e-5	35	60	6	0.1	0.17142857142857143	REAC:R-HSA-3232142	REAC	SUMOylation of ubiquitinylation proteins	10916	2179		0.5310344827586206	0.5342465753424658	35	10881	6	54	29	10827	10916	0.1272866588676383
M1	cpdb	0	network_modules	24	TRUE	1.3095101840735783e-5	71	61	7	0.11475409836065574	0.09859154929577464	GO:0030330	GO:BP	DNA damage response, signal transduction by p53 class mediator	16175	6779		0.4057377049180328	0.40816326530612246	71	16104	7	54	64	16050	16175	0.10271675683044636
M1	cpdb	0	network_modules	24	TRUE	1.3472460537532525e-5	92	60	8	0.13333333333333333	0.08695652173913043	REAC:R-HSA-1912408	REAC	Pre-NOTCH Transcription and Translation	10916	1786		0.5379310344827586	0.541095890410959	92	10824	8	52	84	10772	10916	0.10157747836982217
M1	cpdb	0	network_modules	24	TRUE	1.4137396897579002e-5	447	61	13	0.21311475409836064	0.029082774049217	GO:0048514	GO:BP	blood vessel morphogenesis	16175	12799		0.4098360655737705	0.4122448979591837	447	15728	13	48	434	15680	16175	0.06961662515193694
M1	cpdb	0	network_modules	24	TRUE	1.4232532735431436e-5	89	60	8	0.13333333333333333	0.0898876404494382	KEGG:04211	KEGG	Longevity regulating pathway	8484	288		0.5	0.5057471264367817	89	8395	8	52	81	8343	8484	0.10175650017230337
M1	cpdb	0	network_modules	24	TRUE	1.4757216600395271e-5	61	60	7	0.11666666666666667	0.11475409836065574	REAC:R-HSA-198725	REAC	Nuclear Events (kinase and transcription factor activation)	10916	1614		0.5448275862068965	0.547945205479452	61	10855	7	53	54	10802	10916	0.11077826601086757
M1	cpdb	0	network_modules	24	TRUE	1.5470909517692777e-5	37	60	6	0.1	0.16216216216216217	KEGG:05216	KEGG	Thyroid cancer	8484	467		0.5116279069767442	0.5172413793103449	37	8447	6	54	31	8393	8484	0.12248963495256004
M1	cpdb	0	network_modules	24	TRUE	1.7011217168773426e-5	454	61	13	0.21311475409836064	0.028634361233480177	GO:0006338	GO:BP	chromatin remodeling	16175	2126		0.4139344262295082	0.4163265306122449	454	15721	13	48	441	15673	16175	0.06893201501658815
M1	cpdb	0	network_modules	24	TRUE	1.736997540990051e-5	95	60	8	0.13333333333333333	0.08421052631578947	REAC:R-HSA-9692914	REAC	SARS-CoV-1-host interactions	10916	2119		0.5517241379310345	0.5547945205479452	95	10821	8	52	87	10769	10916	0.09975464148612122
M1	cpdb	0	network_modules	24	TRUE	1.8265030796878565e-5	62	60	7	0.11666666666666667	0.11290322580645161	KEGG:05321	KEGG	Inflammatory bowel disease	8484	483		0.5232558139534884	0.5287356321839081	62	8422	7	53	55	8369	8484	0.10835958946846617
M1	cpdb	0	network_modules	24	TRUE	1.9189944016035944e-5	214	60	11	0.18333333333333332	0.0514018691588785	KEGG:05417	KEGG	Lipid and atherosclerosis	8484	494		0.5348837209302325	0.5402298850574713	214	8270	11	49	203	8221	8484	0.08509716789808972
M1	cpdb	0	network_modules	24	TRUE	1.9795117115519735e-5	8	61	4	0.06557377049180328	0.5	GO:0090400	GO:BP	stress-induced premature senescence	16175	18271		0.4180327868852459	0.4204081632653061	8	16167	4	57	4	16110	16175	0.1800901198956117
M1	cpdb	0	network_modules	24	TRUE	2.1904623786353184e-5	138	60	9	0.15	0.06521739130434782	REAC:R-HSA-6807070	REAC	PTEN Regulation	10916	1703		0.5586206896551724	0.5616438356164384	138	10778	9	51	129	10727	10916	0.09140071256808793
M1	cpdb	0	network_modules	24	TRUE	2.2897672325786106e-5	8	60	4	0.06666666666666667	0.5	REAC:R-HSA-9818749	REAC	Regulation of NFE2L2 gene expression	10916	1993		0.5655172413793104	0.5684931506849316	8	10908	4	56	4	10852	10916	0.18113182653210586
M1	cpdb	0	network_modules	24	TRUE	2.439301189920003e-5	39	60	6	0.1	0.15384615384615385	REAC:R-HSA-8853884	REAC	Transcriptional Regulation by VENTX	10916	2547		0.5724137931034483	0.5753424657534246	39	10877	6	54	33	10823	10916	0.12014818256011946
M1	cpdb	0	network_modules	24	TRUE	2.5654123257867446e-5	121	61	8	0.13114754098360656	0.06611570247933884	GO:0033002	GO:BP	muscle cell proliferation	16175	7971		0.42213114754098363	0.42448979591836733	121	16054	8	53	113	16001	16175	0.08830322188448278
M1	cpdb	0	network_modules	24	TRUE	2.71468466061633e-5	175	60	10	0.16666666666666666	0.05714285714285714	KEGG:05152	KEGG	Tuberculosis	8484	440		0.5465116279069767	0.5517241379310345	175	8309	10	50	165	8259	8484	0.0867150240043306
M1	cpdb	0	network_modules	24	TRUE	2.7882436101478438e-5	79	61	7	0.11475409836065574	0.08860759493670886	GO:0008630	GO:BP	intrinsic apoptotic signaling pathway in response to DNA damage	16175	3218		0.4262295081967213	0.42857142857142855	79	16096	7	54	72	16042	16175	0.09696481997541996
M1	cpdb	0	network_modules	24	TRUE	2.8198858363169744e-5	776	61	16	0.26229508196721313	0.020618556701030927	GO:0060341	GO:BP	regulation of cellular localization	16175	14553		0.430327868852459	0.4326530612244898	776	15399	16	45	760	15354	16175	0.06170107428806958
M1	cpdb	0	network_modules	24	TRUE	3.228127785465983e-5	136	60	9	0.15	0.0661764705882353	KEGG:04915	KEGG	Estrogen signaling pathway	8484	372		0.5581395348837209	0.5747126436781609	136	8348	9	51	127	8297	8484	0.09002506081621053
M1	cpdb	0	network_modules	24	TRUE	3.228127785465983e-5	136	60	9	0.15	0.0661764705882353	KEGG:05135	KEGG	Yersinia infection	8484	432		0.5581395348837209	0.5747126436781609	136	8348	9	51	127	8297	8484	0.09002506081621053
M1	cpdb	0	network_modules	24	TRUE	3.31329380667217e-5	575	61	14	0.22950819672131148	0.02434782608695652	GO:0044092	GO:BP	negative regulation of molecular function	16175	10914		0.4344262295081967	0.43673469387755104	575	15600	14	47	561	15553	16175	0.06444992035816652
M1	cpdb	0	network_modules	24	TRUE	3.325122727087438e-5	81	61	7	0.11475409836065574	0.08641975308641975	GO:0034644	GO:BP	cellular response to UV	16175	8706		0.4385245901639344	0.44081632653061226	81	16094	7	54	74	16040	16175	0.09565841598824512
M1	cpdb	0	network_modules	24	TRUE	3.3258534575498125e-5	47	61	6	0.09836065573770492	0.1276595744680851	GO:0098732	GO:BP	macromolecule deacylation	16175	18861		0.4426229508196721	0.4489795918367347	47	16128	6	55	41	16073	16175	0.10911054783792169
M1	cpdb	0	network_modules	24	TRUE	3.3258534575498125e-5	47	61	6	0.09836065573770492	0.1276595744680851	GO:0035601	GO:BP	protein deacylation	16175	9110		0.4426229508196721	0.4489795918367347	47	16128	6	55	41	16073	16175	0.10911054783792169
M1	cpdb	0	network_modules	24	TRUE	3.483788126603766e-5	68	60	7	0.11666666666666667	0.10294117647058823	KEGG:05211	KEGG	Renal cell carcinoma	8484	462		0.5813953488372093	0.5862068965517241	68	8416	7	53	61	8363	8484	0.10283615498693613
M1	cpdb	0	network_modules	24	TRUE	3.624837361684656e-5	82	61	7	0.11475409836065574	0.08536585365853659	GO:0062014	GO:BP	negative regulation of small molecule metabolic process	16175	15783		0.45081967213114754	0.4530612244897959	82	16093	7	54	75	16039	16175	0.0950227379027471
M1	cpdb	0	network_modules	24	TRUE	3.7539607093484615e-5	792	61	16	0.26229508196721313	0.020202020202020204	GO:0000278	GO:BP	mitotic cell cycle	16175	76		0.45491803278688525	0.45714285714285713	792	15383	16	45	776	15338	16175	0.060824371998860434
M1	cpdb	0	network_modules	24	TRUE	3.81326089108676e-5	101	60	8	0.13333333333333333	0.07920792079207921	KEGG:05142	KEGG	Chagas disease	8484	434		0.5930232558139535	0.5977011494252874	101	8383	8	52	93	8331	8484	0.09448819911181112
M1	cpdb	0	network_modules	24	TRUE	3.8223532005938106e-5	684	61	15	0.2459016393442623	0.021929824561403508	GO:0032880	GO:BP	regulation of protein localization	16175	7877		0.45901639344262296	0.46122448979591835	684	15491	15	46	669	15445	16175	0.06225119940776937
M1	cpdb	0	network_modules	24	TRUE	3.947128589967135e-5	83	61	7	0.11475409836065574	0.08433734939759036	GO:0043543	GO:BP	protein acylation	16175	10760		0.46311475409836067	0.46530612244897956	83	16092	7	54	76	16038	16175	0.09439827404133395
M1	cpdb	0	network_modules	24	TRUE	4.104666054916233e-5	9	60	4	0.06666666666666667	0.4444444444444444	REAC:R-HSA-139915	REAC	Activation of PUMA and translocation to mitochondria	10916	93		0.5793103448275863	0.589041095890411	9	10907	4	56	5	10851	10916	0.17054326908297923
M1	cpdb	0	network_modules	24	TRUE	4.104666054916233e-5	9	60	4	0.06666666666666667	0.4444444444444444	REAC:R-HSA-8951936	REAC	RUNX3 regulates p14-ARF	10916	1938		0.5793103448275863	0.589041095890411	9	10907	4	56	5	10851	10916	0.17054326908297923
M1	cpdb	0	network_modules	24	TRUE	4.661446459729829e-5	142	60	9	0.15	0.06338028169014084	KEGG:04936	KEGG	Alcoholic liver disease	8484	393		0.6046511627906976	0.6091954022988506	142	8342	9	51	133	8291	8484	0.0876690221034055
M1	cpdb	0	network_modules	24	TRUE	4.7597039070205525e-5	108	60	8	0.13333333333333333	0.07407407407407407	REAC:R-HSA-1912422	REAC	Pre-NOTCH Expression and Processing	10916	1783		0.593103448275862	0.5958904109589042	108	10808	8	52	100	10756	10916	0.09272016432147814
M1	cpdb	0	network_modules	24	TRUE	4.76190599577096e-5	251	61	10	0.16393442622950818	0.0398406374501992	GO:0071214	GO:BP	cellular response to abiotic stimulus	16175	16476		0.4672131147540984	0.47346938775510206	251	15924	10	51	241	15873	16175	0.07388005535427193
M1	cpdb	0	network_modules	24	TRUE	4.76190599577096e-5	251	61	10	0.16393442622950818	0.0398406374501992	GO:0104004	GO:BP	cellular response to environmental stimulus	16175	19202		0.4672131147540984	0.47346938775510206	251	15924	10	51	241	15873	16175	0.07388005535427193
M1	cpdb	0	network_modules	24	TRUE	5.14674236950995e-5	105	60	8	0.13333333333333333	0.0761904761904762	KEGG:04928	KEGG	Parathyroid hormone synthesis, secretion and action	8484	385		0.6162790697674418	0.6206896551724138	105	8379	8	52	97	8327	8484	0.092333162682056
M1	cpdb	0	network_modules	24	TRUE	5.178764292393115e-5	72	60	7	0.11666666666666667	0.09722222222222222	KEGG:05218	KEGG	Melanoma	8484	469		0.627906976744186	0.6436781609195402	72	8412	7	53	65	8359	8484	0.09952876593216686
M1	cpdb	0	network_modules	24	TRUE	5.178764292393115e-5	72	60	7	0.11666666666666667	0.09722222222222222	KEGG:05140	KEGG	Leishmaniasis	8484	433		0.627906976744186	0.6436781609195402	72	8412	7	53	65	8359	8484	0.09952876593216686
M1	cpdb	0	network_modules	24	TRUE	5.5364275076459346e-5	106	60	8	0.13333333333333333	0.07547169811320754	KEGG:04620	KEGG	Toll-like receptor signaling pathway	8484	325		0.6511627906976745	0.6551724137931034	106	8378	8	52	98	8326	8484	0.09181252533406331
M1	cpdb	0	network_modules	24	TRUE	6.366611630297773e-5	3	60	3	0.05	1	REAC:R-HSA-3304347	REAC	Loss of Function of SMAD4 in Cancer	10916	1324		0.6	0.6164383561643836	3	10913	3	57	0	10856	10916	0.22302206971743874
M1	cpdb	0	network_modules	24	TRUE	6.366611630297773e-5	3	60	3	0.05	1	REAC:R-HSA-3311021	REAC	SMAD4 MH2 Domain Mutants in Cancer	10916	2155		0.6	0.6164383561643836	3	10913	3	57	0	10856	10916	0.22302206971743874
M1	cpdb	0	network_modules	24	TRUE	6.366611630297773e-5	3	60	3	0.05	1	REAC:R-HSA-3315487	REAC	SMAD2/3 MH2 Domain Mutants in Cancer	10916	2152		0.6	0.6164383561643836	3	10913	3	57	0	10856	10916	0.22302206971743874
M1	cpdb	0	network_modules	24	TRUE	6.81303688848902e-5	10	60	4	0.06666666666666667	0.4	REAC:R-HSA-9701898	REAC	STAT3 nuclear events downstream of ALK signaling	10916	2158		0.6206896551724138	0.6232876712328768	10	10906	4	56	6	10850	10916	0.16157385152341414
M1	cpdb	0	network_modules	24	TRUE	6.863736246710487e-5	75	60	7	0.11666666666666667	0.09333333333333334	KEGG:05214	KEGG	Glioma	8484	465		0.6627906976744186	0.6666666666666666	75	8409	7	53	68	8356	8484	0.09721645805146992
M1	cpdb	0	network_modules	24	TRUE	7.197753676603103e-5	138	61	8	0.13114754098360656	0.057971014492753624	GO:0009267	GO:BP	cellular response to starvation	16175	3432		0.47540983606557374	0.4775510204081633	138	16037	8	53	130	15984	16175	0.08202628728823246
M1	cpdb	0	network_modules	24	TRUE	7.518660201168099e-5	76	60	7	0.11666666666666667	0.09210526315789473	KEGG:05133	KEGG	Pertussis	8484	430		0.6744186046511628	0.6781609195402298	76	8408	7	53	69	8355	8484	0.09647492556669235
M1	cpdb	0	network_modules	24	TRUE	8.291985764139351e-5	427	61	12	0.19672131147540983	0.02810304449648712	GO:0007346	GO:BP	regulation of mitotic cell cycle	16175	2855		0.47950819672131145	0.4816326530612245	427	15748	12	49	415	15699	16175	0.06536616892560138
M1	cpdb	0	network_modules	24	TRUE	8.403050307785431e-5	199	61	9	0.14754098360655737	0.04522613065326633	GO:0071375	GO:BP	cellular response to peptide hormone stimulus	16175	16627		0.48360655737704916	0.4857142857142857	199	15976	9	52	190	15924	16175	0.07548242660330118
M1	cpdb	0	network_modules	24	TRUE	9.247919106377933e-5	154	60	9	0.15	0.05844155844155844	KEGG:04932	KEGG	Non-alcoholic fatty liver disease	8484	389		0.686046511627907	0.6896551724137931	154	8330	9	51	145	8279	8484	0.08335053657482924
M1	cpdb	0	network_modules	24	TRUE	1.0301562573059314e-4	529	61	13	0.21311475409836064	0.024574669187145556	GO:0006325	GO:BP	chromatin organization	16175	2122		0.48770491803278687	0.4897959183673469	529	15646	13	48	516	15598	16175	0.062407752862346066
M1	cpdb	0	network_modules	24	TRUE	1.0354088842335028e-4	630	61	14	0.22950819672131148	0.022222222222222223	GO:0010564	GO:BP	regulation of cell cycle process	16175	4217		0.4918032786885246	0.49387755102040815	630	15545	14	47	616	15498	16175	0.06059988685051067
M1	cpdb	0	network_modules	24	TRUE	1.0662271064206793e-4	11	60	4	0.06666666666666667	0.36363636363636365	REAC:R-HSA-9675151	REAC	Disorders of Developmental Biology	10916	776		0.6275862068965518	0.6506849315068494	11	10905	4	56	7	10849	10916	0.15384703583656772
M1	cpdb	0	network_modules	24	TRUE	1.0662271064206793e-4	11	60	4	0.06666666666666667	0.36363636363636365	REAC:R-HSA-9005891	REAC	Loss of function of MECP2 in Rett syndrome	10916	1332		0.6275862068965518	0.6506849315068494	11	10905	4	56	7	10849	10916	0.15384703583656772
M1	cpdb	0	network_modules	24	TRUE	1.0662271064206793e-4	11	60	4	0.06666666666666667	0.36363636363636365	REAC:R-HSA-9697154	REAC	Disorders of Nervous System Development	10916	777		0.6275862068965518	0.6506849315068494	11	10905	4	56	7	10849	10916	0.15384703583656772
M1	cpdb	0	network_modules	24	TRUE	1.0662271064206793e-4	11	60	4	0.06666666666666667	0.36363636363636365	REAC:R-HSA-9005895	REAC	Pervasive developmental disorders	10916	1729		0.6275862068965518	0.6506849315068494	11	10905	4	56	7	10849	10916	0.15384703583656772
M1	cpdb	0	network_modules	24	TRUE	1.0678060807548142e-4	437	61	12	0.19672131147540983	0.02745995423340961	GO:0080135	GO:BP	regulation of cellular response to stress	16175	17817		0.4959016393442623	0.49795918367346936	437	15738	12	49	425	15689	16175	0.06439985808486856
M1	cpdb	0	network_modules	24	TRUE	1.1169685209059117e-4	29	61	5	0.08196721311475409	0.1724137931034483	GO:0071276	GO:BP	cellular response to cadmium ion	16175	16533		0.5	0.5061224489795918	29	16146	5	56	24	16090	16175	0.11660343777652515
M1	cpdb	0	network_modules	24	TRUE	1.1169685209059117e-4	29	61	5	0.08196721311475409	0.1724137931034483	GO:0060765	GO:BP	regulation of androgen receptor signaling pathway	16175	14933		0.5	0.5061224489795918	29	16146	5	56	24	16090	16175	0.11660343777652515
M1	cpdb	0	network_modules	24	TRUE	1.130978511753485e-4	206	61	9	0.14754098360655737	0.043689320388349516	GO:1903320	GO:BP	regulation of protein modification by small protein conjugation or removal	16175	22904		0.5081967213114754	0.5102040816326531	206	15969	9	52	197	15917	16175	0.0739676737465991
M1	cpdb	0	network_modules	24	TRUE	1.1634853757016237e-4	81	60	7	0.11666666666666667	0.08641975308641975	KEGG:04662	KEGG	B cell receptor signaling pathway	8484	339		0.6976744186046512	0.7011494252873564	81	8403	7	53	74	8350	8484	0.09296619866318652
M1	cpdb	0	network_modules	24	TRUE	1.1667169222443445e-4	205	60	10	0.16666666666666666	0.04878048780487805	KEGG:05205	KEGG	Proteoglycans in cancer	8484	457		0.7093023255813954	0.7126436781609196	205	8279	10	50	195	8229	8484	0.07832075676597354
M1	cpdb	0	network_modules	24	TRUE	1.2265622793373627e-4	122	60	8	0.13333333333333333	0.06557377049180328	REAC:R-HSA-2559580	REAC	Oxidative Stress Induced Senescence	10916	1654		0.6551724137931034	0.6575342465753424	122	10794	8	52	114	10742	10916	0.08638766779895365
M1	cpdb	0	network_modules	24	TRUE	1.2286805741943717e-4	208	61	9	0.14754098360655737	0.04326923076923077	GO:0051091	GO:BP	positive regulation of DNA-binding transcription factor activity	16175	13486		0.5122950819672131	0.5142857142857142	208	15967	9	52	199	15915	16175	0.07354828830309552
M1	cpdb	0	network_modules	24	TRUE	1.240866013587637e-4	148	61	8	0.13114754098360656	0.05405405405405406	GO:0071478	GO:BP	cellular response to radiation	16175	16711		0.5163934426229508	0.5183673469387755	148	16027	8	53	140	15974	16175	0.07883188350357102
M1	cpdb	0	network_modules	24	TRUE	1.2802354544972163e-4	209	61	9	0.14754098360655737	0.0430622009569378	GO:1901873	GO:BP	regulation of post-translational protein modification	16175	21817		0.5204918032786885	0.5224489795918368	209	15966	9	52	200	15914	16175	0.07334074066384534
M1	cpdb	0	network_modules	24	TRUE	1.5889199899784314e-4	31	61	5	0.08196721311475409	0.16129032258064516	GO:0046686	GO:BP	response to cadmium ion	16175	12317		0.5245901639344263	0.5346938775510204	31	16144	5	56	26	16088	16175	0.11261237179089599
M1	cpdb	0	network_modules	24	TRUE	1.5889199899784314e-4	31	61	5	0.08196721311475409	0.16129032258064516	GO:0044819	GO:BP	mitotic G1/S transition checkpoint signaling	16175	11175		0.5245901639344263	0.5346938775510204	31	16144	5	56	26	16088	16175	0.11261237179089599
M1	cpdb	0	network_modules	24	TRUE	1.5889199899784314e-4	31	61	5	0.08196721311475409	0.16129032258064516	GO:0031571	GO:BP	mitotic G1 DNA damage checkpoint signaling	16175	7221		0.5245901639344263	0.5346938775510204	31	16144	5	56	26	16088	16175	0.11261237179089599
M1	cpdb	0	network_modules	24	TRUE	1.592778868566469e-4	12	60	4	0.06666666666666667	0.3333333333333333	REAC:R-HSA-4755510	REAC	SUMOylation of immune response proteins	10916	2174		0.6620689655172414	0.6643835616438356	12	10904	4	56	8	10848	10916	0.14709855522848084
M1	cpdb	0	network_modules	24	TRUE	1.6172742258233806e-4	53	60	6	0.1	0.11320754716981132	REAC:R-HSA-2151201	REAC	Transcriptional activation of mitochondrial biogenesis	10916	2548		0.6689655172413793	0.6712328767123288	53	10863	6	54	47	10809	10916	0.10175978988223132
M1	cpdb	0	network_modules	24	TRUE	1.6509800369840356e-4	61	61	6	0.09836065573770492	0.09836065573770492	GO:2000134	GO:BP	negative regulation of G1/S transition of mitotic cell cycle	16175	25483		0.5368852459016393	0.5428571428571428	61	16114	6	55	55	16059	16175	0.0949474746529339
M1	cpdb	0	network_modules	24	TRUE	1.6509800369840356e-4	61	61	6	0.09836065573770492	0.09836065573770492	GO:0033143	GO:BP	regulation of intracellular steroid hormone receptor signaling pathway	16175	8057		0.5368852459016393	0.5428571428571428	61	16114	6	55	55	16059	16175	0.0949474746529339
M1	cpdb	0	network_modules	24	TRUE	1.6892400433700432e-4	552	61	13	0.21311475409836064	0.02355072463768116	GO:0035239	GO:BP	tube morphogenesis	16175	8921		0.5450819672131147	0.5469387755102041	552	15623	13	48	539	15575	16175	0.06065683203367929
M1	cpdb	0	network_modules	24	TRUE	1.7699748648335455e-4	507	60	14	0.23333333333333334	0.027613412228796843	REAC:R-HSA-9006934	REAC	Signaling by Receptor Tyrosine Kinases	10916	2302		0.6758620689655173	0.678082191780822	507	10409	14	46	493	10363	10916	0.06602016170960687
M1	cpdb	0	network_modules	24	TRUE	1.8117184822914086e-4	54	60	6	0.1	0.1111111111111111	REAC:R-HSA-109606	REAC	Intrinsic Pathway for Apoptosis	10916	1268		0.6827586206896552	0.684931506849315	54	10862	6	54	48	10808	10916	0.10072073626815169
M1	cpdb	0	network_modules	24	TRUE	1.8990955613701574e-4	104	61	7	0.11475409836065574	0.0673076923076923	GO:0071453	GO:BP	cellular response to oxygen levels	16175	16687		0.5491803278688525	0.5510204081632653	104	16071	7	54	97	16017	16175	0.08338650876702003
M1	cpdb	0	network_modules	24	TRUE	2.0094373171762812e-4	234	60	10	0.16666666666666666	0.042735042735042736	REAC:R-HSA-8878171	REAC	Transcriptional regulation by RUNX1	10916	2552		0.6896551724137931	0.6917808219178082	234	10682	10	50	224	10632	10916	0.0745464700768812
M1	cpdb	0	network_modules	24	TRUE	2.0287948452088331e-4	105	61	7	0.11475409836065574	0.06666666666666667	GO:0071482	GO:BP	cellular response to light stimulus	16175	16715		0.5532786885245902	0.5551020408163265	105	16070	7	54	98	16016	16175	0.08294369691375336
M1	cpdb	0	network_modules	24	TRUE	2.1612657972029566e-4	159	61	8	0.13114754098360656	0.050314465408805034	GO:0042594	GO:BP	response to starvation	16175	10254		0.5573770491803278	0.5591836734693878	159	16016	8	53	151	15963	16175	0.07565812761706363
M1	cpdb	0	network_modules	24	TRUE	2.1891498236545877e-4	30	60	5	0.08333333333333333	0.16666666666666666	REAC:R-HSA-114452	REAC	Activation of BH3-only proteins	10916	77		0.696551724137931	0.7054794520547946	30	10886	5	55	25	10831	10916	0.11443636414572189
M1	cpdb	0	network_modules	24	TRUE	2.1891498236545877e-4	30	60	5	0.08333333333333333	0.16666666666666666	REAC:R-HSA-6804758	REAC	Regulation of TP53 Activity through Acetylation	10916	2013		0.696551724137931	0.7054794520547946	30	10886	5	55	25	10831	10916	0.11443636414572189
M1	cpdb	0	network_modules	24	TRUE	2.3072920738509054e-4	297	61	10	0.16393442622950818	0.03367003367003367	GO:0031647	GO:BP	regulation of protein stability	16175	7257		0.5614754098360656	0.563265306122449	297	15878	10	51	287	15827	16175	0.06671315977201048
M1	cpdb	0	network_modules	24	TRUE	2.401185054780904e-4	58	60	6	0.1	0.10344827586206896	KEGG:05213	KEGG	Endometrial cancer	8484	464		0.7209302325581395	0.7241379310344828	58	8426	6	54	52	8372	8484	0.0954198333003835
M1	cpdb	0	network_modules	24	TRUE	2.4995196702615207e-4	223	60	10	0.16666666666666666	0.04484304932735426	KEGG:04024	KEGG	cAMP signaling pathway	8484	252		0.7325581395348837	0.735632183908046	223	8261	10	50	213	8211	8484	0.07405586601544069
M1	cpdb	0	network_modules	24	TRUE	2.596451482820651e-4	92	60	7	0.11666666666666667	0.07608695652173914	REAC:R-HSA-1592230	REAC	Mitochondrial biogenesis	10916	1464		0.7103448275862069	0.7191780821917808	92	10824	7	53	85	10771	10916	0.08802355022239186
M1	cpdb	0	network_modules	24	TRUE	2.596451482820651e-4	92	60	7	0.11666666666666667	0.07608695652173914	REAC:R-HSA-2219528	REAC	PI3K/AKT Signaling in Cancer	10916	1674		0.7103448275862069	0.7191780821917808	92	10824	7	53	85	10771	10916	0.08802355022239186
M1	cpdb	0	network_modules	24	TRUE	2.662438943263269e-4	66	61	6	0.09836065573770492	0.09090909090909091	GO:1902807	GO:BP	negative regulation of cell cycle G1/S phase transition	16175	22526		0.5655737704918032	0.5673469387755102	66	16109	6	55	60	16054	16175	0.0909959690674182
M1	cpdb	0	network_modules	24	TRUE	2.7594800118879703e-4	92	60	7	0.11666666666666667	0.07608695652173914	KEGG:05222	KEGG	Small cell lung cancer	8484	473		0.7441860465116279	0.7471264367816092	92	8392	7	53	85	8339	8484	0.08623218604506805
M1	cpdb	0	network_modules	24	TRUE	2.7952271280437486e-4	110	61	7	0.11475409836065574	0.06363636363636363	GO:1900180	GO:BP	regulation of protein localization to nucleus	16175	20456		0.569672131147541	0.5714285714285714	110	16065	7	54	103	16011	16175	0.08081788243784307
M1	cpdb	0	network_modules	24	TRUE	2.8750677747723616e-4	165	61	8	0.13114754098360656	0.048484848484848485	GO:0002573	GO:BP	myeloid leukocyte differentiation	16175	1094		0.5737704918032787	0.5755102040816327	165	16010	8	53	157	15957	16175	0.07405657150079764
M1	cpdb	0	network_modules	24	TRUE	2.915796124855288e-4	67	61	6	0.09836065573770492	0.08955223880597014	GO:1900542	GO:BP	regulation of purine nucleotide metabolic process	16175	20727		0.5778688524590164	0.5795918367346938	67	16108	6	55	61	16053	16175	0.09025792008668042
M1	cpdb	0	network_modules	24	TRUE	3.0118146395947194e-4	166	61	8	0.13114754098360656	0.04819277108433735	GO:1902806	GO:BP	regulation of cell cycle G1/S phase transition	16175	22525		0.5819672131147541	0.5836734693877551	166	16009	8	53	158	15956	16175	0.07379773635002863
M1	cpdb	0	network_modules	24	TRUE	3.1812005260950656e-4	4	61	3	0.04918032786885246	0.75	GO:0018076	GO:BP	N-terminal peptidyl-lysine acetylation	16175	5317		0.5860655737704918	0.5877551020408164	4	16171	3	58	1	16113	16175	0.19147462396063678
M1	cpdb	0	network_modules	24	TRUE	3.1886504969750093e-4	68	61	6	0.09836065573770492	0.08823529411764706	GO:0006140	GO:BP	regulation of nucleotide metabolic process	16175	1985		0.5901639344262295	0.5918367346938775	68	16107	6	55	62	16052	16175	0.0895357922450246
M1	cpdb	0	network_modules	24	TRUE	3.4678520395208786e-4	135	60	8	0.13333333333333333	0.05925925925925926	KEGG:04210	KEGG	Apoptosis	8484	287		0.7558139534883721	0.7586206896551724	135	8349	8	52	127	8297	8484	0.0791915546168714
M1	cpdb	0	network_modules	24	TRUE	3.572245374159672e-4	114	61	7	0.11475409836065574	0.06140350877192982	GO:0000077	GO:BP	DNA damage checkpoint signaling	16175	28		0.5942622950819673	0.5959183673469388	114	16061	7	54	107	16007	16175	0.07921536969624489
M1	cpdb	0	network_modules	24	TRUE	3.600209058889637e-4	33	60	5	0.08333333333333333	0.15151515151515152	REAC:R-HSA-9634815	REAC	Transcriptional Regulation by NPAS4	10916	2545		0.7241379310344828	0.726027397260274	33	10883	5	55	28	10828	10916	0.10875366888336686
M1	cpdb	0	network_modules	24	TRUE	3.784530698017619e-4	15	61	4	0.06557377049180328	0.26666666666666666	GO:0060766	GO:BP	negative regulation of androgen receptor signaling pathway	16175	14934		0.5983606557377049	0.6	15	16160	4	57	11	16103	16175	0.1306729377702847
M1	cpdb	0	network_modules	24	TRUE	4.135141757422766e-4	173	61	8	0.13114754098360656	0.046242774566473986	GO:0006352	GO:BP	DNA-templated transcription initiation	16175	2129		0.6024590163934426	0.6040816326530613	173	16002	8	53	165	15949	16175	0.072046260118148
M1	cpdb	0	network_modules	24	TRUE	4.303372471836319e-4	241	61	9	0.14754098360655737	0.03734439834024896	GO:0034504	GO:BP	protein localization to nucleus	16175	8670		0.6065573770491803	0.6081632653061224	241	15934	9	52	232	15882	16175	0.06736213624461099
M1	cpdb	0	network_modules	24	TRUE	4.3383791195037585e-4	15	60	4	0.06666666666666667	0.26666666666666666	REAC:R-HSA-9823730	REAC	Formation of definitive endoderm	10916	957		0.7310344827586207	0.7328767123287672	15	10901	4	56	11	10845	10916	0.13103550265688574
M1	cpdb	0	network_modules	24	TRUE	5.031822245751829e-4	16	61	4	0.06557377049180328	0.25	GO:1900034	GO:BP	regulation of cellular response to heat	16175	20340		0.610655737704918	0.6122448979591837	16	16159	4	57	12	16102	16175	0.12640643987760203
M1	cpdb	0	network_modules	24	TRUE	5.517631930498006e-4	301	60	11	0.18333333333333332	0.036544850498338874	KEGG:04010	KEGG	MAPK signaling pathway	8484	243		0.7674418604651163	0.7701149425287356	301	8183	11	49	290	8134	8484	0.0674548169444793
M1	cpdb	0	network_modules	24	TRUE	5.875180529704212e-4	103	60	7	0.11666666666666667	0.06796116504854369	KEGG:04137	KEGG	Mitophagy - animal	8484	274		0.7790697674418605	0.7816091954022989	103	8381	7	53	96	8328	8484	0.08055186460435333
M1	cpdb	0	network_modules	24	TRUE	6.000027258590666e-4	246	60	10	0.16666666666666666	0.04065040650406504	KEGG:05131	KEGG	Shigellosis	8484	428		0.7906976744186046	0.7931034482758621	246	8238	10	50	236	8188	8484	0.06924379174176633
M1	cpdb	0	network_modules	24	TRUE	6.005821790509954e-4	123	61	7	0.11475409836065574	0.056910569105691054	GO:0031570	GO:BP	DNA integrity checkpoint signaling	16175	7220		0.6147540983606558	0.6163265306122448	123	16052	7	54	116	15998	16175	0.07588949133889324
M1	cpdb	0	network_modules	24	TRUE	6.316833579346383e-4	5	60	3	0.05	0.6	REAC:R-HSA-3134973	REAC	LRR FLII-interacting protein 1 (LRRFIP1) activates type I IFN production	10916	1299		0.7379310344827587	0.7397260273972602	5	10911	3	57	2	10854	10916	0.17213140385266137
M1	cpdb	0	network_modules	24	TRUE	6.561535223163121e-4	17	61	4	0.06557377049180328	0.23529411764705882	GO:1900543	GO:BP	negative regulation of purine nucleotide metabolic process	16175	20728		0.6188524590163934	0.6204081632653061	17	16158	4	57	13	16101	16175	0.12251866059338838
M1	cpdb	0	network_modules	24	TRUE	6.696429408101434e-4	69	60	6	0.1	0.08695652173913043	KEGG:05031	KEGG	Amphetamine addiction	8484	419		0.8023255813953488	0.8045977011494253	69	8415	6	54	63	8361	8484	0.08632274497906772
M1	cpdb	0	network_modules	24	TRUE	6.728085152541748e-4	77	61	6	0.09836065573770492	0.07792207792207792	GO:0044773	GO:BP	mitotic DNA damage checkpoint signaling	16175	11149		0.6229508196721312	0.6244897959183674	77	16098	6	55	71	16043	16175	0.08366678603568377
M1	cpdb	0	network_modules	24	TRUE	6.80852375946557e-4	41	61	5	0.08196721311475409	0.12195121951219512	GO:0003300	GO:BP	cardiac muscle hypertrophy	16175	1722		0.6270491803278688	0.6285714285714286	41	16134	5	56	36	16078	16175	0.09719467250155117
M1	cpdb	0	network_modules	24	TRUE	7.022592341902979e-4	625	61	13	0.21311475409836064	0.0208	GO:0034097	GO:BP	response to cytokine	16175	8408		0.6311475409836066	0.636734693877551	625	15550	13	48	612	15502	16175	0.05569743874387574
M1	cpdb	0	network_modules	24	TRUE	7.022592341902979e-4	625	61	13	0.21311475409836064	0.0208	GO:1901652	GO:BP	response to peptide	16175	21619		0.6311475409836066	0.636734693877551	625	15550	13	48	612	15502	16175	0.05569743874387574
M1	cpdb	0	network_modules	24	TRUE	7.467825731012905e-4	127	61	7	0.11475409836065574	0.05511811023622047	GO:0000302	GO:BP	response to reactive oxygen species	16175	88		0.639344262295082	0.6408163265306123	127	16048	7	54	120	15994	16175	0.0745217373057835
M1	cpdb	0	network_modules	24	TRUE	7.502437540710336e-4	17	60	4	0.06666666666666667	0.23529411764705882	REAC:R-HSA-1502540	REAC	Signaling by Activin	10916	2223		0.7448275862068966	0.7671232876712328	17	10899	4	56	13	10843	10916	0.12275229066362867
M1	cpdb	0	network_modules	24	TRUE	7.502437540710336e-4	17	60	4	0.06666666666666667	0.23529411764705882	REAC:R-HSA-9659787	REAC	Aberrant regulation of mitotic G1/S transition in cancer due to RB1 defects	10916	47		0.7448275862068966	0.7671232876712328	17	10899	4	56	13	10843	10916	0.12275229066362867
M1	cpdb	0	network_modules	24	TRUE	7.502437540710336e-4	17	60	4	0.06666666666666667	0.23529411764705882	REAC:R-HSA-9661069	REAC	Defective binding of RB1 mutants to E2F1,(E2F2, E2F3)	10916	689		0.7448275862068966	0.7671232876712328	17	10899	4	56	13	10843	10916	0.12275229066362867
M1	cpdb	0	network_modules	24	TRUE	7.502437540710336e-4	17	60	4	0.06666666666666667	0.23529411764705882	REAC:R-HSA-9754189	REAC	Germ layer formation at gastrulation	10916	1046		0.7448275862068966	0.7671232876712328	17	10899	4	56	13	10843	10916	0.12275229066362867
M1	cpdb	0	network_modules	24	TRUE	7.706314575870984e-4	42	61	5	0.08196721311475409	0.11904761904761904	GO:0045815	GO:BP	transcription initiation-coupled chromatin remodeling	16175	11637		0.6434426229508197	0.6530612244897959	42	16133	5	56	37	16077	16175	0.09595885381986818
M1	cpdb	0	network_modules	24	TRUE	7.706314575870984e-4	42	61	5	0.08196721311475409	0.11904761904761904	GO:0141137	GO:BP	positive regulation of gene expression, epigenetic	16175	20039		0.6434426229508197	0.6530612244897959	42	16133	5	56	37	16077	16175	0.09595885381986818
M1	cpdb	0	network_modules	24	TRUE	7.706314575870984e-4	42	61	5	0.08196721311475409	0.11904761904761904	GO:0043502	GO:BP	regulation of muscle adaptation	16175	10740		0.6434426229508197	0.6530612244897959	42	16133	5	56	37	16077	16175	0.09595885381986818
M1	cpdb	0	network_modules	24	TRUE	7.826671874963252e-4	631	61	13	0.21311475409836064	0.020602218700475437	GO:0022603	GO:BP	regulation of anatomical structure morphogenesis	16175	6611		0.6557377049180327	0.6571428571428571	631	15544	13	48	618	15496	16175	0.055324823936076
M1	cpdb	0	network_modules	24	TRUE	7.931611848763079e-4	5	61	3	0.04918032786885246	0.6	GO:0030578	GO:BP	PML body organization	16175	6850		0.6598360655737705	0.6612244897959184	5	16170	3	58	2	16112	16175	0.17104902254369697
M1	cpdb	0	network_modules	24	TRUE	7.968428905650106e-4	632	61	13	0.21311475409836064	0.020569620253164556	GO:0031401	GO:BP	positive regulation of protein modification process	16175	7157		0.6639344262295082	0.6653061224489796	632	15543	13	48	619	15495	16175	0.05526318449916172
M1	cpdb	0	network_modules	24	TRUE	8.41249117173388e-4	18	61	4	0.06557377049180328	0.2222222222222222	GO:0045980	GO:BP	negative regulation of nucleotide metabolic process	16175	11772		0.6680327868852459	0.6693877551020408	18	16157	4	57	14	16100	16175	0.11895633089754788
M1	cpdb	0	network_modules	24	TRUE	8.516264385328736e-4	39	60	5	0.08333333333333333	0.1282051282051282	REAC:R-HSA-9031628	REAC	NGF-stimulated transcription	10916	1527		0.7724137931034483	0.773972602739726	39	10877	5	55	34	10822	10916	0.09938154818133892
M1	cpdb	0	network_modules	24	TRUE	8.54905358711616e-4	109	60	7	0.11666666666666667	0.06422018348623854	KEGG:04066	KEGG	HIF-1 signaling pathway	8484	257		0.813953488372093	0.8160919540229885	109	8375	7	53	102	8322	8484	0.07780152240134289
M1	cpdb	0	network_modules	24	TRUE	8.585583544958101e-4	72	60	6	0.1	0.08333333333333333	KEGG:05223	KEGG	Non-small cell lung cancer	8484	474		0.8255813953488372	0.8275862068965517	72	8412	6	54	66	8358	8484	0.08419495954427364
M1	cpdb	0	network_modules	24	TRUE	8.65657365783916e-4	202	60	9	0.15	0.04455445544554455	KEGG:05415	KEGG	Diabetic cardiomyopathy	8484	492		0.8372093023255814	0.8390804597701149	202	8282	9	51	193	8231	8484	0.0698554649068128
M1	cpdb	0	network_modules	24	TRUE	8.691345287268001e-4	262	61	9	0.14754098360655737	0.03435114503816794	GO:0010948	GO:BP	negative regulation of cell cycle process	16175	4526		0.6721311475409836	0.673469387755102	262	15913	9	52	253	15861	16175	0.06401596099649091
M1	cpdb	0	network_modules	24	TRUE	8.695165287430932e-4	43	61	5	0.08196721311475409	0.11627906976744186	GO:0014897	GO:BP	striated muscle hypertrophy	16175	4772		0.6762295081967213	0.6775510204081633	43	16132	5	56	38	16076	16175	0.094765555920265
M1	cpdb	0	network_modules	24	TRUE	9.102707416722631e-4	81	61	6	0.09836065573770492	0.07407407407407407	GO:0044774	GO:BP	mitotic DNA integrity checkpoint signaling	16175	11150		0.680327868852459	0.6816326530612244	81	16094	6	55	75	16039	16175	0.08136937163626454
M1	cpdb	0	network_modules	24	TRUE	9.282722534935591e-4	111	60	7	0.11666666666666667	0.06306306306306306	REAC:R-HSA-6785807	REAC	Interleukin-4 and Interleukin-13 signaling	10916	1252		0.7793103448275862	0.7876712328767124	111	10805	7	53	104	10752	10916	0.07891730523897728
M1	cpdb	0	network_modules	24	TRUE	9.282722534935591e-4	111	60	7	0.11666666666666667	0.06306306306306306	REAC:R-HSA-2559582	REAC	Senescence-Associated Secretory Phenotype (SASP)	10916	2194		0.7793103448275862	0.7876712328767124	111	10805	7	53	104	10752	10916	0.07891730523897728
M1	cpdb	0	network_modules	24	TRUE	9.672416485543188e-4	347	61	10	0.16393442622950818	0.02881844380403458	GO:0007507	GO:BP	heart development	16175	2993		0.6844262295081968	0.6857142857142857	347	15828	10	51	337	15777	16175	0.06050460798424361
M1	cpdb	0	network_modules	24	TRUE	9.781651859236946e-4	44	61	5	0.08196721311475409	0.11363636363636363	GO:0014896	GO:BP	muscle hypertrophy	16175	4771		0.6885245901639344	0.689795918367347	44	16131	5	56	39	16075	16175	0.09361235835029948
M1	cpdb	0	network_modules	24	TRUE	9.859434078941373e-4	112	60	7	0.11666666666666667	0.0625	REAC:R-HSA-187037	REAC	Signaling by NTRK1 (TRKA)	10916	2284		0.7931034482758621	0.7945205479452054	112	10804	7	53	105	10751	10916	0.0785002584039281
M1	cpdb	0	network_modules	24	TRUE	0.0010112505624095308	156	60	8	0.13333333333333333	0.05128205128205128	KEGG:04148	KEGG	Efferocytosis	8484	283		0.8488372093023255	0.8505747126436781	156	8328	8	52	148	8276	8484	0.07220669734307557
M1	cpdb	0	network_modules	24	TRUE	0.001015287453195392	72	60	6	0.1	0.08333333333333333	REAC:R-HSA-3108214	REAC	SUMOylation of DNA damage response and repair proteins	10916	2168		0.8	0.8013698630136986	72	10844	6	54	66	10790	10916	0.08578463978826309
M1	cpdb	0	network_modules	24	TRUE	0.0011103026944386226	114	60	7	0.11666666666666667	0.06140350877192982	REAC:R-HSA-9758941	REAC	Gastrulation	10916	1040		0.8068965517241379	0.8082191780821918	114	10802	7	53	107	10749	10916	0.07768182743456511
M1	cpdb	0	network_modules	24	TRUE	0.001172997191695653	654	61	13	0.21311475409836064	0.019877675840978593	GO:0031347	GO:BP	regulation of defense response	16175	7138		0.6926229508196722	0.6938775510204082	654	15521	13	48	641	15473	16175	0.05393936657412072
M1	cpdb	0	network_modules	24	TRUE	0.0012140374871317933	656	61	13	0.21311475409836064	0.019817073170731708	GO:1903047	GO:BP	mitotic cell cycle process	16175	22727		0.6967213114754098	0.6979591836734694	656	15519	13	48	643	15471	16175	0.053821983016722315
M1	cpdb	0	network_modules	24	TRUE	0.0012584195429124017	6	60	3	0.05	0.5	REAC:R-HSA-9022537	REAC	Loss of MECP2 binding ability to the NCoR/SMRT complex	10916	1330		0.8137931034482758	0.821917808219178	6	10910	3	57	3	10853	10916	0.1568503844798911
M1	cpdb	0	network_modules	24	TRUE	0.0012584195429124017	6	60	3	0.05	0.5	REAC:R-HSA-3304349	REAC	Loss of Function of SMAD2/3 in Cancer	10916	1323		0.8137931034482758	0.821917808219178	6	10910	3	57	3	10853	10916	0.1568503844798911
M1	cpdb	0	network_modules	24	TRUE	0.0013025019856362562	275	61	9	0.14754098360655737	0.03272727272727273	GO:2001233	GO:BP	regulation of apoptotic signaling pathway	16175	26422		0.7008196721311475	0.7020408163265306	275	15900	9	52	266	15848	16175	0.0621275684885261
M1	cpdb	0	network_modules	24	TRUE	0.0013441137842845022	202	61	8	0.13114754098360656	0.039603960396039604	GO:0045930	GO:BP	negative regulation of mitotic cell cycle	16175	11724		0.7049180327868853	0.7061224489795919	202	15973	8	53	194	15920	16175	0.06574152395095517
M1	cpdb	0	network_modules	24	TRUE	0.0013697029175568718	47	61	5	0.08196721311475409	0.10638297872340426	GO:0043470	GO:BP	regulation of carbohydrate catabolic process	16175	10718		0.7090163934426229	0.710204081632653	47	16128	5	56	42	16072	16175	0.09037188893686329
M1	cpdb	0	network_modules	24	TRUE	0.0013869189494829447	555	61	12	0.19672131147540983	0.021621621621621623	GO:0071345	GO:BP	cellular response to cytokine stimulus	16175	16597		0.7131147540983607	0.7142857142857143	555	15620	12	49	543	15571	16175	0.054894759149718066
M1	cpdb	0	network_modules	24	TRUE	0.0014636085839234187	667	61	13	0.21311475409836064	0.019490254872563718	GO:0032446	GO:BP	protein modification by small protein conjugation	16175	7568		0.7172131147540983	0.7183673469387755	667	15508	13	48	654	15460	16175	0.05318482176618344
M1	cpdb	0	network_modules	24	TRUE	0.0015083265797625847	77	60	6	0.1	0.07792207792207792	REAC:R-HSA-5693565	REAC	Recruitment and ATM-mediated phosphorylation of repair and signaling proteins at DNA double strand breaks	10916	1949		0.8275862068965517	0.8287671232876712	77	10839	6	54	71	10785	10916	0.08256492583344238
M1	cpdb	0	network_modules	24	TRUE	0.001508573247568079	20	60	4	0.06666666666666667	0.2	REAC:R-HSA-6803204	REAC	TP53 Regulates Transcription of Genes Involved in Cytochrome C Release	10916	2458		0.8344827586206897	0.8493150684931506	20	10896	4	56	16	10840	10916	0.11270983488222948
M1	cpdb	0	network_modules	24	TRUE	0.001508573247568079	20	60	4	0.06666666666666667	0.2	REAC:R-HSA-5621575	REAC	CD209 (DC-SIGN) signaling	10916	265		0.8344827586206897	0.8493150684931506	20	10896	4	56	16	10840	10916	0.11270983488222948
M1	cpdb	0	network_modules	24	TRUE	0.001508573247568079	20	60	4	0.06666666666666667	0.2	REAC:R-HSA-9013695	REAC	NOTCH4 Intracellular Domain Regulates Transcription	10916	1538		0.8344827586206897	0.8493150684931506	20	10896	4	56	16	10840	10916	0.11270983488222948
M1	cpdb	0	network_modules	24	TRUE	0.001515873386493754	141	61	7	0.11475409836065574	0.04964539007092199	GO:2000045	GO:BP	regulation of G1/S transition of mitotic cell cycle	16175	25406		0.7213114754098361	0.7224489795918367	141	16034	7	54	134	15980	16175	0.07018337144974414
M1	cpdb	0	network_modules	24	TRUE	0.0015646525385258556	120	60	7	0.11666666666666667	0.058333333333333334	REAC:R-HSA-5619507	REAC	Activation of HOX genes during differentiation	10916	84		0.8551724137931035	0.863013698630137	120	10796	7	53	113	10743	10916	0.07534402125673818
M1	cpdb	0	network_modules	24	TRUE	0.0015646525385258556	120	60	7	0.11666666666666667	0.058333333333333334	REAC:R-HSA-5617472	REAC	Activation of anterior HOX genes in hindbrain development during early embryogenesis	10916	99		0.8551724137931035	0.863013698630137	120	10796	7	53	113	10743	10916	0.07534402125673818
M1	cpdb	0	network_modules	24	TRUE	0.0015820565387294038	6	61	3	0.04918032786885246	0.5	GO:0032906	GO:BP	transforming growth factor beta2 production	16175	7898		0.7254098360655737	0.7306122448979592	6	16169	3	58	3	16111	16175	0.15595297272176414
M1	cpdb	0	network_modules	24	TRUE	0.0015820565387294038	6	61	3	0.04918032786885246	0.5	GO:0032909	GO:BP	regulation of transforming growth factor beta2 production	16175	7901		0.7254098360655737	0.7306122448979592	6	16169	3	58	3	16111	16175	0.15595297272176414
M1	cpdb	0	network_modules	24	TRUE	0.001592283067672554	89	61	6	0.09836065573770492	0.06741573033707865	GO:0071456	GO:BP	cellular response to hypoxia	16175	16690		0.7336065573770492	0.7387755102040816	89	16086	6	55	83	16031	16175	0.07723415420346998
M1	cpdb	0	network_modules	24	TRUE	0.001592283067672554	89	61	6	0.09836065573770492	0.06741573033707865	GO:0048660	GO:BP	regulation of smooth muscle cell proliferation	16175	12918		0.7336065573770492	0.7387755102040816	89	16086	6	55	83	16031	16175	0.07723415420346998
M1	cpdb	0	network_modules	24	TRUE	0.001627094046250918	78	60	6	0.1	0.07692307692307693	REAC:R-HSA-5693606	REAC	DNA Double Strand Break Response	10916	442		0.8689655172413793	0.8698630136986302	78	10838	6	54	72	10784	10916	0.0819568834125818
M1	cpdb	0	network_modules	24	TRUE	0.0016315181551940813	21	61	4	0.06557377049180328	0.19047619047619047	GO:0006977	GO:BP	DNA damage response, signal transduction by p53 class mediator resulting in cell cycle arrest	16175	2602		0.7418032786885246	0.7428571428571429	21	16154	4	57	17	16097	16175	0.10982547895596308
M1	cpdb	0	network_modules	24	TRUE	0.0016667496387196914	143	61	7	0.11475409836065574	0.04895104895104895	GO:0006367	GO:BP	transcription initiation at RNA polymerase II promoter	16175	2142		0.7459016393442623	0.746938775510204	143	16032	7	54	136	15978	16175	0.06961392711951768
M1	cpdb	0	network_modules	24	TRUE	0.001692916401732193	49	61	5	0.08196721311475409	0.10204081632653061	GO:0034605	GO:BP	cellular response to heat	16175	8685		0.75	0.7510204081632653	49	16126	5	56	44	16070	16175	0.08837540873120424
M1	cpdb	0	network_modules	24	TRUE	0.0017010470447002216	90	61	6	0.09836065573770492	0.06666666666666667	GO:0010212	GO:BP	response to ionizing radiation	16175	3993		0.7540983606557377	0.7551020408163265	90	16085	6	55	84	16030	16175	0.07675512786369378
M1	cpdb	0	network_modules	24	TRUE	0.0017947765839752673	298	60	10	0.16666666666666666	0.03355704697986577	REAC:R-HSA-5688426	REAC	Deubiquitination	10916	736		0.8758620689655172	0.8767123287671232	298	10618	10	50	288	10568	10916	0.06358220666755014
M1	cpdb	0	network_modules	24	TRUE	0.0018158151257825586	91	61	6	0.09836065573770492	0.06593406593406594	GO:0048659	GO:BP	smooth muscle cell proliferation	16175	12917		0.7581967213114754	0.7591836734693878	91	16084	6	55	85	16029	16175	0.07628374787872802
M1	cpdb	0	network_modules	24	TRUE	0.0018246189725545025	798	61	14	0.22950819672131148	0.017543859649122806	GO:0043687	GO:BP	post-translational protein modification	16175	10838		0.7622950819672131	0.763265306122449	798	15377	14	47	784	15330	16175	0.051186980141188256
M1	cpdb	0	network_modules	24	TRUE	0.0018267680000818743	49	60	5	0.08333333333333333	0.10204081632653061	KEGG:05030	KEGG	Cocaine addiction	8484	418		0.8604651162790697	0.8620689655172413	49	8435	5	55	44	8380	8484	0.08637772395444922
M1	cpdb	0	network_modules	24	TRUE	0.0018558926740416298	21	60	4	0.06666666666666667	0.19047619047619047	REAC:R-HSA-9768919	REAC	NPAS4 regulates expression of target genes	10916	1539		0.8827586206896552	0.8835616438356164	21	10895	4	56	17	10839	10916	0.10984316008689037
M1	cpdb	0	network_modules	24	TRUE	0.0019368404976831761	92	61	6	0.09836065573770492	0.06521739130434782	GO:0016525	GO:BP	negative regulation of angiogenesis	16175	5237		0.7663934426229508	0.7714285714285715	92	16083	6	55	86	16028	16175	0.07581980732872798
M1	cpdb	0	network_modules	24	TRUE	0.0019368404976831761	92	61	6	0.09836065573770492	0.06521739130434782	GO:0036294	GO:BP	cellular response to decreased oxygen levels	16175	9545		0.7663934426229508	0.7714285714285715	92	16083	6	55	86	16028	16175	0.07581980732872798
M1	cpdb	0	network_modules	24	TRUE	0.0019464106795120115	124	60	7	0.11666666666666667	0.056451612903225805	REAC:R-HSA-9755511	REAC	KEAP1-NFE2L2 pathway	10916	1281		0.8896551724137931	0.8904109589041096	124	10792	7	53	117	10739	10916	0.07387550558458719
M1	cpdb	0	network_modules	24	TRUE	0.0020643836869261314	93	61	6	0.09836065573770492	0.06451612903225806	GO:2000181	GO:BP	negative regulation of blood vessel morphogenesis	16175	25513		0.7745901639344263	0.7755102040816326	93	16082	6	55	87	16027	16175	0.07536310707889575
M1	cpdb	0	network_modules	24	TRUE	0.0020755565617216415	214	61	8	0.13114754098360656	0.037383177570093455	GO:0044843	GO:BP	cell cycle G1/S phase transition	16175	11189		0.7786885245901639	0.7795918367346939	214	15961	8	53	206	15908	16175	0.06349622761431627
M1	cpdb	0	network_modules	24	TRUE	0.0020999570916605424	148	61	7	0.11475409836065574	0.0472972972972973	GO:2000058	GO:BP	regulation of ubiquitin-dependent protein catabolic process	16175	25413		0.7827868852459017	0.7836734693877551	148	16027	7	54	141	15973	16175	0.0682388409715016
M1	cpdb	0	network_modules	24	TRUE	0.0021936121848322374	7	60	3	0.05	0.42857142857142855	REAC:R-HSA-3304351	REAC	Signaling by TGF-beta Receptor Complex in Cancer	10916	2309		0.896551724137931	0.8972602739726028	7	10909	3	57	4	10852	10916	0.14495286513579483
M1	cpdb	0	network_modules	24	TRUE	0.0021987126703051584	94	61	6	0.09836065573770492	0.06382978723404255	GO:1901343	GO:BP	negative regulation of vasculature development	16175	21402		0.7868852459016393	0.7877551020408163	94	16081	6	55	88	16026	16175	0.07491345540641395
M1	cpdb	0	network_modules	24	TRUE	0.002287444471641114	52	61	5	0.08196721311475409	0.09615384615384616	GO:1903053	GO:BP	regulation of extracellular matrix organization	16175	22732		0.7909836065573771	0.7918367346938775	52	16123	5	56	47	16067	16175	0.08559464412896366
M1	cpdb	0	network_modules	24	TRUE	0.0024003050883864654	23	61	4	0.06557377049180328	0.17391304347826086	GO:0034391	GO:BP	regulation of smooth muscle cell apoptotic process	16175	8612		0.7950819672131147	0.8	23	16152	4	57	19	16095	16175	0.10474648513165864
M1	cpdb	0	network_modules	24	TRUE	0.0024003050883864654	23	61	4	0.06557377049180328	0.17391304347826086	GO:0034390	GO:BP	smooth muscle cell apoptotic process	16175	8611		0.7950819672131147	0.8	23	16152	4	57	19	16095	16175	0.10474648513165864
M1	cpdb	0	network_modules	24	TRUE	0.0025184414022111326	53	61	5	0.08196721311475409	0.09433962264150944	GO:0071479	GO:BP	cellular response to ionizing radiation	16175	16712		0.8032786885245902	0.8040816326530612	53	16122	5	56	48	16066	16175	0.08471937117700044
M1	cpdb	0	network_modules	24	TRUE	0.00266900943547346	356	60	11	0.18333333333333332	0.03089887640449438	KEGG:04151	KEGG	PI3K-Akt signaling pathway	8484	285		0.872093023255814	0.8735632183908046	356	8128	11	49	345	8079	8484	0.05950639546521008
M1	cpdb	0	network_modules	24	TRUE	0.002704481823993754	49	60	5	0.08333333333333333	0.10204081632653061	REAC:R-HSA-6791312	REAC	TP53 Regulates Transcription of Cell Cycle Genes	10916	2454		0.903448275862069	0.9041095890410958	49	10867	5	55	44	10812	10916	0.08768449751082538
M1	cpdb	0	network_modules	24	TRUE	0.0027233907860357786	23	60	4	0.06666666666666667	0.17391304347826086	REAC:R-HSA-1181150	REAC	Signaling by NODAL	10916	2273		0.9103448275862069	0.9178082191780822	23	10893	4	56	19	10837	10916	0.10467135633622322
M1	cpdb	0	network_modules	24	TRUE	0.0027233907860357786	23	60	4	0.06666666666666667	0.17391304347826086	REAC:R-HSA-8940973	REAC	RUNX2 regulates osteoblast differentiation	10916	1930		0.9103448275862069	0.9178082191780822	23	10893	4	56	19	10837	10916	0.10467135633622322
M1	cpdb	0	network_modules	24	TRUE	0.0027611547865425464	7	61	3	0.04918032786885246	0.42857142857142855	GO:0097709	GO:BP	connective tissue replacement	16175	18738		0.8073770491803278	0.8081632653061225	7	16168	3	58	4	16110	16175	0.14420597346372488
M1	cpdb	0	network_modules	24	TRUE	0.0028008183554775108	131	60	7	0.11666666666666667	0.05343511450381679	REAC:R-HSA-166520	REAC	Signaling by NTRKs	10916	2287		0.9241379310344827	0.9246575342465754	131	10785	7	53	124	10732	10916	0.0714601403372319
M1	cpdb	0	network_modules	24	TRUE	0.002824233632559583	594	61	12	0.19672131147540983	0.020202020202020204	GO:0006954	GO:BP	inflammatory response	16175	2585		0.8114754098360656	0.8122448979591836	594	15581	12	49	582	15532	16175	0.05233968704630207
M1	cpdb	0	network_modules	24	TRUE	0.0029220407796891165	224	61	8	0.13114754098360656	0.03571428571428571	GO:1901988	GO:BP	negative regulation of cell cycle phase transition	16175	21921		0.8155737704918032	0.8163265306122449	224	15951	8	53	216	15898	16175	0.061756674888256986
M1	cpdb	0	network_modules	24	TRUE	0.003035398079617911	55	61	5	0.08196721311475409	0.09090909090909091	GO:0043500	GO:BP	muscle adaptation	16175	10738		0.819672131147541	0.8204081632653061	55	16120	5	56	50	16064	16175	0.08303922808263399
M1	cpdb	0	network_modules	24	TRUE	0.003163161385084397	100	61	6	0.09836065573770492	0.06	GO:0009266	GO:BP	response to temperature stimulus	16175	3431		0.8237704918032787	0.8244897959183674	100	16075	6	55	94	16020	16175	0.07235367844338282
M1	cpdb	0	network_modules	24	TRUE	0.0032546764683829632	24	60	4	0.06666666666666667	0.16666666666666666	REAC:R-HSA-9013508	REAC	NOTCH3 Intracellular Domain Regulates Transcription	10916	1536		0.9310344827586207	0.9383561643835616	24	10892	4	56	20	10836	10916	0.10232680005661281
M1	cpdb	0	network_modules	24	TRUE	0.0032546764683829632	24	60	4	0.06666666666666667	0.16666666666666666	REAC:R-HSA-9634638	REAC	Estrogen-dependent nuclear events downstream of ESR-membrane signaling	10916	867		0.9310344827586207	0.9383561643835616	24	10892	4	56	20	10836	10916	0.10232680005661281
M1	cpdb	0	network_modules	24	TRUE	0.0033531431594961245	101	61	6	0.09836065573770492	0.0594059405940594	GO:0010565	GO:BP	regulation of ketone metabolic process	16175	4218		0.8278688524590164	0.8285714285714286	101	16074	6	55	95	16019	16175	0.07194855218834371
M1	cpdb	0	network_modules	24	TRUE	0.0034097211570351593	25	61	4	0.06557377049180328	0.16	GO:1903055	GO:BP	positive regulation of extracellular matrix organization	16175	22734		0.8319672131147541	0.8408163265306122	25	16150	4	57	21	16093	16175	0.10028186120742445
M1	cpdb	0	network_modules	24	TRUE	0.0034097211570351593	25	61	4	0.06557377049180328	0.16	GO:0030511	GO:BP	positive regulation of transforming growth factor beta receptor signaling pathway	16175	6827		0.8319672131147541	0.8408163265306122	25	16150	4	57	21	16093	16175	0.10028186120742445
M1	cpdb	0	network_modules	24	TRUE	0.0034097211570351593	25	61	4	0.06557377049180328	0.16	GO:1903846	GO:BP	positive regulation of cellular response to transforming growth factor beta stimulus	16175	23325		0.8319672131147541	0.8408163265306122	25	16150	4	57	21	16093	16175	0.10028186120742445
M1	cpdb	0	network_modules	24	TRUE	0.0034453885439606168	229	61	8	0.13114754098360656	0.034934497816593885	GO:0033044	GO:BP	regulation of chromosome organization	16175	7999		0.8442622950819673	0.8448979591836735	229	15946	8	53	221	15893	16175	0.0609273430827331
M1	cpdb	0	network_modules	24	TRUE	0.0035523359050754428	102	61	6	0.09836065573770492	0.058823529411764705	GO:0043534	GO:BP	blood vessel endothelial cell migration	16175	10755		0.8483606557377049	0.8489795918367347	102	16073	6	55	96	16018	16175	0.07154916930180324
M1	cpdb	0	network_modules	24	TRUE	0.003632441455517487	57	61	5	0.08196721311475409	0.08771929824561403	GO:1903578	GO:BP	regulation of ATP metabolic process	16175	23121		0.8524590163934426	0.8530612244897959	57	16118	5	56	52	16062	16175	0.08144607084659386
M1	cpdb	0	network_modules	24	TRUE	0.003687577563196157	161	61	7	0.11475409836065574	0.043478260869565216	GO:0045637	GO:BP	regulation of myeloid cell differentiation	16175	11488		0.8565573770491803	0.8571428571428571	161	16014	7	54	154	15960	16175	0.06495429774271373
M1	cpdb	0	network_modules	24	TRUE	0.0037343385689323698	93	60	6	0.1	0.06451612903225806	KEGG:04520	KEGG	Adherens junction	8484	316		0.8837209302325582	0.8850574712643678	93	8391	6	54	87	8337	8484	0.07216807011836456
M1	cpdb	0	network_modules	24	TRUE	0.0038587383385801383	25	60	4	0.06666666666666667	0.16	REAC:R-HSA-201556	REAC	Signaling by ALK	10916	2217		0.9448275862068966	0.9452054794520548	25	10891	4	56	21	10835	10916	0.1001215072131488
M1	cpdb	0	network_modules	24	TRUE	0.003964103902601091	138	60	7	0.11666666666666667	0.050724637681159424	KEGG:04371	KEGG	Apelin signaling pathway	8484	308		0.8953488372093024	0.896551724137931	138	8346	7	53	131	8293	8484	0.06698465863138328
M1	cpdb	0	network_modules	24	TRUE	0.00397972262990334	104	61	6	0.09836065573770492	0.057692307692307696	GO:0051100	GO:BP	negative regulation of binding	16175	13495		0.860655737704918	0.8612244897959184	104	16071	6	55	98	16016	16175	0.07076708361842908
M1	cpdb	0	network_modules	24	TRUE	0.004018323400993897	26	61	4	0.06557377049180328	0.15384615384615385	GO:0045648	GO:BP	positive regulation of erythrocyte differentiation	16175	11499		0.8647540983606558	0.8653061224489796	26	16149	4	57	22	16092	16175	0.09824254785503261
M1	cpdb	0	network_modules	24	TRUE	0.004256346728358403	92	60	6	0.1	0.06521739130434782	REAC:R-HSA-6804756	REAC	Regulation of TP53 Activity through Phosphorylation	10916	2016		0.9517241379310345	0.952054794520548	92	10824	6	54	86	10770	10916	0.07446962207496155
M1	cpdb	0	network_modules	24	TRUE	0.0043105189488412176	510	61	11	0.18032786885245902	0.021568627450980392	GO:0048871	GO:BP	multicellular organismal-level homeostasis	16175	13114		0.8688524590163934	0.8693877551020408	510	15665	11	50	499	15615	16175	0.052390620800738745
M1	cpdb	0	network_modules	24	TRUE	0.004698663287951657	107	61	6	0.09836065573770492	0.056074766355140186	GO:0034614	GO:BP	cellular response to reactive oxygen species	16175	8691		0.8729508196721312	0.8734693877551021	107	16068	6	55	101	16013	16175	0.06963371101910684
M1	cpdb	0	network_modules	24	TRUE	0.004703880213111464	27	61	4	0.06557377049180328	0.14814814814814814	GO:0007622	GO:BP	rhythmic behavior	16175	3079		0.8770491803278688	0.8816326530612245	27	16148	4	57	23	16091	16175	0.09631588180349972
M1	cpdb	0	network_modules	24	TRUE	0.004703880213111464	27	61	4	0.06557377049180328	0.14814814814814814	GO:0048512	GO:BP	circadian behavior	16175	12797		0.8770491803278688	0.8816326530612245	27	16148	4	57	23	16091	16175	0.09631588180349972
M1	cpdb	0	network_modules	24	TRUE	0.004855771395315211	263	60	9	0.15	0.034220532319391636	REAC:R-HSA-913531	REAC	Interferon Signaling	10916	1227		0.9586206896551724	0.958904109589041	263	10653	9	51	254	10602	10916	0.06104358295142421
M1	cpdb	0	network_modules	24	TRUE	0.004930089995155511	60	60	5	0.08333333333333333	0.08333333333333333	KEGG:04330	KEGG	Notch signaling pathway	8484	301		0.9069767441860465	0.9080459770114943	60	8424	5	55	55	8369	8484	0.07680436847103515
M1	cpdb	0	network_modules	24	TRUE	0.004975089403337294	143	60	7	0.11666666666666667	0.04895104895104895	KEGG:04550	KEGG	Signaling pathways regulating pluripotency of stem cells	8484	319		0.9186046511627907	0.9195402298850575	143	8341	7	53	136	8288	8484	0.06543652319329402
M1	cpdb	0	network_modules	24	TRUE	0.00501789735867998	98	60	6	0.1	0.061224489795918366	KEGG:05231	KEGG	Choline metabolism in cancer	8484	479		0.9302325581395349	0.9310344827586207	98	8386	6	54	92	8332	8484	0.06985842735026768
M1	cpdb	0	network_modules	24	TRUE	0.005122080878995913	95	60	6	0.1	0.06315789473684211	REAC:R-HSA-9759194	REAC	Nuclear events mediated by NFE2L2	10916	1617		0.9655172413793104	0.9657534246575342	95	10821	6	54	89	10767	10916	0.07307453989199912
M1	cpdb	0	network_modules	24	TRUE	0.005223538008229571	9	60	3	0.05	0.3333333333333333	REAC:R-HSA-6811555	REAC	PI5P Regulates TP53 Acetylation	10916	1676		0.9724137931034482	0.9726027397260274	9	10907	3	57	6	10850	10916	0.12737356485076975
M1	cpdb	0	network_modules	24	TRUE	0.005234236613845833	109	61	6	0.09836065573770492	0.05504587155963303	GO:0043467	GO:BP	regulation of generation of precursor metabolites and energy	16175	10715		0.8852459016393442	0.8857142857142857	109	16066	6	55	103	16011	16175	0.06890321829024756
M1	cpdb	0	network_modules	24	TRUE	0.005289185999921768	419	61	10	0.16393442622950818	0.02386634844868735	GO:0019221	GO:BP	cytokine-mediated signaling pathway	16175	5598		0.889344262295082	0.889795918367347	419	15756	10	51	409	15705	16175	0.05346281400684676
M1	cpdb	0	network_modules	24	TRUE	0.0053020422452993	749	61	13	0.21311475409836064	0.017356475300400534	GO:0070647	GO:BP	protein modification by small protein conjugation or removal	16175	16231		0.8934426229508197	0.8938775510204081	749	15426	13	48	736	15378	16175	0.04883809563896278
M1	cpdb	0	network_modules	24	TRUE	0.005354516510914967	243	61	8	0.13114754098360656	0.03292181069958848	GO:0019216	GO:BP	regulation of lipid metabolic process	16175	5593		0.8975409836065574	0.8979591836734694	243	15932	8	53	235	15879	16175	0.05873440370592212
M1	cpdb	0	network_modules	24	TRUE	0.005543624608176064	634	61	12	0.19672131147540983	0.01892744479495268	GO:0001817	GO:BP	regulation of cytokine production	16175	474		0.9016393442622951	0.9020408163265307	634	15541	12	49	622	15492	16175	0.04994280884377433
M1	cpdb	0	network_modules	24	TRUE	0.005863502193134611	246	61	8	0.13114754098360656	0.032520325203252036	GO:0051054	GO:BP	positive regulation of DNA metabolic process	16175	13464		0.9057377049180327	0.9061224489795918	246	15929	8	53	238	15876	16175	0.05828742093183218
M1	cpdb	0	network_modules	24	TRUE	0.005913866179875505	638	61	12	0.19672131147540983	0.018808777429467086	GO:0001816	GO:BP	cytokine production	16175	473		0.9098360655737705	0.9102040816326531	638	15537	12	49	626	15488	16175	0.04971424238398133
M1	cpdb	0	network_modules	24	TRUE	0.005943248478099477	101	60	6	0.1	0.0594059405940594	KEGG:04916	KEGG	Melanogenesis	8484	373		0.9418604651162791	0.9425287356321839	101	8383	6	54	95	8329	8484	0.06855026210072572
M1	cpdb	0	network_modules	24	TRUE	0.005943609146574965	173	61	7	0.11475409836065574	0.04046242774566474	GO:2001234	GO:BP	negative regulation of apoptotic signaling pathway	16175	26423		0.9139344262295082	0.9142857142857143	173	16002	7	54	166	15948	16175	0.06224081061238813
M1	cpdb	0	network_modules	24	TRUE	0.005993086909339628	63	61	5	0.08196721311475409	0.07936507936507936	GO:1904356	GO:BP	regulation of telomere maintenance via telomere lengthening	16175	23743		0.9180327868852459	0.9183673469387755	63	16112	5	56	58	16056	16175	0.07711867784058896
M1	cpdb	0	network_modules	24	TRUE	0.006330123205583586	29	61	4	0.06557377049180328	0.13793103448275862	GO:0071354	GO:BP	cellular response to interleukin-6	16175	16606		0.9221311475409836	0.9224489795918367	29	16146	4	57	25	16089	16175	0.09276124368207853
M1	cpdb	0	network_modules	24	TRUE	0.006659182661149313	176	61	7	0.11475409836065574	0.03977272727272727	GO:0000075	GO:BP	cell cycle checkpoint signaling	16175	26		0.9262295081967213	0.926530612244898	176	15999	7	54	169	15945	16175	0.06160385719013002
M1	cpdb	0	network_modules	24	TRUE	0.00717504449748031	178	61	7	0.11475409836065574	0.03932584269662921	GO:0045926	GO:BP	negative regulation of growth	16175	11720		0.930327868852459	0.9306122448979591	178	15997	7	54	171	15943	16175	0.06118769668711636
M1	cpdb	0	network_modules	24	TRUE	0.007224969412546761	434	61	10	0.16393442622950818	0.02304147465437788	GO:0002521	GO:BP	leukocyte differentiation	16175	1043		0.9344262295081968	0.9346938775510204	434	15741	10	51	424	15690	16175	0.05220271992279634
M1	cpdb	0	network_modules	24	TRUE	0.0073734880452794044	435	61	10	0.16393442622950818	0.022988505747126436	GO:0051052	GO:BP	regulation of DNA metabolic process	16175	13462		0.9385245901639344	0.9387755102040817	435	15740	10	51	425	15689	16175	0.05212082517676492
M1	cpdb	0	network_modules	24	TRUE	0.00743299842509159	10	60	3	0.05	0.3	REAC:R-HSA-198693	REAC	AKT phosphorylates targets in the nucleus	10916	15		0.9793103448275862	0.9931506849315068	10	10906	3	57	7	10849	10916	0.1206175965719561
M1	cpdb	0	network_modules	24	TRUE	0.00743299842509159	10	60	3	0.05	0.3	REAC:R-HSA-8866904	REAC	Negative regulation of activity of TFAP2 (AP-2) family transcription factors	10916	1579		0.9793103448275862	0.9931506849315068	10	10906	3	57	7	10849	10916	0.1206175965719561
M1	cpdb	0	network_modules	24	TRUE	0.00743299842509159	10	60	3	0.05	0.3	REAC:R-HSA-1234158	REAC	Regulation of gene expression by Hypoxia-inducible Factor	10916	2033		0.9793103448275862	0.9931506849315068	10	10906	3	57	7	10849	10916	0.1206175965719561
M1	cpdb	0	network_modules	24	TRUE	0.007514550438645484	116	61	6	0.09836065573770492	0.05172413793103448	GO:0051099	GO:BP	positive regulation of binding	16175	13494		0.9426229508196722	0.9469387755102041	116	16059	6	55	110	16004	16175	0.06649089635212665
M1	cpdb	0	network_modules	24	TRUE	0.007514550438645484	116	61	6	0.09836065573770492	0.05172413793103448	GO:1901875	GO:BP	positive regulation of post-translational protein modification	16175	21819		0.9426229508196722	0.9469387755102041	116	16059	6	55	110	16004	16175	0.06649089635212665
M1	cpdb	0	network_modules	24	TRUE	0.007554334676943909	66	61	5	0.08196721311475409	0.07575757575757576	GO:0003170	GO:BP	heart valve development	16175	1600		0.9508196721311475	0.9510204081632653	66	16109	5	56	61	16053	16175	0.07517360279994434
M1	cpdb	0	network_modules	24	TRUE	0.008140040730529246	67	61	5	0.08196721311475409	0.07462686567164178	GO:0060173	GO:BP	limb development	16175	14409		0.9549180327868853	0.9591836734693877	67	16108	5	56	62	16052	16175	0.07455358763826486
M1	cpdb	0	network_modules	24	TRUE	0.008140040730529246	67	61	5	0.08196721311475409	0.07462686567164178	GO:0048736	GO:BP	appendage development	16175	12993		0.9549180327868853	0.9591836734693877	67	16108	5	56	62	16052	16175	0.07455358763826486
M1	cpdb	0	network_modules	24	TRUE	0.008201808501149242	107	60	6	0.1	0.056074766355140186	KEGG:04922	KEGG	Glucagon signaling pathway	8484	379		0.9534883720930233	0.9540229885057471	107	8377	6	54	101	8323	8484	0.06608956315399173
M1	cpdb	0	network_modules	24	TRUE	0.008338913466405763	31	61	4	0.06557377049180328	0.12903225806451613	GO:0010611	GO:BP	regulation of cardiac muscle hypertrophy	16175	4258		0.9631147540983607	0.9673469387755103	31	16144	4	57	27	16087	16175	0.08955067431143506
M1	cpdb	0	network_modules	24	TRUE	0.008338913466405763	31	61	4	0.06557377049180328	0.12903225806451613	GO:0033144	GO:BP	negative regulation of intracellular steroid hormone receptor signaling pathway	16175	8058		0.9631147540983607	0.9673469387755103	31	16144	4	57	27	16087	16175	0.08955067431143506
M1	cpdb	0	network_modules	24	TRUE	0.00843091910114818	547	61	11	0.18032786885245902	0.02010968921389397	GO:0006511	GO:BP	ubiquitin-dependent protein catabolic process	16175	2235		0.9713114754098361	0.9714285714285714	547	15628	11	50	536	15578	16175	0.049868943712474294
M1	cpdb	0	network_modules	24	TRUE	0.008498116637774101	210	60	8	0.13333333333333333	0.0380952380952381	KEGG:05170	KEGG	Human immunodeficiency virus 1 infection	8484	451		0.9651162790697675	0.9655172413793104	210	8274	8	52	202	8222	8484	0.05897975575702806
M1	cpdb	0	network_modules	24	TRUE	0.008636949646115	108	60	6	0.1	0.05555555555555555	KEGG:04931	KEGG	Insulin resistance	8484	388		0.9767441860465116	0.9885057471264368	108	8376	6	54	102	8322	8484	0.06569807492344892
M1	cpdb	0	network_modules	24	TRUE	0.008636949646115	108	60	6	0.1	0.05555555555555555	KEGG:05145	KEGG	Toxoplasmosis	8484	437		0.9767441860465116	0.9885057471264368	108	8376	6	54	102	8322	8484	0.06569807492344892
M1	cpdb	0	network_modules	24	TRUE	0.008689992492323507	62	60	5	0.08333333333333333	0.08064516129032258	REAC:R-HSA-9707564	REAC	Cytoprotection by HMOX1	10916	426		1	1	62	10854	5	55	57	10799	10916	0.076820133923331535
M1	cpdb	0	network_modules	24	TRUE	0.008711602888924188	119	61	6	0.09836065573770492	0.05042016806722689	GO:0001936	GO:BP	regulation of endothelial cell proliferation	16175	550		0.9754098360655737	0.9755102040816327	119	16056	6	55	113	16001	16175	0.06552002443495177
M1	cpdb	0	network_modules	24	TRUE	0.008760768959166719	68	61	5	0.08196721311475409	0.07352941176470588	GO:0032922	GO:BP	circadian regulation of gene expression	16175	7913		0.9795081967213115	0.9795918367346939	68	16107	5	56	63	16051	16175	0.07394687661819985
M1	cpdb	0	network_modules	24	TRUE	0.008978558399151314	157	60	7	0.11666666666666667	0.044585987261146494	KEGG:04390	KEGG	Hippo signaling pathway	8484	310		1	1	157	8327	7	53	150	8274	8484	0.06146997748821847
M1	cpdb	0	network_modules	24	TRUE	0.009417999703422358	69	61	5	0.08196721311475409	0.07246376811594203	GO:0043255	GO:BP	regulation of carbohydrate biosynthetic process	16175	10589		0.9836065573770492	0.9836734693877551	69	16106	5	56	64	16050	16175	0.0733529889420111
M1	cpdb	0	network_modules	24	TRUE	0.009503362048330891	32	61	4	0.06557377049180328	0.125	GO:0014743	GO:BP	regulation of muscle hypertrophy	16175	4679		0.9877049180327869	0.9918367346938776	32	16143	4	57	28	16086	16175	0.088057464868065
M1	cpdb	0	network_modules	24	TRUE	0.009503362048330891	32	61	4	0.06557377049180328	0.125	GO:0070741	GO:BP	response to interleukin-6	16175	16280		0.9877049180327869	0.9918367346938776	32	16143	4	57	28	16086	16175	0.088057464868065
M1	cpdb	0	network_modules	24	TRUE	0.00967884341289171	555	61	11	0.18032786885245902	0.01981981981981982	GO:0019941	GO:BP	modification-dependent protein catabolic process	16175	6072		0.9959016393442623	0.9959183673469387	555	15620	11	50	544	15570	16175	0.04935372679771526
M1	cpdb	0	network_modules	24	TRUE	0.009927759708731677	187	61	7	0.11475409836065574	0.0374331550802139	GO:0000082	GO:BP	G1/S transition of mitotic cell cycle	16175	31		1	1	187	15988	7	54	180	15934	16175	0.05939366044400628
M1	cpdb	0	network_modules	25	TRUE	1.684725072676243e-80	50	58	38	0.6551724137931034	0.76	REAC:R-HSA-211733	REAC	Regulation of activated PAK-2p34 by proteasome mediated degradation	10916	2021		0	0.007518796992481203	50	10866	38	20	12	10846	10916	0.7041926030592949
M1	cpdb	0	network_modules	25	TRUE	2.4460877555031638e-79	52	58	38	0.6551724137931034	0.7307692307692307	REAC:R-HSA-69601	REAC	Ubiquitin Mediated Degradation of Phosphorylated Cdc25A	10916	2619		0.007575757575757576	0.05263157894736842	52	10864	38	20	14	10844	10916	0.6903867368515599
M1	cpdb	0	network_modules	25	TRUE	2.4460877555031638e-79	52	58	38	0.6551724137931034	0.7307692307692307	REAC:R-HSA-69610	REAC	p53-Independent DNA Damage Response	10916	2719		0.007575757575757576	0.05263157894736842	52	10864	38	20	14	10844	10916	0.6903867368515599
M1	cpdb	0	network_modules	25	TRUE	2.4460877555031638e-79	52	58	38	0.6551724137931034	0.7307692307692307	REAC:R-HSA-75815	REAC	Ubiquitin-dependent degradation of Cyclin D	10916	2620		0.007575757575757576	0.05263157894736842	52	10864	38	20	14	10844	10916	0.6903867368515599
M1	cpdb	0	network_modules	25	TRUE	2.4460877555031638e-79	52	58	38	0.6551724137931034	0.7307692307692307	REAC:R-HSA-180534	REAC	Vpu mediated degradation of CD4	10916	2666		0.007575757575757576	0.05263157894736842	52	10864	38	20	14	10844	10916	0.6903867368515599
M1	cpdb	0	network_modules	25	TRUE	2.4460877555031638e-79	52	58	38	0.6551724137931034	0.7307692307692307	REAC:R-HSA-69613	REAC	p53-Independent G1/S DNA damage checkpoint	10916	2720		0.007575757575757576	0.05263157894736842	52	10864	38	20	14	10844	10916	0.6903867368515599
M1	cpdb	0	network_modules	25	TRUE	2.4460877555031638e-79	52	58	38	0.6551724137931034	0.7307692307692307	REAC:R-HSA-349425	REAC	Autodegradation of the E3 ubiquitin ligase COP1	10916	191		0.007575757575757576	0.05263157894736842	52	10864	38	20	14	10844	10916	0.6903867368515599
M1	cpdb	0	network_modules	25	TRUE	8.627341155543275e-79	53	58	38	0.6551724137931034	0.71698113207547165	REAC:R-HSA-180585	REAC	Vif-mediated degradation of APOBEC3G	10916	2646		0.05303030303030303	0.06766917293233082	53	10863	38	20	15	10843	10916	0.6837777919263284
M1	cpdb	0	network_modules	25	TRUE	8.627341155543275e-79	53	58	38	0.6551724137931034	0.71698113207547165	REAC:R-HSA-169911	REAC	Regulation of Apoptosis	10916	1964		0.05303030303030303	0.06766917293233082	53	10863	38	20	15	10843	10916	0.6837777919263284
M1	cpdb	0	network_modules	25	TRUE	2.9065045534407423e-78	54	58	38	0.6551724137931034	0.7037037037037037	REAC:R-HSA-450408	REAC	AUF1 (hnRNP D0) binds and destabilizes mRNA	10916	40		0.06818181818181818	0.07518796992481203	54	10862	38	20	16	10842	10916	0.6773526816704176
M1	cpdb	0	network_modules	25	TRUE	6.626010801748368e-78	49	58	37	0.6379310344827587	0.7551020408163265	REAC:R-HSA-1236978	REAC	Cross-presentation of soluble exogenous antigens (endosomes)	10916	416		0.07575757575757576	0.08270676691729323	49	10867	37	21	12	10846	10916	0.6925589270709795
M1	cpdb	0	network_modules	25	TRUE	9.386527681715873e-78	55	58	38	0.6551724137931034	0.6909090909090909	REAC:R-HSA-174113	REAC	SCF-beta-TrCP mediated degradation of Emi1	10916	2130		0.08333333333333333	0.10526315789473684	55	10861	38	20	17	10841	10916	0.671103016816055
M1	cpdb	0	network_modules	25	TRUE	9.386527681715873e-78	55	58	38	0.6551724137931034	0.6909090909090909	REAC:R-HSA-8854050	REAC	FBXL7 down-regulates AURKA during mitotic entry and in early mitosis	10916	892		0.08333333333333333	0.10526315789473684	55	10861	38	20	17	10841	10916	0.671103016816055
M1	cpdb	0	network_modules	25	TRUE	9.386527681715873e-78	55	58	38	0.6551724137931034	0.6909090909090909	REAC:R-HSA-4641257	REAC	Degradation of AXIN	10916	719		0.08333333333333333	0.10526315789473684	55	10861	38	20	17	10841	10916	0.671103016816055
M1	cpdb	0	network_modules	25	TRUE	2.9150137490254717e-77	56	58	38	0.6551724137931034	0.6785714285714286	REAC:R-HSA-5362768	REAC	Hh mutants are degraded by ERAD	10916	1122		0.10606060606060606	0.11278195488721804	56	10860	38	20	18	10840	10916	0.6650209346615701
M1	cpdb	0	network_modules	25	TRUE	8.729350134687618e-77	57	58	38	0.6551724137931034	0.6666666666666666	REAC:R-HSA-69541	REAC	Stabilization of p53	10916	2351		0.11363636363636363	0.12781954887218044	57	10859	38	20	19	10839	10916	0.6590990573206549
M1	cpdb	0	network_modules	25	TRUE	8.729350134687618e-77	57	58	38	0.6551724137931034	0.6666666666666666	REAC:R-HSA-4641258	REAC	Degradation of DVL	10916	720		0.11363636363636363	0.12781954887218044	57	10859	38	20	19	10839	10916	0.6590990573206549
M1	cpdb	0	network_modules	25	TRUE	9.248792874538023e-77	51	58	37	0.6379310344827587	0.7254901960784313	REAC:R-HSA-350562	REAC	Regulation of ornithine decarboxylase (ODC)	10916	2046		0.12878787878787878	0.13533834586466165	51	10865	37	21	14	10844	10916	0.6787096405085113
M1	cpdb	0	network_modules	25	TRUE	3.200214513376412e-76	52	58	37	0.6379310344827587	0.7115384615384616	REAC:R-HSA-9762114	REAC	GSK3B and BTRC:CUL1-mediated-degradation of NFE2L2	10916	1026		0.13636363636363635	0.14285714285714285	52	10864	37	21	15	10843	10916	0.6720856003081797
M1	cpdb	0	network_modules	25	TRUE	7.086838292228989e-76	59	58	38	0.6551724137931034	0.6440677966101694	REAC:R-HSA-5676590	REAC	NIK-->noncanonical NF-kB signaling	10916	1528		0.14393939393939395	0.15789473684210525	59	10857	38	20	21	10837	10916	0.6477086065001758
M1	cpdb	0	network_modules	25	TRUE	7.086838292228989e-76	59	58	38	0.6551724137931034	0.6440677966101694	REAC:R-HSA-5387390	REAC	Hh mutants abrogate ligand secretion	10916	1121		0.14393939393939395	0.15789473684210525	59	10857	38	20	21	10837	10916	0.6477086065001758
M1	cpdb	0	network_modules	25	TRUE	1.0580759849136568e-75	53	58	37	0.6379310344827587	0.6981132075471698	REAC:R-HSA-9604323	REAC	Negative regulation of NOTCH4 signaling	10916	1576		0.1590909090909091	0.16541353383458646	53	10863	37	21	16	10842	10916	0.6656492954293964
M1	cpdb	0	network_modules	25	TRUE	1.6419302344802737e-75	46	53	36	0.6792452830188679	0.782608695652174	KEGG:03050	KEGG	Proteasome	8484	216		0	0.1111111111111111	46	8438	36	17	10	8421	8484	0.7275224607568431
M1	cpdb	0	network_modules	25	TRUE	1.929305206777981e-75	60	58	38	0.6551724137931034	0.6333333333333333	REAC:R-HSA-5610780	REAC	Degradation of GLI1 by the proteasome	10916	722		0.16666666666666666	0.19548872180451127	60	10856	38	20	22	10836	10916	0.6422273786506555
M1	cpdb	0	network_modules	25	TRUE	1.929305206777981e-75	60	58	38	0.6551724137931034	0.6333333333333333	REAC:R-HSA-5610783	REAC	Degradation of GLI2 by the proteasome	10916	723		0.16666666666666666	0.19548872180451127	60	10856	38	20	22	10836	10916	0.6422273786506555
M1	cpdb	0	network_modules	25	TRUE	1.929305206777981e-75	60	58	38	0.6551724137931034	0.6333333333333333	REAC:R-HSA-5607761	REAC	Dectin-1 mediated noncanonical NF-kB signaling	10916	456		0.16666666666666666	0.19548872180451127	60	10856	38	20	22	10836	10916	0.6422273786506555
M1	cpdb	0	network_modules	25	TRUE	1.929305206777981e-75	60	58	38	0.6551724137931034	0.6333333333333333	REAC:R-HSA-5610785	REAC	GLI3 is processed to GLI3R by the proteasome	10916	1016		0.16666666666666666	0.19548872180451127	60	10856	38	20	22	10836	10916	0.6422273786506555
M1	cpdb	0	network_modules	25	TRUE	5.107668583596732e-75	61	58	38	0.6551724137931034	0.6229508196721312	REAC:R-HSA-5678895	REAC	Defective CFTR causes cystic fibrosis	10916	505		0.19696969696969696	0.20300751879699247	61	10855	38	20	23	10835	10916	0.6368809875157567
M1	cpdb	0	network_modules	25	TRUE	1.0230937295802993e-74	55	58	37	0.6379310344827587	0.6727272727272727	REAC:R-HSA-8941858	REAC	Regulation of RUNX3 expression and activity	10916	2006		0.20454545454545456	0.21052631578947367	55	10861	37	21	18	10840	10916	0.6533055431109107
M1	cpdb	0	network_modules	25	TRUE	8.140840251581296e-74	64	58	38	0.6551724137931034	0.59375	REAC:R-HSA-4608870	REAC	Asymmetric localization of PCP proteins	10916	184		0.21212121212121213	0.21804511278195488	64	10852	38	20	26	10832	10916	0.6215977819483509
M1	cpdb	0	network_modules	25	TRUE	1.9563129180973786e-73	65	58	38	0.6551724137931034	0.5846153846153846	REAC:R-HSA-5358346	REAC	Hedgehog ligand biogenesis	10916	1114		0.2196969696969697	0.22556390977443608	65	10851	38	20	27	10831	10916	0.6167391221272308
M1	cpdb	0	network_modules	25	TRUE	2.3601965922432193e-73	58	58	37	0.6379310344827587	0.6379310344827587	REAC:R-HSA-351202	REAC	Metabolism of polyamines	10916	1433		0.22727272727272727	0.23308270676691728	58	10858	37	21	21	10837	10916	0.6359969766452195
M1	cpdb	0	network_modules	25	TRUE	4.6030284086467995e-73	66	58	38	0.6551724137931034	0.5757575757575758	REAC:R-HSA-1234176	REAC	Oxygen-dependent proline hydroxylation of Hypoxia-inducible Factor Alpha	10916	1655		0.23484848484848486	0.2556390977443609	66	10850	38	20	28	10830	10916	0.6119908592119361
M1	cpdb	0	network_modules	25	TRUE	4.6030284086467995e-73	66	58	38	0.6551724137931034	0.5757575757575758	REAC:R-HSA-69563	REAC	p53-Dependent G1 DNA Damage Response	10916	2717		0.23484848484848486	0.2556390977443609	66	10850	38	20	28	10830	10916	0.6119908592119361
M1	cpdb	0	network_modules	25	TRUE	4.6030284086467995e-73	66	58	38	0.6551724137931034	0.5757575757575758	REAC:R-HSA-69580	REAC	p53-Dependent G1/S DNA damage checkpoint	10916	2718		0.23484848484848486	0.2556390977443609	66	10850	38	20	28	10830	10916	0.6119908592119361
M1	cpdb	0	network_modules	25	TRUE	1.0615484465646305e-72	67	58	38	0.6551724137931034	0.5671641791044776	REAC:R-HSA-5658442	REAC	Regulation of RAS by GAPs	10916	2003		0.25757575757575757	0.2706766917293233	67	10849	38	20	29	10829	10916	0.6073488616261448
M1	cpdb	0	network_modules	25	TRUE	1.0615484465646305e-72	67	58	38	0.6551724137931034	0.5671641791044776	REAC:R-HSA-1169091	REAC	Activation of NF-kappaB in B cells	10916	87		0.25757575757575757	0.2706766917293233	67	10849	38	20	29	10829	10916	0.6073488616261448
M1	cpdb	0	network_modules	25	TRUE	1.6449918203851885e-72	60	58	37	0.6379310344827587	0.6166666666666667	REAC:R-HSA-187577	REAC	SCF(Skp2)-mediated degradation of p27/p21	10916	2129		0.2727272727272727	0.2781954887218045	60	10856	37	21	23	10835	10916	0.6251836712800156
M1	cpdb	0	network_modules	25	TRUE	2.4018548972247663e-72	68	58	38	0.6551724137931034	0.5588235294117647	REAC:R-HSA-69615	REAC	G1/S DNA Damage Checkpoints	10916	1001		0.2803030303030303	0.2932330827067669	68	10848	38	20	30	10828	10916	0.6028092111685813
M1	cpdb	0	network_modules	25	TRUE	2.4018548972247663e-72	68	58	38	0.6551724137931034	0.5588235294117647	REAC:R-HSA-174154	REAC	APC/C:Cdc20 mediated degradation of Securin	10916	26		0.2803030303030303	0.2932330827067669	68	10848	38	20	30	10828	10916	0.6028092111685813
M1	cpdb	0	network_modules	25	TRUE	5.336461546426761e-72	69	58	38	0.6551724137931034	0.5507246376811594	REAC:R-HSA-8948751	REAC	Regulation of PTEN stability and activity	10916	2002		0.29545454545454547	0.3007518796992481	69	10847	38	20	31	10827	10916	0.5983681890486173
M1	cpdb	0	network_modules	25	TRUE	9.818028980544335e-72	55	58	36	0.6206896551724138	0.6545454545454545	REAC:R-HSA-9824272	REAC	Somitogenesis	10916	2341		0.30303030303030304	0.3082706766917293	55	10861	36	22	19	10839	10916	0.6355080694057665
M1	cpdb	0	network_modules	25	TRUE	2.5025576332862157e-71	71	58	38	0.6551724137931034	0.5352112676056338	REAC:R-HSA-8939902	REAC	Regulation of RUNX2 expression and activity	10916	2005		0.3106060606060606	0.3233082706766917	71	10845	38	20	33	10825	10916	0.58976807553213
M1	cpdb	0	network_modules	25	TRUE	2.5025576332862157e-71	71	58	38	0.6551724137931034	0.5352112676056338	REAC:R-HSA-68949	REAC	Orc1 removal from chromatin	10916	1644		0.3106060606060606	0.3233082706766917	71	10845	38	20	33	10825	10916	0.58976807553213
M1	cpdb	0	network_modules	25	TRUE	5.9107446241457075e-71	64	58	37	0.6379310344827587	0.578125	REAC:R-HSA-174084	REAC	Autodegradation of Cdh1 by Cdh1:APC/C	10916	190		0.32575757575757575	0.3308270676691729	64	10852	37	21	27	10831	10916	0.6050922421529061
M1	cpdb	0	network_modules	25	TRUE	1.1013628897710366e-70	73	58	38	0.6551724137931034	0.5205479452054794	REAC:R-HSA-69017	REAC	CDK-mediated phosphorylation and removal of Cdc6	10916	272		0.3333333333333333	0.3458646616541353	73	10843	38	20	35	10823	10916	0.5815222944403948
M1	cpdb	0	network_modules	25	TRUE	1.1013628897710366e-70	73	58	38	0.6551724137931034	0.5205479452054794	REAC:R-HSA-174184	REAC	Cdc20:Phospho-APC/C mediated degradation of Cyclin A	10916	319		0.3333333333333333	0.3458646616541353	73	10843	38	20	35	10823	10916	0.5815222944403948
M1	cpdb	0	network_modules	25	TRUE	2.2598443720161227e-70	74	58	38	0.6551724137931034	0.5135135135135135	REAC:R-HSA-174178	REAC	APC/C:Cdh1 mediated degradation of Cdc20 and other APC/C:Cdh1 targeted proteins in late mitosis/early G1	10916	28		0.3484848484848485	0.3609022556390977	74	10842	38	20	36	10822	10916	0.5775247646206577
M1	cpdb	0	network_modules	25	TRUE	2.2598443720161227e-70	74	58	38	0.6551724137931034	0.5135135135135135	REAC:R-HSA-179419	REAC	APC:Cdc20 mediated degradation of cell cycle proteins prior to satisfation of the cell cycle checkpoint	10916	29		0.3484848484848485	0.3609022556390977	74	10842	38	20	36	10822	10916	0.5775247646206577
M1	cpdb	0	network_modules	25	TRUE	4.572533285658688e-70	75	58	38	0.6551724137931034	0.5066666666666667	REAC:R-HSA-1234174	REAC	Cellular response to hypoxia	10916	335		0.36363636363636365	0.3684210526315789	75	10841	38	20	37	10821	10916	0.5736070828457823
M1	cpdb	0	network_modules	25	TRUE	9.12863003603028e-70	76	58	38	0.6551724137931034	0.5	REAC:R-HSA-176409	REAC	APC/C:Cdc20 mediated degradation of mitotic proteins	10916	27		0.3712121212121212	0.37593984962406013	76	10840	38	20	38	10820	10916	0.5697666161744194
M1	cpdb	0	network_modules	25	TRUE	1.7990796465600482e-69	77	58	38	0.6551724137931034	0.4935064935064935	REAC:R-HSA-176814	REAC	Activation of APC/C and APC/C:Cdc20 mediated degradation of mitotic proteins	10916	74		0.3787878787878788	0.38345864661654133	77	10839	38	20	39	10819	10916	0.566000851691161
M1	cpdb	0	network_modules	25	TRUE	3.5018988532023483e-69	78	58	38	0.6551724137931034	0.48717948717948717	REAC:R-HSA-5619084	REAC	ABC transporter disorders	10916	7		0.38636363636363635	0.39097744360902253	78	10838	38	20	40	10818	10916	0.5623073895609441
M1	cpdb	0	network_modules	25	TRUE	6.369122328960944e-69	89	58	39	0.6724137931034483	0.43820224719101125	REAC:R-HSA-5687128	REAC	MAPK6/MAPK4 signaling	10916	1353		0.3939393939393939	0.39849624060150374	89	10827	39	19	50	10808	10916	0.5398735394888692
M1	cpdb	0	network_modules	25	TRUE	6.735430505251771e-69	79	58	38	0.6551724137931034	0.4810126582278481	REAC:R-HSA-8852276	REAC	The role of GTSE1 in G2/M progression after G2 checkpoint	10916	2503		0.4015151515151515	0.40601503759398494	79	10837	38	20	41	10817	10916	0.5586839365684964
M1	cpdb	0	network_modules	25	TRUE	1.2806324836702904e-68	80	58	38	0.6551724137931034	0.475	REAC:R-HSA-1168372	REAC	Downstream signaling events of B Cell Receptor (BCR)	10916	791		0.4090909090909091	0.41353383458646614	80	10836	38	20	42	10816	10916	0.5551283001032956
M1	cpdb	0	network_modules	25	TRUE	1.5421965171731244e-68	102	58	40	0.6896551724137931	0.39215686274509803	REAC:R-HSA-5689603	REAC	UCH proteinases	10916	2615		0.4166666666666667	0.42105263157894735	102	10814	40	18	62	10796	10916	0.5167933153001851
M1	cpdb	0	network_modules	25	TRUE	2.408016536637114e-68	81	58	38	0.6551724137931034	0.4691358024691358	REAC:R-HSA-176408	REAC	Regulation of APC/C activators between G1/S and early anaphase	10916	1963		0.42424242424242425	0.42857142857142855	81	10835	38	20	43	10815	10916	0.5516383825541813
M1	cpdb	0	network_modules	25	TRUE	8.247508795287975e-68	83	58	38	0.6551724137931034	0.4578313253012048	REAC:R-HSA-195253	REAC	Degradation of beta-catenin by the destruction complex	10916	724		0.4318181818181818	0.43609022556390975	83	10833	38	20	45	10813	10916	0.5448477577340021
M1	cpdb	0	network_modules	25	TRUE	2.713948482746383e-67	85	58	38	0.6551724137931034	0.4470588235294118	REAC:R-HSA-5632684	REAC	Hedgehog 'on' state	10916	1113		0.4393939393939394	0.44360902255639095	85	10831	38	20	47	10811	10916	0.5382969910035239
M1	cpdb	0	network_modules	25	TRUE	4.853743858638389e-67	86	58	38	0.6551724137931034	0.4418604651162791	REAC:R-HSA-450531	REAC	Regulation of mRNA stability by proteins that bind AU-rich elements	10916	2043		0.44696969696969696	0.45112781954887216	86	10830	38	20	48	10810	10916	0.5351071815854384
M1	cpdb	0	network_modules	25	TRUE	1.5112926401394734e-66	88	58	38	0.6551724137931034	0.4318181818181818	REAC:R-HSA-174143	REAC	APC/C-mediated degradation of cell cycle proteins	10916	24		0.45454545454545453	0.46616541353383456	88	10828	38	20	50	10808	10916	0.5288905764223739
M1	cpdb	0	network_modules	25	TRUE	1.5112926401394734e-66	88	58	38	0.6551724137931034	0.4318181818181818	REAC:R-HSA-453276	REAC	Regulation of mitotic cell cycle	10916	2044		0.45454545454545453	0.46616541353383456	88	10828	38	20	50	10808	10916	0.5288905764223739
M1	cpdb	0	network_modules	25	TRUE	1.8032614112063824e-66	69	58	36	0.6206896551724138	0.5217391304347826	REAC:R-HSA-9793380	REAC	Formation of paraxial mesoderm	10916	961		0.4696969696969697	0.47368421052631576	69	10847	36	22	33	10825	10916	0.5665683265750667
M1	cpdb	0	network_modules	25	TRUE	4.548237750476892e-66	90	58	38	0.6551724137931034	0.4222222222222222	REAC:R-HSA-1236974	REAC	ER-Phagosome pathway	10916	824		0.4772727272727273	0.48120300751879697	90	10826	38	20	52	10806	10916	0.5228812187323857
M1	cpdb	0	network_modules	25	TRUE	1.0712449658437777e-65	81	58	37	0.6379310344827587	0.4567901234567901	REAC:R-HSA-9013694	REAC	Signaling by NOTCH4	10916	2283		0.48484848484848486	0.48872180451127817	81	10835	37	21	44	10814	10916	0.5369552863508177
M1	cpdb	0	network_modules	25	TRUE	1.3256780495718723e-65	92	58	38	0.6551724137931034	0.41304347826086957	REAC:R-HSA-4086400	REAC	PCP/CE pathway	10916	1659		0.49242424242424243	0.5037593984962406	92	10824	38	20	54	10804	10916	0.5170677947187379
M1	cpdb	0	network_modules	25	TRUE	1.3256780495718723e-65	92	58	38	0.6551724137931034	0.41304347826086957	REAC:R-HSA-69052	REAC	Switching of origins to a post-replicative state	10916	2365		0.49242424242424243	0.5037593984962406	92	10824	38	20	54	10804	10916	0.5170677947187379
M1	cpdb	0	network_modules	25	TRUE	1.948363157881638e-65	82	58	37	0.6379310344827587	0.45121951219512196	REAC:R-HSA-69202	REAC	Cyclin E associated events during G1/S transition 	10916	421		0.5075757575757576	0.5112781954887218	82	10834	37	21	45	10813	10916	0.5336182121103787
M1	cpdb	0	network_modules	25	TRUE	6.259374433745229e-65	84	58	37	0.6379310344827587	0.44047619047619047	REAC:R-HSA-69656	REAC	Cyclin A:Cdk2-associated events at S phase entry	10916	419		0.5151515151515151	0.518796992481203	84	10832	37	21	47	10811	10916	0.527122774135507
M1	cpdb	0	network_modules	25	TRUE	1.6912076570836144e-64	97	58	38	0.6551724137931034	0.3917525773195876	REAC:R-HSA-5607764	REAC	CLEC7A (Dectin-1) signaling	10916	275		0.5227272727272727	0.5263157894736842	97	10819	38	20	59	10799	10916	0.5033246240116542
M1	cpdb	0	network_modules	25	TRUE	2.7573314057011183e-64	98	58	38	0.6551724137931034	0.3877551020408163	REAC:R-HSA-202424	REAC	Downstream TCR signaling	10916	789		0.5303030303030303	0.5338345864661654	98	10818	38	20	60	10798	10916	0.500702217679863
M1	cpdb	0	network_modules	25	TRUE	7.191787394827849e-64	100	58	38	0.6551724137931034	0.38	REAC:R-HSA-5668541	REAC	TNFR2 non-canonical NF-kB pathway	10916	2450		0.5378787878787878	0.5413533834586466	100	10816	38	20	62	10796	10916	0.49557518063731026
M1	cpdb	0	network_modules	25	TRUE	7.595971662746453e-64	113	58	39	0.6724137931034483	0.34513274336283184	REAC:R-HSA-9020702	REAC	Interleukin-1 signaling	10916	1233		0.5454545454545454	0.5488721804511278	113	10803	39	19	74	10784	10916	0.47806821212664946
M1	cpdb	0	network_modules	25	TRUE	2.89609305270023e-63	103	58	38	0.6551724137931034	0.36893203883495146	REAC:R-HSA-382556	REAC	ABC-family proteins mediated transport	10916	9		0.553030303030303	0.556390977443609	103	10813	38	20	65	10793	10916	0.48816470568389225
M1	cpdb	0	network_modules	25	TRUE	7.126067268574952e-63	105	58	38	0.6551724137931034	0.3619047619047619	REAC:R-HSA-1236975	REAC	Antigen processing-Cross presentation	10916	153		0.5606060606060606	0.5639097744360902	105	10811	38	20	67	10791	10916	0.48340068988427176
M1	cpdb	0	network_modules	25	TRUE	2.1023909211124854e-62	95	58	37	0.6379310344827587	0.3894736842105263	REAC:R-HSA-8878159	REAC	Transcriptional regulation by RUNX3	10916	2554		0.5681818181818182	0.5789473684210527	95	10821	37	21	58	10800	10916	0.4951254965596572
M1	cpdb	0	network_modules	25	TRUE	2.1023909211124854e-62	95	58	37	0.6379310344827587	0.3894736842105263	REAC:R-HSA-9759194	REAC	Nuclear events mediated by NFE2L2	10916	1617		0.5681818181818182	0.5789473684210527	95	10821	37	21	58	10800	10916	0.4951254965596572
M1	cpdb	0	network_modules	25	TRUE	2.1304455783947485e-61	113	58	38	0.6551724137931034	0.336283185840708	REAC:R-HSA-5610787	REAC	Hedgehog 'off' state	10916	1112		0.5833333333333334	0.5864661654135338	113	10803	38	20	75	10783	10916	0.46561838841890674
M1	cpdb	0	network_modules	25	TRUE	1.536606787762177e-60	118	58	38	0.6551724137931034	0.3220338983050847	REAC:R-HSA-8878166	REAC	Transcriptional regulation by RUNX2	10916	2553		0.5909090909090909	0.5939849624060151	118	10798	38	20	80	10778	10916	0.4554285587670684
M1	cpdb	0	network_modules	25	TRUE	2.2808014357884323e-60	151	58	40	0.6896551724137931	0.26490066225165565	REAC:R-HSA-446652	REAC	Interleukin-1 family signaling	10916	1231		0.5984848484848485	0.6015037593984962	151	10765	40	18	111	10747	10916	0.4229018752729929
M1	cpdb	0	network_modules	25	TRUE	3.2917246120067706e-60	120	58	38	0.6551724137931034	0.31666666666666665	REAC:R-HSA-202403	REAC	TCR signaling	10916	2422		0.6060606060606061	0.6090225563909775	120	10796	38	20	82	10776	10916	0.4515307798548169
M1	cpdb	0	network_modules	25	TRUE	4.7901197798236717e-60	121	58	38	0.6551724137931034	0.3140495867768595	REAC:R-HSA-69239	REAC	Synthesis of DNA	10916	2376		0.6136363636363636	0.6165413533834586	121	10795	38	20	83	10775	10916	0.4496179567627303
M1	cpdb	0	network_modules	25	TRUE	1.4437191599033011e-59	124	58	38	0.6551724137931034	0.3064516129032258	REAC:R-HSA-9755511	REAC	KEAP1-NFE2L2 pathway	10916	1281		0.6212121212121212	0.6240601503759399	124	10792	38	20	86	10772	10916	0.4440179184383112
M1	cpdb	0	network_modules	25	TRUE	2.959319973364523e-59	126	58	38	0.6551724137931034	0.30158730158730157	REAC:R-HSA-162909	REAC	Host Interactions of HIV factors	10916	1132		0.6287878787878788	0.631578947368421	126	10790	38	20	88	10770	10916	0.4403953276841896
M1	cpdb	0	network_modules	25	TRUE	8.467725103261664e-59	129	58	38	0.6551724137931034	0.29457364341085274	REAC:R-HSA-8939236	REAC	RUNX1 regulates transcription of genes involved in differentiation of HSCs	10916	1922		0.6363636363636364	0.6390977443609023	129	10787	38	20	91	10767	10916	0.4351189746858141
M1	cpdb	0	network_modules	25	TRUE	8.820566793464262e-58	136	58	38	0.6551724137931034	0.27941176470588236	REAC:R-HSA-2871837	REAC	FCERI mediated NF-kB activation	10916	896		0.6439393939393939	0.6541353383458647	136	10780	38	20	98	10760	10916	0.4234881727385881
M1	cpdb	0	network_modules	25	TRUE	8.820566793464262e-58	136	58	38	0.6551724137931034	0.27941176470588236	REAC:R-HSA-5621481	REAC	C-type lectin receptors (CLRs)	10916	261		0.6439393939393939	0.6541353383458647	136	10780	38	20	98	10760	10916	0.4234881727385881
M1	cpdb	0	network_modules	25	TRUE	1.2584355981455435e-57	298	58	45	0.7758620689655172	0.15100671140939598	REAC:R-HSA-5688426	REAC	Deubiquitination	10916	736		0.6590909090909091	0.6616541353383458	298	10618	45	13	253	10605	10916	0.33573861212805783
M1	cpdb	0	network_modules	25	TRUE	1.67837824830894e-57	138	58	38	0.6551724137931034	0.2753623188405797	REAC:R-HSA-6807070	REAC	PTEN Regulation	10916	1703		0.6666666666666666	0.6691729323308271	138	10778	38	20	100	10758	10916	0.420327366031134
M1	cpdb	0	network_modules	25	TRUE	7.997712033171306e-57	143	58	38	0.6551724137931034	0.26573426573426573	REAC:R-HSA-3858494	REAC	Beta-catenin independent WNT signaling	10916	216		0.6742424242424242	0.6766917293233082	143	10773	38	20	105	10753	10916	0.4127149898919661
M1	cpdb	0	network_modules	25	TRUE	9.751793878966538e-57	470	59	46	0.7796610169491526	0.09787234042553192	GO:0010498	GO:BP	proteasomal protein catabolic process	16175	4177		0	0.034482758620689655	470	15705	46	13	424	15692	16175	0.27038621261257834
M1	cpdb	0	network_modules	25	TRUE	1.8801553856837502e-56	114	58	36	0.6206896551724138	0.3157894736842105	REAC:R-HSA-9758941	REAC	Gastrulation	10916	1040		0.6818181818181818	0.6842105263157895	114	10802	36	22	78	10780	10916	0.43873595417040795
M1	cpdb	0	network_modules	25	TRUE	2.5029020918408718e-56	130	58	37	0.6379310344827587	0.2846153846153846	REAC:R-HSA-69206	REAC	G1/S Transition	10916	1002		0.6893939393939394	0.6917293233082706	130	10786	37	21	93	10765	10916	0.42178414886526583
M1	cpdb	0	network_modules	25	TRUE	4.7955867604537055e-56	149	58	38	0.6551724137931034	0.2550335570469799	REAC:R-HSA-5358351	REAC	Signaling by Hedgehog	10916	2258		0.696969696969697	0.6992481203007519	149	10767	38	20	111	10747	10916	0.4040863309533786
M1	cpdb	0	network_modules	25	TRUE	1.0907885464902306e-54	142	58	37	0.6379310344827587	0.2605633802816901	REAC:R-HSA-68867	REAC	Assembly of the pre-replicative complex	10916	181		0.7045454545454546	0.706766917293233	142	10774	37	21	105	10753	10916	0.4030845784037323
M1	cpdb	0	network_modules	25	TRUE	1.7700372425546032e-54	162	58	38	0.6551724137931034	0.2345679012345679	REAC:R-HSA-69242	REAC	S Phase	10916	2111		0.7121212121212122	0.7142857142857143	162	10754	38	20	124	10734	10916	0.38704829678291836
M1	cpdb	0	network_modules	25	TRUE	2.303947871218051e-54	163	58	38	0.6551724137931034	0.2331288343558282	REAC:R-HSA-983705	REAC	Signaling by the B Cell Receptor (BCR)	10916	2328		0.7196969696969697	0.7218045112781954	163	10753	38	20	125	10733	10916	0.38582194175989865
M1	cpdb	0	network_modules	25	TRUE	4.714336253158148e-54	147	58	37	0.6379310344827587	0.25170068027210885	REAC:R-HSA-453279	REAC	Mitotic G1 phase and G1/S transition	10916	1480		0.7272727272727273	0.7293233082706767	147	10769	37	21	110	10748	10916	0.39597160833948936
M1	cpdb	0	network_modules	25	TRUE	6.49383068681445e-54	167	58	38	0.6551724137931034	0.2275449101796407	REAC:R-HSA-69481	REAC	G2/M Checkpoints	10916	1005		0.7348484848484849	0.7368421052631579	167	10749	38	20	129	10729	10916	0.38102602983727096
M1	cpdb	0	network_modules	25	TRUE	1.4954233109007514e-53	363	59	42	0.711864406779661	0.11570247933884298	GO:0043161	GO:BP	proteasome-mediated ubiquitin-dependent protein catabolic process	16175	10561		0.03571428571428571	0.06896551724137931	363	15812	42	17	321	15795	16175	0.28163091058092704
M1	cpdb	0	network_modules	25	TRUE	1.7797153170037961e-53	171	58	38	0.6551724137931034	0.2222222222222222	REAC:R-HSA-9010553	REAC	Regulation of expression of SLITs and ROBOs	10916	2031		0.7424242424242424	0.7443609022556391	171	10745	38	20	133	10725	10916	0.37639762124777204
M1	cpdb	0	network_modules	25	TRUE	2.8010712903861954e-53	673	59	48	0.8135593220338984	0.0713224368499257	GO:0051603	GO:BP	proteolysis involved in protein catabolic process	16175	13820		0.07142857142857142	0.10344827586206896	673	15502	48	11	625	15491	16175	0.2339001550368535
M1	cpdb	0	network_modules	25	TRUE	2.916825765752635e-53	173	58	38	0.6551724137931034	0.21965317919075145	REAC:R-HSA-5619115	REAC	Disorders of transmembrane transporters	10916	778		0.75	0.7518796992481203	173	10743	38	20	135	10723	10916	0.37414319764491316
M1	cpdb	0	network_modules	25	TRUE	5.7689912981897e-53	221	58	40	0.6896551724137931	0.18099547511312217	REAC:R-HSA-5689880	REAC	Ub-specific processing proteases	10916	2617		0.7575757575757576	0.7593984962406015	221	10695	40	18	181	10677	10916	0.3473825907978842
M1	cpdb	0	network_modules	25	TRUE	6.046545296282041e-53	176	58	38	0.6551724137931034	0.2159090909090909	REAC:R-HSA-109581	REAC	Apoptosis	10916	158		0.7651515151515151	0.7669172932330827	176	10740	38	20	138	10720	10916	0.37083309721241176
M1	cpdb	0	network_modules	25	TRUE	1.2643746089041898e-52	159	58	37	0.6379310344827587	0.23270440251572327	REAC:R-HSA-69002	REAC	DNA Replication Pre-Initiation	10916	446		0.7727272727272727	0.7744360902255639	159	10757	37	21	122	10736	10916	0.3802778709427963
M1	cpdb	0	network_modules	25	TRUE	2.4928502423561863e-52	182	58	38	0.6551724137931034	0.2087912087912088	REAC:R-HSA-2454202	REAC	Fc epsilon receptor (FCERI) signaling	10916	938		0.7803030303030303	0.7819548872180451	182	10734	38	20	144	10714	10916	0.3644573997228167
M1	cpdb	0	network_modules	25	TRUE	5.399947968139754e-52	208	58	39	0.6724137931034483	0.1875	REAC:R-HSA-5357801	REAC	Programmed Cell Death	10916	1803		0.7878787878787878	0.7894736842105263	208	10708	39	19	169	10689	10916	0.34927601503731076
M1	cpdb	0	network_modules	25	TRUE	7.799391218751662e-52	187	58	38	0.6551724137931034	0.20320855614973263	REAC:R-HSA-69306	REAC	DNA Replication	10916	445		0.7954545454545454	0.7969924812030075	187	10729	38	20	149	10709	10916	0.3593777392717822
M1	cpdb	0	network_modules	25	TRUE	9.757491538292287e-52	188	58	38	0.6551724137931034	0.20212765957446807	REAC:R-HSA-2467813	REAC	Separation of Sister Chromatids	10916	2204		0.803030303030303	0.8045112781954887	188	10728	38	20	150	10708	10916	0.35838591387504953
M1	cpdb	0	network_modules	25	TRUE	1.5758093128390563e-51	141	53	36	0.6792452830188679	0.2553191489361702	KEGG:05017	KEGG	Spinocerebellar ataxia	8484	415		0.125	0.2222222222222222	141	8343	36	17	105	8326	8484	0.41095729091249716
M1	cpdb	0	network_modules	25	TRUE	2.7460084291356447e-51	555	59	45	0.7627118644067796	0.08108108108108109	GO:0019941	GO:BP	modification-dependent protein catabolic process	16175	6072		0.10714285714285714	0.13793103448275862	555	15620	45	14	510	15606	16175	0.24211650180166985
M1	cpdb	0	network_modules	25	TRUE	3.8316332723062144e-51	559	59	45	0.7627118644067796	0.08050089445438283	GO:0043632	GO:BP	modification-dependent macromolecule catabolic process	16175	10812		0.14285714285714285	0.1724137931034483	559	15616	45	14	514	15602	16175	0.24119767798985006
M1	cpdb	0	network_modules	25	TRUE	4.511982770444021e-51	195	58	38	0.6551724137931034	0.19487179487179487	REAC:R-HSA-69275	REAC	G2/M Transition	10916	1008		0.8106060606060606	0.8120300751879699	195	10721	38	20	157	10701	10916	0.35165558338920405
M1	cpdb	0	network_modules	25	TRUE	6.909650663933803e-51	197	58	38	0.6551724137931034	0.19289340101522842	REAC:R-HSA-453274	REAC	Mitotic G2-G2/M phases	10916	1481		0.8181818181818182	0.8195488721804511	197	10719	38	20	159	10699	10916	0.34979802327173753
M1	cpdb	0	network_modules	25	TRUE	1.0044864406051639e-50	308	58	42	0.7241379310344828	0.13636363636363635	REAC:R-HSA-983168	REAC	Antigen processing: Ubiquitination & Proteasome degradation	10916	154		0.8257575757575758	0.8270676691729323	308	10608	42	16	266	10592	10916	0.3071647317005956
M1	cpdb	0	network_modules	25	TRUE	1.1992243777717813e-49	211	58	38	0.6551724137931034	0.18009478672985782	REAC:R-HSA-9711123	REAC	Cellular response to chemical stress	10916	333		0.8333333333333334	0.8345864661654135	211	10705	38	20	173	10685	10916	0.3375343128975721
M1	cpdb	0	network_modules	25	TRUE	1.3046595307316634e-49	547	59	44	0.7457627118644068	0.08043875685557587	GO:0006511	GO:BP	ubiquitin-dependent protein catabolic process	16175	2235		0.17857142857142858	0.20689655172413793	547	15628	44	15	503	15613	16175	0.23831029367120962
M1	cpdb	0	network_modules	25	TRUE	3.821988868602957e-49	217	58	38	0.6551724137931034	0.17511520737327188	REAC:R-HSA-376176	REAC	Signaling by ROBO receptors	10916	2301		0.8409090909090909	0.8421052631578947	217	10699	38	20	179	10679	10916	0.33264074528287957
M1	cpdb	0	network_modules	25	TRUE	4.648233917554966e-49	244	58	39	0.6724137931034483	0.1598360655737705	REAC:R-HSA-8951664	REAC	Neddylation	10916	1559		0.8484848484848485	0.849624060150376	244	10672	39	19	205	10653	10916	0.32139497651409665
M1	cpdb	0	network_modules	25	TRUE	1.6980238271851048e-48	225	58	38	0.6551724137931034	0.1688888888888889	REAC:R-HSA-162906	REAC	HIV Infection	10916	1102		0.8560606060606061	0.8571428571428571	225	10691	38	20	187	10671	10916	0.32641882274468326
M1	cpdb	0	network_modules	25	TRUE	2.925930635488054e-48	228	58	38	0.6551724137931034	0.16666666666666666	REAC:R-HSA-68882	REAC	Mitotic Anaphase	10916	1479		0.8636363636363636	0.8646616541353384	228	10688	38	20	190	10668	10916	0.32416926753591435
M1	cpdb	0	network_modules	25	TRUE	3.501661149833538e-48	229	58	38	0.6551724137931034	0.16593886462882096	REAC:R-HSA-2555396	REAC	Mitotic Metaphase and Anaphase	10916	1482		0.8712121212121212	0.8721804511278195	229	10687	38	20	191	10667	10916	0.32342911401339547
M1	cpdb	0	network_modules	25	TRUE	5.002316141271993e-48	231	58	38	0.6551724137931034	0.1645021645021645	REAC:R-HSA-201681	REAC	TCF dependent signaling in response to WNT	10916	2421		0.8787878787878788	0.8796992481203008	231	10685	38	20	193	10665	10916	0.32196303962338746
M1	cpdb	0	network_modules	25	TRUE	8.487143787889735e-48	234	58	38	0.6551724137931034	0.1623931623931624	REAC:R-HSA-8878171	REAC	Transcriptional regulation by RUNX1	10916	2552		0.8863636363636364	0.8872180451127819	234	10682	38	20	196	10662	10916	0.3197987495203548
M1	cpdb	0	network_modules	25	TRUE	1.0918237413112155e-46	380	58	42	0.7241379310344828	0.11052631578947368	REAC:R-HSA-983169	REAC	Class I MHC mediated antigen processing & presentation	10916	368		0.8939393939393939	0.8947368421052632	380	10536	42	16	338	10520	10916	0.27485142415910035
M1	cpdb	0	network_modules	25	TRUE	2.0486177929874994e-46	253	58	38	0.6551724137931034	0.15019762845849802	REAC:R-HSA-1257604	REAC	PIP3 activates AKT signaling	10916	1679		0.9015151515151515	0.9022556390977443	253	10663	38	20	215	10643	10916	0.30698458975622434
M1	cpdb	0	network_modules	25	TRUE	5.913645148315618e-46	232	58	37	0.6379310344827587	0.15948275862068967	REAC:R-HSA-157118	REAC	Signaling by NOTCH	10916	2274		0.9090909090909091	0.9097744360902256	232	10684	37	21	195	10663	10916	0.312499989605048
M1	cpdb	0	network_modules	25	TRUE	1.1503778678761529e-45	264	58	38	0.6551724137931034	0.14393939393939395	REAC:R-HSA-5673001	REAC	RAF/MAP kinase cascade	10916	1841		0.9166666666666666	0.9172932330827067	264	10652	38	20	226	10632	10916	0.3001967440062777
M1	cpdb	0	network_modules	25	TRUE	2.456160018208337e-45	269	58	38	0.6551724137931034	0.1412639405204461	REAC:R-HSA-5684996	REAC	MAPK1/MAPK3 signaling	10916	1351		0.9242424242424242	0.924812030075188	269	10647	38	20	231	10627	10916	0.297247614225706
M1	cpdb	0	network_modules	25	TRUE	7.364918659976486e-45	308	58	39	0.6724137931034483	0.1266233766233766	REAC:R-HSA-5683057	REAC	MAPK family signaling cascades	10916	1348		0.9318181818181818	0.9323308270676691	308	10608	39	19	269	10589	10916	0.28433484519437896
M1	cpdb	0	network_modules	25	TRUE	4.4082423774522787e-44	289	58	38	0.6551724137931034	0.1314878892733564	REAC:R-HSA-69620	REAC	Cell Cycle Checkpoints	10916	321		0.9393939393939394	0.9398496240601504	289	10627	38	20	251	10607	10916	0.2862134817939218
M1	cpdb	0	network_modules	25	TRUE	7.651136595372639e-44	293	58	38	0.6551724137931034	0.1296928327645051	REAC:R-HSA-9006925	REAC	Intracellular signaling by second messengers	10916	1266		0.946969696969697	0.9473684210526315	293	10623	38	20	255	10603	10916	0.2841408965998124
M1	cpdb	0	network_modules	25	TRUE	9.213728207390709e-43	363	53	40	0.7547169811320755	0.11019283746556474	KEGG:05014	KEGG	Amyotrophic lateral sclerosis	8484	413		0.25	0.3333333333333333	363	8121	40	13	323	8108	8484	0.2789193328026714
M1	cpdb	0	network_modules	25	TRUE	1.2826406839421513e-42	265	53	37	0.6981132075471698	0.13962264150943396	KEGG:05012	KEGG	Parkinson disease	8484	412		0.375	0.4444444444444444	265	8219	37	16	228	8203	8484	0.3039575777656294
M1	cpdb	0	network_modules	25	TRUE	6.11554442225327e-42	327	58	38	0.6551724137931034	0.1162079510703364	REAC:R-HSA-195721	REAC	Signaling by WNT	10916	2314		0.9545454545454546	0.9548872180451128	327	10589	38	20	289	10569	10916	0.2680597488230737
M1	cpdb	0	network_modules	25	TRUE	8.238780350207922e-41	472	58	41	0.7068965517241379	0.08686440677966102	REAC:R-HSA-449147	REAC	Signaling by Interleukins	10916	2261		0.9621212121212122	0.9624060150375939	472	10444	41	17	431	10427	10916	0.2384745458534807
M1	cpdb	0	network_modules	25	TRUE	2.047773826946553e-38	305	53	36	0.6792452830188679	0.1180327868852459	KEGG:05016	KEGG	Huntington disease	8484	414		0.5	0.5555555555555556	305	8179	36	17	269	8162	8484	0.273974016910536
M1	cpdb	0	network_modules	25	TRUE	3.086965504784107e-38	406	58	38	0.6551724137931034	0.09359605911330049	REAC:R-HSA-68886	REAC	M Phase	10916	1343		0.9696969696969697	0.9699248120300752	406	10510	38	20	368	10490	10916	0.23867787377673355
M1	cpdb	0	network_modules	25	TRUE	4.632685813535341e-38	370	58	37	0.6379310344827587	0.1	REAC:R-HSA-71291	REAC	Metabolism of amino acids and derivatives	10916	1421		0.9772727272727273	0.9774436090225563	370	10546	37	21	333	10525	10916	0.24396108924729581
M1	cpdb	0	network_modules	25	TRUE	9.628806781793254e-38	418	58	38	0.6551724137931034	0.09090909090909091	REAC:R-HSA-5663202	REAC	Diseases of signal transduction by growth factor receptors and second messengers	10916	773		0.9848484848484849	0.9849624060150376	418	10498	38	20	380	10478	10916	0.23494265347211202
M1	cpdb	0	network_modules	25	TRUE	1.0407236669709246e-36	271	53	34	0.6415094339622641	0.12546125461254612	KEGG:05020	KEGG	Prion disease	8484	416		0.625	0.6666666666666666	271	8213	34	19	237	8194	8484	0.2748431440809231
M1	cpdb	0	network_modules	25	TRUE	9.065293224457853e-35	382	53	36	0.6792452830188679	0.09424083769633508	KEGG:05010	KEGG	Alzheimer disease	8484	411		0.75	0.7777777777777778	382	8102	36	17	346	8085	8484	0.24249943919019878
M1	cpdb	0	network_modules	25	TRUE	2.096252223846221e-16	198	53	19	0.3584905660377358	0.09595959595959595	KEGG:05169	KEGG	Epstein-Barr virus infection	8484	450		0.875	0.8888888888888888	198	8286	19	34	179	8252	8484	0.176009649018734
M1	cpdb	0	network_modules	25	TRUE	1.8405544455213446e-14	201	59	16	0.2711864406779661	0.07960199004975124	GO:1903050	GO:BP	regulation of proteolysis involved in protein catabolic process	16175	22729		0.21428571428571427	0.2413793103448276	201	15974	16	43	185	15931	16175	0.14132978509456043
M1	cpdb	0	network_modules	25	TRUE	4.9902747727635194e-14	171	59	15	0.2542372881355932	0.08771929824561403	GO:0061136	GO:BP	regulation of proteasomal protein catabolic process	16175	15243		0.25	0.27586206896551724	171	16004	15	44	156	15960	16175	0.1441528509234358
M1	cpdb	0	network_modules	25	TRUE	1.950023168482908e-11	375	59	17	0.288135593220339	0.04533333333333334	GO:0030162	GO:BP	regulation of proteolysis	16175	6690		0.2857142857142857	0.3103448275862069	375	15800	17	42	358	15758	16175	0.10652809124089166
M1	cpdb	0	network_modules	25	TRUE	3.3290815917789126e-10	309	59	15	0.2542372881355932	0.04854368932038835	GO:0042176	GO:BP	regulation of protein catabolic process	16175	10004		0.32142857142857145	0.3448275862068966	309	15866	15	44	294	15822	16175	0.10393064927339718
M1	cpdb	0	network_modules	25	TRUE	2.044363413775257e-7	10	59	5	0.0847457627118644	0.5	GO:0043248	GO:BP	proteasome assembly	16175	10584		0.35714285714285715	0.3793103448275862	10	16165	5	54	5	16111	16175	0.2047820668824077
M1	cpdb	0	network_modules	25	TRUE	7.523594223221337e-7	476	58	16	0.27586206896551724	0.03361344537815126	REAC:R-HSA-6798695	REAC	Neutrophil degranulation	10916	1597		0.9924242424242424	0.9924812030075187	476	10440	16	42	460	10398	10916	0.08312209505975489
M1	cpdb	0	network_modules	25	TRUE	1.0513564566814804e-6	12	58	5	0.08620689655172414	0.4166666666666667	REAC:R-HSA-5689877	REAC	Josephin domain DUBs	10916	1280		1	1	12	10904	5	53	7	10851	10916	0.18770998179853585
M1	cpdb	0	network_modules	25	TRUE	4.539967933105371e-6	148	59	9	0.15254237288135594	0.060810810810810814	GO:2000058	GO:BP	regulation of ubiquitin-dependent protein catabolic process	16175	25413		0.39285714285714285	0.41379310344827586	148	16027	9	50	139	15977	16175	0.09111942600242252
M1	cpdb	0	network_modules	25	TRUE	4.876653636349211e-6	102	59	8	0.13559322033898305	0.0784313725490196	GO:1901800	GO:BP	positive regulation of proteasomal protein catabolic process	16175	21744		0.42857142857142855	0.4482758620689655	102	16073	8	51	94	16022	16175	0.09882085620432768
M1	cpdb	0	network_modules	25	TRUE	1.4537933358555503e-5	117	59	8	0.13559322033898305	0.06837606837606838	GO:1903052	GO:BP	positive regulation of proteolysis involved in protein catabolic process	16175	22731		0.4642857142857143	0.4827586206896552	117	16058	8	51	109	16007	16175	0.09164993471661671
M1	cpdb	0	network_modules	25	TRUE	6.984874552951312e-5	3	59	3	0.05084745762711865	1	GO:0070682	GO:BP	proteasome regulatory particle assembly	16175	16258		0.5	0.5172413793103449	3	16172	3	56	0	16116	16175	0.2251030526526565
M1	cpdb	0	network_modules	25	TRUE	1.1714502345363422e-4	12	59	4	0.06779661016949153	0.3333333333333333	GO:1901526	GO:BP	positive regulation of mitophagy	16175	21541		0.5357142857142857	0.5517241379310345	12	16163	4	55	8	16108	16175	0.1490113808099532
M1	cpdb	0	network_modules	25	TRUE	1.384628171539859e-4	156	59	8	0.13559322033898305	0.05128205128205128	GO:0016241	GO:BP	regulation of macroautophagy	16175	5183		0.5714285714285714	0.5862068965517241	156	16019	8	51	148	15968	16175	0.07797499938115832
M1	cpdb	0	network_modules	25	TRUE	1.8147989730731682e-4	477	59	12	0.2033898305084746	0.025157232704402517	GO:0009896	GO:BP	positive regulation of catabolic process	16175	3756		0.6071428571428571	0.6206896551724138	477	15698	12	47	465	15651	16175	0.06219558949089858
M1	cpdb	0	network_modules	25	TRUE	2.3560657137015504e-4	14	59	4	0.06779661016949153	0.2857142857142857	GO:1903599	GO:BP	positive regulation of autophagy of mitochondrion	16175	23138		0.6428571428571429	0.6551724137931034	14	16161	4	55	10	16106	16175	0.13771186053785367
M1	cpdb	0	network_modules	25	TRUE	4.535062240684044e-4	182	59	8	0.13559322033898305	0.04395604395604396	GO:0045732	GO:BP	positive regulation of protein catabolic process	16175	11573		0.6785714285714286	0.6896551724137931	182	15993	8	51	174	15942	16175	0.0713273954932285
M1	cpdb	0	network_modules	25	TRUE	7.12337524782169e-4	43	59	5	0.0847457627118644	0.11627906976744186	GO:0000423	GO:BP	mitophagy	16175	127		0.7142857142857143	0.7241379310344828	43	16132	5	54	38	16078	16175	0.09645827922115358
M1	cpdb	0	network_modules	25	TRUE	0.0012971843841641329	209	59	8	0.13559322033898305	0.03827751196172249	GO:0045862	GO:BP	positive regulation of proteolysis	16175	11674		0.75	0.7586206896551724	209	15966	8	51	201	15915	16175	0.06572280158229195
M1	cpdb	0	network_modules	25	TRUE	0.0024338903875063124	24	59	4	0.06779661016949153	0.16666666666666666	GO:1901524	GO:BP	regulation of mitophagy	16175	21539		0.7857142857142857	0.7931034482758621	24	16151	4	55	20	16096	16175	0.10423989308450525
M1	cpdb	0	network_modules	25	TRUE	0.002482831560956947	309	59	9	0.15254237288135594	0.02912621359223301	GO:0016236	GO:BP	macroautophagy	16175	5179		0.8214285714285714	0.8275862068965517	309	15866	9	50	300	15816	16175	0.0589808310430381
M1	cpdb	0	network_modules	25	TRUE	0.0029801072350806057	57	59	5	0.0847457627118644	0.08771929824561403	GO:0000422	GO:BP	autophagy of mitochondrion	16175	126		0.8571428571428571	0.8620689655172413	57	16118	5	54	52	16064	16175	0.08293184057845508
M1	cpdb	0	network_modules	25	TRUE	0.00568892404014554	115	59	6	0.1016949152542373	0.05217391304347826	GO:0032434	GO:BP	regulation of proteasomal ubiquitin-dependent protein catabolic process	16175	7563		0.8928571428571429	0.896551724137931	115	16060	6	53	109	16007	16175	0.06811504700579568
M1	cpdb	0	network_modules	25	TRUE	0.006435654202636591	168	53	7	0.1320754716981132	0.041666666666666664	KEGG:04141	KEGG	Protein processing in endoplasmic reticulum	8484	278		1	1	168	8316	7	46	161	8270	8484	0.063894635567729
M1	cpdb	0	network_modules	25	TRUE	0.0070711159310621234	31	59	4	0.06779661016949153	0.12903225806451613	GO:1903146	GO:BP	regulation of autophagy of mitochondrion	16175	22796		0.9285714285714286	0.9310344827586207	31	16144	4	55	27	16089	16175	0.09114006029703235
M1	cpdb	0	network_modules	25	TRUE	0.008230709123167021	10	59	3	0.05084745762711865	0.3	GO:0035973	GO:BP	aggrephagy	16175	9373		0.9642857142857143	0.9655172413793104	10	16165	3	56	7	16109	16175	0.12226727752392369
M1	cpdb	0	network_modules	25	TRUE	0.008308137615494763	70	59	5	0.0847457627118644	0.07142857142857142	GO:0016239	GO:BP	positive regulation of macroautophagy	16175	5181		1	1	70	16105	5	54	65	16051	16175	0.0741252328563404
M1	cpdb	0	network_modules	26	TRUE	2.905258330683488e-15	514	52	21	0.40384615384615385	0.04085603112840467	GO:1901137	GO:BP	carbohydrate derivative biosynthetic process	16175	21245		0	0.0625	514	15661	21	31	493	15630	16175	0.12046333699832655
M1	cpdb	0	network_modules	26	TRUE	1.0364775433578707e-13	315	52	17	0.3269230769230769	0.05396825396825397	GO:0009100	GO:BP	glycoprotein metabolic process	16175	3272		0.06666666666666667	0.125	315	15860	17	35	298	15825	16175	0.12635390144764214
M1	cpdb	0	network_modules	26	TRUE	4.653724946198484e-12	265	52	15	0.28846153846153844	0.05660377358490566	GO:0009101	GO:BP	glycoprotein biosynthetic process	16175	3273		0.13333333333333333	0.1875	265	15910	15	37	250	15873	16175	0.1217191196015194
M1	cpdb	0	network_modules	26	TRUE	2.257544244486908e-11	183	52	13	0.25	0.07103825136612021	GO:0006486	GO:BP	protein glycosylation	16175	2220		0.2	0.3125	183	15992	13	39	170	15953	16175	0.12816619451508018
M1	cpdb	0	network_modules	26	TRUE	2.257544244486908e-11	183	52	13	0.25	0.07103825136612021	GO:0043413	GO:BP	macromolecule glycosylation	16175	10680		0.2	0.3125	183	15992	13	39	170	15953	16175	0.12816619451508018
M1	cpdb	0	network_modules	26	TRUE	9.2524325910034e-11	204	52	13	0.25	0.06372549019607843	GO:0070085	GO:BP	glycosylation	16175	15903		0.3333333333333333	0.375	204	15971	13	39	191	15932	16175	0.12080935213455216
M1	cpdb	0	network_modules	26	TRUE	1.5919906929432897e-8	17	52	6	0.11538461538461539	0.35294117647058826	GO:0035268	GO:BP	protein mannosylation	16175	8932		0.4	0.5	17	16158	6	46	11	16112	16175	0.2003912206242364
M1	cpdb	0	network_modules	26	TRUE	1.5919906929432897e-8	17	52	6	0.11538461538461539	0.35294117647058826	GO:0035269	GO:BP	protein O-linked mannosylation	16175	8933		0.4	0.5	17	16158	6	46	11	16112	16175	0.2003912206242364
M1	cpdb	0	network_modules	26	TRUE	2.3821626739325084e-8	18	52	6	0.11538461538461539	0.3333333333333333	GO:0097502	GO:BP	mannosylation	16175	18684		0.5333333333333333	0.5625	18	16157	6	46	12	16111	16175	0.194645979642341
M1	cpdb	0	network_modules	26	TRUE	9.454709884854712e-7	94	52	8	0.15384615384615385	0.0851063829787234	GO:0006493	GO:BP	protein O-linked glycosylation	16175	2225		0.6	0.625	94	16081	8	44	86	16037	16175	0.11060280914777489
M1	cpdb	0	network_modules	26	TRUE	3.969581124326403e-6	23	39	5	0.1282051282051282	0.21739130434782608	KEGG:00515	KEGG	Mannose type O-glycan biosynthesis	8484	68		0	0.25	23	8461	5	34	18	8427	8484	0.16401434252718705
M1	cpdb	0	network_modules	26	TRUE	1.3701372875193366e-5	108	35	7	0.2	0.06481481481481481	REAC:R-HSA-5173105	REAC	O-linked glycosylation	10916	1631		0	0.3333333333333333	108	10808	7	28	101	10780	10916	0.10893690440231288
M1	cpdb	0	network_modules	26	TRUE	9.416945450317635e-5	42	39	5	0.1282051282051282	0.11904761904761904	KEGG:00513	KEGG	Various types of N-glycan biosynthesis	8484	66		0.3333333333333333	0.5	42	8442	5	34	37	8408	8484	0.11934083460293778
M1	cpdb	0	network_modules	26	TRUE	3.0619048392025247e-4	53	39	5	0.1282051282051282	0.09433962264150944	KEGG:00510	KEGG	N-Glycan biosynthesis	8484	63		0.6666666666666666	0.75	53	8431	5	34	48	8397	8484	0.10518800479440715
M1	cpdb	0	network_modules	26	TRUE	4.2200936277058873e-4	26	39	4	0.10256410256410256	0.15384615384615385	KEGG:00563	KEGG	Glycosylphosphatidylinositol (GPI)-anchor biosynthesis	8484	87		1	1	26	8458	4	35	22	8423	8484	0.12233016618512564
M1	cpdb	0	network_modules	26	TRUE	7.637615837413063e-4	92	52	6	0.11538461538461539	0.06521739130434782	GO:0006664	GO:BP	glycolipid metabolic process	16175	2373		0.6666666666666666	0.6875	92	16083	6	46	86	16037	16175	0.08283991595950368
M1	cpdb	0	network_modules	26	TRUE	8.144435906165116e-4	93	52	6	0.11538461538461539	0.06451612903225806	GO:1903509	GO:BP	liposaccharide metabolic process	16175	23059		0.7333333333333333	0.75	93	16082	6	46	87	16036	16175	0.08234946063319692
M1	cpdb	0	network_modules	26	TRUE	0.0016030834008953698	140	35	6	0.17142857142857143	0.04285714285714286	REAC:R-HSA-3781865	REAC	Diseases of glycosylation	10916	765		0.5	0.6666666666666666	140	10776	6	29	134	10747	10916	0.07994341941927272
M1	cpdb	0	network_modules	26	TRUE	0.001820623426576312	37	35	4	0.11428571428571428	0.10810810810810811	REAC:R-HSA-9694548	REAC	Maturation of spike protein	10916	1408		1	1	37	10879	4	31	33	10848	10916	0.10821424558175197
M1	cpdb	0	network_modules	26	TRUE	0.0025449181999271328	27	52	4	0.07692307692307693	0.14814814814814814	GO:0006505	GO:BP	GPI anchor metabolic process	16175	2231		0.8	0.8125	27	16148	4	48	23	16100	16175	0.10469125700698584
M1	cpdb	0	network_modules	26	TRUE	0.0037778333598430533	67	52	5	0.09615384615384616	0.07462686567164178	GO:0009247	GO:BP	glycolipid biosynthetic process	16175	3412		0.8666666666666667	0.875	67	16108	5	47	62	16061	16175	0.08135938325572224
M1	cpdb	0	network_modules	26	TRUE	0.004067795501276863	68	52	5	0.09615384615384616	0.07352941176470588	GO:0006487	GO:BP	protein N-linked glycosylation	16175	2221		0.9333333333333333	0.9375	68	16107	5	47	63	16060	16175	0.08070717906512577
M1	cpdb	0	network_modules	26	TRUE	0.004519592849118057	31	52	4	0.07692307692307693	0.12903225806451613	GO:0180046	GO:BP	GPI anchored protein biosynthesis	16175	20314		1	1	31	16144	4	48	27	16096	16175	0.0973947931487385
M1	cpdb	0	network_modules	27	TRUE	7.695533149783792e-51	96	35	28	0.8	0.2916666666666667	REAC:R-HSA-5620912	REAC	Anchoring of the basal body to the plasma membrane	10916	147		0	0.07142857142857142	96	10820	28	7	68	10813	10916	0.48062154257928486
M1	cpdb	0	network_modules	27	TRUE	7.54675051419304e-42	68	35	23	0.6571428571428571	0.3382352941176471	REAC:R-HSA-380284	REAC	Loss of proteins required for interphase microtubule organization from the centrosome	10916	1335		0.07692307692307693	0.21428571428571427	68	10848	23	12	45	10836	10916	0.46919903228873266
M1	cpdb	0	network_modules	27	TRUE	7.54675051419304e-42	68	35	23	0.6571428571428571	0.3382352941176471	REAC:R-HSA-380259	REAC	Loss of Nlp from mitotic centrosomes	10916	1331		0.07692307692307693	0.21428571428571427	68	10848	23	12	45	10836	10916	0.46919903228873266
M1	cpdb	0	network_modules	27	TRUE	2.4859182755140427e-41	71	35	23	0.6571428571428571	0.323943661971831	REAC:R-HSA-8854518	REAC	AURKA Activation by TPX2	10916	41		0.23076923076923078	0.2857142857142857	71	10845	23	12	48	10833	10916	0.45904899940847826
M1	cpdb	0	network_modules	27	TRUE	6.661378849920898e-41	200	35	28	0.8	0.14	REAC:R-HSA-5617833	REAC	Cilium Assembly	10916	361		0.3076923076923077	0.35714285714285715	200	10716	28	7	172	10709	10916	0.3305672562220785
M1	cpdb	0	network_modules	27	TRUE	6.347009200792994e-40	80	35	23	0.6571428571428571	0.2875	REAC:R-HSA-380270	REAC	Recruitment of mitotic centrosome proteins and complexes	10916	1951		0.38461538461538464	0.5	80	10836	23	12	57	10824	10916	0.43208861829728556
M1	cpdb	0	network_modules	27	TRUE	6.347009200792994e-40	80	35	23	0.6571428571428571	0.2875	REAC:R-HSA-380287	REAC	Centrosome maturation	10916	341		0.38461538461538464	0.5	80	10836	23	12	57	10824	10916	0.43208861829728556
M1	cpdb	0	network_modules	27	TRUE	3.2002661316104295e-39	85	35	23	0.6571428571428571	0.27058823529411763	REAC:R-HSA-2565942	REAC	Regulation of PLK1 Activity at G2/M Transition	10916	1998		0.5384615384615384	0.5714285714285714	85	10831	23	12	62	10819	10916	0.41898873115866914
M1	cpdb	0	network_modules	27	TRUE	4.527304517538125e-38	94	35	23	0.6571428571428571	0.24468085106382978	REAC:R-HSA-380320	REAC	Recruitment of NuMA to mitotic centrosomes	10916	1950		0.6153846153846154	0.6428571428571429	94	10822	23	12	71	10810	10916	0.3980857430920218
M1	cpdb	0	network_modules	27	TRUE	6.366558565829398e-38	586	54	37	0.6851851851851852	0.06313993174061433	GO:0000226	GO:BP	microtubule cytoskeleton organization	16175	61		0	0.016129032258064516	586	15589	37	17	549	15572	16175	0.20100311523762354
M1	cpdb	0	network_modules	27	TRUE	4.79374351253298e-36	292	35	28	0.8	0.0958904109589041	REAC:R-HSA-1852241	REAC	Organelle biogenesis and maintenance	10916	1646		0.6923076923076923	0.7142857142857143	292	10624	28	7	264	10617	10916	0.27179894728528525
M1	cpdb	0	network_modules	27	TRUE	1.837704958401072e-34	146	54	25	0.46296296296296297	0.17123287671232876	GO:0031023	GO:BP	microtubule organizing center organization	16175	6997		0.01639344262295082	0.03225806451612903	146	16029	25	29	121	16000	16175	0.277786299508874
M1	cpdb	0	network_modules	27	TRUE	8.01118067162047e-34	129	54	24	0.4444444444444444	0.18604651162790697	GO:0007098	GO:BP	centrosome cycle	16175	2681		0.03278688524590164	0.04838709677419355	129	16046	24	30	105	16016	16175	0.2840014176103136
M1	cpdb	0	network_modules	27	TRUE	3.860264632605577e-30	195	35	23	0.6571428571428571	0.11794871794871795	REAC:R-HSA-69275	REAC	G2/M Transition	10916	1008		0.7692307692307693	0.7857142857142857	195	10721	23	12	172	10709	10916	0.2737276977445465
M1	cpdb	0	network_modules	27	TRUE	4.940975326711206e-30	197	35	23	0.6571428571428571	0.116751269035533	REAC:R-HSA-453274	REAC	Mitotic G2-G2/M phases	10916	1481		0.8461538461538461	0.8571428571428571	197	10719	23	12	174	10707	10916	0.27228201961793086
M1	cpdb	0	network_modules	27	TRUE	6.307376177320496e-30	199	35	23	0.6571428571428571	0.11557788944723618	REAC:R-HSA-68877	REAC	Mitotic Prometaphase	10916	1484		0.9230769230769231	0.9285714285714286	199	10717	23	12	176	10705	10916	0.2708579180877221
M1	cpdb	0	network_modules	27	TRUE	8.827132921146495e-25	343	54	25	0.46296296296296297	0.0728862973760933	GO:0140694	GO:BP	membraneless organelle assembly	16175	19860		0.04918032786885246	0.06451612903225806	343	15832	25	29	318	15803	16175	0.17746555095190308
M1	cpdb	0	network_modules	27	TRUE	6.342516636694087e-23	176	54	20	0.37037037037037035	0.11363636363636363	GO:0007051	GO:BP	spindle organization	16175	2650		0.06557377049180328	0.08064516129032258	176	15999	20	34	156	15965	16175	0.20055269096752085
M1	cpdb	0	network_modules	27	TRUE	1.328812702831885e-22	406	35	23	0.6571428571428571	0.05665024630541872	REAC:R-HSA-68886	REAC	M Phase	10916	1343		1	1	406	10510	23	12	383	10498	10916	0.18580408403649815
M1	cpdb	0	network_modules	27	TRUE	1.398445756856877e-21	343	54	23	0.42592592592592593	0.06705539358600583	GO:0060271	GO:BP	cilium assembly	16175	14488		0.08196721311475409	0.0967741935483871	343	15832	23	31	320	15801	16175	0.1625868003051696
M1	cpdb	0	network_modules	27	TRUE	3.70635849060548e-21	113	54	17	0.3148148148148148	0.1504424778761062	GO:0051225	GO:BP	spindle assembly	16175	13578		0.09836065573770492	0.11290322580645161	113	16062	17	37	96	16025	16175	0.2139022197769257
M1	cpdb	0	network_modules	27	TRUE	7.091536517540035e-21	368	54	23	0.42592592592592593	0.0625	GO:0044782	GO:BP	cilium organization	16175	11155		0.11475409836065574	0.12903225806451613	368	15807	23	31	345	15776	16175	0.156491188044979
M1	cpdb	0	network_modules	27	TRUE	2.6292782444564593e-19	47	54	13	0.24074074074074073	0.2765957446808511	GO:0098534	GO:BP	centriole assembly	16175	18792		0.13114754098360656	0.14516129032258066	47	16128	13	41	34	16087	16175	0.25573007163389394
M1	cpdb	0	network_modules	27	TRUE	8.018801473324018e-18	42	54	12	0.2222222222222222	0.2857142857142857	GO:0007099	GO:BP	centriole replication	16175	2682		0.14754098360655737	0.16129032258064516	42	16133	12	42	30	16091	16175	0.24977327809258507
M1	cpdb	0	network_modules	27	TRUE	8.808338544601414e-18	503	54	23	0.42592592592592593	0.04572564612326044	GO:0120031	GO:BP	plasma membrane bounded cell projection assembly	16175	19467		0.16393442622950818	0.1774193548387097	503	15672	23	31	480	15641	16175	0.13164595790101621
M1	cpdb	0	network_modules	27	TRUE	1.4346925268302037e-17	514	54	23	0.42592592592592593	0.04474708171206226	GO:0030031	GO:BP	cell projection assembly	16175	6655		0.18032786885245902	0.1935483870967742	514	15661	23	31	491	15630	16175	0.1300510146438809
M1	cpdb	0	network_modules	27	TRUE	3.156426629942552e-17	232	54	18	0.3333333333333333	0.07758620689655173	GO:0032886	GO:BP	regulation of microtubule-based process	16175	7882		0.19672131147540983	0.20967741935483872	232	15943	18	36	214	15907	16175	0.15527213368874945
M1	cpdb	0	network_modules	27	TRUE	1.026106950163052e-16	71	54	13	0.24074074074074073	0.18309859154929578	GO:0051298	GO:BP	centrosome duplication	16175	13629		0.21311475409836064	0.22580645161290322	71	16104	13	41	58	16063	16175	0.20692217271685123
M1	cpdb	0	network_modules	27	TRUE	5.026897231056573e-14	147	54	14	0.25925925925925924	0.09523809523809523	GO:0070507	GO:BP	regulation of microtubule cytoskeleton organization	16175	16162		0.22950819672131148	0.24193548387096775	147	16028	14	40	133	15988	16175	0.1525752495339102
M1	cpdb	0	network_modules	27	TRUE	8.753455214151719e-14	361	54	18	0.3333333333333333	0.04986149584487535	GO:0007059	GO:BP	chromosome segregation	16175	2658		0.2459016393442623	0.25806451612903225	361	15814	18	36	343	15778	16175	0.1218574159788029
M1	cpdb	0	network_modules	27	TRUE	1.3331657570642448e-13	88	54	12	0.2222222222222222	0.13636363636363635	GO:0046785	GO:BP	microtubule polymerization	16175	12369		0.26229508196721313	0.27419354838709675	88	16087	12	42	76	16045	16175	0.17056463386669257
M1	cpdb	0	network_modules	27	TRUE	2.1371415884483658e-13	124	54	13	0.24074074074074073	0.10483870967741936	GO:0031109	GO:BP	microtubule polymerization or depolymerization	16175	7034		0.2786885245901639	0.2903225806451613	124	16051	13	41	111	16010	16175	0.15466007551158384
M1	cpdb	0	network_modules	27	TRUE	4.0128410074727047e-13	46	54	10	0.18518518518518517	0.21739130434782608	GO:0007020	GO:BP	microtubule nucleation	16175	2628		0.29508196721311475	0.3064516129032258	46	16129	10	44	36	16085	16175	0.19817440689894203
M1	cpdb	0	network_modules	27	TRUE	9.9889818382426e-13	19	54	8	0.14814814814814814	0.42105263157894735	GO:0010968	GO:BP	regulation of microtubule nucleation	16175	4544		0.3114754098360656	0.3225806451612903	19	16156	8	46	11	16110	16175	0.24833645767128865
M1	cpdb	0	network_modules	27	TRUE	3.102635516762314e-12	793	54	22	0.4074074074074074	0.027742749054224466	GO:0044087	GO:BP	regulation of cellular component biogenesis	16175	10909		0.32786885245901637	0.3387096774193548	793	15382	22	32	771	15350	16175	0.09606104800011256
M1	cpdb	0	network_modules	27	TRUE	4.483504695570333e-11	186	54	13	0.24074074074074073	0.06989247311827956	GO:1902115	GO:BP	regulation of organelle assembly	16175	22028		0.3442622950819672	0.3548387096774194	186	15989	13	41	173	15948	16175	0.1244432440703971
M1	cpdb	0	network_modules	27	TRUE	1.0113628092018738e-10	31	54	8	0.14814814814814814	0.25806451612903225	GO:0071539	GO:BP	protein localization to centrosome	16175	16751		0.36065573770491804	0.3709677419354839	31	16144	8	46	23	16098	16175	0.19350848878778196
M1	cpdb	0	network_modules	27	TRUE	1.3450713524113418e-10	32	54	8	0.14814814814814814	0.25	GO:1905508	GO:BP	protein localization to microtubule organizing center	16175	24684		0.3770491803278688	0.3870967741935484	32	16143	8	46	24	16097	16175	0.19038629407431032
M1	cpdb	0	network_modules	27	TRUE	3.6409511672959435e-10	58	54	9	0.16666666666666666	0.15517241379310345	GO:0031113	GO:BP	regulation of microtubule polymerization	16175	7038		0.39344262295081966	0.4032258064516129	58	16117	9	45	49	16072	16175	0.1579036406057389
M1	cpdb	0	network_modules	27	TRUE	4.0033825080383943e-10	88	54	10	0.18518518518518517	0.11363636363636363	GO:0031110	GO:BP	regulation of microtubule polymerization or depolymerization	16175	7035		0.4098360655737705	0.41935483870967744	88	16087	10	44	78	16043	16175	0.14142376147518326
M1	cpdb	0	network_modules	27	TRUE	7.72928067911492e-10	39	54	8	0.14814814814814814	0.20512820512820512	GO:1905515	GO:BP	non-motile cilium assembly	16175	24691		0.4262295081967213	0.43548387096774194	39	16136	8	46	31	16090	16175	0.17198272213385593
M1	cpdb	0	network_modules	27	TRUE	8.497817467372568e-10	440	54	16	0.2962962962962963	0.03636363636363636	GO:0051493	GO:BP	regulation of cytoskeleton organization	16175	13748		0.4426229508196721	0.45161290322580644	440	15735	16	38	424	15697	16175	0.09573906850219528
M1	cpdb	0	network_modules	27	TRUE	4.633756002131046e-9	48	54	8	0.14814814814814814	0.16666666666666666	GO:0072698	GO:BP	protein localization to microtubule cytoskeleton	16175	17509		0.45901639344262296	0.46774193548387094	48	16127	8	46	40	16081	16175	0.154474348556893
M1	cpdb	0	network_modules	27	TRUE	6.559404440541155e-9	50	54	8	0.14814814814814814	0.16	GO:0044380	GO:BP	protein localization to cytoskeleton	16175	10982		0.47540983606557374	0.4838709677419355	50	16125	8	46	42	16079	16175	0.15123380609300552
M1	cpdb	0	network_modules	27	TRUE	2.349902751047447e-8	238	54	12	0.2222222222222222	0.05042016806722689	GO:0051258	GO:BP	protein polymerization	16175	13605		0.4918032786885246	0.5	238	15937	12	42	226	15895	16175	0.09974441539321148
M1	cpdb	0	network_modules	27	TRUE	4.0071335786062576e-8	62	54	8	0.14814814814814814	0.12903225806451613	GO:1902017	GO:BP	regulation of cilium assembly	16175	21945		0.5081967213114754	0.5161290322580645	62	16113	8	46	54	16067	16175	0.13516766876564346
M1	cpdb	0	network_modules	27	TRUE	9.735290616460054e-8	69	54	8	0.14814814814814814	0.11594202898550725	GO:1902117	GO:BP	positive regulation of organelle assembly	16175	22030		0.5245901639344263	0.532258064516129	69	16106	8	46	61	16060	16175	0.12777155390723693
M1	cpdb	0	network_modules	27	TRUE	4.109571845914247e-7	124	54	9	0.16666666666666666	0.07258064516129033	GO:0007052	GO:BP	mitotic spindle organization	16175	2651		0.5409836065573771	0.5483870967741935	124	16051	9	45	115	16006	16175	0.10550713299001004
M1	cpdb	0	network_modules	27	TRUE	2.681913987920702e-6	153	54	9	0.16666666666666666	0.058823529411764705	GO:1902850	GO:BP	microtubule cytoskeleton organization involved in mitosis	16175	22560		0.5573770491803278	0.5645161290322581	153	16022	9	45	144	15977	16175	0.09399715469668432
M1	cpdb	0	network_modules	27	TRUE	4.208912575972411e-6	161	54	9	0.16666666666666666	0.055900621118012424	GO:0032271	GO:BP	regulation of protein polymerization	16175	7452		0.5737704918032787	0.5806451612903226	161	16014	9	45	152	15969	16175	0.09136659713861844
M1	cpdb	0	network_modules	27	TRUE	8.73653069497501e-6	43	54	6	0.1111111111111111	0.13953488372093023	GO:0010824	GO:BP	regulation of centrosome duplication	16175	4434		0.5901639344262295	0.5967741935483871	43	16132	6	48	37	16084	16175	0.12190097093031564
M1	cpdb	0	network_modules	27	TRUE	1.1648746594598116e-5	8	54	4	0.07407407407407407	0.5	GO:0061511	GO:BP	centriole elongation	16175	15513		0.6065573770491803	0.6129032258064516	8	16167	4	50	4	16117	16175	0.19153237919467886
M1	cpdb	0	network_modules	27	TRUE	1.670806402946839e-5	23	54	5	0.09259259259259259	0.21739130434782608	GO:0046599	GO:BP	regulation of centriole replication	16175	12249		0.6229508196721312	0.6290322580645161	23	16152	5	49	18	16103	16175	0.14003066048366503
M1	cpdb	0	network_modules	27	TRUE	1.73630995282312e-5	48	54	6	0.1111111111111111	0.125	GO:0046605	GO:BP	regulation of centrosome cycle	16175	12255		0.639344262295082	0.6451612903225806	48	16127	6	48	42	16079	16175	0.11506638395043685
M1	cpdb	0	network_modules	27	TRUE	2.0915889592204614e-5	9	54	4	0.07407407407407407	0.4444444444444444	GO:0046601	GO:BP	positive regulation of centriole replication	16175	12251		0.6557377049180327	0.6612903225806451	9	16166	4	50	5	16116	16175	0.18043231149761452
M1	cpdb	0	network_modules	27	TRUE	1.2623284128749794e-4	318	54	10	0.18518518518518517	0.031446540880503145	GO:1902903	GO:BP	regulation of supramolecular fiber organization	16175	22602		0.6721311475409836	0.6774193548387096	318	15857	10	44	308	15813	16175	0.06900574845463196
M1	cpdb	0	network_modules	27	TRUE	1.443625233973096e-4	172	54	8	0.14814814814814814	0.046511627906976744	GO:0120032	GO:BP	regulation of plasma membrane bounded cell projection assembly	16175	19468		0.6885245901639344	0.6935483870967742	172	16003	8	46	164	15957	16175	0.07759408273331446
M1	cpdb	0	network_modules	27	TRUE	1.509776829765458e-4	173	54	8	0.14814814814814814	0.046242774566473986	GO:0060491	GO:BP	regulation of cell projection assembly	16175	14685		0.7049180327868853	0.7096774193548387	173	16002	8	46	165	15956	16175	0.07733712992397654
M1	cpdb	0	network_modules	27	TRUE	1.5909480174991665e-4	748	54	14	0.25925925925925924	0.01871657754010695	GO:0097435	GO:BP	supramolecular fiber organization	16175	18657		0.7213114754098361	0.7258064516129032	748	15427	14	40	734	15387	16175	0.05870349260590729
M1	cpdb	0	network_modules	27	TRUE	1.6168846496259233e-4	630	54	13	0.24074074074074073	0.020634920634920634	GO:0010564	GO:BP	regulation of cell cycle process	16175	4217		0.7377049180327869	0.7419354838709677	630	15545	13	41	617	15504	16175	0.06036468505276569
M1	cpdb	0	network_modules	27	TRUE	2.2324793754022678e-4	15	54	4	0.07407407407407407	0.26666666666666666	GO:0010457	GO:BP	centriole-centriole cohesion	16175	4153		0.7540983606557377	0.7580645161290323	15	16160	4	50	11	16110	16175	0.13908289166043195
M1	cpdb	0	network_modules	27	TRUE	2.580904221704361e-4	656	54	13	0.24074074074074073	0.019817073170731708	GO:1903047	GO:BP	mitotic cell cycle process	16175	22727		0.7704918032786885	0.7741935483870968	656	15519	13	41	643	15478	16175	0.0587342551181343
M1	cpdb	0	network_modules	27	TRUE	5.304201518073479e-4	5	54	3	0.05555555555555555	0.6	GO:0098535	GO:BP	de novo centriole assembly involved in multi-ciliated epithelial cell differentiation	16175	18793		0.7868852459016393	0.7903225806451613	5	16170	3	51	2	16119	16175	0.18189025798365738
M1	cpdb	0	network_modules	27	TRUE	7.826621214032794e-4	20	54	4	0.07407407407407407	0.2	GO:1902018	GO:BP	negative regulation of cilium assembly	16175	21946		0.8032786885245902	0.8064516129032258	20	16155	4	50	16	16105	16175	0.1199588564001439
M1	cpdb	0	network_modules	27	TRUE	0.0010583317504518038	6	54	3	0.05555555555555555	0.5	GO:0097742	GO:BP	de novo centriole assembly	16175	18754		0.819672131147541	0.8225806451612904	6	16169	3	51	3	16118	16175	0.16586164707534398
M1	cpdb	0	network_modules	27	TRUE	0.001419859010945228	23	54	4	0.07407407407407407	0.17391304347826086	GO:0045724	GO:BP	positive regulation of cilium assembly	16175	11566		0.8360655737704918	0.8387096774193549	23	16152	4	50	19	16102	16175	0.11158772937064303
M1	cpdb	0	network_modules	27	TRUE	0.0018477014529953864	7	54	3	0.05555555555555555	0.42857142857142855	GO:1903722	GO:BP	regulation of centriole elongation	16175	23234		0.8524590163934426	0.8709677419354839	7	16168	3	51	4	16117	16175	0.1533907576597909
M1	cpdb	0	network_modules	27	TRUE	0.0018477014529953864	7	54	3	0.05555555555555555	0.42857142857142855	GO:1905832	GO:BP	positive regulation of spindle assembly	16175	24942		0.8524590163934426	0.8709677419354839	7	16168	3	51	4	16117	16175	0.1533907576597909
M1	cpdb	0	network_modules	27	TRUE	0.002191058494396194	792	54	13	0.24074074074074073	0.016414141414141416	GO:0000278	GO:BP	mitotic cell cycle	16175	76		0.8852459016393442	0.8870967741935484	792	15383	13	41	779	15342	16175	0.05143479116983529
M1	cpdb	0	network_modules	27	TRUE	0.0026366884543916713	252	54	8	0.14814814814814814	0.031746031746031744	GO:0140014	GO:BP	mitotic nuclear division	16175	19633		0.9016393442622951	0.9032258064516129	252	15923	8	46	244	15877	16175	0.061954515985610734
M1	cpdb	0	network_modules	27	TRUE	0.0029157128079385533	346	54	9	0.16666666666666666	0.02601156069364162	GO:0043254	GO:BP	regulation of protein-containing complex assembly	16175	10588		0.9180327868852459	0.9193548387096774	346	15829	9	45	337	15784	16175	0.05811298210766676
M1	cpdb	0	network_modules	27	TRUE	0.002949333076835855	8	54	3	0.05555555555555555	0.375	GO:1903251	GO:BP	multi-ciliated epithelial cell differentiation	16175	22858		0.9344262295081968	0.9354838709677419	8	16167	3	51	5	16116	16175	0.1433274213078
M1	cpdb	0	network_modules	27	TRUE	0.0030133314615059777	178	54	7	0.12962962962962962	0.03932584269662921	GO:0000070	GO:BP	mitotic sister chromatid segregation	16175	24		0.9508196721311475	0.9516129032258065	178	15997	7	47	171	15950	16175	0.0658100326014824
M1	cpdb	0	network_modules	27	TRUE	0.0046197677101464255	68	54	5	0.09259259259259259	0.07352941176470588	GO:0090307	GO:BP	mitotic spindle assembly	16175	18189		0.9672131147540983	0.967741935483871	68	16107	5	49	63	16058	16175	0.07906413467901197
M1	cpdb	0	network_modules	27	TRUE	0.004946407729963901	31	54	4	0.07407407407407407	0.12903225806451613	GO:0090169	GO:BP	regulation of spindle assembly	16175	18077		0.9836065573770492	0.9838709677419355	31	16144	4	50	27	16094	16175	0.09548616581071
M1	cpdb	0	network_modules	27	TRUE	0.00872047454845882	209	54	7	0.12962962962962962	0.03349282296650718	GO:0090068	GO:BP	positive regulation of cell cycle process	16175	17994		1	1	209	15966	7	47	202	15919	16175	0.05981034320716455
M1	cpdb	0	network_modules	28	TRUE	1.7140677199579608e-14	132	24	12	0.5	0.09090909090909091	KEGG:05322	KEGG	Systemic lupus erythematosus	8484	484		0	0.2	132	8352	12	12	120	8340	8484	0.20848751492532225
M1	cpdb	0	network_modules	28	TRUE	8.660750191308366e-14	72	25	10	0.4	0.1388888888888889	REAC:R-HSA-2299718	REAC	Condensation of Prophase Chromosomes	10916	395		0	0.011111111111111112	72	10844	10	15	62	10829	10916	0.2328507369644331
M1	cpdb	0	network_modules	28	TRUE	3.4248376778603623e-13	51	25	9	0.36	0.17647058823529413	REAC:R-HSA-171306	REAC	Packaging Of Telomere Ends	10916	1712		0.011235955056179775	0.022222222222222223	51	10865	9	16	42	10849	10916	0.249648568544405
M1	cpdb	0	network_modules	28	TRUE	5.619354831311238e-13	86	25	10	0.4	0.11627906976744186	REAC:R-HSA-912446	REAC	Meiotic recombination	10916	1411		0.02247191011235955	0.03333333333333333	86	10830	10	15	76	10815	10916	0.2124990666048305
M1	cpdb	0	network_modules	28	TRUE	5.9628358734332e-13	54	25	9	0.36	0.16666666666666666	REAC:R-HSA-73927	REAC	Depurination	10916	731		0.033707865168539325	0.06666666666666667	54	10862	9	16	45	10846	10916	0.24246062617057207
M1	cpdb	0	network_modules	28	TRUE	5.9628358734332e-13	54	25	9	0.36	0.16666666666666666	REAC:R-HSA-110330	REAC	Recognition and association of DNA glycosylase with site containing an affected purine	10916	1946		0.033707865168539325	0.06666666666666667	54	10862	9	16	45	10846	10916	0.24246062617057207
M1	cpdb	0	network_modules	28	TRUE	5.9628358734332e-13	54	25	9	0.36	0.16666666666666666	REAC:R-HSA-110331	REAC	Cleavage of the damaged purine	10916	373		0.033707865168539325	0.06666666666666667	54	10862	9	16	45	10846	10916	0.24246062617057207
M1	cpdb	0	network_modules	28	TRUE	9.033012008236268e-13	90	25	10	0.4	0.1111111111111111	REAC:R-HSA-201722	REAC	Formation of the beta-catenin:TCF transactivating complex	10916	968		0.06741573033707865	0.07777777777777778	90	10826	10	15	80	10811	10916	0.20756741659888417
M1	cpdb	0	network_modules	28	TRUE	1.2154435870729474e-12	187	24	12	0.5	0.06417112299465241	KEGG:05034	KEGG	Alcoholism	8484	422		0.25	0.4	187	8297	12	12	175	8285	8484	0.17339235674840994
M1	cpdb	0	network_modules	28	TRUE	1.296586509212448e-12	188	24	12	0.5	0.06382978723404255	KEGG:04613	KEGG	Neutrophil extracellular trap formation	8484	323		0.5	0.6	188	8296	12	12	176	8284	8484	0.17289836537810652
M1	cpdb	0	network_modules	28	TRUE	1.3996426721262994e-12	59	25	9	0.36	0.15254237288135594	REAC:R-HSA-110329	REAC	Cleavage of the damaged pyrimidine 	10916	374		0.07865168539325842	0.1111111111111111	59	10857	9	16	50	10841	10916	0.2317135575212703
M1	cpdb	0	network_modules	28	TRUE	1.3996426721262994e-12	59	25	9	0.36	0.15254237288135594	REAC:R-HSA-110328	REAC	Recognition and association of DNA glycosylase with site containing an affected pyrimidine	10916	1947		0.07865168539325842	0.1111111111111111	59	10857	9	16	50	10841	10916	0.2317135575212703
M1	cpdb	0	network_modules	28	TRUE	1.3996426721262994e-12	59	25	9	0.36	0.15254237288135594	REAC:R-HSA-73928	REAC	Depyrimidination	10916	732		0.07865168539325842	0.1111111111111111	59	10857	9	16	50	10841	10916	0.2317135575212703
M1	cpdb	0	network_modules	28	TRUE	1.6444568364753735e-12	60	25	9	0.36	0.15	REAC:R-HSA-73929	REAC	Base-Excision Repair, AP Site Formation	10916	206		0.11235955056179775	0.12222222222222222	60	10856	9	16	51	10840	10916	0.22972571610446987
M1	cpdb	0	network_modules	28	TRUE	2.2506767686740103e-12	62	25	9	0.36	0.14516129032258066	REAC:R-HSA-73728	REAC	RNA Polymerase I Promoter Opening	10916	1883		0.12359550561797752	0.13333333333333333	62	10854	9	16	53	10838	10916	0.22589410084503792
M1	cpdb	0	network_modules	28	TRUE	3.047371343305408e-12	64	25	9	0.36	0.140625	REAC:R-HSA-5334118	REAC	DNA methylation	10916	447		0.1348314606741573	0.14444444444444443	64	10852	9	16	55	10836	10916	0.22224199849673162
M1	cpdb	0	network_modules	28	TRUE	4.08477184738617e-12	66	25	9	0.36	0.13636363636363635	REAC:R-HSA-5625886	REAC	Activated PKN1 stimulates transcription of AR (androgen receptor) regulated genes KLK2 and KLK3	10916	68		0.14606741573033707	0.16666666666666666	66	10850	9	16	57	10834	10916	0.21875572645673763
M1	cpdb	0	network_modules	28	TRUE	4.08477184738617e-12	66	25	9	0.36	0.13636363636363635	REAC:R-HSA-9670095	REAC	Inhibition of DNA recombination at telomere	10916	1189		0.14606741573033707	0.16666666666666666	66	10850	9	16	57	10834	10916	0.21875572645673763
M1	cpdb	0	network_modules	28	TRUE	4.712361082295592e-12	67	25	9	0.36	0.13432835820895522	REAC:R-HSA-427359	REAC	SIRT1 negatively regulates rRNA expression	10916	2142		0.16853932584269662	0.17777777777777778	67	10849	9	16	58	10833	10916	0.21707089399603852
M1	cpdb	0	network_modules	28	TRUE	5.423996100095946e-12	68	25	9	0.36	0.1323529411764706	REAC:R-HSA-68616	REAC	Assembly of the ORC complex at the origin of replication	10916	178		0.1797752808988764	0.18888888888888888	68	10848	9	16	59	10832	10916	0.21542302028889362
M1	cpdb	0	network_modules	28	TRUE	7.138929722055274e-12	70	25	9	0.36	0.12857142857142856	REAC:R-HSA-9821002	REAC	Chromatin modifications during the maternal to zygotic transition (MZT)	10916	354		0.19101123595505617	0.2	70	10846	9	16	61	10830	10916	0.2122328501122006
M1	cpdb	0	network_modules	28	TRUE	9.31835483682655e-12	72	25	9	0.36	0.125	REAC:R-HSA-9710421	REAC	Defective pyroptosis	10916	702		0.20224719101123595	0.2222222222222222	72	10844	9	16	63	10828	10916	0.20917526523656654
M1	cpdb	0	network_modules	28	TRUE	9.31835483682655e-12	72	25	9	0.36	0.125	REAC:R-HSA-212300	REAC	PRC2 methylates histones and DNA	10916	1701		0.20224719101123595	0.2222222222222222	72	10844	9	16	63	10828	10916	0.20917526523656654
M1	cpdb	0	network_modules	28	TRUE	1.246542936864142e-11	116	25	10	0.4	0.08620689655172414	REAC:R-HSA-1500620	REAC	Meiosis	10916	1410		0.2247191011235955	0.23333333333333334	116	10800	10	15	106	10785	10916	0.18193868685494918
M1	cpdb	0	network_modules	28	TRUE	1.369584446071209e-11	75	25	9	0.36	0.12	REAC:R-HSA-427389	REAC	ERCC6 (CSB) and EHMT2 (G9a) positively regulate rRNA expression	10916	827		0.23595505617977527	0.24444444444444444	75	10841	9	16	66	10825	10916	0.20481802080980702
M1	cpdb	0	network_modules	28	TRUE	1.5514978880149005e-11	76	25	9	0.36	0.11842105263157894	REAC:R-HSA-1221632	REAC	Meiotic synapsis	10916	1412		0.24719101123595505	0.25555555555555554	76	10840	9	16	67	10824	10916	0.20342267114855925
M1	cpdb	0	network_modules	28	TRUE	2.2324311508561236e-11	79	25	9	0.36	0.11392405063291139	REAC:R-HSA-2559586	REAC	DNA Damage/Telomere Stress Induced Senescence	10916	441		0.25842696629213485	0.26666666666666666	79	10837	9	16	70	10821	10916	0.199395106096835
M1	cpdb	0	network_modules	28	TRUE	5.447106845614537e-11	134	25	10	0.4	0.07462686567164178	REAC:R-HSA-68875	REAC	Mitotic Prophase	10916	1485		0.2696629213483146	0.2777777777777778	134	10782	10	15	124	10767	10916	0.16870220852945517
M1	cpdb	0	network_modules	28	TRUE	6.123789582656539e-11	88	25	9	0.36	0.10227272727272728	REAC:R-HSA-73884	REAC	Base Excision Repair	10916	205		0.2808988764044944	0.3	88	10828	9	16	79	10812	10916	0.1885605759681072
M1	cpdb	0	network_modules	28	TRUE	6.123789582656539e-11	88	25	9	0.36	0.10227272727272728	REAC:R-HSA-9616222	REAC	Transcriptional regulation of granulopoiesis	10916	2559		0.2808988764044944	0.3	88	10828	9	16	79	10812	10916	0.1885605759681072
M1	cpdb	0	network_modules	28	TRUE	6.803671523979145e-11	89	25	9	0.36	0.10112359550561797	REAC:R-HSA-5250924	REAC	B-WICH complex positively regulates rRNA expression	10916	198		0.30337078651685395	0.3111111111111111	89	10827	9	16	80	10811	10916	0.1874581054833354
M1	cpdb	0	network_modules	28	TRUE	7.54959834663441e-11	90	25	9	0.36	0.1	REAC:R-HSA-73772	REAC	RNA Polymerase I Promoter Escape	10916	1882		0.3146067415730337	0.32222222222222224	90	10826	9	16	81	10810	10916	0.18637383396308377
M1	cpdb	0	network_modules	28	TRUE	9.262048210027644e-11	92	25	9	0.36	0.09782608695652174	REAC:R-HSA-1912408	REAC	Pre-NOTCH Transcription and Translation	10916	1786		0.3258426966292135	0.3333333333333333	92	10824	9	16	83	10808	10916	0.18425790622703003
M1	cpdb	0	network_modules	28	TRUE	1.0240793213262275e-10	93	25	9	0.36	0.0967741935483871	REAC:R-HSA-5625740	REAC	RHO GTPases activate PKNs	10916	1857		0.33707865168539325	0.34444444444444444	93	10823	9	16	84	10807	10916	0.18322530594325315
M1	cpdb	0	network_modules	28	TRUE	1.1310072302180881e-10	94	25	9	0.36	0.09574468085106383	REAC:R-HSA-3214815	REAC	HDACs deacetylate histones	10916	1092		0.34831460674157305	0.35555555555555557	94	10822	9	16	85	10806	10916	0.18220901469375428
M1	cpdb	0	network_modules	28	TRUE	1.247709125633137e-10	95	25	9	0.36	0.09473684210526316	REAC:R-HSA-8936459	REAC	RUNX1 regulates genes involved in megakaryocyte differentiation and platelet function	10916	1919		0.3595505617977528	0.36666666666666664	95	10821	9	16	86	10805	10916	0.18120860322510818
M1	cpdb	0	network_modules	28	TRUE	2.234458078246158e-10	154	25	10	0.4	0.06493506493506493	REAC:R-HSA-1474165	REAC	Reproduction	10916	2064		0.3707865168539326	0.37777777777777777	154	10762	10	15	144	10747	10916	0.15676852606681738
M1	cpdb	0	network_modules	28	TRUE	2.409634132890778e-10	102	25	9	0.36	0.08823529411764706	REAC:R-HSA-5578749	REAC	Transcriptional regulation by small RNAs	10916	2555		0.38202247191011235	0.3888888888888889	102	10814	9	16	93	10798	10916	0.17461741574182332
M1	cpdb	0	network_modules	28	TRUE	2.636835093931962e-10	103	25	9	0.36	0.08737864077669903	REAC:R-HSA-9645723	REAC	Diseases of programmed cell death	10916	771		0.39325842696629215	0.4	103	10813	9	16	94	10797	10916	0.17373032705344565
M1	cpdb	0	network_modules	28	TRUE	2.882804267456295e-10	104	25	9	0.36	0.08653846153846154	REAC:R-HSA-5250913	REAC	Positive epigenetic regulation of rRNA expression	10916	1771		0.4044943820224719	0.4111111111111111	104	10812	9	16	95	10796	10916	0.17285588072948088
M1	cpdb	0	network_modules	28	TRUE	3.1488765449087817e-10	105	25	9	0.36	0.08571428571428572	REAC:R-HSA-427413	REAC	NoRC negatively regulates rRNA expression	10916	1602		0.4157303370786517	0.4222222222222222	105	10811	9	16	96	10795	10916	0.17199377586843803
M1	cpdb	0	network_modules	28	TRUE	4.082282169585921e-10	108	25	9	0.36	0.08333333333333333	REAC:R-HSA-1912422	REAC	Pre-NOTCH Expression and Processing	10916	1783		0.42696629213483145	0.4444444444444444	108	10808	9	16	99	10792	10916	0.16947864776141625
M1	cpdb	0	network_modules	28	TRUE	4.082282169585921e-10	108	25	9	0.36	0.08333333333333333	REAC:R-HSA-5250941	REAC	Negative epigenetic regulation of rRNA expression	10916	1566		0.42696629213483145	0.4444444444444444	108	10808	9	16	99	10792	10916	0.16947864776141625
M1	cpdb	0	network_modules	28	TRUE	4.443771996554066e-10	109	25	9	0.36	0.08256880733944955	REAC:R-HSA-73854	REAC	RNA Polymerase I Promoter Clearance	10916	1881		0.449438202247191	0.45555555555555555	109	10807	9	16	100	10791	10916	0.1686630925203365
M1	cpdb	0	network_modules	28	TRUE	4.833317095931945e-10	110	25	9	0.36	0.08181818181818182	REAC:R-HSA-73864	REAC	RNA Polymerase I Transcription	10916	1884		0.4606741573033708	0.4666666666666667	110	10806	9	16	101	10790	10916	0.16785851537337396
M1	cpdb	0	network_modules	28	TRUE	5.252792730793151e-10	111	25	9	0.36	0.08108108108108109	REAC:R-HSA-157579	REAC	Telomere Maintenance	10916	2489		0.47191011235955055	0.4888888888888889	111	10805	9	16	102	10789	10916	0.16706466922492053
M1	cpdb	0	network_modules	28	TRUE	5.252792730793151e-10	111	25	9	0.36	0.08108108108108109	REAC:R-HSA-2559582	REAC	Senescence-Associated Secretory Phenotype (SASP)	10916	2194		0.47191011235955055	0.4888888888888889	111	10805	9	16	102	10789	10916	0.16706466922492053
M1	cpdb	0	network_modules	28	TRUE	6.189568629707466e-10	113	25	9	0.36	0.07964601769911504	REAC:R-HSA-9610379	REAC	HCMV Late Events	10916	1090		0.4943820224719101	0.5	113	10803	9	16	104	10787	10916	0.16550821987918654
M1	cpdb	0	network_modules	28	TRUE	8.362046060151338e-10	72	25	8	0.32	0.1111111111111111	REAC:R-HSA-774815	REAC	Nucleosome assembly	10916	1621		0.5056179775280899	0.5222222222222223	72	10844	8	17	64	10827	10916	0.18549979350870002
M1	cpdb	0	network_modules	28	TRUE	8.362046060151338e-10	72	25	8	0.32	0.1111111111111111	REAC:R-HSA-606279	REAC	Deposition of new CENPA-containing nucleosomes at the centromere	10916	730		0.5056179775280899	0.5222222222222223	72	10844	8	17	64	10827	10916	0.18549979350870002
M1	cpdb	0	network_modules	28	TRUE	9.94822708693338e-10	119	25	9	0.36	0.07563025210084033	REAC:R-HSA-9816359	REAC	Maternal to zygotic transition (MZT)	10916	1394		0.5280898876404494	0.5333333333333333	119	10797	9	16	110	10781	10916	0.16107297936194762
M1	cpdb	0	network_modules	28	TRUE	1.0740531222549877e-9	120	25	9	0.36	0.075	REAC:R-HSA-5617472	REAC	Activation of anterior HOX genes in hindbrain development during early embryogenesis	10916	99		0.5393258426966292	0.5555555555555556	120	10796	9	16	111	10780	10916	0.16036577300855503
M1	cpdb	0	network_modules	28	TRUE	1.0740531222549877e-9	120	25	9	0.36	0.075	REAC:R-HSA-5619507	REAC	Activation of HOX genes during differentiation	10916	84		0.5393258426966292	0.5555555555555556	120	10796	9	16	111	10780	10916	0.16036577300855503
M1	cpdb	0	network_modules	28	TRUE	1.2494474182273285e-9	122	25	9	0.36	0.07377049180327869	REAC:R-HSA-2559580	REAC	Oxidative Stress Induced Senescence	10916	1654		0.5617977528089888	0.5666666666666667	122	10794	9	16	113	10778	10916	0.15897709999158882
M1	cpdb	0	network_modules	28	TRUE	2.079806403771375e-9	129	25	9	0.36	0.06976744186046512	REAC:R-HSA-8939236	REAC	RUNX1 regulates transcription of genes involved in differentiation of HSCs	10916	1922		0.5730337078651685	0.5777777777777777	129	10787	9	16	120	10771	10916	0.15436945739553443
M1	cpdb	0	network_modules	28	TRUE	2.0812377100423166e-9	271	25	11	0.44	0.04059040590405904	REAC:R-HSA-4839726	REAC	Chromatin organization	10916	356		0.5842696629213483	0.6	271	10645	11	14	260	10631	10916	0.12784165413131937
M1	cpdb	0	network_modules	28	TRUE	2.0812377100423166e-9	271	25	11	0.44	0.04059040590405904	REAC:R-HSA-3247509	REAC	Chromatin modifying enzymes	10916	355		0.5842696629213483	0.6	271	10645	11	14	260	10631	10916	0.12784165413131937
M1	cpdb	0	network_modules	28	TRUE	2.275919185748393e-9	194	25	10	0.4	0.05154639175257732	REAC:R-HSA-2559583	REAC	Cellular Senescence	10916	331		0.6067415730337079	0.6111111111111112	194	10722	10	15	184	10707	10916	0.1386064037727147
M1	cpdb	0	network_modules	28	TRUE	2.940982967228493e-9	134	25	9	0.36	0.06716417910447761	REAC:R-HSA-211000	REAC	Gene Silencing by RNA	10916	1041		0.6179775280898876	0.6222222222222222	134	10782	9	16	125	10766	10916	0.15129786765139513
M1	cpdb	0	network_modules	28	TRUE	3.1468564276399396e-9	135	25	9	0.36	0.06666666666666667	REAC:R-HSA-9609690	REAC	HCMV Early Events	10916	1088		0.6292134831460674	0.6333333333333333	135	10781	9	16	126	10765	10916	0.150703740643517
M1	cpdb	0	network_modules	28	TRUE	3.84304470093665e-9	138	25	9	0.36	0.06521739130434782	REAC:R-HSA-73886	REAC	Chromosome Maintenance	10916	357		0.6404494382022472	0.6444444444444445	138	10778	9	16	129	10762	10916	0.14895954370002415
M1	cpdb	0	network_modules	28	TRUE	4.672096306446768e-9	141	25	9	0.36	0.06382978723404255	REAC:R-HSA-3214847	REAC	HATs acetylate histones	10916	1087		0.651685393258427	0.6555555555555556	141	10775	9	16	132	10759	10916	0.14727025039260402
M1	cpdb	0	network_modules	28	TRUE	4.981606303669488e-9	142	25	9	0.36	0.06338028169014084	REAC:R-HSA-68867	REAC	Assembly of the pre-replicative complex	10916	181		0.6629213483146067	0.6666666666666666	142	10774	9	16	133	10758	10916	0.14671885225436415
M1	cpdb	0	network_modules	28	TRUE	6.8176224915340784e-9	147	25	9	0.36	0.061224489795918366	REAC:R-HSA-9018519	REAC	Estrogen-dependent gene expression	10916	866		0.6741573033707865	0.6777777777777778	147	10769	9	16	138	10753	10916	0.144045122578621
M1	cpdb	0	network_modules	28	TRUE	1.292676554621815e-8	231	25	10	0.4	0.04329004329004329	REAC:R-HSA-201681	REAC	TCF dependent signaling in response to WNT	10916	2421		0.6853932584269663	0.6888888888888889	231	10685	10	15	221	10670	10916	0.1261131564138715
M1	cpdb	0	network_modules	28	TRUE	1.3859071328205452e-8	159	25	9	0.36	0.05660377358490566	REAC:R-HSA-9609646	REAC	HCMV Infection	10916	1089		0.6966292134831461	0.7111111111111111	159	10757	9	16	150	10741	10916	0.13814045123899826
M1	cpdb	0	network_modules	28	TRUE	1.3859071328205452e-8	159	25	9	0.36	0.05660377358490566	REAC:R-HSA-69002	REAC	DNA Replication Pre-Initiation	10916	446		0.6966292134831461	0.7111111111111111	159	10757	9	16	150	10741	10916	0.13814045123899826
M1	cpdb	0	network_modules	28	TRUE	2.7147177064358048e-8	110	25	8	0.32	0.07272727272727272	REAC:R-HSA-977225	REAC	Amyloid fiber formation	10916	145		0.7191011235955056	0.7222222222222222	110	10806	8	17	102	10789	10916	0.148670466346045
M1	cpdb	0	network_modules	28	TRUE	5.4064501952373185e-8	185	25	9	0.36	0.04864864864864865	REAC:R-HSA-212165	REAC	Epigenetic regulation of gene expression	10916	852		0.7303370786516854	0.7333333333333333	185	10731	9	16	176	10715	10916	0.12733686483067122
M1	cpdb	0	network_modules	28	TRUE	5.952668492922391e-8	187	25	9	0.36	0.0481283422459893	REAC:R-HSA-69306	REAC	DNA Replication	10916	445		0.7415730337078652	0.7444444444444445	187	10729	9	16	178	10713	10916	0.12659824313097512
M1	cpdb	0	network_modules	28	TRUE	1.6165987208804618e-7	406	25	11	0.44	0.027093596059113302	REAC:R-HSA-68886	REAC	M Phase	10916	1343		0.7528089887640449	0.7555555555555555	406	10510	11	14	395	10496	10916	0.10198402938753033
M1	cpdb	0	network_modules	28	TRUE	2.1523333905890523e-7	216	25	9	0.36	0.041666666666666664	REAC:R-HSA-8939211	REAC	ESR-mediated signaling	10916	830		0.7640449438202247	0.7666666666666667	216	10700	9	16	207	10684	10916	0.11703915972237677
M1	cpdb	0	network_modules	28	TRUE	3.9180805695551897e-7	327	25	10	0.4	0.03058103975535168	REAC:R-HSA-195721	REAC	Signaling by WNT	10916	2314		0.7752808988764045	0.7777777777777778	327	10589	10	15	317	10574	10916	0.10400438157563185
M1	cpdb	0	network_modules	28	TRUE	4.0552774960059506e-7	232	25	9	0.36	0.03879310344827586	REAC:R-HSA-157118	REAC	Signaling by NOTCH	10916	2274		0.7865168539325843	0.7888888888888889	232	10684	9	16	223	10668	10916	0.11252885850861175
M1	cpdb	0	network_modules	28	TRUE	4.1573132779432047e-7	329	25	10	0.4	0.030395136778115502	REAC:R-HSA-73894	REAC	DNA Repair	10916	444		0.797752808988764	0.8	329	10587	10	15	319	10572	10916	0.10364622729827329
M1	cpdb	0	network_modules	28	TRUE	4.3751827333368344e-7	234	25	9	0.36	0.038461538461538464	REAC:R-HSA-8878171	REAC	Transcriptional regulation by RUNX1	10916	2552		0.8089887640449438	0.8111111111111111	234	10682	9	16	225	10666	10916	0.1119968145461006
M1	cpdb	0	network_modules	28	TRUE	2.650902413576738e-6	68	25	6	0.24	0.08823529411764706	REAC:R-HSA-5693571	REAC	Nonhomologous End-Joining (NHEJ)	10916	1605		0.8202247191011236	0.8222222222222222	68	10848	6	19	62	10829	10916	0.14235091774061834
M1	cpdb	0	network_modules	28	TRUE	2.884849478481239e-6	290	25	9	0.36	0.03103448275862069	REAC:R-HSA-9006931	REAC	Signaling by Nuclear Receptors	10916	2289		0.8314606741573034	0.8333333333333334	290	10626	9	16	281	10610	10916	0.09934018592438072
M1	cpdb	0	network_modules	28	TRUE	5.665355119187003e-6	77	25	6	0.24	0.07792207792207792	REAC:R-HSA-5693565	REAC	Recruitment and ATM-mediated phosphorylation of repair and signaling proteins at DNA double strand breaks	10916	1949		0.8426966292134831	0.8444444444444444	77	10839	6	19	71	10820	10916	0.13335680716380652
M1	cpdb	0	network_modules	28	TRUE	6.128274752969109e-6	78	25	6	0.24	0.07692307692307693	REAC:R-HSA-5693606	REAC	DNA Double Strand Break Response	10916	442		0.8539325842696629	0.8555555555555555	78	10838	6	19	72	10819	10916	0.13245320161426846
M1	cpdb	0	network_modules	28	TRUE	6.439064220790005e-6	318	25	9	0.36	0.02830188679245283	REAC:R-HSA-195258	REAC	RHO GTPase Effectors	10916	1846		0.8651685393258427	0.8666666666666667	318	10598	9	16	309	10582	10916	0.09426044628567222
M1	cpdb	0	network_modules	28	TRUE	7.0420580573817074e-6	221	25	8	0.32	0.03619909502262444	REAC:R-HSA-5689880	REAC	Ub-specific processing proteases	10916	2617		0.8764044943820225	0.8777777777777778	221	10695	8	17	213	10678	10916	0.10197150201405934
M1	cpdb	0	network_modules	28	TRUE	8.540409020786656e-6	529	50	13	0.26	0.024574669187145556	GO:0006325	GO:BP	chromatin organization	16175	2122		NA	1	529	15646	13	37	516	15609	16175	0.07116070005070305
M1	cpdb	0	network_modules	28	TRUE	1.165369378034441e-5	42	25	5	0.2	0.11904761904761904	REAC:R-HSA-9821993	REAC	Replacement of protamines by nucleosomes in the male pronucleus	10916	2060		0.8876404494382022	0.8888888888888888	42	10874	5	20	37	10854	10916	0.15180079656370568
M1	cpdb	0	network_modules	28	TRUE	1.896598835171677e-5	94	25	6	0.24	0.06382978723404255	REAC:R-HSA-69473	REAC	G2/M DNA damage checkpoint	10916	1006		0.898876404494382	0.9	94	10822	6	19	88	10803	10916	0.11998425805422452
M1	cpdb	0	network_modules	28	TRUE	2.2914659193749107e-5	97	25	6	0.24	0.061855670103092786	REAC:R-HSA-5693607	REAC	Processing of DNA double-strand break ends	10916	1798		0.9101123595505618	0.9111111111111111	97	10819	6	19	91	10800	10916	0.11799032733228268
M1	cpdb	0	network_modules	28	TRUE	7.139634555127704e-5	298	25	8	0.32	0.026845637583892617	REAC:R-HSA-5688426	REAC	Deubiquitination	10916	736		0.9213483146067416	0.9222222222222223	298	10618	8	17	290	10601	10916	0.0860585068233472
M1	cpdb	0	network_modules	28	TRUE	1.4405027867634625e-4	132	25	6	0.24	0.045454545454545456	REAC:R-HSA-5693567	REAC	HDR through Homologous Recombination (HRR) or Single Strand Annealing (SSA)	10916	1098		0.9325842696629213	0.9333333333333333	132	10784	6	19	126	10765	10916	0.09990372149058492
M1	cpdb	0	network_modules	28	TRUE	1.8734151247910626e-4	138	25	6	0.24	0.043478260869565216	REAC:R-HSA-5693538	REAC	Homology Directed Repair	10916	1130		0.9438202247191011	0.9444444444444444	138	10778	6	19	132	10759	10916	0.0974992494083138
M1	cpdb	0	network_modules	28	TRUE	2.7369645721549623e-4	78	25	5	0.2	0.0641025641025641	REAC:R-HSA-3214858	REAC	RMTs methylate histone arginines	10916	1878		0.9550561797752809	0.9555555555555556	78	10838	5	20	73	10818	10916	0.10970024865387198
M1	cpdb	0	network_modules	28	TRUE	5.742658177968664e-4	167	25	6	0.24	0.03592814371257485	REAC:R-HSA-69481	REAC	G2/M Checkpoints	10916	1005		0.9662921348314607	0.9666666666666667	167	10749	6	19	161	10730	10916	0.08771282085139225
M1	cpdb	0	network_modules	28	TRUE	5.946390372321649e-4	168	25	6	0.24	0.03571428571428571	REAC:R-HSA-5693532	REAC	DNA Double-Strand Break Repair	10916	443		0.9775280898876404	0.9777777777777777	168	10748	6	19	162	10729	10916	0.0874197945585325
M1	cpdb	0	network_modules	28	TRUE	9.478097114126047e-4	201	24	6	0.25	0.029850746268656716	KEGG:05203	KEGG	Viral carcinogenesis	8484	455		0.75	0.8	201	8283	6	18	195	8265	8484	0.0792555727224185
M1	cpdb	0	network_modules	28	TRUE	0.0029407983157496787	58	25	4	0.16	0.06896551724137931	REAC:R-HSA-8866654	REAC	E3 ubiquitin ligases ubiquitinate target proteins	10916	811		0.9887640449438202	0.9888888888888889	58	10858	4	21	54	10837	10916	0.10194447813426939
M1	cpdb	0	network_modules	28	TRUE	0.004112628776123844	158	24	5	0.20833333333333334	0.03164556962025317	KEGG:04217	KEGG	Necroptosis	8484	294		1	1	158	8326	5	19	153	8307	8484	0.07474199290488306
M1	cpdb	0	network_modules	28	TRUE	0.009586928754125439	78	25	4	0.16	0.05128205128205128	REAC:R-HSA-8852135	REAC	Protein ubiquitination	10916	1818		1	1	78	10838	4	21	74	10817	10916	0.08694729569347551
M1	cpdb	0	network_modules	29	TRUE	7.604707998568166e-21	170	39	19	0.48717948717948717	0.11176470588235295	KEGG:04530	KEGG	Tight junction	8484	317		0	0.2	170	8314	19	20	151	8294	8484	0.22654389689780466
M1	cpdb	0	network_modules	29	TRUE	4.2748208255609054e-19	87	43	15	0.3488372093023256	0.1724137931034483	REAC:R-HSA-421270	REAC	Cell-cell junction organization	10916	329		0	0.14285714285714285	87	10829	15	28	72	10801	10916	0.2410763144155966
M1	cpdb	0	network_modules	29	TRUE	3.170116174083536e-17	114	43	15	0.3488372093023256	0.13157894736842105	REAC:R-HSA-446728	REAC	Cell junction organization	10916	324		0.16666666666666666	0.2857142857142857	114	10802	15	28	99	10774	10916	0.20933458032353375
M1	cpdb	0	network_modules	29	TRUE	2.2629119038841132e-15	150	43	15	0.3488372093023256	0.1	REAC:R-HSA-1500931	REAC	Cell-Cell communication	10916	328		0.3333333333333333	0.42857142857142855	150	10766	15	28	135	10738	10916	0.1810170043001108
M1	cpdb	0	network_modules	29	TRUE	4.7824456613527965e-15	153	39	15	0.38461538461538464	0.09803921568627451	KEGG:04514	KEGG	Cell adhesion molecules	8484	315		0.25	0.4	153	8331	15	24	138	8307	8484	0.18720150016589196
M1	cpdb	0	network_modules	29	TRUE	4.525996796621896e-13	30	43	9	0.20930232558139536	0.3	REAC:R-HSA-420029	REAC	Tight junction interactions	10916	2510		0.5	0.5714285714285714	30	10886	9	34	21	10852	10916	0.24812013979176958
M1	cpdb	0	network_modules	29	TRUE	1.0661199614244127e-12	179	55	14	0.2545454545454545	0.0782122905027933	GO:0045216	GO:BP	cell-cell junction organization	16175	11328		0	0.027777777777777776	179	15996	14	41	165	15955	16175	0.13594786786689528
M1	cpdb	0	network_modules	29	TRUE	6.522505704706765e-12	7	43	6	0.13953488372093023	0.8571428571428571	REAC:R-HSA-420597	REAC	Nectin/Necl  trans heterodimerization	10916	1558		0.6666666666666666	0.7142857142857143	7	10909	6	37	1	10872	10916	0.3450355762111485
M1	cpdb	0	network_modules	29	TRUE	3.73810373868425e-11	69	55	10	0.18181818181818182	0.14492753623188406	GO:0120192	GO:BP	tight junction assembly	16175	19553		0.02857142857142857	0.05555555555555555	69	16106	10	45	59	16061	16175	0.15912965515827038
M1	cpdb	0	network_modules	29	TRUE	5.050345377541819e-11	71	55	10	0.18181818181818182	0.14084507042253522	GO:0120193	GO:BP	tight junction organization	16175	19554		0.05714285714285714	0.08333333333333333	71	16104	10	45	61	16059	16175	0.15677287062885015
M1	cpdb	0	network_modules	29	TRUE	6.653403657040367e-11	143	55	12	0.21818181818181817	0.08391608391608392	GO:0007043	GO:BP	cell-cell junction assembly	16175	2647		0.08571428571428572	0.1111111111111111	143	16032	12	43	131	15989	16175	0.13062778686577856
M1	cpdb	0	network_modules	29	TRUE	9.109857934794456e-11	193	55	13	0.23636363636363636	0.06735751295336788	GO:0098742	GO:BP	cell-cell adhesion via plasma-membrane adhesion molecules	16175	18867		0.11428571428571428	0.1388888888888889	193	15982	13	42	180	15940	16175	0.12073494417124997
M1	cpdb	0	network_modules	29	TRUE	2.0087239951834735e-10	33	55	8	0.14545454545454545	0.24242424242424243	GO:0035633	GO:BP	maintenance of blood-brain barrier	16175	9129		0.14285714285714285	0.16666666666666666	33	16142	8	47	25	16095	16175	0.18565220556496903
M1	cpdb	0	network_modules	29	TRUE	2.328081660951124e-10	745	55	20	0.36363636363636365	0.026845637583892617	GO:0098609	GO:BP	cell-cell adhesion	16175	18805		0.17142857142857143	0.19444444444444445	745	15430	20	35	725	15395	16175	0.08849768714305098
M1	cpdb	0	network_modules	29	TRUE	8.763889839313378e-10	39	55	8	0.14545454545454545	0.20512820512820512	GO:0045197	GO:BP	establishment or maintenance of epithelial cell apical/basal polarity	16175	11321		0.2	0.2222222222222222	39	16136	8	47	31	16089	16175	0.17036514439947825
M1	cpdb	0	network_modules	29	TRUE	2.044322179087416e-9	43	55	8	0.14545454545454545	0.18604651162790697	GO:0061245	GO:BP	establishment or maintenance of bipolar cell polarity	16175	15338		0.22857142857142856	0.2777777777777778	43	16132	8	47	35	16085	16175	0.1619873847871537
M1	cpdb	0	network_modules	29	TRUE	2.044322179087416e-9	43	55	8	0.14545454545454545	0.18604651162790697	GO:0035088	GO:BP	establishment or maintenance of apical/basal cell polarity	16175	8802		0.22857142857142856	0.2777777777777778	43	16132	8	47	35	16085	16175	0.1619873847871537
M1	cpdb	0	network_modules	29	TRUE	1.0364819241365521e-8	52	55	8	0.14545454545454545	0.15384615384615385	GO:0007157	GO:BP	heterophilic cell-cell adhesion via plasma membrane cell adhesion molecules	16175	2721		0.2857142857142857	0.3055555555555556	52	16123	8	47	44	16076	16175	0.14677070077569973
M1	cpdb	0	network_modules	29	TRUE	1.472297453616729e-8	170	55	11	0.2	0.06470588235294118	GO:0007163	GO:BP	establishment or maintenance of cell polarity	16175	2727		0.3142857142857143	0.3333333333333333	170	16005	11	44	159	15961	16175	0.10853679796267196
M1	cpdb	0	network_modules	29	TRUE	5.909637141523391e-8	64	55	8	0.14545454545454545	0.125	GO:0070830	GO:BP	bicellular tight junction assembly	16175	16327		0.34285714285714286	0.3611111111111111	64	16111	8	47	56	16064	16175	0.1316562967260379
M1	cpdb	0	network_modules	29	TRUE	1.3949621605768364e-7	71	55	8	0.14545454545454545	0.11267605633802817	GO:0043297	GO:BP	apical junction assembly	16175	10606		0.37142857142857144	0.3888888888888889	71	16104	8	47	63	16057	16175	0.12464260128333207
M1	cpdb	0	network_modules	29	TRUE	2.144303533724586e-6	346	55	12	0.21818181818181817	0.03468208092485549	GO:0034329	GO:BP	cell junction assembly	16175	8571		0.4	0.4166666666666667	346	15829	12	43	334	15786	16175	0.0794480202028171
M1	cpdb	0	network_modules	29	TRUE	2.776152455378955e-6	533	55	14	0.2545454545454545	0.02626641651031895	GO:0034330	GO:BP	cell junction organization	16175	8572		0.42857142857142855	0.4444444444444444	533	15642	14	41	519	15601	16175	0.07250870161129286
M1	cpdb	0	network_modules	29	TRUE	2.8735504548459216e-6	114	39	8	0.20512820512820512	0.07017543859649122	KEGG:04670	KEGG	Leukocyte transendothelial migration	8484	343		0.5	0.6	114	8370	8	31	106	8339	8484	0.11314100654759301
M1	cpdb	0	network_modules	29	TRUE	2.913284141233971e-6	152	55	9	0.16363636363636364	0.05921052631578947	GO:0060249	GO:BP	anatomical structure homeostasis	16175	14466		0.45714285714285713	0.5	152	16023	9	46	143	15977	16175	0.09337788138214607
M1	cpdb	0	network_modules	29	TRUE	2.913284141233971e-6	152	55	9	0.16363636363636364	0.05921052631578947	GO:0001894	GO:BP	tissue homeostasis	16175	519		0.45714285714285713	0.5	152	16023	9	46	143	15977	16175	0.09337788138214607
M1	cpdb	0	network_modules	29	TRUE	4.513937641538658e-6	109	55	8	0.14545454545454545	0.07339449541284404	GO:0030010	GO:BP	establishment of cell polarity	16175	6650		0.5142857142857142	0.5277777777777778	109	16066	8	47	101	16019	16175	0.09903797744449032
M1	cpdb	0	network_modules	29	TRUE	6.110651980194623e-6	7	55	4	0.07272727272727272	0.5714285714285714	GO:0090557	GO:BP	establishment of endothelial intestinal barrier	16175	18351		0.5428571428571428	0.5555555555555556	7	16168	4	51	3	16117	16175	0.20303515447024034
M1	cpdb	0	network_modules	29	TRUE	2.3487999541832695e-5	55	43	6	0.13953488372093023	0.10909090909090909	REAC:R-HSA-418990	REAC	Adherens junctions interactions	10916	121		0.8333333333333334	0.8571428571428571	55	10861	6	37	49	10824	10916	0.11945862050081994
M1	cpdb	0	network_modules	29	TRUE	3.4629265746713355e-5	157	39	8	0.20512820512820512	0.050955414012738856	KEGG:04390	KEGG	Hippo signaling pathway	8484	310		0.75	0.8	157	8327	8	31	149	8296	8484	0.09410304784861918
M1	cpdb	0	network_modules	29	TRUE	1.0050334834259393e-4	63	55	6	0.10909090909090909	0.09523809523809523	GO:0007156	GO:BP	homophilic cell adhesion via plasma membrane adhesion molecules	16175	2720		0.5714285714285714	0.5833333333333334	63	16112	6	49	57	16063	16175	0.09865006593817784
M1	cpdb	0	network_modules	29	TRUE	1.3335154516933852e-4	66	55	6	0.10909090909090909	0.09090909090909091	GO:1902414	GO:BP	protein localization to cell junction	16175	22265		0.6	0.6111111111111112	66	16109	6	49	60	16060	16175	0.09622097227031204
M1	cpdb	0	network_modules	29	TRUE	2.7876481267268525e-4	19	43	4	0.09302325581395349	0.21052631578947367	REAC:R-HSA-2028269	REAC	Signaling by Hippo	10916	2259		1	1	19	10897	4	39	15	10858	10916	0.1377149921788112
M1	cpdb	0	network_modules	29	TRUE	2.8623692361740645e-4	93	39	6	0.15384615384615385	0.06451612903225806	KEGG:04520	KEGG	Adherens junction	8484	316		1	1	93	8391	6	33	87	8358	8484	0.09325442421607616
M1	cpdb	0	network_modules	29	TRUE	3.335576824805613e-4	40	55	5	0.09090909090909091	0.125	GO:0061028	GO:BP	establishment of endothelial barrier	16175	15145		0.6285714285714286	0.6388888888888888	40	16135	5	50	35	16085	16175	0.10400600324324749
M1	cpdb	0	network_modules	29	TRUE	5.444700699237352e-4	5	55	3	0.05454545454545454	0.6	GO:1905605	GO:BP	positive regulation of blood-brain barrier permeability	16175	24763		0.6571428571428571	0.6666666666666666	5	16170	3	52	2	16118	16175	0.18021603985196236
M1	cpdb	0	network_modules	29	TRUE	6.114024826755252e-4	45	55	5	0.09090909090909091	0.1111111111111111	GO:0001885	GO:BP	endothelial cell development	16175	512		0.6857142857142857	0.6944444444444444	45	16130	5	50	40	16080	16175	0.09773019349372318
M1	cpdb	0	network_modules	29	TRUE	6.565137918865601e-4	19	55	4	0.07272727272727272	0.21052631578947367	GO:0150105	GO:BP	protein localization to cell-cell junction	16175	20144		0.7142857142857143	0.7222222222222222	19	16156	4	51	15	16105	16175	0.12201829053407498
M1	cpdb	0	network_modules	29	TRUE	0.0010863146655495726	6	55	3	0.05454545454545454	0.5	GO:0002860	GO:BP	positive regulation of natural killer cell mediated cytotoxicity directed against tumor cell target	16175	1370		0.7428571428571429	0.7777777777777778	6	16169	3	52	3	16117	16175	0.16433153630806108
M1	cpdb	0	network_modules	29	TRUE	0.0010863146655495726	6	55	3	0.05454545454545454	0.5	GO:0002857	GO:BP	positive regulation of natural killer cell mediated immune response to tumor cell	16175	1367		0.7428571428571429	0.7777777777777778	6	16169	3	52	3	16117	16175	0.16433153630806108
M1	cpdb	0	network_modules	29	TRUE	0.0012296624600855895	22	55	4	0.07272727272727272	0.18181818181818182	GO:0016338	GO:BP	calcium-independent cell-cell adhesion via plasma membrane cell-adhesion molecules	16175	5213		0.8	0.8055555555555556	22	16153	4	51	18	16102	16175	0.11311065743351187
M1	cpdb	0	network_modules	29	TRUE	0.0014847868208443507	23	55	4	0.07272727272727272	0.17391304347826086	GO:0045954	GO:BP	positive regulation of natural killer cell mediated cytotoxicity	16175	11746		0.8285714285714286	0.8333333333333334	23	16152	4	51	19	16101	16175	0.11053199526428753
M1	cpdb	0	network_modules	29	TRUE	0.0018964676757266105	7	55	3	0.05454545454545454	0.42857142857142855	GO:1905603	GO:BP	regulation of blood-brain barrier permeability	16175	24761		0.8571428571428571	0.8611111111111112	7	16168	3	52	4	16116	16175	0.15197251552821844
M1	cpdb	0	network_modules	29	TRUE	0.0029131918387147295	27	55	4	0.07272727272727272	0.14814814814814814	GO:0002717	GO:BP	positive regulation of natural killer cell mediated immunity	16175	1235		0.8857142857142857	0.8888888888888888	27	16148	4	51	23	16097	16175	0.10167519789021678
M1	cpdb	0	network_modules	29	TRUE	0.003027033996657966	8	55	3	0.05454545454545454	0.375	GO:0002855	GO:BP	regulation of natural killer cell mediated immune response to tumor cell	16175	1365		0.9142857142857143	0.9444444444444444	8	16167	3	52	5	16115	16175	0.14199924793309887
M1	cpdb	0	network_modules	29	TRUE	0.003027033996657966	8	55	3	0.05454545454545454	0.375	GO:0002858	GO:BP	regulation of natural killer cell mediated cytotoxicity directed against tumor cell target	16175	1368		0.9142857142857143	0.9444444444444444	8	16167	3	52	5	16115	16175	0.14199924793309887
M1	cpdb	0	network_modules	29	TRUE	0.004529607243544338	9	55	3	0.05454545454545454	0.3333333333333333	GO:0002423	GO:BP	natural killer cell mediated immune response to tumor cell	16175	946		0.9714285714285714	1	9	16166	3	52	6	16114	16175	0.133729179875842
M1	cpdb	0	network_modules	29	TRUE	0.004529607243544338	9	55	3	0.05454545454545454	0.3333333333333333	GO:0002420	GO:BP	natural killer cell mediated cytotoxicity directed against tumor cell target	16175	944		0.9714285714285714	1	9	16166	3	52	6	16114	16175	0.133729179875842
M1	cpdb	0	network_modules	30	TRUE	3.1331398272273577e-9	449	38	15	0.39473684210526316	0.0334075723830735	REAC:R-HSA-9012999	REAC	RHO GTPase cycle	10916	1847		0	0.2	449	10467	15	23	434	10444	10916	0.10523600949325888
M1	cpdb	0	network_modules	30	TRUE	2.438022845674902e-6	43	38	6	0.15789473684210525	0.13953488372093023	REAC:R-HSA-9696270	REAC	RND2 GTPase cycle	10916	1906		0.25	0.4	43	10873	6	32	37	10841	10916	0.14526710046655994
M1	cpdb	0	network_modules	30	TRUE	1.2878357044619017e-5	149	38	8	0.21052631578947367	0.053691275167785234	REAC:R-HSA-8980692	REAC	RHOA GTPase cycle	10916	1859		0.5	0.6	149	10767	8	30	141	10737	10916	0.1002846511460991
M1	cpdb	0	network_modules	30	TRUE	1.603266951165419e-4	37	50	5	0.1	0.13513513513513514	GO:0000266	GO:BP	mitochondrial fission	16175	72		0	0.5	37	16138	5	45	32	16093	16175	0.11389480702333776
M1	cpdb	0	network_modules	30	TRUE	5.186582102914966e-4	103	24	5	0.20833333333333334	0.04854368932038835	KEGG:04137	KEGG	Mitophagy - animal	8484	274		0	0.5	103	8381	5	19	98	8362	8484	0.095419625154604365
M1	cpdb	0	network_modules	30	TRUE	0.0019642967379508392	74	38	5	0.13157894736842105	0.06756756756756757	REAC:R-HSA-9013408	REAC	RHOG GTPase cycle	10916	1868		0.75	0.8	74	10842	5	33	69	10809	10916	0.08989271550708675
M1	cpdb	0	network_modules	30	TRUE	0.004742265321259507	42	38	4	0.10526315789473684	0.09523809523809523	REAC:R-HSA-9696264	REAC	RND3 GTPase cycle	10916	1907		1	1	42	10874	4	34	38	10840	10916	0.09682025679227425
M1	cpdb	0	network_modules	30	TRUE	0.0055064535597109925	168	24	5	0.20833333333333334	0.02976190476190476	KEGG:04141	KEGG	Protein processing in endoplasmic reticulum	8484	278		1	1	168	8316	5	19	163	8297	8484	0.07207635282660678
M1	cpdb	0	network_modules	30	TRUE	0.008044748704589844	808	50	12	0.24	0.01485148514851485	GO:0033365	GO:BP	protein localization to organelle	16175	8175		1	1	808	15367	12	38	796	15329	16175	0.04857790460035518
M1	cpdb	0	network_modules	31	TRUE	9.019944675077076e-103	158	57	53	0.9298245614035088	0.33544303797468356	GO:0140053	GO:BP	mitochondrial gene expression	16175	19653		0	0.2	158	16017	53	4	105	16013	16175	0.556315885315589
M1	cpdb	0	network_modules	31	TRUE	2.004086927916843e-102	127	57	51	0.8947368421052632	0.4015748031496063	GO:0032543	GO:BP	mitochondrial translation	16175	7635		0.25	0.4	127	16048	51	6	76	16042	16175	0.5975596169213002
M1	cpdb	0	network_modules	31	TRUE	1.7126064429403549e-100	87	52	48	0.9230769230769231	0.5517241379310345	REAC:R-HSA-5389840	REAC	Mitochondrial translation elongation	10916	1474		0	0.2	87	10829	48	4	39	10825	10916	0.7120137502711423
M1	cpdb	0	network_modules	31	TRUE	1.5992448628832053e-98	93	52	48	0.9230769230769231	0.5161290322580645	REAC:R-HSA-5368287	REAC	Mitochondrial translation	10916	1473		0.25	0.4	93	10823	48	4	45	10819	10916	0.6884397629953564
M1	cpdb	0	network_modules	31	TRUE	9.203003088776585e-94	87	52	46	0.8846153846153846	0.5287356321839081	REAC:R-HSA-5368286	REAC	Mitochondrial translation initiation	10916	1475		0.5	0.8	87	10829	46	6	41	10823	10916	0.6820881294228516
M1	cpdb	0	network_modules	31	TRUE	9.203003088776585e-94	87	52	46	0.8846153846153846	0.5287356321839081	REAC:R-HSA-5419276	REAC	Mitochondrial translation termination	10916	1476		0.5	0.8	87	10829	46	6	41	10823	10916	0.6820881294228516
M1	cpdb	0	network_modules	31	TRUE	5.602931702006091e-70	292	52	48	0.9230769230769231	0.1643835616438356	REAC:R-HSA-72766	REAC	Translation	10916	2565		1	1	292	10624	48	4	244	10620	10916	0.3843274800472302
M1	cpdb	0	network_modules	31	TRUE	9.8354577295662755e-68	566	57	52	0.9122807017543859	0.09187279151943463	GO:0006412	GO:BP	translation	16175	2170		0.5	0.6	566	15609	52	5	514	15604	16175	0.28390483395892824
M1	cpdb	0	network_modules	31	TRUE	3.3578086962695178e-46	153	30	28	0.9333333333333333	0.1830065359477124	KEGG:03010	KEGG	Ribosome	8484	208		NA	1	153	8331	28	2	125	8329	8484	0.409731217653785
M1	cpdb	0	network_modules	31	TRUE	5.082013325797016e-5	27	57	5	0.08771929824561403	0.18518518518518517	GO:0062125	GO:BP	regulation of mitochondrial gene expression	16175	15832		0.75	0.8	27	16148	5	52	22	16096	16175	0.1253533787163621
M1	cpdb	0	network_modules	31	TRUE	0.0020543421014574243	24	57	4	0.07017543859649122	0.16666666666666666	GO:0070129	GO:BP	regulation of mitochondrial translation	16175	15928		1	1	24	16151	4	53	20	16098	16175	0.10612675132307738
M1	cpdb	0	network_modules	32	TRUE	8.21408609996999e-17	9	51	8	0.1568627450980392	0.8888888888888888	GO:0090522	GO:BP	vesicle tethering involved in exocytosis	16175	18337		0	0.034482758620689655	9	16166	8	43	1	16123	16175	0.37277519779044976
M1	cpdb	0	network_modules	32	TRUE	1.204425764705113e-13	9	51	7	0.13725490196078433	0.7777777777777778	GO:0000301	GO:BP	retrograde transport, vesicle recycling within Golgi	16175	87		0.03571428571428571	0.06896551724137931	9	16166	7	44	2	16122	16175	0.3260124239306183
M1	cpdb	0	network_modules	32	TRUE	2.0763999368572995e-12	25	36	8	0.2222222222222222	0.32	REAC:R-HSA-264876	REAC	Insulin processing	10916	1209		0	0.08333333333333333	25	10891	8	28	17	10863	10916	0.26465791199905797
M1	cpdb	0	network_modules	32	TRUE	2.1503604352551166e-12	36	51	9	0.17647058823529413	0.25	GO:0006904	GO:BP	vesicle docking involved in exocytosis	16175	2556		0.07142857142857142	0.10344827586206896	36	16139	9	42	27	16097	16175	0.2079522267528094
M1	cpdb	0	network_modules	32	TRUE	6.834413378149312e-11	31	51	8	0.1568627450980392	0.25806451612903225	GO:0099022	GO:BP	vesicle tethering	16175	19011		0.10714285714285714	0.13793103448275862	31	16144	8	43	23	16101	16175	0.19924503653784453
M1	cpdb	0	network_modules	32	TRUE	8.449975168492177e-11	21	36	7	0.19444444444444445	0.3333333333333333	REAC:R-HSA-5620916	REAC	VxPx cargo-targeting to cilium	10916	2667		0.09090909090909091	0.16666666666666666	21	10895	7	29	14	10866	10916	0.2527286126420685
M1	cpdb	0	network_modules	32	TRUE	1.389090581155621e-10	55	51	9	0.17647058823529413	0.16363636363636364	GO:0048278	GO:BP	vesicle docking	16175	12620		0.14285714285714285	0.1724137931034483	55	16120	9	42	46	16078	16175	0.16720590594062512
M1	cpdb	0	network_modules	32	TRUE	1.6512109016652641e-10	56	51	9	0.17647058823529413	0.16071428571428573	GO:0140029	GO:BP	exocytic process	16175	19642		0.17857142857142858	0.20689655172413793	56	16119	9	42	47	16077	16175	0.16565221603949667
M1	cpdb	0	network_modules	32	TRUE	2.3149461843306096e-10	284	51	14	0.27450980392156865	0.04929577464788732	GO:0048193	GO:BP	Golgi vesicle transport	16175	12570		0.21428571428571427	0.2413793103448276	284	15891	14	37	270	15854	16175	0.11002970224453813
M1	cpdb	0	network_modules	32	TRUE	3.787872148312702e-10	72	36	9	0.25	0.125	REAC:R-HSA-1445148	REAC	Translocation of SLC2A4 (GLUT4) to the plasma membrane	10916	2578		0.18181818181818182	0.25	72	10844	9	27	63	10817	10916	0.1729686335236998
M1	cpdb	0	network_modules	32	TRUE	1.3716510679521789e-9	70	51	9	0.17647058823529413	0.12857142857142856	GO:0140056	GO:BP	organelle localization by membrane tethering	16175	19654		0.25	0.27586206896551724	70	16105	9	42	61	16063	16175	0.1474866695590996
M1	cpdb	0	network_modules	32	TRUE	1.4888959100874678e-9	44	51	8	0.1568627450980392	0.18181818181818182	GO:0090148	GO:BP	membrane fission	16175	18057		0.2857142857142857	0.3103448275862069	44	16131	8	43	36	16088	16175	0.1664402621075575
M1	cpdb	0	network_modules	32	TRUE	4.7777056797308865e-9	80	51	9	0.17647058823529413	0.1125	GO:0022406	GO:BP	membrane docking	16175	6597		0.32142857142857145	0.3448275862068966	80	16095	9	42	71	16053	16175	0.13750836767182997
M1	cpdb	0	network_modules	32	TRUE	1.6956561506951588e-8	34	51	7	0.13725490196078433	0.20588235294117646	GO:0006891	GO:BP	intra-Golgi vesicle-mediated transport	16175	2546		0.35714285714285715	0.3793103448275862	34	16141	7	44	27	16097	16175	0.16596390723858084
M1	cpdb	0	network_modules	32	TRUE	1.7978021889915503e-8	59	51	8	0.1568627450980392	0.13559322033898305	GO:0006903	GO:BP	vesicle targeting	16175	2555		0.39285714285714285	0.41379310344827586	59	16116	8	43	51	16073	16175	0.1429354759104409
M1	cpdb	0	network_modules	32	TRUE	2.6393381691239133e-8	44	36	7	0.19444444444444445	0.1590909090909091	REAC:R-HSA-6811438	REAC	Intra-Golgi traffic	10916	1263		0.2727272727272727	0.3333333333333333	44	10872	7	29	37	10843	10916	0.1728691033616951
M1	cpdb	0	network_modules	32	TRUE	5.8478152838249386e-8	49	36	7	0.19444444444444445	0.14285714285714285	REAC:R-HSA-6811440	REAC	Retrograde transport at the Trans-Golgi-Network	10916	2096		0.36363636363636365	0.4166666666666667	49	10867	7	29	42	10838	10916	0.16345552498222446
M1	cpdb	0	network_modules	32	TRUE	7.844877312798588e-8	51	36	7	0.19444444444444445	0.13725490196078433	REAC:R-HSA-5620920	REAC	Cargo trafficking to the periciliary membrane	10916	310		0.45454545454545453	0.5	51	10865	7	29	44	10836	10916	0.16007865776343858
M1	cpdb	0	network_modules	32	TRUE	1.0681890476615669e-7	88	36	8	0.2222222222222222	0.09090909090909091	REAC:R-HSA-2980736	REAC	Peptide hormone metabolism	10916	1725		0.5454545454545454	0.5833333333333334	88	10828	8	28	80	10800	10916	0.13776045519217006
M1	cpdb	0	network_modules	32	TRUE	3.020962166118283e-7	83	51	8	0.1568627450980392	0.0963855421686747	GO:0000281	GO:BP	mitotic cytokinesis	16175	79		0.42857142857142855	0.4482758620689655	83	16092	8	43	75	16049	16175	0.11943298925308693
M1	cpdb	0	network_modules	32	TRUE	2.5409185180576877e-06	108	51	8	0.1568627450980392	0.07407407407407407	GO:0061640	GO:BP	cytoskeleton-dependent cytokinesis	16175	15599		0.4642857142857143	0.4827586206896552	108	16067	8	43	100	16024	16175	0.10371522324180112
M1	cpdb	0	network_modules	32	TRUE	6.586473626475107e-6	178	51	9	0.17647058823529413	0.05056179775280899	GO:0051650	GO:BP	establishment of vesicle localization	16175	13863		0.5	0.5172413793103449	178	15997	9	42	169	15955	16175	0.08920153954215837
M1	cpdb	0	network_modules	32	TRUE	9.687490391226276e-6	186	51	9	0.17647058823529413	0.04838709677419355	GO:0051648	GO:BP	vesicle localization	16175	13861		0.5357142857142857	0.5517241379310345	186	15989	9	42	177	15947	16175	0.08702307328813519
M1	cpdb	0	network_modules	32	TRUE	1.1107853988769703e-5	102	36	7	0.19444444444444445	0.06862745098039216	REAC:R-HSA-6807878	REAC	COPI-mediated anterograde transport	10916	279		0.6363636363636364	0.6666666666666666	102	10814	7	29	95	10785	10916	0.11066602991779757
M1	cpdb	0	network_modules	32	TRUE	1.2899749620418064e-5	263	51	10	0.19607843137254902	0.03802281368821293	GO:0006887	GO:BP	exocytosis	16175	2543		0.5714285714285714	0.5862068965517241	263	15912	10	41	253	15871	16175	0.07996275513238045
M1	cpdb	0	network_modules	32	TRUE	3.8804317694938644e-5	57	51	6	0.11764705882352941	0.10526315789473684	GO:0006893	GO:BP	Golgi to plasma membrane transport	16175	2548		0.6071428571428571	0.6206896551724138	57	16118	6	45	51	16073	16175	0.10831124483273841
M1	cpdb	0	network_modules	32	TRUE	4.3103130900232105e-5	100	51	7	0.13725490196078433	0.07	GO:0006892	GO:BP	post-Golgi vesicle-mediated transport	16175	2547		0.6428571428571429	0.6551724137931034	100	16075	7	44	93	16031	16175	0.09404357862080917
M1	cpdb	0	network_modules	32	TRUE	1.14181131286225e-4	175	51	8	0.1568627450980392	0.045714285714285714	GO:0000910	GO:BP	cytokinesis	16175	243		0.6785714285714286	0.6896551724137931	175	16000	8	43	167	15957	16175	0.07939560026492753
M1	cpdb	0	network_modules	32	TRUE	1.9749779547046696e-4	155	36	7	0.19444444444444445	0.04516129032258064	REAC:R-HSA-199977	REAC	ER to Golgi Anterograde Transport	10916	823		0.7272727272727273	0.75	155	10761	7	29	148	10732	10916	0.0876337995345731
M1	cpdb	0	network_modules	32	TRUE	3.1396646639746383e-4	583	51	12	0.23529411764705882	0.02058319039451115	GO:0032940	GO:BP	secretion by cell	16175	7926		0.7142857142857143	0.7241379310344828	583	15592	12	39	571	15553	16175	0.06011847497790686
M1	cpdb	0	network_modules	32	TRUE	3.791147920789344e-4	137	51	7	0.13725490196078433	0.051094890510948905	GO:0098876	GO:BP	vesicle-mediated transport to the plasma membrane	16175	18924		0.75	0.7586206896551724	137	16038	7	44	130	15994	16175	0.07903564744207033
M1	cpdb	0	network_modules	32	TRUE	5.325260341533699e-4	144	51	7	0.13725490196078433	0.04861111111111111	GO:0007030	GO:BP	Golgi organization	16175	2635		0.7857142857142857	0.7931034482758621	144	16031	7	44	137	15987	16175	0.07684842984256735
M1	cpdb	0	network_modules	32	TRUE	6.734793018937742e-4	186	36	7	0.19444444444444445	0.03763440860215054	REAC:R-HSA-948021	REAC	Transport to the Golgi and subsequent modification	10916	2604		0.8181818181818182	0.8333333333333334	186	10730	7	29	179	10701	10916	0.0788515854617733
M1	cpdb	0	network_modules	32	TRUE	9.416677908524821e-4	646	51	12	0.23529411764705882	0.018575851393188854	GO:0140352	GO:BP	export from cell	16175	19748		0.8214285714285714	0.8275862068965517	646	15529	12	39	634	15490	16175	0.05610888039744796
M1	cpdb	0	network_modules	32	TRUE	9.891586958373632e-4	649	51	12	0.23529411764705882	0.01848998459167951	GO:0046903	GO:BP	secretion	16175	12430		0.8571428571428571	0.8620689655172413	649	15526	12	39	637	15487	16175	0.05593130485991336
M1	cpdb	0	network_modules	32	TRUE	0.0010919018833415676	200	36	7	0.19444444444444445	0.035	REAC:R-HSA-5617833	REAC	Cilium Assembly	10916	361		0.9090909090909091	0.9166666666666666	200	10716	7	29	193	10687	10916	0.0755412819726515
M1	cpdb	0	network_modules	32	TRUE	0.0011664208042554912	202	36	7	0.19444444444444445	0.034653465346534656	REAC:R-HSA-6811442	REAC	Intra-Golgi and retrograde Golgi-to-ER traffic	10916	1262		1	1	202	10714	7	29	195	10685	10916	0.07509519881023041
M1	cpdb	0	network_modules	32	TRUE	0.0026942291023340633	265	51	8	0.1568627450980392	0.03018867924528302	GO:0051301	GO:BP	cell division	16175	13632		0.8928571428571429	0.896551724137931	265	15910	8	43	257	15867	16175	0.06223686604650076
M1	cpdb	0	network_modules	32	TRUE	0.005521448341826048	204	51	7	0.13725490196078433	0.03431372549019608	GO:0070085	GO:BP	glycosylation	16175	15903		0.9285714285714286	0.9310344827586207	204	15971	7	44	197	15927	16175	0.06281729078492476
M1	cpdb	0	network_modules	32	TRUE	0.0069159150014987845	519	51	10	0.19607843137254902	0.019267822736030827	GO:0051640	GO:BP	organelle localization	16175	13853		0.9642857142857143	0.9655172413793104	519	15656	10	41	509	15615	16175	0.05233488050334485
M1	cpdb	0	network_modules	32	TRUE	0.007813447007737541	410	51	9	0.17647058823529413	0.02195121951219512	GO:0051656	GO:BP	establishment of organelle localization	16175	13869		1	1	410	15765	9	42	401	15723	16175	0.054073457882955804
M1	cpdb	0	network_modules	33	TRUE	5.555771388679809e-32	42	54	18	0.3333333333333333	0.42857142857142855	GO:0007007	GO:BP	inner mitochondrial membrane organization	16175	2619		0	0.02564102564102564	42	16133	18	36	24	16097	16175	0.37613643251356477
M1	cpdb	0	network_modules	33	TRUE	4.318046698717444e-29	364	54	28	0.5185185185185185	0.07692307692307693	GO:0007005	GO:BP	mitochondrion organization	16175	2617		0.02631578947368421	0.05128205128205128	364	15811	28	26	336	15785	16175	0.19355719814798006
M1	cpdb	0	network_modules	33	TRUE	1.1741005341194993e-28	95	54	20	0.37037037037037035	0.21052631578947367	GO:0007006	GO:BP	mitochondrial membrane organization	16175	2618		0.05263157894736842	0.07692307692307693	95	16080	20	34	75	16046	16175	0.27607968049646
M1	cpdb	0	network_modules	33	TRUE	3.398326482315322e-22	156	54	19	0.35185185185185186	0.12179487179487179	GO:0006839	GO:BP	mitochondrial transport	16175	2508		0.07894736842105263	0.10256410256410256	156	16019	19	35	137	15984	16175	0.20265368219999072
M1	cpdb	0	network_modules	33	TRUE	6.946736592863338e-21	117	54	17	0.3148148148148148	0.1452991452991453	GO:0070585	GO:BP	protein localization to mitochondrion	16175	16190		0.10526315789473684	0.1282051282051282	117	16058	17	37	100	16021	16175	0.21007125706425658
M1	cpdb	0	network_modules	33	TRUE	2.885431692157662e-20	99	54	16	0.2962962962962963	0.16161616161616163	GO:0006626	GO:BP	protein targeting to mitochondrion	16175	2340		0.13157894736842105	0.15384615384615385	99	16076	16	38	83	16038	16175	0.21532759246754943
M1	cpdb	0	network_modules	33	TRUE	1.2424640685560027e-19	65	40	14	0.35	0.2153846153846154	REAC:R-HSA-1268020	REAC	Mitochondrial protein import	10916	1468		0	0.09090909090909091	65	10851	14	26	51	10825	10916	0.271195929379069
M1	cpdb	0	network_modules	33	TRUE	1.7386856153425211e-19	110	54	16	0.2962962962962963	0.14545454545454545	GO:0072655	GO:BP	establishment of protein localization to mitochondrion	16175	17476		0.15789473684210525	0.1794871794871795	110	16065	16	38	94	16027	16175	0.2038687016881413
M1	cpdb	0	network_modules	33	TRUE	3.5909829098141846e-17	32	54	11	0.2037037037037037	0.34375	GO:0090151	GO:BP	establishment of protein localization to mitochondrial membrane	16175	18060		0.18421052631578946	0.20512820512820512	32	16143	11	43	21	16100	16175	0.26274746112703845
M1	cpdb	0	network_modules	33	TRUE	6.332151712155891e-14	158	40	14	0.35	0.08860759493670886	REAC:R-HSA-9609507	REAC	Protein localization	10916	1815		0.1	0.18181818181818182	158	10758	14	26	144	10732	10916	0.17036899982578885
M1	cpdb	0	network_modules	33	TRUE	3.2291475030897397e-13	17	54	8	0.14814814814814814	0.47058823529411764	GO:0042407	GO:BP	cristae formation	16175	10152		0.21052631578947367	0.23076923076923078	17	16158	8	46	9	16112	16175	0.2627430015214086
M1	cpdb	0	network_modules	33	TRUE	3.289945528482664e-13	31	40	9	0.225	0.2903225806451613	REAC:R-HSA-8949613	REAC	Cristae formation	10916	414		0.2	0.2727272727272727	31	10885	9	31	22	10854	10916	0.25318034318878724
M1	cpdb	0	network_modules	33	TRUE	5.644479791665015e-13	275	54	16	0.2962962962962963	0.05818181818181818	GO:0006605	GO:BP	protein targeting	16175	2322		0.23684210526315788	0.2564102564102564	275	15900	16	38	259	15862	16175	0.12503829539823172
M1	cpdb	0	network_modules	33	TRUE	3.3708655873261544e-12	373	54	17	0.3148148148148148	0.045576407506702415	GO:0072594	GO:BP	establishment of protein localization to organelle	16175	17458		0.2631578947368421	0.28205128205128205	373	15802	17	37	356	15765	16175	0.11249995621411911
M1	cpdb	0	network_modules	33	TRUE	1.4972088383469233e-11	657	54	20	0.37037037037037035	0.030441400304414	GO:0061024	GO:BP	membrane organization	16175	15141		0.2894736842105263	0.3076923076923077	657	15518	20	34	637	15484	16175	0.0966790188525382
M1	cpdb	0	network_modules	33	TRUE	4.0033825080383943e-10	88	54	10	0.18518518518518517	0.11363636363636363	GO:1990542	GO:BP	mitochondrial transmembrane transport	16175	25201		0.3157894736842105	0.3333333333333333	88	16087	10	44	78	16043	16175	0.14142376147518326
M1	cpdb	0	network_modules	33	TRUE	1.344540389783072e-9	99	54	10	0.18518518518518517	0.10101010101010101	GO:0022904	GO:BP	respiratory electron transport chain	16175	6631		0.34210526315789475	0.358974358974359	99	16076	10	44	89	16032	16175	0.1328765644744001
M1	cpdb	0	network_modules	33	TRUE	2.6544476476607255e-9	13	54	6	0.1111111111111111	0.46153846153846156	GO:0045039	GO:BP	protein insertion into mitochondrial inner membrane	16175	11242		0.3684210526315789	0.38461538461538464	13	16162	6	48	7	16114	16175	0.22528413440748307
M1	cpdb	0	network_modules	33	TRUE	2.9727573747810184e-9	107	54	10	0.18518518518518517	0.09345794392523364	GO:0022900	GO:BP	electron transport chain	16175	6630		0.39473684210526316	0.41025641025641024	107	16068	10	44	97	16024	16175	0.12749142395445415
M1	cpdb	0	network_modules	33	TRUE	7.702788307676132e-9	15	54	6	0.1111111111111111	0.4	GO:0045040	GO:BP	protein insertion into mitochondrial outer membrane	16175	11243		0.42105263157894735	0.46153846153846156	15	16160	6	48	9	16112	16175	0.20950598674909957
M1	cpdb	0	network_modules	33	TRUE	7.702788307676132e-9	15	54	6	0.1111111111111111	0.4	GO:0007008	GO:BP	outer mitochondrial membrane organization	16175	2620		0.42105263157894735	0.46153846153846156	15	16160	6	48	9	16112	16175	0.20950598674909957
M1	cpdb	0	network_modules	33	TRUE	1.2121008839091766e-8	92	40	9	0.225	0.09782608695652174	REAC:R-HSA-1592230	REAC	Mitochondrial biogenesis	10916	1464		0.3	0.36363636363636365	92	10824	9	31	83	10793	10916	0.14367242883460846
M1	cpdb	0	network_modules	33	TRUE	4.1734740165740385e-8	103	27	8	0.2962962962962963	0.07766990291262135	KEGG:04137	KEGG	Mitophagy - animal	8484	274		0	0.25	103	8381	8	19	95	8362	8484	0.1466102599054388
M1	cpdb	0	network_modules	33	TRUE	4.0434799289773376e-7	12	54	5	0.09259259259259259	0.4166666666666667	GO:0034982	GO:BP	mitochondrial protein processing	16175	8747		0.47368421052631576	0.48717948717948717	12	16163	5	49	7	16114	16175	0.19524327062855287
M1	cpdb	0	network_modules	33	TRUE	4.82783757690671e-7	239	54	11	0.2037037037037037	0.04602510460251046	GO:0090150	GO:BP	establishment of protein localization to membrane	16175	18059		0.5	0.5128205128205128	239	15936	11	43	228	15893	16175	0.090625928908986
M1	cpdb	0	network_modules	33	TRUE	7.95080463510052e-7	808	54	17	0.3148148148148148	0.02103960396039604	GO:0033365	GO:BP	protein localization to organelle	16175	8175		0.5263157894736842	0.5384615384615384	808	15367	17	37	791	15330	16175	0.070366065490135285
M1	cpdb	0	network_modules	33	TRUE	8.239037191630316e-7	188	54	10	0.18518518518518517	0.05319148936170213	GO:0045333	GO:BP	cellular respiration	16175	11360		0.5526315789473685	0.5641025641025641	188	15987	10	44	178	15943	16175	0.09372127555814566
M1	cpdb	0	network_modules	33	TRUE	8.254420179817072e-7	16	40	5	0.125	0.3125	REAC:R-HSA-8949664	REAC	Processing of SMDT1	10916	1800		0.4	0.45454545454545453	16	10900	5	35	11	10865	10916	0.19582724167269602
M1	cpdb	0	network_modules	33	TRUE	4.00691812427027e-6	38	54	6	0.1111111111111111	0.15789473684210525	GO:0017004	GO:BP	cytochrome complex assembly	16175	5266		0.5789473684210527	0.5897435897435898	38	16137	6	48	32	16089	16175	0.13002246505711368
M1	cpdb	0	network_modules	33	TRUE	5.8324363597111355e-6	19	54	5	0.09259259259259259	0.2631578947368421	GO:0006123	GO:BP	mitochondrial electron transport, cytochrome c to oxygen	16175	1981		0.6052631578947368	0.6153846153846154	19	16156	5	49	14	16107	16175	0.15446599629671684
M1	cpdb	0	network_modules	33	TRUE	6.2407750412719594e-6	23	40	5	0.125	0.21739130434782608	REAC:R-HSA-8949215	REAC	Mitochondrial calcium ion transport	10916	1465		0.5	0.5454545454545454	23	10893	5	35	18	10858	10916	0.16253556429479793
M1	cpdb	0	network_modules	33	TRUE	1.1612961370183353e-5	45	54	6	0.1111111111111111	0.13333333333333333	GO:0170036	GO:BP	import into the mitochondrion	16175	20284		0.631578947368421	0.6410256410256411	45	16130	6	48	39	16082	16175	0.11903279578835319
M1	cpdb	0	network_modules	33	TRUE	1.4000247876913565e-5	252	54	10	0.18518518518518517	0.03968253968253968	GO:0015980	GO:BP	energy derivation by oxidation of organic compounds	16175	5060		0.6578947368421053	0.6666666666666666	252	15923	10	44	242	15879	16175	0.07926338526962437
M1	cpdb	0	network_modules	33	TRUE	2.9874883876733406e-5	103	40	7	0.175	0.06796116504854369	REAC:R-HSA-611105	REAC	Respiratory electron transport	10916	2081		0.6	0.6363636363636364	103	10813	7	33	96	10780	10916	0.10385655938298945
M1	cpdb	0	network_modules	33	TRUE	3.303662412603226e-5	62	40	6	0.15	0.0967741935483871	REAC:R-HSA-9707564	REAC	Cytoprotection by HMOX1	10916	426		0.7	0.7272727272727273	62	10854	6	34	56	10820	10916	0.11646501419878591
M1	cpdb	0	network_modules	33	TRUE	1.771916337153289e-4	524	54	12	0.2222222222222222	0.022900763358778626	GO:0006886	GO:BP	intracellular protein transport	16175	2542		0.6842105263157895	0.6923076923076923	524	15651	12	42	512	15609	16175	0.06205338047992082
M1	cpdb	0	network_modules	33	TRUE	2.0594249282220327e-4	84	40	6	0.15	0.07142857142857142	REAC:R-HSA-5628897	REAC	TP53 Regulates Metabolic Genes	10916	2452		0.8	0.8181818181818182	84	10832	6	34	78	10798	10916	0.09876082935774759
M1	cpdb	0	network_modules	33	TRUE	3.076447261427237e-4	127	54	7	0.12962962962962962	0.05511811023622047	GO:0006119	GO:BP	oxidative phosphorylation	16175	1977		0.7105263157894737	0.717948717948718	127	16048	7	47	120	16001	16175	0.07985492814895807
M1	cpdb	0	network_modules	33	TRUE	3.12238234568469e-4	292	40	9	0.225	0.030821917808219176	REAC:R-HSA-1852241	REAC	Organelle biogenesis and maintenance	10916	1646		0.9	0.9090909090909091	292	10624	9	31	283	10593	10916	0.0745138948307391
M1	cpdb	0	network_modules	33	TRUE	3.6891372826285303e-4	232	27	7	0.25925925925925924	0.03017241379310345	KEGG:04714	KEGG	Thermogenesis	8484	349		0.3333333333333333	0.5	232	8252	7	20	225	8232	8484	0.08034837883431904
M1	cpdb	0	network_modules	33	TRUE	4.2597506093718844e-4	198	54	8	0.14814814814814814	0.04040404040404041	GO:0016485	GO:BP	protein processing	16175	5233		0.7368421052631579	0.7435897435897436	198	15977	8	46	190	15931	16175	0.0715330769581693
M1	cpdb	0	network_modules	33	TRUE	4.543362463834204e-4	82	54	6	0.1111111111111111	0.07317073170731707	GO:0019646	GO:BP	aerobic electron transport chain	16175	5967		0.7631578947368421	0.7692307692307693	82	16093	6	48	76	16045	16175	0.0864163370472527
M1	cpdb	0	network_modules	33	TRUE	5.403087414641538e-4	372	54	10	0.18518518518518517	0.026881720430107527	GO:0006091	GO:BP	generation of precursor metabolites and energy	16175	1954		0.7894736842105263	0.7948717948717948	372	15803	10	44	362	15759	16175	0.06262089350247559
M1	cpdb	0	network_modules	33	TRUE	6.924908619724181e-4	88	54	6	0.1111111111111111	0.06818181818181818	GO:0042773	GO:BP	ATP synthesis coupled electron transport	16175	10358		0.8157894736842105	0.8461538461538461	88	16087	6	48	82	16039	16175	0.08314201669216464
M1	cpdb	0	network_modules	33	TRUE	6.924908619724181e-4	88	54	6	0.1111111111111111	0.06818181818181818	GO:0042775	GO:BP	mitochondrial ATP synthesis coupled electron transport	16175	10360		0.8157894736842105	0.8461538461538461	88	16087	6	48	82	16039	16175	0.08314201669216464
M1	cpdb	0	network_modules	33	TRUE	0.0010396342519313308	504	54	11	0.2037037037037037	0.021825396825396824	GO:0072657	GO:BP	protein localization to membrane	16175	17478		0.868421052631579	0.8717948717948718	504	15671	11	43	493	15628	16175	0.05747549175518061
M1	cpdb	0	network_modules	33	TRUE	0.0011856464531322067	177	40	7	0.175	0.03954802259887006	REAC:R-HSA-1428517	REAC	Aerobic respiration and respiratory electron transport	10916	127		1	1	177	10739	7	33	170	10706	10916	0.07624310574145288
M1	cpdb	0	network_modules	33	TRUE	0.00123408366603804	97	54	6	0.1111111111111111	0.061855670103092786	GO:0033108	GO:BP	mitochondrial respiratory chain complex assembly	16175	8042		0.8947368421052632	0.8974358974358975	97	16078	6	48	91	16030	16175	0.07879609585004199
M1	cpdb	0	network_modules	33	TRUE	0.0016041748510523862	162	54	7	0.12962962962962962	0.043209876543209874	GO:0009060	GO:BP	aerobic respiration	16175	3236		0.9210526315789473	0.9230769230769231	162	16013	7	47	155	15966	16175	0.06952387428347609
M1	cpdb	0	network_modules	33	TRUE	0.0032427135342294375	28	54	4	0.07407407407407407	0.14285714285714285	GO:0008535	GO:BP	respiratory chain complex IV assembly	16175	3189		0.9473684210526315	0.9487179487179487	28	16147	4	50	24	16097	16175	0.10072025166801711
M1	cpdb	0	network_modules	33	TRUE	0.0035332558536882806	134	27	5	0.18518518518518517	0.03731343283582089	KEGG:00190	KEGG	Oxidative phosphorylation	8484	18		0.6666666666666666	0.75	134	8350	5	22	129	8328	8484	0.07676591433453285
M1	cpdb	0	network_modules	33	TRUE	0.0037522550407585353	29	54	4	0.07407407407407407	0.13793103448275862	GO:0008053	GO:BP	mitochondrial fusion	16175	3106		0.9736842105263158	0.9743589743589743	29	16146	4	50	25	16096	16175	0.09888694589692817
M1	cpdb	0	network_modules	33	TRUE	0.005148263269455526	594	54	11	0.2037037037037037	0.018518518518518517	GO:0051668	GO:BP	localization within membrane	16175	13880		1	1	594	15581	11	43	583	15538	16175	0.05138302882226844
M1	cpdb	0	network_modules	33	TRUE	0.009594535240448591	87	27	4	0.14814814814814814	0.04597701149425287	KEGG:04260	KEGG	Cardiac muscle contraction	8484	296		1	1	87	8397	4	23	83	8374	8484	0.07733865769980772
M1	cpdb	0	network_modules	34	TRUE	1.9643769943648309e-4	4	51	3	0.058823529411764705	0.75	GO:0006556	GO:BP	S-adenosylmethionine biosynthetic process	16175	2276		0	0.5	4	16171	3	48	1	16123	16175	0.2095154221871603
M1	cpdb	0	network_modules	34	TRUE	2.726258709446465e-4	153	25	6	0.24	0.0392156862745098	KEGG:01240	KEGG	Biosynthesis of cofactors	8484	190		0	0.25	153	8331	6	19	147	8312	8484	0.09067831262229724
M1	cpdb	0	network_modules	34	TRUE	3.3933127095245156e-4	215	40	8	0.2	0.037209302325581395	REAC:R-HSA-211859	REAC	Biological oxidations	10916	227		0	0.3333333333333333	215	10701	8	32	207	10669	10916	0.07869247625616338
M1	cpdb	0	network_modules	34	TRUE	8.078211229569186e-4	50	25	4	0.16	0.08	KEGG:00270	KEGG	Cysteine and methionine metabolism	8484	30		0.3333333333333333	0.75	50	8434	4	21	46	8413	8484	0.10945370299833476
M1	cpdb	0	network_modules	34	TRUE	8.078211229569186e-4	50	25	4	0.16	0.08	KEGG:00565	KEGG	Ether lipid metabolism	8484	89		0.3333333333333333	0.75	50	8434	4	21	46	8413	8484	0.10945370299833476
M1	cpdb	0	network_modules	34	TRUE	8.148028513602504e-4	106	40	6	0.15	0.05660377358490566	REAC:R-HSA-156580	REAC	Phase II - Conjugation of compounds	10916	1738		0.5	0.6666666666666666	106	10810	6	34	100	10776	10916	0.08675974349536
M1	cpdb	0	network_modules	34	TRUE	0.003848300822348754	74	25	4	0.16	0.05405405405405406	KEGG:01230	KEGG	Biosynthesis of amino acids	8484	188		1	1	74	8410	4	21	70	8389	8484	0.0884447797126122
M1	cpdb	0	network_modules	34	TRUE	0.00581488370373742	10	51	3	0.058823529411764705	0.3	GO:0046500	GO:BP	S-adenosylmethionine metabolic process	16175	12203		1	1	10	16165	3	48	7	16117	16175	0.13169448731767278
M1	cpdb	0	network_modules	34	TRUE	0.006158568349617164	14	40	3	0.075	0.21428571428571427	REAC:R-HSA-156581	REAC	Methylation	10916	1447		1	1	14	10902	3	37	11	10865	10916	0.1249143380394237
M1	cpdb	0	network_modules	35	TRUE	7.308289363751985e-32	270	51	27	0.5294117647058824	0.1	GO:0016197	GO:BP	endosomal transport	16175	5169		0	0.041666666666666664	270	15905	27	24	243	15881	16175	0.22507329130612028
M1	cpdb	0	network_modules	35	TRUE	7.686658555328376e-30	248	31	24	0.7741935483870968	0.0967741935483871	KEGG:04144	KEGG	Endocytosis	8484	280		NA	1	248	8236	24	7	224	8229	8484	0.26780964543180663
M1	cpdb	0	network_modules	35	TRUE	4.059598525055909e-19	94	51	15	0.29411764705882354	0.1595744680851064	GO:0042147	GO:BP	retrograde transport, endosome to Golgi	16175	9990		0.043478260869565216	0.08333333333333333	94	16081	15	36	79	16045	16175	0.2133175201903088
M1	cpdb	0	network_modules	35	TRUE	6.846257201946062e-17	130	51	15	0.29411764705882354	0.11538461538461539	GO:0016482	GO:BP	cytosolic transport	16175	5232		0.08695652173913043	0.125	130	16045	15	36	115	16009	16175	0.18019377431829414
M1	cpdb	0	network_modules	35	TRUE	1.7495445960385728e-14	79	51	12	0.23529411764705882	0.1518987341772152	GO:0032456	GO:BP	endocytic recycling	16175	7571		0.13043478260869565	0.16666666666666666	79	16096	12	39	67	16057	16175	0.1858753714880044
M1	cpdb	0	network_modules	35	TRUE	1.6678050698029507e-11	137	51	12	0.23529411764705882	0.08759124087591241	GO:0098876	GO:BP	vesicle-mediated transport to the plasma membrane	16175	18924		0.17391304347826086	0.20833333333333334	137	16038	12	39	125	15999	16175	0.13920251792981894
M1	cpdb	0	network_modules	35	TRUE	1.4529115804542978e-8	309	51	13	0.2549019607843137	0.042071197411003236	GO:0016236	GO:BP	macroautophagy	16175	5179		0.21739130434782608	0.25	309	15866	13	38	296	15828	16175	0.09687704488971126
M1	cpdb	0	network_modules	35	TRUE	4.280731132289879e-6	594	51	14	0.27450980392156865	0.02356902356902357	GO:0051668	GO:BP	localization within membrane	16175	13880		0.2608695652173913	0.2916666666666667	594	15581	14	37	580	15544	16175	0.07110321328831
M1	cpdb	0	network_modules	35	TRUE	4.390624209158621e-6	491	51	13	0.2549019607843137	0.026476578411405296	GO:0061919	GO:BP	process utilizing autophagic mechanism	16175	15723		0.30434782608695654	0.375	491	15684	13	38	478	15646	16175	0.07360885452580306
M1	cpdb	0	network_modules	35	TRUE	4.390624209158621e-6	491	51	13	0.2549019607843137	0.026476578411405296	GO:0006914	GO:BP	autophagy	16175	2563		0.30434782608695654	0.375	491	15684	13	38	478	15646	16175	0.07360885452580306
M1	cpdb	0	network_modules	35	TRUE	1.8193922044517526e-5	9	51	4	0.0784313725490196	0.4444444444444444	GO:0034498	GO:BP	early endosome to Golgi transport	16175	8665		0.391304347826087	0.4166666666666667	9	16166	4	47	5	16119	16175	0.18572410235112402
M1	cpdb	0	network_modules	35	TRUE	4.439508699421421e-5	155	51	8	0.1568627450980392	0.05161290322580645	GO:0007034	GO:BP	vacuolar transport	16175	2639		0.43478260869565216	0.4583333333333333	155	16020	8	43	147	15977	16175	0.08502366422437814
M1	cpdb	0	network_modules	35	TRUE	4.668378241202928e-5	156	51	8	0.1568627450980392	0.05128205128205128	GO:0016241	GO:BP	regulation of macroautophagy	16175	5183		0.4782608695652174	0.5	156	16019	8	43	148	15976	16175	0.08471778268602359
M1	cpdb	0	network_modules	35	TRUE	4.2056009995471296e-4	31	29	4	0.13793103448275862	0.12903225806451613	REAC:R-HSA-917729	REAC	Endosomal Sorting Complex Required For Transport (ESCRT)	10916	841		NA	1	31	10885	4	25	27	10860	10916	0.13102081673963525
M1	cpdb	0	network_modules	35	TRUE	5.381413700089134e-4	88	51	6	0.11764705882352941	0.06818181818181818	GO:0007032	GO:BP	endosome organization	16175	2637		0.5217391304347826	0.5416666666666666	88	16087	6	45	82	16042	16175	0.08578915301858295
M1	cpdb	0	network_modules	35	TRUE	9.107876772904206e-4	524	51	11	0.21568627450980393	0.02099236641221374	GO:0006886	GO:BP	intracellular protein transport	16175	2542		0.5652173913043478	0.5833333333333334	524	15651	11	40	513	15611	16175	0.058223256372955105
M1	cpdb	0	network_modules	35	TRUE	0.0024302261146682894	27	51	4	0.0784313725490196	0.14814814814814814	GO:0032511	GO:BP	late endosome to vacuole transport via multivesicular body sorting pathway	16175	7618		0.6086956521739131	0.6666666666666666	27	16148	4	47	23	16101	16175	0.10575447330422888
M1	cpdb	0	network_modules	35	TRUE	0.0024302261146682894	27	51	4	0.0784313725490196	0.14814814814814814	GO:0034315	GO:BP	regulation of Arp2/3 complex-mediated actin nucleation	16175	8569		0.6086956521739131	0.6666666666666666	27	16148	4	47	23	16101	16175	0.10575447330422888
M1	cpdb	0	network_modules	35	TRUE	0.004921984507613584	32	51	4	0.0784313725490196	0.125	GO:0036258	GO:BP	multivesicular body assembly	16175	9519		0.6956521739130435	0.7083333333333334	32	16143	4	47	28	16096	16175	0.09676548186456767
M1	cpdb	0	network_modules	35	TRUE	0.005587873007481299	33	51	4	0.0784313725490196	0.12121212121212122	GO:0051125	GO:BP	regulation of actin nucleation	16175	13509		0.7391304347826086	0.7916666666666666	33	16142	4	47	29	16095	16175	0.09521395384599497
M1	cpdb	0	network_modules	35	TRUE	0.005587873007481299	33	51	4	0.0784313725490196	0.12121212121212122	GO:0036257	GO:BP	multivesicular body organization	16175	9518		0.7391304347826086	0.7916666666666666	33	16142	4	47	29	16095	16175	0.09521395384599497
M1	cpdb	0	network_modules	35	TRUE	0.007116908320022793	35	51	4	0.0784313725490196	0.11428571428571428	GO:0043162	GO:BP	ubiquitin-dependent protein catabolic process via the multivesicular body sorting pathway	16175	10562		0.8260869565217391	0.8333333333333334	35	16140	4	47	31	16093	16175	0.09230961311748757
M1	cpdb	0	network_modules	35	TRUE	0.007278431689358282	522	51	10	0.19607843137254902	0.019157088122605363	GO:0010256	GO:BP	endomembrane system organization	16175	4029		0.8695652173913043	0.875	522	15653	10	41	512	15612	16175	0.052130251720539686
M1	cpdb	0	network_modules	35	TRUE	0.007977679040941222	11	51	3	0.058823529411764705	0.2727272727272727	GO:0007175	GO:BP	negative regulation of epidermal growth factor-activated receptor activity	16175	2738		0.9130434782608695	0.9166666666666666	11	16164	3	48	8	16116	16175	0.12543627485112757
M1	cpdb	0	network_modules	35	TRUE	0.008935373315525038	37	51	4	0.0784313725490196	0.10810810810810811	GO:0045324	GO:BP	late endosome to vacuole transport	16175	11357		0.9565217391304348	0.9583333333333334	37	16138	4	47	33	16091	16175	0.08964010070568755
M1	cpdb	0	network_modules	35	TRUE	0.009696600887435562	315	51	8	0.1568627450980392	0.025396825396825397	GO:0016050	GO:BP	vesicle organization	16175	5082		1	1	315	15860	8	43	307	15817	16175	0.05591594870177844
M1	cpdb	0	network_modules	36	TRUE	1.5335302775508174e-13	10	38	7	0.18421052631578946	0.7	REAC:R-HSA-164940	REAC	Nef mediated downregulation of MHC class I complex cell surface expression	10916	1564		0	0.058823529411764705	10	10906	7	31	3	10875	10916	0.35809424579654003
M1	cpdb	0	network_modules	36	TRUE	6.67552603721359e-13	35	38	9	0.23684210526315788	0.2571428571428571	REAC:R-HSA-432720	REAC	Lysosome Vesicle Biogenesis	10916	1341		0.0625	0.11764705882352941	35	10881	9	29	26	10852	10916	0.24425966999306736
M1	cpdb	0	network_modules	36	TRUE	7.211925000846028e-13	21	38	8	0.21052631578947367	0.38095238095238093	REAC:R-HSA-164938	REAC	Nef-mediates down modulation of cell surface receptors by recruiting them to clathrin adapters	10916	1565		0.125	0.17647058823529413	21	10895	8	30	13	10865	10916	0.28136956134120505
M1	cpdb	0	network_modules	36	TRUE	7.753406665891606e-12	27	38	8	0.21052631578947367	0.2962962962962963	REAC:R-HSA-164952	REAC	The role of Nef in HIV-1 replication and disease pathogenesis	10916	2504		0.1875	0.23529411764705882	27	10889	8	30	19	10859	10916	0.2475589624423553
M1	cpdb	0	network_modules	36	TRUE	1.2407770558664631e-11	72	38	10	0.2631578947368421	0.1388888888888889	REAC:R-HSA-199992	REAC	trans-Golgi Network Vesicle Budding	10916	2749		0.25	0.29411764705882354	72	10844	10	28	62	10816	10916	0.1873321208125808
M1	cpdb	0	network_modules	36	TRUE	1.296765559206584e-11	284	52	15	0.28846153846153844	0.0528169014084507	GO:0048193	GO:BP	Golgi vesicle transport	16175	12570		0	0.045454545454545456	284	15891	15	37	269	15854	16175	0.11713939925459357
M1	cpdb	0	network_modules	36	TRUE	3.5804606229511534e-11	131	31	11	0.3548387096774194	0.08396946564885496	KEGG:04142	KEGG	Lysosome	8484	279		0	0.3333333333333333	131	8353	11	20	120	8333	8484	0.16669720143686587
M1	cpdb	0	network_modules	36	TRUE	1.0594139708062474e-9	100	52	10	0.19230769230769232	0.1	GO:0006892	GO:BP	post-Golgi vesicle-mediated transport	16175	2547		0.047619047619047616	0.09090909090909091	100	16075	10	42	90	16033	16175	0.1348506308070411
M1	cpdb	0	network_modules	36	TRUE	3.400977987156054e-9	54	38	8	0.21052631578947367	0.14814814814814814	REAC:R-HSA-432722	REAC	Golgi Associated Vesicle Biogenesis	10916	1082		0.3125	0.35294117647058826	54	10862	8	30	46	10832	10916	0.17318437882727367
M1	cpdb	0	network_modules	36	TRUE	3.808128428211613e-8	248	31	11	0.3548387096774194	0.04435483870967742	KEGG:04144	KEGG	Endocytosis	8484	280		0.5	0.6666666666666666	248	8236	11	20	237	8216	8484	0.11705395245293267
M1	cpdb	0	network_modules	36	TRUE	5.347939973176229e-8	39	52	7	0.1346153846153846	0.1794871794871795	GO:0032438	GO:BP	melanosome organization	16175	7566		0.09523809523809523	0.18181818181818182	39	16136	7	45	32	16091	16175	0.15308696939929695
M1	cpdb	0	network_modules	36	TRUE	5.347939973176229e-8	39	52	7	0.1346153846153846	0.1794871794871795	GO:0048753	GO:BP	pigment granule organization	16175	13004		0.09523809523809523	0.18181818181818182	39	16136	7	45	32	16091	16175	0.15308696939929695
M1	cpdb	0	network_modules	36	TRUE	1.5315524249569914e-7	4	52	4	0.07692307692307693	1	GO:0110010	GO:BP	basolateral protein secretion	16175	19342		0.19047619047619047	0.22727272727272727	4	16171	4	48	0	16123	16175	0.2769381663081502
M1	cpdb	0	network_modules	36	TRUE	4.234498065968598e-7	202	38	10	0.2631578947368421	0.04950495049504951	REAC:R-HSA-6811442	REAC	Intra-Golgi and retrograde Golgi-to-ER traffic	10916	1262		0.375	0.4117647058823529	202	10714	10	28	192	10686	10916	0.1072950645431337
M1	cpdb	0	network_modules	36	TRUE	9.980827407224536e-7	58	52	7	0.1346153846153846	0.1206896551724138	GO:0033059	GO:BP	cellular pigmentation	16175	8013		0.23809523809523808	0.2727272727272727	58	16117	7	45	51	16072	16175	0.1244905435667193
M1	cpdb	0	network_modules	36	TRUE	2.8158695472492663e-6	44	38	6	0.15789473684210525	0.13636363636363635	REAC:R-HSA-8854214	REAC	TBC/RABGAPs	10916	2420		0.4375	0.47058823529411764	44	10872	6	32	38	10840	10916	0.1435280000403278
M1	cpdb	0	network_modules	36	TRUE	3.4393682731292255e-6	126	38	8	0.21052631578947367	0.06349206349206349	REAC:R-HSA-162909	REAC	Host Interactions of HIV factors	10916	1132		0.5	0.5294117647058824	126	10790	8	30	118	10760	10916	0.11010375844915546
M1	cpdb	0	network_modules	36	TRUE	5.109728427461703e-6	19	52	5	0.09615384615384616	0.2631578947368421	GO:1903232	GO:BP	melanosome assembly	16175	22844		0.2857142857142857	0.3181818181818182	19	16156	5	47	14	16109	16175	0.15747361263785006
M1	cpdb	0	network_modules	36	TRUE	1.091246373238228e-5	81	52	7	0.1346153846153846	0.08641975308641975	GO:0043473	GO:BP	pigmentation	16175	10719		0.3333333333333333	0.36363636363636365	81	16094	7	45	74	16049	16175	0.10427475657988806
M1	cpdb	0	network_modules	36	TRUE	1.2640449448650968e-5	130	52	8	0.15384615384615385	0.06153846153846154	GO:0016482	GO:BP	cytosolic transport	16175	5232		0.38095238095238093	0.4090909090909091	130	16045	8	44	122	16001	16175	0.09273976822375497
M1	cpdb	0	network_modules	36	TRUE	1.845261547692275e-5	24	52	5	0.09615384615384616	0.20833333333333334	GO:0060155	GO:BP	platelet dense granule organization	16175	14393		0.42857142857142855	0.45454545454545453	24	16151	5	47	19	16104	16175	0.13967877754323357
M1	cpdb	0	network_modules	36	TRUE	1.9123209245016523e-5	137	52	8	0.15384615384615385	0.058394160583941604	GO:0098876	GO:BP	vesicle-mediated transport to the plasma membrane	16175	18924		0.47619047619047616	0.5	137	16038	8	44	129	15994	16175	0.09009096447351529
M1	cpdb	0	network_modules	36	TRUE	4.2335973788730804e-5	57	52	6	0.11538461538461539	0.10526315789473684	GO:0006893	GO:BP	Golgi to plasma membrane transport	16175	2548		0.5238095238095238	0.5454545454545454	57	16118	6	46	51	16072	16175	0.10720311450780744
M1	cpdb	0	network_modules	36	TRUE	5.036494039739041e-5	155	52	8	0.15384615384615385	0.05161290322580645	GO:0007034	GO:BP	vacuolar transport	16175	2639		0.5714285714285714	0.5909090909090909	155	16020	8	44	147	15976	16175	0.08409734533761032
M1	cpdb	0	network_modules	36	TRUE	6.84626844771653e-5	123	38	7	0.18421052631578946	0.056910569105691054	REAC:R-HSA-2132295	REAC	MHC class II antigen presentation	10916	1371		0.5625	0.5882352941176471	123	10793	7	31	116	10762	10916	0.09684100658018445
M1	cpdb	0	network_modules	36	TRUE	8.414740650482353e-5	315	52	10	0.19230769230769232	0.031746031746031744	GO:0016050	GO:BP	vesicle organization	16175	5082		0.6190476190476191	0.6363636363636364	315	15860	10	42	305	15818	16175	0.07103024673115775
M1	cpdb	0	network_modules	36	TRUE	1.2039006888710368e-4	524	52	12	0.23076923076923078	0.022900763358778626	GO:0006886	GO:BP	intracellular protein transport	16175	2542		0.6666666666666666	0.6818181818181818	524	15651	12	40	512	15611	16175	0.06363120222902213
M1	cpdb	0	network_modules	36	TRUE	1.8336904308253747e-4	37	52	5	0.09615384615384616	0.13513513513513514	GO:0043001	GO:BP	Golgi to plasma membrane protein transport	16175	10477		0.7142857142857143	0.7272727272727273	37	16138	5	47	32	16091	16175	0.11158538566295635
M1	cpdb	0	network_modules	36	TRUE	2.247549257293212e-4	125	52	7	0.1346153846153846	0.056	GO:0007041	GO:BP	lysosomal transport	16175	2645		0.7619047619047619	0.7727272727272727	125	16050	7	45	118	16005	16175	0.08229037469091129
M1	cpdb	0	network_modules	36	TRUE	3.0808500310173094e-4	225	38	8	0.21052631578947367	0.035555555555555556	REAC:R-HSA-162906	REAC	HIV Infection	10916	1102		0.625	0.6470588235294118	225	10691	8	30	217	10661	10916	0.07900202101175448
M1	cpdb	0	network_modules	36	TRUE	3.890974399257072e-4	99	38	6	0.15789473684210525	0.06060606060606061	REAC:R-HSA-6811434	REAC	COPI-dependent Golgi-to-ER retrograde traffic	10916	277		0.6875	0.7058823529411765	99	10817	6	32	93	10785	10916	0.09278698859431159
M1	cpdb	0	network_modules	36	TRUE	4.6405506537202165e-4	102	38	6	0.15789473684210525	0.058823529411764705	REAC:R-HSA-6807878	REAC	COPI-mediated anterograde transport	10916	279		0.75	0.7647058823529411	102	10814	6	32	96	10782	10916	0.09125614107635883
M1	cpdb	0	network_modules	36	TRUE	5.770997335716118e-4	210	31	7	0.22580645161290322	0.03333333333333333	KEGG:05170	KEGG	Human immunodeficiency virus 1 infection	8484	451		1	1	210	8274	7	24	203	8250	8484	0.0783648548389534
M1	cpdb	0	network_modules	36	TRUE	0.0010542756375482415	52	52	5	0.09615384615384616	0.09615384615384616	GO:0033363	GO:BP	secretory granule organization	16175	8173		0.8095238095238095	0.8181818181818182	52	16123	5	47	47	16076	16175	0.09323875591009499
M1	cpdb	0	network_modules	36	TRUE	0.0012029169195977797	120	38	6	0.15789473684210525	0.05	REAC:R-HSA-9007101	REAC	Rab regulation of trafficking	10916	1939		0.8125	0.8235294117647058	120	10796	6	32	114	10764	10916	0.08326942314677621
M1	cpdb	0	network_modules	36	TRUE	0.0012838458574153287	533	52	11	0.21153846153846154	0.020637898686679174	GO:0006897	GO:BP	endocytosis	16175	2551		0.8571428571428571	0.8636363636363636	533	15642	11	41	522	15601	16175	0.056814816817340415
M1	cpdb	0	network_modules	36	TRUE	0.001534573662280996	56	52	5	0.09615384615384616	0.08928571428571429	GO:0061951	GO:BP	establishment of protein localization to plasma membrane	16175	15744		0.9047619047619048	0.9090909090909091	56	16119	5	47	51	16072	16175	0.08961916276841071
M1	cpdb	0	network_modules	36	TRUE	0.0021850836590603714	133	38	6	0.15789473684210525	0.045112781954887216	REAC:R-HSA-8856688	REAC	Golgi-to-ER retrograde transport	10916	1084		0.875	0.8823529411764706	133	10783	6	32	127	10751	10916	0.07850130525349622
M1	cpdb	0	network_modules	36	TRUE	0.003696656405335313	594	52	11	0.21153846153846154	0.018518518518518517	GO:0051668	GO:BP	localization within membrane	16175	13880		0.9523809523809523	0.9545454545454546	594	15581	11	41	583	15540	16175	0.05278507562764359
M1	cpdb	0	network_modules	36	TRUE	0.005217989672976685	285	52	8	0.15384615384615385	0.028070175438596492	GO:1990778	GO:BP	protein localization to cell periphery	16175	25286		1	1	285	15890	8	44	277	15846	16175	0.05880304835144337
M1	cpdb	0	network_modules	36	TRUE	0.005264405552550354	155	38	6	0.15789473684210525	0.03870967741935484	REAC:R-HSA-199977	REAC	ER to Golgi Anterograde Transport	10916	823		0.9375	0.9411764705882353	155	10761	6	32	149	10729	10916	0.07178463361857867
M1	cpdb	0	network_modules	36	TRUE	0.00882151089816948	49	38	4	0.10526315789473684	0.08163265306122448	REAC:R-HSA-6811440	REAC	Retrograde transport at the Trans-Golgi-Network	10916	2096		1	1	49	10867	4	34	45	10833	10916	0.08910003237201054
M1	cpdb	0	network_modules	37	TRUE	7.911909644439231e-33	66	51	20	0.39215686274509803	0.30303030303030304	GO:0036503	GO:BP	ERAD pathway	16175	9635		0	0.02631578947368421	66	16109	20	31	46	16078	16175	0.34237658812059907
M1	cpdb	0	network_modules	37	TRUE	6.242105623915053e-26	200	51	22	0.43137254901960786	0.11	GO:0034976	GO:BP	response to endoplasmic reticulum stress	16175	8746		0.02702702702702703	0.05263157894736842	200	15975	22	29	178	15946	16175	0.21324538800814125
M1	cpdb	0	network_modules	37	TRUE	3.159670828045071e-23	168	32	19	0.59375	0.1130952380952381	KEGG:04141	KEGG	Protein processing in endoplasmic reticulum	8484	278		NA	1	168	8316	19	13	149	8303	8484	0.2534875217385277
M1	cpdb	0	network_modules	37	TRUE	3.469049349274762e-23	28	51	13	0.2549019607843137	0.4642857142857143	GO:0030970	GO:BP	retrograde protein transport, ER to cytosol	16175	6980		0.05405405405405406	0.10526315789473684	28	16147	13	38	15	16109	16175	0.34251675438520307
M1	cpdb	0	network_modules	37	TRUE	3.469049349274762e-23	28	51	13	0.2549019607843137	0.4642857142857143	GO:1903513	GO:BP	endoplasmic reticulum to cytosol transport	16175	23063		0.05405405405405406	0.10526315789473684	28	16147	13	38	15	16109	16175	0.34251675438520307
M1	cpdb	0	network_modules	37	TRUE	1.250308115190865e-19	47	51	13	0.2549019607843137	0.2765957446808511	GO:0032527	GO:BP	protein exit from endoplasmic reticulum	16175	7621		0.10810810810810811	0.13157894736842105	47	16128	13	38	34	16090	16175	0.2632981821434611
M1	cpdb	0	network_modules	37	TRUE	3.84711621544423e-15	21	39	9	0.23076923076923078	0.42857142857142855	REAC:R-HSA-901032	REAC	ER Quality Control Compartment (ERQC)	10916	822		0	0.07142857142857142	21	10895	9	30	12	10865	10916	0.3127233300296365
M1	cpdb	0	network_modules	37	TRUE	6.408471216726902e-15	35	39	10	0.2564102564102564	0.2857142857142857	REAC:R-HSA-532668	REAC	N-glycan trimming in the ER and Calnexin/Calreticulin cycle	10916	1508		0.07692307692307693	0.14285714285714285	35	10881	10	29	25	10852	10916	0.2681904578805305
M1	cpdb	0	network_modules	37	TRUE	6.942545235714461e-15	470	51	20	0.39215686274509803	0.0425531914893617	GO:0010498	GO:BP	proteasomal protein catabolic process	16175	4177		0.13513513513513514	0.15789473684210525	470	15705	20	31	450	15674	16175	0.12157686611025283
M1	cpdb	0	network_modules	37	TRUE	4.039172386253623e-14	26	39	9	0.23076923076923078	0.34615384615384615	REAC:R-HSA-901042	REAC	Calnexin/calreticulin cycle	10916	302		0.15384615384615385	0.21428571428571427	26	10890	9	30	17	10860	10916	0.28055163505096864
M1	cpdb	0	network_modules	37	TRUE	8.097040185812803e-14	619	51	21	0.4117647058823529	0.033925686591276254	GO:1901698	GO:BP	response to nitrogen compound	16175	21651		0.16216216216216217	0.18421052631578946	619	15556	21	30	598	15526	16175	0.10949250233799888
M1	cpdb	0	network_modules	37	TRUE	7.0440614962659826e-12	673	51	20	0.39215686274509803	0.029717682020802376	GO:0051603	GO:BP	proteolysis involved in protein catabolic process	16175	13820		0.1891891891891892	0.21052631578947367	673	15502	20	31	653	15471	16175	0.09872811990269688
M1	cpdb	0	network_modules	37	TRUE	3.276179639552074e-10	524	51	17	0.3333333333333333	0.03244274809160305	GO:0006886	GO:BP	intracellular protein transport	16175	2542		0.21621621621621623	0.23684210526315788	524	15651	17	34	507	15617	16175	0.09559448428146955
M1	cpdb	0	network_modules	37	TRUE	2.6181053332901256e-9	75	51	9	0.17647058823529413	0.12	GO:1905897	GO:BP	regulation of response to endoplasmic reticulum stress	16175	24995		0.24324324324324326	0.2631578947368421	75	16100	9	42	66	16058	16175	0.14225188010657333
M1	cpdb	0	network_modules	37	TRUE	1.2216844104433914e-8	61	39	8	0.20512820512820512	0.13114754098360656	REAC:R-HSA-5678895	REAC	Defective CFTR causes cystic fibrosis	10916	505		0.23076923076923078	0.2857142857142857	61	10855	8	31	53	10824	10916	0.16028451655529025
M1	cpdb	0	network_modules	37	TRUE	4.57994343427581e-8	66	51	8	0.1568627450980392	0.12121212121212122	GO:0030968	GO:BP	endoplasmic reticulum unfolded protein response	16175	6979		0.2702702702702703	0.2894736842105263	66	16109	8	43	58	16066	16175	0.13479071547286942
M1	cpdb	0	network_modules	37	TRUE	9.316489969272588e-8	78	39	8	0.20512820512820512	0.10256410256410256	REAC:R-HSA-5619084	REAC	ABC transporter disorders	10916	7		0.3076923076923077	0.35714285714285715	78	10838	8	31	70	10807	10916	0.1407494483447028
M1	cpdb	0	network_modules	37	TRUE	2.0171872477557888e-07	79	51	8	0.1568627450980392	0.10126582278481013	GO:0034620	GO:BP	cellular response to unfolded protein	16175	8693		0.2972972972972973	0.3157894736842105	79	16096	8	43	71	16053	16175	0.12260355971622498
M1	cpdb	0	network_modules	37	TRUE	5.361717374088746e-7	13	51	5	0.09803921568627451	0.38461538461538464	GO:1904152	GO:BP	regulation of retrograde protein transport, ER to cytosol	16175	23573		0.32432432432432434	0.34210526315789475	13	16162	5	46	8	16116	16175	0.1929739270880319
M1	cpdb	0	network_modules	37	TRUE	6.978513097734657e-7	92	51	8	0.1568627450980392	0.08695652173913043	GO:0035967	GO:BP	cellular response to topologically incorrect protein	16175	9370		0.35135135135135137	0.3684210526315789	92	16083	8	43	84	16040	16175	0.11305646105825913
M1	cpdb	0	network_modules	37	TRUE	8.86612883990319e-7	103	39	8	0.20512820512820512	0.07766990291262135	REAC:R-HSA-382556	REAC	ABC-family proteins mediated transport	10916	9		0.38461538461538464	0.42857142857142855	103	10813	8	31	95	10782	10916	0.12120590142080997
M1	cpdb	0	network_modules	37	TRUE	1.028653796192836e-6	32	51	6	0.11764705882352941	0.1875	GO:1905898	GO:BP	positive regulation of response to endoplasmic reticulum stress	16175	24996		0.3783783783783784	0.39473684210526316	32	16143	6	45	26	16098	16175	0.14640021482452778
M1	cpdb	0	network_modules	37	TRUE	1.4499765993543634e-6	62	51	7	0.13725490196078433	0.11290322580645161	GO:0070972	GO:BP	protein localization to endoplasmic reticulum	16175	16407		0.40540540540540543	0.42105263157894735	62	16113	7	44	55	16069	16175	0.12143274577317408
M1	cpdb	0	network_modules	37	TRUE	1.8769086579353024e-6	104	51	8	0.1568627450980392	0.07692307692307693	GO:0006986	GO:BP	response to unfolded protein	16175	2608		0.43243243243243246	0.4473684210526316	104	16071	8	43	96	16028	16175	0.10585178355340791
M1	cpdb	0	network_modules	37	TRUE	2.172633042509211e-6	305	39	11	0.28205128205128205	0.036065573770491806	REAC:R-HSA-446203	REAC	Asparagine N-linked glycosylation	10916	169		0.46153846153846156	0.5	305	10611	11	28	294	10583	10916	0.09232855676235287
M1	cpdb	0	network_modules	37	TRUE	4.995470780707651e-6	41	51	6	0.11764705882352941	0.14634146341463414	GO:0006984	GO:BP	ER-nucleus signaling pathway	16175	2607		0.4594594594594595	0.47368421052631576	41	16134	6	45	35	16089	16175	0.1287513214112007
M1	cpdb	0	network_modules	37	TRUE	5.514803848208827e-6	119	51	8	0.1568627450980392	0.06722689075630252	GO:0035966	GO:BP	response to topologically incorrect protein	16175	9369		0.4864864864864865	0.5	119	16056	8	43	111	16013	16175	0.0983917329272723
M1	cpdb	0	network_modules	37	TRUE	1.138496934413402e-5	92	39	7	0.1794871794871795	0.07608695652173914	REAC:R-HSA-381119	REAC	Unfolded Protein Response (UPR)	10916	2624		0.5384615384615384	0.5714285714285714	92	10824	7	32	85	10792	10916	0.11204690285292694
M1	cpdb	0	network_modules	37	TRUE	1.3256072610529668e-5	437	51	12	0.23529411764705882	0.02745995423340961	GO:0080135	GO:BP	regulation of cellular response to stress	16175	17817		0.5135135135135135	0.5263157894736842	437	15738	12	39	425	15699	16175	0.07224687210988905
M1	cpdb	0	network_modules	37	TRUE	1.7251181005419784e-5	24	51	5	0.09803921568627451	0.20833333333333334	GO:0070861	GO:BP	regulation of protein exit from endoplasmic reticulum	16175	16345		0.5405405405405406	0.5526315789473685	24	16151	5	46	19	16105	16175	0.14107966522144488
M1	cpdb	0	network_modules	37	TRUE	1.8193922044517526e-5	9	51	4	0.0784313725490196	0.4444444444444444	GO:1904153	GO:BP	negative regulation of retrograde protein transport, ER to cytosol	16175	23574		0.5675675675675675	0.5789473684210527	9	16166	4	47	5	16119	16175	0.18572410235112402
M1	cpdb	0	network_modules	37	TRUE	3.0252713536684407e-5	10	51	4	0.0784313725490196	0.4	GO:0070862	GO:BP	negative regulation of protein exit from endoplasmic reticulum	16175	16346		0.5945945945945946	0.6052631578947368	10	16165	4	47	6	16118	16175	0.1760589220227307
M1	cpdb	0	network_modules	37	TRUE	5.268889397913491e-5	173	39	8	0.20512820512820512	0.046242774566473986	REAC:R-HSA-5619115	REAC	Disorders of transmembrane transporters	10916	778		0.6153846153846154	0.6428571428571429	173	10743	8	31	165	10712	10916	0.09075278165163604
M1	cpdb	0	network_modules	37	TRUE	2.2340349944304508e-4	76	51	6	0.11764705882352941	0.07894736842105263	GO:0051224	GO:BP	negative regulation of protein transport	16175	13577		0.6216216216216216	0.631578947368421	76	16099	6	45	70	16054	16175	0.09288958256581326
M1	cpdb	0	network_modules	37	TRUE	2.9185157454788505e-4	49	39	5	0.1282051282051282	0.10204081632653061	REAC:R-HSA-381070	REAC	IRE1alpha activates chaperones	10916	1160		0.6923076923076923	0.7142857142857143	49	10867	5	34	44	10833	10916	0.11081928183348595
M1	cpdb	0	network_modules	37	TRUE	4.3269531599193545e-4	18	51	4	0.0784313725490196	0.2222222222222222	GO:0006613	GO:BP	cotranslational protein targeting to membrane	16175	2328		0.6486486486486487	0.6578947368421053	18	16157	4	47	14	16110	16175	0.13042475674081702
M1	cpdb	0	network_modules	37	TRUE	5.740828375022241e-4	56	39	5	0.1282051282051282	0.08928571428571429	REAC:R-HSA-5362768	REAC	Hh mutants are degraded by ERAD	10916	1122		0.7692307692307693	0.7857142857142857	56	10860	5	34	51	10826	10916	0.10315786365725757
M1	cpdb	0	network_modules	37	TRUE	6.57175620365643e-4	91	51	6	0.11764705882352941	0.06593406593406594	GO:1904950	GO:BP	negative regulation of establishment of protein localization	16175	24240		0.6756756756756757	0.6842105263157895	91	16084	6	45	85	16039	16175	0.08423160176584542
M1	cpdb	0	network_modules	37	TRUE	6.819208192973891e-4	20	51	4	0.0784313725490196	0.2	GO:1904292	GO:BP	regulation of ERAD pathway	16175	23682		0.7027027027027027	0.7105263157894737	20	16155	4	47	16	16108	16175	0.12354156338952538
M1	cpdb	0	network_modules	37	TRUE	7.46566151047654e-4	59	39	5	0.1282051282051282	0.0847457627118644	REAC:R-HSA-5387390	REAC	Hh mutants abrogate ligand secretion	10916	1121		0.8461538461538461	0.8571428571428571	59	10857	5	34	54	10823	10916	0.10029042673317087
M1	cpdb	0	network_modules	37	TRUE	8.420976290110005e-4	313	51	9	0.17647058823529413	0.02875399361022364	GO:0051223	GO:BP	regulation of protein transport	16175	13576		0.7297297297297297	0.7368421052631579	313	15862	9	42	304	15820	16175	0.06414644426754834
M1	cpdb	0	network_modules	37	TRUE	0.0010872918162377551	53	51	5	0.09803921568627451	0.09433962264150944	GO:0042987	GO:BP	amyloid precursor protein catabolic process	16175	10471		0.7567567567567568	0.7631578947368421	53	16122	5	46	48	16076	16175	0.0932571947416076
M1	cpdb	0	network_modules	37	TRUE	0.0012126676165051878	65	39	5	0.1282051282051282	0.07692307692307693	REAC:R-HSA-5358346	REAC	Hedgehog ligand biogenesis	10916	1114		0.9230769230769231	0.9285714285714286	65	10851	5	34	60	10817	10916	0.09514820180757805
M1	cpdb	0	network_modules	37	TRUE	0.001481730938514326	24	51	4	0.0784313725490196	0.16666666666666666	GO:0090317	GO:BP	negative regulation of intracellular protein transport	16175	18197		0.7837837837837838	0.7894736842105263	24	16151	4	47	20	16104	16175	0.11243013684192836
M1	cpdb	0	network_modules	37	TRUE	0.0026195167792112508	115	51	6	0.11764705882352941	0.05217391304347826	GO:0033157	GO:BP	regulation of intracellular protein transport	16175	8067		0.8108108108108109	0.8157894736842105	115	16060	6	45	109	16015	16175	0.07399122694808397
M1	cpdb	0	network_modules	37	TRUE	0.0032736460206893433	29	51	4	0.0784313725490196	0.13793103448275862	GO:0045047	GO:BP	protein targeting to ER	16175	11246		0.8378378378378378	0.8421052631578947	29	16146	4	47	25	16099	16175	0.10188456726491349
M1	cpdb	0	network_modules	37	TRUE	0.00353968854945526	67	51	5	0.09803921568627451	0.07462686567164178	GO:0042982	GO:BP	amyloid precursor protein metabolic process	16175	10466		0.8648648648648649	0.868421052631579	67	16108	5	46	62	16062	16175	0.08222172510124238
M1	cpdb	0	network_modules	37	TRUE	0.005587873007481299	33	51	4	0.0784313725490196	0.12121212121212122	GO:0072599	GO:BP	establishment of protein localization to endoplasmic reticulum	16175	17463		0.8918918918918919	0.8947368421052632	33	16142	4	47	29	16095	16175	0.09521395384599497
M1	cpdb	0	network_modules	37	TRUE	0.0063922015200932	400	51	9	0.17647058823529413	0.0225	GO:0070201	GO:BP	regulation of establishment of protein localization	16175	15984		0.918918918918919	0.9210526315789473	400	15775	9	42	391	15733	16175	0.05495173862304442
M1	cpdb	0	network_modules	37	TRUE	0.007809499962996345	215	51	7	0.13725490196078433	0.03255813953488372	GO:0032386	GO:BP	regulation of intracellular transport	16175	7540		0.9459459459459459	0.9473684210526315	215	15960	7	44	208	15916	16175	0.060876353763465695
M1	cpdb	0	network_modules	37	TRUE	0.007977679040941222	11	51	3	0.058823529411764705	0.2727272727272727	GO:0006614	GO:BP	SRP-dependent cotranslational protein targeting to membrane	16175	2329		0.972972972972973	0.9736842105263158	11	16164	3	48	8	16116	16175	0.12543627485112757
M1	cpdb	0	network_modules	37	TRUE	0.00802606385624164	307	51	8	0.1568627450980392	0.026058631921824105	GO:0051051	GO:BP	negative regulation of transport	16175	13461		1	1	307	15868	8	43	299	15825	16175	0.05682937925156184
M1	cpdb	0	network_modules	37	TRUE	0.008545260077842395	47	39	4	0.10256410256410256	0.0851063829787234	REAC:R-HSA-381038	REAC	XBP1(S) activates chaperone genes	10916	2676		1	1	47	10869	4	35	43	10834	10916	0.0898602568678369
M1	cpdb	0	network_modules	39	TRUE	1.9254393246195423e-43	329	44	35	0.7954545454545454	0.10638297872340426	REAC:R-HSA-73894	REAC	DNA Repair	10916	444		0	0.02631578947368421	329	10587	35	9	294	10578	10916	0.2847679663472075
M1	cpdb	0	network_modules	39	TRUE	1.3502731010342568e-41	798	54	42	0.7777777777777778	0.05263157894736842	GO:0006974	GO:BP	DNA damage response	16175	2601		0	0.020833333333333332	798	15377	42	12	756	15365	16175	0.19467184020858636
M1	cpdb	0	network_modules	39	TRUE	1.7633651260335537e-41	528	54	38	0.7037037037037037	0.07196969696969698	GO:0006281	GO:BP	DNA repair	16175	2095		0.02127659574468085	0.041666666666666664	528	15647	38	16	490	15631	16175	0.21856192477690484
M1	cpdb	0	network_modules	39	TRUE	3.6013385221016015e-41	54	39	23	0.5897435897435898	0.42592592592592593	KEGG:03460	KEGG	Fanconi anemia pathway	8484	242		0	0.3333333333333333	54	8430	23	16	31	8414	8484	0.4985090114430473
M1	cpdb	0	network_modules	39	TRUE	9.781191702039618e-30	39	44	17	0.38636363636363635	0.4358974358974359	REAC:R-HSA-6783310	REAC	Fanconi Anemia Pathway	10916	932		0.02702702702702703	0.05263157894736842	39	10877	17	27	22	10850	10916	0.408140675958862
M1	cpdb	0	network_modules	39	TRUE	3.027623606938431e-25	39	54	15	0.2777777777777778	0.38461538461538464	GO:0036297	GO:BP	interstrand cross-link repair	16175	9548		0.0425531914893617	0.0625	39	16136	15	39	24	16097	16175	0.32495728270706314
M1	cpdb	0	network_modules	39	TRUE	6.091348691435126e-23	50	44	15	0.3409090909090909	0.3	REAC:R-HSA-9675135	REAC	Diseases of DNA repair	10916	758		0.05405405405405406	0.07894736842105263	50	10866	15	29	35	10837	10916	0.3168685714600188
M1	cpdb	0	network_modules	39	TRUE	1.659169977389615e-16	35	44	11	0.25	0.3142857142857143	REAC:R-HSA-9709570	REAC	Impaired BRCA2 binding to RAD51	10916	1173		0.08108108108108109	0.10526315789473684	35	10881	11	33	24	10848	10916	0.2777159226534245
M1	cpdb	0	network_modules	39	TRUE	3.3811552724512084e-16	37	44	11	0.25	0.2972972972972973	REAC:R-HSA-5685938	REAC	HDR through Single Strand Annealing (SSA)	10916	1100		0.10810810810810811	0.13157894736842105	37	10879	11	33	26	10846	10916	0.2699301036888027
M1	cpdb	0	network_modules	39	TRUE	4.0554738332089663e-16	75	44	13	0.29545454545454547	0.17333333333333334	REAC:R-HSA-9833482	REAC	PKR-mediated signaling	10916	1692		0.13513513513513514	0.15789473684210525	75	10841	13	31	62	10810	10916	0.2222500836203832
M1	cpdb	0	network_modules	39	TRUE	9.066255971109237e-16	40	44	11	0.25	0.275	REAC:R-HSA-5693616	REAC	Presynaptic phase of homologous DNA pairing and strand exchange	10916	1793		0.16216216216216217	0.18421052631578946	40	10876	11	33	29	10843	10916	0.25935691010039974
M1	cpdb	0	network_modules	39	TRUE	1.2356114032781355e-15	41	44	11	0.25	0.2682926829268293	REAC:R-HSA-9701190	REAC	Defective homologous recombination repair (HRR) due to BRCA2 loss of function	10916	698		0.1891891891891892	0.23684210526315788	41	10875	11	33	30	10842	10916	0.25609100211856584
M1	cpdb	0	network_modules	39	TRUE	1.2356114032781355e-15	41	44	11	0.25	0.2682926829268293	REAC:R-HSA-9675136	REAC	Diseases of DNA Double-Strand Break Repair	10916	757		0.1891891891891892	0.23684210526315788	41	10875	11	33	30	10842	10916	0.25609100211856584
M1	cpdb	0	network_modules	39	TRUE	1.2738069522935642e-15	114	54	14	0.25925925925925924	0.12280701754385964	GO:0000077	GO:BP	DNA damage checkpoint signaling	16175	28		0.06382978723404255	0.08333333333333333	114	16061	14	40	100	16021	16175	0.17449021714506538
M1	cpdb	0	network_modules	39	TRUE	2.237022765829866e-15	43	44	11	0.25	0.2558139534883721	REAC:R-HSA-5693579	REAC	Homologous DNA Pairing and Strand Exchange	10916	1129		0.24324324324324326	0.2631578947368421	43	10873	11	33	32	10840	10916	0.24990140792117332
M1	cpdb	0	network_modules	39	TRUE	3.850346891485903e-15	123	54	14	0.25925925925925924	0.11382113821138211	GO:0031570	GO:BP	DNA integrity checkpoint signaling	16175	7220		0.0851063829787234	0.10416666666666667	123	16052	14	40	109	16012	16175	0.16766155684539072
M1	cpdb	0	network_modules	39	TRUE	8.045207084750726e-15	68	44	12	0.2727272727272727	0.17647058823529413	REAC:R-HSA-5685942	REAC	HDR through Homologous Recombination (HRR)	10916	1097		0.2702702702702703	0.2894736842105263	68	10848	12	32	56	10816	10916	0.2154763522817454
M1	cpdb	0	network_modules	39	TRUE	4.703475412962796e-13	172	54	14	0.25925925925925924	0.08139534883720931	GO:0042770	GO:BP	signal transduction in response to DNA damage	16175	10355		0.10638297872340426	0.125	172	16003	14	40	158	15963	16175	0.1402897811586855
M1	cpdb	0	network_modules	39	TRUE	6.511164369607487e-13	176	54	14	0.25925925925925924	0.07954545454545454	GO:0000075	GO:BP	cell cycle checkpoint signaling	16175	26		0.1276595744680851	0.14583333333333334	176	15999	14	40	162	15959	16175	0.138565790948419
M1	cpdb	0	network_modules	39	TRUE	7.277092446790927e-13	97	44	12	0.2727272727272727	0.12371134020618557	REAC:R-HSA-5693607	REAC	Processing of DNA double-strand break ends	10916	1798		0.2972972972972973	0.3157894736842105	97	10819	12	32	85	10787	10916	0.1788538878859978
M1	cpdb	0	network_modules	39	TRUE	7.942450332036293e-13	281	54	16	0.2962962962962963	0.05693950177935943	GO:0006310	GO:BP	DNA recombination	16175	2115		0.14893617021276595	0.16666666666666666	281	15894	16	38	265	15856	16175	0.12355519246847535
M1	cpdb	0	network_modules	39	TRUE	8.867130563301724e-13	132	44	13	0.29545454545454547	0.09848484848484848	REAC:R-HSA-5693567	REAC	HDR through Homologous Recombination (HRR) or Single Strand Annealing (SSA)	10916	1098		0.32432432432432434	0.34210526315789475	132	10784	13	31	119	10753	10916	0.16493019023330477
M1	cpdb	0	network_modules	39	TRUE	1.5984509464699995e-12	138	44	13	0.29545454545454547	0.09420289855072464	REAC:R-HSA-5693538	REAC	Homology Directed Repair	10916	1130		0.35135135135135137	0.3684210526315789	138	10778	13	31	125	10747	10916	0.16103682201239705
M1	cpdb	0	network_modules	39	TRUE	3.680762402722617e-12	147	44	13	0.29545454545454547	0.08843537414965986	REAC:R-HSA-1169410	REAC	Antiviral mechanism by IFN-stimulated genes	10916	157		0.3783783783783784	0.39473684210526316	147	10769	13	31	134	10738	10916	0.15563939327667664
M1	cpdb	0	network_modules	39	TRUE	1.8235549319838766e-11	92	44	11	0.25	0.11956521739130435	REAC:R-HSA-6804756	REAC	Regulation of TP53 Activity through Phosphorylation	10916	2016		0.40540540540540543	0.42105263157894735	92	10824	11	33	81	10791	10916	0.16811015195205245
M1	cpdb	0	network_modules	39	TRUE	1.9131490835320516e-11	224	54	14	0.25925925925925924	0.0625	GO:1901988	GO:BP	negative regulation of cell cycle phase transition	16175	21921		0.1702127659574468	0.1875	224	15951	14	40	210	15911	16175	0.1215404266622276
M1	cpdb	0	network_modules	39	TRUE	2.1178981027115263e-11	168	44	13	0.29545454545454547	0.07738095238095238	REAC:R-HSA-5693532	REAC	DNA Double-Strand Break Repair	10916	443		0.43243243243243246	0.4473684210526316	168	10748	13	31	155	10717	10916	0.14473528302298425
M1	cpdb	0	network_modules	39	TRUE	2.329228592207369e-11	94	44	11	0.25	0.11702127659574468	REAC:R-HSA-69473	REAC	G2/M DNA damage checkpoint	10916	1006		0.4594594594594595	0.47368421052631576	94	10822	11	33	83	10789	10916	0.1662013489417723
M1	cpdb	0	network_modules	39	TRUE	4.625774578151407e-11	298	54	15	0.2777777777777778	0.050335570469798654	GO:0006302	GO:BP	double-strand break repair	16175	2109		0.19148936170212766	0.20833333333333334	298	15877	15	39	283	15838	16175	0.11162108844174953
M1	cpdb	0	network_modules	39	TRUE	7.546028989740518e-11	147	54	12	0.2222222222222222	0.08163265306122448	GO:0006261	GO:BP	DNA-templated DNA replication	16175	2078		0.2127659574468085	0.22916666666666666	147	16028	12	42	135	15986	16175	0.12998697373019233
M1	cpdb	0	network_modules	39	TRUE	1.669147852798508e-10	262	54	14	0.25925925925925924	0.05343511450381679	GO:0010948	GO:BP	negative regulation of cell cycle process	16175	4526		0.23404255319148937	0.25	262	15913	14	40	248	15873	16175	0.1114383157178138
M1	cpdb	0	network_modules	39	TRUE	5.525233106994076e-10	167	44	12	0.2727272727272727	0.0718562874251497	REAC:R-HSA-69481	REAC	G2/M Checkpoints	10916	1005		0.4864864864864865	0.5	167	10749	12	32	155	10717	10916	0.13342884274937114
M1	cpdb	0	network_modules	39	TRUE	5.354530860919747e-9	338	54	14	0.25925925925925924	0.04142011834319527	GO:0045786	GO:BP	negative regulation of cell cycle	16175	11618		0.2553191489361702	0.2708333333333333	338	15837	14	40	324	15797	16175	0.09644703386010119
M1	cpdb	0	network_modules	39	TRUE	6.631008032655563e-9	263	44	13	0.29545454545454547	0.049429657794676805	REAC:R-HSA-913531	REAC	Interferon Signaling	10916	1227		0.5135135135135135	0.5263157894736842	263	10653	13	31	250	10622	10916	0.11258213764714997
M1	cpdb	0	network_modules	39	TRUE	8.697098559483537e-9	160	44	11	0.25	0.06875	REAC:R-HSA-5633007	REAC	Regulation of TP53 Activity	10916	2012		0.5405405405405406	0.5526315789473685	160	10756	11	33	149	10723	10916	0.12458057543614601
M1	cpdb	0	network_modules	39	TRUE	1.656025566302981e-8	231	54	12	0.2222222222222222	0.05194805194805195	GO:0006260	GO:BP	DNA replication	16175	2077		0.2765957446808511	0.2916666666666667	231	15944	12	42	219	15902	16175	0.10143329108913454
M1	cpdb	0	network_modules	39	TRUE	1.7876166870131215e-8	176	54	11	0.2037037037037037	0.0625	GO:0000725	GO:BP	recombinational repair	16175	204		0.2978723404255319	0.3125	176	15999	11	43	165	15956	16175	0.1075723409388681
M1	cpdb	0	network_modules	39	TRUE	2.164499665666245e-8	289	44	13	0.29545454545454547	0.04498269896193772	REAC:R-HSA-69620	REAC	Cell Cycle Checkpoints	10916	321		0.5675675675675675	0.5789473684210527	289	10627	13	31	276	10596	10916	0.10658603328142789
M1	cpdb	0	network_modules	39	TRUE	2.2379433515354513e-8	376	54	14	0.25925925925925924	0.03723404255319149	GO:1901987	GO:BP	regulation of cell cycle phase transition	16175	21920		0.3191489361702128	0.3333333333333333	376	15799	14	40	362	15759	16175	0.0906511507210769
M1	cpdb	0	network_modules	39	TRUE	5.889726611343128e-8	20	54	6	0.1111111111111111	0.3	GO:0000076	GO:BP	DNA replication checkpoint signaling	16175	27		0.3404255319148936	0.3541666666666667	20	16155	6	48	14	16107	16175	0.1809564830041152
M1	cpdb	0	network_modules	39	TRUE	1.8717777965686632e-7	630	54	16	0.2962962962962963	0.025396825396825397	GO:0010564	GO:BP	regulation of cell cycle process	16175	4217		0.3617021276595745	0.375	630	15545	16	38	614	15507	16175	0.07698376730396682
M1	cpdb	0	network_modules	39	TRUE	3.171023686209478e-7	359	44	13	0.29545454545454547	0.036211699164345405	REAC:R-HSA-3700989	REAC	Transcriptional Regulation by TP53	10916	2546		0.5945945945945946	0.6052631578947368	359	10557	13	31	346	10526	10916	0.09366080108750846
M1	cpdb	0	network_modules	39	TRUE	3.442520203282983e-7	172	54	10	0.18518518518518517	0.05813953488372093	GO:0000724	GO:BP	double-strand break repair via homologous recombination	16175	203		0.3829787234042553	0.3958333333333333	172	16003	10	44	162	15959	16175	0.09849264887510481
M1	cpdb	0	network_modules	39	TRUE	3.72388494295502e-7	465	54	14	0.25925925925925924	0.030107526881720432	GO:0044770	GO:BP	cell cycle phase transition	16175	11146		0.40425531914893614	0.4166666666666667	465	15710	14	40	451	15670	16175	0.07984038571784752
M1	cpdb	0	network_modules	39	TRUE	1.5215691234726485e-6	15	54	5	0.09259259259259259	0.3333333333333333	GO:0031573	GO:BP	mitotic intra-S DNA damage checkpoint signaling	16175	7222		0.425531914893617	0.4583333333333333	15	16160	5	49	10	16111	16175	0.17429443920476576
M1	cpdb	0	network_modules	39	TRUE	1.5215691234726485e-6	15	54	5	0.09259259259259259	0.3333333333333333	GO:0000712	GO:BP	resolution of meiotic recombination intermediates	16175	192		0.425531914893617	0.4583333333333333	15	16160	5	49	10	16111	16175	0.17429443920476576
M1	cpdb	0	network_modules	39	TRUE	2.3094247868250874e-6	37	44	6	0.13636363636363635	0.16216216216216217	REAC:R-HSA-176187	REAC	Activation of ATR in response to replication stress	10916	75		0.6216216216216216	0.631578947368421	37	10879	6	38	31	10841	10916	0.14554822253137623
M1	cpdb	0	network_modules	39	TRUE	3.969581124326403e-6	23	39	5	0.1282051282051282	0.21739130434782608	KEGG:03430	KEGG	Mismatch repair	8484	239		0.5	0.6666666666666666	23	8461	5	34	18	8427	8484	0.16401434252718705
M1	cpdb	0	network_modules	39	TRUE	7.536657550150571e-6	42	54	6	0.1111111111111111	0.14285714285714285	GO:0006284	GO:BP	base-excision repair	16175	2098		0.46808510638297873	0.4791666666666667	42	16133	6	48	36	16085	16175	0.12341012367160535
M1	cpdb	0	network_modules	39	TRUE	9.405414895369887e-6	77	54	7	0.12962962962962962	0.09090909090909091	GO:0044773	GO:BP	mitotic DNA damage checkpoint signaling	16175	11149		0.48936170212765956	0.5	77	16098	7	47	70	16051	16175	0.10499513458319232
M1	cpdb	0	network_modules	39	TRUE	1.1279621177100785e-5	79	54	7	0.12962962962962962	0.08860759493670886	GO:0006289	GO:BP	nucleotide-excision repair	16175	2102		0.5106382978723404	0.5208333333333334	79	16096	7	47	72	16049	16175	0.10356135222869449
M1	cpdb	0	network_modules	39	TRUE	1.346172117650702e-5	81	54	7	0.12962962962962962	0.08641975308641975	GO:0044774	GO:BP	mitotic DNA integrity checkpoint signaling	16175	11150		0.5319148936170213	0.5416666666666666	81	16094	7	47	74	16047	16175	0.1021797995480818
M1	cpdb	0	network_modules	39	TRUE	1.73630995282312e-5	48	54	6	0.1111111111111111	0.125	GO:0031297	GO:BP	replication fork processing	16175	7119		0.5531914893617021	0.5625	48	16127	6	48	42	16079	16175	0.11506638395043685
M1	cpdb	0	network_modules	39	TRUE	3.198602416704509e-5	203	54	9	0.16666666666666666	0.04433497536945813	GO:0051321	GO:BP	meiotic cell cycle	16175	13648		0.574468085106383	0.5833333333333334	203	15972	9	45	194	15927	16175	0.08012470885867051
M1	cpdb	0	network_modules	39	TRUE	5.0180699961182186e-5	57	54	6	0.1111111111111111	0.10526315789473684	GO:0045005	GO:BP	DNA-templated DNA replication maintenance of fidelity	16175	11223		0.5957446808510638	0.6041666666666666	57	16118	6	48	51	16070	16175	0.1050781934406696
M1	cpdb	0	network_modules	39	TRUE	5.450912109187232e-5	11	54	4	0.07407407407407407	0.36363636363636365	GO:0033314	GO:BP	mitotic DNA replication checkpoint signaling	16175	8127		0.6170212765957447	0.625	11	16164	4	50	7	16114	16175	0.16294275194190885
M1	cpdb	0	network_modules	39	TRUE	5.807911842250031e-5	29	54	5	0.09259259259259259	0.1724137931034483	GO:0006298	GO:BP	mismatch repair	16175	2107		0.6382978723404256	0.6458333333333334	29	16146	5	49	24	16097	16175	0.1242218898238584
M1	cpdb	0	network_modules	39	TRUE	7.600394922928675e-5	61	54	6	0.1111111111111111	0.09836065573770492	GO:0035825	GO:BP	homologous recombination	16175	9273		0.6595744680851063	0.6666666666666666	61	16114	6	48	55	16066	16175	0.10135369923036572
M1	cpdb	0	network_modules	39	TRUE	7.781499623150674e-5	34	44	5	0.11363636363636363	0.14705882352941177	REAC:R-HSA-5693568	REAC	Resolution of D-loop Structures through Holliday Junction Intermediates	10916	2077		0.6486486486486487	0.6578947368421053	34	10882	5	39	29	10843	10916	0.12617948807502197
M1	cpdb	0	network_modules	39	TRUE	8.08559451523059e-5	14	44	4	0.09090909090909091	0.2857142857142857	REAC:R-HSA-5358606	REAC	Mismatch repair (MMR) directed by MSH2:MSH3 (MutSbeta)	10916	1458		0.6756756756756757	0.6842105263157895	14	10902	4	40	10	10862	10916	0.15931431928277845
M1	cpdb	0	network_modules	39	TRUE	8.156150764135925e-5	12	54	4	0.07407407407407407	0.3333333333333333	GO:0006285	GO:BP	base-excision repair, AP site formation	16175	2099		0.6808510638297872	0.6875	12	16163	4	50	8	16113	16175	0.1558792173495216
M1	cpdb	0	network_modules	39	TRUE	8.649564467272778e-5	161	54	8	0.14814814814814814	0.049689440993788817	GO:1903046	GO:BP	meiotic cell cycle process	16175	22726		0.7021276595744681	0.7083333333333334	161	16014	8	46	153	15968	16175	0.08056995838877622
M1	cpdb	0	network_modules	39	TRUE	9.051381024417097e-5	35	44	5	0.11363636363636363	0.14285714285714285	REAC:R-HSA-5693537	REAC	Resolution of D-Loop Structures	10916	2076		0.7027027027027027	0.7105263157894737	35	10881	5	39	30	10842	10916	0.12426648897834949
M1	cpdb	0	network_modules	39	TRUE	1.099349206000109e-4	15	44	4	0.09090909090909091	0.26666666666666666	REAC:R-HSA-5358508	REAC	Mismatch Repair	10916	1457		0.7297297297297297	0.7368421052631579	15	10901	4	40	11	10861	10916	0.15376199095508647
M1	cpdb	0	network_modules	39	TRUE	1.1941950700267926e-4	44	39	5	0.1282051282051282	0.11363636363636363	KEGG:03410	KEGG	Base excision repair	8484	237		1	1	44	8440	5	34	39	8406	8484	0.11638778352348172
M1	cpdb	0	network_modules	39	TRUE	4.4389774791802445e-4	134	54	7	0.12962962962962962	0.05223880597014925	GO:0007093	GO:BP	mitotic cell cycle checkpoint signaling	16175	2676		0.723404255319149	0.7291666666666666	134	16041	7	47	127	15994	16175	0.07748181886929037
M1	cpdb	0	network_modules	39	TRUE	7.915462348207414e-4	90	54	6	0.1111111111111111	0.06666666666666667	GO:0010212	GO:BP	response to ionizing radiation	16175	3993		0.7446808510638298	0.75	90	16085	6	48	84	16037	16175	0.08212193213405908
M1	cpdb	0	network_modules	39	TRUE	8.334926671147574e-4	24	44	4	0.09090909090909091	0.16666666666666666	REAC:R-HSA-9709603	REAC	Impaired BRCA2 binding to PALB2	10916	1172		0.7567567567567568	0.7631578947368421	24	10892	4	40	20	10852	10916	0.12048990218086543
M1	cpdb	0	network_modules	39	TRUE	9.893460952009353e-4	25	44	4	0.09090909090909091	0.16	REAC:R-HSA-9704646	REAC	Defective HDR through Homologous Recombination Repair (HRR) due to PALB2 loss of BRCA2/RAD51/RAD51C binding function	10916	563		0.7837837837837838	0.868421052631579	25	10891	4	40	21	10851	10916	0.11793901356868848
M1	cpdb	0	network_modules	39	TRUE	9.893460952009353e-4	25	44	4	0.09090909090909091	0.16	REAC:R-HSA-9701192	REAC	Defective homologous recombination repair (HRR) due to BRCA1 loss of function	10916	697		0.7837837837837838	0.868421052631579	25	10891	4	40	21	10851	10916	0.11793901356868848
M1	cpdb	0	network_modules	39	TRUE	9.893460952009353e-4	25	44	4	0.09090909090909091	0.16	REAC:R-HSA-9701193	REAC	Defective homologous recombination repair (HRR) due to PALB2 loss of function	10916	699		0.7837837837837838	0.868421052631579	25	10891	4	40	21	10851	10916	0.11793901356868848
M1	cpdb	0	network_modules	39	TRUE	9.893460952009353e-4	25	44	4	0.09090909090909091	0.16	REAC:R-HSA-9704331	REAC	Defective HDR through Homologous Recombination Repair (HRR) due to PALB2 loss of BRCA1 binding function	10916	562		0.7837837837837838	0.868421052631579	25	10891	4	40	21	10851	10916	0.11793901356868848
M1	cpdb	0	network_modules	39	TRUE	0.0010583317504518038	6	54	3	0.05555555555555555	0.5	GO:0071139	GO:BP	resolution of DNA recombination intermediates	16175	16460		0.7659574468085106	0.7708333333333334	6	16169	3	51	3	16118	16175	0.16586164707534398
M1	cpdb	0	network_modules	39	TRUE	0.0013208915475019305	53	54	5	0.09259259259259259	0.09433962264150944	GO:0007131	GO:BP	reciprocal meiotic recombination	16175	2702		0.7872340425531915	0.8333333333333334	53	16122	5	49	48	16073	16175	0.09045377927658299
M1	cpdb	0	network_modules	39	TRUE	0.0013208915475019305	53	54	5	0.09259259259259259	0.09433962264150944	GO:0071479	GO:BP	cellular response to ionizing radiation	16175	16712		0.7872340425531915	0.8333333333333334	53	16122	5	49	48	16073	16175	0.09045377927658299
M1	cpdb	0	network_modules	39	TRUE	0.0013208915475019305	53	54	5	0.09259259259259259	0.09433962264150944	GO:0140527	GO:BP	reciprocal homologous recombination	16175	19808		0.7872340425531915	0.8333333333333334	53	16122	5	49	48	16073	16175	0.09045377927658299
M1	cpdb	0	network_modules	39	TRUE	0.0013645407784386163	27	44	4	0.09090909090909091	0.14814814814814814	REAC:R-HSA-5693554	REAC	Resolution of D-loop Structures through Synthesis-Dependent Strand Annealing (SDSA)	10916	2078		0.8918918918918919	0.8947368421052632	27	10889	4	40	23	10849	10916	0.1132626376035872
M1	cpdb	0	network_modules	39	TRUE	0.0022376070298238994	545	54	11	0.2037037037037037	0.02018348623853211	GO:0051276	GO:BP	chromosome organization	16175	13613		0.851063829787234	0.8541666666666666	545	15630	11	43	534	15587	16175	0.054530718705175105
M1	cpdb	0	network_modules	39	TRUE	0.0027863526159391206	27	54	4	0.07407407407407407	0.14814814814814814	GO:0006304	GO:BP	DNA modification	16175	2111		0.8723404255319149	0.875	27	16148	4	50	23	16098	16175	0.10265295946117724
M1	cpdb	0	network_modules	39	TRUE	0.002949333076835855	8	54	3	0.05555555555555555	0.375	GO:0045008	GO:BP	depyrimidination	16175	11226		0.8936170212765957	0.8958333333333334	8	16167	3	51	5	16116	16175	0.1433274213078
M1	cpdb	0	network_modules	39	TRUE	0.0035325273483767555	34	44	4	0.09090909090909091	0.11764705882352941	REAC:R-HSA-174417	REAC	Telomere C-strand (Lagging Strand) Synthesis	10916	2486		0.918918918918919	0.9210526315789473	34	10882	4	40	30	10842	10916	0.10023239871048764
M1	cpdb	0	network_modules	39	TRUE	0.004413541670457669	9	54	3	0.05555555555555555	0.3333333333333333	GO:1900262	GO:BP	regulation of DNA-directed DNA polymerase activity	16175	20524		0.9148936170212766	0.9583333333333334	9	16166	3	51	6	16115	16175	0.13498283570613734
M1	cpdb	0	network_modules	39	TRUE	0.004413541670457669	9	54	3	0.05555555555555555	0.3333333333333333	GO:0033313	GO:BP	meiotic cell cycle checkpoint signaling	16175	8126		0.9148936170212766	0.9583333333333334	9	16166	3	51	6	16115	16175	0.13498283570613734
M1	cpdb	0	network_modules	39	TRUE	0.004413541670457669	9	54	3	0.05555555555555555	0.3333333333333333	GO:1900264	GO:BP	positive regulation of DNA-directed DNA polymerase activity	16175	20525		0.9148936170212766	0.9583333333333334	9	16166	3	51	6	16115	16175	0.13498283570613734
M1	cpdb	0	network_modules	39	TRUE	0.0044606404193671826	36	44	4	0.09090909090909091	0.1111111111111111	REAC:R-HSA-73933	REAC	Resolution of Abasic Sites (AP sites)	10916	2075		0.9459459459459459	0.9473684210526315	36	10880	4	40	32	10840	10916	0.09721403578152735
M1	cpdb	0	network_modules	39	TRUE	0.006308161276854637	138	44	6	0.13636363636363635	0.043478260869565216	REAC:R-HSA-73886	REAC	Chromosome Maintenance	10916	357		0.972972972972973	0.9736842105263158	138	10778	6	38	132	10740	10916	0.07044857115392593
M1	cpdb	0	network_modules	39	TRUE	0.006969343559853255	202	54	7	0.12962962962962962	0.034653465346534656	GO:0045930	GO:BP	negative regulation of mitotic cell cycle	16175	11724		0.9787234042553191	0.9791666666666666	202	15973	7	47	195	15926	16175	0.061050046407267834
M1	cpdb	0	network_modules	39	TRUE	0.007813026441027389	14	44	3	0.06818181818181818	0.21428571428571427	REAC:R-HSA-5358565	REAC	Mismatch repair (MMR) directed by MSH2:MSH6 (MutSalpha)	10916	1459		1	1	14	10902	3	41	11	10861	10916	0.1189158081024493
M1	cpdb	0	network_modules	39	TRUE	0.009585033220052235	300	54	8	0.14814814814814814	0.02666666666666667	GO:0009314	GO:BP	response to radiation	16175	3460		1	1	300	15875	8	46	292	15829	16175	0.05559504212153774
M1	cpdb	0	network_modules	40	TRUE	1.0577794268551955e-62	345	53	44	0.8301886792452831	0.12753623188405797	GO:0016055	GO:BP	Wnt signaling pathway	16175	5087		0	0.011627906976744186	345	15830	44	9	301	15821	16175	0.32099320120709324
M1	cpdb	0	network_modules	40	TRUE	1.6395309077019543e-61	174	46	40	0.8695652173913043	0.22988505747126436	KEGG:04310	KEGG	Wnt signaling pathway	8484	299		0	0.07692307692307693	174	8310	40	6	134	8304	8484	0.44230416254144056
M1	cpdb	0	network_modules	40	TRUE	3.5303260074028155e-52	257	53	37	0.6981132075471698	0.14396887159533073	GO:0060070	GO:BP	canonical Wnt signaling pathway	16175	14332		0.011764705882352941	0.023255813953488372	257	15918	37	16	220	15902	16175	0.3128162168790511
M1	cpdb	0	network_modules	40	TRUE	2.384282946484556e-44	327	46	36	0.782608695652174	0.11009174311926606	REAC:R-HSA-195721	REAC	Signaling by WNT	10916	2314		0	0.0625	327	10589	36	10	291	10579	10916	0.2872241319955544
M1	cpdb	0	network_modules	40	TRUE	6.170713153295403e-37	63	46	23	0.5	0.36507936507936506	KEGG:05217	KEGG	Basal cell carcinoma	8484	468		0.08333333333333333	0.15384615384615385	63	8421	23	23	40	8398	8484	0.42362288937608206
M1	cpdb	0	network_modules	40	TRUE	1.19421971443457e-35	61	53	21	0.39622641509433965	0.3442622950819672	GO:0035567	GO:BP	non-canonical Wnt signaling pathway	16175	9097		0.023529411764705882	0.03488372093023256	61	16114	21	32	40	16082	16175	0.36711000074099565
M1	cpdb	0	network_modules	40	TRUE	1.618748181113512e-33	26	46	17	0.3695652173913043	0.6538461538461539	REAC:R-HSA-3238698	REAC	WNT ligand biogenesis and trafficking	10916	2668		0.06666666666666667	0.125	26	10890	17	29	9	10861	10916	0.49001580392662814
M1	cpdb	0	network_modules	40	TRUE	5.118092889146029e-32	93	46	22	0.4782608695652174	0.23655913978494625	REAC:R-HSA-373080	REAC	Class B/2 (Secretin family receptors)	10916	366		0.13333333333333333	0.1875	93	10823	22	24	71	10799	10916	0.33248425250395114
M1	cpdb	0	network_modules	40	TRUE	1.9130802232877896e-31	101	46	23	0.5	0.22772277227722773	KEGG:04916	KEGG	Melanogenesis	8484	373		0.16666666666666666	0.23076923076923078	101	8383	23	23	78	8360	8484	0.33227981947886454
M1	cpdb	0	network_modules	40	TRUE	4.332068978669906e-31	147	46	25	0.5434782608695652	0.17006802721088435	KEGG:05224	KEGG	Breast cancer	8484	475		0.25	0.3076923076923077	147	8337	25	21	122	8316	8484	0.2977193644194113
M1	cpdb	0	network_modules	40	TRUE	5.199958408926535e-31	148	46	25	0.5434782608695652	0.16891891891891891	KEGG:05226	KEGG	Gastric cancer	8484	477		0.3333333333333333	0.38461538461538464	148	8336	25	21	123	8315	8484	0.2966631738352618
M1	cpdb	0	network_modules	40	TRUE	1.7989736911611052e-30	155	46	25	0.5434782608695652	0.16129032258064516	KEGG:04150	KEGG	mTOR signaling pathway	8484	284		0.4166666666666667	0.46153846153846156	155	8329	25	21	130	8308	8484	0.28955385053230603
M1	cpdb	0	network_modules	40	TRUE	1.121919715729048e-29	166	46	25	0.5434782608695652	0.15060240963855423	KEGG:05225	KEGG	Hepatocellular carcinoma	8484	476		0.5	0.5384615384615384	166	8318	25	21	141	8297	8484	0.27928954235557835
M1	cpdb	0	network_modules	40	TRUE	1.801802321918398e-28	157	46	24	0.5217391304347826	0.15286624203821655	KEGG:04390	KEGG	Hippo signaling pathway	8484	310		0.5833333333333334	0.6153846153846154	157	8327	24	22	133	8305	8484	0.2756991522544917
M1	cpdb	0	network_modules	40	TRUE	1.1854475790912563e-27	143	46	23	0.5	0.16083916083916083	KEGG:04550	KEGG	Signaling pathways regulating pluripotency of stem cells	8484	319		0.6666666666666666	0.6923076923076923	143	8341	23	23	120	8318	8484	0.2771149744089839
M1	cpdb	0	network_modules	40	TRUE	2.138514500819079e-27	277	53	25	0.4716981132075472	0.09025270758122744	GO:0030111	GO:BP	regulation of Wnt signaling pathway	16175	6681		0.03529411764705882	0.046511627906976744	277	15898	25	28	252	15870	16175	0.20089318077671883
M1	cpdb	0	network_modules	40	TRUE	6.2165675416024e-27	153	46	23	0.5	0.1503267973856209	KEGG:04934	KEGG	Cushing syndrome	8484	391		0.75	0.7692307692307693	153	8331	23	23	130	8308	8484	0.2674126718240801
M1	cpdb	0	network_modules	40	TRUE	3.7986718945176233e-26	231	46	24	0.5217391304347826	0.1038961038961039	REAC:R-HSA-201681	REAC	TCF dependent signaling in response to WNT	10916	2421		0.2	0.25	231	10685	24	22	207	10663	10916	0.22625895191778872
M1	cpdb	0	network_modules	40	TRUE	1.5116974296045428e-25	205	46	24	0.5217391304347826	0.11707317073170732	KEGG:05205	KEGG	Proteoglycans in cancer	8484	457		0.8333333333333334	0.8461538461538461	205	8279	24	22	181	8257	8484	0.23925078295558277
M1	cpdb	0	network_modules	40	TRUE	7.632659292630181e-25	382	46	28	0.6086956521739131	0.07329842931937172	KEGG:05010	KEGG	Alzheimer disease	8484	411		0.9166666666666666	0.9230769230769231	382	8102	28	18	354	8084	8484	0.20070432001758817
M1	cpdb	0	network_modules	40	TRUE	1.5163169953606788e-24	21	46	13	0.2826086956521739	0.6190476190476191	REAC:R-HSA-4641263	REAC	Regulation of FZD by ubiquitination	10916	1974		0.26666666666666666	0.3125	21	10895	13	33	8	10862	10916	0.41669997788008917
M1	cpdb	0	network_modules	40	TRUE	1.027320738078655e-21	15	46	11	0.2391304347826087	0.7333333333333333	REAC:R-HSA-3772470	REAC	Negative regulation of TCF-dependent signaling by WNT ligand antagonists	10916	1578		0.3333333333333333	0.375	15	10901	11	35	4	10866	10916	0.4175234902163175
M1	cpdb	0	network_modules	40	TRUE	1.2305080095526472e-19	175	53	18	0.33962264150943394	0.10285714285714286	GO:0045165	GO:BP	cell fate commitment	16175	11307		0.047058823529411764	0.05813953488372093	175	16000	18	35	157	15965	16175	0.18223431151306987
M1	cpdb	0	network_modules	40	TRUE	4.802520902585891e-19	330	46	23	0.5	0.0696969696969697	KEGG:05165	KEGG	Human papillomavirus infection	8484	446		1	1	330	8154	23	23	307	8131	8484	0.17608229009397247
M1	cpdb	0	network_modules	40	TRUE	4.2337389482836205e-18	212	53	18	0.33962264150943394	0.08490566037735849	GO:0060828	GO:BP	regulation of canonical Wnt signaling pathway	16175	14976		0.058823529411764705	0.06976744186046512	212	15963	18	35	194	15928	16175	0.164608417561187
M1	cpdb	0	network_modules	40	TRUE	1.9521826642816393e-17	8	46	8	0.17391304347826086	1	REAC:R-HSA-5340588	REAC	Signaling by RNF43 mutants	10916	2300		0.4	0.4375	8	10908	8	38	0	10870	10916	0.4163017965263216
M1	cpdb	0	network_modules	40	TRUE	2.0358933008758162e-16	34	46	11	0.2391304347826087	0.3235294117647059	REAC:R-HSA-4791275	REAC	Signaling by WNT in cancer	10916	2315		0.4666666666666667	0.5	34	10882	11	35	23	10847	10916	0.27553376087667025
M1	cpdb	0	network_modules	40	TRUE	3.8999351019629552e-16	460	46	22	0.4782608695652174	0.04782608695652174	REAC:R-HSA-500792	REAC	GPCR ligand binding	10916	1019		0.5333333333333333	0.5625	460	10456	22	24	438	10432	10916	0.1412124080261206
M1	cpdb	0	network_modules	40	TRUE	7.516012620277957e-16	146	53	15	0.2830188679245283	0.10273972602739725	GO:0030178	GO:BP	negative regulation of Wnt signaling pathway	16175	6698		0.07058823529411765	0.08139534883720931	146	16029	15	38	131	15991	16175	0.1661047093197514
M1	cpdb	0	network_modules	40	TRUE	1.70535684495484e-15	44	53	11	0.20754716981132076	0.25	GO:0071300	GO:BP	cellular response to retinoic acid	16175	16557		0.08235294117647059	0.09302325581395349	44	16131	11	42	33	16089	16175	0.22547729796212382
M1	cpdb	0	network_modules	40	TRUE	1.8171371339172055e-15	64	53	12	0.22641509433962265	0.1875	GO:0032526	GO:BP	response to retinoic acid	16175	7620		0.09411764705882353	0.10465116279069768	64	16111	12	41	52	16070	16175	0.20317500663086563
M1	cpdb	0	network_modules	40	TRUE	6.123430705729587e-14	115	53	13	0.24528301886792453	0.11304347826086956	GO:0030177	GO:BP	positive regulation of Wnt signaling pathway	16175	6697		0.10588235294117647	0.11627906976744186	115	16060	13	40	102	16020	16175	0.16253395959762673
M1	cpdb	0	network_modules	40	TRUE	1.588874668609668e-12	512	53	19	0.3584905660377358	0.037109375	GO:0009790	GO:BP	embryo development	16175	3677		0.11764705882352941	0.12790697674418605	512	15663	19	34	493	15629	16175	0.10703633584659944
M1	cpdb	0	network_modules	40	TRUE	2.3522579520508513e-12	21	53	8	0.1509433962264151	0.38095238095238093	GO:2000050	GO:BP	regulation of non-canonical Wnt signaling pathway	16175	25410		0.12941176470588237	0.13953488372093023	21	16154	8	45	13	16109	16175	0.23827889059747073
M1	cpdb	0	network_modules	40	TRUE	2.9277347990806066e-12	36	53	9	0.16981132075471697	0.25	GO:0060071	GO:BP	Wnt signaling pathway, planar cell polarity pathway	16175	14333		0.1411764705882353	0.1511627906976744	36	16139	9	44	27	16095	16175	0.2039013347457224
M1	cpdb	0	network_modules	40	TRUE	4.644508115969652e-12	543	53	19	0.3584905660377358	0.034990791896869246	GO:0009887	GO:BP	animal organ morphogenesis	16175	3747		0.15294117647058825	0.16279069767441862	543	15632	19	34	524	15598	16175	0.10342900459997388
M1	cpdb	0	network_modules	40	TRUE	3.222367735947595e-11	92	46	11	0.2391304347826087	0.11956521739130435	REAC:R-HSA-4086400	REAC	PCP/CE pathway	10916	1659		0.6	0.625	92	10824	11	35	81	10789	10916	0.1641693397643919
M1	cpdb	0	network_modules	40	TRUE	8.520702442136135e-11	199	53	13	0.24528301886792453	0.06532663316582915	GO:0001654	GO:BP	eye development	16175	368		0.16470588235294117	0.1744186046511628	199	15976	13	40	186	15936	16175	0.12118001329929007
M1	cpdb	0	network_modules	40	TRUE	9.90162173533257e-11	153	53	12	0.22641509433962265	0.0784313725490196	GO:0043010	GO:BP	camera-type eye development	16175	10480		0.17647058823529413	0.18604651162790697	153	16022	12	41	141	15981	16175	0.12851104560137147
M1	cpdb	0	network_modules	40	TRUE	1.0341133159427738e-10	202	53	13	0.24528301886792453	0.06435643564356436	GO:0150063	GO:BP	visual system development	16175	20119		0.18823529411764706	0.19767441860465115	202	15973	13	40	189	15933	16175	0.12019233085529275
M1	cpdb	0	network_modules	40	TRUE	1.5094514540073032e-10	208	53	13	0.24528301886792453	0.0625	GO:0048880	GO:BP	sensory system development	16175	13120		0.2	0.20930232558139536	208	15967	13	40	195	15927	16175	0.1182795834469561
M1	cpdb	0	network_modules	40	TRUE	1.7825414824709603e-10	118	53	11	0.20754716981132076	0.09322033898305085	GO:0090090	GO:BP	negative regulation of canonical Wnt signaling pathway	16175	18011		0.21176470588235294	0.22093023255813954	118	16057	11	42	107	16015	16175	0.13492000120899073
M1	cpdb	0	network_modules	40	TRUE	3.06679809952034e-10	279	53	14	0.2641509433962264	0.05017921146953405	GO:0007423	GO:BP	sensory organ development	16175	2918		0.2235294117647059	0.23255813953488372	279	15896	14	39	265	15857	16175	0.10873053511276802
M1	cpdb	0	network_modules	40	TRUE	4.612625592979562e-10	701	53	19	0.3584905660377358	0.02710413694721826	GO:0060429	GO:BP	epithelium development	16175	14627		0.23529411764705882	0.2441860465116279	701	15474	19	34	682	15440	16175	0.08874270026236812
M1	cpdb	0	network_modules	40	TRUE	1.5967653382662123e-9	250	53	13	0.24528301886792453	0.052	GO:0007389	GO:BP	pattern specification process	16175	2889		0.24705882352941178	0.2558139534883721	250	15925	13	40	237	15885	16175	0.10682286414358234
M1	cpdb	0	network_modules	40	TRUE	2.434148914322844e-9	13	53	6	0.11320754716981132	0.46153846153846156	GO:1904948	GO:BP	midbrain dopaminergic neuron differentiation	16175	24239		0.25882352941176473	0.26744186046511625	13	16162	6	47	7	16115	16175	0.2274231537426375
M1	cpdb	0	network_modules	40	TRUE	4.449751922209264e-9	143	46	11	0.2391304347826087	0.07692307692307693	REAC:R-HSA-3858494	REAC	Beta-catenin independent WNT signaling	10916	216		0.6666666666666666	0.6875	143	10773	11	35	132	10738	10916	0.12931775966015288
M1	cpdb	0	network_modules	40	TRUE	8.06606143411883e-9	30	53	7	0.1320754716981132	0.23333333333333334	GO:0071542	GO:BP	dopaminergic neuron differentiation	16175	16752		0.27058823529411763	0.27906976744186046	30	16145	7	46	23	16099	16175	0.1735295064097423
M1	cpdb	0	network_modules	40	TRUE	1.3318598017398112e-8	31	46	7	0.15217391304347827	0.22580645161290322	REAC:R-HSA-4641262	REAC	Disassembly of the destruction complex and recruitment of AXIN to the membrane	10916	746		0.7333333333333333	0.75	31	10885	7	39	24	10846	10916	0.18255403475169185
M1	cpdb	0	network_modules	40	TRUE	1.434998099259405e-7	283	53	12	0.22641509433962265	0.04240282685512368	GO:0001501	GO:BP	skeletal system development	16175	318		0.2823529411764706	0.29069767441860467	283	15892	12	41	271	15851	16175	0.0913625308526706
M1	cpdb	0	network_modules	40	TRUE	1.604809077936438e-7	4	53	4	0.07547169811320754	1	GO:0061054	GO:BP	dermatome development	16175	15170		0.29411764705882354	0.313953488372093	4	16171	4	49	0	16122	16175	0.2743045937282946
M1	cpdb	0	network_modules	40	TRUE	1.604809077936438e-7	4	53	4	0.07547169811320754	1	GO:0061183	GO:BP	regulation of dermatome development	16175	15280		0.29411764705882354	0.313953488372093	4	16171	4	49	0	16122	16175	0.2743045937282946
M1	cpdb	0	network_modules	40	TRUE	2.107069456716964e-7	225	53	11	0.20754716981132076	0.04888888888888889	GO:0003002	GO:BP	regionalization	16175	1453		0.3176470588235294	0.32558139534883723	225	15950	11	42	214	15908	16175	0.09479579914041183
M1	cpdb	0	network_modules	40	TRUE	2.2134561637021204e-7	11	53	5	0.09433962264150944	0.45454545454545453	GO:2000052	GO:BP	positive regulation of non-canonical Wnt signaling pathway	16175	25412		0.32941176470588235	0.3372093023255814	11	16164	5	48	6	16116	16175	0.20599378580856784
M1	cpdb	0	network_modules	40	TRUE	2.8947635922740007e-7	80	53	8	0.1509433962264151	0.1	GO:0048592	GO:BP	eye morphogenesis	16175	12861		0.3411764705882353	0.3488372093023256	80	16095	8	45	72	16050	16175	0.11932396533404183
M1	cpdb	0	network_modules	40	TRUE	3.245972377558967e-7	49	53	7	0.1320754716981132	0.14285714285714285	GO:0072089	GO:BP	stem cell proliferation	16175	17122		0.35294117647058826	0.36046511627906974	49	16126	7	46	42	16080	16175	0.1346344808574155
M1	cpdb	0	network_modules	40	TRUE	5.070518532088551e-7	129	53	9	0.16981132075471697	0.06976744186046512	GO:0061448	GO:BP	connective tissue development	16175	15483		0.36470588235294116	0.37209302325581395	129	16046	9	44	120	16002	16175	0.10432053058855344
M1	cpdb	0	network_modules	40	TRUE	5.220417778508975e-7	86	53	8	0.1509433962264151	0.09302325581395349	GO:0090263	GO:BP	positive regulation of canonical Wnt signaling pathway	16175	18152		0.3764705882352941	0.38372093023255816	86	16089	8	45	78	16044	16175	0.11481524923192761
M1	cpdb	0	network_modules	40	TRUE	6.474506942270874e-7	29	53	6	0.11320754716981132	0.20689655172413793	GO:0061053	GO:BP	somite development	16175	15169		0.38823529411764707	0.3953488372093023	29	16146	6	47	23	16099	16175	0.1510023200358321
M1	cpdb	0	network_modules	40	TRUE	7.283972747072305e-7	408	53	13	0.24528301886792453	0.031862745098039214	GO:0071396	GO:BP	cellular response to lipid	16175	16648		0.4	0.4069767441860465	408	15767	13	40	395	15727	16175	0.08046501620509403
M1	cpdb	0	network_modules	40	TRUE	8.004594361342811e-7	5	53	4	0.07547169811320754	0.8	GO:0007223	GO:BP	Wnt signaling pathway, calcium modulating pathway	16175	2776		0.4117647058823529	0.4186046511627907	5	16170	4	49	1	16121	16175	0.2451514281026675
M1	cpdb	0	network_modules	40	TRUE	8.688143387307567e-7	331	53	12	0.22641509433962265	0.03625377643504532	GO:0048729	GO:BP	tissue morphogenesis	16175	12986		0.4235294117647059	0.43023255813953487	331	15844	12	41	319	15803	16175	0.08340481701080536
M1	cpdb	0	network_modules	40	TRUE	9.847227655563465e-7	93	53	8	0.1509433962264151	0.08602150537634409	GO:0051216	GO:BP	cartilage development	16175	13573		0.43529411764705883	0.4418604651162791	93	16082	8	45	85	16037	16175	0.11010556816778147
M1	cpdb	0	network_modules	40	TRUE	1.2566685624927939e-6	520	53	14	0.2641509433962264	0.026923076923076925	GO:0033993	GO:BP	response to lipid	16175	8371		0.4470588235294118	0.45348837209302323	520	15655	14	39	506	15616	16175	0.0754114596092926
M1	cpdb	0	network_modules	40	TRUE	1.7990825222172762e-6	62	53	7	0.1320754716981132	0.11290322580645161	GO:0048593	GO:BP	camera-type eye morphogenesis	16175	12862		0.4588235294117647	0.46511627906976744	62	16113	7	46	55	16067	16175	0.11899270598363378
M1	cpdb	0	network_modules	40	TRUE	3.878483547635177e-6	69	53	7	0.1320754716981132	0.10144927536231885	GO:0030901	GO:BP	midbrain development	16175	6957		0.47058823529411764	0.47674418604651164	69	16106	7	46	62	16060	16175	0.11243925214503979
M1	cpdb	0	network_modules	40	TRUE	4.034410324004093e-6	18	53	5	0.09433962264150944	0.2777777777777778	GO:0062009	GO:BP	secondary palate development	16175	15779		0.4823529411764706	0.4883720930232558	18	16157	5	48	13	16109	16175	0.16032339506172186
M1	cpdb	0	network_modules	40	TRUE	7.108918280634481e-6	119	53	8	0.1509433962264151	0.06722689075630252	GO:0090596	GO:BP	sensory organ morphogenesis	16175	18358		0.49411764705882355	0.5	119	16056	8	45	111	16011	16175	0.09633715189510238
M1	cpdb	0	network_modules	40	TRUE	1.1318429736102096e-5	617	53	14	0.2641509433962264	0.022690437601296597	GO:0051093	GO:BP	negative regulation of developmental process	16175	13488		0.5058823529411764	0.5116279069767442	617	15558	14	39	603	15519	16175	0.06765074924436529
M1	cpdb	0	network_modules	40	TRUE	1.223680498721092e-5	46	53	6	0.11320754716981132	0.13043478260869565	GO:0002088	GO:BP	lens development in camera-type eye	16175	674		0.5176470588235295	0.5232558139534884	46	16129	6	47	40	16082	16175	0.11882729013279852
M1	cpdb	0	network_modules	40	TRUE	1.3354995752999212e-5	255	53	10	0.18867924528301888	0.0392156862745098	GO:0002009	GO:BP	morphogenesis of an epithelium	16175	612		0.5294117647058824	0.5348837209302325	255	15920	10	43	245	15877	16175	0.07959059338470743
M1	cpdb	0	network_modules	40	TRUE	1.8420985063457548e-5	434	53	12	0.22641509433962265	0.027649769585253458	GO:0045596	GO:BP	negative regulation of cell differentiation	16175	11447		0.5411764705882353	0.5465116279069767	434	15741	12	41	422	15700	16175	0.0708168354162729
M1	cpdb	0	network_modules	40	TRUE	2.0083476337419806e-5	87	53	7	0.1320754716981132	0.08045977011494253	GO:0021953	GO:BP	central nervous system neuron differentiation	16175	6508		0.5529411764705883	0.5581395348837209	87	16088	7	46	80	16042	16175	0.09931795295723224
M1	cpdb	0	network_modules	40	TRUE	4.6123654993705926e-5	57	53	6	0.11320754716981132	0.10526315789473684	GO:0009798	GO:BP	axis specification	16175	3682		0.5647058823529412	0.5697674418604651	57	16118	6	47	51	16071	16175	0.10612590839187346
M1	cpdb	0	network_modules	40	TRUE	5.190594481677619e-5	3	53	3	0.05660377358490566	1	GO:0061184	GO:BP	positive regulation of dermatome development	16175	15281		0.5764705882352941	0.5813953488372093	3	16172	3	50	0	16122	16175	0.23754740179888414
M1	cpdb	0	network_modules	40	TRUE	5.698460558598891e-5	59	53	6	0.11320754716981132	0.1016949152542373	GO:0002062	GO:BP	chondrocyte differentiation	16175	653		0.5882352941176471	0.5930232558139535	59	16116	6	47	53	16069	16175	0.10420052990906242
M1	cpdb	0	network_modules	40	TRUE	5.6990235386635735e-5	384	53	11	0.20754716981132076	0.028645833333333332	GO:0007420	GO:BP	brain development	16175	2915		0.6	0.6046511627906976	384	15791	11	42	373	15749	16175	0.06922516209967476
M1	cpdb	0	network_modules	40	TRUE	8.24522999107939e-5	309	53	10	0.18867924528301888	0.032362459546925564	GO:0048598	GO:BP	embryonic morphogenesis	16175	12865		0.611764705882353	0.6162790697674418	309	15866	10	43	299	15823	16175	0.07102698747541528
M1	cpdb	0	network_modules	40	TRUE	9.089843529844251e-5	402	53	11	0.20754716981132076	0.02736318407960199	GO:0060322	GO:BP	head development	16175	14534		0.6235294117647059	0.627906976744186	402	15773	11	42	391	15731	16175	0.0672863352801376
M1	cpdb	0	network_modules	40	TRUE	9.302595378926966e-5	64	46	6	0.13043478260869565	0.09375	REAC:R-HSA-4608870	REAC	Asymmetric localization of PCP proteins	10916	184		0.8	0.8125	64	10852	6	40	58	10812	10916	0.10614575554610005
M1	cpdb	0	network_modules	40	TRUE	1.9101503705986207e-4	254	53	9	0.16981132075471697	0.03543307086614173	GO:0001503	GO:BP	ossification	16175	320		0.6352941176470588	0.6395348837209303	254	15921	9	44	245	15877	16175	0.07107160642416065
M1	cpdb	0	network_modules	40	TRUE	1.958192501959864e-4	37	53	5	0.09433962264150944	0.13513513513513514	GO:0060021	GO:BP	roof of mouth development	16175	14284		0.6470588235294118	0.6511627906976745	37	16138	5	48	32	16090	16175	0.11047930834737577
M1	cpdb	0	network_modules	40	TRUE	2.0714233654372285e-4	4	53	3	0.05660377358490566	0.75	GO:0033278	GO:BP	cell proliferation in midbrain	16175	8110		0.6588235294117647	0.6627906976744186	4	16171	3	50	1	16121	16175	0.20550300578084446
M1	cpdb	0	network_modules	40	TRUE	2.526350991158364e-4	791	53	14	0.2641509433962264	0.017699115044247787	GO:1901701	GO:BP	cellular response to oxygen-containing compound	16175	21654		0.6705882352941176	0.6744186046511628	791	15384	14	39	777	15345	16175	0.05722550719582353
M1	cpdb	0	network_modules	40	TRUE	3.375470847959232e-4	418	46	11	0.2391304347826087	0.02631578947368421	REAC:R-HSA-5663202	REAC	Diseases of signal transduction by growth factor receptors and second messengers	10916	773		0.8666666666666667	0.875	418	10498	11	35	407	10463	10916	0.0680819798632159
M1	cpdb	0	network_modules	40	TRUE	3.6064703646827736e-4	80	53	6	0.11320754716981132	0.075	GO:0030278	GO:BP	regulation of ossification	16175	6755		0.6823529411764706	0.686046511627907	80	16095	6	47	74	16048	16175	0.08848240030882408
M1	cpdb	0	network_modules	40	TRUE	4.7467125382522215e-4	18	53	4	0.07547169811320754	0.2222222222222222	GO:0071425	GO:BP	hematopoietic stem cell proliferation	16175	16675		0.6941176470588235	0.6976744186046512	18	16157	4	49	14	16108	16175	0.12787596678725893
M1	cpdb	0	network_modules	40	TRUE	4.7748212637052607e-4	283	53	9	0.16981132075471697	0.03180212014134275	GO:0050808	GO:BP	synapse organization	16175	13274		0.7058823529411765	0.7093023255813954	283	15892	9	44	274	15848	16175	0.06660908553619642
M1	cpdb	0	network_modules	40	TRUE	5.180736663328912e-4	6	46	3	0.06521739130434782	0.5	REAC:R-HSA-5339717	REAC	Signaling by LRP5 mutants 	10916	2263		0.9333333333333333	0.9375	6	10910	3	43	3	10867	10916	0.17948466547512307
M1	cpdb	0	network_modules	40	TRUE	6.864056957594605e-4	145	53	7	0.1320754716981132	0.04827586206896552	GO:0045444	GO:BP	fat cell differentiation	16175	11377		0.7176470588235294	0.7209302325581395	145	16030	7	46	138	15984	16175	0.07488915569269758
M1	cpdb	0	network_modules	40	TRUE	7.288231578754822e-4	90	53	6	0.11320754716981132	0.06666666666666667	GO:0045598	GO:BP	regulation of fat cell differentiation	16175	11449		0.7294117647058823	0.7325581395348837	90	16085	6	47	84	16038	16175	0.08297139754966379
M1	cpdb	0	network_modules	40	TRUE	8.870809522165254e-4	744	53	13	0.24528301886792453	0.01747311827956989	GO:0072359	GO:BP	circulatory system development	16175	17370		0.7411764705882353	0.7441860465116279	744	15431	13	40	731	15391	16175	0.05454642505441196
M1	cpdb	0	network_modules	40	TRUE	9.216791961287389e-4	50	53	5	0.09433962264150944	0.1	GO:0048144	GO:BP	fibroblast proliferation	16175	12545		0.7529411764705882	0.7558139534883721	50	16125	5	48	45	16077	16175	0.09424608417737214
M1	cpdb	0	network_modules	40	TRUE	0.0010309147469754142	6	53	3	0.05660377358490566	0.5	GO:0009950	GO:BP	dorsal/ventral axis specification	16175	3788		0.7647058823529411	0.7906976744186046	6	16169	3	50	3	16119	16175	0.167434714734746
M1	cpdb	0	network_modules	40	TRUE	0.0010309147469754142	6	53	3	0.05660377358490566	0.5	GO:2000096	GO:BP	positive regulation of Wnt signaling pathway, planar cell polarity pathway	16175	25447		0.7647058823529411	0.7906976744186046	6	16169	3	50	3	16119	16175	0.167434714734746
M1	cpdb	0	network_modules	40	TRUE	0.0010309147469754142	6	53	3	0.05660377358490566	0.5	GO:0061072	GO:BP	iris morphogenesis	16175	15188		0.7647058823529411	0.7906976744186046	6	16169	3	50	3	16119	16175	0.167434714734746
M1	cpdb	0	network_modules	40	TRUE	0.001282551549490921	99	53	6	0.11320754716981132	0.06060606060606061	GO:0009952	GO:BP	anterior/posterior pattern specification	16175	3790		0.8	0.8023255813953488	99	16076	6	47	93	16029	16175	0.0787232262873607
M1	cpdb	0	network_modules	40	TRUE	0.001307944658436748	770	53	13	0.24528301886792453	0.016883116883116882	GO:0048646	GO:BP	anatomical structure formation involved in morphogenesis	16175	12904		0.8117647058823529	0.813953488372093	770	15405	13	40	757	15365	16175	0.053229992971808575
M1	cpdb	0	network_modules	40	TRUE	0.0015775403270944653	239	53	8	0.1509433962264151	0.03347280334728033	GO:0060485	GO:BP	mesenchyme development	16175	14679		0.8235294117647058	0.8255813953488372	239	15936	8	45	231	15891	16175	0.06470795021300295
M1	cpdb	0	network_modules	40	TRUE	0.0016752624522024012	59	46	5	0.10869565217391304	0.0847457627118644	REAC:R-HSA-4086398	REAC	Ca2+ pathway	10916	296		1	1	59	10857	5	41	54	10816	10916	0.09164486653680917
M1	cpdb	0	network_modules	40	TRUE	0.0019292566993313691	25	53	4	0.07547169811320754	0.16	GO:0061180	GO:BP	mammary gland epithelium development	16175	15277		0.8352941176470589	0.8372093023255814	25	16150	4	49	21	16101	16175	0.10789822777369211
M1	cpdb	0	network_modules	40	TRUE	0.0028338300072975305	179	53	7	0.1320754716981132	0.03910614525139665	GO:0043009	GO:BP	chordate embryonic development	16175	10479		0.8470588235294118	0.8488372093023255	179	15996	7	46	172	15950	16175	0.06632209928050709
M1	cpdb	0	network_modules	40	TRUE	0.002873194904066899	8	53	3	0.05660377358490566	0.375	GO:0070307	GO:BP	lens fiber cell development	16175	16050		0.8588235294117647	0.8604651162790697	8	16167	3	50	5	16117	16175	0.1446928261550928
M1	cpdb	0	network_modules	40	TRUE	0.0030945586883791435	115	53	6	0.11320754716981132	0.05217391304347826	GO:0007369	GO:BP	gastrulation	16175	2871		0.8705882352941177	0.872093023255814	115	16060	6	47	109	16013	16175	0.07240315552552717
M1	cpdb	0	network_modules	40	TRUE	0.00402811539667059	67	53	5	0.09433962264150944	0.07462686567164178	GO:0048736	GO:BP	appendage development	16175	12993		0.8823529411764706	0.8953488372093024	67	16108	5	48	62	16060	16175	0.08052091607103617
M1	cpdb	0	network_modules	40	TRUE	0.00402811539667059	67	53	5	0.09433962264150944	0.07462686567164178	GO:0060173	GO:BP	limb development	16175	14409		0.8823529411764706	0.8953488372093024	67	16108	5	48	62	16060	16175	0.08052091607103617
M1	cpdb	0	network_modules	40	TRUE	0.0042998039956307224	9	53	3	0.05660377358490566	0.3333333333333333	GO:2000095	GO:BP	regulation of Wnt signaling pathway, planar cell polarity pathway	16175	25446		0.9058823529411765	0.9186046511627907	9	16166	3	50	6	16116	16175	0.13627160771349767
M1	cpdb	0	network_modules	40	TRUE	0.0042998039956307224	9	53	3	0.05660377358490566	0.3333333333333333	GO:0061303	GO:BP	cornea development in camera-type eye	16175	15391		0.9058823529411765	0.9186046511627907	9	16166	3	50	6	16116	16175	0.13627160771349767
M1	cpdb	0	network_modules	40	TRUE	0.004300440022124881	593	53	11	0.20754716981132076	0.01854974704890388	GO:0007417	GO:BP	central nervous system development	16175	2912		0.9294117647058824	0.9302325581395349	593	15582	11	42	582	15540	16175	0.052136206334999206
M1	cpdb	0	network_modules	40	TRUE	0.004729448127611655	31	53	4	0.07547169811320754	0.12903225806451613	GO:0099054	GO:BP	presynapse assembly	16175	19026		0.9411764705882353	0.9418604651162791	31	16144	4	49	27	16095	16175	0.09642718538928108
M1	cpdb	0	network_modules	40	TRUE	0.004839183004289591	194	53	7	0.1320754716981132	0.03608247422680412	GO:0009792	GO:BP	embryo development ending in birth or egg hatching	16175	3679		0.9529411764705882	0.9534883720930233	194	15981	7	46	187	15935	16175	0.06324796934863856
M1	cpdb	0	network_modules	40	TRUE	0.0053919990923193845	32	53	4	0.07547169811320754	0.125	GO:0099172	GO:BP	presynapse organization	16175	19080		0.9647058823529412	0.9651162790697675	32	16143	4	49	28	16094	16175	0.09483171770279841
M1	cpdb	0	network_modules	40	TRUE	0.007209809541005921	504	53	10	0.18867924528301888	0.01984126984126984	GO:0001944	GO:BP	vasculature development	16175	555		0.9764705882352941	0.9767441860465116	504	15671	10	43	494	15628	16175	0.05198104192704731
M1	cpdb	0	network_modules	40	TRUE	0.00856888874050758	78	53	5	0.09433962264150944	0.0641025641025641	GO:0046330	GO:BP	positive regulation of JNK cascade	16175	12063		0.9882352941176471	0.9883720930232558	78	16097	5	48	73	16049	16175	0.07409011818384499
M1	cpdb	0	network_modules	40	TRUE	0.009709579227454189	80	53	5	0.09433962264150944	0.0625	GO:0061351	GO:BP	neural precursor cell proliferation	16175	15426		1	1	80	16095	5	48	75	16047	16175	0.0730616177962152
M1	cpdb	0	network_modules	41	TRUE	4.0758005284442315e-11	558	50	18	0.36	0.03225806451612903	GO:0055086	GO:BP	nucleobase-containing small molecule metabolic process	16175	14237		0	0.02127659574468085	558	15617	18	32	540	15585	16175	0.09931563218695709
M1	cpdb	0	network_modules	41	TRUE	6.140005329168505e-10	126	40	11	0.275	0.0873015873015873	KEGG:00230	KEGG	Purine metabolism	8484	22		0	0.1111111111111111	126	8358	11	29	115	8329	8484	0.14802717061955398
M1	cpdb	0	network_modules	41	TRUE	1.3057875906532962e-9	13	42	6	0.14285714285714285	0.46153846153846156	REAC:R-HSA-74217	REAC	Purine salvage	10916	1825		0	0.1	13	10903	6	36	7	10867	10916	0.2552790433482427
M1	cpdb	0	network_modules	41	TRUE	6.512946428446326e-9	115	40	10	0.25	0.08695652173913043	KEGG:01200	KEGG	Carbon metabolism	8484	184		0.125	0.2222222222222222	115	8369	10	30	105	8339	8484	0.14073467285825128
M1	cpdb	0	network_modules	41	TRUE	1.6044458827603638e-8	91	42	9	0.21428571428571427	0.0989010989010989	REAC:R-HSA-15869	REAC	Metabolism of nucleotides	10916	1432		0.1111111111111111	0.2	91	10825	9	33	82	10792	10916	0.1407729582116713
M1	cpdb	0	network_modules	41	TRUE	2.2031553564287762e-8	8	50	5	0.1	0.625	GO:0043101	GO:BP	purine-containing compound salvage	16175	10530		0.021739130434782608	0.0425531914893617	8	16167	5	45	3	16122	16175	0.24921054151978198
M1	cpdb	0	network_modules	41	TRUE	4.6871844436423946e-8	521	50	15	0.3	0.028790786948176585	GO:0006753	GO:BP	nucleoside phosphate metabolic process	16175	2450		0.043478260869565216	0.06382978723404255	521	15654	15	35	506	15619	16175	0.08445822168213306
M1	cpdb	0	network_modules	41	TRUE	6.02768176995608e-8	742	50	17	0.34	0.022911051212938006	GO:0019752	GO:BP	carboxylic acid metabolic process	16175	6036		0.06521739130434782	0.0851063829787234	742	15433	17	33	725	15400	16175	0.07828648729110642
M1	cpdb	0	network_modules	41	TRUE	6.5727919551233e-8	4	42	4	0.09523809523809523	1	REAC:R-HSA-9735804	REAC	Diseases of nucleotide metabolism	10916	770		0.2222222222222222	0.3	4	10912	4	38	0	10874	10916	0.30806888458325865
M1	cpdb	0	network_modules	41	TRUE	7.466980363056646e-8	23	42	6	0.14285714285714285	0.2608695652173913	REAC:R-HSA-8956321	REAC	Nucleotide salvage	10916	1626		0.3333333333333333	0.4	23	10893	6	36	17	10857	10916	0.19076763064448068
M1	cpdb	0	network_modules	41	TRUE	8.959349643612118e-8	761	50	17	0.34	0.022339027595269383	GO:0043436	GO:BP	oxoacid metabolic process	16175	10693		0.08695652173913043	0.10638297872340426	761	15414	17	33	744	15381	16175	0.07704172881123363
M1	cpdb	0	network_modules	41	TRUE	1.0130723198030912e-7	767	50	17	0.34	0.02216427640156454	GO:0006082	GO:BP	organic acid metabolic process	16175	1947		0.10869565217391304	0.1276595744680851	767	15408	17	33	750	15375	16175	0.07665755200108626
M1	cpdb	0	network_modules	41	TRUE	1.5234480488101208e-7	469	50	14	0.28	0.029850746268656716	GO:0072521	GO:BP	purine-containing compound metabolic process	16175	17423		0.13043478260869565	0.14893617021276595	469	15706	14	36	455	15670	16175	0.08329941591049915
M1	cpdb	0	network_modules	41	TRUE	1.8678107314262127e-7	25	50	6	0.12	0.24	GO:0043094	GO:BP	cellular metabolic compound salvage	16175	10523		0.15217391304347827	0.1702127659574468	25	16150	6	44	19	16106	16175	0.1679091555935046
M1	cpdb	0	network_modules	41	TRUE	1.952924737341275e-7	388	50	13	0.26	0.03350515463917526	GO:0009117	GO:BP	nucleotide metabolic process	16175	3286		0.17391304347826086	0.19148936170212766	388	15787	13	37	375	15750	16175	0.08589117005320188
M1	cpdb	0	network_modules	41	TRUE	1.9690803112309137e-7	50	40	7	0.175	0.14	KEGG:00270	KEGG	Cysteine and methionine metabolism	8484	30		0.25	0.3333333333333333	50	8434	7	33	43	8401	8484	0.15206006827369745
M1	cpdb	0	network_modules	41	TRUE	2.9994813130613415e-7	84	40	8	0.2	0.09523809523809523	KEGG:01232	KEGG	Nucleotide metabolism	8484	189		0.375	0.4444444444444444	84	8400	8	32	76	8368	8484	0.13214694030626273
M1	cpdb	0	network_modules	41	TRUE	3.9456012659495106e-7	28	50	6	0.12	0.21428571428571427	GO:0009161	GO:BP	ribonucleoside monophosphate metabolic process	16175	3327		0.1956521739130435	0.2127659574468085	28	16147	6	44	22	16103	16175	0.15842553128966094
M1	cpdb	0	network_modules	41	TRUE	7.767326176547712e-7	14	50	5	0.1	0.35714285714285715	GO:0006144	GO:BP	purine nucleobase metabolic process	16175	1988		0.21739130434782608	0.23404255319148937	14	16161	5	45	9	16116	16175	0.18771802305398688
M1	cpdb	0	network_modules	41	TRUE	8.45175188625662e-7	349	50	12	0.24	0.034383954154727794	GO:0006163	GO:BP	purine nucleotide metabolic process	16175	1998		0.2391304347826087	0.2553191489361702	349	15826	12	38	337	15788	16175	0.08371060559093664
M1	cpdb	0	network_modules	41	TRUE	1.1464902261754166e-6	33	50	6	0.12	0.18181818181818182	GO:0009123	GO:BP	nucleoside monophosphate metabolic process	16175	3290		0.2608695652173913	0.2765957446808511	33	16142	6	44	27	16098	16175	0.14557200693217864
M1	cpdb	0	network_modules	41	TRUE	5.932013142397727e-6	20	50	5	0.1	0.25	GO:0009156	GO:BP	ribonucleoside monophosphate biosynthetic process	16175	3323		0.2826086956521739	0.2978723404255319	20	16155	5	45	15	16110	16175	0.1564975447266629
M1	cpdb	0	network_modules	41	TRUE	9.749522572969365e-6	260	50	10	0.2	0.038461538461538464	GO:1901293	GO:BP	nucleoside phosphate biosynthetic process	16175	21368		0.30434782608695654	0.3191489361702128	260	15915	10	40	250	15875	16175	0.08143894052753524
M1	cpdb	0	network_modules	41	TRUE	1.0029029619783409e-5	22	50	5	0.1	0.22727272727272727	GO:0009167	GO:BP	purine ribonucleoside monophosphate metabolic process	16175	3333		0.32608695652173914	0.3617021276595745	22	16153	5	45	17	16108	16175	0.14903696984686937
M1	cpdb	0	network_modules	41	TRUE	1.0029029619783409e-5	22	50	5	0.1	0.22727272727272727	GO:0009112	GO:BP	nucleobase metabolic process	16175	3281		0.32608695652173914	0.3617021276595745	22	16153	5	45	17	16108	16175	0.14903696984686937
M1	cpdb	0	network_modules	41	TRUE	1.2785159052691845e-5	23	50	5	0.1	0.21739130434782608	GO:0009124	GO:BP	nucleoside monophosphate biosynthetic process	16175	3291		0.3695652173913043	0.40425531914893614	23	16152	5	45	18	16107	16175	0.14567418368682758
M1	cpdb	0	network_modules	41	TRUE	1.2785159052691845e-5	23	50	5	0.1	0.21739130434782608	GO:0009126	GO:BP	purine nucleoside monophosphate metabolic process	16175	3293		0.3695652173913043	0.40425531914893614	23	16152	5	45	18	16107	16175	0.14567418368682758
M1	cpdb	0	network_modules	41	TRUE	1.7349418015930805e-5	9	50	4	0.08	0.4444444444444444	GO:0009113	GO:BP	purine nucleobase biosynthetic process	16175	3282		0.41304347826086957	0.425531914893617	9	16166	4	46	5	16120	16175	0.18759261017003515
M1	cpdb	0	network_modules	41	TRUE	1.839202015545145e-5	3	42	3	0.07142857142857142	1	REAC:R-HSA-9734207	REAC	Nucleotide salvage defects	10916	1627		0.4444444444444444	0.5	3	10913	3	39	0	10874	10916	0.2667832561385996
M1	cpdb	0	network_modules	41	TRUE	2.0738957909777084e-5	143	50	8	0.16	0.055944055944055944	GO:0072524	GO:BP	pyridine-containing compound metabolic process	16175	17426		0.43478260869565216	0.44680851063829785	143	16032	8	42	135	15990	16175	0.089919137631371715
M1	cpdb	0	network_modules	41	TRUE	2.142670690225526e-5	31	40	5	0.125	0.16129032258064516	KEGG:00030	KEGG	Pentose phosphate pathway	8484	4		0.5	0.5555555555555556	31	8453	5	35	26	8418	8484	0.13841907825073624
M1	cpdb	0	network_modules	41	TRUE	3.198748557581607e-5	482	50	12	0.24	0.024896265560165973	GO:0044283	GO:BP	small molecule biosynthetic process	16175	10950		0.45652173913043476	0.46808510638297873	482	15693	12	38	470	15655	16175	0.06883947524022013
M1	cpdb	0	network_modules	41	TRUE	3.3852903046785123e-5	288	42	10	0.23809523809523808	0.034722222222222224	REAC:R-HSA-71387	REAC	Metabolism of carbohydrates	10916	1422		0.5555555555555556	0.6	288	10628	10	32	278	10596	10916	0.08209502856474782
M1	cpdb	0	network_modules	41	TRUE	3.812451438206897e-5	300	50	10	0.2	0.03333333333333333	GO:0044282	GO:BP	small molecule catabolic process	16175	10949		0.4782608695652174	0.48936170212765956	300	15875	10	40	290	15835	16175	0.07489033128837537
M1	cpdb	0	network_modules	41	TRUE	4.6044131294262255e-5	67	40	6	0.15	0.08955223880597014	KEGG:00010	KEGG	Glycolysis / Gluconeogenesis	8484	2		0.625	0.6666666666666666	67	8417	6	34	61	8383	8484	0.11049510977691945
M1	cpdb	0	network_modules	41	TRUE	4.792112593593614e-5	3	50	3	0.06	1	GO:0043096	GO:BP	purine nucleobase salvage	16175	10525		0.5	0.5106382978723404	3	16172	3	47	0	16125	16175	0.24459277286182327
M1	cpdb	0	network_modules	41	TRUE	1.3627078415817133e-4	14	50	4	0.08	0.2857142857142857	GO:0046128	GO:BP	purine ribonucleoside metabolic process	16175	11904		0.5217391304347826	0.574468085106383	14	16161	4	46	10	16115	16175	0.14984662894237805
M1	cpdb	0	network_modules	41	TRUE	1.3627078415817133e-4	14	50	4	0.08	0.2857142857142857	GO:0046112	GO:BP	nucleobase biosynthetic process	16175	11888		0.5217391304347826	0.574468085106383	14	16161	4	46	10	16115	16175	0.14984662894237805
M1	cpdb	0	network_modules	41	TRUE	1.3627078415817133e-4	14	50	4	0.08	0.2857142857142857	GO:0009168	GO:BP	purine ribonucleoside monophosphate biosynthetic process	16175	3334		0.5217391304347826	0.574468085106383	14	16161	4	46	10	16115	16175	0.14984662894237805
M1	cpdb	0	network_modules	41	TRUE	1.8306172561041625e-4	47	40	5	0.125	0.10638297872340426	KEGG:00620	KEGG	Pyruvate metabolism	8484	99		0.75	0.7777777777777778	47	8437	5	35	42	8402	8484	0.11077370531629664
M1	cpdb	0	network_modules	41	TRUE	1.8540110666466389e-4	15	50	4	0.08	0.26666666666666666	GO:0009127	GO:BP	purine nucleoside monophosphate biosynthetic process	16175	3294		0.5869565217391305	0.5957446808510638	15	16160	4	46	11	16114	16175	0.14465697438576008
M1	cpdb	0	network_modules	41	TRUE	4.1279491590316697e-4	18	50	4	0.08	0.2222222222222222	GO:0042278	GO:BP	purine nucleoside metabolic process	16175	10074		0.6086956521739131	0.6170212765957447	18	16157	4	46	14	16111	16175	0.13175563543178095
M1	cpdb	0	network_modules	41	TRUE	0.00047712456924234287	5	50	3	0.06	0.6	GO:0046129	GO:BP	purine ribonucleoside biosynthetic process	16175	11905		0.6304347826086957	0.6808510638297872	5	16170	3	47	2	16123	16175	0.18908078927926142
M1	cpdb	0	network_modules	41	TRUE	0.00047712456924234287	5	50	3	0.06	0.6	GO:0042455	GO:BP	ribonucleoside biosynthetic process	16175	10194		0.6304347826086957	0.6808510638297872	5	16170	3	47	2	16123	16175	0.18908078927926142
M1	cpdb	0	network_modules	41	TRUE	0.00047712456924234287	5	50	3	0.06	0.6	GO:0042451	GO:BP	purine nucleoside biosynthetic process	16175	10190		0.6304347826086957	0.6808510638297872	5	16170	3	47	2	16123	16175	0.18908078927926142
M1	cpdb	0	network_modules	41	TRUE	5.840870246055058e-4	220	50	8	0.16	0.03636363636363636	GO:0072522	GO:BP	purine-containing compound biosynthetic process	16175	17424		0.6956521739130435	0.7021276595744681	220	15955	8	42	212	15913	16175	0.0703812691347338
M1	cpdb	0	network_modules	41	TRUE	6.044847476283911e-4	512	50	11	0.22	0.021484375	GO:0090407	GO:BP	organophosphate biosynthetic process	16175	18274		0.717391304347826	0.723404255319149	512	15663	11	39	501	15624	16175	0.05990510980008447
M1	cpdb	0	network_modules	41	TRUE	6.506224970306233e-4	20	50	4	0.08	0.2	GO:0009119	GO:BP	ribonucleoside metabolic process	16175	3288		0.7391304347826086	0.7446808510638298	20	16155	4	46	16	16109	16175	0.12480617964429956
M1	cpdb	0	network_modules	41	TRUE	9.521695684108542e-4	6	50	3	0.06	0.5	GO:0032261	GO:BP	purine nucleotide salvage	16175	7447		0.7608695652173914	0.7659574468085106	6	16169	3	47	3	16122	16175	0.17243291369744793
M1	cpdb	0	network_modules	41	TRUE	0.0017164976027694277	36	40	4	0.1	0.1111111111111111	KEGG:00350	KEGG	Tyrosine metabolism	8484	41		0.875	0.8888888888888888	36	8448	4	36	32	8412	8484	0.10139057712322193
M1	cpdb	0	network_modules	41	TRUE	0.0019324614052999257	177	50	7	0.14	0.03954802259887006	GO:1901605	GO:BP	alpha-amino acid metabolic process	16175	21589		0.782608695652174	0.7872340425531915	177	15998	7	43	170	15955	16175	0.06907838018413949
M1	cpdb	0	network_modules	41	TRUE	0.0020696243158291384	61	50	5	0.1	0.08196721311475409	GO:1901657	GO:BP	glycosyl compound metabolic process	16175	21624		0.8043478260869565	0.8085106382978723	61	16114	5	45	56	16069	16175	0.08742138212597679
M1	cpdb	0	network_modules	41	TRUE	0.00248067187018224	33	42	4	0.09523809523809523	0.12121212121212122	REAC:R-HSA-70263	REAC	Gluconeogenesis	10916	1052		0.6666666666666666	0.7	33	10883	4	38	29	10845	10916	0.10439118808622797
M1	cpdb	0	network_modules	41	TRUE	0.0026934619243760855	186	50	7	0.14	0.03763440860215054	GO:0009165	GO:BP	nucleotide biosynthetic process	16175	3331		0.8260869565217391	0.8297872340425532	186	15989	7	43	179	15946	16175	0.06711476069303532
M1	cpdb	0	network_modules	41	TRUE	0.0029702435984091478	11	42	3	0.07142857142857142	0.2727272727272727	REAC:R-HSA-9755088	REAC	Ribavirin ADME	10916	2105		0.7777777777777778	0.8	11	10905	3	39	8	10866	10916	0.13793858143023754
M1	cpdb	0	network_modules	41	TRUE	0.003973028667071805	9	50	3	0.06	0.3333333333333333	GO:0043173	GO:BP	nucleotide salvage	16175	10568		0.8478260869565217	0.851063829787234	9	16166	3	47	6	16119	16175	0.140365988076645
M1	cpdb	0	network_modules	41	TRUE	0.005907446977448863	49	40	4	0.1	0.08163265306122448	KEGG:00520	KEGG	Amino sugar and nucleotide sugar metabolism	8484	69		1	1	49	8435	4	36	45	8399	8484	0.08558141125135628
M1	cpdb	0	network_modules	41	TRUE	0.006032401257934902	34	50	4	0.08	0.11764705882352941	GO:0009066	GO:BP	aspartate family amino acid metabolic process	16175	3242		0.8695652173913043	0.8723404255319149	34	16141	4	46	30	16095	16175	0.09471112784910266
M1	cpdb	0	network_modules	41	TRUE	0.006226793392584072	211	50	7	0.14	0.03317535545023697	GO:0046395	GO:BP	carboxylic acid catabolic process	16175	12121		0.8913043478260869	0.9148936170212766	211	15964	7	43	204	15921	16175	0.06230426262740866
M1	cpdb	0	network_modules	41	TRUE	0.006226793392584072	211	50	7	0.14	0.03317535545023697	GO:0016054	GO:BP	organic acid catabolic process	16175	5086		0.8913043478260869	0.9148936170212766	211	15964	7	43	204	15921	16175	0.06230426262740866
M1	cpdb	0	network_modules	41	TRUE	0.006338752155476053	86	42	5	0.11904761904761904	0.05813953488372093	REAC:R-HSA-70326	REAC	Glucose metabolism	10916	1053		0.8888888888888888	0.9	86	10830	5	37	81	10793	10916	0.0781474531167535
M1	cpdb	0	network_modules	41	TRUE	0.006959427036129939	138	50	6	0.12	0.043478260869565216	GO:0046496	GO:BP	nicotinamide nucleotide metabolic process	16175	12199		0.9347826086956522	0.9787234042553191	138	16037	6	44	132	15993	16175	0.0674884974854528
M1	cpdb	0	network_modules	41	TRUE	0.006959427036129939	138	50	6	0.12	0.043478260869565216	GO:0019362	GO:BP	pyridine nucleotide metabolic process	16175	5724		0.9347826086956522	0.9787234042553191	138	16037	6	44	132	15993	16175	0.0674884974854528
M1	cpdb	0	network_modules	41	TRUE	0.006959427036129939	138	50	6	0.12	0.043478260869565216	GO:0170039	GO:BP	proteinogenic amino acid metabolic process	16175	20287		0.9347826086956522	0.9787234042553191	138	16037	6	44	132	15993	16175	0.0674884974854528
M1	cpdb	0	network_modules	41	TRUE	0.008103298900048324	15	42	3	0.07142857142857142	0.2	REAC:R-HSA-71336	REAC	Pentose phosphate pathway	10916	1721		1	1	15	10901	3	39	12	10862	10916	0.11753044618573422
M1	cpdb	0	network_modules	41	TRUE	0.008900321815198734	144	50	6	0.12	0.041666666666666664	GO:0170033	GO:BP	L-amino acid metabolic process	16175	20281		1	1	144	16031	6	44	138	15987	16175	0.06585999061934532
M1	cpdb	0	network_modules	42	TRUE	6.538627233008289e-40	226	46	29	0.6304347826086957	0.12831858407079647	GO:0006402	GO:BP	mRNA catabolic process	16175	2163		0	0.02127659574468085	226	15949	29	17	197	15932	16175	0.2804821782972638
M1	cpdb	0	network_modules	42	TRUE	4.033344220458183e-37	279	46	29	0.6304347826086957	0.1039426523297491	GO:0006401	GO:BP	RNA catabolic process	16175	2162		0.021739130434782608	0.0425531914893617	279	15896	29	17	250	15879	16175	0.25151601587138317
M1	cpdb	0	network_modules	42	TRUE	3.265166668762236e-36	299	46	29	0.6304347826086957	0.09698996655518395	GO:0141188	GO:BP	nucleic acid catabolic process	16175	20075		0.043478260869565216	0.06382978723404255	299	15876	29	17	270	15859	16175	0.2426212885542924
M1	cpdb	0	network_modules	42	TRUE	5.269259553645406e-33	113	46	22	0.4782608695652174	0.19469026548672566	GO:0000956	GO:BP	nuclear-transcribed mRNA catabolic process	16175	264		0.06521739130434782	0.0851063829787234	113	16062	22	24	91	16038	16175	0.3021723005150866
M1	cpdb	0	network_modules	42	TRUE	2.3557099183141485e-32	97	46	21	0.45652173913043476	0.21649484536082475	GO:0061014	GO:BP	positive regulation of mRNA catabolic process	16175	15137		0.08695652173913043	0.10638297872340426	97	16078	21	25	76	16053	16175	0.3116279026115147
M1	cpdb	0	network_modules	42	TRUE	5.577517388362817e-31	448	46	29	0.6304347826086957	0.06473214285714286	GO:0034655	GO:BP	nucleobase-containing compound catabolic process	16175	8711		0.10869565217391304	0.1276595744680851	448	15727	29	17	419	15710	16175	0.19614891232168896
M1	cpdb	0	network_modules	42	TRUE	1.0728361000357503e-30	172	46	23	0.5	0.13372093023255813	GO:0061013	GO:BP	regulation of mRNA catabolic process	16175	15136		0.13043478260869565	0.14893617021276595	172	16003	23	23	149	15980	16175	0.2547936627834579
M1	cpdb	0	network_modules	42	TRUE	1.2262093813638294e-30	92	46	20	0.43478260869565216	0.21739130434782608	GO:0061157	GO:BP	mRNA destabilization	16175	15262		0.15217391304347827	0.1702127659574468	92	16083	20	26	72	16057	16175	0.3047160361632171
M1	cpdb	0	network_modules	42	TRUE	2.5019377486523452e-30	95	46	20	0.43478260869565216	0.21052631578947367	GO:0050779	GO:BP	RNA destabilization	16175	13253		0.17391304347826086	0.19148936170212766	95	16080	20	26	75	16054	16175	0.2997644799135876
M1	cpdb	0	network_modules	42	TRUE	8.09686527025769e-30	125	46	21	0.45652173913043476	0.168	GO:1903313	GO:BP	positive regulation of mRNA metabolic process	16175	22897		0.1956521739130435	0.2127659574468085	125	16050	21	25	104	16025	16175	0.2736993543828156
M1	cpdb	0	network_modules	42	TRUE	1.1255078440630335e-29	156	46	22	0.4782608695652174	0.14102564102564102	GO:0043488	GO:BP	regulation of mRNA stability	16175	10733		0.21739130434782608	0.23404255319148937	156	16019	22	24	134	15995	16175	0.25606895393663337
M1	cpdb	0	network_modules	42	TRUE	5.521612855664004e-29	167	46	22	0.4782608695652174	0.1317365269461078	GO:0043487	GO:BP	regulation of RNA stability	16175	10732		0.2391304347826087	0.2553191489361702	167	16008	22	24	145	15984	16175	0.24721763222866305
M1	cpdb	0	network_modules	42	TRUE	4.1178517088253255e-28	57	46	17	0.3695652173913043	0.2982456140350877	GO:0000288	GO:BP	nuclear-transcribed mRNA catabolic process, deadenylation-dependent decay	16175	81		0.2608695652173913	0.2765957446808511	57	16118	17	29	40	16089	16175	0.3298804080430881
M1	cpdb	0	network_modules	42	TRUE	7.788793335656979e-28	434	46	27	0.5869565217391305	0.06221198156682028	GO:0010608	GO:BP	post-transcriptional regulation of gene expression	16175	4255		0.2826086956521739	0.2978723404255319	434	15741	27	19	407	15722	16175	0.18511576683379136
M1	cpdb	0	network_modules	42	TRUE	1.7694683082124717e-27	590	46	29	0.6304347826086957	0.04915254237288136	GO:0016071	GO:BP	mRNA metabolic process	16175	5098		0.30434782608695654	0.3191489361702128	590	15585	29	17	561	15568	16175	0.16919843896434145
M1	cpdb	0	network_modules	42	TRUE	3.0778103357960847e-26	56	27	15	0.5555555555555556	0.26785714285714285	REAC:R-HSA-429914	REAC	Deadenylation-dependent mRNA decay	10916	454		0	0.09090909090909091	56	10860	15	12	41	10848	10916	0.3836551276025053
M1	cpdb	0	network_modules	42	TRUE	6.905075816567369e-26	273	46	23	0.5	0.08424908424908426	GO:1903311	GO:BP	regulation of mRNA metabolic process	16175	22895		0.32608695652173914	0.3404255319148936	273	15902	23	23	250	15879	16175	0.20029457766303715
M1	cpdb	0	network_modules	42	TRUE	1.1500491352232004e-25	31	46	14	0.30434782608695654	0.45161290322580644	GO:0000289	GO:BP	nuclear-transcribed mRNA poly(A) tail shortening	16175	82		0.34782608695652173	0.3617021276595745	31	16144	14	32	17	16112	16175	0.369283397031499
M1	cpdb	0	network_modules	42	TRUE	4.797823837082281e-24	25	27	12	0.4444444444444444	0.48	REAC:R-HSA-429947	REAC	Deadenylation of mRNA	10916	453		0.1	0.18181818181818182	25	10891	12	15	13	10876	10916	0.4605972166954403
M1	cpdb	0	network_modules	42	TRUE	1.225021310144762e-21	79	24	14	0.5833333333333334	0.17721518987341772	KEGG:03018	KEGG	RNA degradation	8484	211		0	0.5	79	8405	14	10	65	8395	8484	0.3183222501035074
M1	cpdb	0	network_modules	42	TRUE	1.4241754641428192e-19	21	27	10	0.37037037037037035	0.47619047619047616	REAC:R-HSA-6804115	REAC	TP53 regulates transcription of additional cell cycle genes whose exact role in the p53 pathway remain uncertain	10916	2461		0.2	0.2727272727272727	21	10895	10	17	11	10878	10916	0.4186997345080272
M1	cpdb	0	network_modules	42	TRUE	1.3123682092673653e-18	25	27	10	0.37037037037037035	0.4	REAC:R-HSA-9820841	REAC	M-decay: degradation of maternal mRNAs by maternally stored factors	10916	1344		0.3	0.36363636363636365	25	10891	10	17	15	10874	10916	0.38343338975885605
M1	cpdb	0	network_modules	42	TRUE	2.962241255856824e-17	477	46	21	0.45652173913043476	0.0440251572327044	GO:0009896	GO:BP	positive regulation of catabolic process	16175	3756		0.3695652173913043	0.3829787234042553	477	15698	21	25	456	15673	16175	0.13480262046380592
M1	cpdb	0	network_modules	42	TRUE	3.1887495486499585e-15	49	27	10	0.37037037037037035	0.20408163265306123	REAC:R-HSA-6791312	REAC	TP53 Regulates Transcription of Cell Cycle Genes	10916	2454		0.4	0.45454545454545453	49	10867	10	17	39	10850	10916	0.2725455169921967
M1	cpdb	0	network_modules	42	TRUE	6.1688190208274726e-15	112	46	13	0.2826086956521739	0.11607142857142858	GO:0031047	GO:BP	regulatory ncRNA-mediated gene silencing	16175	7011		0.391304347826087	0.40425531914893614	112	16063	13	33	99	16030	16175	0.17754538245611523
M1	cpdb	0	network_modules	42	TRUE	2.2099400485167865e-14	62	46	11	0.2391304347826087	0.1774193548387097	GO:0035194	GO:BP	regulatory ncRNA-mediated post-transcriptional gene silencing	16175	8883		0.41304347826086957	0.425531914893617	62	16113	11	35	51	16078	16175	0.20335389193242323
M1	cpdb	0	network_modules	42	TRUE	5.532038379308071e-14	67	46	11	0.2391304347826087	0.16417910447761194	GO:0016441	GO:BP	post-transcriptional gene silencing	16175	5222		0.43478260869565216	0.44680851063829785	67	16108	11	35	56	16073	16175	0.19539228016505805
M1	cpdb	0	network_modules	42	TRUE	2.0466586464221917e-13	50	46	10	0.21739130434782608	0.2	GO:0035195	GO:BP	miRNA-mediated post-transcriptional gene silencing	16175	8884		0.45652173913043476	0.46808510638297873	50	16125	10	36	40	16089	16175	0.2061612424944052
M1	cpdb	0	network_modules	42	TRUE	5.824735578366695e-13	119	27	11	0.4074074074074074	0.09243697478991597	REAC:R-HSA-9816359	REAC	Maternal to zygotic transition (MZT)	10916	1394		0.5	0.5454545454545454	119	10797	11	16	108	10781	10916	0.19014115101019438
M1	cpdb	0	network_modules	42	TRUE	4.766359896044852e-9	359	27	12	0.4444444444444444	0.033426183844011144	REAC:R-HSA-3700989	REAC	Transcriptional Regulation by TP53	10916	2546		0.6	0.6363636363636364	359	10557	12	15	347	10542	10916	0.11491159544145128
M1	cpdb	0	network_modules	42	TRUE	8.137907697148361e-9	17	46	6	0.13043478260869565	0.35294117647058826	GO:0033962	GO:BP	P-body assembly	16175	8367		0.4782608695652174	0.48936170212765956	17	16158	6	40	11	16118	16175	0.21324607677168111
M1	cpdb	0	network_modules	42	TRUE	3.558247858909614e-8	110	46	9	0.1956521739130435	0.08181818181818182	GO:0017148	GO:BP	negative regulation of translation	16175	5285		0.5	0.5106382978723404	110	16065	9	37	101	16028	16175	0.12271660826389938
M1	cpdb	0	network_modules	42	TRUE	1.0220859143391175e-7	4	46	4	0.08695652173913043	1	GO:0010606	GO:BP	positive regulation of cytoplasmic mRNA processing body assembly	16175	4253		0.5217391304347826	0.5319148936170213	4	16171	4	42	0	16129	16175	0.2945007209002209
M1	cpdb	0	network_modules	42	TRUE	3.359151526253351e-7	13	46	5	0.10869565217391304	0.38461538461538464	GO:0060213	GO:BP	positive regulation of nuclear-transcribed mRNA poly(A) tail shortening	16175	14437		0.5434782608695652	0.5531914893617021	13	16162	5	41	8	16121	16175	0.2033242926544877
M1	cpdb	0	network_modules	42	TRUE	5.099811153934843e-7	5	46	4	0.08695652173913043	0.8	GO:0010603	GO:BP	regulation of cytoplasmic mRNA processing body assembly	16175	4250		0.5652173913043478	0.574468085106383	5	16170	4	42	1	16128	16175	0.2632297802984323
M1	cpdb	0	network_modules	42	TRUE	6.950239810206067e-7	290	46	11	0.2391304347826087	0.03793103448275862	GO:0006417	GO:BP	regulation of translation	16175	2174		0.5869565217391305	0.5957446808510638	290	15885	11	35	279	15850	16175	0.08902561991291895
M1	cpdb	0	network_modules	42	TRUE	7.804934423649805e-7	15	46	5	0.10869565217391304	0.3333333333333333	GO:0060211	GO:BP	regulation of nuclear-transcribed mRNA poly(A) tail shortening	16175	14435		0.6086956521739131	0.6595744680851063	15	16160	5	41	10	16119	16175	0.1890793884610999
M1	cpdb	0	network_modules	42	TRUE	7.804934423649805e-7	15	46	5	0.10869565217391304	0.3333333333333333	GO:0110156	GO:BP	mRNA methylguanosine-cap decapping	16175	19450		0.6086956521739131	0.6595744680851063	15	16160	5	41	10	16119	16175	0.1890793884610999
M1	cpdb	0	network_modules	42	TRUE	7.804934423649805e-7	15	46	5	0.10869565217391304	0.3333333333333333	GO:1900153	GO:BP	positive regulation of nuclear-transcribed mRNA catabolic process, deadenylation-dependent decay	16175	20437		0.6086956521739131	0.6595744680851063	15	16160	5	41	10	16119	16175	0.1890793884610999
M1	cpdb	0	network_modules	42	TRUE	2.212777547676677e-6	18	46	5	0.10869565217391304	0.2777777777777778	GO:0110154	GO:BP	RNA decapping	16175	19448		0.6739130434782609	0.6808510638297872	18	16157	5	41	13	16116	16175	0.1723240163831224
M1	cpdb	0	network_modules	42	TRUE	1.6703371885739033e-5	26	46	5	0.10869565217391304	0.19230769230769232	GO:1900151	GO:BP	regulation of nuclear-transcribed mRNA catabolic process, deadenylation-dependent decay	16175	20435		0.6956521739130435	0.7021276595744681	26	16149	5	41	21	16108	16175	0.14275842465361757
M1	cpdb	0	network_modules	42	TRUE	2.1197629574214075e-5	10	46	4	0.08695652173913043	0.4	GO:0000290	GO:BP	deadenylation-dependent decapping of nuclear-transcribed mRNA	16175	83		0.717391304347826	0.723404255319149	10	16165	4	42	6	16123	16175	0.1854962101392946
M1	cpdb	0	network_modules	42	TRUE	7.026836165506569e-5	566	46	12	0.2608695652173913	0.02120141342756184	GO:0006412	GO:BP	translation	16175	2170		0.7391304347826086	0.7446808510638298	566	15609	12	34	554	15575	16175	0.06564419139213759
M1	cpdb	0	network_modules	42	TRUE	1.2682622012437052e-4	76	46	6	0.13043478260869565	0.07894736842105263	GO:0051028	GO:BP	mRNA transport	16175	13445		0.7608695652173914	0.7659574468085106	76	16099	6	40	70	16059	16175	0.09819140579679561
M1	cpdb	0	network_modules	42	TRUE	1.622122334114556e-4	40	46	5	0.10869565217391304	0.125	GO:0035196	GO:BP	miRNA processing	16175	8885		0.782608695652174	0.7872340425531915	40	16135	5	41	35	16094	16175	0.11421478860909336
M1	cpdb	0	network_modules	42	TRUE	3.0378432832439087e-4	18	46	4	0.08695652173913043	0.2222222222222222	GO:0035278	GO:BP	miRNA-mediated gene silencing by inhibition of translation	16175	8938		0.8043478260869565	0.8085106382978723	18	16157	4	42	14	16115	16175	0.13750271183708063
M1	cpdb	0	network_modules	42	TRUE	0.0014271632547119594	114	46	6	0.13043478260869565	0.05263157894736842	GO:0050657	GO:BP	nucleic acid transport	16175	13197		0.8260869565217391	0.851063829787234	114	16061	6	40	108	16021	16175	0.07876798070060774
M1	cpdb	0	network_modules	42	TRUE	0.0014271632547119594	114	46	6	0.13043478260869565	0.05263157894736842	GO:0050658	GO:BP	RNA transport	16175	13198		0.8260869565217391	0.851063829787234	114	16061	6	40	108	16021	16175	0.07876798070060774
M1	cpdb	0	network_modules	42	TRUE	0.0016630487469739945	117	46	6	0.13043478260869565	0.05128205128205128	GO:0051236	GO:BP	establishment of RNA localization	16175	13586		0.8695652173913043	0.8723404255319149	117	16058	6	40	111	16018	16175	0.07764195488617318
M1	cpdb	0	network_modules	42	TRUE	0.0019295739015912658	15	27	3	0.1111111111111111	0.2	REAC:R-HSA-430039	REAC	mRNA decay by 5' to 3' exoribonuclease	10916	2710		0.7	0.7272727272727273	15	10901	3	24	12	10877	10916	0.14751141209150873
M1	cpdb	0	network_modules	42	TRUE	0.0019313906970194977	65	46	5	0.10869565217391304	0.07692307692307693	GO:0070918	GO:BP	regulatory ncRNA processing	16175	16370		0.8913043478260869	0.8936170212765957	65	16110	5	41	60	16069	16175	0.08836224450102272
M1	cpdb	0	network_modules	42	TRUE	0.00266758226061504	116	27	5	0.18518518518518517	0.04310344827586207	REAC:R-HSA-975957	REAC	Nonsense Mediated Decay (NMD) enhanced by the Exon Junction Complex (EJC)	10916	1606		0.8	0.9090909090909091	116	10800	5	22	111	10778	10916	0.08477186605339246
M1	cpdb	0	network_modules	42	TRUE	0.00266758226061504	116	27	5	0.18518518518518517	0.04310344827586207	REAC:R-HSA-927802	REAC	Nonsense-Mediated Decay (NMD)	10916	1608		0.8	0.9090909090909091	116	10800	5	22	111	10778	10916	0.08477186605339246
M1	cpdb	0	network_modules	42	TRUE	0.0028742580728184997	17	27	3	0.1111111111111111	0.17647058823529413	REAC:R-HSA-450513	REAC	Tristetraprolin (TTP, ZFP36) binds and destabilizes mRNA	10916	2608		1	1	17	10899	3	24	14	10875	10916	0.13834419067177614
M1	cpdb	0	network_modules	42	TRUE	0.004548801131702547	10	46	3	0.06521739130434782	0.3	GO:0033147	GO:BP	negative regulation of intracellular estrogen receptor signaling pathway	16175	8061		0.9130434782608695	0.9148936170212766	10	16165	3	43	7	16122	16175	0.1387900893578019
M1	cpdb	0	network_modules	42	TRUE	0.00501763869511359	35	46	4	0.08695652173913043	0.11428571428571428	GO:0000184	GO:BP	nuclear-transcribed mRNA catabolic process, nonsense-mediated decay	16175	57		0.9347826086956522	0.9361702127659575	35	16140	4	42	31	16098	16175	0.09745230218926838
M1	cpdb	0	network_modules	42	TRUE	0.006242136044971485	11	46	3	0.06521739130434782	0.2727272727272727	GO:1900246	GO:BP	positive regulation of RIG-I signaling pathway	16175	20518		0.9565217391304348	0.9574468085106383	11	16164	3	43	8	16121	16175	0.1322086015112548
M1	cpdb	0	network_modules	42	TRUE	0.006818354918581954	149	46	6	0.13043478260869565	0.040268456375838924	GO:0006403	GO:BP	RNA localization	16175	2164		0.9782608695652174	0.9787234042553191	149	16026	6	40	143	15986	16175	0.06776398501249975
M1	cpdb	0	network_modules	42	TRUE	0.008426363993545646	96	24	4	0.16666666666666666	0.041666666666666664	KEGG:03015	KEGG	mRNA surveillance pathway	8484	210		1	1	96	8388	4	20	92	8368	8484	0.07822958424594038
M1	cpdb	0	network_modules	42	TRUE	0.009252217366799447	595	46	10	0.21739130434782608	0.01680672268907563	GO:0051248	GO:BP	negative regulation of protein metabolic process	16175	13595		1	1	595	15580	10	36	585	15544	16175	0.05124007897316881
M1	cpdb	0	network_modules	43	TRUE	1.4533678760080916e-49	92	38	28	0.7368421052631579	0.30434782608695654	REAC:R-HSA-141424	REAC	Amplification of signal from the kinetochores	10916	144		0	0.125	92	10824	28	10	64	10814	10916	0.47094624908915295
M1	cpdb	0	network_modules	43	TRUE	1.4533678760080916e-49	92	38	28	0.7368421052631579	0.30434782608695654	REAC:R-HSA-141444	REAC	Amplification  of signal from unattached  kinetochores via a MAD2  inhibitory signal	10916	143		0	0.125	92	10824	28	10	64	10814	10916	0.47094624908915295
M1	cpdb	0	network_modules	43	TRUE	3.637039907366346e-47	109	38	28	0.7368421052631579	0.25688073394495414	REAC:R-HSA-69618	REAC	Mitotic Spindle Checkpoint	10916	1486		0.13333333333333333	0.1875	109	10807	28	10	81	10797	10916	0.4320796463537165
M1	cpdb	0	network_modules	43	TRUE	2.0157014929938062e-46	115	38	28	0.7368421052631579	0.24347826086956523	REAC:R-HSA-9648025	REAC	EML4 and NUDC in mitotic spindle formation	10916	817		0.2	0.25	115	10801	28	10	87	10791	10916	0.42045564814611586
M1	cpdb	0	network_modules	43	TRUE	1.695683434345829e-45	123	38	28	0.7368421052631579	0.22764227642276422	REAC:R-HSA-2500257	REAC	Resolution of Sister Chromatid Cohesion	10916	2079		0.26666666666666666	0.3125	123	10793	28	10	95	10783	10916	0.4062926916622213
M1	cpdb	0	network_modules	43	TRUE	3.937454055840344e-44	136	38	28	0.7368421052631579	0.20588235294117646	REAC:R-HSA-5663220	REAC	RHO GTPases Activate Formins	10916	1848		0.3333333333333333	0.375	136	10780	28	10	108	10770	10916	0.38598498472421
M1	cpdb	0	network_modules	43	TRUE	7.778430951291935e-40	188	38	28	0.7368421052631579	0.14893617021276595	REAC:R-HSA-2467813	REAC	Separation of Sister Chromatids	10916	2204		0.4	0.4375	188	10728	28	10	160	10718	10916	0.3269230353498581
M1	cpdb	0	network_modules	43	TRUE	4.280099732813381e-39	199	38	28	0.7368421052631579	0.1407035175879397	REAC:R-HSA-68877	REAC	Mitotic Prometaphase	10916	1484		0.4666666666666667	0.5	199	10717	28	10	171	10707	10916	0.3174768774863363
M1	cpdb	0	network_modules	43	TRUE	2.451016490349992e-37	228	38	28	0.7368421052631579	0.12280701754385964	REAC:R-HSA-68882	REAC	Mitotic Anaphase	10916	1479		0.5333333333333333	0.5625	228	10688	28	10	200	10678	10916	0.2959041667853431
M1	cpdb	0	network_modules	43	TRUE	2.7899311454712386e-37	229	38	28	0.7368421052631579	0.1222707423580786	REAC:R-HSA-2555396	REAC	Mitotic Metaphase and Anaphase	10916	1482		0.6	0.625	229	10687	28	10	201	10677	10916	0.29523341364052624
M1	cpdb	0	network_modules	43	TRUE	2.583464904970512e-34	289	38	28	0.7368421052631579	0.09688581314878893	REAC:R-HSA-69620	REAC	Cell Cycle Checkpoints	10916	321		0.6666666666666666	0.6875	289	10627	28	10	261	10617	10916	0.26152272962261425
M1	cpdb	0	network_modules	43	TRUE	4.156634549471005e-33	318	38	28	0.7368421052631579	0.0880503144654088	REAC:R-HSA-195258	REAC	RHO GTPase Effectors	10916	1846		0.7333333333333333	0.75	318	10598	28	10	290	10588	10916	0.24872013999490222
M1	cpdb	0	network_modules	43	TRUE	1.8508666337121027e-31	361	47	28	0.5957446808510638	0.07756232686980609	GO:0007059	GO:BP	chromosome segregation	16175	2658		0	0.012658227848101266	361	15814	28	19	333	15795	16175	0.20955889110941742
M1	cpdb	0	network_modules	43	TRUE	4.7052821002461846e-30	406	38	28	0.7368421052631579	0.06896551724137931	REAC:R-HSA-68886	REAC	M Phase	10916	1343		0.8	0.8125	406	10510	28	10	378	10500	10916	0.21852274001950608
M1	cpdb	0	network_modules	43	TRUE	1.5978679088646045e-23	72	38	16	0.42105263157894735	0.2222222222222222	REAC:R-HSA-774815	REAC	Nucleosome assembly	10916	1621		0.8666666666666667	0.9375	72	10844	16	22	56	10822	10916	0.30262100851404655
M1	cpdb	0	network_modules	43	TRUE	1.5978679088646045e-23	72	38	16	0.42105263157894735	0.2222222222222222	REAC:R-HSA-606279	REAC	Deposition of new CENPA-containing nucleosomes at the centromere	10916	730		0.8666666666666667	0.9375	72	10844	16	22	56	10822	10916	0.30262100851404655
M1	cpdb	0	network_modules	43	TRUE	1.1453852907562296e-18	138	38	16	0.42105263157894735	0.11594202898550725	REAC:R-HSA-73886	REAC	Chromosome Maintenance	10916	357		1	1	138	10778	16	22	122	10756	10916	0.21605743265144273
M1	cpdb	0	network_modules	43	TRUE	1.4043215326935458e-17	96	47	14	0.2978723404255319	0.14583333333333334	GO:0051310	GO:BP	metaphase chromosome alignment	16175	13641		0.01282051282051282	0.02531645569620253	96	16079	14	33	82	16046	16175	0.2051763726538769
M1	cpdb	0	network_modules	43	TRUE	2.870446340009788e-17	52	47	12	0.2553191489361702	0.23076923076923078	GO:0008608	GO:BP	attachment of spindle microtubules to kinetochore	16175	3205		0.02564102564102564	0.0379746835443038	52	16123	12	35	40	16088	16175	0.24041338023022443
M1	cpdb	0	network_modules	43	TRUE	3.9844450129880855e-17	103	47	14	0.2978723404255319	0.13592233009708737	GO:0051303	GO:BP	establishment of chromosome localization	16175	13634		0.038461538461538464	0.05063291139240506	103	16072	14	33	89	16039	16175	0.19783113080709253
M1	cpdb	0	network_modules	43	TRUE	5.193475837443479e-17	277	47	18	0.3829787234042553	0.06498194945848375	GO:0098813	GO:BP	nuclear chromosome segregation	16175	18900		0.05128205128205128	0.06329113924050633	277	15898	18	29	259	15869	16175	0.15222959083125343
M1	cpdb	0	network_modules	43	TRUE	8.01420129974136e-17	108	47	14	0.2978723404255319	0.12962962962962962	GO:0050000	GO:BP	chromosome localization	16175	13183		0.0641025641025641	0.0759493670886076	108	16067	14	33	94	16034	16175	0.19302259565039265
M1	cpdb	0	network_modules	43	TRUE	2.459945714456619e-15	178	47	15	0.3191489361702128	0.08426966292134831	GO:0000070	GO:BP	mitotic sister chromatid segregation	16175	24		0.07692307692307693	0.08860759493670886	178	15997	15	32	163	15965	16175	0.1594512121629926
M1	cpdb	0	network_modules	43	TRUE	4.991239083203923e-14	217	47	15	0.3191489361702128	0.06912442396313365	GO:0000819	GO:BP	sister chromatid segregation	16175	237		0.08974358974358974	0.10126582278481013	217	15958	15	32	202	15926	16175	0.14345854590640567
M1	cpdb	0	network_modules	43	TRUE	6.5947222479723e-14	16	47	8	0.1702127659574468	0.5	GO:0051383	GO:BP	kinetochore organization	16175	13687		0.10256410256410256	0.11392405063291139	16	16159	8	39	8	16120	16175	0.29060067636741194
M1	cpdb	0	network_modules	43	TRUE	6.832620969569514e-14	44	47	10	0.2127659574468085	0.22727272727272727	GO:0071174	GO:BP	mitotic spindle checkpoint signaling	16175	16470		0.11538461538461539	0.1518987341772152	44	16131	10	37	34	16094	16175	0.21770068385555033
M1	cpdb	0	network_modules	43	TRUE	6.832620969569514e-14	44	47	10	0.2127659574468085	0.22727272727272727	GO:0071173	GO:BP	spindle assembly checkpoint signaling	16175	16469		0.11538461538461539	0.1518987341772152	44	16131	10	37	34	16094	16175	0.21770068385555033
M1	cpdb	0	network_modules	43	TRUE	6.832620969569514e-14	44	47	10	0.2127659574468085	0.22727272727272727	GO:0007094	GO:BP	mitotic spindle assembly checkpoint signaling	16175	2677		0.11538461538461539	0.1518987341772152	44	16131	10	37	34	16094	16175	0.21770068385555033
M1	cpdb	0	network_modules	43	TRUE	8.766494457782381e-14	45	47	10	0.2127659574468085	0.2222222222222222	GO:0033046	GO:BP	negative regulation of sister chromatid segregation	16175	8001		0.15384615384615385	0.21518987341772153	45	16130	10	37	35	16093	16175	0.21521150751655063
M1	cpdb	0	network_modules	43	TRUE	8.766494457782381e-14	45	47	10	0.2127659574468085	0.2222222222222222	GO:0045841	GO:BP	negative regulation of mitotic metaphase/anaphase transition	16175	11657		0.15384615384615385	0.21518987341772153	45	16130	10	37	35	16093	16175	0.21521150751655063
M1	cpdb	0	network_modules	43	TRUE	8.766494457782381e-14	45	47	10	0.2127659574468085	0.2222222222222222	GO:0031577	GO:BP	spindle checkpoint signaling	16175	7223		0.15384615384615385	0.21518987341772153	45	16130	10	37	35	16093	16175	0.21521150751655063
M1	cpdb	0	network_modules	43	TRUE	8.766494457782381e-14	45	47	10	0.2127659574468085	0.2222222222222222	GO:2000816	GO:BP	negative regulation of mitotic sister chromatid separation	16175	26071		0.15384615384615385	0.21518987341772153	45	16130	10	37	35	16093	16175	0.21521150751655063
M1	cpdb	0	network_modules	43	TRUE	8.766494457782381e-14	45	47	10	0.2127659574468085	0.2222222222222222	GO:0033048	GO:BP	negative regulation of mitotic sister chromatid segregation	16175	8003		0.15384615384615385	0.21518987341772153	45	16130	10	37	35	16093	16175	0.21521150751655063
M1	cpdb	0	network_modules	43	TRUE	1.4169862899293068e-13	47	47	10	0.2127659574468085	0.2127659574468085	GO:1905819	GO:BP	negative regulation of chromosome separation	16175	24929		0.21794871794871795	0.25316455696202533	47	16128	10	37	37	16091	16175	0.2104718106214117
M1	cpdb	0	network_modules	43	TRUE	1.4169862899293068e-13	47	47	10	0.2127659574468085	0.2127659574468085	GO:1902100	GO:BP	negative regulation of metaphase/anaphase transition of cell cycle	16175	22014		0.21794871794871795	0.25316455696202533	47	16128	10	37	37	16091	16175	0.2104718106214117
M1	cpdb	0	network_modules	43	TRUE	1.4169862899293068e-13	47	47	10	0.2127659574468085	0.2127659574468085	GO:0051985	GO:BP	negative regulation of chromosome segregation	16175	14047		0.21794871794871795	0.25316455696202533	47	16128	10	37	37	16091	16175	0.2104718106214117
M1	cpdb	0	network_modules	43	TRUE	3.467584958956668e-13	51	47	10	0.2127659574468085	0.19607843137254902	GO:0033047	GO:BP	regulation of mitotic sister chromatid segregation	16175	8002		0.2564102564102564	0.26582278481012656	51	16124	10	37	41	16087	16175	0.20183643877229415
M1	cpdb	0	network_modules	43	TRUE	4.2842526997941866e-13	52	47	10	0.2127659574468085	0.19230769230769232	GO:0045839	GO:BP	negative regulation of mitotic nuclear division	16175	11655		0.2692307692307692	0.27848101265822783	52	16123	10	37	42	16086	16175	0.199833524392433
M1	cpdb	0	network_modules	43	TRUE	4.322654463295092e-13	545	47	19	0.40425531914893614	0.03486238532110092	GO:0051276	GO:BP	chromosome organization	16175	13613		0.28205128205128205	0.2911392405063291	545	15630	19	28	526	15602	16175	0.11086267083276397
M1	cpdb	0	network_modules	43	TRUE	4.722959606741725e-13	252	47	15	0.3191489361702128	0.05952380952380952	GO:0140014	GO:BP	mitotic nuclear division	16175	19633		0.2948717948717949	0.3037974683544304	252	15923	15	32	237	15891	16175	0.1323269024679293
M1	cpdb	0	network_modules	43	TRUE	9.562671883049634e-13	56	47	10	0.2127659574468085	0.17857142857142858	GO:0010965	GO:BP	regulation of mitotic sister chromatid separation	16175	4541		0.3076923076923077	0.31645569620253167	56	16119	10	37	46	16082	16175	0.19236101672814254
M1	cpdb	0	network_modules	43	TRUE	1.1573107581341826e-12	57	47	10	0.2127659574468085	0.17543859649122806	GO:0051784	GO:BP	negative regulation of nuclear division	16175	13934		0.32051282051282054	0.3291139240506329	57	16118	10	37	47	16081	16175	0.19061576718421336
M1	cpdb	0	network_modules	43	TRUE	1.3955019546305385e-12	58	47	10	0.2127659574468085	0.1724137931034483	GO:0051306	GO:BP	mitotic sister chromatid separation	16175	13637		0.3333333333333333	0.34177215189873417	58	16117	10	37	48	16080	16175	0.18891541087473893
M1	cpdb	0	network_modules	43	TRUE	1.0347120471806152e-11	70	47	10	0.2127659574468085	0.14285714285714285	GO:1905818	GO:BP	regulation of chromosome separation	16175	24928		0.34615384615384615	0.35443037974683544	70	16105	10	37	60	16068	16175	0.17141589108317204
M1	cpdb	0	network_modules	43	TRUE	2.4586650602940535e-11	76	47	10	0.2127659574468085	0.13157894736842105	GO:0051304	GO:BP	chromosome separation	16175	13635		0.358974358974359	0.3670886075949367	76	16099	10	37	66	16062	16175	0.1642482107905599
M1	cpdb	0	network_modules	43	TRUE	3.0626518764092835e-11	410	47	16	0.3404255319148936	0.03902439024390244	GO:0051656	GO:BP	establishment of organelle localization	16175	13869		0.3717948717948718	0.379746835443038	410	15765	16	31	394	15734	16175	0.10821359178953947
M1	cpdb	0	network_modules	43	TRUE	8.932087851731285e-11	86	47	10	0.2127659574468085	0.11627906976744186	GO:0030071	GO:BP	regulation of mitotic metaphase/anaphase transition	16175	6671		0.38461538461538464	0.3924050632911392	86	16089	10	37	76	16052	16175	0.15399293144254256
M1	cpdb	0	network_modules	43	TRUE	1.1338481633296753e-10	88	47	10	0.2127659574468085	0.11363636363636363	GO:1902099	GO:BP	regulation of metaphase/anaphase transition of cell cycle	16175	22013		0.3974358974358974	0.4050632911392405	88	16087	10	37	78	16050	16175	0.15215167493152426
M1	cpdb	0	network_modules	43	TRUE	1.4310523313034817e-10	90	47	10	0.2127659574468085	0.1111111111111111	GO:2001251	GO:BP	negative regulation of chromosome organization	16175	26440		0.41025641025641024	0.43037974683544306	90	16085	10	37	80	16048	16175	0.1503712221324262
M1	cpdb	0	network_modules	43	TRUE	1.4310523313034817e-10	90	47	10	0.2127659574468085	0.1111111111111111	GO:0007091	GO:BP	metaphase/anaphase transition of mitotic cell cycle	16175	2675		0.41025641025641024	0.43037974683544306	90	16085	10	37	80	16048	16175	0.1503712221324262
M1	cpdb	0	network_modules	43	TRUE	1.7962670336141017e-10	92	47	10	0.2127659574468085	0.10869565217391304	GO:0044784	GO:BP	metaphase/anaphase transition of cell cycle	16175	11156		0.4358974358974359	0.4430379746835443	92	16083	10	37	82	16046	16175	0.14864825991969133
M1	cpdb	0	network_modules	43	TRUE	1.956013785102362e-10	379	47	15	0.3191489361702128	0.0395778364116095	GO:0000280	GO:BP	nuclear division	16175	78		0.44871794871794873	0.45569620253164556	379	15796	15	32	364	15764	16175	0.10553272087538265
M1	cpdb	0	network_modules	43	TRUE	2.376840114452527e-10	21	47	7	0.14893617021276595	0.3333333333333333	GO:0034508	GO:BP	centromere complex assembly	16175	8672		0.46153846153846156	0.46835443037974683	21	16154	7	40	14	16114	16175	0.22133548485399032
M1	cpdb	0	network_modules	43	TRUE	3.802575147092641e-10	792	47	19	0.40425531914893614	0.023989898989898988	GO:0000278	GO:BP	mitotic cell cycle	16175	76		0.47435897435897434	0.4810126582278481	792	15383	19	28	773	15355	16175	0.088879969094778
M1	cpdb	0	network_modules	43	TRUE	3.8246294998908137e-10	99	47	10	0.2127659574468085	0.10101010101010101	GO:0033045	GO:BP	regulation of sister chromatid segregation	16175	8000		0.48717948717948717	0.4936708860759494	99	16076	10	37	89	16039	16175	0.14302834362452543
M1	cpdb	0	network_modules	43	TRUE	7.706267128850789e-10	106	47	10	0.2127659574468085	0.09433962264150944	GO:0007088	GO:BP	regulation of mitotic nuclear division	16175	2673		0.5	0.5063291139240507	106	16069	10	37	96	16032	16175	0.1379656188781562
M1	cpdb	0	network_modules	43	TRUE	9.96142161617423e-10	424	47	15	0.3191489361702128	0.03537735849056604	GO:0048285	GO:BP	organelle fission	16175	12627		0.5128205128205128	0.5189873417721519	424	15751	15	32	409	15719	16175	0.0989778888304291
M1	cpdb	0	network_modules	43	TRUE	1.1586845188497541e-9	519	47	16	0.3404255319148936	0.030828516377649325	GO:0051640	GO:BP	organelle localization	16175	13853		0.5256410256410257	0.5316455696202531	519	15656	16	31	503	15625	16175	0.09445116196348718
M1	cpdb	0	network_modules	43	TRUE	2.4522673137881055e-9	14	47	6	0.1276595744680851	0.42857142857142855	GO:0051382	GO:BP	kinetochore assembly	16175	13686		0.5384615384615384	0.5443037974683544	14	16161	6	41	8	16120	16175	0.2327574936594591
M1	cpdb	0	network_modules	43	TRUE	2.504980207003768e-9	119	47	10	0.2127659574468085	0.08403361344537816	GO:0051783	GO:BP	regulation of nuclear division	16175	13933		0.5512820512820513	0.5569620253164557	119	16056	10	37	109	16019	16175	0.12975679508792093
M1	cpdb	0	network_modules	43	TRUE	2.994595861883929e-9	656	47	17	0.3617021276595745	0.025914634146341462	GO:1903047	GO:BP	mitotic cell cycle process	16175	22727		0.5641025641025641	0.569620253164557	656	15519	17	30	639	15489	16175	0.08788632491139205
M1	cpdb	0	network_modules	43	TRUE	3.801874489215331e-9	124	47	10	0.2127659574468085	0.08064516129032258	GO:0051983	GO:BP	regulation of chromosome segregation	16175	14045		0.5769230769230769	0.5822784810126582	124	16051	10	37	114	16014	16175	0.1269422876373391
M1	cpdb	0	network_modules	43	TRUE	8.319833621063748e-9	134	47	10	0.2127659574468085	0.07462686567164178	GO:0007093	GO:BP	mitotic cell cycle checkpoint signaling	16175	2676		0.5897435897435898	0.5949367088607594	134	16041	10	37	124	16004	16175	0.12178365637817706
M1	cpdb	0	network_modules	43	TRUE	4.616192296331865e-8	159	47	10	0.2127659574468085	0.06289308176100629	GO:1901991	GO:BP	negative regulation of mitotic cell cycle phase transition	16175	21924		0.6025641025641025	0.6075949367088608	159	16016	10	37	149	15979	16175	0.1110417778772182
M1	cpdb	0	network_modules	43	TRUE	1.265636196516524e-7	176	47	10	0.2127659574468085	0.056818181818181816	GO:0000075	GO:BP	cell cycle checkpoint signaling	16175	26		0.6153846153846154	0.620253164556962	176	15999	10	37	166	15962	16175	0.10505196776348048
M1	cpdb	0	network_modules	43	TRUE	4.91818152727786e-7	202	47	10	0.2127659574468085	0.04950495049504951	GO:0045930	GO:BP	negative regulation of mitotic cell cycle	16175	11724		0.6282051282051282	0.6329113924050633	202	15973	10	37	192	15936	16175	0.09735680188161193
M1	cpdb	0	network_modules	43	TRUE	9.401091579360076e-7	15	47	5	0.10638297872340426	0.3333333333333333	GO:0034501	GO:BP	protein localization to kinetochore	16175	8667		0.6410256410256411	0.6582278481012658	15	16160	5	42	10	16118	16175	0.18702789654994387
M1	cpdb	0	network_modules	43	TRUE	9.401091579360076e-7	15	47	5	0.10638297872340426	0.3333333333333333	GO:1903083	GO:BP	protein localization to condensed chromosome	16175	22757		0.6410256410256411	0.6582278481012658	15	16160	5	42	10	16118	16175	0.18702789654994387
M1	cpdb	0	network_modules	43	TRUE	1.3505404964604827e-6	224	47	10	0.2127659574468085	0.044642857142857144	GO:1901988	GO:BP	negative regulation of cell cycle phase transition	16175	21921		0.6666666666666666	0.6708860759493671	224	15951	10	37	214	15914	16175	0.09188779383521145
M1	cpdb	0	network_modules	43	TRUE	1.5834632870948195e-6	304	47	11	0.23404255319148937	0.03618421052631579	GO:0010639	GO:BP	negative regulation of organelle organization	16175	4285		0.6794871794871795	0.6835443037974683	304	15871	11	36	293	15835	16175	0.08556642451120645
M1	cpdb	0	network_modules	43	TRUE	1.6740987319373213e-6	229	47	10	0.2127659574468085	0.043668122270742356	GO:0033044	GO:BP	regulation of chromosome organization	16175	7999		0.6923076923076923	0.6962025316455697	229	15946	10	37	219	15909	16175	0.0907521136478253
M1	cpdb	0	network_modules	43	TRUE	1.8057501051068669e-6	37	47	6	0.1276595744680851	0.16216216216216217	GO:0071459	GO:BP	protein localization to chromosome, centromeric region	16175	16692		0.7051282051282052	0.7088607594936709	37	16138	6	41	31	16097	16175	0.1416700744800574
M1	cpdb	0	network_modules	43	TRUE	6.15672878544162e-6	262	47	10	0.2127659574468085	0.03816793893129771	GO:0010948	GO:BP	negative regulation of cell cycle process	16175	4526		0.717948717948718	0.7215189873417721	262	15913	10	37	252	15876	16175	0.08405999711153857
M1	cpdb	0	network_modules	43	TRUE	1.4271608177460003e-5	286	47	10	0.2127659574468085	0.03496503496503497	GO:1901990	GO:BP	regulation of mitotic cell cycle phase transition	16175	21923		0.7307692307692307	0.7341772151898734	286	15889	10	37	276	15852	16175	0.07990870505526303
M1	cpdb	0	network_modules	43	TRUE	1.46432146497217e-5	376	47	11	0.23404255319148937	0.02925531914893617	GO:1901987	GO:BP	regulation of cell cycle phase transition	16175	21920		0.7435897435897436	0.7468354430379747	376	15799	11	36	365	15763	16175	0.07551935291565295
M1	cpdb	0	network_modules	43	TRUE	4.421936941617925e-5	3	47	3	0.06382978723404255	1	GO:0043060	GO:BP	meiotic metaphase I homologous chromosome alignment	16175	10507		0.7564102564102564	0.7721518987341772	3	16172	3	44	0	16128	16175	0.25230164925753185
M1	cpdb	0	network_modules	43	TRUE	4.421936941617925e-5	3	47	3	0.06382978723404255	1	GO:0051311	GO:BP	meiotic metaphase chromosome alignment	16175	13642		0.7564102564102564	0.7721518987341772	3	16172	3	44	0	16128	16175	0.25230164925753185
M1	cpdb	0	network_modules	43	TRUE	6.968240909783128e-5	338	47	10	0.2127659574468085	0.029585798816568046	GO:0045786	GO:BP	negative regulation of cell cycle	16175	11618		0.782051282051282	0.7848101265822784	338	15837	10	37	328	15800	16175	0.0724125971414691
M1	cpdb	0	network_modules	43	TRUE	1.295865358762906e-4	465	47	11	0.23404255319148937	0.023655913978494623	GO:0044770	GO:BP	cell cycle phase transition	16175	11146		0.7948717948717948	0.7974683544303798	465	15710	11	36	454	15674	16175	0.06632323098898797
M1	cpdb	0	network_modules	43	TRUE	1.628298341764409e-4	370	47	10	0.2127659574468085	0.02702702702702703	GO:0044772	GO:BP	mitotic cell cycle phase transition	16175	11148		0.8076923076923077	0.810126582278481	370	15805	10	37	360	15768	16175	0.06856612007687353
M1	cpdb	0	network_modules	43	TRUE	6.149334554119246e-4	427	47	10	0.2127659574468085	0.0234192037470726	GO:0007346	GO:BP	regulation of mitotic cell cycle	16175	2855		0.8205128205128205	0.8227848101265823	427	15748	10	37	417	15711	16175	0.062754631913137085
M1	cpdb	0	network_modules	43	TRUE	7.152228803289476e-4	157	9	4	0.4444444444444444	0.025477707006369428	KEGG:04110	KEGG	Cell cycle	8484	264		NA	1	157	8327	4	5	153	8322	8484	0.10299244836807693
M1	cpdb	0	network_modules	43	TRUE	8.46981584923106e-4	22	47	4	0.0851063829787234	0.18181818181818182	GO:0090231	GO:BP	regulation of spindle checkpoint	16175	18126		0.8333333333333334	0.8354430379746836	22	16153	4	43	18	16110	16175	0.12266776192006816
M1	cpdb	0	network_modules	43	TRUE	0.001225126850568986	24	47	4	0.0851063829787234	0.16666666666666666	GO:0051315	GO:BP	attachment of mitotic spindle microtubules to kinetochore	16175	13643		0.8461538461538461	0.8481012658227848	24	16151	4	43	20	16108	16175	0.11727929832485437
M1	cpdb	0	network_modules	43	TRUE	0.0012487510330411599	583	47	11	0.23404255319148937	0.018867924528301886	GO:0051129	GO:BP	negative regulation of cellular component organization	16175	13513		0.8589743589743589	0.8607594936708861	583	15592	11	36	572	15556	16175	0.05734312725768462
M1	cpdb	0	network_modules	43	TRUE	0.0014247993647197514	59	47	5	0.10638297872340426	0.0847457627118644	GO:0007080	GO:BP	mitotic metaphase chromosome alignment	16175	2669		0.8717948717948718	0.8734177215189873	59	16116	5	42	54	16074	16175	0.0919958706017035
M1	cpdb	0	network_modules	43	TRUE	0.0015350856374983428	7	47	3	0.06382978723404255	0.42857142857142855	GO:0031055	GO:BP	chromatin remodeling at centromere	16175	7017		0.8846153846153846	0.8987341772151899	7	16168	3	44	4	16124	16175	0.1645487695451152
M1	cpdb	0	network_modules	43	TRUE	0.0015350856374983428	7	47	3	0.06382978723404255	0.42857142857142855	GO:0034080	GO:BP	CENP-A containing chromatin assembly	16175	8395		0.8846153846153846	0.8987341772151899	7	16168	3	44	4	16124	16175	0.1645487695451152
M1	cpdb	0	network_modules	43	TRUE	0.0017459584744696523	183	47	7	0.14893617021276595	0.03825136612021858	GO:0065004	GO:BP	protein-DNA complex assembly	16175	15888		0.9102564102564102	0.9113924050632911	183	15992	7	40	176	15952	16175	0.07024496464416724
M1	cpdb	0	network_modules	43	TRUE	0.0021456868024659075	118	47	6	0.1276595744680851	0.05084745762711865	GO:0034502	GO:BP	protein localization to chromosome	16175	8668		0.9230769230769231	0.9240506329113924	118	16057	6	41	112	16016	16175	0.07635327775099185
M1	cpdb	0	network_modules	43	TRUE	0.002674247331536198	630	47	11	0.23404255319148937	0.01746031746031746	GO:0010564	GO:BP	regulation of cell cycle process	16175	4217		0.9358974358974359	0.9367088607594937	630	15545	11	36	619	15509	16175	0.05443525376324104
M1	cpdb	0	network_modules	43	TRUE	0.003854033269667819	206	47	7	0.14893617021276595	0.03398058252427184	GO:0071824	GO:BP	protein-DNA complex organization	16175	16927		0.9487179487179487	0.9493670886075949	206	15969	7	40	199	15929	16175	0.06557058930950857
M1	cpdb	0	network_modules	43	TRUE	0.004076043347326138	32	47	4	0.0851063829787234	0.125	GO:0000132	GO:BP	establishment of mitotic spindle orientation	16175	50		0.9615384615384616	0.9620253164556962	32	16143	4	43	28	16100	16175	0.10099114393709493
M1	cpdb	0	network_modules	43	TRUE	0.007406962392444485	37	47	4	0.0851063829787234	0.10810810810810811	GO:0040001	GO:BP	establishment of mitotic spindle localization	16175	9890		0.9743589743589743	0.9746835443037974	37	16138	4	43	33	16095	16175	0.09358510097825953
M1	cpdb	0	network_modules	43	TRUE	0.008260781682695919	38	47	4	0.0851063829787234	0.10526315789473684	GO:0051294	GO:BP	establishment of spindle orientation	16175	13626		0.9871794871794872	0.9873417721518988	38	16137	4	43	34	16094	16175	0.092279432248226
M1	cpdb	0	network_modules	43	TRUE	0.009734354356332263	153	47	6	0.1276595744680851	0.0392156862745098	GO:1902850	GO:BP	microtubule cytoskeleton organization involved in mitosis	16175	22560		1	1	153	16022	6	41	147	15981	16175	0.06592016955613743
M1	cpdb	0	network_modules	44	TRUE	1.9993142330970032e-4	20	39	4	0.10256410256410256	0.2	GO:0071786	GO:BP	endoplasmic reticulum tubular network organization	16175	16907		0	0.5	20	16155	4	35	16	16120	16175	0.1417548873444791
M1	cpdb	0	network_modules	44	TRUE	0.002774389400065377	86	39	5	0.1282051282051282	0.05813953488372093	GO:0007029	GO:BP	endoplasmic reticulum organization	16175	2634		1	1	86	16089	5	34	81	16055	16175	0.08307596004397401
M1	cpdb	0	network_modules	45	TRUE	6.727259798618114e-7	29	23	5	0.21739130434782608	0.1724137931034483	KEGG:04392	KEGG	Hippo signaling pathway - multiple species	8484	312		NA	1	29	8455	5	18	24	8437	8484	0.19114243533839462
M1	cpdb	0	network_modules	45	TRUE	1.869876001660742e-5	19	23	4	0.17391304347826086	0.21052631578947367	REAC:R-HSA-2028269	REAC	Signaling by Hippo	10916	2259		NA	1	19	10897	4	19	15	10878	10916	0.1897960415212133
M1	cpdb	0	network_modules	45	TRUE	3.79906576517443e-4	50	44	5	0.11363636363636363	0.1	GO:0031098	GO:BP	stress-activated protein kinase signaling cascade	16175	7024		0	0.3333333333333333	50	16125	5	39	45	16086	16175	0.10400276940391837
M1	cpdb	0	network_modules	45	TRUE	8.485288822611429e-4	180	44	7	0.1590909090909091	0.03888888888888889	GO:0046777	GO:BP	protein autophosphorylation	16175	12365		0.5	0.6666666666666666	180	15995	7	37	173	15958	16175	0.07366541398840537
M1	cpdb	0	network_modules	45	TRUE	0.009952704989704656	44	44	4	0.09090909090909091	0.09090909090909091	GO:0035329	GO:BP	hippo signaling	16175	8973		1	1	44	16131	4	40	40	16091	16175	0.0884293934321831
M1	cpdb	0	network_modules	46	TRUE	3.177365226566937e-68	32	41	29	0.7073170731707317	0.90625	KEGG:04130	KEGG	SNARE interactions in vesicular transport	8484	272		0	0.5	32	8452	29	12	3	8440	8484	0.7998001959644087
M1	cpdb	0	network_modules	46	TRUE	4.611244154089715e-52	101	50	30	0.6	0.297029702970297	GO:0090174	GO:BP	organelle membrane fusion	16175	18081		0	0.01282051282051282	101	16074	30	20	71	16054	16175	0.4197247924359419
M1	cpdb	0	network_modules	46	TRUE	3.622459927278287e-50	157	50	32	0.64	0.20382165605095542	GO:0061025	GO:BP	membrane fusion	16175	15142		0.012987012987012988	0.02564102564102564	157	16018	32	18	125	16000	16175	0.35798794289052843
M1	cpdb	0	network_modules	46	TRUE	7.455250467754489e-50	99	50	29	0.58	0.29292929292929293	GO:0006906	GO:BP	vesicle fusion	16175	2557		0.025974025974025976	0.038461538461538464	99	16076	29	21	70	16055	16175	0.409725979700243
M1	cpdb	0	network_modules	46	TRUE	1.2732244796541985e-47	136	50	30	0.6	0.22058823529411764	GO:0048284	GO:BP	organelle fusion	16175	12626		0.03896103896103896	0.05128205128205128	136	16039	30	20	106	16019	16175	0.3607809495118808
M1	cpdb	0	network_modules	46	TRUE	7.956653584926492e-38	315	50	31	0.62	0.09841269841269841	GO:0016050	GO:BP	vesicle organization	16175	5082		0.05194805194805195	0.0641025641025641	315	15860	31	19	284	15841	16175	0.2419936759399841
M1	cpdb	0	network_modules	46	TRUE	1.823630506743795e-34	657	50	35	0.7	0.0532724505327245	GO:0061024	GO:BP	membrane organization	16175	15141		0.06493506493506493	0.07692307692307693	657	15518	35	15	622	15503	16175	0.1860012239423644
M1	cpdb	0	network_modules	46	TRUE	1.9720587071041522e-32	70	50	20	0.4	0.2857142857142857	GO:0140056	GO:BP	organelle localization by membrane tethering	16175	19654		0.07792207792207792	0.08974358974358974	70	16105	20	30	50	16075	16175	0.3356492877245692
M1	cpdb	0	network_modules	46	TRUE	4.230890187963164e-31	80	50	20	0.4	0.25	GO:0022406	GO:BP	membrane docking	16175	6597		0.09090909090909091	0.10256410256410256	80	16095	20	30	60	16065	16175	0.3135779485977408
M1	cpdb	0	network_modules	46	TRUE	1.0875731634063593e-27	55	50	17	0.34	0.3090909090909091	GO:0048278	GO:BP	vesicle docking	16175	12620		0.1038961038961039	0.11538461538461539	55	16120	17	33	38	16087	16175	0.3219802840475474
M1	cpdb	0	network_modules	46	TRUE	3.1356691979936834e-25	56	50	16	0.32	0.2857142857142857	GO:0140029	GO:BP	exocytic process	16175	19642		0.11688311688311688	0.1282051282051282	56	16119	16	34	40	16085	16175	0.3000834473562778
M1	cpdb	0	network_modules	46	TRUE	3.4201682777348913e-25	263	50	23	0.46	0.08745247148288973	GO:0006887	GO:BP	exocytosis	16175	2543		0.12987012987012986	0.14102564102564102	263	15912	23	27	240	15885	16175	0.19537459122943138
M1	cpdb	0	network_modules	46	TRUE	5.996178447634735e-25	58	50	16	0.32	0.27586206896551724	GO:0016079	GO:BP	synaptic vesicle exocytosis	16175	5106		0.14285714285714285	0.15384615384615385	58	16117	16	34	42	16083	16175	0.29476731283594027
M1	cpdb	0	network_modules	46	TRUE	1.238214108345383e-22	161	50	19	0.38	0.11801242236024845	GO:0045055	GO:BP	regulated exocytosis	16175	11253		0.15584415584415584	0.16666666666666666	161	16014	19	31	142	15983	16175	0.2075738906389336
M1	cpdb	0	network_modules	46	TRUE	1.1009414708521329e-20	101	50	16	0.32	0.15841584158415842	GO:0099643	GO:BP	signal release from synapse	16175	19183		0.16883116883116883	0.19230769230769232	101	16074	16	34	85	16040	16175	0.22179334877263693
M1	cpdb	0	network_modules	46	TRUE	1.1009414708521329e-20	101	50	16	0.32	0.15841584158415842	GO:0007269	GO:BP	neurotransmitter secretion	16175	2797		0.16883116883116883	0.19230769230769232	101	16074	16	34	85	16040	16175	0.22179334877263693
M1	cpdb	0	network_modules	46	TRUE	1.342333556480281e-19	117	50	16	0.32	0.13675213675213677	GO:0099504	GO:BP	synaptic vesicle cycle	16175	19100		0.19480519480519481	0.20512820512820512	117	16058	16	34	101	16024	16175	0.20552334621824855
M1	cpdb	0	network_modules	46	TRUE	1.3684368913535251e-19	202	37	18	0.4864864864864865	0.0891089108910891	REAC:R-HSA-6811442	REAC	Intra-Golgi and retrograde Golgi-to-ER traffic	10916	1262		0	0.03225806451612903	202	10714	18	19	184	10695	10916	0.20251029988868977
M1	cpdb	0	network_modules	46	TRUE	2.3666505981900895e-19	121	50	16	0.32	0.1322314049586777	GO:0099003	GO:BP	vesicle-mediated transport in synapse	16175	18999		0.2077922077922078	0.21794871794871795	121	16054	16	34	105	16020	16175	0.2019630803545613
M1	cpdb	0	network_modules	46	TRUE	5.858548082537702e-19	646	50	25	0.5	0.03869969040247678	GO:0140352	GO:BP	export from cell	16175	19748		0.22077922077922077	0.23076923076923078	646	15529	25	25	621	15504	16175	0.13083008472223284
M1	cpdb	0	network_modules	46	TRUE	1.2662718269556794e-18	583	50	24	0.48	0.0411663807890223	GO:0032940	GO:BP	secretion by cell	16175	7926		0.23376623376623376	0.24358974358974358	583	15592	24	26	559	15566	16175	0.1326278950060973
M1	cpdb	0	network_modules	46	TRUE	4.8762731392816575e-18	145	50	16	0.32	0.1103448275862069	GO:0006836	GO:BP	neurotransmitter transport	16175	2506		0.24675324675324675	0.2564102564102564	145	16030	16	34	129	15996	16175	0.18375480131250815
M1	cpdb	0	network_modules	46	TRUE	1.5701317424649595e-17	649	50	24	0.48	0.03697996918335902	GO:0046903	GO:BP	secretion	16175	12430		0.2597402597402597	0.2692307692307692	649	15526	24	26	625	15500	16175	0.12481244924841264
M1	cpdb	0	network_modules	46	TRUE	4.381622667530771e-17	311	50	19	0.38	0.06109324758842444	GO:0023061	GO:BP	signal release	16175	6645		0.2727272727272727	0.28205128205128205	311	15864	19	31	292	15833	16175	0.14629405192883155
M1	cpdb	0	network_modules	46	TRUE	5.898891278028181e-17	519	50	22	0.44	0.04238921001926782	GO:0051640	GO:BP	organelle localization	16175	13853		0.2857142857142857	0.2948717948717949	519	15656	22	28	497	15628	16175	0.12889122950241733
M1	cpdb	0	network_modules	46	TRUE	2.7563551888633054e-16	284	50	18	0.36	0.06338028169014084	GO:0048193	GO:BP	Golgi vesicle transport	16175	12570		0.2987012987012987	0.3076923076923077	284	15891	18	32	266	15859	16175	0.14518833398549683
M1	cpdb	0	network_modules	46	TRUE	3.2629330601277535e-16	44	37	11	0.2972972972972973	0.25	REAC:R-HSA-6811438	REAC	Intra-Golgi traffic	10916	1263		0.03333333333333333	0.06451612903225806	44	10872	11	26	33	10846	10916	0.2699301036888027
M1	cpdb	0	network_modules	46	TRUE	4.948010681243488e-16	17	50	9	0.18	0.5294117647058824	GO:0048499	GO:BP	synaptic vesicle membrane organization	16175	12788		0.3116883116883117	0.32051282051282054	17	16158	9	41	8	16117	16175	0.30753208440601787
M1	cpdb	0	network_modules	46	TRUE	3.913407851045852e-15	12	50	8	0.16	0.6666666666666666	GO:0099500	GO:BP	vesicle fusion to plasma membrane	16175	19098		0.3246753246753247	0.34615384615384615	12	16163	8	42	4	16121	16175	0.325708722918899
M1	cpdb	0	network_modules	46	TRUE	3.913407851045852e-15	12	50	8	0.16	0.6666666666666666	GO:0031629	GO:BP	synaptic vesicle fusion to presynaptic active zone membrane	16175	7242		0.3246753246753247	0.34615384615384615	12	16163	8	42	4	16121	16175	0.325708722918899
M1	cpdb	0	network_modules	46	TRUE	8.978941482243108e-15	487	50	20	0.4	0.04106776180698152	GO:0007268	GO:BP	chemical synaptic transmission	16175	2796		0.35064935064935066	0.3717948717948718	487	15688	20	30	467	15658	16175	0.12053297401495712
M1	cpdb	0	network_modules	46	TRUE	8.978941482243108e-15	487	50	20	0.4	0.04106776180698152	GO:0098916	GO:BP	anterograde trans-synaptic signaling	16175	18949		0.35064935064935066	0.3717948717948718	487	15688	20	30	467	15658	16175	0.12053297401495712
M1	cpdb	0	network_modules	46	TRUE	1.0959020035417888e-14	492	50	20	0.4	0.04065040650406504	GO:0099537	GO:BP	trans-synaptic signaling	16175	19116		0.37662337662337664	0.38461538461538464	492	15683	20	30	472	15653	16175	0.11983782787484491
M1	cpdb	0	network_modules	46	TRUE	2.7702492675371394e-14	516	50	20	0.4	0.03875968992248062	GO:0099536	GO:BP	synaptic signaling	16175	19115		0.38961038961038963	0.3974358974358974	516	15659	20	30	496	15629	16175	0.11663720605827618
M1	cpdb	0	network_modules	46	TRUE	6.978354463200717e-13	522	50	19	0.38	0.03639846743295019	GO:0010256	GO:BP	endomembrane system organization	16175	4029		0.4025974025974026	0.41025641025641024	522	15653	19	31	503	15622	16175	0.10956832373364664
M1	cpdb	0	network_modules	46	TRUE	3.6134051365653195e-12	78	41	11	0.2682926829268293	0.14102564102564102	KEGG:04721	KEGG	Synaptic vesicle cycle	8484	351		1	1	78	8406	11	30	67	8376	8484	0.18917675835450248
M1	cpdb	0	network_modules	46	TRUE	5.076917369826883e-12	13	50	7	0.14	0.5384615384615384	GO:0016082	GO:BP	synaptic vesicle priming	16175	5109		0.4155844155844156	0.4230769230769231	13	16162	7	43	6	16119	16175	0.27351922953554536
M1	cpdb	0	network_modules	46	TRUE	1.3475899436848692e-11	49	37	9	0.24324324324324326	0.1836734693877551	REAC:R-HSA-6811440	REAC	Retrograde transport at the Trans-Golgi-Network	10916	2096		0.06666666666666667	0.0967741935483871	49	10867	9	28	40	10839	10916	0.2082900127258633
M1	cpdb	0	network_modules	46	TRUE	7.203570614290204e-11	10	37	6	0.16216216216216217	0.6	REAC:R-HSA-168799	REAC	Neurotoxicity of clostridium toxins	10916	1592		0.1	0.12903225806451613	10	10906	6	31	4	10875	10916	0.31083241867146094
M1	cpdb	0	network_modules	46	TRUE	2.3283399990590624e-10	524	50	17	0.34	0.03244274809160305	GO:0006886	GO:BP	intracellular protein transport	16175	2542		0.42857142857142855	0.4358974358974359	524	15651	17	33	507	15618	16175	0.0967464820408258
M1	cpdb	0	network_modules	46	TRUE	6.244908377681172e-9	18	37	6	0.16216216216216217	0.3333333333333333	REAC:R-HSA-888590	REAC	GABA synthesis, release, reuptake and degradation	10916	1013		0.13333333333333333	0.16129032258064516	18	10898	6	31	12	10867	10916	0.23071244242928138
M1	cpdb	0	network_modules	46	TRUE	1.8098128671757785e-8	137	50	10	0.2	0.072992700729927	GO:0098876	GO:BP	vesicle-mediated transport to the plasma membrane	16175	18924		0.44155844155844154	0.44871794871794873	137	16038	10	40	127	15998	16175	0.11638075379744268
M1	cpdb	0	network_modules	46	TRUE	1.8151896186443194e-8	94	50	9	0.18	0.09574468085106383	GO:0042147	GO:BP	retrograde transport, endosome to Golgi	16175	9990		0.45454545454545453	0.46153846153846156	94	16081	9	41	85	16040	16175	0.12760820874720627
M1	cpdb	0	network_modules	46	TRUE	2.473278030998373e-8	409	50	14	0.28	0.034229828850855744	GO:0060627	GO:BP	regulation of vesicle-mediated transport	16175	14803		0.4675324675324675	0.47435897435897434	409	15766	14	36	395	15730	16175	0.09034621055997927
M1	cpdb	0	network_modules	46	TRUE	3.920418579376105e-8	148	50	10	0.2	0.06756756756756757	GO:0017157	GO:BP	regulation of exocytosis	16175	5287		0.4805194805194805	0.48717948717948717	148	16027	10	40	138	15987	16175	0.111613003166379
M1	cpdb	0	network_modules	46	TRUE	4.367911409442473e-8	270	50	12	0.24	0.044444444444444446	GO:0016197	GO:BP	endosomal transport	16175	5169		0.4935064935064935	0.5	270	15905	12	38	258	15867	16175	0.09705863144746074
M1	cpdb	0	network_modules	46	TRUE	5.8567501767232936e-8	25	37	6	0.16216216216216217	0.24	REAC:R-HSA-5339562	REAC	Uptake and actions of bacterial toxins	10916	2626		0.16666666666666666	0.1935483870967742	25	10891	6	31	19	10860	10916	0.19504655254000505
M1	cpdb	0	network_modules	46	TRUE	2.950349579590847e-7	594	50	15	0.3	0.025252525252525252	GO:0051668	GO:BP	localization within membrane	16175	13880		0.5064935064935064	0.5128205128205128	594	15581	15	35	579	15546	16175	0.07794726939319319
M1	cpdb	0	network_modules	46	TRUE	3.215959448926699e-7	404	50	13	0.26	0.03217821782178218	GO:1903530	GO:BP	regulation of secretion by cell	16175	23080		0.5194805194805194	0.5256410256410257	404	15771	13	37	391	15734	16175	0.08386289238679233
M1	cpdb	0	network_modules	46	TRUE	3.459516874317592e-7	130	50	9	0.18	0.06923076923076923	GO:0016482	GO:BP	cytosolic transport	16175	5232		0.5324675324675324	0.5384615384615384	130	16045	9	41	121	16004	16175	0.10724391701382553
M1	cpdb	0	network_modules	46	TRUE	4.749435376519502e-7	102	37	8	0.21621621621621623	0.0784313725490196	REAC:R-HSA-6807878	REAC	COPI-mediated anterograde transport	10916	279		0.2	0.22580645161290322	102	10814	8	29	94	10785	10916	0.12539454008232323
M1	cpdb	0	network_modules	46	TRUE	5.021940463613585e-7	16	37	5	0.13513513513513514	0.3125	REAC:R-HSA-264642	REAC	Acetylcholine Neurotransmitter Release Cycle	10916	53		0.23333333333333334	0.25806451612903225	16	10900	5	32	11	10868	10916	0.2037645588099395
M1	cpdb	0	network_modules	46	TRUE	5.757654557916985e-7	155	37	9	0.24324324324324326	0.05806451612903226	REAC:R-HSA-199977	REAC	ER to Golgi Anterograde Transport	10916	823		0.26666666666666666	0.2903225806451613	155	10761	9	28	146	10733	10916	0.1129006575087976
M1	cpdb	0	network_modules	46	TRUE	7.097026323570301e-7	17	37	5	0.13513513513513514	0.29411764705882354	REAC:R-HSA-181429	REAC	Serotonin Neurotransmitter Release Cycle	10916	2206		0.3	0.3548387096774194	17	10899	5	32	12	10867	10916	0.19755424288914167
M1	cpdb	0	network_modules	46	TRUE	7.097026323570301e-7	17	37	5	0.13513513513513514	0.29411764705882354	REAC:R-HSA-181430	REAC	Norepinephrine Neurotransmitter Release Cycle	10916	1609		0.3	0.3548387096774194	17	10899	5	32	12	10867	10916	0.19755424288914167
M1	cpdb	0	network_modules	46	TRUE	8.236045722633436e-7	68	37	7	0.1891891891891892	0.10294117647058823	REAC:R-HSA-204005	REAC	COPII-mediated vesicle transport	10916	280		0.36666666666666664	0.3870967741935484	68	10848	7	30	61	10818	10916	0.13561142688832367
M1	cpdb	0	network_modules	46	TRUE	9.69175626855951e-7	442	50	13	0.26	0.029411764705882353	GO:0051046	GO:BP	regulation of secretion	16175	13456		0.5454545454545454	0.5512820512820513	442	15733	13	37	429	15696	16175	0.07947127027672442
M1	cpdb	0	network_modules	46	TRUE	1.3889190272337538e-6	34	50	6	0.12	0.17647058823529413	GO:0006891	GO:BP	intra-Golgi vesicle-mediated transport	16175	2546		0.5584415584415584	0.5641025641025641	34	16141	6	44	28	16097	16175	0.14334454032399901
M1	cpdb	0	network_modules	46	TRUE	2.8762936541229603e-6	186	37	9	0.24324324324324326	0.04838709677419355	REAC:R-HSA-948021	REAC	Transport to the Golgi and subsequent modification	10916	2604		0.4	0.41935483870967744	186	10730	9	28	177	10702	10916	0.10193279074593209
M1	cpdb	0	network_modules	46	TRUE	2.9835184045728125e-6	22	37	5	0.13513513513513514	0.22727272727272727	REAC:R-HSA-212676	REAC	Dopamine Neurotransmitter Release Cycle	10916	781		0.43333333333333335	0.45161290322580644	22	10894	5	32	17	10862	10916	0.1731040988364527
M1	cpdb	0	network_modules	46	TRUE	3.802954970579981e-6	23	37	5	0.13513513513513514	0.21739130434782608	REAC:R-HSA-210500	REAC	Glutamate Neurotransmitter Release Cycle	10916	1055		0.4666666666666667	0.4838709677419355	23	10893	5	32	18	10861	10916	0.16919040785773065
M1	cpdb	0	network_modules	46	TRUE	4.791990481063748e-6	24	37	5	0.13513513513513514	0.20833333333333334	REAC:R-HSA-449836	REAC	Other interleukin signaling	10916	1651		0.5	0.5161290322580645	24	10892	5	32	19	10860	10916	0.16552164503679265
M1	cpdb	0	network_modules	46	TRUE	4.8412887900075385e-6	7	50	4	0.08	0.5714285714285714	GO:0048280	GO:BP	vesicle fusion with Golgi apparatus	16175	12622		0.5714285714285714	0.5769230769230769	7	16168	4	46	3	16122	16175	0.213027915198253
M1	cpdb	0	network_modules	46	TRUE	4.944040445810611e-6	50	37	6	0.16216216216216217	0.12	REAC:R-HSA-112310	REAC	Neurotransmitter release cycle	10916	1595		0.5333333333333333	0.5483870967741935	50	10866	6	31	44	10835	10916	0.13609930628056582
M1	cpdb	0	network_modules	46	TRUE	5.932013142397727e-6	20	50	5	0.1	0.25	GO:0035493	GO:BP	SNARE complex assembly	16175	9063		0.5844155844155844	0.5897435897435898	20	16155	5	45	15	16110	16175	0.1564975447266629
M1	cpdb	0	network_modules	46	TRUE	7.625481584270277e-6	126	50	8	0.16	0.06349206349206349	GO:0006888	GO:BP	endoplasmic reticulum to Golgi vesicle-mediated transport	16175	2544		0.5974025974025974	0.6025641025641025	126	16049	8	42	118	16007	16175	0.0964081897067601
M1	cpdb	0	network_modules	46	TRUE	1.173449808632055e-5	99	37	7	0.1891891891891892	0.0707070707070707	REAC:R-HSA-6811434	REAC	COPI-dependent Golgi-to-ER retrograde traffic	10916	277		0.5666666666666667	0.5806451612903226	99	10817	7	30	92	10787	10916	0.11080533354050869
M1	cpdb	0	network_modules	46	TRUE	1.2535308296296072e-5	3	37	3	0.08108108108108109	1	REAC:R-HSA-5250989	REAC	Toxicity of botulinum toxin type G (botG)	10916	2529		0.6	0.6451612903225806	3	10913	3	34	0	10879	10916	0.28430348027722785
M1	cpdb	0	network_modules	46	TRUE	1.2535308296296072e-5	3	37	3	0.08108108108108109	1	REAC:R-HSA-5250971	REAC	Toxicity of botulinum toxin type C (botC)	10916	2525		0.6	0.6451612903225806	3	10913	3	34	0	10879	10916	0.28430348027722785
M1	cpdb	0	network_modules	46	TRUE	2.015920532117691e-5	52	50	6	0.12	0.11538461538461539	GO:0006890	GO:BP	retrograde vesicle-mediated transport, Golgi to endoplasmic reticulum	16175	2545		0.6103896103896104	0.6153846153846154	52	16123	6	44	46	16079	16175	0.11487949019737806
M1	cpdb	0	network_modules	46	TRUE	2.3429338975773278e-05	285	50	10	0.2	0.03508771929824561	GO:1990778	GO:BP	protein localization to cell periphery	16175	25286		0.6233766233766234	0.6282051282051282	285	15890	10	40	275	15850	16175	0.07719208611392257
M1	cpdb	0	network_modules	46	TRUE	2.718545644329455e-5	66	37	6	0.16216216216216217	0.09090909090909091	REAC:R-HSA-9824439	REAC	Bacterial Infection Pathways	10916	204		0.6666666666666666	0.6774193548387096	66	10850	6	31	60	10819	10916	0.11744389744958077
M1	cpdb	0	network_modules	46	TRUE	4.6067389841007563e-5	72	37	6	0.16216216216216217	0.08333333333333333	REAC:R-HSA-199992	REAC	trans-Golgi Network Vesicle Budding	10916	2749		0.7	0.7096774193548387	72	10844	6	31	66	10813	10916	0.11207907314944236
M1	cpdb	0	network_modules	46	TRUE	4.792112593593614e-5	3	50	3	0.06	1	GO:0035494	GO:BP	SNARE complex disassembly	16175	9064		0.6363636363636364	0.6410256410256411	3	16172	3	47	0	16125	16175	0.24459277286182327
M1	cpdb	0	network_modules	46	TRUE	9.030941627853686e-5	133	37	7	0.1891891891891892	0.05263157894736842	REAC:R-HSA-8856688	REAC	Golgi-to-ER retrograde transport	10916	1084		0.7333333333333333	0.7419354838709677	133	10783	7	30	126	10753	10916	0.09409366793607532
M1	cpdb	0	network_modules	46	TRUE	9.830059167160734e-5	776	50	14	0.28	0.01804123711340206	GO:0060341	GO:BP	regulation of cellular localization	16175	14553		0.6493506493506493	0.6538461538461539	776	15399	14	36	762	15363	16175	0.06045560683021726
M1	cpdb	0	network_modules	46	TRUE	1.0440598453937514e-4	68	50	6	0.12	0.08823529411764706	GO:0045921	GO:BP	positive regulation of exocytosis	16175	11715		0.6623376623376623	0.6666666666666666	68	16107	6	44	62	16063	16175	0.0996577624908547
M1	cpdb	0	network_modules	46	TRUE	1.199579714888627e-4	35	50	5	0.1	0.14285714285714285	GO:1903307	GO:BP	positive regulation of regulated secretory pathway	16175	22894		0.6753246753246753	0.6794871794871795	35	16140	5	45	30	16095	16175	0.11724466007581706
M1	cpdb	0	network_modules	46	TRUE	1.2003227368591496e-4	253	50	9	0.18	0.03557312252964427	GO:0072659	GO:BP	protein localization to plasma membrane	16175	17480		0.6883116883116883	0.6923076923076923	253	15922	9	41	244	15881	16175	0.07375861187731965
M1	cpdb	0	network_modules	46	TRUE	1.3898310178261944e-4	36	50	5	0.1	0.1388888888888889	GO:0006904	GO:BP	vesicle docking involved in exocytosis	16175	2556		0.7012987012987013	0.7051282051282052	36	16139	5	45	31	16094	16175	0.11553532107261447
M1	cpdb	0	network_modules	46	TRUE	1.7773402939772238e-4	684	50	13	0.26	0.019005847953216373	GO:0032880	GO:BP	regulation of protein localization	16175	7877		0.7142857142857143	0.717948717948718	684	15491	13	37	671	15454	16175	0.06024139988504741
M1	cpdb	0	network_modules	46	TRUE	2.0152125577812098e-4	305	37	9	0.24324324324324326	0.029508196721311476	REAC:R-HSA-446203	REAC	Asparagine N-linked glycosylation	10916	169		0.7666666666666667	0.7741935483870968	305	10611	9	28	296	10583	10916	0.07618879581993886
M1	cpdb	0	network_modules	46	TRUE	4.137454444587287e-4	104	37	6	0.16216216216216217	0.057692307692307696	REAC:R-HSA-8856825	REAC	Cargo recognition for clathrin-mediated endocytosis	10916	309		0.8	0.8064516129032258	104	10812	6	31	98	10781	10916	0.09163343207228711
M1	cpdb	0	network_modules	46	TRUE	0.00047712456924234287	5	50	3	0.06	0.6	GO:0001821	GO:BP	histamine secretion	16175	478		0.7272727272727273	0.782051282051282	5	16170	3	47	2	16123	16175	0.18908078927926142
M1	cpdb	0	network_modules	46	TRUE	0.00047712456924234287	5	50	3	0.06	0.6	GO:0002349	GO:BP	histamine production involved in inflammatory response	16175	881		0.7272727272727273	0.782051282051282	5	16170	3	47	2	16123	16175	0.18908078927926142
M1	cpdb	0	network_modules	46	TRUE	0.00047712456924234287	5	50	3	0.06	0.6	GO:0002441	GO:BP	histamine secretion involved in inflammatory response	16175	964		0.7272727272727273	0.782051282051282	5	16170	3	47	2	16123	16175	0.18908078927926142
M1	cpdb	0	network_modules	46	TRUE	0.00047712456924234287	5	50	3	0.06	0.6	GO:0002553	GO:BP	histamine secretion by mast cell	16175	1074		0.7272727272727273	0.782051282051282	5	16170	3	47	2	16123	16175	0.18908078927926142
M1	cpdb	0	network_modules	46	TRUE	0.00047712456924234287	5	50	3	0.06	0.6	GO:0010807	GO:BP	regulation of synaptic vesicle priming	16175	4419		0.7272727272727273	0.782051282051282	5	16170	3	47	2	16123	16175	0.18908078927926142
M1	cpdb	0	network_modules	46	TRUE	6.858493208354246e-4	93	50	6	0.12	0.06451612903225806	GO:1903076	GO:BP	regulation of protein localization to plasma membrane	16175	22751		0.7922077922077922	0.7948717948717948	93	16082	6	44	87	16038	16175	0.08414447483335238
M1	cpdb	0	network_modules	46	TRUE	9.091319765141757e-4	66	37	5	0.13513513513513514	0.07575757575757576	REAC:R-HSA-9662360	REAC	Sensory processing of sound by inner hair cells of the cochlea	10916	2202		0.8333333333333334	0.8387096774193549	66	10850	5	32	61	10818	10916	0.097111839458658325
M1	cpdb	0	network_modules	46	TRUE	0.0010551819629863214	100	50	6	0.12	0.06	GO:0006892	GO:BP	post-Golgi vesicle-mediated transport	16175	2547		0.8051948051948052	0.8076923076923077	100	16075	6	44	94	16031	16175	0.08085622071922993
M1	cpdb	0	network_modules	46	TRUE	0.001344364675891438	56	50	5	0.1	0.08928571428571429	GO:0043299	GO:BP	leukocyte degranulation	16175	10607		0.8181818181818182	0.8205128205128205	56	16119	5	45	51	16074	16175	0.09151959043883355
M1	cpdb	0	network_modules	46	TRUE	0.0016069239937814956	74	37	5	0.13513513513513514	0.06756756756756757	REAC:R-HSA-9659379	REAC	Sensory processing of sound	10916	2201		0.8666666666666667	0.8709677419354839	74	10842	5	32	69	10810	10916	0.09122541253348422
M1	cpdb	0	network_modules	46	TRUE	0.0020591707384922907	112	50	6	0.12	0.05357142857142857	GO:1904375	GO:BP	regulation of protein localization to cell periphery	16175	23762		0.8311688311688312	0.8333333333333334	112	16063	6	44	106	16019	16175	0.07593229126814502
M1	cpdb	0	network_modules	46	TRUE	0.002433917690931847	63	50	5	0.1	0.07936507936507936	GO:0002275	GO:BP	myeloid cell activation involved in immune response	16175	807		0.8441558441558441	0.8461538461538461	63	16112	5	45	58	16067	16175	0.08591734845756911
M1	cpdb	0	network_modules	46	TRUE	0.002654468917386508	8	50	3	0.06	0.375	GO:0043308	GO:BP	eosinophil degranulation	16175	10616		0.8571428571428571	0.8846153846153846	8	16167	3	47	5	16120	16175	0.14903084573643377
M1	cpdb	0	network_modules	46	TRUE	0.002654468917386508	8	50	3	0.06	0.375	GO:0002447	GO:BP	eosinophil mediated immunity	16175	970		0.8571428571428571	0.8846153846153846	8	16167	3	47	5	16120	16175	0.14903084573643377
M1	cpdb	0	network_modules	46	TRUE	0.002654468917386508	8	50	3	0.06	0.375	GO:0002278	GO:BP	eosinophil activation involved in immune response	16175	810		0.8571428571428571	0.8846153846153846	8	16167	3	47	5	16120	16175	0.14903084573643377
M1	cpdb	0	network_modules	46	TRUE	0.0027552282824658174	144	37	6	0.16216216216216217	0.041666666666666664	REAC:R-HSA-8856828	REAC	Clathrin-mediated endocytosis	10916	372		0.9	0.9032258064516129	144	10772	6	31	138	10741	10916	0.07614489757730171
M1	cpdb	0	network_modules	46	TRUE	0.0036910091877141635	195	50	7	0.14	0.035897435897435895	GO:1903532	GO:BP	positive regulation of secretion by cell	16175	23082		0.8961038961038961	0.8974358974358975	195	15980	7	43	188	15937	16175	0.06528221449543271
M1	cpdb	0	network_modules	46	TRUE	0.003973028667071805	9	50	3	0.06	0.3333333333333333	GO:0043307	GO:BP	eosinophil activation	16175	10615		0.9090909090909091	0.9230769230769231	9	16166	3	47	6	16119	16175	0.140365988076645
M1	cpdb	0	network_modules	46	TRUE	0.003973028667071805	9	50	3	0.06	0.3333333333333333	GO:0051608	GO:BP	histamine transport	16175	13824		0.9090909090909091	0.9230769230769231	9	16166	3	47	6	16119	16175	0.140365988076645
M1	cpdb	0	network_modules	46	TRUE	0.004215728757420745	90	37	5	0.13513513513513514	0.05555555555555555	REAC:R-HSA-1236974	REAC	ER-Phagosome pathway	10916	824		0.9333333333333333	0.9354838709677419	90	10826	5	32	85	10794	10916	0.0818357851000071
M1	cpdb	0	network_modules	46	TRUE	0.004557498764484102	504	50	10	0.2	0.01984126984126984	GO:0072657	GO:BP	protein localization to membrane	16175	17478		0.935064935064935	0.9358974358974359	504	15671	10	40	494	15631	16175	0.05411195404943304
M1	cpdb	0	network_modules	46	TRUE	0.004744829930308184	72	50	5	0.1	0.06944444444444445	GO:0002444	GO:BP	myeloid leukocyte mediated immunity	16175	967		0.948051948051948	0.9487179487179487	72	16103	5	45	67	16058	16175	0.07992534235734983
M1	cpdb	0	network_modules	46	TRUE	0.006226793392584072	211	50	7	0.14	0.03317535545023697	GO:0051047	GO:BP	positive regulation of secretion	16175	13457		0.961038961038961	0.9615384615384616	211	15964	7	43	204	15921	16175	0.06230426262740866
M1	cpdb	0	network_modules	46	TRUE	0.007519864470778255	79	50	5	0.1	0.06329113924050633	GO:0032456	GO:BP	endocytic recycling	16175	7571		0.974025974025974	0.9743589743589743	79	16096	5	45	74	16051	16175	0.07597314654716156
M1	cpdb	0	network_modules	46	TRUE	0.007642234339401988	259	37	7	0.1891891891891892	0.02702702702702703	REAC:R-HSA-112315	REAC	Transmission across Chemical Synapses	10916	2580		0.9666666666666667	0.967741935483871	259	10657	7	30	252	10627	10916	0.0634018962652598
M1	cpdb	0	network_modules	46	TRUE	0.008900321815198734	144	50	6	0.12	0.041666666666666664	GO:1905475	GO:BP	regulation of protein localization to membrane	16175	24661		0.987012987012987	1	144	16031	6	44	138	15987	16175	0.06585999061934532
M1	cpdb	0	network_modules	46	TRUE	0.008900321815198734	144	50	6	0.12	0.041666666666666664	GO:0007030	GO:BP	Golgi organization	16175	2635		0.987012987012987	1	144	16031	6	44	138	15987	16175	0.06585999061934532
M1	cpdb	0	network_modules	46	TRUE	0.008928352144035973	105	37	5	0.13513513513513514	0.047619047619047616	REAC:R-HSA-1236975	REAC	Antigen processing-Cross presentation	10916	153		1	1	105	10811	5	32	100	10779	10916	0.0749967068654033
M1	cpdb	0	network_modules	47	TRUE	7.231775962886804e-32	79	23	18	0.782608695652174	0.22784810126582278	KEGG:03018	KEGG	RNA degradation	8484	211		0	0.5	79	8405	18	5	61	8400	8484	0.41977607195380023
M1	cpdb	0	network_modules	47	TRUE	2.9402372523310627e-21	56	37	14	0.3783783783783784	0.25	REAC:R-HSA-429914	REAC	Deadenylation-dependent mRNA decay	10916	454		0	0.07692307692307693	56	10860	14	23	42	10837	10916	0.3046904246013512
M1	cpdb	0	network_modules	47	TRUE	8.09997456728113e-17	16	37	9	0.24324324324324326	0.5625	REAC:R-HSA-429958	REAC	mRNA decay by 3' to 5' exoribonuclease	10916	2709		0.08333333333333333	0.15384615384615385	16	10900	9	28	7	10872	10916	0.36856369372653575
M1	cpdb	0	network_modules	47	TRUE	1.7172660900004855e-16	17	37	9	0.24324324324324326	0.5294117647058824	REAC:R-HSA-450513	REAC	Tristetraprolin (TTP, ZFP36) binds and destabilizes mRNA	10916	2608		0.16666666666666666	0.38461538461538464	17	10899	9	28	8	10871	10916	0.35744022204636733
M1	cpdb	0	network_modules	47	TRUE	1.7172660900004855e-16	17	37	9	0.24324324324324326	0.5294117647058824	REAC:R-HSA-450385	REAC	Butyrate Response Factor 1 (BRF1) binds and destabilizes mRNA	10916	259		0.16666666666666666	0.38461538461538464	17	10899	9	28	8	10871	10916	0.35744022204636733
M1	cpdb	0	network_modules	47	TRUE	1.7172660900004855e-16	17	37	9	0.24324324324324326	0.5294117647058824	REAC:R-HSA-450604	REAC	KSRP (KHSRP) binds and destabilizes mRNA	10916	1283		0.16666666666666666	0.38461538461538464	17	10899	9	28	8	10871	10916	0.35744022204636733
M1	cpdb	0	network_modules	47	TRUE	3.1098232514102373e-16	205	46	16	0.34782608695652173	0.07804878048780488	GO:0016072	GO:BP	rRNA metabolic process	16175	5099		0	0.022727272727272728	205	15970	16	30	189	15940	16175	0.1600044936905241
M1	cpdb	0	network_modules	47	TRUE	1.3292995505484342e-14	8	46	7	0.15217391304347827	0.875	GO:0034475	GO:BP	U4 snRNA 3'-end processing	16175	8652		0.023255813953488372	0.045454545454545456	8	16167	7	39	1	16128	16175	0.36432263309120266
M1	cpdb	0	network_modules	47	TRUE	3.2350284596499554e-14	27	37	9	0.24324324324324326	0.3333333333333333	REAC:R-HSA-380994	REAC	ATF4 activates genes in response to endoplasmic reticulum  stress	10916	35		0.4166666666666667	0.46153846153846156	27	10889	9	28	18	10861	10916	0.28268062916972886
M1	cpdb	0	network_modules	47	TRUE	3.4316513509029105e-14	169	46	14	0.30434782608695654	0.08284023668639054	GO:0006364	GO:BP	rRNA processing	16175	2140		0.046511627906976744	0.06818181818181818	169	16006	14	32	155	15974	16175	0.15435962891261606
M1	cpdb	0	network_modules	47	TRUE	1.9137480528468002e-13	32	37	9	0.24324324324324326	0.28125	REAC:R-HSA-381042	REAC	PERK regulates gene expression	10916	1664		0.5	0.5384615384615384	32	10884	9	28	23	10856	10916	0.25922428236585177
M1	cpdb	0	network_modules	47	TRUE	1.247319054644942e-12	22	46	8	0.17391304347826086	0.36363636363636365	GO:0034472	GO:BP	snRNA 3'-end processing	16175	8649		0.06976744186046512	0.09090909090909091	22	16153	8	38	14	16115	16175	0.2500367583789224
M1	cpdb	0	network_modules	47	TRUE	4.394648323030012e-12	182	37	13	0.35135135135135137	0.07142857142857142	REAC:R-HSA-6791226	REAC	Major pathway of rRNA processing in the nucleolus and cytosol	10916	1389		0.5833333333333334	0.6153846153846154	182	10734	13	24	169	10710	10916	0.15243381730261765
M1	cpdb	0	network_modules	47	TRUE	5.630851344036369e-12	14	46	7	0.15217391304347827	0.5	GO:0071027	GO:BP	nuclear RNA surveillance	16175	16427		0.09302325581395349	0.11363636363636363	14	16161	7	39	7	16122	16175	0.2747795020584803
M1	cpdb	0	network_modules	47	TRUE	8.801388395344816e-12	390	46	16	0.34782608695652173	0.041025641025641026	GO:0022613	GO:BP	ribonucleoprotein complex biogenesis	16175	6620		0.11627906976744186	0.13636363636363635	390	15785	16	30	374	15755	16175	0.11270091670438392
M1	cpdb	0	network_modules	47	TRUE	8.831987169898024e-12	192	37	13	0.35135135135135137	0.06770833333333333	REAC:R-HSA-8868773	REAC	rRNA processing in the nucleus and cytosol	10916	2734		0.6666666666666666	0.6923076923076923	192	10724	13	24	179	10700	10916	0.14807386474371706
M1	cpdb	0	network_modules	47	TRUE	8.994699343988327e-12	251	46	14	0.30434782608695654	0.055776892430278883	GO:0042254	GO:BP	ribosome biogenesis	16175	10060		0.13953488372093023	0.1590909090909091	251	15924	14	32	237	15892	16175	0.12479549760716724
M1	cpdb	0	network_modules	47	TRUE	1.709318798708567e-11	202	37	13	0.35135135135135137	0.06435643564356436	REAC:R-HSA-72312	REAC	rRNA processing	10916	2732		0.75	0.7692307692307693	202	10714	13	24	189	10690	10916	0.1440330856721519
M1	cpdb	0	network_modules	47	TRUE	1.8690343707145526e-11	16	46	7	0.15217391304347827	0.4375	GO:0071025	GO:BP	RNA surveillance	16175	16425		0.16279069767441862	0.18181818181818182	16	16159	7	39	9	16120	16175	0.25683853699611714
M1	cpdb	0	network_modules	47	TRUE	1.966910756463629e-11	590	46	18	0.391304347826087	0.030508474576271188	GO:0016071	GO:BP	mRNA metabolic process	16175	5098		0.18604651162790697	0.20454545454545456	590	15585	18	28	572	15557	16175	0.10107839358950023
M1	cpdb	0	network_modules	47	TRUE	3.086572730829242e-11	80	46	10	0.21739130434782608	0.125	GO:0031123	GO:BP	RNA 3'-end processing	16175	7048		0.20930232558139536	0.22727272727272727	80	16095	10	36	70	16059	16175	0.16172469191691702
M1	cpdb	0	network_modules	47	TRUE	3.8958202551197866e-11	279	46	14	0.30434782608695654	0.05017921146953405	GO:0006401	GO:BP	RNA catabolic process	16175	2162		0.23255813953488372	0.25	279	15896	14	32	265	15864	16175	0.1177619837901052
M1	cpdb	0	network_modules	47	TRUE	6.906512022895376e-11	34	46	8	0.17391304347826086	0.23529411764705882	GO:0016180	GO:BP	snRNA processing	16175	5161		0.2558139534883721	0.2727272727272727	34	16141	8	38	26	16103	16175	0.2003391648443542
M1	cpdb	0	network_modules	47	TRUE	1.011649272017967e-10	299	46	14	0.30434782608695654	0.046822742474916385	GO:0141188	GO:BP	nucleic acid catabolic process	16175	20075		0.27906976744186046	0.29545454545454547	299	15876	14	32	285	15844	16175	0.11333669562867466
M1	cpdb	0	network_modules	47	TRUE	2.768120480909516e-9	86	37	9	0.24324324324324326	0.10465116279069768	REAC:R-HSA-450531	REAC	Regulation of mRNA stability by proteins that bind AU-rich elements	10916	2043		0.8333333333333334	0.8461538461538461	86	10830	9	28	77	10802	10916	0.1552559106045007
M1	cpdb	0	network_modules	47	TRUE	5.157080390369552e-9	92	37	9	0.24324324324324326	0.09782608695652174	REAC:R-HSA-381119	REAC	Unfolded Protein Response (UPR)	10916	2624		0.9166666666666666	0.9230769230769231	92	10824	9	28	83	10796	10916	0.1497988189958174
M1	cpdb	0	network_modules	47	TRUE	5.5511361235420656e-9	7	46	5	0.10869565217391304	0.7142857142857143	GO:0071038	GO:BP	TRAMP-dependent tRNA surveillance pathway	16175	16436		0.3023255813953488	0.3409090909090909	7	16168	5	41	2	16127	16175	0.27798535211511355
M1	cpdb	0	network_modules	47	TRUE	5.5511361235420656e-9	7	46	5	0.10869565217391304	0.7142857142857143	GO:0071035	GO:BP	nuclear polyadenylation-dependent rRNA catabolic process	16175	16433		0.3023255813953488	0.3409090909090909	7	16168	5	41	2	16127	16175	0.27798535211511355
M1	cpdb	0	network_modules	47	TRUE	5.990151963166497e-9	57	46	8	0.17391304347826086	0.14035087719298245	GO:0016073	GO:BP	snRNA metabolic process	16175	5100		0.3488372093023256	0.36363636363636365	57	16118	8	38	49	16080	16175	0.15355651808824072
M1	cpdb	0	network_modules	47	TRUE	6.733212644324682e-9	33	46	7	0.15217391304347827	0.21212121212121213	GO:0000460	GO:BP	maturation of 5.8S rRNA	16175	150		0.37209302325581395	0.38636363636363635	33	16142	7	39	26	16103	16175	0.17768964117330066
M1	cpdb	0	network_modules	47	TRUE	1.4771751829405093e-8	8	46	5	0.10869565217391304	0.625	GO:0106354	GO:BP	tRNA surveillance	16175	19317		0.3953488372093023	0.4090909090909091	8	16167	5	41	3	16126	16175	0.25989103221132454
M1	cpdb	0	network_modules	47	TRUE	2.4364973350650185e-8	448	46	14	0.30434782608695654	0.03125	GO:0034655	GO:BP	nucleobase-containing compound catabolic process	16175	8711		0.4186046511627907	0.4318181818181818	448	15727	14	32	434	15695	16175	0.09003044685589151
M1	cpdb	0	network_modules	47	TRUE	3.316621572162343e-8	9	46	5	0.10869565217391304	0.5555555555555556	GO:0000467	GO:BP	exonucleolytic trimming to generate mature 3'-end of 5.8S rRNA from tricistronic rRNA transcript (SSU-rRNA, 5.8S rRNA, LSU-rRNA)	16175	157		0.4418604651162791	0.45454545454545453	9	16166	5	41	4	16125	16175	0.24489518542802166
M1	cpdb	0	network_modules	47	TRUE	6.619227748530275e-8	10	46	5	0.10869565217391304	0.5	GO:0071028	GO:BP	nuclear mRNA surveillance	16175	16428		0.46511627906976744	0.5	10	16165	5	41	5	16124	16175	0.2322023309207873
M1	cpdb	0	network_modules	47	TRUE	6.619227748530275e-8	10	46	5	0.10869565217391304	0.5	GO:0031125	GO:BP	rRNA 3'-end processing	16175	7050		0.46511627906976744	0.5	10	16165	5	41	5	16124	16175	0.2322023309207873
M1	cpdb	0	network_modules	47	TRUE	3.345566469391875e-7	352	46	12	0.2608695652173913	0.03409090909090909	GO:0006397	GO:BP	mRNA processing	16175	2158		0.5116279069767442	0.5227272727272727	352	15823	12	34	340	15789	16175	0.08751794165650006
M1	cpdb	0	network_modules	47	TRUE	3.4610436191945125e-7	15	37	5	0.13513513513513514	0.3333333333333333	REAC:R-HSA-430039	REAC	mRNA decay by 5' to 3' exoribonuclease	10916	2710		1	1	15	10901	5	32	10	10869	10916	0.21058169923597986
M1	cpdb	0	network_modules	47	TRUE	1.1328646000250083e-6	16	46	5	0.10869565217391304	0.3125	GO:0016078	GO:BP	tRNA decay	16175	5105		0.5348837209302325	0.5454545454545454	16	16159	5	41	11	16118	16175	0.18297596668413652
M1	cpdb	0	network_modules	47	TRUE	6.743743779463046e-6	22	46	5	0.10869565217391304	0.22727272727272727	GO:0000466	GO:BP	maturation of 5.8S rRNA from tricistronic rRNA transcript (SSU-rRNA, 5.8S rRNA, LSU-rRNA)	16175	156		0.5581395348837209	0.5681818181818182	22	16153	5	41	17	16112	16175	0.1555338944014696
M1	cpdb	0	network_modules	47	TRUE	7.0953264600554945e-6	8	46	4	0.08695652173913043	0.5	GO:0071051	GO:BP	poly(A)-dependent snoRNA 3'-end processing	16175	16446		0.5813953488372093	0.5909090909090909	8	16167	4	42	4	16125	16175	0.20767523177138547
M1	cpdb	0	network_modules	47	TRUE	2.1732128554412295e-5	226	46	9	0.1956521739130435	0.03982300884955752	GO:0006402	GO:BP	mRNA catabolic process	16175	2163		0.6046511627906976	0.6136363636363636	226	15949	9	37	217	15912	16175	0.0826619495988389
M1	cpdb	0	network_modules	47	TRUE	3.843993815509808e-5	3	46	3	0.06521739130434782	1	GO:0034473	GO:BP	U1 snRNA 3'-end processing	16175	8650		0.627906976744186	0.6590909090909091	3	16172	3	43	0	16129	16175	0.25503722021892494
M1	cpdb	0	network_modules	47	TRUE	3.843993815509808e-5	3	46	3	0.06521739130434782	1	GO:0034476	GO:BP	U5 snRNA 3'-end processing	16175	8653		0.627906976744186	0.6590909090909091	3	16172	3	43	0	16129	16175	0.25503722021892494
M1	cpdb	0	network_modules	47	TRUE	4.9758467125779945e-5	12	46	4	0.08695652173913043	0.3333333333333333	GO:0031126	GO:BP	sno(s)RNA 3'-end processing	16175	7051		0.6744186046511628	0.6818181818181818	12	16163	4	42	8	16121	16175	0.16910205067194428
M1	cpdb	0	network_modules	47	TRUE	7.172404578051513e-5	13	46	4	0.08695652173913043	0.3076923076923077	GO:0045006	GO:BP	DNA deamination	16175	11224		0.6976744186046512	0.7045454545454546	13	16162	4	42	9	16120	16175	0.16235651316987396
M1	cpdb	0	network_modules	47	TRUE	1.0020509183228048e-4	14	46	4	0.08695652173913043	0.2857142857142857	GO:0016075	GO:BP	rRNA catabolic process	16175	5102		0.7209302325581395	0.75	14	16161	4	42	10	16119	16175	0.1563432176287119
M1	cpdb	0	network_modules	47	TRUE	1.0020509183228048e-4	14	46	4	0.08695652173913043	0.2857142857142857	GO:0043144	GO:BP	sno(s)RNA processing	16175	10551		0.7209302325581395	0.75	14	16161	4	42	10	16119	16175	0.1563432176287119
M1	cpdb	0	network_modules	47	TRUE	1.5345312684609063e-4	4	46	3	0.06521739130434782	0.75	GO:0071047	GO:BP	polyadenylation-dependent mRNA catabolic process	16175	16445		0.7674418604651163	0.7954545454545454	4	16171	3	43	1	16128	16175	0.22066556124120495
M1	cpdb	0	network_modules	47	TRUE	1.5345312684609063e-4	4	46	3	0.06521739130434782	0.75	GO:0071042	GO:BP	nuclear polyadenylation-dependent mRNA catabolic process	16175	16440		0.7674418604651163	0.7954545454545454	4	16171	3	43	1	16128	16175	0.22066556124120495
M1	cpdb	0	network_modules	47	TRUE	1.8143503346238515e-4	16	46	4	0.08695652173913043	0.25	GO:0016074	GO:BP	sno(s)RNA metabolic process	16175	5101		0.813953488372093	0.8181818181818182	16	16159	4	42	12	16117	16175	0.1460446815281462
M1	cpdb	0	network_modules	47	TRUE	1.9154008918540933e-4	291	46	9	0.1956521739130435	0.030927835051546393	GO:0000375	GO:BP	RNA splicing, via transesterification reactions	16175	107		0.8372093023255814	0.8409090909090909	291	15884	9	37	282	15847	16175	0.07138159480274885
M1	cpdb	0	network_modules	47	TRUE	3.828678454421361e-4	5	46	3	0.06521739130434782	0.6	GO:0071043	GO:BP	CUT metabolic process	16175	16441		0.8604651162790697	0.8863636363636364	5	16170	3	43	2	16127	16175	0.19718756382057995
M1	cpdb	0	network_modules	47	TRUE	3.828678454421361e-4	5	46	3	0.06521739130434782	0.6	GO:0071034	GO:BP	CUT catabolic process	16175	16432		0.8604651162790697	0.8863636363636364	5	16170	3	43	2	16127	16175	0.19718756382057995
M1	cpdb	0	network_modules	47	TRUE	0.001354925079331414	113	46	6	0.13043478260869565	0.05309734513274336	GO:0000956	GO:BP	nuclear-transcribed mRNA catabolic process	16175	264		0.9069767441860465	0.9090909090909091	113	16062	6	40	107	16022	16175	0.07915292126356539
M1	cpdb	0	network_modules	47	TRUE	0.0017100014449248106	27	46	4	0.08695652173913043	0.14814814814814814	GO:0006304	GO:BP	DNA modification	16175	2111		0.9302325581395349	0.9318181818181818	27	16148	4	42	23	16106	16175	0.11157386846788604
M1	cpdb	0	network_modules	47	TRUE	0.0023132558410063455	287	46	8	0.17391304347826086	0.027874564459930314	GO:0000398	GO:BP	mRNA splicing, via spliceosome	16175	121		0.9534883720930233	0.9772727272727273	287	15888	8	38	279	15850	16175	0.06317430201678374
M1	cpdb	0	network_modules	47	TRUE	0.0023132558410063455	287	46	8	0.17391304347826086	0.027874564459930314	GO:0000377	GO:BP	RNA splicing, via transesterification reactions with bulged adenosine as nucleophile	16175	109		0.9534883720930233	0.9772727272727273	287	15888	8	38	279	15850	16175	0.06317430201678374
M1	cpdb	0	network_modules	47	TRUE	0.0025996751434275867	397	46	9	0.1956521739130435	0.022670025188916875	GO:0008380	GO:BP	RNA splicing	16175	3186		1	1	397	15778	9	37	388	15741	16175	0.05905666061154162
M1	cpdb	0	network_modules	47	TRUE	0.005489676047957176	174	23	5	0.21739130434782608	0.028735632183908046	KEGG:03040	KEGG	Spliceosome	8484	215		1	1	174	8310	5	18	169	8292	8484	0.07242439077177268
M1	cpdb	0	network_modules	48	TRUE	1.6371553459961953e-76	57	42	35	0.8333333333333334	0.6140350877192983	REAC:R-HSA-380108	REAC	Chemokine receptors bind chemokines	10916	346		0	0.16666666666666666	57	10859	35	7	22	10852	10916	0.7140852341643518
M1	cpdb	0	network_modules	48	TRUE	2.9733417973480713e-74	98	45	40	0.8888888888888888	0.40816326530612246	KEGG:04061	KEGG	Viral protein interaction with cytokine and cytokine receptor	8484	254		0	0.1111111111111111	98	8386	40	5	58	8381	8484	0.5995670600952189
M1	cpdb	0	network_modules	48	TRUE	4.358525566831863e-58	190	45	39	0.8666666666666667	0.20526315789473684	KEGG:04062	KEGG	Chemokine signaling pathway	8484	255		0.125	0.2222222222222222	190	8294	39	6	151	8288	8484	0.41666284257557956
M1	cpdb	0	network_modules	48	TRUE	5.85257895202827e-58	273	49	39	0.7959183673469388	0.14285714285714285	GO:0060326	GO:BP	cell chemotaxis	16175	14538		0	0.00684931506849315	273	15902	39	10	234	15892	16175	0.3333740740158908
M1	cpdb	0	network_modules	48	TRUE	7.239349592964993e-57	375	49	41	0.8367346938775511	0.10933333333333334	GO:0006935	GO:BP	chemotaxis	16175	2574		0.006896551724137931	0.02054794520547945	375	15800	41	8	334	15792	16175	0.2980022092254545
M1	cpdb	0	network_modules	48	TRUE	7.239349592964993e-57	375	49	41	0.8367346938775511	0.10933333333333334	GO:0042330	GO:BP	taxis	16175	10096		0.006896551724137931	0.02054794520547945	375	15800	41	8	334	15792	16175	0.2980022092254545
M1	cpdb	0	network_modules	48	TRUE	1.1252805628071665e-56	91	49	31	0.6326530612244898	0.34065934065934067	GO:0030593	GO:BP	neutrophil chemotaxis	16175	6860		0.020689655172413793	0.0273972602739726	91	16084	31	18	60	16066	16175	0.46211235645903875
M1	cpdb	0	network_modules	48	TRUE	3.334245571157982e-56	110	49	32	0.6530612244897959	0.2909090909090909	GO:0071621	GO:BP	granulocyte chemotaxis	16175	16801		0.027586206896551724	0.03424657534246575	110	16065	32	17	78	16048	16175	0.43346094930161205
M1	cpdb	0	network_modules	48	TRUE	5.47050794578738e-56	68	49	29	0.5918367346938775	0.4264705882352941	GO:0070098	GO:BP	chemokine-mediated signaling pathway	16175	15910		0.034482758620689655	0.0410958904109589	68	16107	29	20	39	16087	16175	0.5006372760647158
M1	cpdb	0	network_modules	48	TRUE	6.640182674602196e-56	195	42	36	0.8571428571428571	0.18461538461538463	REAC:R-HSA-375276	REAC	Peptide ligand-binding receptors	10916	1726		0.2	0.3333333333333333	195	10721	36	6	159	10715	10916	0.393790286313465
M1	cpdb	0	network_modules	48	TRUE	5.346484578796945e-55	291	45	41	0.9111111111111111	0.140893470790378	KEGG:04060	KEGG	Cytokine-cytokine receptor interaction	8484	253		0.25	0.3333333333333333	291	8193	41	4	250	8189	8484	0.3518030222574354
M1	cpdb	0	network_modules	48	TRUE	3.1482525242932725e-54	106	49	31	0.6326530612244898	0.29245283018867924	GO:1990266	GO:BP	neutrophil migration	16175	25128		0.041379310344827586	0.04794520547945205	106	16069	31	18	75	16051	16175	0.42773537165014863
M1	cpdb	0	network_modules	48	TRUE	3.248923468157701e-54	76	49	29	0.5918367346938775	0.3815789473684211	GO:1990868	GO:BP	response to chemokine	16175	25323		0.04827586206896552	0.06164383561643835	76	16099	29	20	47	16079	16175	0.4732744260009601
M1	cpdb	0	network_modules	48	TRUE	3.248923468157701e-54	76	49	29	0.5918367346938775	0.3815789473684211	GO:1990869	GO:BP	cellular response to chemokine	16175	25324		0.04827586206896552	0.06164383561643835	76	16099	29	20	47	16079	16175	0.4732744260009601
M1	cpdb	0	network_modules	48	TRUE	6.813330884477126e-54	127	49	32	0.6530612244897959	0.25196850393700787	GO:0097530	GO:BP	granulocyte migration	16175	18690		0.06206896551724138	0.0684931506849315	127	16048	32	17	95	16031	16175	0.4029651654907282
M1	cpdb	0	network_modules	48	TRUE	2.708654188203569e-50	186	49	33	0.673469387755102	0.1774193548387097	GO:0097529	GO:BP	myeloid leukocyte migration	16175	18689		0.06896551724137931	0.07534246575342465	186	15989	33	16	153	15973	16175	0.34225538623983753
M1	cpdb	0	network_modules	48	TRUE	3.667139074683522e-49	200	49	33	0.673469387755102	0.165	GO:0030595	GO:BP	leukocyte chemotaxis	16175	6861		0.07586206896551724	0.0821917808219178	200	15975	33	16	167	15959	16175	0.32977199177775424
M1	cpdb	0	network_modules	48	TRUE	3.562223482352595e-47	328	42	36	0.8571428571428571	0.10975609756097561	REAC:R-HSA-373076	REAC	Class A/1 (Rhodopsin-like receptors)	10916	365		0.4	0.5	328	10588	36	6	292	10582	10916	0.3010961004783288
M1	cpdb	0	network_modules	48	TRUE	7.206644366591448e-45	304	49	34	0.6938775510204082	0.1118421052631579	GO:0050900	GO:BP	leukocyte migration	16175	13342		0.08275862068965517	0.08904109589041095	304	15871	34	15	270	15856	16175	0.2740294946249694
M1	cpdb	0	network_modules	48	TRUE	1.1562429818099752e-41	460	42	36	0.8571428571428571	0.0782608695652174	REAC:R-HSA-500792	REAC	GPCR ligand binding	10916	1019		0.6	0.6666666666666666	460	10456	36	6	424	10450	10916	0.2521105081094308
M1	cpdb	0	network_modules	48	TRUE	9.30717214449785e-38	774	49	38	0.7755102040816326	0.04909560723514212	GO:0007186	GO:BP	G protein-coupled receptor signaling pathway	16175	2744		0.0896551724137931	0.0958904109589041	774	15401	38	11	736	15390	16175	0.18791511589276566
M1	cpdb	0	network_modules	48	TRUE	1.1134225281202054e-34	594	49	34	0.6938775510204082	0.05723905723905724	GO:0006954	GO:BP	inflammatory response	16175	2585		0.09655172413793103	0.10273972602739725	594	15581	34	15	560	15566	16175	0.19259961361882252
M1	cpdb	0	network_modules	48	TRUE	3.01281274961734e-34	419	49	31	0.6326530612244898	0.07398568019093078	GO:0019221	GO:BP	cytokine-mediated signaling pathway	16175	5598		0.10344827586206896	0.1095890410958904	419	15756	31	18	388	15738	16175	0.21055133200067627
M1	cpdb	0	network_modules	48	TRUE	3.951349114188352e-32	555	49	32	0.6530612244897959	0.05765765765765766	GO:0071345	GO:BP	cellular response to cytokine stimulus	16175	16597		0.1103448275862069	0.11643835616438356	555	15620	32	17	523	15603	16175	0.18737278648141856
M1	cpdb	0	network_modules	48	TRUE	1.8217919693206633e-30	625	49	32	0.6530612244897959	0.0512	GO:0034097	GO:BP	response to cytokine	16175	8408		0.11724137931034483	0.13013698630136986	625	15550	32	17	593	15533	16175	0.17572764672227653
M1	cpdb	0	network_modules	48	TRUE	1.8217919693206633e-30	625	49	32	0.6530612244897959	0.0512	GO:1901652	GO:BP	response to peptide	16175	21619		0.11724137931034483	0.13013698630136986	625	15550	32	17	593	15533	16175	0.17572764672227653
M1	cpdb	0	network_modules	48	TRUE	1.4468550148439008e-29	59	49	18	0.3673469387755102	0.3050847457627119	GO:0048247	GO:BP	lymphocyte chemotaxis	16175	12605		0.1310344827586207	0.136986301369863	59	16116	18	31	41	16085	16175	0.332557596528443
M1	cpdb	0	network_modules	48	TRUE	1.5617650643185952e-29	312	42	27	0.6428571428571429	0.08653846153846154	REAC:R-HSA-418594	REAC	G alpha (i) signalling events	10916	987		0.8	0.8333333333333334	312	10604	27	15	285	10589	10916	0.22911016861382058
M1	cpdb	0	network_modules	48	TRUE	6.195718568286866e-29	102	49	20	0.40816326530612246	0.19607843137254902	GO:0072676	GO:BP	lymphocyte migration	16175	17494		0.13793103448275862	0.14383561643835616	102	16073	20	29	82	16044	16175	0.2798351323701655
M1	cpdb	0	network_modules	48	TRUE	6.640341687818523e-29	188	49	23	0.46938775510204084	0.12234042553191489	GO:0071674	GO:BP	mononuclear cell migration	16175	16847		0.14482758620689656	0.1506849315068493	188	15987	23	26	165	15961	16175	0.2354285132750193
M1	cpdb	0	network_modules	48	TRUE	2.0622354974928807e-28	67	49	18	0.3673469387755102	0.26865671641791045	GO:0002548	GO:BP	monocyte chemotaxis	16175	1069		0.15172413793103448	0.15753424657534246	67	16108	18	31	49	16077	16175	0.3117254799440363
M1	cpdb	0	network_modules	48	TRUE	9.128210354583408e-22	89	49	16	0.32653061224489793	0.1797752808988764	GO:0071347	GO:BP	cellular response to interleukin-1	16175	16599		0.15862068965517243	0.1643835616438356	89	16086	16	33	73	16053	16175	0.23922318970187612
M1	cpdb	0	network_modules	48	TRUE	1.0911153098434496e-20	78	49	15	0.30612244897959184	0.19230769230769232	GO:0061844	GO:BP	antimicrobial humoral immune response mediated by antimicrobial peptide	16175	15685		0.16551724137931034	0.17123287671232876	78	16097	15	34	63	16063	16175	0.2397500118265381
M1	cpdb	0	network_modules	48	TRUE	1.569922386513963e-20	105	49	16	0.32653061224489793	0.1523809523809524	GO:0070555	GO:BP	response to interleukin-1	16175	16175		0.1724137931034483	0.1780821917808219	105	16070	16	33	89	16037	16175	0.21967441159697257
M1	cpdb	0	network_modules	48	TRUE	4.430700628927742e-20	85	49	15	0.30612244897959184	0.17647058823529413	GO:0071346	GO:BP	cellular response to type II interferon	16175	16598		0.1793103448275862	0.18493150684931506	85	16090	15	34	70	16056	16175	0.22938588309663357
M1	cpdb	0	network_modules	48	TRUE	1.3727538486379411e-18	27	49	11	0.22448979591836735	0.4074074074074074	GO:0048245	GO:BP	eosinophil chemotaxis	16175	12603		0.18620689655172415	0.1917808219178082	27	16148	11	38	16	16110	16175	0.30087977622655887
M1	cpdb	0	network_modules	48	TRUE	1.5408867242601072e-18	175	49	17	0.3469387755102041	0.09714285714285714	GO:0070374	GO:BP	positive regulation of ERK1 and ERK2 cascade	16175	16085		0.19310344827586207	0.19863013698630136	175	16000	17	32	158	15968	16175	0.1790992788218692
M1	cpdb	0	network_modules	48	TRUE	1.7784549633899505e-18	107	49	15	0.30612244897959184	0.14018691588785046	GO:0034341	GO:BP	response to type II interferon	16175	8579		0.2	0.2054794520547945	107	16068	15	34	92	16034	16175	0.20366369391164013
M1	cpdb	0	network_modules	48	TRUE	5.71455190944961e-18	30	49	11	0.22448979591836735	0.36666666666666664	GO:0072677	GO:BP	eosinophil migration	16175	17495		0.20689655172413793	0.21232876712328766	30	16145	11	38	19	16107	16175	0.285228520478561
M1	cpdb	0	network_modules	48	TRUE	1.6021017601598282e-17	123	49	15	0.30612244897959184	0.12195121951219512	GO:0019730	GO:BP	antimicrobial humoral response	16175	6021		0.21379310344827587	0.2191780821917808	123	16052	15	34	108	16018	16175	0.1894229387854658
M1	cpdb	0	network_modules	48	TRUE	2.749154292673846e-17	164	49	16	0.32653061224489793	0.0975609756097561	GO:0071356	GO:BP	cellular response to tumor necrosis factor	16175	16608		0.2206896551724138	0.22602739726027396	164	16011	16	33	148	15978	16175	0.1740895361880701
M1	cpdb	0	network_modules	48	TRUE	1.1177824697604047e-16	224	49	17	0.3469387755102041	0.07589285714285714	GO:0006959	GO:BP	humoral immune response	16175	2590		0.22758620689655173	0.2328767123287671	224	15951	17	32	207	15919	16175	0.15711691653877616
M1	cpdb	0	network_modules	48	TRUE	1.2666371429314515e-16	180	49	16	0.32653061224489793	0.08888888888888889	GO:0034612	GO:BP	response to tumor necrosis factor	16175	8690		0.23448275862068965	0.23972602739726026	180	15995	16	33	164	15962	16175	0.16573549174946658
M1	cpdb	0	network_modules	48	TRUE	3.403696322548328e-16	239	49	17	0.3469387755102041	0.07112970711297072	GO:0070372	GO:BP	regulation of ERK1 and ERK2 cascade	16175	16083		0.2413793103448276	0.2465753424657534	239	15936	17	32	222	15904	16175	0.15175447160049443
M1	cpdb	0	network_modules	48	TRUE	1.0314193450516345e-15	255	49	17	0.3469387755102041	0.06666666666666667	GO:0070371	GO:BP	ERK1 and ERK2 cascade	16175	16082		0.2482758620689655	0.2534246575342466	255	15920	17	32	238	15888	16175	0.146552498772667
M1	cpdb	0	network_modules	48	TRUE	2.88450537280048e-15	172	49	15	0.30612244897959184	0.0872093023255814	GO:0002685	GO:BP	regulation of leukocyte migration	16175	1203		0.25517241379310346	0.2602739726027397	172	16003	15	34	157	15969	16175	0.15880165847787842
M1	cpdb	0	network_modules	48	TRUE	8.078340509495875e-15	142	49	14	0.2857142857142857	0.09859154929577464	GO:0071222	GO:BP	cellular response to lipopolysaccharide	16175	16484		0.2620689655172414	0.2671232876712329	142	16033	14	35	128	15998	16175	0.16364613763163377
M1	cpdb	0	network_modules	48	TRUE	2.1466784738243557e-14	152	49	14	0.2857142857142857	0.09210526315789473	GO:0071219	GO:BP	cellular response to molecule of bacterial origin	16175	16481		0.2689655172413793	0.273972602739726	152	16023	14	35	138	15988	16175	0.15786759865937558
M1	cpdb	0	network_modules	48	TRUE	2.6062106547864616e-14	116	49	13	0.2653061224489796	0.11206896551724138	GO:0050921	GO:BP	positive regulation of chemotaxis	16175	13363		0.27586206896551724	0.2808219178082192	116	16059	13	36	103	16023	16175	0.16863080517656012
M1	cpdb	0	network_modules	48	TRUE	2.9073984567501365e-14	376	49	18	0.3673469387755102	0.047872340425531915	GO:0043410	GO:BP	positive regulation of MAPK cascade	16175	10678		0.2827586206896552	0.2876712328767123	376	15799	18	31	358	15768	16175	0.12587991850949606
M1	cpdb	0	network_modules	48	TRUE	1.252233890796964e-13	172	49	14	0.2857142857142857	0.08139534883720931	GO:0071216	GO:BP	cellular response to biotic stimulus	16175	16478		0.2896551724137931	0.2945205479452055	172	16003	14	35	158	15968	16175	0.14783389703823707
M1	cpdb	0	network_modules	48	TRUE	2.581423860079308e-13	181	49	14	0.2857142857142857	0.07734806629834254	GO:0050920	GO:BP	regulation of chemotaxis	16175	13362		0.296551724137931	0.3013698630136986	181	15994	14	35	167	15959	16175	0.14386056691906274
M1	cpdb	0	network_modules	48	TRUE	3.644337266569614e-13	104	49	12	0.24489795918367346	0.11538461538461539	GO:0002688	GO:BP	regulation of leukocyte chemotaxis	16175	1206		0.30344827586206896	0.3082191780821918	104	16071	12	37	92	16034	16175	0.1644642494966068
M1	cpdb	0	network_modules	48	TRUE	4.094434842278028e-13	187	49	14	0.2857142857142857	0.0748663101604278	GO:0032496	GO:BP	response to lipopolysaccharide	16175	7607		0.3103448275862069	0.3150684931506849	187	15988	14	35	173	15953	16175	0.1413691032096494
M1	cpdb	0	network_modules	48	TRUE	1.1359354472274345e-12	81	49	11	0.22448979591836735	0.13580246913580246	GO:0002690	GO:BP	positive regulation of leukocyte chemotaxis	16175	1208		0.31724137931034485	0.3219178082191781	81	16094	11	38	70	16056	16175	0.1713971266928134
M1	cpdb	0	network_modules	48	TRUE	1.3020909103503006e-12	203	49	14	0.2857142857142857	0.06896551724137931	GO:0002237	GO:BP	response to molecule of bacterial origin	16175	770		0.32413793103448274	0.3287671232876712	203	15972	14	35	189	15937	16175	0.13526171236006285
M1	cpdb	0	network_modules	48	TRUE	1.5717777275474278e-12	117	49	12	0.24489795918367346	0.10256410256410256	GO:0002687	GO:BP	positive regulation of leukocyte migration	16175	1205		0.3310344827586207	0.3356164383561644	117	16058	12	37	105	16021	16175	0.15459832908084903
M1	cpdb	0	network_modules	48	TRUE	1.7593280336752075e-12	57	49	10	0.20408163265306123	0.17543859649122806	GO:0072678	GO:BP	T cell migration	16175	17496		0.33793103448275863	0.3424657534246575	57	16118	10	39	47	16079	16175	0.18656290106002235
M1	cpdb	0	network_modules	48	TRUE	1.1892344732977664e-11	530	49	18	0.3673469387755102	0.033962264150943396	GO:0043408	GO:BP	regulation of MAPK cascade	16175	10676		0.3448275862068966	0.3493150684931507	530	15645	18	31	512	15614	16175	0.1035985507314094
M1	cpdb	0	network_modules	48	TRUE	4.276859402168347e-11	77	49	10	0.20408163265306123	0.12987012987012986	GO:0071677	GO:BP	positive regulation of mononuclear cell migration	16175	16850		0.35172413793103446	0.3561643835616438	77	16098	10	39	67	16059	16175	0.15962509561389046
M1	cpdb	0	network_modules	48	TRUE	5.6130107242731305e-11	114	49	11	0.22448979591836735	0.09649122807017543	GO:0071675	GO:BP	regulation of mononuclear cell migration	16175	16848		0.3586206896551724	0.363013698630137	114	16061	11	38	103	16023	16175	0.14327931091321033
M1	cpdb	0	network_modules	48	TRUE	7.904774524004294e-11	92	45	11	0.24444444444444444	0.11956521739130435	KEGG:04657	KEGG	IL-17 signaling pathway	8484	335		0.375	0.4444444444444444	92	8392	11	34	81	8358	8484	0.1647056682568455
M1	cpdb	0	network_modules	48	TRUE	8.72369708846831e-11	595	49	18	0.3673469387755102	0.030252100840336135	GO:0000165	GO:BP	MAPK cascade	16175	55		0.36551724137931035	0.3698630136986301	595	15580	18	31	577	15549	16175	0.09680313580240911
M1	cpdb	0	network_modules	48	TRUE	1.5015911946481263e-10	520	49	17	0.3469387755102041	0.032692307692307694	GO:0033993	GO:BP	response to lipid	16175	8371		0.3724137931034483	0.3767123287671233	520	15655	17	32	503	15623	16175	0.098372174394947
M1	cpdb	0	network_modules	48	TRUE	2.5277670278214683e-10	233	49	13	0.2653061224489796	0.055793991416309016	GO:0006874	GO:BP	intracellular calcium ion homeostasis	16175	2532		0.3793103448275862	0.3835616438356164	233	15942	13	36	220	15906	16175	0.11607330128710842
M1	cpdb	0	network_modules	48	TRUE	5.07473720880338e-10	246	49	13	0.2653061224489796	0.052845528455284556	GO:0055074	GO:BP	calcium ion homeostasis	16175	14230		0.38620689655172413	0.3904109589041096	246	15929	13	36	233	15893	16175	0.1126487781101196
M1	cpdb	0	network_modules	48	TRUE	6.885900578863407e-10	479	49	16	0.32653061224489793	0.033402922755741124	GO:0040017	GO:BP	positive regulation of locomotion	16175	9905		0.3931034482758621	0.3972602739726027	479	15696	16	33	463	15663	16175	0.09654990034710727
M1	cpdb	0	network_modules	48	TRUE	9.227629576005303e-10	24	49	7	0.14285714285714285	0.2916666666666667	GO:0010818	GO:BP	T cell chemotaxis	16175	4430		0.4	0.4041095890410959	24	16151	7	42	17	16109	16175	0.2024609581325789
M1	cpdb	0	network_modules	48	TRUE	1.5983075847894804e-9	45	42	8	0.19047619047619047	0.17777777777777778	REAC:R-HSA-6783783	REAC	Interleukin-10 signaling	10916	1234		1	1	45	10871	8	34	37	10837	10916	0.180755183015821
M1	cpdb	0	network_modules	48	TRUE	3.1282066078209282e-9	28	49	7	0.14285714285714285	0.25	GO:2000406	GO:BP	positive regulation of T cell migration	16175	25721		0.4068965517241379	0.410958904109589	28	16147	7	42	21	16105	16175	0.18713771861315856
M1	cpdb	0	network_modules	48	TRUE	4.506367430544403e-9	450	49	15	0.30612244897959184	0.03333333333333333	GO:0030335	GO:BP	positive regulation of cell migration	16175	6781		0.41379310344827586	0.4178082191780822	450	15725	15	34	435	15691	16175	0.09328103071480404
M1	cpdb	0	network_modules	48	TRUE	7.882758522075296e-9	55	49	8	0.16326530612244897	0.14545454545454545	GO:2000401	GO:BP	regulation of lymphocyte migration	16175	25716		0.4206896551724138	0.4246575342465753	55	16120	8	41	47	16079	16175	0.15138000735804918
M1	cpdb	0	network_modules	48	TRUE	8.394074260161864e-9	470	49	15	0.30612244897959184	0.031914893617021274	GO:2000147	GO:BP	positive regulation of cell motility	16175	25495		0.42758620689655175	0.4315068493150685	470	15705	15	34	455	15671	16175	0.09092706654695813
M1	cpdb	0	network_modules	48	TRUE	8.549364085951958e-9	129	49	10	0.20408163265306123	0.07751937984496124	GO:0007204	GO:BP	positive regulation of cytosolic calcium ion concentration	16175	2759		0.43448275862068964	0.4383561643835616	129	16046	10	39	119	16007	16175	0.12153250120742685
M1	cpdb	0	network_modules	48	TRUE	8.745348949094688e-9	781	49	18	0.3673469387755102	0.023047375160051217	GO:0030334	GO:BP	regulation of cell migration	16175	6780		0.4413793103448276	0.4452054794520548	781	15394	18	31	763	15363	16175	0.0820452748870419
M1	cpdb	0	network_modules	48	TRUE	1.4020001705324462e-8	34	49	7	0.14285714285714285	0.20588235294117646	GO:2000403	GO:BP	positive regulation of lymphocyte migration	16175	25718		0.4482758620689655	0.4520547945205479	34	16141	7	42	27	16099	16175	0.16940981477935588
M1	cpdb	0	network_modules	48	TRUE	1.8941437347591135e-8	408	49	14	0.2857142857142857	0.03431372549019608	GO:0071396	GO:BP	cellular response to lipid	16175	16648		0.45517241379310347	0.4589041095890411	408	15767	14	35	394	15732	16175	0.091572639564361
M1	cpdb	0	network_modules	48	TRUE	2.837228429565035e-8	721	49	17	0.3469387755102041	0.023578363384188627	GO:0045087	GO:BP	innate immune response	16175	11270		0.46206896551724136	0.4657534246575342	721	15454	17	32	704	15422	16175	0.0807645412149243
M1	cpdb	0	network_modules	48	TRUE	3.259190521313352e-8	38	49	7	0.14285714285714285	0.18421052631578946	GO:2000404	GO:BP	regulation of T cell migration	16175	25719		0.4689655172413793	0.4726027397260274	38	16137	7	42	31	16095	16175	0.15998392826279542
M1	cpdb	0	network_modules	48	TRUE	4.770397779957294e-8	88	45	9	0.2	0.10227272727272728	KEGG:05323	KEGG	Rheumatoid arthritis	8484	485		0.5	0.5555555555555556	88	8396	9	36	79	8360	8484	0.13667380017047515
M1	cpdb	0	network_modules	48	TRUE	5.678876448824593e-8	443	49	14	0.2857142857142857	0.03160270880361174	GO:0009617	GO:BP	response to bacterium	16175	3543		0.47586206896551725	0.4794520547945205	443	15732	14	35	429	15697	16175	0.08724767503835511
M1	cpdb	0	network_modules	48	TRUE	1.0119179989161364e-7	23	49	6	0.12244897959183673	0.2608695652173913	GO:1901623	GO:BP	regulation of lymphocyte chemotaxis	16175	21603		0.4827586206896552	0.4863013698630137	23	16152	6	43	17	16109	16175	0.17704526416372712
M1	cpdb	0	network_modules	48	TRUE	1.3762052170332478e-7	4	49	4	0.08163265306122448	1	GO:1903237	GO:BP	negative regulation of leukocyte tethering or rolling	16175	22849		0.4896551724137931	0.4931506849315068	4	16171	4	45	0	16126	16175	0.2853164717291432
M1	cpdb	0	network_modules	48	TRUE	2.864660590710716e-7	407	49	13	0.2653061224489796	0.03194103194103194	GO:0098771	GO:BP	inorganic ion homeostasis	16175	18886		0.496551724137931	0.5	407	15768	13	36	394	15732	16175	0.08452105964321924
M1	cpdb	0	network_modules	48	TRUE	4.473871787791083e-7	422	49	13	0.2653061224489796	0.030805687203791468	GO:0030003	GO:BP	intracellular monoatomic cation homeostasis	16175	6648		0.503448275862069	0.5068493150684932	422	15753	13	36	409	15717	16175	0.08272413438822411
M1	cpdb	0	network_modules	48	TRUE	5.023990310008799e-7	426	49	13	0.2653061224489796	0.03051643192488263	GO:0006873	GO:BP	intracellular monoatomic ion homeostasis	16175	2531		0.5103448275862069	0.5136986301369864	426	15749	13	36	413	15713	16175	0.08226017116936153
M1	cpdb	0	network_modules	48	TRUE	6.192507922516868e-7	531	49	14	0.2857142857142857	0.026365348399246705	GO:0032103	GO:BP	positive regulation of response to external stimulus	16175	7367		0.5172413793103449	0.5205479452054794	531	15644	14	35	517	15609	16175	0.07823162680170122
M1	cpdb	0	network_modules	48	TRUE	6.865707493918559e-7	5	49	4	0.08163265306122448	0.8	GO:1904995	GO:BP	negative regulation of leukocyte adhesion to vascular endothelial cell	16175	24280		0.5241379310344828	0.5273972602739726	5	16170	4	45	1	16125	16175	0.2550088383308909
M1	cpdb	0	network_modules	48	TRUE	7.511905586502323e-7	14	49	5	0.10204081632653061	0.35714285714285715	GO:0010819	GO:BP	regulation of T cell chemotaxis	16175	4431		0.5310344827586206	0.5342465753424658	14	16161	5	44	9	16117	16175	0.18965106982396984
M1	cpdb	0	network_modules	48	TRUE	1.1791589557436282e-6	101	49	8	0.16326530612244897	0.07920792079207921	GO:0051209	GO:BP	release of sequestered calcium ion into cytosol	16175	13568		0.5379310344827586	0.541095890410959	101	16074	8	41	93	16033	16175	0.10987891289543668
M1	cpdb	0	network_modules	48	TRUE	1.2766213730546327e-6	102	49	8	0.16326530612244897	0.0784313725490196	GO:0051283	GO:BP	negative regulation of sequestering of calcium ion	16175	13619		0.5448275862068965	0.547945205479452	102	16073	8	41	94	16032	16175	0.10929931409257501
M1	cpdb	0	network_modules	48	TRUE	1.3809982996308486e-6	103	49	8	0.16326530612244897	0.07766990291262135	GO:0051282	GO:BP	regulation of sequestering of calcium ion	16175	13618		0.5517241379310345	0.5547945205479452	103	16072	8	41	95	16031	16175	0.10872798137293588
M1	cpdb	0	network_modules	48	TRUE	1.546453409676985e-6	467	49	13	0.2653061224489796	0.027837259100642397	GO:0055080	GO:BP	monoatomic cation homeostasis	16175	14233		0.5586206896551724	0.5616438356164384	467	15708	13	36	454	15672	16175	0.07783425843633009
M1	cpdb	0	network_modules	48	TRUE	1.7398214882561123e-6	106	49	8	0.16326530612244897	0.07547169811320754	GO:0051208	GO:BP	sequestering of calcium ion	16175	13567		0.5655172413793104	0.5684931506849316	106	16069	8	41	98	16028	16175	0.10706162970708877
M1	cpdb	0	network_modules	48	TRUE	1.901643022317018e-6	475	49	13	0.2653061224489796	0.02736842105263158	GO:0050801	GO:BP	monoatomic ion homeostasis	16175	13267		0.5724137931034483	0.5753424657534246	475	15700	13	36	462	15664	16175	0.07703420549760086
M1	cpdb	0	network_modules	48	TRUE	2.055127091611654e-6	6	49	4	0.08163265306122448	0.6666666666666666	GO:0002692	GO:BP	negative regulation of cellular extravasation	16175	1210		0.5793103448275863	0.589041095890411	6	16169	4	45	2	16124	16175	0.2326203764641337
M1	cpdb	0	network_modules	48	TRUE	2.055127091611654e-6	6	49	4	0.08163265306122448	0.6666666666666666	GO:2000669	GO:BP	negative regulation of dendritic cell apoptotic process	16175	25944		0.5793103448275863	0.589041095890411	6	16169	4	45	2	16124	16175	0.2326203764641337
M1	cpdb	0	network_modules	48	TRUE	2.7189835597784244e-6	166	49	9	0.1836734693877551	0.05421686746987952	GO:0019722	GO:BP	calcium-mediated signaling	16175	6018		0.593103448275862	0.5958904109589042	166	16009	9	40	157	15969	16175	0.09484595030444315
M1	cpdb	0	network_modules	48	TRUE	3.938262708714362e-6	102	45	8	0.17777777777777778	0.0784313725490196	KEGG:04064	KEGG	NF-kappa B signaling pathway	8484	256		0.625	0.6666666666666666	102	8382	8	37	94	8345	8484	0.11105919774150305
M1	cpdb	0	network_modules	48	TRUE	4.313821454986259e-6	19	49	5	0.10204081632653061	0.2631578947368421	GO:0090023	GO:BP	positive regulation of neutrophil chemotaxis	16175	17957		0.6	0.6027397260273972	19	16156	5	44	14	16112	16175	0.16232327035948615
M1	cpdb	0	network_modules	48	TRUE	4.814200888330733e-6	324	49	11	0.22448979591836735	0.033950617283950615	GO:0006816	GO:BP	calcium ion transport	16175	2495		0.6068965517241379	0.6095890410958904	324	15851	11	38	313	15813	16175	0.0804422388951969
M1	cpdb	0	network_modules	48	TRUE	4.914178551765423e-6	623	49	14	0.2857142857142857	0.02247191011235955	GO:0019725	GO:BP	cellular homeostasis	16175	6020		0.6137931034482759	0.6164383561643836	623	15552	14	35	609	15517	16175	0.07080874665837482
M1	cpdb	0	network_modules	48	TRUE	5.03533689669458e-6	42	49	6	0.12244897959183673	0.14285714285714285	GO:0071622	GO:BP	regulation of granulocyte chemotaxis	16175	16802		0.6206896551724138	0.6232876712328768	42	16133	6	43	36	16090	16175	0.12982055209119506
M1	cpdb	0	network_modules	48	TRUE	7.832090994347127e-6	534	49	13	0.2653061224489796	0.024344569288389514	GO:0055082	GO:BP	intracellular chemical homeostasis	16175	14235		0.6275862068965518	0.6301369863013698	534	15641	13	36	521	15605	16175	0.07166560389576142
M1	cpdb	0	network_modules	48	TRUE	8.803026551168179e-6	113	45	8	0.17777777777777778	0.07079646017699115	KEGG:04668	KEGG	TNF signaling pathway	8484	342		0.75	0.7777777777777778	113	8371	8	37	105	8334	8484	0.10475869740658326
M1	cpdb	0	network_modules	48	TRUE	9.703240127311647e-6	22	49	5	0.10204081632653061	0.22727272727272727	GO:0002407	GO:BP	dendritic cell chemotaxis	16175	931		0.6344827586206897	0.6438356164383562	22	16153	5	44	17	16109	16175	0.15058692307352758
M1	cpdb	0	network_modules	48	TRUE	9.703240127311647e-6	22	49	5	0.10204081632653061	0.22727272727272727	GO:0071624	GO:BP	positive regulation of granulocyte chemotaxis	16175	16804		0.6344827586206897	0.6438356164383562	22	16153	5	44	17	16109	16175	0.15058692307352758
M1	cpdb	0	network_modules	48	TRUE	1.714804483988547e-5	9	49	4	0.08163265306122448	0.4444444444444444	GO:0097048	GO:BP	dendritic cell apoptotic process	16175	18461		0.6482758620689655	0.6575342465753424	9	16166	4	45	5	16121	16175	0.18951782042020504
M1	cpdb	0	network_modules	48	TRUE	1.714804483988547e-5	9	49	4	0.08163265306122448	0.4444444444444444	GO:2000668	GO:BP	regulation of dendritic cell apoptotic process	16175	25943		0.6482758620689655	0.6575342465753424	9	16166	4	45	5	16121	16175	0.18951782042020504
M1	cpdb	0	network_modules	48	TRUE	1.9443868742828285e-5	25	49	5	0.10204081632653061	0.2	GO:0036336	GO:BP	dendritic cell migration	16175	9571		0.6620689655172414	0.6712328767123288	25	16150	5	44	20	16106	16175	0.14101591986984968
M1	cpdb	0	network_modules	48	TRUE	1.9443868742828285e-5	25	49	5	0.10204081632653061	0.2	GO:1902624	GO:BP	positive regulation of neutrophil migration	16175	22395		0.6620689655172414	0.6712328767123288	25	16150	5	44	20	16106	16175	0.14101591986984968
M1	cpdb	0	network_modules	48	TRUE	2.1584641376182923e-5	93	49	7	0.14285714285714285	0.07526881720430108	GO:0051928	GO:BP	positive regulation of calcium ion transport	16175	13999		0.6758620689655173	0.678082191780822	93	16082	7	42	86	16040	16175	0.09996058824144315
M1	cpdb	0	network_modules	48	TRUE	2.401878665983511e-5	26	49	5	0.10204081632653061	0.19230769230769232	GO:0090022	GO:BP	regulation of neutrophil chemotaxis	16175	17956		0.6827586206896552	0.684931506849315	26	16149	5	44	21	16105	16175	0.13819669746205515
M1	cpdb	0	network_modules	48	TRUE	4.552216689759769e-5	160	49	8	0.16326530612244897	0.05	GO:0097553	GO:BP	calcium ion transmembrane import into cytosol	16175	18700		0.6896551724137931	0.6917808219178082	160	16015	8	41	152	15974	16175	0.08542910585440343
M1	cpdb	0	network_modules	48	TRUE	4.838258863013408e-5	3	49	3	0.061224489795918366	1	GO:0002408	GO:BP	myeloid dendritic cell chemotaxis	16175	932		0.696551724137931	0.7123287671232876	3	16172	3	46	0	16126	16175	0.24708367303836232
M1	cpdb	0	network_modules	48	TRUE	4.838258863013408e-5	3	49	3	0.061224489795918366	1	GO:0097026	GO:BP	dendritic cell dendrite assembly	16175	18450		0.696551724137931	0.7123287671232876	3	16172	3	46	0	16126	16175	0.24708367303836232
M1	cpdb	0	network_modules	48	TRUE	4.838258863013408e-5	3	49	3	0.061224489795918366	1	GO:2000547	GO:BP	regulation of dendritic cell dendrite assembly	16175	25848		0.696551724137931	0.7123287671232876	3	16172	3	46	0	16126	16175	0.24708367303836232
M1	cpdb	0	network_modules	48	TRUE	6.691851087189523e-5	12	49	4	0.08163265306122448	0.3333333333333333	GO:1903236	GO:BP	regulation of leukocyte tethering or rolling	16175	22848		0.7172413793103448	0.7191780821917808	12	16163	4	45	8	16118	16175	0.16376698283078284
M1	cpdb	0	network_modules	48	TRUE	9.644495764673005e-5	13	49	4	0.08163265306122448	0.3076923076923077	GO:0010820	GO:BP	positive regulation of T cell chemotaxis	16175	4432		0.7241379310344828	0.726027397260274	13	16162	4	45	9	16117	16175	0.15722683685621747
M1	cpdb	0	network_modules	48	TRUE	9.977387448230847e-5	34	49	5	0.10204081632653061	0.14705882352941177	GO:1902622	GO:BP	regulation of neutrophil migration	16175	22393		0.7310344827586207	0.7328767123287672	34	16141	5	44	29	16097	16175	0.12028417266969048
M1	cpdb	0	network_modules	48	TRUE	1.0093728436866367e-4	791	49	14	0.2857142857142857	0.017699115044247787	GO:1901701	GO:BP	cellular response to oxygen-containing compound	16175	21654		0.7379310344827587	0.7397260273972602	791	15384	14	35	777	15349	16175	0.06052840126964777
M1	cpdb	0	network_modules	48	TRUE	1.2406382817838538e-4	182	49	8	0.16326530612244897	0.04395604395604396	GO:0051651	GO:BP	maintenance of location in cell	16175	13864		0.7448275862068966	0.7465753424657534	182	15993	8	41	174	15952	16175	0.07944382349513188
M1	cpdb	0	network_modules	48	TRUE	1.2790052245860076e-4	70	45	6	0.13333333333333333	0.08571428571428572	KEGG:05120	KEGG	Epithelial cell signaling in Helicobacter pylori infection	8484	426		0.875	0.8888888888888888	70	8414	6	39	64	8375	8484	0.10097357454623992
M1	cpdb	0	network_modules	48	TRUE	1.3456537893193814e-4	36	49	5	0.10204081632653061	0.1388888888888889	GO:0051281	GO:BP	positive regulation of release of sequestered calcium ion into cytosol	16175	13617		0.7517241379310344	0.7534246575342466	36	16139	5	44	31	16095	16175	0.11675781131169478
M1	cpdb	0	network_modules	48	TRUE	1.5197803648318866e-4	686	49	13	0.2653061224489796	0.018950437317784258	GO:0008284	GO:BP	positive regulation of cell population proliferation	16175	3151		0.7586206896551724	0.7602739726027398	686	15489	13	36	673	15453	16175	0.06096850824220466
M1	cpdb	0	network_modules	48	TRUE	1.7835434673554444e-4	38	49	5	0.10204081632653061	0.13157894736842105	GO:0002686	GO:BP	negative regulation of leukocyte migration	16175	1204		0.7655172413793103	0.7671232876712328	38	16137	5	44	33	16093	16175	0.11350996402600733
M1	cpdb	0	network_modules	48	TRUE	2.995355194707757e-4	42	49	5	0.10204081632653061	0.11904761904761904	GO:0030838	GO:BP	positive regulation of actin filament polymerization	16175	6923		0.7724137931034483	0.773972602739726	42	16133	5	44	37	16089	16175	0.1077150334151478
M1	cpdb	0	network_modules	48	TRUE	4.0818552644085893e-4	18	49	4	0.08163265306122448	0.2222222222222222	GO:0140131	GO:BP	positive regulation of lymphocyte chemotaxis	16175	19677		0.7793103448275862	0.7808219178082192	18	16157	4	45	14	16112	16175	0.1331267123255769
M1	cpdb	0	network_modules	48	TRUE	4.358985882820265e-4	622	49	12	0.24489795918367346	0.01929260450160772	GO:0030155	GO:BP	regulation of cell adhesion	16175	6688		0.7862068965517242	0.7876712328767124	622	15553	12	37	610	15516	16175	0.05918042105997538
M1	cpdb	0	network_modules	48	TRUE	5.158846477704247e-4	19	49	4	0.08163265306122448	0.21052631578947367	GO:0090026	GO:BP	positive regulation of monocyte chemotaxis	16175	17960		0.7931034482758621	0.7945205479452054	19	16156	4	45	15	16111	16175	0.1294805442253837
M1	cpdb	0	network_modules	48	TRUE	5.198360916743113e-4	763	49	13	0.2653061224489796	0.01703800786369594	GO:0048878	GO:BP	chemical homeostasis	16175	13119		0.8	0.8013698630136986	763	15412	13	36	750	15376	16175	0.056716799184924366
M1	cpdb	0	network_modules	48	TRUE	9.095726765581732e-4	236	49	8	0.16326530612244897	0.03389830508474576	GO:0050678	GO:BP	regulation of epithelial cell proliferation	16175	13212		0.8068965517241379	0.8082191780821918	236	15939	8	41	228	15898	16175	0.06834867301753118
M1	cpdb	0	network_modules	48	TRUE	9.614726254373461e-4	6	49	3	0.061224489795918366	0.5	GO:0002606	GO:BP	positive regulation of dendritic cell antigen processing and presentation	16175	1127		0.8137931034482758	0.815068493150685	6	16169	3	46	3	16123	16175	0.17419981643389795
M1	cpdb	0	network_modules	48	TRUE	0.0010338894580306313	163	49	7	0.14285714285714285	0.04294478527607362	GO:0043270	GO:BP	positive regulation of monoatomic ion transport	16175	10594		0.8206896551724138	0.821917808219178	163	16012	7	42	156	15970	16175	0.07328154639077747
M1	cpdb	0	network_modules	48	TRUE	0.0013647857328268718	249	49	8	0.16326530612244897	0.0321285140562249	GO:0070588	GO:BP	calcium ion transmembrane transport	16175	16193		0.8275862068965517	0.8287671232876712	249	15926	8	41	241	15885	16175	0.06620785366496246
M1	cpdb	0	network_modules	48	TRUE	0.001661331076735288	25	49	4	0.08163265306122448	0.16	GO:1904994	GO:BP	regulation of leukocyte adhesion to vascular endothelial cell	16175	24279		0.8344827586206897	0.8356164383561644	25	16150	4	45	21	16105	16175	0.11237897694587205
M1	cpdb	0	network_modules	48	TRUE	0.0016961403134379118	59	49	5	0.10204081632653061	0.0847457627118644	GO:0045123	GO:BP	cellular extravasation	16175	11289		0.8413793103448276	0.8424657534246576	59	16116	5	44	54	16072	16175	0.08996829798089254
M1	cpdb	0	network_modules	48	TRUE	0.0018461420781314718	60	49	5	0.10204081632653061	0.08333333333333333	GO:0051279	GO:BP	regulation of release of sequestered calcium ion into cytosol	16175	13615		0.8482758620689655	0.8493150684931506	60	16115	5	44	55	16071	16175	0.08916212118389406
M1	cpdb	0	network_modules	48	TRUE	0.0019427062553248652	179	49	7	0.14285714285714285	0.03910614525139665	GO:0051924	GO:BP	regulation of calcium ion transport	16175	13997		0.8551724137931035	0.8561643835616438	179	15996	7	42	172	15954	16175	0.06944348292937869
M1	cpdb	0	network_modules	48	TRUE	0.001959024220385366	26	49	4	0.08163265306122448	0.15384615384615385	GO:0090025	GO:BP	regulation of monocyte chemotaxis	16175	17959		0.8620689655172413	0.863013698630137	26	16149	4	45	22	16104	16175	0.11011499520393349
M1	cpdb	0	network_modules	48	TRUE	0.002062303227961487	113	49	6	0.12244897959183673	0.05309734513274336	GO:0008064	GO:BP	regulation of actin polymerization or depolymerization	16175	3113		0.8689655172413793	0.8698630136986302	113	16062	6	43	107	16019	16175	0.07641566422259193
M1	cpdb	0	network_modules	48	TRUE	0.002405444618974655	116	49	6	0.12244897959183673	0.05172413793103448	GO:0030832	GO:BP	regulation of actin filament length	16175	6917		0.8758620689655172	0.8767123287671232	116	16059	6	43	110	16016	16175	0.07530693992287829
M1	cpdb	0	network_modules	48	TRUE	0.0026518120593091174	272	49	8	0.16326530612244897	0.029411764705882353	GO:0050673	GO:BP	epithelial cell proliferation	16175	13207		0.8827586206896552	0.8835616438356164	272	15903	8	41	264	15862	16175	0.06278300786876498
M1	cpdb	0	network_modules	48	TRUE	0.0026710901522370226	28	49	4	0.08163265306122448	0.14285714285714285	GO:0050901	GO:BP	leukocyte tethering or rolling	16175	13343		0.8896551724137931	0.8972602739726028	28	16147	4	45	24	16102	16175	0.1059520749942702
M1	cpdb	0	network_modules	48	TRUE	0.0026710901522370226	28	49	4	0.08163265306122448	0.14285714285714285	GO:2000107	GO:BP	negative regulation of leukocyte apoptotic process	16175	25458		0.8896551724137931	0.8972602739726028	28	16147	4	45	24	16102	16175	0.1059520749942702
M1	cpdb	0	network_modules	48	TRUE	0.0026806530384460053	8	49	3	0.061224489795918366	0.375	GO:0002579	GO:BP	positive regulation of antigen processing and presentation	16175	1100		0.903448275862069	0.9041095890410958	8	16167	3	46	5	16121	16175	0.1505642449285411
M1	cpdb	0	network_modules	48	TRUE	0.002801269600103015	274	49	8	0.16326530612244897	0.029197080291970802	GO:0051235	GO:BP	maintenance of location	16175	13585		0.9103448275862069	0.910958904109589	274	15901	8	41	266	15860	16175	0.06250456952619626
M1	cpdb	0	network_modules	48	TRUE	0.0028203104200062125	373	49	9	0.1836734693877551	0.024128686327077747	GO:0045785	GO:BP	positive regulation of cell adhesion	16175	11617		0.9172413793103448	0.9178082191780822	373	15802	9	40	364	15762	16175	0.05898611158576459
M1	cpdb	0	network_modules	48	TRUE	0.003559267520674176	30	49	4	0.08163265306122448	0.13333333333333333	GO:0002691	GO:BP	regulation of cellular extravasation	16175	1209		0.9241379310344827	0.9246575342465754	30	16145	4	45	26	16100	16175	0.10220735796582366
M1	cpdb	0	network_modules	48	TRUE	0.0037221577266251258	69	49	5	0.10204081632653061	0.07246376811594203	GO:1904427	GO:BP	positive regulation of calcium ion transmembrane transport	16175	23809		0.9310344827586207	0.9315068493150684	69	16106	5	44	64	16062	16175	0.08269672636775234
M1	cpdb	0	network_modules	48	TRUE	0.0037402482204427433	386	49	9	0.1836734693877551	0.023316062176165803	GO:0022407	GO:BP	regulation of cell-cell adhesion	16175	6598		0.9379310344827586	0.9383561643835616	386	15789	9	40	377	15749	16175	0.057717907794524966
M1	cpdb	0	network_modules	48	TRUE	0.0039593346275675085	287	49	8	0.16326530612244897	0.027874564459930314	GO:1903037	GO:BP	regulation of leukocyte cell-cell adhesion	16175	22717		0.9448275862068966	0.9452054794520548	287	15888	8	41	279	15847	16175	0.060761952270116625
M1	cpdb	0	network_modules	48	TRUE	0.00401240553524907	9	49	3	0.061224489795918366	0.3333333333333333	GO:0001771	GO:BP	immunological synapse formation	16175	437		0.9517241379310345	0.958904109589041	9	16166	3	46	6	16120	16175	0.14181320713184362
M1	cpdb	0	network_modules	48	TRUE	0.00401240553524907	9	49	3	0.061224489795918366	0.3333333333333333	GO:0002604	GO:BP	regulation of dendritic cell antigen processing and presentation	16175	1125		0.9517241379310345	0.958904109589041	9	16166	3	46	6	16120	16175	0.14181320713184362
M1	cpdb	0	network_modules	48	TRUE	0.004075277016966143	631	49	11	0.22448979591836735	0.017432646592709985	GO:0022603	GO:BP	regulation of anatomical structure morphogenesis	16175	6611		0.9655172413793104	0.9657534246575342	631	15544	11	38	620	15506	16175	0.052805312794570215
M1	cpdb	0	network_modules	48	TRUE	0.004277956731975779	128	49	6	0.12244897959183673	0.046875	GO:0034767	GO:BP	positive regulation of monoatomic ion transmembrane transport	16175	8736		0.9724137931034482	0.9726027397260274	128	16047	6	43	122	16004	16175	0.07125532599971117
M1	cpdb	0	network_modules	48	TRUE	0.006404672560849055	44	45	4	0.08888888888888889	0.09090909090909091	KEGG:04672	KEGG	Intestinal immune network for IgA production	8484	344		1	1	44	8440	4	41	40	8399	8484	0.08509481542226562
M1	cpdb	0	network_modules	48	TRUE	0.007296958383044968	79	49	5	0.10204081632653061	0.06329113924050633	GO:0032273	GO:BP	positive regulation of protein polymerization	16175	7454		0.9793103448275862	0.9794520547945206	79	16096	5	44	74	16052	16175	0.07682089989332995
M1	cpdb	0	network_modules	48	TRUE	0.007847939585138014	11	49	3	0.061224489795918366	0.2727272727272727	GO:0001768	GO:BP	establishment of T cell polarity	16175	434		0.9862068965517241	0.9863013698630136	11	16164	3	46	8	16118	16175	0.12802135468568063
M1	cpdb	0	network_modules	48	TRUE	0.008029323296357797	677	49	11	0.22448979591836735	0.01624815361890694	GO:0030001	GO:BP	metal ion transport	16175	6646		0.993103448275862	0.9931506849315068	677	15498	11	38	666	15460	16175	0.050272564802988064
M1	cpdb	0	network_modules	48	TRUE	0.009712000226153088	324	49	8	0.16326530612244897	0.024691358024691357	GO:0007159	GO:BP	leukocyte cell-cell adhesion	16175	2723		1	1	324	15851	8	41	316	15810	16175	0.05635409492399418
M1	cpdb	0	network_modules	49	TRUE	1.0915194631376922e-13	630	45	20	0.4444444444444444	0.031746031746031744	GO:0098660	GO:BP	inorganic ion transmembrane transport	16175	18816		0	0.015873015873015872	630	15545	20	25	610	15520	16175	0.11070155186462564
M1	cpdb	0	network_modules	49	TRUE	6.765580727275065e-12	671	45	19	0.4222222222222222	0.028315946348733235	GO:0034220	GO:BP	monoatomic ion transmembrane transport	16175	8508		0.016129032258064516	0.031746031746031744	671	15504	19	26	652	15478	16175	0.10085024584653035
M1	cpdb	0	network_modules	49	TRUE	7.930793823116097e-12	575	45	18	0.4	0.03130434782608696	GO:0098662	GO:BP	inorganic cation transmembrane transport	16175	18818		0.03225806451612903	0.047619047619047616	575	15600	18	27	557	15573	16175	0.10396248721956272
M1	cpdb	0	network_modules	49	TRUE	7.954737838036762e-12	677	45	19	0.4222222222222222	0.028064992614475627	GO:0030001	GO:BP	metal ion transport	16175	6646		0.04838709677419355	0.06349206349206349	677	15498	19	26	658	15472	16175	0.10032394729610165
M1	cpdb	0	network_modules	49	TRUE	8.422673225267521e-12	577	45	18	0.4	0.03119584055459272	GO:0098655	GO:BP	monoatomic cation transmembrane transport	16175	18811		0.06451612903225806	0.07936507936507936	577	15598	18	27	559	15571	16175	0.1037535940489336
M1	cpdb	0	network_modules	49	TRUE	1.0470669518421631e-11	108	45	11	0.24444444444444444	0.10185185185185185	GO:0001508	GO:BP	action potential	16175	323		0.08064516129032258	0.09523809523809523	108	16067	11	34	97	16033	16175	0.15420786752811846
M1	cpdb	0	network_modules	49	TRUE	1.1516926635847687e-11	262	45	14	0.3111111111111111	0.05343511450381679	GO:0034765	GO:BP	regulation of monoatomic ion transmembrane transport	16175	8734		0.0967741935483871	0.1111111111111111	262	15913	14	31	248	15882	16175	0.12339597884402552
M1	cpdb	0	network_modules	49	TRUE	2.0767575002978857e-11	159	45	12	0.26666666666666666	0.07547169811320754	GO:0006814	GO:BP	sodium ion transport	16175	2494		0.11290322580645161	0.12698412698412698	159	16016	12	33	147	15983	16175	0.13750383829342966
M1	cpdb	0	network_modules	49	TRUE	2.587820388132751e-11	117	45	11	0.24444444444444444	0.09401709401709402	GO:0099587	GO:BP	inorganic ion import across plasma membrane	16175	19152		0.12903225806451613	0.15873015873015872	117	16058	11	34	106	16024	16175	0.1478528288791375
M1	cpdb	0	network_modules	49	TRUE	2.587820388132751e-11	117	45	11	0.24444444444444444	0.09401709401709402	GO:0098659	GO:BP	inorganic cation import across plasma membrane	16175	18815		0.12903225806451613	0.15873015873015872	117	16058	11	34	106	16024	16175	0.1478528288791375
M1	cpdb	0	network_modules	49	TRUE	4.843147489732125e-11	748	45	19	0.4222222222222222	0.02540106951871658	GO:0006812	GO:BP	monoatomic cation transport	16175	2492		0.16129032258064516	0.1746031746031746	748	15427	19	26	729	15401	16175	0.09455930645225001
M1	cpdb	0	network_modules	49	TRUE	1.0962533273467524e-10	203	33	12	0.36363636363636365	0.059113300492610835	REAC:R-HSA-397014	REAC	Muscle contraction	10916	1496		0	0.041666666666666664	203	10713	12	21	191	10692	10916	0.14064095753084255
M1	cpdb	0	network_modules	49	TRUE	4.3386657166215223e-10	341	45	14	0.3111111111111111	0.04105571847507331	GO:0043269	GO:BP	regulation of monoatomic ion transport	16175	10593		0.1774193548387097	0.19047619047619047	341	15834	14	31	327	15803	16175	0.10663568651763516
M1	cpdb	0	network_modules	49	TRUE	4.993232783187983e-10	71	45	9	0.2	0.1267605633802817	GO:0086001	GO:BP	cardiac muscle cell action potential	16175	17878		0.1935483870967742	0.20634920634920634	71	16104	9	36	62	16068	16175	0.1562893887761117
M1	cpdb	0	network_modules	49	TRUE	7.226423019433398e-10	354	45	14	0.3111111111111111	0.03954802259887006	GO:0034762	GO:BP	regulation of transmembrane transport	16175	8731		0.20967741935483872	0.2222222222222222	354	15821	14	31	340	15790	16175	0.10441221872684678
M1	cpdb	0	network_modules	49	TRUE	1.0286164301122876e-9	31	33	7	0.21212121212121213	0.22580645161290322	REAC:R-HSA-445095	REAC	Interaction between L1 and Ankyrins	10916	1219		0.043478260869565216	0.08333333333333333	31	10885	7	26	24	10859	10916	0.21656169129191793
M1	cpdb	0	network_modules	49	TRUE	1.2030950220194437e-9	27	45	7	0.15555555555555556	0.25925925925925924	GO:0086010	GO:BP	membrane depolarization during action potential	16175	17884		0.22580645161290322	0.23809523809523808	27	16148	7	38	20	16110	16175	0.19910955613026862
M1	cpdb	0	network_modules	49	TRUE	1.9822895224122958e-9	259	33	12	0.36363636363636365	0.04633204633204633	REAC:R-HSA-112315	REAC	Transmission across Chemical Synapses	10916	2580		0.08695652173913043	0.125	259	10657	12	21	247	10636	10916	0.12298224200349693
M1	cpdb	0	network_modules	49	TRUE	2.061984917017067e-9	303	45	13	0.28888888888888886	0.0429042904290429	GO:0003012	GO:BP	muscle system process	16175	1463		0.24193548387096775	0.25396825396825395	303	15872	13	32	290	15840	16175	0.10524737754554556
M1	cpdb	0	network_modules	49	TRUE	3.5121631209200828e-9	182	45	11	0.24444444444444444	0.06043956043956044	GO:0098739	GO:BP	import across plasma membrane	16175	18866		0.25806451612903225	0.2698412698412698	182	15993	11	34	171	15959	16175	0.11677430777606536
M1	cpdb	0	network_modules	49	TRUE	6.764106173455938e-9	258	45	12	0.26666666666666666	0.046511627906976744	GO:0006936	GO:BP	muscle contraction	16175	2575		0.27419354838709675	0.2857142857142857	258	15917	12	33	246	15884	16175	0.10570004433780679
M1	cpdb	0	network_modules	49	TRUE	9.959728022051712e-9	144	45	10	0.2222222222222222	0.06944444444444445	GO:0006941	GO:BP	striated muscle contraction	16175	2579		0.2903225806451613	0.30158730158730157	144	16031	10	35	134	15996	16175	0.11995063718737066
M1	cpdb	0	network_modules	49	TRUE	1.7459285041797872e-8	119	33	9	0.2727272727272727	0.07563025210084033	REAC:R-HSA-373760	REAC	L1CAM interactions	10916	1294		0.13043478260869565	0.16666666666666666	119	10797	9	24	110	10773	10916	0.1388460926505195
M1	cpdb	0	network_modules	49	TRUE	1.921320108018995e-8	282	45	12	0.26666666666666666	0.0425531914893617	GO:0042391	GO:BP	regulation of membrane potential	16175	10141		0.3064516129032258	0.31746031746031744	282	15893	12	33	270	15860	16175	0.10057968864618384
M1	cpdb	0	network_modules	49	TRUE	3.078962720372687e-8	21	45	6	0.13333333333333333	0.2857142857142857	GO:0086012	GO:BP	membrane depolarization during cardiac muscle cell action potential	16175	17886		0.3225806451612903	0.3333333333333333	21	16154	6	39	15	16115	16175	0.19367468390286108
M1	cpdb	0	network_modules	49	TRUE	3.8878221979300543e-8	130	33	9	0.2727272727272727	0.06923076923076923	REAC:R-HSA-5576891	REAC	Cardiac conduction	10916	306		0.17391304347826086	0.20833333333333334	130	10786	9	24	121	10762	10916	0.13239820764648044
M1	cpdb	0	network_modules	49	TRUE	4.22415297395634e-8	43	45	7	0.15555555555555556	0.16279069767441862	GO:1902305	GO:BP	regulation of sodium ion transmembrane transport	16175	22192		0.3387096774193548	0.36507936507936506	43	16132	7	38	36	16094	16175	0.1568391093453838
M1	cpdb	0	network_modules	49	TRUE	4.22415297395634e-8	43	45	7	0.15555555555555556	0.16279069767441862	GO:1990573	GO:BP	potassium ion import across plasma membrane	16175	25222		0.3387096774193548	0.36507936507936506	43	16132	7	38	36	16094	16175	0.1568391093453838
M1	cpdb	0	network_modules	49	TRUE	5.047771858832964e-8	117	45	9	0.2	0.07692307692307693	GO:0035725	GO:BP	sodium ion transmembrane transport	16175	9195		0.3709677419354839	0.38095238095238093	117	16058	9	36	108	16022	16175	0.1201507611492632
M1	cpdb	0	network_modules	49	TRUE	6.301843436515825e-8	196	33	10	0.30303030303030304	0.05102040816326531	REAC:R-HSA-112314	REAC	Neurotransmitter receptors and postsynaptic signal transmission	10916	1594		0.21739130434782608	0.25	196	10720	10	23	186	10697	10916	0.11821699053219048
M1	cpdb	0	network_modules	49	TRUE	7.517831942727748e-8	29	33	6	0.18181818181818182	0.20689655172413793	REAC:R-HSA-1296059	REAC	G protein gated Potassium channels	10916	995		0.2608695652173913	0.375	29	10887	6	27	23	10860	10916	0.19166280377060763
M1	cpdb	0	network_modules	49	TRUE	7.517831942727748e-8	29	33	6	0.18181818181818182	0.20689655172413793	REAC:R-HSA-997272	REAC	Inhibition  of voltage gated Ca2+ channels via Gbeta/gamma subunits	10916	1188		0.2608695652173913	0.375	29	10887	6	27	23	10860	10916	0.19166280377060763
M1	cpdb	0	network_modules	49	TRUE	7.517831942727748e-8	29	33	6	0.18181818181818182	0.20689655172413793	REAC:R-HSA-1296041	REAC	Activation of G protein gated Potassium channels	10916	82		0.2608695652173913	0.375	29	10887	6	27	23	10860	10916	0.19166280377060763
M1	cpdb	0	network_modules	49	TRUE	9.55287166272144e-8	48	45	7	0.15555555555555556	0.14583333333333334	GO:0086002	GO:BP	cardiac muscle cell action potential involved in contraction	16175	17879		0.3870967741935484	0.3968253968253968	48	16127	7	38	41	16089	16175	0.14816866527053413
M1	cpdb	0	network_modules	49	TRUE	1.0450214951880268e-7	740	45	16	0.35555555555555557	0.021621621621621623	GO:0098657	GO:BP	import into cell	16175	18813		0.4032258064516129	0.4126984126984127	740	15435	16	29	724	15406	16175	0.07831661873799871
M1	cpdb	0	network_modules	49	TRUE	1.2087852903577668e-7	185	45	10	0.2222222222222222	0.05405405405405406	GO:0060047	GO:BP	heart contraction	16175	14310		0.41935483870967744	0.42857142857142855	185	15990	10	35	175	15955	16175	0.10470383653637455
M1	cpdb	0	network_modules	49	TRUE	1.4250558797420044e-7	32	33	6	0.18181818181818182	0.1875	REAC:R-HSA-5576892	REAC	Phase 0 - rapid depolarisation	10916	1732		0.391304347826087	0.4166666666666667	32	10884	6	27	26	10857	10916	0.18220277684289973
M1	cpdb	0	network_modules	49	TRUE	1.656646154690943e-7	191	45	10	0.2222222222222222	0.05235602094240838	GO:0003015	GO:BP	heart process	16175	1466		0.43548387096774194	0.4444444444444444	191	15984	10	35	181	15949	16175	0.10288411353734285
M1	cpdb	0	network_modules	49	TRUE	2.5363177538483386e-7	35	33	6	0.18181818181818182	0.17142857142857143	REAC:R-HSA-1296065	REAC	Inwardly rectifying K+ channels	10916	1271		0.43478260869565216	0.4583333333333333	35	10881	6	27	29	10854	10916	0.17397550053598276
M1	cpdb	0	network_modules	49	TRUE	3.095311774864662e-7	400	33	12	0.36363636363636365	0.03	REAC:R-HSA-112316	REAC	Neuronal System	10916	1590		0.4782608695652174	0.5	400	10516	12	21	388	10495	10916	0.09583612092897174
M1	cpdb	0	network_modules	49	TRUE	3.8214756523657035e-7	58	45	7	0.15555555555555556	0.1206896551724138	GO:0051899	GO:BP	membrane depolarization	16175	13983		0.45161290322580644	0.4603174603174603	58	16117	7	38	51	16079	16175	0.1342871582057406
M1	cpdb	0	network_modules	49	TRUE	4.092099931342223e-7	31	45	6	0.13333333333333333	0.1935483870967742	GO:0060306	GO:BP	regulation of membrane repolarization	16175	14519		0.46774193548387094	0.47619047619047616	31	16144	6	39	25	16105	16175	0.1587076328415127
M1	cpdb	0	network_modules	49	TRUE	5.510690101525993e-7	61	45	7	0.15555555555555556	0.11475409836065574	GO:0002028	GO:BP	regulation of sodium ion transport	16175	630		0.4838709677419355	0.49206349206349204	61	16114	7	38	54	16076	16175	0.13079574859065318
M1	cpdb	0	network_modules	49	TRUE	6.13020398906546e-7	33	45	6	0.13333333333333333	0.18181818181818182	GO:0099622	GO:BP	cardiac muscle cell membrane repolarization	16175	19167		0.5	0.5079365079365079	33	16142	6	39	27	16103	16175	0.15368793741126754
M1	cpdb	0	network_modules	49	TRUE	6.199260310765506e-7	62	45	7	0.15555555555555556	0.11290322580645161	GO:0086003	GO:BP	cardiac muscle cell contraction	16175	17880		0.5161290322580645	0.5238095238095238	62	16113	7	38	55	16075	16175	0.12968783691177732
M1	cpdb	0	network_modules	49	TRUE	9.365550148265459e-7	43	33	6	0.18181818181818182	0.13953488372093023	REAC:R-HSA-977444	REAC	GABA B receptor activation	10916	1010		0.5217391304347826	0.5833333333333334	43	10873	6	27	37	10846	10916	0.15637307056880909
M1	cpdb	0	network_modules	49	TRUE	9.365550148265459e-7	43	33	6	0.18181818181818182	0.13953488372093023	REAC:R-HSA-991365	REAC	Activation of GABAB receptors	10916	83		0.5217391304347826	0.5833333333333334	43	10873	6	27	37	10846	10916	0.15637307056880909
M1	cpdb	0	network_modules	49	TRUE	1.1874375695631908e-6	111	45	8	0.17777777777777778	0.07207207207207207	GO:0060048	GO:BP	cardiac muscle contraction	16175	14311		0.532258064516129	0.5396825396825397	111	16064	8	37	103	16027	16175	0.10935183063473115
M1	cpdb	0	network_modules	49	TRUE	2.4051063066033067e-6	50	33	6	0.18181818181818182	0.12	REAC:R-HSA-112310	REAC	Neurotransmitter release cycle	10916	1595		0.6086956521739131	0.625	50	10866	6	27	44	10839	10916	0.14453817157276122
M1	cpdb	0	network_modules	49	TRUE	2.6729121219772203e-6	19	45	5	0.1111111111111111	0.2631578947368421	GO:0060307	GO:BP	regulation of ventricular cardiac muscle cell membrane repolarization	16175	14520		0.5483870967741935	0.5555555555555556	19	16156	5	40	14	16116	16175	0.16952407515105292
M1	cpdb	0	network_modules	49	TRUE	2.7456147616730936e-6	63	28	6	0.21428571428571427	0.09523809523809523	KEGG:05416	KEGG	Viral myocarditis	8484	493		0	0.2	63	8421	6	22	57	8399	8484	0.1386505321982482
M1	cpdb	0	network_modules	49	TRUE	2.779028218228513e-6	183	45	9	0.2	0.04918032786885246	GO:0071805	GO:BP	potassium ion transmembrane transport	16175	16918		0.5645161290322581	0.5714285714285714	183	15992	9	36	174	15956	16175	0.09423162208753448
M1	cpdb	0	network_modules	49	TRUE	4.598675425828097e-6	82	45	7	0.15555555555555556	0.08536585365853659	GO:0002027	GO:BP	regulation of heart rate	16175	629		0.5806451612903226	0.5873015873015873	82	16093	7	38	75	16055	16175	0.11191905646335178
M1	cpdb	0	network_modules	49	TRUE	5.046706372135948e-6	46	45	6	0.13333333333333333	0.13043478260869565	GO:0086009	GO:BP	membrane repolarization	16175	17883		0.5967741935483871	0.6031746031746031	46	16129	6	39	40	16090	16175	0.12942735855259585
M1	cpdb	0	network_modules	49	TRUE	5.563378734232642e-6	198	45	9	0.2	0.045454545454545456	GO:0006813	GO:BP	potassium ion transport	16175	2493		0.6129032258064516	0.6190476190476191	198	15977	9	36	189	15941	16175	0.09018901678236652
M1	cpdb	0	network_modules	49	TRUE	6.446133977546537e-6	86	45	7	0.15555555555555556	0.08139534883720931	GO:0070252	GO:BP	actin-mediated cell contraction	16175	16020		0.6290322580645161	0.6349206349206349	86	16089	7	38	79	16051	16175	0.10911927023915177
M1	cpdb	0	network_modules	49	TRUE	7.417840604664653e-6	60	33	6	0.18181818181818182	0.1	REAC:R-HSA-977443	REAC	GABA receptor activation	10916	1011		0.6521739130434783	0.6666666666666666	60	10856	6	27	54	10829	10916	0.13132315651703289
M1	cpdb	0	network_modules	49	TRUE	7.67127234573137e-6	23	45	5	0.1111111111111111	0.21739130434782608	GO:0099625	GO:BP	ventricular cardiac muscle cell membrane repolarization	16175	19170		0.6451612903225806	0.6666666666666666	23	16152	5	40	18	16112	16175	0.1537517319843106
M1	cpdb	0	network_modules	49	TRUE	7.67127234573137e-6	23	45	5	0.1111111111111111	0.21739130434782608	GO:0099623	GO:BP	regulation of cardiac muscle cell membrane repolarization	16175	19168		0.6451612903225806	0.6666666666666666	23	16152	5	40	18	16112	16175	0.1537517319843106
M1	cpdb	0	network_modules	49	TRUE	1.4903931883179785e-5	26	45	5	0.1111111111111111	0.19230769230769232	GO:0010765	GO:BP	positive regulation of sodium ion transport	16175	4386		0.6774193548387096	0.6825396825396826	26	16149	5	40	21	16109	16175	0.1443785361774111
M1	cpdb	0	network_modules	49	TRUE	1.5672391868604184e-5	84	28	6	0.21428571428571427	0.07142857142857142	KEGG:05412	KEGG	Arrhythmogenic right ventricular cardiomyopathy	8484	490		0.25	0.4	84	8400	6	22	78	8378	8484	0.11878629470028428
M1	cpdb	0	network_modules	49	TRUE	2.5101308267361787e-5	163	45	8	0.17777777777777778	0.049079754601226995	GO:0008016	GO:BP	regulation of heart contraction	16175	3097		0.6935483870967742	0.6984126984126984	163	16012	8	37	155	15975	16175	0.08868519432148919
M1	cpdb	0	network_modules	49	TRUE	3.5383412133771836e-5	4	33	3	0.09090909090909091	0.75	REAC:R-HSA-1296053	REAC	Classical Kir channels	10916	370		0.6956521739130435	0.7083333333333334	4	10912	3	30	1	10882	10916	0.26050570556082553
M1	cpdb	0	network_modules	49	TRUE	3.633219149312547e-5	110	45	7	0.15555555555555556	0.06363636363636363	GO:0030048	GO:BP	actin filament-based movement	16175	6667		0.7096774193548387	0.7142857142857143	110	16065	7	38	103	16027	16175	0.0956022347613599
M1	cpdb	0	network_modules	49	TRUE	3.7008078898508815e-5	97	28	6	0.21428571428571427	0.061855670103092786	KEGG:05410	KEGG	Hypertrophic cardiomyopathy	8484	489		0.5	0.6	97	8387	6	22	91	8365	8484	0.10979642768073677
M1	cpdb	0	network_modules	49	TRUE	4.986841698852034e-5	102	28	6	0.21428571428571427	0.058823529411764705	KEGG:05414	KEGG	Dilated cardiomyopathy	8484	491		0.75	0.8	102	8382	6	22	96	8360	8484	0.10679228963146022
M1	cpdb	0	network_modules	49	TRUE	6.201305452373392e-5	34	45	5	0.1111111111111111	0.14705882352941177	GO:2000649	GO:BP	regulation of sodium ion transmembrane transporter activity	16175	25931		0.7258064516129032	0.7301587301587301	34	16141	5	40	29	16101	16175	0.12571625830289257
M1	cpdb	0	network_modules	49	TRUE	7.117162013563788e-5	358	45	10	0.2222222222222222	0.027932960893854747	GO:0008015	GO:BP	blood circulation	16175	3096		0.7419354838709677	0.746031746031746	358	15817	10	35	348	15782	16175	0.07183790507921042
M1	cpdb	0	network_modules	49	TRUE	8.301211268541196e-5	190	45	8	0.17777777777777778	0.042105263157894736	GO:1903522	GO:BP	regulation of blood circulation	16175	23072		0.7580645161290323	0.7619047619047619	190	15985	8	37	182	15948	16175	0.08139356923346344
M1	cpdb	0	network_modules	49	TRUE	1.245700131768447e-4	15	45	4	0.08888888888888889	0.26666666666666666	GO:0014819	GO:BP	regulation of skeletal muscle contraction	16175	4698		0.7741935483870968	0.7777777777777778	15	16160	4	41	11	16119	16175	0.15263700604406596
M1	cpdb	0	network_modules	49	TRUE	1.715502047977646e-4	22	33	4	0.12121212121212122	0.18181818181818182	REAC:R-HSA-212676	REAC	Dopamine Neurotransmitter Release Cycle	10916	781		0.7391304347826086	0.75	22	10894	4	29	18	10865	10916	0.1463543048521924
M1	cpdb	0	network_modules	49	TRUE	1.933217954567893e-4	103	33	6	0.18181818181818182	0.05825242718446602	REAC:R-HSA-1296071	REAC	Potassium Channels	10916	1780		0.782608695652174	0.7916666666666666	103	10813	6	27	97	10786	10916	0.09818555987082549
M1	cpdb	0	network_modules	49	TRUE	4.7641444606926186e-4	439	45	10	0.2222222222222222	0.022779043280182234	GO:0003013	GO:BP	circulatory system process	16175	1464		0.7903225806451613	0.7936507936507936	439	15736	10	35	429	15701	16175	0.06341181411942105
M1	cpdb	0	network_modules	49	TRUE	0.0012478855765254981	7	45	3	0.06666666666666667	0.42857142857142855	GO:1903361	GO:BP	protein localization to basolateral plasma membrane	16175	22944		0.8064516129032258	0.8095238095238095	7	16168	3	42	4	16126	16175	0.168204077945535
M1	cpdb	0	network_modules	49	TRUE	0.0015185893326236596	381	45	9	0.2	0.023622047244094488	GO:0044057	GO:BP	regulation of system process	16175	10893		0.8225806451612904	0.8253968253968254	381	15794	9	36	372	15758	16175	0.061451782858753745
M1	cpdb	0	network_modules	49	TRUE	0.0027677283418676623	43	33	4	0.12121212121212122	0.09302325581395349	REAC:R-HSA-9609736	REAC	Assembly and cell surface presentation of NMDA receptors	10916	173		0.8260869565217391	0.8333333333333334	43	10873	4	29	39	10844	10916	0.10309440776221326
M1	cpdb	0	network_modules	49	TRUE	0.0027797699422187393	31	45	4	0.08888888888888889	0.12903225806451613	GO:0019226	GO:BP	transmission of nerve impulse	16175	5600		0.8387096774193549	0.8412698412698413	31	16144	4	41	27	16103	16175	0.10503357584059339
M1	cpdb	0	network_modules	49	TRUE	0.00298327388368957	9	45	3	0.06666666666666667	0.3333333333333333	GO:0035090	GO:BP	maintenance of apical/basal cell polarity	16175	8804		0.8548387096774194	0.873015873015873	9	16166	3	42	6	16124	16175	0.1480742822300821
M1	cpdb	0	network_modules	49	TRUE	0.00298327388368957	9	45	3	0.06666666666666667	0.3333333333333333	GO:0045199	GO:BP	maintenance of epithelial cell apical/basal polarity	16175	11323		0.8548387096774194	0.873015873015873	9	16166	3	42	6	16124	16175	0.1480742822300821
M1	cpdb	0	network_modules	49	TRUE	0.0033057132033643367	74	45	5	0.1111111111111111	0.06756756756756757	GO:0070509	GO:BP	calcium ion import	16175	16164		0.8870967741935484	0.8888888888888888	74	16101	5	40	69	16061	16175	0.08338502721960402
M1	cpdb	0	network_modules	49	TRUE	0.003966317318986474	47	33	4	0.12121212121212122	0.0851063829787234	REAC:R-HSA-9717189	REAC	Sensory perception of taste	10916	2200		0.8695652173913043	0.875	47	10869	4	29	43	10840	10916	0.0983198421090342
M1	cpdb	0	network_modules	49	TRUE	0.0040722231512590875	34	45	4	0.08888888888888889	0.11764705882352941	GO:0003254	GO:BP	regulation of membrane depolarization	16175	1684		0.9032258064516129	0.9047619047619048	34	16141	4	41	30	16100	16175	0.10008817237373147
M1	cpdb	0	network_modules	49	TRUE	0.00429665696098785	78	45	5	0.1111111111111111	0.0641025641025641	GO:0006942	GO:BP	regulation of striated muscle contraction	16175	2580		0.9193548387096774	0.9206349206349206	78	16097	5	40	73	16057	16175	0.08104035147714064
M1	cpdb	0	network_modules	49	TRUE	0.005151440682275385	36	45	4	0.08888888888888889	0.1111111111111111	GO:0003009	GO:BP	skeletal muscle contraction	16175	1460		0.9354838709677419	0.9365079365079365	36	16139	4	41	32	16098	16175	0.09713565720574535
M1	cpdb	0	network_modules	49	TRUE	0.005333623774708184	229	45	7	0.15555555555555556	0.03056768558951965	GO:1904062	GO:BP	regulation of monoatomic cation transmembrane transport	16175	23501		0.9516129032258065	0.9523809523809523	229	15946	7	38	222	15908	16175	0.0632168302183763
M1	cpdb	0	network_modules	49	TRUE	0.0065136451141048655	76	28	4	0.14285714285714285	0.05263157894736842	KEGG:04971	KEGG	Gastric acid secretion	8484	402		1	1	76	8408	4	24	72	8384	8484	0.08177521831744516
M1	cpdb	0	network_modules	49	TRUE	0.007927789562976663	40	45	4	0.08888888888888889	0.1	GO:0086091	GO:BP	regulation of heart rate by cardiac conduction	16175	17929		0.967741935483871	0.9682539682539683	40	16135	4	41	36	16094	16175	0.09189941023954613
M1	cpdb	0	network_modules	49	TRUE	0.008012597819728287	56	33	4	0.12121212121212122	0.07142857142857142	REAC:R-HSA-6794361	REAC	Neurexins and neuroligins	10916	1587		0.9130434782608695	0.9166666666666666	56	10860	4	29	52	10831	10916	0.08947511730448582
M1	cpdb	0	network_modules	49	TRUE	0.008310467440793466	19	33	3	0.09090909090909091	0.15789473684210525	REAC:R-HSA-5576886	REAC	Phase 4 - resting membrane potential	10916	1736		0.9565217391304348	0.9583333333333334	19	10897	3	30	16	10867	10916	0.11779517370777758
M1	cpdb	0	network_modules	49	TRUE	0.008767051280919945	41	45	4	0.08888888888888889	0.0975609756097561	GO:0050881	GO:BP	musculoskeletal movement	16175	13325		0.9838709677419355	1	41	16134	4	41	37	16093	16175	0.09070963835435701
M1	cpdb	0	network_modules	49	TRUE	0.008767051280919945	41	45	4	0.08888888888888889	0.0975609756097561	GO:0050879	GO:BP	multicellular organismal movement	16175	13324		0.9838709677419355	1	41	16134	4	41	37	16093	16175	0.09070963835435701
M1	cpdb	0	network_modules	49	TRUE	0.009344507340524721	3	33	2	0.06060606060606061	0.6666666666666666	REAC:R-HSA-1296067	REAC	Potassium transport channels	10916	1781		1	1	3	10913	2	31	1	10882	10916	0.20042675288201525
M1	cpdb	0	network_modules	50	TRUE	2.1148677713053024e-23	251	45	21	0.4666666666666667	0.08366533864541832	GO:0042254	GO:BP	ribosome biogenesis	16175	10060		0	0.0625	251	15924	21	24	230	15900	16175	0.19279257890468582
M1	cpdb	0	network_modules	50	TRUE	1.1350163446787731e-22	65	45	15	0.3333333333333333	0.23076923076923078	GO:0042273	GO:BP	ribosomal large subunit biogenesis	16175	10070		0.06666666666666667	0.125	65	16110	15	30	50	16080	16175	0.2749414032652344
M1	cpdb	0	network_modules	50	TRUE	1.2614676551724112e-21	205	45	19	0.4222222222222222	0.09268292682926829	GO:0016072	GO:BP	rRNA metabolic process	16175	5099		0.13333333333333333	0.1875	205	15970	19	26	186	15944	16175	0.19337892731916032
M1	cpdb	0	network_modules	50	TRUE	2.0957822817673323e-21	169	45	18	0.4	0.10650887573964497	GO:0006364	GO:BP	rRNA processing	16175	2140		0.2	0.25	169	16006	18	27	151	15979	16175	0.202354932139578
M1	cpdb	0	network_modules	50	TRUE	2.471536278240601e-19	390	45	21	0.4666666666666667	0.05384615384615385	GO:0022613	GO:BP	ribonucleoprotein complex biogenesis	16175	6620		0.26666666666666666	0.3125	390	15785	21	24	369	15761	16175	0.1523864649179529
M1	cpdb	0	network_modules	50	TRUE	4.628508652428331e-19	27	45	11	0.24444444444444444	0.4074074074074074	GO:0000470	GO:BP	maturation of LSU-rRNA	16175	159		0.3333333333333333	0.375	27	16148	11	34	16	16114	16175	0.3141206112291739
M1	cpdb	0	network_modules	50	TRUE	8.936197818245196e-12	15	45	7	0.15555555555555556	0.4666666666666667	GO:0000463	GO:BP	maturation of LSU-rRNA from tricistronic rRNA transcript (SSU-rRNA, 5.8S rRNA, LSU-rRNA)	16175	153		0.4	0.4375	15	16160	7	38	8	16122	16175	0.26832167169480087
M1	cpdb	0	network_modules	50	TRUE	2.9033153616331588e-8	192	23	9	0.391304347826087	0.046875	REAC:R-HSA-8868773	REAC	rRNA processing in the nucleus and cytosol	10916	2734		0	0.3333333333333333	192	10724	9	14	183	10710	10916	0.1306368718018832
M1	cpdb	0	network_modules	50	TRUE	4.5751838858724476e-8	202	23	9	0.391304347826087	0.04455445544554455	REAC:R-HSA-72312	REAC	rRNA processing	10916	2732		0.5	0.6666666666666666	202	10714	9	14	193	10700	10916	0.1271093193868445
M1	cpdb	0	network_modules	50	TRUE	2.0541186998702058e-5	182	23	7	0.30434782608695654	0.038461538461538464	REAC:R-HSA-6791226	REAC	Major pathway of rRNA processing in the nucleolus and cytosol	10916	1389		1	1	182	10734	7	16	175	10718	10916	0.1032379576314432
M1	cpdb	0	network_modules	50	TRUE	5.300272922610103e-5	33	45	5	0.1111111111111111	0.15151515151515152	GO:0000460	GO:BP	maturation of 5.8S rRNA	16175	150		0.4666666666666667	0.5	33	16142	5	40	28	16102	16175	0.12767525088767362
M1	cpdb	0	network_modules	50	TRUE	2.980205868969513e-4	46	45	5	0.1111111111111111	0.10869565217391304	GO:0006356	GO:BP	regulation of transcription by RNA polymerase I	16175	2133		0.5333333333333333	0.5625	46	16129	5	40	41	16089	16175	0.1073860074830208
M1	cpdb	0	network_modules	50	TRUE	8.236200880333635e-4	139	10	4	0.4	0.02877697841726619	KEGG:03008	KEGG	Ribosome biogenesis in eukaryotes	8484	207		NA	1	139	8345	4	6	135	8339	8484	0.10380847704517679
M1	cpdb	0	network_modules	50	TRUE	0.0012540157811299375	61	45	5	0.1111111111111111	0.08196721311475409	GO:0006360	GO:BP	transcription by RNA polymerase I	16175	2136		0.6	0.625	61	16114	5	40	56	16074	16175	0.09249702966498673
M1	cpdb	0	network_modules	50	TRUE	0.0024260063414512745	30	45	4	0.08888888888888889	0.13333333333333333	GO:0009303	GO:BP	rRNA transcription	16175	3450		0.6666666666666666	0.6875	30	16145	4	41	26	16104	16175	0.10684237332926541
M1	cpdb	0	network_modules	50	TRUE	0.0026129147827825597	529	45	10	0.2222222222222222	0.01890359168241966	GO:0006325	GO:BP	chromatin organization	16175	2122		0.7333333333333333	0.75	529	15646	10	35	519	15611	16175	0.056279862013526694
M1	cpdb	0	network_modules	50	TRUE	0.0029058196372472108	209	45	7	0.15555555555555556	0.03349282296650718	GO:0040029	GO:BP	epigenetic regulation of gene expression	16175	9916		0.8	0.8125	209	15966	7	38	202	15928	16175	0.06670929922259353
M1	cpdb	0	network_modules	50	TRUE	0.005745423407975945	148	45	6	0.13333333333333333	0.04054054054054054	GO:0072331	GO:BP	signal transduction by p53 class mediator	16175	17354		0.8666666666666667	0.875	148	16027	6	39	142	15988	16175	0.0688874279259127
M1	cpdb	0	network_modules	50	TRUE	0.005837208130928911	11	45	3	0.06666666666666667	0.2727272727272727	GO:0016479	GO:BP	negative regulation of transcription by RNA polymerase I	16175	5230		0.9333333333333333	0.9375	11	16164	3	42	8	16122	16175	0.13369599034230295
M1	cpdb	0	network_modules	50	TRUE	0.0064388285782592414	454	45	9	0.2	0.019823788546255508	GO:0006338	GO:BP	chromatin remodeling	16175	2126		1	1	454	15721	9	36	445	15685	16175	0.054982192216605906
M1	cpdb	0	network_modules	51	TRUE	5.041620159326589e-28	96	44	20	0.45454545454545453	0.20833333333333334	REAC:R-HSA-975956	REAC	Nonsense Mediated Decay (NMD) independent of the Exon Junction Complex (EJC)	10916	1607		0	0.02702702702702703	96	10820	20	24	76	10796	10916	0.303723395418177
M1	cpdb	0	network_modules	51	TRUE	1.6606942912996487e-27	182	44	23	0.5227272727272727	0.12637362637362637	REAC:R-HSA-6791226	REAC	Major pathway of rRNA processing in the nucleolus and cytosol	10916	1389		0.027777777777777776	0.05405405405405406	182	10734	23	21	159	10713	10916	0.25142933342138385
M1	cpdb	0	network_modules	51	TRUE	6.034645708256282e-27	192	44	23	0.5227272727272727	0.11979166666666667	REAC:R-HSA-8868773	REAC	rRNA processing in the nucleus and cytosol	10916	2734		0.05555555555555555	0.08108108108108109	192	10724	23	21	169	10703	10916	0.24446490499035242
M1	cpdb	0	network_modules	51	TRUE	8.873383190320436e-27	158	49	21	0.42857142857142855	0.13291139240506328	GO:0002181	GO:BP	cytoplasmic translation	16175	729		0	0.03333333333333333	158	16017	21	28	137	15989	16175	0.2347307206385913
M1	cpdb	0	network_modules	51	TRUE	1.4667318622532018e-26	90	44	19	0.4318181818181818	0.2111111111111111	REAC:R-HSA-156902	REAC	Peptide chain elongation	10916	1723		0.08333333333333333	0.13513513513513514	90	10826	19	25	71	10801	10916	0.2979947136693267
M1	cpdb	0	network_modules	51	TRUE	1.4667318622532018e-26	90	44	19	0.4318181818181818	0.2111111111111111	REAC:R-HSA-192823	REAC	Viral mRNA Translation	10916	2650		0.08333333333333333	0.13513513513513514	90	10826	19	25	71	10801	10916	0.2979947136693267
M1	cpdb	0	network_modules	51	TRUE	1.4710409975150902e-26	112	44	20	0.45454545454545453	0.17857142857142858	REAC:R-HSA-156827	REAC	L13a-mediated translational silencing of Ceruloplasmin expression	10916	1293		0.1388888888888889	0.16216216216216217	112	10804	20	24	92	10780	10916	0.2804760448932897
M1	cpdb	0	network_modules	51	TRUE	2.043367191154246e-26	202	44	23	0.5227272727272727	0.11386138613861387	REAC:R-HSA-72312	REAC	rRNA processing	10916	2732		0.16666666666666666	0.1891891891891892	202	10714	23	21	179	10693	10916	0.238015757031538
M1	cpdb	0	network_modules	51	TRUE	3.143994551562133e-26	116	44	20	0.45454545454545453	0.1724137931034483	REAC:R-HSA-927802	REAC	Nonsense-Mediated Decay (NMD)	10916	1608		0.19444444444444445	0.24324324324324326	116	10800	20	24	96	10776	10916	0.2754215126277218
M1	cpdb	0	network_modules	51	TRUE	3.143994551562133e-26	116	44	20	0.45454545454545453	0.1724137931034483	REAC:R-HSA-975957	REAC	Nonsense Mediated Decay (NMD) enhanced by the Exon Junction Complex (EJC)	10916	1606		0.19444444444444445	0.24324324324324326	116	10800	20	24	96	10776	10916	0.2754215126277218
M1	cpdb	0	network_modules	51	TRUE	3.6477868094627665e-26	94	44	19	0.4318181818181818	0.20212765957446807	REAC:R-HSA-2408557	REAC	Selenocysteine synthesis	10916	2188		0.25	0.32432432432432434	94	10822	19	25	75	10797	10916	0.2913870605200636
M1	cpdb	0	network_modules	51	TRUE	3.6477868094627665e-26	94	44	19	0.4318181818181818	0.20212765957446807	REAC:R-HSA-72764	REAC	Eukaryotic Translation Termination	10916	872		0.25	0.32432432432432434	94	10822	19	25	75	10797	10916	0.2913870605200636
M1	cpdb	0	network_modules	51	TRUE	3.6477868094627665e-26	94	44	19	0.4318181818181818	0.20212765957446807	REAC:R-HSA-156842	REAC	Eukaryotic Translation Elongation	10916	870		0.25	0.32432432432432434	94	10822	19	25	75	10797	10916	0.2913870605200636
M1	cpdb	0	network_modules	51	TRUE	6.530811579163935e-26	120	44	20	0.45454545454545453	0.16666666666666666	REAC:R-HSA-72737	REAC	Cap-dependent Translation Initiation	10916	304		0.3333333333333333	0.3783783783783784	120	10796	20	24	100	10772	10916	0.2706188426418834
M1	cpdb	0	network_modules	51	TRUE	6.530811579163935e-26	120	44	20	0.45454545454545453	0.16666666666666666	REAC:R-HSA-72613	REAC	Eukaryotic Translation Initiation	10916	871		0.3333333333333333	0.3783783783783784	120	10796	20	24	100	10772	10916	0.2706188426418834
M1	cpdb	0	network_modules	51	TRUE	1.9927654504768271e-25	102	44	19	0.4318181818181818	0.18627450980392157	REAC:R-HSA-9633012	REAC	Response of EIF2AK4 (GCN2) to amino acid deficiency	10916	2087		0.3888888888888889	0.43243243243243246	102	10814	19	25	83	10789	10916	0.2793456829231859
M1	cpdb	0	network_modules	51	TRUE	1.9927654504768271e-25	102	44	19	0.4318181818181818	0.18627450980392157	REAC:R-HSA-72689	REAC	Formation of a pool of free 40S subunits	10916	953		0.3888888888888889	0.43243243243243246	102	10814	19	25	83	10789	10916	0.2793456829231859
M1	cpdb	0	network_modules	51	TRUE	1.6379396978604387e-24	113	44	19	0.4318181818181818	0.168141592920354	REAC:R-HSA-72706	REAC	GTP hydrolysis and joining of the 60S ribosomal subunit	10916	1027		0.4444444444444444	0.4864864864864865	113	10803	19	25	94	10778	10916	0.26490288980460425
M1	cpdb	0	network_modules	51	TRUE	1.6379396978604387e-24	113	44	19	0.4318181818181818	0.168141592920354	REAC:R-HSA-1799339	REAC	SRP-dependent cotranslational protein targeting to membrane	10916	2157		0.4444444444444444	0.4864864864864865	113	10803	19	25	94	10778	10916	0.26490288980460425
M1	cpdb	0	network_modules	51	TRUE	3.3322042125711224e-24	117	44	19	0.4318181818181818	0.1623931623931624	REAC:R-HSA-2408522	REAC	Selenoamino acid metabolism	10916	2187		0.5	0.5135135135135135	117	10799	19	25	98	10774	10916	0.26015708179336117
M1	cpdb	0	network_modules	51	TRUE	4.46653900682946e-23	133	44	19	0.4318181818181818	0.14285714285714285	REAC:R-HSA-168273	REAC	Influenza Viral RNA Transcription and Replication	10916	1186		0.5277777777777778	0.5405405405405406	133	10783	19	25	114	10758	10916	0.24333827710740474
M1	cpdb	0	network_modules	51	TRUE	1.1762134646887406e-22	171	44	20	0.45454545454545453	0.11695906432748537	REAC:R-HSA-9010553	REAC	Regulation of expression of SLITs and ROBOs	10916	2031		0.5555555555555556	0.5675675675675675	171	10745	20	24	151	10721	10916	0.2248433463908523
M1	cpdb	0	network_modules	51	TRUE	7.358485472281793e-22	153	44	19	0.4318181818181818	0.12418300653594772	REAC:R-HSA-168255	REAC	Influenza Infection	10916	1185		0.5833333333333334	0.5945945945945946	153	10763	19	25	134	10738	10916	0.22609623656018732
M1	cpdb	0	network_modules	51	TRUE	9.46078198747503e-22	153	39	19	0.48717948717948717	0.12418300653594772	KEGG:03010	KEGG	Ribosome	8484	208		0	0.5	153	8331	19	20	134	8311	8484	0.23957773053062617
M1	cpdb	0	network_modules	51	TRUE	1.2284569595914854e-21	157	44	19	0.4318181818181818	0.12101910828025478	REAC:R-HSA-9711097	REAC	Cellular response to starvation	10916	337		0.6111111111111112	0.6216216216216216	157	10759	19	25	138	10734	10916	0.2230431410875939
M1	cpdb	0	network_modules	51	TRUE	1.6107235114203892e-20	217	44	20	0.45454545454545453	0.09216589861751152	REAC:R-HSA-376176	REAC	Signaling by ROBO receptors	10916	2301		0.6388888888888888	0.6486486486486487	217	10699	20	24	197	10675	10916	0.19810239721172523
M1	cpdb	0	network_modules	51	TRUE	3.6372688537661993e-19	566	49	24	0.4897959183673469	0.04240282685512368	GO:0006412	GO:BP	translation	16175	2170		0.034482758620689655	0.06666666666666667	566	15609	24	25	542	15584	16175	0.1364291532436347
M1	cpdb	0	network_modules	51	TRUE	2.976201115537641e-18	231	39	19	0.48717948717948717	0.08225108225108226	KEGG:05171	KEGG	Coronavirus disease - COVID-19	8484	452		1	1	231	8253	19	20	212	8233	8484	0.19205849134812153
M1	cpdb	0	network_modules	51	TRUE	6.589064963884331e-18	292	44	20	0.45454545454545453	0.0684931506849315	REAC:R-HSA-72766	REAC	Translation	10916	2565		0.6666666666666666	0.6756756756756757	292	10624	20	24	272	10600	10916	0.16866933450355923
M1	cpdb	0	network_modules	51	TRUE	7.8729705029854385e-16	251	49	17	0.3469387755102041	0.06772908366533864	GO:0042254	GO:BP	ribosome biogenesis	16175	10060		0.06896551724137931	0.1	251	15924	17	32	234	15892	16175	0.14780736723023633
M1	cpdb	0	network_modules	51	TRUE	1.761102764388193e-14	370	44	19	0.4318181818181818	0.051351351351351354	REAC:R-HSA-71291	REAC	Metabolism of amino acids and derivatives	10916	1421		0.6944444444444444	0.7027027027027027	370	10546	19	25	351	10521	10916	0.13989088589744397
M1	cpdb	0	network_modules	51	TRUE	4.168002375311577e-14	205	49	15	0.30612244897959184	0.07317073170731707	GO:0016072	GO:BP	rRNA metabolic process	16175	5099		0.10344827586206896	0.13333333333333333	205	15970	15	34	190	15936	16175	0.14460443397436012
M1	cpdb	0	network_modules	51	TRUE	9.751013154276304e-14	169	49	14	0.2857142857142857	0.08284023668639054	GO:0006364	GO:BP	rRNA processing	16175	2140		0.13793103448275862	0.16666666666666666	169	16006	14	35	155	15971	16175	0.14922683042276647
M1	cpdb	0	network_modules	51	TRUE	1.028393691841528e-13	94	49	12	0.24489795918367346	0.1276595744680851	GO:0042274	GO:BP	ribosomal small subunit biogenesis	16175	10071		0.1724137931034483	0.2	94	16081	12	37	82	16044	16175	0.17338584639173032
M1	cpdb	0	network_modules	51	TRUE	1.3242026575006935e-12	390	49	17	0.3469387755102041	0.04358974358974359	GO:0022613	GO:BP	ribonucleoprotein complex biogenesis	16175	6620		0.20689655172413793	0.23333333333333334	390	15785	17	32	373	15753	16175	0.11600986410320621
M1	cpdb	0	network_modules	51	TRUE	4.874786681626675e-12	37	44	9	0.20454545454545456	0.24324324324324326	REAC:R-HSA-9735869	REAC	SARS-CoV-1 modulates host translation machinery	10916	2116		0.7222222222222222	0.7297297297297297	37	10879	9	35	28	10844	10916	0.22017735122583212
M1	cpdb	0	network_modules	51	TRUE	7.453361953952123e-12	59	44	10	0.22727272727272727	0.1694915254237288	REAC:R-HSA-72649	REAC	Translation initiation complex formation	10916	2566		0.75	0.7567567567567568	59	10857	10	34	49	10823	10916	0.19250788783334055
M1	cpdb	0	network_modules	51	TRUE	8.918610961521942e-12	60	44	10	0.22727272727272727	0.16666666666666666	REAC:R-HSA-72662	REAC	Activation of the mRNA upon binding of the cap-binding complex and eIFs, and subsequent binding to 43S	10916	105		0.7777777777777778	0.7837837837837838	60	10856	10	34	50	10822	10916	0.19082688239914758
M1	cpdb	0	network_modules	51	TRUE	6.615147839704945e-11	140	44	12	0.2727272727272727	0.08571428571428572	REAC:R-HSA-9678108	REAC	SARS-CoV-1 Infection	10916	2114		0.8055555555555556	0.8108108108108109	140	10776	12	32	128	10744	10916	0.1469440682183499
M1	cpdb	0	network_modules	51	TRUE	1.1447444468691203e-10	51	44	9	0.20454545454545456	0.17647058823529413	REAC:R-HSA-9754678	REAC	SARS-CoV-2 modulates host translation machinery	10916	2125		0.8333333333333334	0.8378378378378378	51	10865	9	35	42	10830	10916	0.18646194907311997
M1	cpdb	0	network_modules	51	TRUE	1.3803350298828885e-10	52	44	9	0.20454545454545456	0.17307692307692307	REAC:R-HSA-72695	REAC	Formation of the ternary complex, and subsequently, the 43S complex	10916	973		0.8611111111111112	0.8648648648648649	52	10864	9	35	43	10829	10916	0.18458420074342585
M1	cpdb	0	network_modules	51	TRUE	4.619736041021292e-10	59	44	9	0.20454545454545456	0.15254237288135594	REAC:R-HSA-72702	REAC	Ribosomal scanning and start codon recognition	10916	2106		0.8888888888888888	0.8918918918918919	59	10857	9	35	50	10822	10916	0.1727881315968184
M1	cpdb	0	network_modules	51	TRUE	1.0818792753007045e-9	95	44	10	0.22727272727272727	0.10526315789473684	REAC:R-HSA-9692914	REAC	SARS-CoV-1-host interactions	10916	2119		0.9166666666666666	0.918918918918919	95	10821	10	34	85	10787	10916	0.14970282889297745
M1	cpdb	0	network_modules	51	TRUE	5.767176175539416e-7	343	49	12	0.24489795918367346	0.03498542274052478	GO:0140694	GO:BP	membraneless organelle assembly	16175	19860		0.2413793103448276	0.26666666666666666	343	15832	12	37	331	15795	16175	0.08558847149300017
M1	cpdb	0	network_modules	51	TRUE	5.800346277000557e-7	459	44	14	0.3181818181818182	0.030501089324618737	REAC:R-HSA-9679506	REAC	SARS-CoV Infections	10916	2112		0.9444444444444444	0.9459459459459459	459	10457	14	30	445	10427	10916	0.08752744751919266
M1	cpdb	0	network_modules	51	TRUE	5.268271516486588e-6	292	44	11	0.25	0.03767123287671233	REAC:R-HSA-9694516	REAC	SARS-CoV-2 Infection	10916	2122		0.9722222222222222	0.972972972972973	292	10624	11	33	281	10591	10916	0.08802209254860832
M1	cpdb	0	network_modules	51	TRUE	8.909324828353152e-6	46	49	6	0.12244897959183673	0.13043478260869565	GO:0030490	GO:BP	maturation of SSU-rRNA	16175	6815		0.27586206896551724	0.3	46	16129	6	43	40	16086	16175	0.12380723020673873
M1	cpdb	0	network_modules	51	TRUE	1.0189842152712607e-5	47	49	6	0.12244897959183673	0.1276595744680851	GO:0042255	GO:BP	ribosome assembly	16175	10061		0.3103448275862069	0.3333333333333333	47	16128	6	43	41	16085	16175	0.12242353441008665
M1	cpdb	0	network_modules	51	TRUE	2.517099492312132e-5	197	44	9	0.20454545454545456	0.04568527918781726	REAC:R-HSA-9705683	REAC	SARS-CoV-2-host interactions	10916	2128		1	1	197	10719	9	35	188	10684	10916	0.08912516698460808
M1	cpdb	0	network_modules	51	TRUE	7.522990600790178e-5	65	49	6	0.12244897959183673	0.09230769230769231	GO:0042273	GO:BP	ribosomal large subunit biogenesis	16175	10070		0.3448275862068966	0.36666666666666664	65	16110	6	43	59	16067	16175	0.1031900607687999
M1	cpdb	0	network_modules	51	TRUE	9.900818022808991e-5	68	49	6	0.12244897959183673	0.08823529411764706	GO:0090307	GO:BP	mitotic spindle assembly	16175	18189		0.3793103448275862	0.4	68	16107	6	43	62	16064	16175	0.10073951565183596
M1	cpdb	0	network_modules	51	TRUE	3.2993317423904575e-4	83	49	6	0.12244897959183673	0.07228915662650602	GO:0000281	GO:BP	mitotic cytokinesis	16175	79		0.41379310344827586	0.43333333333333335	83	16092	6	43	77	16049	16175	0.09051032581481157
M1	cpdb	0	network_modules	51	TRUE	4.081656070873374e-4	86	49	6	0.12244897959183673	0.06976744186046512	GO:0032465	GO:BP	regulation of cytokinesis	16175	7580		0.4482758620689655	0.4666666666666667	86	16089	6	43	80	16046	16175	0.08878534787134357
M1	cpdb	0	network_modules	51	TRUE	5.356097324158171e-4	90	49	6	0.12244897959183673	0.06666666666666667	GO:1901796	GO:BP	regulation of signal transduction by p53 class mediator	16175	21740		0.4827586206896552	0.5	90	16085	6	43	84	16042	16175	0.0866174494530085
M1	cpdb	0	network_modules	51	TRUE	0.001579870537991229	108	49	6	0.12244897959183673	0.05555555555555555	GO:0061640	GO:BP	cytoskeleton-dependent cytokinesis	16175	15599		0.5172413793103449	0.5333333333333333	108	16067	6	43	102	16024	16175	0.07836160030153143
M1	cpdb	0	network_modules	51	TRUE	0.0016690639280539498	175	49	7	0.14285714285714285	0.04	GO:0000910	GO:BP	cytokinesis	16175	243		0.5517241379310345	0.5666666666666667	175	16000	7	42	168	15958	16175	0.07035562886151882
M1	cpdb	0	network_modules	51	TRUE	0.0016961403134379118	59	49	5	0.10204081632653061	0.0847457627118644	GO:0007080	GO:BP	mitotic metaphase chromosome alignment	16175	2669		0.5862068965517241	0.6	59	16116	5	44	54	16072	16175	0.08996829798089254
M1	cpdb	0	network_modules	51	TRUE	0.001734234426051978	176	49	7	0.14285714285714285	0.03977272727272727	GO:0007051	GO:BP	spindle organization	16175	2650		0.6206896551724138	0.6333333333333333	176	15999	7	42	169	15957	16175	0.07012481291409545
M1	cpdb	0	network_modules	51	TRUE	0.0018709997589676447	178	49	7	0.14285714285714285	0.03932584269662921	GO:0000070	GO:BP	mitotic sister chromatid segregation	16175	24		0.6551724137931034	0.6666666666666666	178	15997	7	42	171	15955	16175	0.06966876576538547
M1	cpdb	0	network_modules	51	TRUE	0.002062303227961487	113	49	6	0.12244897959183673	0.05309734513274336	GO:0051225	GO:BP	spindle assembly	16175	13578		0.6896551724137931	0.7	113	16062	6	43	107	16019	16175	0.07641566422259193
M1	cpdb	0	network_modules	51	TRUE	0.0021810304618667875	265	49	8	0.16326530612244897	0.03018867924528302	GO:0051301	GO:BP	cell division	16175	13632		0.7241379310344828	0.7333333333333333	265	15910	8	41	257	15869	16175	0.06378073915196267
M1	cpdb	0	network_modules	51	TRUE	0.003554530363516918	124	49	6	0.12244897959183673	0.04838709677419355	GO:0007052	GO:BP	mitotic spindle organization	16175	2651		0.7586206896551724	0.7666666666666667	124	16051	6	43	118	16008	16175	0.07254275295101313
M1	cpdb	0	network_modules	51	TRUE	0.004013101387589014	630	49	11	0.22448979591836735	0.01746031746031746	GO:0010564	GO:BP	regulation of cell cycle process	16175	4217		0.7931034482758621	0.8	630	15545	11	38	619	15507	16175	0.05286311976414995
M1	cpdb	0	network_modules	51	TRUE	0.004895858921104473	131	49	6	0.12244897959183673	0.04580152671755725	GO:0051302	GO:BP	regulation of cell division	16175	13633		0.8275862068965517	0.8333333333333334	131	16044	6	43	125	16001	16175	0.07032721666098857
M1	cpdb	0	network_modules	51	TRUE	0.005932069854690911	656	49	11	0.22448979591836735	0.01676829268292683	GO:1903047	GO:BP	mitotic cell cycle process	16175	22727		0.8620689655172413	0.8666666666666667	656	15519	11	38	645	15481	16175	0.0513991303501749
M1	cpdb	0	network_modules	51	TRUE	0.007000073749908417	217	49	7	0.14285714285714285	0.03225806451612903	GO:0000819	GO:BP	sister chromatid segregation	16175	237		0.896551724137931	0.9	217	15958	7	42	210	15916	16175	0.06202018127833185
M1	cpdb	0	network_modules	51	TRUE	0.007847939585138014	11	49	3	0.061224489795918366	0.2727272727272727	GO:0051256	GO:BP	mitotic spindle midzone assembly	16175	13603		0.9310344827586207	0.9333333333333333	11	16164	3	46	8	16118	16175	0.12802135468568063
M1	cpdb	0	network_modules	51	TRUE	0.009417635571689207	38	49	4	0.08163265306122448	0.10526315789473684	GO:0032506	GO:BP	cytokinetic process	16175	7613		0.9655172413793104	0.9666666666666667	38	16137	4	45	34	16092	16175	0.09027298190761329
M1	cpdb	0	network_modules	51	TRUE	0.009926124305397407	148	49	6	0.12244897959183673	0.04054054054054054	GO:0072331	GO:BP	signal transduction by p53 class mediator	16175	17354		1	1	148	16027	6	43	142	15984	16175	0.06559161438307422
M1	cpdb	0	network_modules	52	TRUE	3.0391341064102184e-11	168	25	11	0.44	0.06547619047619048	KEGG:04141	KEGG	Protein processing in endoplasmic reticulum	8484	278		0	0.25	168	8316	11	14	157	8302	8484	0.16396579986402143
M1	cpdb	0	network_modules	52	TRUE	4.051374429743713e-8	68	48	8	0.16666666666666666	0.11764705882352941	GO:0006487	GO:BP	protein N-linked glycosylation	16175	2221		0	0.041666666666666664	68	16107	8	40	60	16067	16175	0.13698715849501944
M1	cpdb	0	network_modules	52	TRUE	1.2054975762475982e-7	808	48	17	0.3541666666666667	0.02103960396039604	GO:0033365	GO:BP	protein localization to organelle	16175	8175		0.043478260869565216	0.08333333333333333	808	15367	17	31	791	15336	16175	0.07618433959666125
M1	cpdb	0	network_modules	52	TRUE	2.3277618310856415e-7	183	48	10	0.20833333333333334	0.0546448087431694	GO:0006486	GO:BP	protein glycosylation	16175	2220		0.08695652173913043	0.16666666666666666	183	15992	10	38	173	15954	16175	0.10162968117039715
M1	cpdb	0	network_modules	52	TRUE	2.3277618310856415e-7	183	48	10	0.20833333333333334	0.0546448087431694	GO:0043413	GO:BP	macromolecule glycosylation	16175	10680		0.08695652173913043	0.16666666666666666	183	15992	10	38	173	15954	16175	0.10162968117039715
M1	cpdb	0	network_modules	52	TRUE	4.7164099079861956e-7	265	48	11	0.22916666666666666	0.04150943396226415	GO:0009101	GO:BP	glycoprotein biosynthetic process	16175	3273		0.17391304347826086	0.20833333333333334	265	15910	11	37	254	15873	16175	0.0914466391367962
M1	cpdb	0	network_modules	52	TRUE	6.613099310620271e-7	31	48	6	0.125	0.1935483870967742	GO:0045048	GO:BP	protein insertion into ER membrane	16175	11247		0.21739130434782608	0.25	31	16144	6	42	25	16102	16175	0.1535328802970578
M1	cpdb	0	network_modules	52	TRUE	6.767823792639403e-7	204	48	10	0.20833333333333334	0.049019607843137254	GO:0070085	GO:BP	glycosylation	16175	15903		0.2608695652173913	0.2916666666666667	204	15971	10	38	194	15933	16175	0.09568525502788063
M1	cpdb	0	network_modules	52	TRUE	1.5362685902340113e-6	31	25	5	0.2	0.16129032258064516	KEGG:03060	KEGG	Protein export	8484	217		0.3333333333333333	0.5	31	8453	5	20	26	8433	8484	0.17690783523243098
M1	cpdb	0	network_modules	52	TRUE	2.441181727320837e-6	38	48	6	0.125	0.15789473684210525	GO:0018279	GO:BP	protein N-linked glycosylation via asparagine	16175	5395		0.30434782608695654	0.3333333333333333	38	16137	6	42	32	16095	16175	0.13821492185958476
M1	cpdb	0	network_modules	52	TRUE	2.936581169804961e-6	315	48	11	0.22916666666666666	0.03492063492063492	GO:0009100	GO:BP	glycoprotein metabolic process	16175	3272		0.34782608695652173	0.375	315	15860	11	37	304	15823	16175	0.08278725038192945
M1	cpdb	0	network_modules	52	TRUE	3.1607555506571796e-6	239	48	10	0.20833333333333334	0.04184100418410042	GO:0090150	GO:BP	establishment of protein localization to membrane	16175	18059		0.391304347826087	0.4166666666666667	239	15936	10	38	229	15898	16175	0.08752041813609983
M1	cpdb	0	network_modules	52	TRUE	6.1591483672992235e-6	44	48	6	0.125	0.13636363636363635	GO:0051205	GO:BP	protein insertion into membrane	16175	13565		0.43478260869565216	0.4583333333333333	44	16131	6	42	38	16089	16175	0.1280812870309608
M1	cpdb	0	network_modules	52	TRUE	7.526503192879205e-6	42	25	5	0.2	0.11904761904761904	KEGG:00513	KEGG	Various types of N-glycan biosynthesis	8484	66		0.6666666666666666	0.75	42	8442	5	20	37	8422	8484	0.15108059445478803
M1	cpdb	0	network_modules	52	TRUE	9.700599918452123e-6	113	32	7	0.21875	0.061946902654867256	REAC:R-HSA-1799339	REAC	SRP-dependent cotranslational protein targeting to membrane	10916	2157		0	0.125	113	10803	7	25	106	10778	10916	0.11164180535265311
M1	cpdb	0	network_modules	52	TRUE	1.4421097750699894e-5	13	32	4	0.125	0.3076923076923077	REAC:R-HSA-400511	REAC	Synthesis, secretion, and inactivation of Glucose-dependent Insulinotropic Polypeptide (GIP)	10916	2416		0.14285714285714285	0.25	13	10903	4	28	9	10875	10916	0.19464896125431383
M1	cpdb	0	network_modules	52	TRUE	2.2119101109241073e-5	483	48	12	0.25	0.024844720496894408	GO:0051604	GO:BP	protein maturation	16175	13821		0.4782608695652174	0.5	483	15692	12	36	471	15656	16175	0.07056227810666289
M1	cpdb	0	network_modules	52	TRUE	2.4845650037400487e-5	53	25	5	0.2	0.09433962264150944	KEGG:00510	KEGG	N-Glycan biosynthesis	8484	63		1	1	53	8431	5	20	48	8411	8484	0.13368478702669181
M1	cpdb	0	network_modules	52	TRUE	4.2656002311275235e-5	11	48	4	0.08333333333333333	0.36363636363636365	GO:0045050	GO:BP	protein insertion into ER membrane by stop-transfer membrane-anchor sequence	16175	11249		0.5217391304347826	0.5416666666666666	11	16164	4	44	7	16120	16175	0.17297263434532503
M1	cpdb	0	network_modules	52	TRUE	5.152752295301728e-5	62	48	6	0.125	0.0967741935483871	GO:0070972	GO:BP	protein localization to endoplasmic reticulum	16175	16407		0.5652173913043478	0.5833333333333334	62	16113	6	42	56	16071	16175	0.10697644230168248
M1	cpdb	0	network_modules	52	TRUE	6.108745487944204e-5	18	32	4	0.125	0.2222222222222222	REAC:R-HSA-422085	REAC	Synthesis, secretion, and deacylation of Ghrelin	10916	2414		0.2857142857142857	0.375	18	10898	4	28	14	10870	10916	0.1648456252101857
M1	cpdb	0	network_modules	52	TRUE	9.201954171794088e-5	13	48	4	0.08333333333333333	0.3076923076923077	GO:0006465	GO:BP	signal peptide processing	16175	2206		0.6086956521739131	0.625	13	16162	4	44	9	16118	16175	0.15888348371018224
M1	cpdb	0	network_modules	52	TRUE	1.1874569219921544e-4	21	32	4	0.125	0.19047619047619047	REAC:R-HSA-381771	REAC	Synthesis, secretion, and inactivation of Glucagon-like Peptide-1 (GLP-1)	10916	2415		0.42857142857142855	0.5	21	10895	4	28	17	10867	10916	0.15229832562815024
M1	cpdb	0	network_modules	52	TRUE	2.095302384678718e-4	24	32	4	0.125	0.16666666666666666	REAC:R-HSA-400508	REAC	Incretin synthesis, secretion, and inactivation	10916	1180		0.5714285714285714	0.625	24	10892	4	28	20	10864	10916	0.14216349891188185
M1	cpdb	0	network_modules	52	TRUE	3.0364564787355397e-4	17	48	4	0.08333333333333333	0.23529411764705882	GO:0071816	GO:BP	tail-anchored membrane protein insertion into ER membrane	16175	16925		0.6521739130434783	0.6666666666666666	17	16158	4	44	13	16114	16175	0.13854039666438067
M1	cpdb	0	network_modules	52	TRUE	3.6883857454540265e-4	504	48	11	0.22916666666666666	0.021825396825396824	GO:0072657	GO:BP	protein localization to membrane	16175	17478		0.6956521739130435	0.7083333333333334	504	15671	11	37	493	15634	16175	0.06217360748218334
M1	cpdb	0	network_modules	52	TRUE	3.7354427707418013e-4	86	48	6	0.125	0.06976744186046512	GO:0007029	GO:BP	endoplasmic reticulum organization	16175	2634		0.7391304347826086	0.75	86	16089	6	42	80	16047	16175	0.08978574397380584
M1	cpdb	0	network_modules	52	TRUE	4.4907409889183265e-4	514	48	11	0.22916666666666666	0.021400778210116732	GO:1901137	GO:BP	carbohydrate derivative biosynthetic process	16175	21245		0.782608695652174	0.7916666666666666	514	15661	11	37	503	15624	16175	0.06139319973638657
M1	cpdb	0	network_modules	52	TRUE	0.0017399182413580612	88	32	5	0.15625	0.056818181818181816	REAC:R-HSA-2980736	REAC	Peptide hormone metabolism	10916	1725		0.7142857142857143	0.75	88	10828	5	27	83	10801	10916	0.08985517889987302
M1	cpdb	0	network_modules	52	TRUE	0.0018840269903891338	594	48	11	0.22916666666666666	0.018518518518518517	GO:0051668	GO:BP	localization within membrane	16175	13880		0.8260869565217391	0.8333333333333334	594	15581	11	37	583	15544	16175	0.05582131819150209
M1	cpdb	0	network_modules	52	TRUE	0.002538365126801382	275	48	8	0.16666666666666666	0.02909090909090909	GO:0006605	GO:BP	protein targeting	16175	2322		0.8695652173913043	0.875	275	15900	8	40	267	15860	16175	0.0631602451947326
M1	cpdb	0	network_modules	52	TRUE	0.0029520513399507353	29	48	4	0.08333333333333333	0.13793103448275862	GO:0045047	GO:BP	protein targeting to ER	16175	11246		0.9130434782608695	0.9166666666666666	29	16146	4	44	25	16102	16175	0.10515494704235158
M1	cpdb	0	network_modules	52	TRUE	0.0034292265908601248	198	48	7	0.14583333333333334	0.03535353535353535	GO:0016485	GO:BP	protein processing	16175	5233		0.9565217391304348	0.9583333333333334	198	15977	7	41	191	15936	16175	0.06628100286154887
M1	cpdb	0	network_modules	52	TRUE	0.005041922506274353	33	48	4	0.08333333333333333	0.12121212121212122	GO:0072599	GO:BP	establishment of protein localization to endoplasmic reticulum	16175	17463		1	1	33	16142	4	44	29	16098	16175	0.09828933899603165
M1	cpdb	0	network_modules	52	TRUE	0.005837876946177091	292	32	7	0.21875	0.023972602739726026	REAC:R-HSA-72766	REAC	Translation	10916	2565		0.8571428571428571	0.875	292	10624	7	25	285	10599	10916	0.06452241931561135
M1	cpdb	0	network_modules	52	TRUE	0.00773632878534613	305	32	7	0.21875	0.022950819672131147	REAC:R-HSA-446203	REAC	Asparagine N-linked glycosylation	10916	169		1	1	305	10611	7	25	298	10586	10916	0.06277921096299818
M1	cpdb	0	network_modules	53	TRUE	8.973137874424098e-72	71	45	34	0.7555555555555555	0.4788732394366197	GO:0045109	GO:BP	intermediate filament organization	16175	11280		0	0.05263157894736842	71	16104	34	11	37	16093	16175	0.6001685964340705
M1	cpdb	0	network_modules	53	TRUE	2.612995602262148e-68	85	45	34	0.7555555555555555	0.4	GO:0045104	GO:BP	intermediate filament cytoskeleton organization	16175	11275		0.05555555555555555	0.10526315789473684	85	16090	34	11	51	16079	16175	0.5481269203188863
M1	cpdb	0	network_modules	53	TRUE	4.318623063305028e-68	86	45	34	0.7555555555555555	0.3953488372093023	GO:0045103	GO:BP	intermediate filament-based process	16175	11274		0.1111111111111111	0.15789473684210525	86	16089	34	11	52	16078	16175	0.5449028493639614
M1	cpdb	0	network_modules	53	TRUE	6.750065725732308e-54	128	40	32	0.8	0.25	REAC:R-HSA-6809371	REAC	Formation of the cornified envelope	10916	969		0	0.5	128	10788	32	8	96	10780	10916	0.44407949764186516
M1	cpdb	0	network_modules	53	TRUE	6.2445785034954496e-46	215	40	32	0.8	0.14883720930232558	REAC:R-HSA-6805567	REAC	Keratinization	10916	1288		1	1	215	10701	32	8	183	10693	10916	0.3405582635172993
M1	cpdb	0	network_modules	53	TRUE	4.622739656855354e-39	748	45	37	0.8222222222222222	0.04946524064171123	GO:0097435	GO:BP	supramolecular fiber organization	16175	18657		0.16666666666666666	0.21052631578947367	748	15427	37	8	711	15419	16175	0.19516019466803425
M1	cpdb	0	network_modules	53	TRUE	6.925188158163391e-37	454	45	32	0.7111111111111111	0.07048458149779736	GO:0030855	GO:BP	epithelial cell differentiation	16175	6938		0.2222222222222222	0.2631578947368421	454	15721	32	13	422	15708	16175	0.2184305925472848
M1	cpdb	0	network_modules	53	TRUE	3.491989900329307e-36	33	45	18	0.4	0.5454545454545454	GO:0031424	GO:BP	keratinization	16175	7162		0.2777777777777778	0.3157894736842105	33	16142	18	27	15	16115	16175	0.4658401756943945
M1	cpdb	0	network_modules	53	TRUE	1.569124075919404e-32	701	45	33	0.7333333333333333	0.047075606276747506	GO:0060429	GO:BP	epithelium development	16175	14627		0.3333333333333333	0.3684210526315789	701	15474	33	12	668	15462	16175	0.17898593521634826
M1	cpdb	0	network_modules	53	TRUE	6.640862646357693e-28	231	45	23	0.5111111111111111	0.09956709956709957	GO:0008544	GO:BP	epidermis development	16175	3192		0.3888888888888889	0.42105263157894735	231	15944	23	22	208	15922	16175	0.22117517420219732
M1	cpdb	0	network_modules	53	TRUE	3.331202078927919e-27	168	45	21	0.4666666666666667	0.125	GO:0043588	GO:BP	skin development	16175	10792		0.4444444444444444	0.47368421052631576	168	16007	21	24	147	15983	16175	0.23771437062577325
M1	cpdb	0	network_modules	53	TRUE	1.36716967566459e-25	102	45	18	0.4	0.17647058823529413	GO:0030216	GO:BP	keratinocyte differentiation	16175	6724		0.5	0.5263157894736842	102	16073	18	27	84	16046	16175	0.2626900176458008
M1	cpdb	0	network_modules	53	TRUE	1.0047275782660428e-23	86	23	15	0.6521739130434783	0.1744186046511628	KEGG:05150	KEGG	Staphylococcus aureus infection	8484	439		0	0.5	86	8398	15	8	71	8390	8484	0.3341771505187045
M1	cpdb	0	network_modules	53	TRUE	7.913217208913753e-23	142	45	18	0.4	0.1267605633802817	GO:0009913	GO:BP	epidermal cell differentiation	16175	3769		0.5555555555555556	0.5789473684210527	142	16033	18	27	124	16006	16175	0.22151542599092833
M1	cpdb	0	network_modules	53	TRUE	1.5246144808792568e-20	136	23	15	0.6521739130434783	0.11029411764705882	KEGG:04915	KEGG	Estrogen signaling pathway	8484	372		1	1	136	8348	15	8	121	8340	8484	0.26408778428587815
M1	cpdb	0	network_modules	53	TRUE	8.491064329209437e-6	50	45	6	0.13333333333333333	0.12	GO:0042633	GO:BP	hair cycle	16175	10266		0.6111111111111112	0.6842105263157895	50	16125	6	39	44	16086	16175	0.12392246195868387
M1	cpdb	0	network_modules	53	TRUE	8.491064329209437e-6	50	45	6	0.13333333333333333	0.12	GO:0042303	GO:BP	molting cycle	16175	10076		0.6111111111111112	0.6842105263157895	50	16125	6	39	44	16086	16175	0.12392246195868387
M1	cpdb	0	network_modules	53	TRUE	4.544965735002362e-5	12	45	4	0.08888888888888889	0.3333333333333333	GO:0031069	GO:BP	hair follicle morphogenesis	16175	7018		0.7222222222222222	0.7368421052631579	12	16163	4	41	8	16122	16175	0.17099732053242012
M1	cpdb	0	network_modules	53	TRUE	9.153694738174338e-5	14	45	4	0.08888888888888889	0.2857142857142857	GO:0048730	GO:BP	epidermis morphogenesis	16175	12987		0.7777777777777778	0.7894736842105263	14	16161	4	41	10	16120	16175	0.15810046615427484
M1	cpdb	0	network_modules	53	TRUE	7.424173003917112e-4	55	45	5	0.1111111111111111	0.09090909090909091	GO:0098773	GO:BP	skin epidermis development	16175	18887		0.8333333333333334	0.8421052631578947	55	16120	5	40	50	16080	16175	0.09773019349372318
M1	cpdb	0	network_modules	53	TRUE	0.00317044209188494	32	45	4	0.08888888888888889	0.125	GO:0001942	GO:BP	hair follicle development	16175	554		0.8888888888888888	0.8947368421052632	32	16143	4	41	28	16102	16175	0.10330911340327385
M1	cpdb	0	network_modules	53	TRUE	0.0036004337281137526	33	45	4	0.08888888888888889	0.12121212121212122	GO:0022404	GO:BP	molting cycle process	16175	6595		0.9444444444444444	1	33	16142	4	41	29	16101	16175	0.10166256436407971
M1	cpdb	0	network_modules	53	TRUE	0.0036004337281137526	33	45	4	0.08888888888888889	0.12121212121212122	GO:0022405	GO:BP	hair cycle process	16175	6596		0.9444444444444444	1	33	16142	4	41	29	16101	16175	0.10166256436407971
M1	cpdb	0	network_modules	54	TRUE	4.4562615839307134e-7	105	36	8	0.2222222222222222	0.0761904761904762	REAC:R-HSA-425393	REAC	Transport of inorganic cations/anions and amino acids/oligopeptides	10916	2596		0	0.16666666666666666	105	10811	8	28	97	10783	10916	0.12529760703056392
M1	cpdb	0	network_modules	54	TRUE	1.3524931480673462e-6	245	36	10	0.2777777777777778	0.04081632653061224	REAC:R-HSA-425407	REAC	SLC-mediated transmembrane transport	10916	2146		0.2	0.3333333333333333	245	10671	10	26	235	10645	10916	0.099156867073399907
M1	cpdb	0	network_modules	54	TRUE	3.3039818932162716e-6	326	47	11	0.23404255319148937	0.03374233128834356	GO:0015711	GO:BP	organic anion transport	16175	4831		0	0.0625	326	15849	11	36	315	15813	16175	0.0821636331611716
M1	cpdb	0	network_modules	54	TRUE	3.625103191670863e-6	248	47	10	0.2127659574468085	0.04032258064516129	GO:0046942	GO:BP	carboxylic acid transport	16175	12438		0.06666666666666667	0.125	248	15927	10	37	238	15890	16175	0.08674237619222301
M1	cpdb	0	network_modules	54	TRUE	3.7688498052273377e-6	249	47	10	0.2127659574468085	0.040160642570281124	GO:0015849	GO:BP	organic acid transport	16175	4958		0.13333333333333333	0.1875	249	15926	10	37	239	15889	16175	0.08654362874906425
M1	cpdb	0	network_modules	54	TRUE	4.30061416769801e-6	182	47	9	0.19148936170212766	0.04945054945054945	GO:0098739	GO:BP	import across plasma membrane	16175	18866		0.2	0.25	182	15993	9	38	173	15955	16175	0.09224594489185807
M1	cpdb	0	network_modules	54	TRUE	1.1684579525676425e-5	41	28	5	0.17857142857142858	0.12195121951219512	KEGG:04216	KEGG	Ferroptosis	8484	293		0	0.5	41	8443	5	23	36	8420	8484	0.14416295941851118
M1	cpdb	0	network_modules	54	TRUE	1.8152158735266656e-5	32	36	5	0.1388888888888889	0.15625	REAC:R-HSA-352230	REAC	Amino acid transport across the plasma membrane	10916	141		0.4	0.5	32	10884	5	31	27	10853	10916	0.14465517116684337
M1	cpdb	0	network_modules	54	TRUE	3.9114902515104004e-5	11	47	4	0.0851063829787234	0.36363636363636365	GO:0015824	GO:BP	proline transport	16175	4936		0.26666666666666666	0.3125	11	16164	4	43	7	16121	16175	0.17482762706404742
M1	cpdb	0	network_modules	54	TRUE	3.5841285048491525e-4	45	47	5	0.10638297872340426	0.1111111111111111	GO:0015804	GO:BP	neutral amino acid transport	16175	4918		0.3333333333333333	0.375	45	16130	5	42	40	16088	16175	0.10618008790054517
M1	cpdb	0	network_modules	54	TRUE	7.159390998840627e-4	98	47	6	0.1276595744680851	0.061224489795918366	GO:0006865	GO:BP	amino acid transport	16175	2527		0.4	0.4375	98	16077	6	41	92	16036	16175	0.08459096879131285
M1	cpdb	0	network_modules	54	TRUE	0.0012053456638585333	107	47	6	0.1276595744680851	0.056074766355140186	GO:1905039	GO:BP	carboxylic acid transmembrane transport	16175	24314		0.4666666666666667	0.5	107	16068	6	41	101	16027	16175	0.08060740901687725
M1	cpdb	0	network_modules	54	TRUE	0.0013447239396692002	109	47	6	0.1276595744680851	0.05504587155963303	GO:1903825	GO:BP	organic acid transmembrane transport	16175	23308		0.5333333333333333	0.5625	109	16066	6	41	103	16025	16175	0.07978785149884009
M1	cpdb	0	network_modules	54	TRUE	0.001764135660339302	740	47	12	0.2553191489361702	0.016216216216216217	GO:0098657	GO:BP	import into cell	16175	18813		0.6	0.625	740	15435	12	35	728	15400	16175	0.05414544590429658
M1	cpdb	0	network_modules	54	TRUE	0.0019831308582237053	63	47	5	0.10638297872340426	0.07936507936507936	GO:0015807	GO:BP	L-amino acid transport	16175	4921		0.6666666666666666	0.6875	63	16112	5	42	58	16070	16175	0.08882420176953004
M1	cpdb	0	network_modules	54	TRUE	0.0033548607910544185	42	36	4	0.1111111111111111	0.09523809523809523	REAC:R-HSA-9035034	REAC	RHOF GTPase cycle	10916	1867		0.6	0.6666666666666666	42	10874	4	32	38	10842	10916	0.09966282147337402
M1	cpdb	0	network_modules	54	TRUE	0.0047188100591004515	70	28	4	0.14285714285714285	0.05714285714285714	KEGG:05230	KEGG	Central carbon metabolism in cancer	8484	478		1	1	70	8414	4	24	66	8390	8484	0.08562732139614529
M1	cpdb	0	network_modules	54	TRUE	0.00523101104002878	10	47	3	0.06382978723404255	0.3	GO:0015820	GO:BP	L-leucine transport	16175	4932		0.7333333333333333	0.75	10	16165	3	44	7	16121	16175	0.13728134983042622
M1	cpdb	0	network_modules	54	TRUE	0.007926213328395005	52	36	4	0.1111111111111111	0.07692307692307693	REAC:R-HSA-9013405	REAC	RHOD GTPase cycle	10916	1866		0.8	0.8333333333333334	52	10864	4	32	48	10832	10916	0.08884457350932819
M1	cpdb	0	network_modules	54	TRUE	0.008260781682695919	38	47	4	0.0851063829787234	0.10526315789473684	GO:0089718	GO:BP	amino acid import across plasma membrane	16175	17945		0.8	0.8125	38	16137	4	43	34	16094	16175	0.092279432248226
M1	cpdb	0	network_modules	54	TRUE	0.009551113597164148	12	47	3	0.06382978723404255	0.25	GO:0015803	GO:BP	branched-chain amino acid transport	16175	4917		0.8666666666666667	0.875	12	16163	3	44	9	16119	16175	0.12508275374606562
M1	cpdb	0	network_modules	54	TRUE	0.009897171287528553	87	47	5	0.10638297872340426	0.05747126436781609	GO:0010232	GO:BP	vascular transport	16175	4011		0.9333333333333333	1	87	16088	5	42	82	16046	16175	0.07454734884630788
M1	cpdb	0	network_modules	54	TRUE	0.009897171287528553	87	47	5	0.10638297872340426	0.05747126436781609	GO:0150104	GO:BP	transport across blood-brain barrier	16175	20143		0.9333333333333333	1	87	16088	5	42	82	16046	16175	0.07454734884630788
M1	cpdb	0	network_modules	54	TRUE	0.009915283438804507	55	36	4	0.1111111111111111	0.07272727272727272	REAC:R-HSA-9013409	REAC	RHOJ GTPase cycle	10916	1870		1	1	55	10861	4	32	51	10829	10916	0.0861762194281592
M1	cpdb	0	network_modules	55	TRUE	1.3407020933835187e-22	309	47	22	0.46808510638297873	0.07119741100323625	GO:0016236	GO:BP	macroautophagy	16175	5179		0	0.008547008547008548	309	15866	22	25	287	15841	16175	0.17705919795235667
M1	cpdb	0	network_modules	55	TRUE	1.2548509611887367e-19	10	47	9	0.19148936170212766	0.9	GO:1904903	GO:BP	ESCRT III complex disassembly	16175	24210		0.008620689655172414	0.02564102564102564	10	16165	9	38	1	16127	16175	0.41452939896252206
M1	cpdb	0	network_modules	55	TRUE	1.2548509611887367e-19	10	47	9	0.19148936170212766	0.9	GO:1904896	GO:BP	ESCRT complex disassembly	16175	24203		0.008620689655172414	0.02564102564102564	10	16165	9	38	1	16127	16175	0.41452939896252206
M1	cpdb	0	network_modules	55	TRUE	1.1259942560573489e-18	30	35	11	0.3142857142857143	0.36666666666666664	REAC:R-HSA-77387	REAC	Insulin receptor recycling	10916	1210		0	0.05263157894736842	30	10886	11	24	19	10862	10916	0.3375037628911368
M1	cpdb	0	network_modules	55	TRUE	1.741765387163527e-18	31	35	11	0.3142857142857143	0.3548387096774194	REAC:R-HSA-917977	REAC	Transferrin endocytosis and recycling	10916	2564		0.05555555555555555	0.10526315789473684	31	10885	11	24	20	10861	10916	0.3319331469948113
M1	cpdb	0	network_modules	55	TRUE	3.609829885187478e-18	491	47	22	0.46808510638297873	0.04480651731160896	GO:0006914	GO:BP	autophagy	16175	2563		0.02586206896551724	0.042735042735042736	491	15684	22	25	469	15659	16175	0.1377335472803487
M1	cpdb	0	network_modules	55	TRUE	3.609829885187478e-18	491	47	22	0.46808510638297873	0.04480651731160896	GO:0061919	GO:BP	process utilizing autophagic mechanism	16175	15723		0.02586206896551724	0.042735042735042736	491	15684	22	25	469	15659	16175	0.1377335472803487
M1	cpdb	0	network_modules	55	TRUE	3.83290997311641e-18	88	47	14	0.2978723404255319	0.1590909090909091	GO:0007032	GO:BP	endosome organization	16175	2637		0.04310344827586207	0.05128205128205128	88	16087	14	33	74	16054	16175	0.21460940944793538
M1	cpdb	0	network_modules	55	TRUE	1.2234605151192557e-17	36	35	11	0.3142857142857143	0.3055555555555556	REAC:R-HSA-1222556	REAC	ROS and RNS production in phagocytes	10916	1910		0.1111111111111111	0.15789473684210525	36	10880	11	24	25	10856	10916	0.30763858289555346
M1	cpdb	0	network_modules	55	TRUE	2.491018303657247e-17	14	47	9	0.19148936170212766	0.6428571428571429	GO:0046753	GO:BP	non-lytic viral release	16175	12352		0.05172413793103448	0.05982905982905983	14	16161	9	38	5	16123	16175	0.3499306758719379
M1	cpdb	0	network_modules	55	TRUE	9.36489252131103e-17	25	47	10	0.2127659574468085	0.4	GO:0031468	GO:BP	nuclear membrane reassembly	16175	7184		0.0603448275862069	0.06837606837606838	25	16150	10	37	15	16113	16175	0.29025684924939693
M1	cpdb	0	network_modules	55	TRUE	1.5031746232841448e-16	27	34	10	0.29411764705882354	0.37037037037037035	KEGG:04966	KEGG	Collecting duct acid secretion	8484	400		0	0.09090909090909091	27	8457	10	24	17	8433	8484	0.3276558791183142
M1	cpdb	0	network_modules	55	TRUE	3.005647126177421e-16	17	47	9	0.19148936170212766	0.5294117647058824	GO:0061952	GO:BP	midbody abscission	16175	15745		0.06896551724137931	0.07692307692307693	17	16158	9	38	8	16120	16175	0.3172773901327734
M1	cpdb	0	network_modules	55	TRUE	5.690888407779607e-16	29	47	10	0.2127659574468085	0.3448275862068966	GO:0035891	GO:BP	exit from host cell	16175	9315		0.07758620689655173	0.09401709401709402	29	16146	10	37	19	16109	16175	0.2692145354961149
M1	cpdb	0	network_modules	55	TRUE	5.690888407779607e-16	29	47	10	0.2127659574468085	0.3448275862068966	GO:0019076	GO:BP	viral release from host cell	16175	5568		0.07758620689655173	0.09401709401709402	29	16146	10	37	19	16109	16175	0.2692145354961149
M1	cpdb	0	network_modules	55	TRUE	1.1193939355032709e-15	96	47	13	0.2765957446808511	0.13541666666666666	GO:0007040	GO:BP	lysosome organization	16175	2644		0.09482758620689655	0.1111111111111111	96	16079	13	34	83	16045	16175	0.1902229720299348
M1	cpdb	0	network_modules	55	TRUE	1.1193939355032709e-15	96	47	13	0.2765957446808511	0.13541666666666666	GO:0080171	GO:BP	lytic vacuole organization	16175	17845		0.09482758620689655	0.1111111111111111	96	16079	13	34	83	16045	16175	0.1902229720299348
M1	cpdb	0	network_modules	55	TRUE	1.786859635164383e-15	50	34	11	0.3235294117647059	0.22	KEGG:05110	KEGG	Vibrio cholerae infection	8484	424		0.1	0.18181818181818182	50	8434	11	23	39	8411	8484	0.2632325762419899
M1	cpdb	0	network_modules	55	TRUE	1.8214825196350494e-15	32	47	10	0.2127659574468085	0.3125	GO:0036258	GO:BP	multivesicular body assembly	16175	9519		0.11206896551724138	0.11965811965811966	32	16143	10	37	22	16106	16175	0.25608308834963783
M1	cpdb	0	network_modules	55	TRUE	2.6079886762836335e-15	33	47	10	0.2127659574468085	0.30303030303030304	GO:0036257	GO:BP	multivesicular body organization	16175	9518		0.1206896551724138	0.1282051282051282	33	16142	10	37	23	16105	16175	0.2521070397946428
M1	cpdb	0	network_modules	55	TRUE	3.60089944610191e-15	57	35	11	0.3142857142857143	0.19298245614035087	REAC:R-HSA-917937	REAC	Iron uptake and transport	10916	1277		0.16666666666666666	0.21052631578947367	57	10859	11	24	46	10835	10916	0.24320878084035705
M1	cpdb	0	network_modules	55	TRUE	3.6034354666788996e-15	21	47	9	0.19148936170212766	0.42857142857142855	GO:1902774	GO:BP	late endosome to lysosome transport	16175	22495		0.12931034482758622	0.13675213675213677	21	16154	9	38	12	16116	16175	0.2851303042113077
M1	cpdb	0	network_modules	55	TRUE	5.578052117672222e-15	108	47	13	0.2765957446808511	0.12037037037037036	GO:0061640	GO:BP	cytoskeleton-dependent cytokinesis	16175	15599		0.13793103448275862	0.1452991452991453	108	16067	13	34	95	16033	16175	0.17891913054317543
M1	cpdb	0	network_modules	55	TRUE	6.637335125115752e-15	13	47	8	0.1702127659574468	0.6153846153846154	GO:0046761	GO:BP	viral budding from plasma membrane	16175	12356		0.14655172413793102	0.15384615384615385	13	16162	8	39	5	16123	16175	0.3227158955559194
M1	cpdb	0	network_modules	55	TRUE	1.2658491791161486e-14	83	47	12	0.2553191489361702	0.14457831325301204	GO:0000281	GO:BP	mitotic cytokinesis	16175	79		0.15517241379310345	0.1623931623931624	83	16092	12	35	71	16057	16175	0.18902749746586173
M1	cpdb	0	network_modules	55	TRUE	1.3181550757651418e-14	38	47	10	0.2127659574468085	0.2631578947368421	GO:0032506	GO:BP	cytokinetic process	16175	7613		0.16379310344827586	0.17094017094017094	38	16137	10	37	28	16100	16175	0.23462801761380972
M1	cpdb	0	network_modules	55	TRUE	1.6882739592552615e-14	202	47	15	0.3191489361702128	0.07425742574257425	GO:0007033	GO:BP	vacuole organization	16175	2638		0.1724137931034483	0.1794871794871795	202	15973	15	32	187	15941	16175	0.14907056916943878
M1	cpdb	0	network_modules	55	TRUE	2.4834486013500487e-14	25	47	9	0.19148936170212766	0.36	GO:1902410	GO:BP	mitotic cytokinetic process	16175	22262		0.1810344827586207	0.18803418803418803	25	16150	9	38	16	16112	16175	0.26101877024202347
M1	cpdb	0	network_modules	55	TRUE	5.290775952026722e-14	43	47	10	0.2127659574468085	0.23255813953488372	GO:0071763	GO:BP	nuclear membrane organization	16175	16893		0.1896551724137931	0.19658119658119658	43	16132	10	37	33	16095	16175	0.22027552850535295
M1	cpdb	0	network_modules	55	TRUE	5.673229008081533e-14	27	47	9	0.19148936170212766	0.3333333333333333	GO:0001778	GO:BP	plasma membrane repair	16175	443		0.19827586206896552	0.20512820512820512	27	16148	9	38	18	16110	16175	0.25101747108910594
M1	cpdb	0	network_modules	55	TRUE	6.723164630815106e-14	73	35	11	0.3142857142857143	0.1506849315068493	REAC:R-HSA-74752	REAC	Signaling by Insulin receptor	10916	2260		0.2222222222222222	0.2631578947368421	73	10843	11	24	62	10819	10916	0.21404786087251
M1	cpdb	0	network_modules	55	TRUE	9.845680743899428e-14	70	34	11	0.3235294117647059	0.15714285714285714	KEGG:05120	KEGG	Epithelial cell signaling in Helicobacter pylori infection	8484	426		0.2	0.2727272727272727	70	8414	11	23	59	8391	8484	0.22108331354760669
M1	cpdb	0	network_modules	55	TRUE	1.2429980716159428e-13	17	47	8	0.1702127659574468	0.47058823529411764	GO:0032510	GO:BP	endosome to lysosome transport via multivesicular body sorting pathway	16175	7617		0.20689655172413793	0.21367521367521367	17	16158	8	39	9	16119	16175	0.2818297898026247
M1	cpdb	0	network_modules	55	TRUE	2.4877292677494096e-13	55	35	10	0.2857142857142857	0.18181818181818182	REAC:R-HSA-9639288	REAC	Amino acids regulate mTORC1	10916	142		0.2777777777777778	0.3157894736842105	55	10861	10	25	45	10836	10916	0.2248287662042039
M1	cpdb	0	network_modules	55	TRUE	3.4691276717158583e-13	78	34	11	0.3235294117647059	0.14102564102564102	KEGG:04721	KEGG	Synaptic vesicle cycle	8484	351		0.3	0.36363636363636365	78	8406	11	23	67	8383	8484	0.20891200065072693
M1	cpdb	0	network_modules	55	TRUE	4.908687848885793e-13	315	47	16	0.3404255319148936	0.050793650793650794	GO:0016050	GO:BP	vesicle organization	16175	5082		0.21551724137931033	0.2222222222222222	315	15860	16	31	299	15829	16175	0.12538190730768053
M1	cpdb	0	network_modules	55	TRUE	5.269584500116792e-13	53	47	10	0.2127659574468085	0.18867924528301888	GO:0006998	GO:BP	nuclear envelope organization	16175	2613		0.22413793103448276	0.23076923076923078	53	16122	10	37	43	16085	16175	0.19788706392469974
M1	cpdb	0	network_modules	55	TRUE	6.453737558098047e-13	54	47	10	0.2127659574468085	0.18518518518518517	GO:0071709	GO:BP	membrane assembly	16175	16873		0.23275862068965517	0.23931623931623933	54	16121	10	37	44	16084	16175	0.1959944360656769
M1	cpdb	0	network_modules	55	TRUE	1.0315693644555701e-12	21	47	8	0.1702127659574468	0.38095238095238093	GO:0039702	GO:BP	viral budding via host ESCRT complex	16175	9879		0.2413793103448276	0.24786324786324787	21	16154	8	39	13	16115	16175	0.253232894532649
M1	cpdb	0	network_modules	55	TRUE	1.3920498684988245e-12	88	34	11	0.3235294117647059	0.125	KEGG:05323	KEGG	Rheumatoid arthritis	8484	485		0.4	0.45454545454545453	88	8396	11	23	77	8373	8484	0.19606327910988333
M1	cpdb	0	network_modules	55	TRUE	1.3955019546305385e-12	58	47	10	0.2127659574468085	0.1724137931034483	GO:0044091	GO:BP	membrane biogenesis	16175	10913		0.25	0.2564102564102564	58	16117	10	37	48	16080	16175	0.18891541087473893
M1	cpdb	0	network_modules	55	TRUE	1.4742799027803725e-12	37	47	9	0.19148936170212766	0.24324324324324326	GO:0045324	GO:BP	late endosome to vacuole transport	16175	11357		0.25862068965517243	0.26495726495726496	37	16138	9	38	28	16100	16175	0.2137975347327542
M1	cpdb	0	network_modules	55	TRUE	3.4864378192088918e-12	175	47	13	0.2765957446808511	0.07428571428571429	GO:0000910	GO:BP	cytokinesis	16175	243		0.2672413793103448	0.27350427350427353	175	16000	13	34	162	15966	16175	0.13868856442130673
M1	cpdb	0	network_modules	55	TRUE	3.7044440290887746e-12	24	47	8	0.1702127659574468	0.3333333333333333	GO:0046755	GO:BP	viral budding	16175	12354		0.27586206896551724	0.28205128205128205	24	16151	8	39	16	16112	16175	0.23663956072997105
M1	cpdb	0	network_modules	55	TRUE	3.9844779768661975e-12	522	47	18	0.3829787234042553	0.034482758620689655	GO:0010256	GO:BP	endomembrane system organization	16175	4029		0.28448275862068967	0.2905982905982906	522	15653	18	29	504	15624	16175	0.10713046204854376
M1	cpdb	0	network_modules	55	TRUE	4.116786261069147e-12	41	47	9	0.19148936170212766	0.21951219512195122	GO:0032509	GO:BP	endosome transport via multivesicular body sorting pathway	16175	7616		0.29310344827586204	0.29914529914529914	41	16134	9	38	32	16096	16175	0.20286047717287511
M1	cpdb	0	network_modules	55	TRUE	8.27761916715934e-12	44	47	9	0.19148936170212766	0.20454545454545456	GO:0090148	GO:BP	membrane fission	16175	18057		0.3017241379310345	0.3076923076923077	44	16131	9	38	35	16093	16175	0.19564867698336982
M1	cpdb	0	network_modules	55	TRUE	1.5809682134554635e-11	47	47	9	0.19148936170212766	0.19148936170212766	GO:0071985	GO:BP	multivesicular body sorting pathway	16175	17028		0.3103448275862069	0.3162393162393162	47	16128	9	38	38	16090	16175	0.1891332109084769
M1	cpdb	0	network_modules	55	TRUE	2.933431081142155e-11	155	47	12	0.2553191489361702	0.07741935483870968	GO:0007034	GO:BP	vacuolar transport	16175	2639		0.31896551724137934	0.3247863247863248	155	16020	12	35	143	15985	16175	0.1361681236071002
M1	cpdb	0	network_modules	55	TRUE	6.859333016512841e-11	33	47	8	0.1702127659574468	0.24242424242424243	GO:0019068	GO:BP	virion assembly	16175	5561		0.3275862068965517	0.3333333333333333	33	16142	8	39	25	16103	16175	0.20119746646798847
M1	cpdb	0	network_modules	55	TRUE	1.1577795403711304e-10	35	47	8	0.1702127659574468	0.22857142857142856	GO:0043162	GO:BP	ubiquitin-dependent protein catabolic process via the multivesicular body sorting pathway	16175	10562		0.33620689655172414	0.3418803418803419	35	16140	8	39	27	16101	16175	0.19523286728274483
M1	cpdb	0	network_modules	55	TRUE	1.5925414643861515e-10	134	34	11	0.3235294117647059	0.08208955223880597	KEGG:00190	KEGG	Oxidative phosphorylation	8484	18		0.5	0.5454545454545454	134	8350	11	23	123	8327	8484	0.15656438815448737
M1	cpdb	0	network_modules	55	TRUE	3.4784835530985106e-10	22	47	7	0.14893617021276595	0.3181818181818182	GO:1901673	GO:BP	regulation of mitotic spindle assembly	16175	21638		0.3448275862068966	0.3504273504273504	22	16153	7	40	15	16113	16175	0.21616276941498394
M1	cpdb	0	network_modules	55	TRUE	3.797427243836042e-10	11	47	6	0.1276595744680851	0.5454545454545454	GO:0051469	GO:BP	vesicle fusion with vacuole	16175	13730		0.35344827586206895	0.36752136752136755	11	16164	6	41	5	16123	16175	0.2629455669472242
M1	cpdb	0	network_modules	55	TRUE	3.797427243836042e-10	11	47	6	0.1276595744680851	0.5454545454545454	GO:0061763	GO:BP	multivesicular body-lysosome fusion	16175	15654		0.35344827586206895	0.36752136752136755	11	16164	6	41	5	16123	16175	0.2629455669472242
M1	cpdb	0	network_modules	55	TRUE	4.433979608419068e-10	147	34	11	0.3235294117647059	0.07482993197278912	KEGG:04145	KEGG	Phagosome	8484	281		0.6	0.6363636363636364	147	8337	11	23	136	8314	8484	0.1488528594996819
M1	cpdb	0	network_modules	55	TRUE	4.754756184485689e-10	67	47	9	0.19148936170212766	0.13432835820895522	GO:0008333	GO:BP	endosome to lysosome transport	16175	3164		0.3706896551724138	0.37606837606837606	67	16108	9	38	58	16070	16175	0.15746784324916266
M1	cpdb	0	network_modules	55	TRUE	6.968156788153164e-10	28	35	7	0.2	0.25	REAC:R-HSA-162588	REAC	Budding and maturation of HIV virion	10916	258		0.3333333333333333	0.3684210526315789	28	10888	7	28	21	10860	10916	0.22137782875915446
M1	cpdb	0	network_modules	55	TRUE	7.522527458437851e-10	265	47	13	0.2765957446808511	0.04905660377358491	GO:0051301	GO:BP	cell division	16175	13632		0.3793103448275862	0.38461538461538464	265	15910	13	34	252	15876	16175	0.11065549477524088
M1	cpdb	0	network_modules	55	TRUE	7.578346574026469e-10	12	47	6	0.1276595744680851	0.5	GO:0097576	GO:BP	vacuole fusion	16175	18701		0.3879310344827586	0.39316239316239315	12	16163	6	41	6	16122	16175	0.25163642496909755
M1	cpdb	0	network_modules	55	TRUE	1.1688821208708987e-9	156	47	11	0.23404255319148937	0.07051282051282051	GO:0016241	GO:BP	regulation of macroautophagy	16175	5183		0.39655172413793105	0.4017094017094017	156	16019	11	36	145	15983	16175	0.12394871263468614
M1	cpdb	0	network_modules	55	TRUE	1.537109433892345e-9	31	35	7	0.2	0.22580645161290322	REAC:R-HSA-917729	REAC	Endosomal Sorting Complex Required For Transport (ESCRT)	10916	841		0.3888888888888889	0.42105263157894735	31	10885	7	28	24	10857	10916	0.21012957420038617
M1	cpdb	0	network_modules	55	TRUE	2.021677867552801e-9	182	35	11	0.3142857142857143	0.06043956043956044	REAC:R-HSA-983712	REAC	Ion channel transport	10916	1272		0.4444444444444444	0.47368421052631576	182	10734	11	24	171	10710	10916	0.13182520798487887
M1	cpdb	0	network_modules	55	TRUE	2.4522673137881055e-9	14	47	6	0.1276595744680851	0.42857142857142855	GO:0097212	GO:BP	lysosomal membrane organization	16175	18546		0.4051724137931034	0.41025641025641024	14	16161	6	41	8	16120	16175	0.2327574936594591
M1	cpdb	0	network_modules	55	TRUE	2.966458263710813e-9	121	47	10	0.2127659574468085	0.08264462809917356	GO:0006997	GO:BP	nucleus organization	16175	2612		0.41379310344827586	0.4188034188034188	121	16054	10	37	111	16017	16175	0.12861050699847282
M1	cpdb	0	network_modules	55	TRUE	4.123835049746166e-9	125	47	10	0.2127659574468085	0.08	GO:0007041	GO:BP	lysosomal transport	16175	2645		0.4224137931034483	0.42735042735042733	125	16050	10	37	115	16013	16175	0.1263993251561084
M1	cpdb	0	network_modules	55	TRUE	4.469975508964512e-9	126	47	10	0.2127659574468085	0.07936507936507936	GO:0051701	GO:BP	biological process involved in interaction with host	16175	13901		0.43103448275862066	0.4358974358974359	126	16049	10	37	116	16012	16175	0.1258627015276311
M1	cpdb	0	network_modules	55	TRUE	5.2597522603721625e-9	31	47	7	0.14893617021276595	0.22580645161290322	GO:0090169	GO:BP	regulation of spindle assembly	16175	18077		0.4396551724137931	0.4444444444444444	31	16144	7	40	24	16104	16175	0.18146458169440657
M1	cpdb	0	network_modules	55	TRUE	5.737526025141808e-9	55	47	8	0.1702127659574468	0.14545454545454545	GO:0097352	GO:BP	autophagosome maturation	16175	18619		0.4482758620689655	0.452991452991453	55	16120	8	39	47	16081	16175	0.1546919008911561
M1	cpdb	0	network_modules	55	TRUE	6.960438471931013e-9	248	34	12	0.35294117647058826	0.04838709677419355	KEGG:04144	KEGG	Endocytosis	8484	280		0.7	0.7272727272727273	248	8236	12	22	236	8214	8484	0.12189431285615124
M1	cpdb	0	network_modules	55	TRUE	1.0359907746701292e-8	59	47	8	0.1702127659574468	0.13559322033898305	GO:0007080	GO:BP	mitotic metaphase chromosome alignment	16175	2669		0.45689655172413796	0.46153846153846156	59	16116	8	39	51	16077	16175	0.14915317285961832
M1	cpdb	0	network_modules	55	TRUE	1.2848812229513281e-8	157	35	10	0.2857142857142857	0.06369426751592357	REAC:R-HSA-9711097	REAC	Cellular response to starvation	10916	337		0.5	0.5263157894736842	157	10759	10	25	147	10734	10916	0.12924922412697143
M1	cpdb	0	network_modules	55	TRUE	3.901113670992695e-8	215	47	11	0.23404255319148937	0.05116279069767442	GO:0032984	GO:BP	protein-containing complex disassembly	16175	7964		0.46551724137931033	0.4700854700854701	215	15960	11	36	204	15924	16175	0.10405641443386023
M1	cpdb	0	network_modules	55	TRUE	4.4004429546912296e-8	41	47	7	0.14893617021276595	0.17073170731707318	GO:0060236	GO:BP	regulation of mitotic spindle organization	16175	14457		0.47413793103448276	0.47863247863247865	41	16134	7	40	34	16094	16175	0.157175633412137
M1	cpdb	0	network_modules	55	TRUE	6.280004382894366e-8	43	47	7	0.14893617021276595	0.16279069767441862	GO:0010824	GO:BP	regulation of centrosome duplication	16175	4434		0.4827586206896552	0.48717948717948717	43	16132	7	40	36	16092	16175	0.15335674718998596
M1	cpdb	0	network_modules	55	TRUE	7.451934799389935e-8	44	47	7	0.14893617021276595	0.1590909090909091	GO:0090224	GO:BP	regulation of spindle organization	16175	18121		0.49137931034482757	0.49572649572649574	44	16131	7	40	37	16091	16175	0.15154466323900884
M1	cpdb	0	network_modules	55	TRUE	1.419445873346369e-7	48	47	7	0.14893617021276595	0.14583333333333334	GO:0046605	GO:BP	regulation of centrosome cycle	16175	12255		0.5	0.5042735042735043	48	16127	7	40	41	16087	16175	0.14486553491511878
M1	cpdb	0	network_modules	55	TRUE	1.8756390532854235e-7	330	34	12	0.35294117647058826	0.03636363636363636	KEGG:05165	KEGG	Human papillomavirus infection	8484	446		0.8	0.8181818181818182	330	8154	12	22	318	8132	8484	0.10302924917668325
M1	cpdb	0	network_modules	55	TRUE	1.982197897825886e-7	32	35	6	0.17142857142857143	0.1875	REAC:R-HSA-9668328	REAC	Sealing of the nuclear envelope (NE) by ESCRT-III	10916	2185		0.5555555555555556	0.5789473684210527	32	10884	6	29	26	10855	10916	0.17676094115651603
M1	cpdb	0	network_modules	55	TRUE	3.433137340830494e-7	137	47	9	0.19148936170212766	0.06569343065693431	GO:0007009	GO:BP	plasma membrane organization	16175	2621		0.5086206896551724	0.5128205128205128	137	16038	9	38	128	16000	16175	0.1078114629467564
M1	cpdb	0	network_modules	55	TRUE	4.797562974339524e-7	155	34	9	0.2647058823529412	0.05806451612903226	KEGG:04150	KEGG	mTOR signaling pathway	8484	284		0.9	0.9090909090909091	155	8329	9	25	146	8304	8484	0.1167223396166645
M1	cpdb	0	network_modules	55	TRUE	5.721155416908515e-7	96	47	8	0.1702127659574468	0.08333333333333333	GO:0051310	GO:BP	metaphase chromosome alignment	16175	13641		0.5172413793103449	0.5213675213675214	96	16079	8	39	88	16040	16175	0.11545596891022437
M1	cpdb	0	network_modules	55	TRUE	7.115757561368115e-7	32	47	6	0.1276595744680851	0.1875	GO:0007035	GO:BP	vacuolar acidification	16175	2640		0.5258620689655172	0.5299145299145299	32	16143	6	41	26	16102	16175	0.1526884587412759
M1	cpdb	0	network_modules	55	TRUE	7.339036325830085e-7	99	47	8	0.1702127659574468	0.08080808080808081	GO:0006906	GO:BP	vesicle fusion	16175	2557		0.5344827586206896	0.5384615384615384	99	16076	8	39	91	16037	16175	0.11357541380248301
M1	cpdb	0	network_modules	55	TRUE	8.626215483721687e-7	101	47	8	0.1702127659574468	0.07920792079207921	GO:0090174	GO:BP	organelle membrane fusion	16175	18081		0.5431034482758621	0.5470085470085471	101	16074	8	39	93	16035	16175	0.1123675417101491
M1	cpdb	0	network_modules	55	TRUE	9.497438907427082e-7	374	47	12	0.2553191489361702	0.03208556149732621	GO:0022411	GO:BP	cellular component disassembly	16175	6602		0.5517241379310345	0.5555555555555556	374	15801	12	35	362	15766	16175	0.0834029794368225
M1	cpdb	0	network_modules	55	TRUE	1.0105011315629013e-6	103	47	8	0.1702127659574468	0.07766990291262135	GO:0051303	GO:BP	establishment of chromosome localization	16175	13634		0.5603448275862069	0.5641025641025641	103	16072	8	39	95	16033	16175	0.11119425574864125
M1	cpdb	0	network_modules	55	TRUE	1.410390948069227e-6	225	47	10	0.2127659574468085	0.044444444444444446	GO:0044403	GO:BP	biological process involved in symbiotic interaction	16175	10991		0.5689655172413793	0.5726495726495726	225	15950	10	37	215	15913	16175	0.09165774918281418
M1	cpdb	0	network_modules	55	TRUE	1.4801119359025428e-6	108	47	8	0.1702127659574468	0.07407407407407407	GO:0050000	GO:BP	chromosome localization	16175	13183		0.5775862068965517	0.5811965811965812	108	16067	8	39	100	16028	16175	0.10840180500708943
M1	cpdb	0	network_modules	55	TRUE	1.7895742988735645e-6	68	47	7	0.14893617021276595	0.10294117647058823	GO:0090307	GO:BP	mitotic spindle assembly	16175	18189		0.5862068965517241	0.5897435897435898	68	16107	7	40	61	16067	16175	0.12075529795216058
M1	cpdb	0	network_modules	55	TRUE	2.4390235563258876e-6	71	47	7	0.14893617021276595	0.09859154929577464	GO:0051298	GO:BP	centrosome duplication	16175	13629		0.5948275862068966	0.5982905982905983	71	16104	7	40	64	16064	16175	0.11803614779127979
M1	cpdb	0	network_modules	55	TRUE	2.8604120834559765e-6	242	47	10	0.2127659574468085	0.04132231404958678	GO:0019058	GO:BP	viral life cycle	16175	5555		0.603448275862069	0.6068376068376068	242	15933	10	37	232	15896	16175	0.08795952613241868
M1	cpdb	0	network_modules	55	TRUE	3.097245613743299e-6	324	47	11	0.23404255319148937	0.033950617283950615	GO:0010506	GO:BP	regulation of autophagy	16175	4181		0.6120689655172413	0.6153846153846154	324	15851	11	36	313	15815	16175	0.08245927660718268
M1	cpdb	0	network_modules	55	TRUE	4.2309732105959875e-6	252	47	10	0.2127659574468085	0.03968253968253968	GO:0140014	GO:BP	mitotic nuclear division	16175	19633		0.6206896551724138	0.6239316239316239	252	15923	10	37	242	15886	16175	0.08595420178159126
M1	cpdb	0	network_modules	55	TRUE	4.4720491077800065e-6	124	47	8	0.1702127659574468	0.06451612903225806	GO:0007052	GO:BP	mitotic spindle organization	16175	2651		0.6293103448275862	0.6324786324786325	124	16051	8	39	116	16012	16175	0.10060486889548151
M1	cpdb	0	network_modules	55	TRUE	6.217381745067074e-6	45	47	6	0.1276595744680851	0.13333333333333333	GO:0051452	GO:BP	intracellular pH reduction	16175	13713		0.6379310344827587	0.6410256410256411	45	16130	6	41	39	16089	16175	0.12798637182374628
M1	cpdb	0	network_modules	55	TRUE	9.315810392431076e-6	136	47	8	0.1702127659574468	0.058823529411764705	GO:0048284	GO:BP	organelle fusion	16175	12626		0.646551724137931	0.6495726495726496	136	16039	8	39	128	16000	16175	0.0956612547606097
M1	cpdb	0	network_modules	55	TRUE	9.32134379164341e-6	507	35	12	0.34285714285714286	0.023668639053254437	REAC:R-HSA-9006934	REAC	Signaling by Receptor Tyrosine Kinases	10916	2302		0.6111111111111112	0.631578947368421	507	10409	12	23	495	10386	10916	0.0798821591128223
M1	cpdb	0	network_modules	55	TRUE	1.0965609143662827e-5	158	34	8	0.23529411764705882	0.05063291139240506	KEGG:04217	KEGG	Necroptosis	8484	294		1	1	158	8326	8	26	150	8300	8484	0.10166359372553228
M1	cpdb	0	network_modules	55	TRUE	2.3595322265126728e-5	153	47	8	0.1702127659574468	0.05228758169934641	GO:1902850	GO:BP	microtubule cytoskeleton organization involved in mitosis	16175	22560		0.6551724137931034	0.6581196581196581	153	16022	8	39	145	15983	16175	0.08965198812902435
M1	cpdb	0	network_modules	55	TRUE	2.6295738244232406e-5	70	35	6	0.17142857142857143	0.08571428571428572	REAC:R-HSA-2995410	REAC	Nuclear Envelope (NE) Reassembly	10916	1612		0.6666666666666666	0.6842105263157895	70	10846	6	29	64	10817	10916	0.11724795868096322
M1	cpdb	0	network_modules	55	TRUE	2.889615885720961e-5	157	47	8	0.1702127659574468	0.050955414012738856	GO:0061025	GO:BP	membrane fusion	16175	15142		0.6637931034482759	0.6666666666666666	157	16018	8	39	149	15979	16175	0.08837744107572648
M1	cpdb	0	network_modules	55	TRUE	3.7885037886224906e-5	519	47	12	0.2553191489361702	0.023121387283236993	GO:0051640	GO:BP	organelle localization	16175	13853		0.6724137931034483	0.6752136752136753	519	15656	12	35	507	15621	16175	0.06838116329007887
M1	cpdb	0	network_modules	55	TRUE	5.4036155081807174e-5	656	47	13	0.2765957446808511	0.019817073170731708	GO:1903047	GO:BP	mitotic cell cycle process	16175	22727		0.6810344827586207	0.6837606837606838	656	15519	13	34	643	15485	16175	0.06459569105432031
M1	cpdb	0	network_modules	55	TRUE	5.485294649197973e-5	132	35	7	0.2	0.05303030303030303	REAC:R-HSA-162599	REAC	Late Phase of HIV Life Cycle	10916	1304		0.7222222222222222	0.7368421052631579	132	10784	7	28	125	10756	10916	0.09750586057008186
M1	cpdb	0	network_modules	55	TRUE	5.501594138584456e-5	657	47	13	0.2765957446808511	0.0197869101978691	GO:0061024	GO:BP	membrane organization	16175	15141		0.6896551724137931	0.6923076923076923	657	15518	13	34	644	15484	16175	0.06453168577720346
M1	cpdb	0	network_modules	55	TRUE	6.465773583652407e-5	113	47	7	0.14893617021276595	0.061946902654867256	GO:0051225	GO:BP	spindle assembly	16175	13578		0.6982758620689655	0.7008547008547008	113	16062	7	40	106	16022	16175	0.09200248794455103
M1	cpdb	0	network_modules	55	TRUE	6.625645284735765e-5	66	47	6	0.1276595744680851	0.09090909090909091	GO:1902600	GO:BP	proton transmembrane transport	16175	22372		0.7068965517241379	0.7094017094017094	66	16109	6	41	60	16068	16175	0.10465068953937093
M1	cpdb	0	network_modules	55	TRUE	7.056276356467172e-5	176	47	8	0.1702127659574468	0.045454545454545456	GO:0007051	GO:BP	spindle organization	16175	2650		0.7155172413793104	0.717948717948718	176	15999	8	39	168	15960	16175	0.08290917754502185
M1	cpdb	0	network_modules	55	TRUE	7.704775202386103e-5	178	47	8	0.1702127659574468	0.0449438202247191	GO:0000070	GO:BP	mitotic sister chromatid segregation	16175	24		0.7241379310344828	0.7264957264957265	178	15997	8	39	170	15958	16175	0.08238325107225612
M1	cpdb	0	network_modules	55	TRUE	9.675224104163423e-5	350	47	10	0.2127659574468085	0.02857142857142857	GO:0016032	GO:BP	viral process	16175	5071		0.7327586206896551	0.7350427350427351	350	15825	10	37	340	15788	16175	0.07091213259260497
M1	cpdb	0	network_modules	55	TRUE	1.043244266959196e-4	145	35	7	0.2	0.04827586206896552	REAC:R-HSA-162587	REAC	HIV Life Cycle	10916	1103		0.7777777777777778	0.7894736842105263	145	10771	7	28	138	10743	10916	0.09249843826555784
M1	cpdb	0	network_modules	55	TRUE	1.3254963551740935e-4	270	47	9	0.19148936170212766	0.03333333333333333	GO:0016197	GO:BP	endosomal transport	16175	5169		0.7413793103448276	0.7435897435897436	270	15905	9	38	261	15867	16175	0.07365259545010414
M1	cpdb	0	network_modules	55	TRUE	1.406447431738343e-4	225	35	8	0.22857142857142856	0.035555555555555556	REAC:R-HSA-162906	REAC	HIV Infection	10916	1102		0.8333333333333334	0.8421052631578947	225	10691	8	27	217	10664	10916	0.0830121092308117
M1	cpdb	0	network_modules	55	TRUE	1.6042157346006858e-4	15	47	4	0.0851063829787234	0.26666666666666666	GO:1903543	GO:BP	positive regulation of exosomal secretion	16175	23093		0.75	0.7521367521367521	15	16160	4	43	11	16117	16175	0.14929337956484542
M1	cpdb	0	network_modules	55	TRUE	1.6161920916876418e-4	129	47	7	0.14893617021276595	0.05426356589147287	GO:0007098	GO:BP	centrosome cycle	16175	2681		0.7586206896551724	0.7606837606837606	129	16046	7	40	122	16006	16175	0.08555066208946058
M1	cpdb	0	network_modules	55	TRUE	2.037647116879874e-4	379	47	10	0.2127659574468085	0.026385224274406333	GO:0000280	GO:BP	nuclear division	16175	78		0.7672413793103449	0.7692307692307693	379	15796	10	37	369	15759	16175	0.0675678488899167
M1	cpdb	0	network_modules	55	TRUE	2.125542624183322e-4	80	47	6	0.1276595744680851	0.075	GO:0051453	GO:BP	regulation of intracellular pH	16175	13714		0.7758620689655172	0.7777777777777778	80	16095	6	41	74	16054	16175	0.0944290069952237
M1	cpdb	0	network_modules	55	TRUE	2.4660554153876105e-4	82	47	6	0.1276595744680851	0.07317073170731707	GO:0030641	GO:BP	regulation of cellular pH	16175	6868		0.7844827586206896	0.7863247863247863	82	16093	6	41	76	16052	16175	0.09318213450422928
M1	cpdb	0	network_modules	55	TRUE	2.785211577241296e-4	17	47	4	0.0851063829787234	0.23529411764705882	GO:1903541	GO:BP	regulation of exosomal secretion	16175	23091		0.7931034482758621	0.7948717948717948	17	16158	4	43	13	16115	16175	0.14003938848202985
M1	cpdb	0	network_modules	55	TRUE	3.0600615706144073e-4	85	47	6	0.1276595744680851	0.07058823529411765	GO:0006885	GO:BP	regulation of pH	16175	2541		0.8017241379310345	0.8034188034188035	85	16090	6	41	79	16049	16175	0.09139302289735816
M1	cpdb	0	network_modules	55	TRUE	3.557383928353811e-4	217	47	8	0.1702127659574468	0.03686635944700461	GO:0000819	GO:BP	sister chromatid segregation	16175	237		0.8103448275862069	0.811965811965812	217	15958	8	39	209	15919	16175	0.07357353364335084
M1	cpdb	0	network_modules	55	TRUE	3.573372337665855e-4	18	47	4	0.0851063829787234	0.2222222222222222	GO:0007039	GO:BP	protein catabolic process in the vacuole	16175	2643		0.8189655172413793	0.8205128205128205	18	16157	4	43	14	16114	16175	0.1359979326383652
M1	cpdb	0	network_modules	55	TRUE	3.7783038470451223e-4	146	47	7	0.14893617021276595	0.04794520547945205	GO:0031023	GO:BP	microtubule organizing center organization	16175	6997		0.8275862068965517	0.8290598290598291	146	16029	7	40	139	15989	16175	0.0798586105232412
M1	cpdb	0	network_modules	55	TRUE	3.9586078644352147e-4	147	47	7	0.14893617021276595	0.047619047619047616	GO:0070507	GO:BP	regulation of microtubule cytoskeleton organization	16175	16162		0.8362068965517241	0.8376068376068376	147	16028	7	40	140	15988	16175	0.0795538327355475
M1	cpdb	0	network_modules	55	TRUE	4.227470011485422e-4	410	47	10	0.2127659574468085	0.024390243902439025	GO:0051656	GO:BP	establishment of organelle localization	16175	13869		0.8448275862068966	0.8461538461538461	410	15765	10	37	400	15728	16175	0.06436885800598499
M1	cpdb	0	network_modules	55	TRUE	4.8518329085009046e-4	792	47	13	0.2765957446808511	0.016414141414141416	GO:0000278	GO:BP	mitotic cell cycle	16175	76		0.853448275862069	0.8547008547008547	792	15383	13	34	779	15349	16175	0.05694450421072275
M1	cpdb	0	network_modules	55	TRUE	5.63380682698229e-4	20	47	4	0.0851063829787234	0.2	GO:1990182	GO:BP	exosomal secretion	16175	25111		0.8620689655172413	0.8632478632478633	20	16155	4	43	16	16112	16175	0.12883701169217102
M1	cpdb	0	network_modules	55	TRUE	5.762836506776701e-4	424	47	10	0.2127659574468085	0.02358490566037736	GO:0048285	GO:BP	organelle fission	16175	12627		0.8706896551724138	0.8717948717948718	424	15751	10	37	414	15714	16175	0.0630329198404519
M1	cpdb	0	network_modules	55	TRUE	6.944612872124864e-4	21	47	4	0.0851063829787234	0.19047619047619047	GO:0007042	GO:BP	lysosomal lumen acidification	16175	2646		0.8793103448275862	0.8888888888888888	21	16154	4	43	17	16111	16175	0.12564325581801428
M1	cpdb	0	network_modules	55	TRUE	6.944612872124864e-4	21	47	4	0.0851063829787234	0.19047619047619047	GO:0097734	GO:BP	extracellular exosome biogenesis	16175	18749		0.8793103448275862	0.8888888888888888	21	16154	4	43	17	16111	16175	0.12564325581801428
M1	cpdb	0	network_modules	55	TRUE	9.11636496135812e-4	339	47	9	0.19148936170212766	0.02654867256637168	GO:0042060	GO:BP	wound healing	16175	9947		0.896551724137931	0.8974358974358975	339	15836	9	38	330	15798	16175	0.06426639519543872
M1	cpdb	0	network_modules	55	TRUE	0.0010231139113757398	23	47	4	0.0851063829787234	0.17391304347826086	GO:0140112	GO:BP	extracellular vesicle biogenesis	16175	19667		0.9051724137931034	0.905982905982906	23	16152	4	43	19	16109	16175	0.11988658268773313
M1	cpdb	0	network_modules	55	TRUE	0.0015416328591830984	361	47	9	0.19148936170212766	0.024930747922437674	GO:0007059	GO:BP	chromosome segregation	16175	2658		0.9137931034482759	0.9145299145299145	361	15814	9	38	352	15776	16175	0.06182360561783567
M1	cpdb	0	network_modules	55	TRUE	0.001947408752274316	186	47	7	0.14893617021276595	0.03763440860215054	GO:1902115	GO:BP	regulation of organelle assembly	16175	22028		0.9224137931034483	0.9230769230769231	186	15989	7	40	179	15949	16175	0.06958879626436727
M1	cpdb	0	network_modules	55	TRUE	0.002266646945584911	277	47	8	0.1702127659574468	0.02888086642599278	GO:0098813	GO:BP	nuclear chromosome segregation	16175	18900		0.9310344827586207	0.9316239316239316	277	15898	8	39	269	15859	16175	0.06369887574751504
M1	cpdb	0	network_modules	55	TRUE	0.0023406625292379185	28	47	4	0.0851063829787234	0.14285714285714285	GO:0035751	GO:BP	regulation of lysosomal lumen pH	16175	9214		0.9396551724137931	0.9401709401709402	28	16147	4	43	24	16104	16175	0.10827184022511491
M1	cpdb	0	network_modules	55	TRUE	0.0028351828075077012	13	35	3	0.08571428571428572	0.23076923076923078	REAC:R-HSA-9679504	REAC	Translation of Replicase and Assembly of the Replication Transcription Complex	10916	2568		0.8888888888888888	0.8947368421052632	13	10903	3	32	10	10871	10916	0.1389937534810512
M1	cpdb	0	network_modules	55	TRUE	0.003600484701817358	14	35	3	0.08571428571428572	0.21428571428571427	REAC:R-HSA-9694676	REAC	Translation of Replicase and Assembly of the Replication Transcription Complex	10916	2569		0.9444444444444444	0.9473684210526315	14	10902	3	32	11	10870	10916	0.13379870300597554
M1	cpdb	0	network_modules	55	TRUE	0.004158125357069294	407	47	9	0.19148936170212766	0.022113022113022112	GO:0009611	GO:BP	response to wounding	16175	3539		0.9482758620689655	0.9487179487179487	407	15768	9	38	398	15730	16175	0.057329796316900265
M1	cpdb	0	network_modules	55	TRUE	0.00523101104002878	10	47	3	0.06382978723404255	0.3	GO:0007084	GO:BP	mitotic nuclear membrane reassembly	16175	2670		0.9568965517241379	0.9658119658119658	10	16165	3	44	7	16121	16175	0.13728134983042622
M1	cpdb	0	network_modules	55	TRUE	0.00523101104002878	10	47	3	0.06382978723404255	0.3	GO:0101024	GO:BP	mitotic nuclear membrane organization	16175	19197		0.9568965517241379	0.9658119658119658	10	16165	3	44	7	16121	16175	0.13728134983042622
M1	cpdb	0	network_modules	55	TRUE	0.0071779720915964105	11	47	3	0.06382978723404255	0.2727272727272727	GO:1904350	GO:BP	regulation of protein catabolic process in the vacuole	16175	23737		0.9741379310344828	0.9743589743589743	11	16164	3	44	8	16120	16175	0.13076865712245905
M1	cpdb	0	network_modules	55	TRUE	0.007866358062017258	440	47	9	0.19148936170212766	0.020454545454545454	GO:0051493	GO:BP	regulation of cytoskeleton organization	16175	13748		0.9827586206896551	0.9829059829059829	440	15735	9	38	431	15697	16175	0.05451878317867699
M1	cpdb	0	network_modules	55	TRUE	0.008467520797705007	232	47	7	0.14893617021276595	0.03017241379310345	GO:0032886	GO:BP	regulation of microtubule-based process	16175	7882		0.9913793103448276	0.9914529914529915	232	15943	7	40	225	15903	16175	0.061107789520979984
M1	cpdb	0	network_modules	55	TRUE	0.009247758294719726	113	35	5	0.14285714285714285	0.04424778761061947	REAC:R-HSA-9610379	REAC	HCMV Late Events	10916	1090		1	1	113	10803	5	30	108	10773	10916	0.07424807512884277
M1	cpdb	0	network_modules	55	TRUE	0.009551113597164148	12	47	3	0.06382978723404255	0.25	GO:0048388	GO:BP	endosomal lumen acidification	16175	12723		1	1	12	16163	3	44	9	16119	16175	0.12508275374606562
M1	cpdb	0	network_modules	56	TRUE	2.254772839341719e-31	590	45	31	0.6888888888888889	0.05254237288135593	GO:0016071	GO:BP	mRNA metabolic process	16175	5098		0	0.02564102564102564	590	15585	31	14	559	15571	16175	0.1838130988919631
M1	cpdb	0	network_modules	56	TRUE	4.314106356583149e-31	397	45	28	0.6222222222222222	0.07052896725440806	GO:0008380	GO:BP	RNA splicing	16175	3186		0.02631578947368421	0.05128205128205128	397	15778	28	17	369	15761	16175	0.20402318777948003
M1	cpdb	0	network_modules	56	TRUE	4.503120229149345e-27	352	45	25	0.5555555555555556	0.07102272727272728	GO:0006397	GO:BP	mRNA processing	16175	2158		0.05263157894736842	0.07692307692307693	352	15823	25	20	327	15803	16175	0.19323729997579686
M1	cpdb	0	network_modules	56	TRUE	1.139907691810152e-25	287	45	23	0.5111111111111111	0.08013937282229965	GO:0000377	GO:BP	RNA splicing, via transesterification reactions with bulged adenosine as nucleophile	16175	109		0.07894736842105263	0.1282051282051282	287	15888	23	22	264	15866	16175	0.19739152140564736
M1	cpdb	0	network_modules	56	TRUE	1.139907691810152e-25	287	45	23	0.5111111111111111	0.08013937282229965	GO:0000398	GO:BP	mRNA splicing, via spliceosome	16175	121		0.07894736842105263	0.1282051282051282	287	15888	23	22	264	15866	16175	0.19739152140564736
M1	cpdb	0	network_modules	56	TRUE	1.57896845163395e-25	291	45	23	0.5111111111111111	0.07903780068728522	GO:0000375	GO:BP	RNA splicing, via transesterification reactions	16175	107		0.13157894736842105	0.15384615384615385	291	15884	23	22	268	15862	16175	0.19595659511511682
M1	cpdb	0	network_modules	56	TRUE	2.220318081580336e-24	273	45	22	0.4888888888888889	0.08058608058608059	GO:1903311	GO:BP	regulation of mRNA metabolic process	16175	22895		0.15789473684210525	0.1794871794871795	273	15902	22	23	251	15879	16175	0.19354335979342674
M1	cpdb	0	network_modules	56	TRUE	1.1898616452483403e-18	276	32	18	0.5625	0.06521739130434782	REAC:R-HSA-72203	REAC	Processing of Capped Intron-Containing Pre-mRNA	10916	1796		0	0.25	276	10640	18	14	258	10626	10916	0.18555294178686016
M1	cpdb	0	network_modules	56	TRUE	1.627914959028397e-17	202	32	16	0.5	0.07920792079207921	REAC:R-HSA-72163	REAC	mRNA Splicing - Major Pathway	10916	2707		0.3333333333333333	0.5	202	10714	16	16	186	10698	10916	0.1937245110433295
M1	cpdb	0	network_modules	56	TRUE	2.8391174190838396e-17	209	32	16	0.5	0.07655502392344497	REAC:R-HSA-72172	REAC	mRNA Splicing	10916	2706		0.6666666666666666	0.75	209	10707	16	16	193	10691	10916	0.1902612085054645
M1	cpdb	0	network_modules	56	TRUE	8.233140741987069e-16	175	45	15	0.3333333333333333	0.08571428571428572	GO:0043484	GO:BP	regulation of RNA splicing	16175	10730		0.18421052631578946	0.20512820512820512	175	16000	15	30	160	15970	16175	0.16466569999636183
M1	cpdb	0	network_modules	56	TRUE	7.595326517325248e-15	84	45	12	0.26666666666666666	0.14285714285714285	GO:1903312	GO:BP	negative regulation of mRNA metabolic process	16175	22896		0.21052631578947367	0.23076923076923078	84	16091	12	33	72	16058	16175	0.19214532751684282
M1	cpdb	0	network_modules	56	TRUE	5.969032620442095e-13	119	45	12	0.26666666666666666	0.10084033613445378	GO:0050684	GO:BP	regulation of mRNA processing	16175	13215		0.23684210526315788	0.2564102564102564	119	16056	12	33	107	16023	16175	0.16027281122972245
M1	cpdb	0	network_modules	56	TRUE	1.46560909188766e-12	226	45	14	0.3111111111111111	0.061946902654867256	GO:0006402	GO:BP	mRNA catabolic process	16175	2163		0.2631578947368421	0.28205128205128205	226	15949	14	31	212	15918	16175	0.1337124885814239
M1	cpdb	0	network_modules	56	TRUE	3.467221609174392e-12	98	45	11	0.24444444444444444	0.11224489795918367	GO:0048024	GO:BP	regulation of mRNA splicing, via spliceosome	16175	12475		0.2894736842105263	0.3076923076923077	98	16077	11	34	87	16043	16175	0.16225498188157542
M1	cpdb	0	network_modules	56	TRUE	3.747747930918394e-12	67	45	10	0.2222222222222222	0.14925373134328357	GO:0000380	GO:BP	alternative mRNA splicing, via spliceosome	16175	112		0.3157894736842105	0.3333333333333333	67	16108	10	35	57	16073	16175	0.1793457311584404
M1	cpdb	0	network_modules	56	TRUE	2.7522393999197013e-11	279	45	14	0.3111111111111111	0.05017921146953405	GO:0006401	GO:BP	RNA catabolic process	16175	2162		0.34210526315789475	0.358974358974359	279	15896	14	31	265	15865	16175	0.11921507144064596
M1	cpdb	0	network_modules	56	TRUE	5.3768531943057596e-11	172	45	12	0.26666666666666666	0.06976744186046512	GO:0061013	GO:BP	regulation of mRNA catabolic process	16175	15136		0.3684210526315789	0.38461538461538464	172	16003	12	33	160	15970	16175	0.13184520357398488
M1	cpdb	0	network_modules	56	TRUE	7.155261417040498e-11	299	45	14	0.3111111111111111	0.046822742474916385	GO:0141188	GO:BP	nucleic acid catabolic process	16175	20075		0.39473684210526316	0.41025641025641024	299	15876	14	31	285	15845	16175	0.11474660071786684
M1	cpdb	0	network_modules	56	TRUE	2.8899131275434497e-10	67	45	9	0.2	0.13432835820895522	GO:1902373	GO:BP	negative regulation of mRNA catabolic process	16175	22245		0.42105263157894735	0.4358974358974359	67	16108	9	36	58	16072	16175	0.16107051018330718
M1	cpdb	0	network_modules	56	TRUE	6.430907841858545e-10	156	45	11	0.24444444444444444	0.07051282051282051	GO:0043488	GO:BP	regulation of mRNA stability	16175	10733		0.4473684210526316	0.46153846153846156	156	16019	11	34	145	15985	16175	0.12689699217476413
M1	cpdb	0	network_modules	56	TRUE	1.0686442135274556e-9	77	45	9	0.2	0.11688311688311688	GO:1902369	GO:BP	negative regulation of RNA catabolic process	16175	22241		0.47368421052631576	0.48717948717948717	77	16098	9	36	68	16062	16175	0.14982002829348554
M1	cpdb	0	network_modules	56	TRUE	1.364734624143165e-9	167	45	11	0.24444444444444444	0.0658682634730539	GO:0043487	GO:BP	regulation of RNA stability	16175	10732		0.5	0.5128205128205128	167	16008	11	34	156	15974	16175	0.12233334824725582
M1	cpdb	0	network_modules	56	TRUE	3.1434219354854458e-9	54	45	8	0.17777777777777778	0.14814814814814814	GO:0000381	GO:BP	regulation of alternative mRNA splicing, via spliceosome	16175	113		0.5263157894736842	0.5384615384615384	54	16121	8	37	46	16084	16175	0.1597293815392856
M1	cpdb	0	network_modules	56	TRUE	5.743920877004457e-9	58	45	8	0.17777777777777778	0.13793103448275862	GO:0048255	GO:BP	mRNA stabilization	16175	12610		0.5526315789473685	0.5641025641025641	58	16117	8	37	50	16080	16175	0.153923688368719
M1	cpdb	0	network_modules	56	TRUE	1.1359246103400162e-8	434	45	14	0.3111111111111111	0.03225806451612903	GO:0010608	GO:BP	post-transcriptional regulation of gene expression	16175	4255		0.5789473684210527	0.5897435897435898	434	15741	14	31	420	15710	16175	0.09292188364919327
M1	cpdb	0	network_modules	56	TRUE	1.738443565930149e-8	448	45	14	0.3111111111111111	0.03125	GO:0034655	GO:BP	nucleobase-containing compound catabolic process	16175	8711		0.6052631578947368	0.6153846153846154	448	15727	14	31	434	15696	16175	0.09122057068213192
M1	cpdb	0	network_modules	56	TRUE	1.9189546129327296e-8	67	45	8	0.17777777777777778	0.11940298507462686	GO:0043489	GO:BP	RNA stabilization	16175	10734		0.631578947368421	0.6410256410256411	67	16108	8	37	59	16071	16175	0.14279528920817394
M1	cpdb	0	network_modules	56	TRUE	2.780488033955259e-7	174	21	8	0.38095238095238093	0.04597701149425287	KEGG:03040	KEGG	Spliceosome	8484	215		NA	1	174	8310	8	13	166	8297	8484	0.12668051549938417
M1	cpdb	0	network_modules	56	TRUE	1.939413176440411e-6	118	45	8	0.17777777777777778	0.06779661016949153	GO:0045727	GO:BP	positive regulation of translation	16175	11569		0.6578947368421053	0.6666666666666666	118	16057	8	37	110	16020	16175	0.105813270201937
M1	cpdb	0	network_modules	56	TRUE	3.0739943987869757e-6	125	45	8	0.17777777777777778	0.064	GO:1903313	GO:BP	positive regulation of mRNA metabolic process	16175	22897		0.6842105263157895	0.6923076923076923	125	16050	8	37	117	16013	16175	0.10256920031789939
M1	cpdb	0	network_modules	56	TRUE	9.622951110315377e-6	290	45	10	0.2222222222222222	0.034482758620689655	GO:0009895	GO:BP	negative regulation of catabolic process	16175	3755		0.7105263157894737	0.717948717948718	290	15885	10	35	280	15850	16175	0.08131954114371122
M1	cpdb	0	network_modules	56	TRUE	1.0380636886020619e-5	92	45	7	0.15555555555555556	0.07608695652173914	GO:0061157	GO:BP	mRNA destabilization	16175	15262		0.7368421052631579	0.7435897435897436	92	16083	7	38	85	16045	16175	0.10526019027504228
M1	cpdb	0	network_modules	56	TRUE	1.3012803294823809e-5	95	45	7	0.15555555555555556	0.07368421052631578	GO:0050779	GO:BP	RNA destabilization	16175	13253		0.7631578947368421	0.7692307692307693	95	16080	7	38	88	16042	16175	0.10346631199413754
M1	cpdb	0	network_modules	56	TRUE	1.506571607250219e-5	97	45	7	0.15555555555555556	0.07216494845360824	GO:0061014	GO:BP	positive regulation of mRNA catabolic process	16175	15137		0.7894736842105263	0.7948717948717948	97	16078	7	38	90	16040	16175	0.1023158720400992
M1	cpdb	0	network_modules	56	TRUE	7.700823948426322e-5	5	32	3	0.09375	0.6	REAC:R-HSA-8849468	REAC	PTK6 Regulates Proteins Involved in RNA Processing	10916	1708		1	1	5	10911	3	29	2	10882	10916	0.23641290081458052
M1	cpdb	0	network_modules	56	TRUE	0.0011243108355117458	112	45	6	0.13333333333333333	0.05357142857142857	GO:0031047	GO:BP	regulatory ncRNA-mediated gene silencing	16175	7011		0.8157894736842105	0.8205128205128205	112	16063	6	39	106	16024	16175	0.08051730851226332
M1	cpdb	0	network_modules	56	TRUE	0.0011848989822258972	113	45	6	0.13333333333333333	0.05309734513274336	GO:0000956	GO:BP	nuclear-transcribed mRNA catabolic process	16175	264		0.8421052631578947	0.8461538461538461	113	16062	6	39	107	16023	16175	0.08012353504242942
M1	cpdb	0	network_modules	56	TRUE	0.0013342206246685785	26	45	4	0.08888888888888889	0.15384615384615385	GO:0070935	GO:BP	3'-UTR-mediated mRNA stabilization	16175	16379		0.868421052631579	0.8717948717948718	26	16149	4	41	22	16108	16175	0.11507895870210058
M1	cpdb	0	network_modules	56	TRUE	0.002098099578240958	290	45	8	0.17777777777777778	0.027586206896551724	GO:0006417	GO:BP	regulation of translation	16175	2174		0.8947368421052632	0.8974358974358975	290	15885	8	37	282	15848	16175	0.06362830270390586
M1	cpdb	0	network_modules	56	TRUE	0.0036004337281137526	33	45	4	0.08888888888888889	0.12121212121212122	GO:2000765	GO:BP	regulation of cytoplasmic translation	16175	26025		0.9210526315789473	0.9230769230769231	33	16142	4	41	29	16101	16175	0.10166256436407971
M1	cpdb	0	network_modules	56	TRUE	0.005837208130928911	11	45	3	0.06666666666666667	0.2727272727272727	GO:0070934	GO:BP	CRD-mediated mRNA stabilization	16175	16378		0.9473684210526315	0.9487179487179487	11	16164	3	42	8	16122	16175	0.13369599034230295
M1	cpdb	0	network_modules	56	TRUE	0.007767794288788536	12	45	3	0.06666666666666667	0.25	GO:1900152	GO:BP	negative regulation of nuclear-transcribed mRNA catabolic process, deadenylation-dependent decay	16175	20436		0.9736842105263158	0.9743589743589743	12	16163	3	42	9	16121	16175	0.12788819242126215
M1	cpdb	0	network_modules	56	TRUE	0.008696694036621431	159	45	6	0.13333333333333333	0.03773584905660377	GO:0001649	GO:BP	osteoblast differentiation	16175	367		1	1	159	16016	6	39	153	15977	16175	0.06612055708035978
M1	cpdb	0	network_modules	57	TRUE	9.90457879785403e-35	510	46	32	0.6956521739130435	0.06274509803921569	GO:0007169	GO:BP	cell surface receptor protein tyrosine kinase signaling pathway	16175	2733		0	0.012658227848101266	510	15665	32	14	478	15651	16175	0.20296309947960928
M1	cpdb	0	network_modules	57	TRUE	2.792956894597777e-30	790	46	33	0.717391304347826	0.04177215189873418	GO:0007167	GO:BP	enzyme-linked receptor protein signaling pathway	16175	2731		0.01282051282051282	0.02531645569620253	790	15385	33	13	757	15372	16175	0.1656499871957624
M1	cpdb	0	network_modules	57	TRUE	4.218502015277437e-26	47	42	16	0.38095238095238093	0.3404255319148936	REAC:R-HSA-512988	REAC	Interleukin-3, Interleukin-5 and GM-CSF signaling	10916	1246		0	0.010101010101010102	47	10869	16	26	31	10843	10916	0.3575065780377761
M1	cpdb	0	network_modules	57	TRUE	5.2024799176276103e-23	84	39	17	0.4358974358974359	0.20238095238095238	KEGG:04012	KEGG	ErbB signaling pathway	8484	245		0	0.010309278350515464	84	8400	17	22	67	8378	8484	0.2923881894580351
M1	cpdb	0	network_modules	57	TRUE	1.856914812592262e-22	21	42	12	0.2857142857142857	0.5714285714285714	REAC:R-HSA-912631	REAC	Regulation of signaling by CBL	10916	2049		0.01020408163265306	0.020202020202020204	21	10895	12	30	9	10865	10916	0.40250205560307817
M1	cpdb	0	network_modules	57	TRUE	3.39062369996348e-22	507	42	26	0.6190476190476191	0.05128205128205128	REAC:R-HSA-9006934	REAC	Signaling by Receptor Tyrosine Kinases	10916	2302		0.02040816326530612	0.030303030303030304	507	10409	26	16	481	10393	10916	0.16909778185467697
M1	cpdb	0	network_modules	57	TRUE	8.210461139698686e-22	76	39	16	0.41025641025641024	0.21052631578947367	KEGG:05220	KEGG	Chronic myeloid leukemia	8484	471		0.010416666666666666	0.020618556701030927	76	8408	16	23	60	8385	8484	0.28943256018541946
M1	cpdb	0	network_modules	57	TRUE	2.5555289663195525e-21	235	39	21	0.5384615384615384	0.08936170212765958	KEGG:04014	KEGG	Ras signaling pathway	8484	247		0.020833333333333332	0.030927835051546393	235	8249	21	18	214	8231	8484	0.2115034332091286
M1	cpdb	0	network_modules	57	TRUE	6.024149368085136e-21	26	42	12	0.2857142857142857	0.46153846153846156	REAC:R-HSA-186763	REAC	Downstream signal transduction	10916	790		0.030612244897959183	0.04040404040404041	26	10890	12	30	14	10860	10916	0.3612345053246806
M1	cpdb	0	network_modules	57	TRUE	9.052059601389699e-21	38	42	13	0.30952380952380953	0.34210526315789475	REAC:R-HSA-8853659	REAC	RET signaling	10916	1845		0.04081632653061224	0.050505050505050504	38	10878	13	29	25	10849	10916	0.32293058550531484
M1	cpdb	0	network_modules	57	TRUE	1.3544492644546263e-20	39	42	13	0.30952380952380953	0.3333333333333333	REAC:R-HSA-1433557	REAC	Signaling by SCF-KIT	10916	2306		0.05102040816326531	0.06060606060606061	39	10877	13	29	26	10848	10916	0.31868279661325233
M1	cpdb	0	network_modules	57	TRUE	1.0989571520290665e-17	79	39	14	0.358974358974359	0.17721518987341772	KEGG:01521	KEGG	EGFR tyrosine kinase inhibitor resistance	8484	195		0.03125	0.041237113402061855	79	8405	14	25	65	8380	8484	0.24740020514894398
M1	cpdb	0	network_modules	57	TRUE	1.1820082786637473e-17	30	42	11	0.2619047619047619	0.36666666666666664	REAC:R-HSA-9680350	REAC	Signaling by CSF1 (M-CSF) in myeloid cells	10916	2226		0.061224489795918366	0.0707070707070707	30	10886	11	31	19	10855	10916	0.3076527671548876
M1	cpdb	0	network_modules	57	TRUE	2.567302248810478e-17	65	42	13	0.30952380952380953	0.2	REAC:R-HSA-2219530	REAC	Constitutive Signaling by Aberrant PI3K in Cancer	10916	401		0.07142857142857142	0.08080808080808081	65	10851	13	29	52	10822	10916	0.2452221646499228
M1	cpdb	0	network_modules	57	TRUE	6.874462910998371e-17	235	46	17	0.3695652173913043	0.07234042553191489	GO:0043491	GO:BP	phosphatidylinositol 3-kinase/protein kinase B signal transduction	16175	10736		0.02564102564102564	0.0379746835443038	235	15940	17	29	218	15911	16175	0.15845813848544832
M1	cpdb	0	network_modules	57	TRUE	1.388995307474181e-16	70	39	13	0.3333333333333333	0.18571428571428572	KEGG:05230	KEGG	Central carbon metabolism in cancer	8484	478		0.041666666666666664	0.05154639175257732	70	8414	13	26	57	8388	8484	0.24421732196519408
M1	cpdb	0	network_modules	57	TRUE	1.992247210047072e-16	54	42	12	0.2857142857142857	0.2222222222222222	REAC:R-HSA-186797	REAC	Signaling by PDGF	10916	2291		0.08163265306122448	0.09090909090909091	54	10862	12	30	42	10832	10916	0.24870724572738315
M1	cpdb	0	network_modules	57	TRUE	3.9440048738943574e-16	26	42	10	0.23809523809523808	0.38461538461538464	REAC:R-HSA-912526	REAC	Interleukin receptor SHC signaling	10916	1230		0.09183673469387756	0.10101010101010101	26	10890	10	32	16	10858	10916	0.3005226368085264
M1	cpdb	0	network_modules	57	TRUE	1.5998429397802037e-15	44	42	11	0.2619047619047619	0.25	REAC:R-HSA-451927	REAC	Interleukin-2 family signaling	10916	1240		0.10204081632653061	0.1111111111111111	44	10872	11	31	33	10841	10916	0.25294143219961285
M1	cpdb	0	network_modules	57	TRUE	2.411858767588629e-15	418	42	20	0.47619047619047616	0.04784688995215311	REAC:R-HSA-5663202	REAC	Diseases of signal transduction by growth factor receptors and second messengers	10916	773		0.11224489795918367	0.12121212121212122	418	10498	20	22	398	10476	10916	0.14181595872667532
M1	cpdb	0	network_modules	57	TRUE	3.2642814770218746e-15	92	42	13	0.30952380952380953	0.14130434782608695	REAC:R-HSA-6811558	REAC	PI5P, PP2A and IER3 Regulate PI3K/AKT Signaling	10916	1677		0.12244897959183673	0.1414141414141414	92	10824	13	29	79	10795	10916	0.20469650145524731
M1	cpdb	0	network_modules	57	TRUE	3.2642814770218746e-15	92	42	13	0.30952380952380953	0.14130434782608695	REAC:R-HSA-2219528	REAC	PI3K/AKT Signaling in Cancer	10916	1674		0.12244897959183673	0.1414141414141414	92	10824	13	29	79	10795	10916	0.20469650145524731
M1	cpdb	0	network_modules	57	TRUE	8.887912898236163e-15	99	42	13	0.30952380952380953	0.13131313131313133	REAC:R-HSA-199418	REAC	Negative regulation of the PI3K/AKT network	10916	1580		0.14285714285714285	0.15151515151515152	99	10817	13	29	86	10788	10916	0.19697054467059544
M1	cpdb	0	network_modules	57	TRUE	1.0915180142330668e-14	202	39	16	0.41025641025641024	0.07920792079207921	KEGG:04510	KEGG	Focal adhesion	8484	313		0.052083333333333336	0.061855670103092786	202	8282	16	23	186	8259	8484	0.17225809941893958
M1	cpdb	0	network_modules	57	TRUE	1.8375513878207013e-14	36	42	10	0.23809523809523808	0.2777777777777778	REAC:R-HSA-9607240	REAC	FLT3 Signaling	10916	917		0.15306122448979592	0.16161616161616163	36	10880	10	32	26	10848	10916	0.25451943931404836
M1	cpdb	0	network_modules	57	TRUE	3.2780877163807447e-14	77	39	12	0.3076923076923077	0.15584415584415584	KEGG:05100	KEGG	Bacterial invasion of epithelial cells	8484	423		0.0625	0.07216494845360824	77	8407	12	27	65	8380	8484	0.21398380499073663
M1	cpdb	0	network_modules	57	TRUE	3.557837687995361e-14	137	39	14	0.358974358974359	0.10218978102189781	KEGG:04910	KEGG	Insulin signaling pathway	8484	367		0.07291666666666667	0.08247422680412371	137	8347	14	25	123	8322	8484	0.18483397240818064
M1	cpdb	0	network_modules	57	TRUE	1.0343428238277718e-13	16	42	8	0.19047619047619047	0.5	REAC:R-HSA-210993	REAC	Tie2 Signaling	10916	2509		0.16326530612244897	0.1717171717171717	16	10900	8	34	8	10866	10916	0.3070478696378384
M1	cpdb	0	network_modules	57	TRUE	1.7732183537663234e-13	118	39	13	0.3333333333333333	0.11016949152542373	KEGG:04722	KEGG	Neurotrophin signaling pathway	8484	352		0.08333333333333333	0.09278350515463918	118	8366	13	26	105	8340	8484	0.18535394493298052
M1	cpdb	0	network_modules	57	TRUE	4.2163441942082386e-13	68	39	11	0.28205128205128205	0.16176470588235295	KEGG:05211	KEGG	Renal cell carcinoma	8484	462		0.09375	0.10309278350515463	68	8416	11	28	57	8388	8484	0.20884964676932402
M1	cpdb	0	network_modules	57	TRUE	4.689927231217443e-13	310	39	17	0.4358974358974359	0.054838709677419356	KEGG:05206	KEGG	MicroRNAs in cancer	8484	458		0.10416666666666667	0.1134020618556701	310	8174	17	22	293	8152	8484	0.14464300476199307
M1	cpdb	0	network_modules	57	TRUE	5.770395409083164e-13	210	39	15	0.38461538461538464	0.07142857142857142	KEGG:04015	KEGG	Rap1 signaling pathway	8484	248		0.11458333333333333	0.12371134020618557	210	8274	15	24	195	8250	8484	0.15739930758143095
M1	cpdb	0	network_modules	57	TRUE	1.3186966994510535e-12	75	39	11	0.28205128205128205	0.14666666666666667	KEGG:05214	KEGG	Glioma	8484	465		0.125	0.13402061855670103	75	8409	11	28	64	8381	8484	0.198348393772885
M1	cpdb	0	network_modules	57	TRUE	3.2627424689245354e-12	147	39	13	0.3333333333333333	0.08843537414965986	KEGG:04072	KEGG	Phospholipase D signaling pathway	8484	261		0.13541666666666666	0.14432989690721648	147	8337	13	26	134	8311	8484	0.16457570433533242
M1	cpdb	0	network_modules	57	TRUE	3.864748128290935e-12	23	42	8	0.19047619047619047	0.34782608695652173	REAC:R-HSA-9006335	REAC	Signaling by Erythropoietin	10916	2238		0.17346938775510204	0.18181818181818182	23	10893	8	34	15	10859	10916	0.25530875744178894
M1	cpdb	0	network_modules	57	TRUE	4.649304550488088e-12	356	39	17	0.4358974358974359	0.047752808988764044	KEGG:04151	KEGG	PI3K-Akt signaling pathway	8484	285		0.14583333333333334	0.15463917525773196	356	8128	17	22	339	8106	8484	0.13351869150913356
M1	cpdb	0	network_modules	57	TRUE	9.528915043633495e-12	472	42	18	0.42857142857142855	0.038135593220338986	REAC:R-HSA-449147	REAC	Signaling by Interleukins	10916	2261		0.1836734693877551	0.1919191919191919	472	10444	18	24	454	10420	10916	0.11774007795471067
M1	cpdb	0	network_modules	57	TRUE	1.983736836260755e-11	67	39	10	0.2564102564102564	0.14925373134328357	KEGG:05221	KEGG	Acute myeloid leukemia	8484	472		0.15625	0.16494845360824742	67	8417	10	29	57	8388	8484	0.19079467527463484
M1	cpdb	0	network_modules	57	TRUE	2.0573189003166937e-11	45	42	9	0.21428571428571427	0.2	REAC:R-HSA-74751	REAC	Insulin receptor signalling cascade	10916	1211		0.19387755102040816	0.20202020202020202	45	10871	9	33	36	10838	10916	0.20384939844456115
M1	cpdb	0	network_modules	57	TRUE	2.226736433542568e-11	96	39	11	0.28205128205128205	0.11458333333333333	KEGG:04666	KEGG	Fc gamma R-mediated phagocytosis	8484	341		0.16666666666666666	0.17525773195876287	96	8388	11	28	85	8360	8484	0.17394586138123722
M1	cpdb	0	network_modules	57	TRUE	2.5038867317773294e-11	97	39	11	0.28205128205128205	0.1134020618556701	KEGG:05215	KEGG	Prostate cancer	8484	466		0.17708333333333334	0.18556701030927836	97	8387	11	28	86	8359	8484	0.17298188334724515
M1	cpdb	0	network_modules	57	TRUE	3.1436178892385355e-11	70	39	10	0.2564102564102564	0.14285714285714285	KEGG:04917	KEGG	Prolactin signaling pathway	8484	374		0.1875	0.1958762886597938	70	8414	10	29	60	8385	8484	0.186429076314703
M1	cpdb	0	network_modules	57	TRUE	4.222592003038888e-11	72	39	10	0.2564102564102564	0.1388888888888889	KEGG:05218	KEGG	Melanoma	8484	469		0.19791666666666666	0.20618556701030927	72	8412	10	29	62	8383	8484	0.18366875807542749
M1	cpdb	0	network_modules	57	TRUE	4.842925750935256e-11	17	42	7	0.16666666666666666	0.4117647058823529	REAC:R-HSA-9669938	REAC	Signaling by KIT in disease	10916	2262		0.20408163265306123	0.2222222222222222	17	10899	7	35	10	10864	10916	0.26022397630561517
M1	cpdb	0	network_modules	57	TRUE	4.842925750935256e-11	17	42	7	0.16666666666666666	0.4117647058823529	REAC:R-HSA-9670439	REAC	Signaling by phosphorylated juxtamembrane, extracellular and kinase domain KIT mutants	10916	2326		0.20408163265306123	0.2222222222222222	17	10899	7	35	10	10864	10916	0.26022397630561517
M1	cpdb	0	network_modules	57	TRUE	9.708923738273839e-11	147	39	12	0.3076923076923077	0.08163265306122448	KEGG:05224	KEGG	Breast cancer	8484	475		0.20833333333333334	0.21649484536082475	147	8337	12	27	135	8310	8484	0.15122190145293146
M1	cpdb	0	network_modules	57	TRUE	1.0534123421543062e-10	148	39	12	0.3076923076923077	0.08108108108108109	KEGG:05226	KEGG	Gastric cancer	8484	477		0.21875	0.2268041237113402	148	8336	12	27	136	8309	8484	0.15065800831436502
M1	cpdb	0	network_modules	57	TRUE	1.1668644973063548e-10	301	39	15	0.38461538461538464	0.04983388704318937	KEGG:04010	KEGG	MAPK signaling pathway	8484	243		0.22916666666666666	0.23711340206185566	301	8183	15	24	286	8159	8484	0.1282594241826911
M1	cpdb	0	network_modules	57	TRUE	1.6116292797501444e-10	10	42	6	0.14285714285714285	0.6	REAC:R-HSA-9673770	REAC	Signaling by PDGFRA extracellular domain mutants	10916	2293		0.22448979591836735	0.24242424242424243	10	10906	6	36	4	10870	10916	0.2915874274244285
M1	cpdb	0	network_modules	57	TRUE	1.6116292797501444e-10	10	42	6	0.14285714285714285	0.6	REAC:R-HSA-9673767	REAC	Signaling by PDGFRA transmembrane, juxtamembrane and kinase domain mutants	10916	2294		0.22448979591836735	0.24242424242424243	10	10906	6	36	4	10870	10916	0.2915874274244285
M1	cpdb	0	network_modules	57	TRUE	2.4366612369269336e-10	205	39	13	0.3333333333333333	0.06341463414634146	KEGG:05205	KEGG	Proteoglycans in cancer	8484	457		0.23958333333333334	0.24742268041237114	205	8279	13	26	192	8253	8484	0.136824823102396
M1	cpdb	0	network_modules	57	TRUE	2.723202208676042e-10	120	39	11	0.28205128205128205	0.09166666666666666	KEGG:04935	KEGG	Growth hormone synthesis, secretion and action	8484	392		0.25	0.25773195876288657	120	8364	11	28	109	8336	8484	0.1541769959733023
M1	cpdb	0	network_modules	57	TRUE	7.403972362357e-10	95	39	10	0.2564102564102564	0.10526315789473684	KEGG:01522	KEGG	Endocrine resistance	8484	196		0.2604166666666667	0.26804123711340205	95	8389	10	29	85	8360	8484	0.15836500184928912
M1	cpdb	0	network_modules	57	TRUE	9.880560754951824e-10	214	46	12	0.2608695652173913	0.056074766355140186	GO:0018108	GO:BP	peptidyl-tyrosine phosphorylation	16175	5327		0.038461538461538464	0.05063291139240506	214	15961	12	34	202	15927	16175	0.11574495398090504
M1	cpdb	0	network_modules	57	TRUE	1.044412529621754e-9	215	46	12	0.2608695652173913	0.05581395348837209	GO:0018212	GO:BP	peptidyl-tyrosine modification	16175	5371		0.05128205128205128	0.06329113924050633	215	15960	12	34	203	15926	16175	0.11545025388164366
M1	cpdb	0	network_modules	57	TRUE	1.8787142654521906e-9	72	39	9	0.23076923076923078	0.125	KEGG:05223	KEGG	Non-small cell lung cancer	8484	474		0.2708333333333333	0.27835051546391754	72	8412	9	30	63	8382	8484	0.16467317411414498
M1	cpdb	0	network_modules	57	TRUE	1.974978660719825e-9	50	46	8	0.17391304347826086	0.16	GO:0046854	GO:BP	phosphatidylinositol phosphate biosynthetic process	16175	12405		0.0641025641025641	0.0759493670886076	50	16125	8	38	42	16087	16175	0.16433423594254565
M1	cpdb	0	network_modules	57	TRUE	1.9959391523994096e-9	253	42	13	0.30952380952380953	0.05138339920948617	REAC:R-HSA-1257604	REAC	PIP3 activates AKT signaling	10916	1679		0.24489795918367346	0.25252525252525254	253	10663	13	29	240	10634	10916	0.1182730808095389
M1	cpdb	0	network_modules	57	TRUE	2.0647887466423795e-9	190	39	12	0.3076923076923077	0.06315789473684211	KEGG:04062	KEGG	Chemokine signaling pathway	8484	255		0.28125	0.28865979381443296	190	8294	12	27	178	8267	8484	0.13103033355890187
M1	cpdb	0	network_modules	57	TRUE	2.087746434643777e-9	73	42	9	0.21428571428571427	0.1232876712328767	REAC:R-HSA-74752	REAC	Signaling by Insulin receptor	10916	2260		0.25510204081632654	0.26262626262626265	73	10843	9	33	64	10810	10916	0.15830006971957417
M1	cpdb	0	network_modules	57	TRUE	3.0386927908425734e-9	76	42	9	0.21428571428571427	0.11842105263157894	REAC:R-HSA-6806834	REAC	Signaling by MET	10916	2270		0.2653061224489796	0.2727272727272727	76	10840	9	33	67	10807	10916	0.154960322859663
M1	cpdb	0	network_modules	57	TRUE	3.4211388366840458e-9	264	42	13	0.30952380952380953	0.04924242424242424	REAC:R-HSA-5673001	REAC	RAF/MAP kinase cascade	10916	1841		0.2755102040816326	0.2828282828282828	264	10652	13	29	251	10623	10916	0.11543494303034428
M1	cpdb	0	network_modules	57	TRUE	4.336025851663255e-9	269	42	13	0.30952380952380953	0.048327137546468404	REAC:R-HSA-5684996	REAC	MAPK1/MAPK3 signaling	10916	1351		0.2857142857142857	0.29292929292929293	269	10647	13	29	256	10618	10916	0.11420032842584885
M1	cpdb	0	network_modules	57	TRUE	5.4724747930985055e-9	52	42	8	0.19047619047619047	0.15384615384615385	REAC:R-HSA-1660499	REAC	Synthesis of PIPs at the plasma membrane	10916	2395		0.29591836734693877	0.30303030303030304	52	10864	8	34	44	10830	10916	0.16762476782555671
M1	cpdb	0	network_modules	57	TRUE	5.59479281906144e-9	81	39	9	0.23076923076923078	0.1111111111111111	KEGG:04662	KEGG	B cell receptor signaling pathway	8484	339		0.2916666666666667	0.29896907216494845	81	8403	9	30	72	8373	8484	0.1545971416804698
M1	cpdb	0	network_modules	57	TRUE	7.110428912900894e-9	136	46	10	0.21739130434782608	0.07352941176470588	GO:0046488	GO:BP	phosphatidylinositol metabolic process	16175	12192		0.07692307692307693	0.08860759493670886	136	16039	10	36	126	16003	16175	0.12222861790444717
M1	cpdb	0	network_modules	57	TRUE	9.595431418613922e-9	166	39	11	0.28205128205128205	0.06626506024096386	KEGG:05225	KEGG	Hepatocellular carcinoma	8484	476		0.3020833333333333	0.30927835051546393	166	8318	11	28	155	8290	8484	0.12878764158451275
M1	cpdb	0	network_modules	57	TRUE	1.202141861850687e-8	58	39	8	0.20512820512820512	0.13793103448275862	KEGG:05213	KEGG	Endometrial cancer	8484	464		0.3125	0.31958762886597936	58	8426	8	31	50	8395	8484	0.1635359292716562
M1	cpdb	0	network_modules	57	TRUE	1.2704010237893782e-8	293	42	13	0.30952380952380953	0.04436860068259386	REAC:R-HSA-9006925	REAC	Intracellular signaling by second messengers	10916	1266		0.30612244897959184	0.31313131313131315	293	10623	13	29	280	10594	10916	0.10870136385026173
M1	cpdb	0	network_modules	57	TRUE	1.392756839636302e-8	18	42	6	0.14285714285714285	0.3333333333333333	REAC:R-HSA-9671555	REAC	Signaling by PDGFR in disease	10916	2292		0.3163265306122449	0.32323232323232326	18	10898	6	36	12	10862	10916	0.216293630921623
M1	cpdb	0	network_modules	57	TRUE	1.586226942646964e-8	530	46	15	0.32608695652173914	0.02830188679245283	GO:0043408	GO:BP	regulation of MAPK cascade	16175	10676		0.08974358974358974	0.10126582278481013	530	15645	15	31	515	15614	16175	0.0879905328012067
M1	cpdb	0	network_modules	57	TRUE	1.619241903244758e-8	129	39	10	0.2564102564102564	0.07751937984496124	KEGG:04926	KEGG	Relaxin signaling pathway	8484	383		0.3229166666666667	0.32989690721649484	129	8355	10	29	119	8326	8484	0.13395275693952374
M1	cpdb	0	network_modules	57	TRUE	1.6576046744647632e-8	227	39	12	0.3076923076923077	0.05286343612334802	KEGG:04810	KEGG	Regulation of actin cytoskeleton	8484	365		0.3333333333333333	0.3402061855670103	227	8257	12	27	215	8230	8484	0.11830866501472899
M1	cpdb	0	network_modules	57	TRUE	1.827843467153708e-8	274	46	12	0.2608695652173913	0.043795620437956206	GO:0032956	GO:BP	regulation of actin cytoskeleton organization	16175	7940		0.10256410256410256	0.11392405063291139	274	15901	12	34	262	15867	16175	0.10094781451133816
M1	cpdb	0	network_modules	57	TRUE	2.372264039649902e-8	308	42	13	0.30952380952380953	0.04220779220779221	REAC:R-HSA-5683057	REAC	MAPK family signaling cascades	10916	1348		0.32653061224489793	0.3333333333333333	308	10608	13	29	295	10579	10916	0.10558057218317478
M1	cpdb	0	network_modules	57	TRUE	3.1955314225843877e-8	98	39	9	0.23076923076923078	0.09183673469387756	KEGG:05231	KEGG	Choline metabolism in cancer	8484	479		0.34375	0.35051546391752575	98	8386	9	30	89	8356	8484	0.13941805851577949
M1	cpdb	0	network_modules	57	TRUE	3.600272695145152e-8	39	42	7	0.16666666666666666	0.1794871794871795	REAC:R-HSA-112399	REAC	IRS-mediated signalling	10916	1164		0.336734693877551	0.3434343434343434	39	10877	7	35	32	10842	10916	0.16988085430925592
M1	cpdb	0	network_modules	57	TRUE	3.972025668787002e-8	67	39	8	0.20512820512820512	0.11940298507462686	KEGG:04664	KEGG	Fc epsilon RI signaling pathway	8484	340		0.3541666666666667	0.36082474226804123	67	8417	8	31	59	8386	8484	0.15142313003937144
M1	cpdb	0	network_modules	57	TRUE	5.769976478739601e-8	116	46	9	0.1956521739130435	0.07758620689655173	GO:0006661	GO:BP	phosphatidylinositol biosynthetic process	16175	2370		0.11538461538461539	0.12658227848101267	116	16059	9	37	107	16022	16175	0.11928832098570652
M1	cpdb	0	network_modules	57	TRUE	7.150505702319278e-8	308	46	12	0.2608695652173913	0.03896103896103896	GO:0032970	GO:BP	regulation of actin filament-based process	16175	7953		0.1282051282051282	0.13924050632911392	308	15867	12	34	296	15833	16175	0.09449373194199666
M1	cpdb	0	network_modules	57	TRUE	7.458370879888148e-8	43	42	7	0.16666666666666666	0.16279069767441862	REAC:R-HSA-2428928	REAC	IRS-related events triggered by IGF1R	10916	1165		0.3469387755102041	0.36363636363636365	43	10873	7	35	36	10838	10916	0.1614527789577624
M1	cpdb	0	network_modules	57	TRUE	7.458370879888148e-8	43	42	7	0.16666666666666666	0.16279069767441862	REAC:R-HSA-2428924	REAC	IGF1R signaling cascade	10916	1142		0.3469387755102041	0.36363636363636365	43	10873	7	35	36	10838	10916	0.1614527789577624
M1	cpdb	0	network_modules	57	TRUE	8.152414438846146e-8	595	46	15	0.32608695652173914	0.025210084033613446	GO:0000165	GO:BP	MAPK cascade	16175	55		0.14102564102564102	0.1518987341772152	595	15580	15	31	580	15549	16175	0.08207830926752085
M1	cpdb	0	network_modules	57	TRUE	8.844482261786183e-8	44	42	7	0.16666666666666666	0.1590909090909091	REAC:R-HSA-2404192	REAC	Signaling by Type 1 Insulin-like Growth Factor 1 Receptor (IGF1R)	10916	2312		0.3673469387755102	0.37373737373737376	44	10872	7	35	37	10837	10916	0.15952502749375724
M1	cpdb	0	network_modules	57	TRUE	1.0618806967630924e-7	112	42	9	0.21428571428571427	0.08035714285714286	REAC:R-HSA-187037	REAC	Signaling by NTRK1 (TRKA)	10916	2284		0.37755102040816324	0.3838383838383838	112	10804	9	33	103	10771	10916	0.12582784449516202
M1	cpdb	0	network_modules	57	TRUE	1.1149987102521734e-7	76	39	8	0.20512820512820512	0.10526315789473684	KEGG:05212	KEGG	Pancreatic cancer	8484	463		0.3645833333333333	0.3711340206185567	76	8408	8	31	68	8377	8484	0.1414858308217744
M1	cpdb	0	network_modules	57	TRUE	1.1665717644596813e-7	180	46	10	0.21739130434782608	0.05555555555555555	GO:0046777	GO:BP	protein autophosphorylation	16175	12365		0.15384615384615385	0.16455696202531644	180	15995	10	36	170	15959	16175	0.10500560501323412
M1	cpdb	0	network_modules	57	TRUE	1.2284271333674578e-7	46	42	7	0.16666666666666666	0.15217391304347827	REAC:R-HSA-1227986	REAC	Signaling by ERBB2	10916	2232		0.3877551020408163	0.3939393939393939	46	10870	7	35	39	10835	10916	0.1558571284962382
M1	cpdb	0	network_modules	57	TRUE	1.533579214227994e-7	162	39	10	0.2564102564102564	0.06172839506172839	KEGG:04630	KEGG	JAK-STAT signaling pathway	8484	332		0.375	0.38144329896907214	162	8322	10	29	152	8293	8484	0.11783867737572741
M1	cpdb	0	network_modules	57	TRUE	2.1648898525143535e-7	27	42	6	0.14285714285714285	0.2222222222222222	REAC:R-HSA-9682385	REAC	FLT3 signaling in disease	10916	920		0.3979591836734694	0.40404040404040403	27	10889	6	36	21	10853	10916	0.17564441317629792
M1	cpdb	0	network_modules	57	TRUE	2.6312983739424115e-7	83	42	8	0.19047619047619047	0.0963855421686747	REAC:R-HSA-1483255	REAC	PI Metabolism	10916	1665		0.40816326530612246	0.41414141414141414	83	10833	8	34	75	10799	10916	0.13083649532462469
M1	cpdb	0	network_modules	57	TRUE	2.650274209239497e-7	124	39	9	0.23076923076923078	0.07258064516129033	KEGG:04650	KEGG	Natural killer cell mediated cytotoxicity	8484	334		0.3854166666666667	0.3917525773195876	124	8360	9	30	115	8330	8484	0.12239999329537392
M1	cpdb	0	network_modules	57	TRUE	2.8798886741267016e-7	13	42	5	0.11904761904761904	0.38461538461538464	REAC:R-HSA-5637812	REAC	Signaling by EGFRvIII in Cancer	10916	2231		0.41836734693877553	0.4444444444444444	13	10903	5	37	8	10866	10916	0.21237487033531866
M1	cpdb	0	network_modules	57	TRUE	2.8798886741267016e-7	13	42	5	0.11904761904761904	0.38461538461538464	REAC:R-HSA-5637810	REAC	Constitutive Signaling by EGFRvIII	10916	402		0.41836734693877553	0.4444444444444444	13	10903	5	37	8	10866	10916	0.21237487033531866
M1	cpdb	0	network_modules	57	TRUE	2.8798886741267016e-7	13	42	5	0.11904761904761904	0.38461538461538464	REAC:R-HSA-1433559	REAC	Regulation of KIT signaling	10916	1982		0.41836734693877553	0.4444444444444444	13	10903	5	37	8	10866	10916	0.21237487033531866
M1	cpdb	0	network_modules	57	TRUE	3.0366127173994295e-7	86	39	8	0.20512820512820512	0.09302325581395349	KEGG:05210	KEGG	Colorectal cancer	8484	461		0.3958333333333333	0.4020618556701031	86	8398	8	31	78	8367	8484	0.13228530559958654
M1	cpdb	0	network_modules	57	TRUE	3.9660025301220755e-7	450	46	13	0.2826086956521739	0.028888888888888888	GO:0030335	GO:BP	positive regulation of cell migration	16175	6781		0.16666666666666666	0.17721518987341772	450	15725	13	33	437	15692	16175	0.08273644264108128
M1	cpdb	0	network_modules	57	TRUE	4.003370464674879e-7	204	46	10	0.21739130434782608	0.049019607843137254	GO:0051896	GO:BP	regulation of phosphatidylinositol 3-kinase/protein kinase B signal transduction	16175	13980		0.1794871794871795	0.189873417721519	204	15971	10	36	194	15935	16175	0.09799959727865949
M1	cpdb	0	network_modules	57	TRUE	4.336763798582362e-7	131	42	9	0.21428571428571427	0.06870229007633588	REAC:R-HSA-166520	REAC	Signaling by NTRKs	10916	2287		0.4489795918367347	0.45454545454545453	131	10785	9	33	122	10752	10916	0.11545464898284707
M1	cpdb	0	network_modules	57	TRUE	4.46716758072024e-7	14	42	5	0.11904761904761904	0.35714285714285715	REAC:R-HSA-9665348	REAC	Signaling by ERBB2 ECD mutants	10916	2233		0.45918367346938777	0.46464646464646464	14	10902	5	37	9	10865	10916	0.20449985241407267
M1	cpdb	0	network_modules	57	TRUE	4.6182227469568e-7	132	39	9	0.23076923076923078	0.06818181818181818	KEGG:04380	KEGG	Osteoclast differentiation	8484	309		0.40625	0.41237113402061853	132	8352	9	30	123	8322	8484	0.11817196281170685
M1	cpdb	0	network_modules	57	TRUE	5.85108123450552e-7	150	46	9	0.1956521739130435	0.06	GO:0051897	GO:BP	positive regulation of phosphatidylinositol 3-kinase/protein kinase B signal transduction	16175	13981		0.19230769230769232	0.20253164556962025	150	16025	9	37	141	15988	16175	0.10384148474651139
M1	cpdb	0	network_modules	57	TRUE	5.96017799881328e-7	686	46	15	0.32608695652173914	0.021865889212827987	GO:0008284	GO:BP	positive regulation of cell population proliferation	16175	3151		0.20512820512820512	0.21518987341772153	686	15489	15	31	671	15458	16175	0.07517407069136427
M1	cpdb	0	network_modules	57	TRUE	6.014555489141556e-7	136	39	9	0.23076923076923078	0.0661764705882353	KEGG:04915	KEGG	Estrogen signaling pathway	8484	372		0.4166666666666667	0.422680412371134	136	8348	9	30	127	8318	8484	0.11619394639702119
M1	cpdb	0	network_modules	57	TRUE	6.534259425107025e-7	32	42	6	0.14285714285714285	0.1875	REAC:R-HSA-5655302	REAC	Signaling by FGFR1 in disease	10916	2243		0.46938775510204084	0.47474747474747475	32	10884	6	36	26	10848	10916	0.16085021110577755
M1	cpdb	0	network_modules	57	TRUE	6.681816218419147e-7	15	42	5	0.11904761904761904	0.3333333333333333	REAC:R-HSA-9703648	REAC	Signaling by FLT3 ITD and TKD mutants	10916	2254		0.47959183673469385	0.48484848484848486	15	10901	5	37	10	10864	10916	0.19742099669096336
M1	cpdb	0	network_modules	57	TRUE	6.765278123212474e-7	470	46	13	0.2826086956521739	0.027659574468085105	GO:2000147	GO:BP	positive regulation of cell motility	16175	25495		0.21794871794871795	0.22784810126582278	470	15705	13	33	457	15672	16175	0.08061535742144083
M1	cpdb	0	network_modules	57	TRUE	7.127485191953739e-7	376	46	12	0.2608695652173913	0.031914893617021274	GO:0043410	GO:BP	positive regulation of MAPK cascade	16175	10678		0.23076923076923078	0.24050632911392406	376	15799	12	34	364	15765	16175	0.08421718628021499
M1	cpdb	0	network_modules	57	TRUE	7.978262674769699e-7	97	39	8	0.20512820512820512	0.08247422680412371	KEGG:04070	KEGG	Phosphatidylinositol signaling system	8484	259		0.4270833333333333	0.4329896907216495	97	8387	8	31	89	8356	8484	0.12381183951309004
M1	cpdb	0	network_modules	57	TRUE	8.534355371678672e-7	479	46	13	0.2826086956521739	0.027139874739039668	GO:0040017	GO:BP	positive regulation of locomotion	16175	9905		0.24358974358974358	0.25316455696202533	479	15696	13	33	466	15663	16175	0.07970202078955922
M1	cpdb	0	network_modules	57	TRUE	1.050793866317389e-6	389	46	12	0.2608695652173913	0.030848329048843187	GO:0007264	GO:BP	small GTPase-mediated signal transduction	16175	2792		0.2564102564102564	0.26582278481012656	389	15786	12	34	377	15752	16175	0.08255192517820605
M1	cpdb	0	network_modules	57	TRUE	1.0530310695151697e-6	37	39	6	0.15384615384615385	0.16216216216216217	KEGG:04960	KEGG	Aldosterone-regulated sodium reabsorption	8484	396		0.4375	0.44329896907216493	37	8447	6	33	31	8414	8484	0.15416246754073212
M1	cpdb	0	network_modules	57	TRUE	1.3690886034276724e-6	17	42	5	0.11904761904761904	0.29411764705882354	REAC:R-HSA-5637815	REAC	Signaling by Ligand-Responsive EGFR Variants in Cancer	10916	2267		0.4897959183673469	0.5050505050505051	17	10899	5	37	12	10862	10916	0.18517298617768324
M1	cpdb	0	network_modules	57	TRUE	1.3690886034276724e-6	17	42	5	0.11904761904761904	0.29411764705882354	REAC:R-HSA-1236382	REAC	Constitutive Signaling by Ligand-Responsive EGFR Cancer Variants	10916	403		0.4897959183673469	0.5050505050505051	17	10899	5	37	12	10862	10916	0.18517298617768324
M1	cpdb	0	network_modules	57	TRUE	1.3886591665561824e-6	36	42	6	0.14285714285714285	0.16666666666666666	REAC:R-HSA-109704	REAC	PI3K Cascade	10916	1671		0.5102040816326531	0.5151515151515151	36	10880	6	36	30	10844	10916	0.15128169408693212
M1	cpdb	0	network_modules	57	TRUE	2.322623224998383e-6	72	39	7	0.1794871794871795	0.09722222222222222	KEGG:01524	KEGG	Platinum drug resistance	8484	198		0.4479166666666667	0.4536082474226804	72	8412	7	32	65	8380	8484	0.12668200619157996
M1	cpdb	0	network_modules	57	TRUE	3.0675745814150983e-6	221	39	10	0.2564102564102564	0.04524886877828054	KEGG:05208	KEGG	Chemical carcinogenesis - reactive oxygen species	8484	460		0.4583333333333333	0.4639175257731959	221	8263	10	29	211	8234	8484	0.0982827950041948
M1	cpdb	0	network_modules	57	TRUE	3.3418288082321165e-6	223	39	10	0.2564102564102564	0.04484304932735426	KEGG:05163	KEGG	Human cytomegalovirus infection	8484	444		0.46875	0.4742268041237113	223	8261	10	29	213	8232	8484	0.09775277855226185
M1	cpdb	0	network_modules	57	TRUE	4.116929068161887e-6	46	39	6	0.15384615384615385	0.13043478260869565	KEGG:04930	KEGG	Type II diabetes mellitus	8484	387		0.4791666666666667	0.4845360824742268	46	8438	6	33	40	8405	8484	0.1373533092411159
M1	cpdb	0	network_modules	57	TRUE	4.2502411286172555e-6	440	46	12	0.2608695652173913	0.02727272727272727	GO:0051493	GO:BP	regulation of cytoskeleton organization	16175	13748		0.2692307692307692	0.27848101265822783	440	15735	12	34	428	15701	16175	0.07671094390206294
M1	cpdb	0	network_modules	57	TRUE	4.4515215704167484e-6	21	42	5	0.11904761904761904	0.23809523809523808	REAC:R-HSA-9664565	REAC	Signaling by ERBB2 KD Mutants	10916	2234		0.5204081632653061	0.5252525252525253	21	10895	5	37	16	10858	10916	0.1661175573113065
M1	cpdb	0	network_modules	57	TRUE	4.546913019004741e-6	189	46	9	0.1956521739130435	0.047619047619047616	GO:0046474	GO:BP	glycerophospholipid biosynthetic process	16175	12181		0.28205128205128205	0.2911392405063291	189	15986	9	37	180	15949	16175	0.09142389630845922
M1	cpdb	0	network_modules	57	TRUE	4.703640523724151e-6	47	39	6	0.15384615384615385	0.1276595744680851	KEGG:04973	KEGG	Carbohydrate digestion and absorption	8484	404		0.4895833333333333	0.4948453608247423	47	8437	6	33	41	8404	8484	0.13578438337660714
M1	cpdb	0	network_modules	57	TRUE	5.744513997833728e-6	22	42	5	0.11904761904761904	0.22727272727272727	REAC:R-HSA-1227990	REAC	Signaling by ERBB2 in Cancer	10916	2236		0.5306122448979592	0.5353535353535354	22	10894	5	37	17	10857	10916	0.16217875342439247
M1	cpdb	0	network_modules	57	TRUE	5.884756159984188e-6	269	46	10	0.21739130434782608	0.03717472118959108	GO:0006650	GO:BP	glycerophospholipid metabolic process	16175	2360		0.2948717948717949	0.3037974683544304	269	15906	10	36	259	15870	16175	0.08383812555582797
M1	cpdb	0	network_modules	57	TRUE	7.295913991644831e-6	181	39	9	0.23076923076923078	0.049723756906077346	KEGG:04360	KEGG	Axon guidance	8484	305		0.5	0.5051546391752577	181	8303	9	30	172	8273	8484	0.09849756555846177
M1	cpdb	0	network_modules	57	TRUE	7.31947071844569e-6	23	42	5	0.11904761904761904	0.21739130434782608	REAC:R-HSA-1643713	REAC	Signaling by EGFR in Cancer	10916	2230		0.5408163265306123	0.5454545454545454	23	10893	5	37	18	10856	10916	0.15849706724582655
M1	cpdb	0	network_modules	57	TRUE	8.167006846364548e-6	9	42	4	0.09523809523809523	0.4444444444444444	REAC:R-HSA-198203	REAC	PI3K/AKT activation	10916	1675		0.5510204081632653	0.5555555555555556	9	10907	4	38	5	10869	10916	0.2044345215985216
M1	cpdb	0	network_modules	57	TRUE	8.5422243349644e-6	131	39	8	0.20512820512820512	0.061068702290076333	KEGG:04068	KEGG	FoxO signaling pathway	8484	258		0.5104166666666666	0.5154639175257731	131	8353	8	31	123	8322	8484	0.10454774627077862
M1	cpdb	0	network_modules	57	TRUE	1.095666898627392e-5	287	46	10	0.21739130434782608	0.03484320557491289	GO:0002768	GO:BP	immune response-regulating cell surface receptor signaling pathway	16175	1279		0.3076923076923077	0.31645569620253167	287	15888	10	36	277	15852	16175	0.08076228692395042
M1	cpdb	0	network_modules	57	TRUE	1.143221890563059e-5	136	39	8	0.20512820512820512	0.058823529411764705	KEGG:05135	KEGG	Yersinia infection	8484	432		0.5208333333333334	0.5257731958762887	136	8348	8	31	128	8317	8484	0.10231974945348225
M1	cpdb	0	network_modules	57	TRUE	1.149183692228405e-5	25	42	5	0.11904761904761904	0.2	REAC:R-HSA-2424491	REAC	DAP12 signaling	10916	433		0.5612244897959183	0.5656565656565656	25	10891	5	37	20	10854	10916	0.15180079656370568
M1	cpdb	0	network_modules	57	TRUE	1.1975610042934038e-5	191	42	9	0.21428571428571427	0.04712041884816754	REAC:R-HSA-202733	REAC	Cell surface interactions at the vascular wall	10916	327		0.5714285714285714	0.5757575757575758	191	10725	9	33	182	10692	10916	0.09327769519294349
M1	cpdb	0	network_modules	57	TRUE	1.3573764619062786e-5	10	42	4	0.09523809523809523	0.4	REAC:R-HSA-8875555	REAC	MET activates RAP1 and RAC1	10916	1364		0.5816326530612245	0.5858585858585859	10	10906	4	38	6	10868	10916	0.19376431728351445
M1	cpdb	0	network_modules	57	TRUE	1.4187784259332772e-5	26	42	5	0.11904761904761904	0.19230769230769232	REAC:R-HSA-1839124	REAC	FGFR1 mutant receptor activation	10916	901		0.5918367346938775	0.5959595959595959	26	10890	5	37	21	10853	10916	0.148742965518141
M1	cpdb	0	network_modules	57	TRUE	1.5879844255221815e-5	218	46	9	0.1956521739130435	0.04128440366972477	GO:0008654	GO:BP	phospholipid biosynthetic process	16175	3225		0.32051282051282054	0.3291139240506329	218	15957	9	37	209	15920	16175	0.08437298300715201
M1	cpdb	0	network_modules	57	TRUE	1.699163470039681e-5	140	42	8	0.19047619047619047	0.05714285714285714	REAC:R-HSA-2029480	REAC	Fcgamma receptor (FCGR) dependent phagocytosis	10916	939		0.6020408163265306	0.6060606060606061	140	10776	8	34	132	10742	10916	0.09812243242833608
M1	cpdb	0	network_modules	57	TRUE	1.708951969323381e-5	58	39	6	0.15384615384615385	0.10344827586206896	KEGG:04923	KEGG	Regulation of lipolysis in adipocytes	8484	380		0.53125	0.5360824742268041	58	8426	6	33	52	8393	8484	0.12124241230958543
M1	cpdb	0	network_modules	57	TRUE	1.8628185802858303e-5	502	46	12	0.2608695652173913	0.02390438247011952	GO:0071363	GO:BP	cellular response to growth factor stimulus	16175	16615		0.3333333333333333	0.34177215189873417	502	15673	12	34	490	15639	16175	0.07077923520535116
M1	cpdb	0	network_modules	57	TRUE	1.896060551775708e-5	59	39	6	0.15384615384615385	0.1016949152542373	KEGG:04370	KEGG	VEGF signaling pathway	8484	307		0.5416666666666666	0.5463917525773195	59	8425	6	33	53	8392	8484	0.12012128949471547
M1	cpdb	0	network_modules	57	TRUE	2.0520339345373775e-5	94	42	7	0.16666666666666666	0.07446808510638298	REAC:R-HSA-4420097	REAC	VEGFA-VEGFR2 Pathway	10916	2634		0.6122448979591837	0.6161616161616161	94	10822	7	35	87	10787	10916	0.10631273775659386
M1	cpdb	0	network_modules	57	TRUE	2.1732128554412295e-5	226	46	9	0.1956521739130435	0.03982300884955752	GO:0045017	GO:BP	glycerolipid biosynthetic process	16175	11231		0.34615384615384615	0.35443037974683544	226	15949	9	37	217	15912	16175	0.0826619495988389
M1	cpdb	0	network_modules	57	TRUE	2.1872245114558025e-5	56	42	6	0.14285714285714285	0.10714285714285714	REAC:R-HSA-1226099	REAC	Signaling by FGFR in disease	10916	2240		0.6224489795918368	0.6262626262626263	56	10860	6	36	50	10824	10916	0.11981297559167332
M1	cpdb	0	network_modules	57	TRUE	2.299725663943583e-5	100	39	7	0.1794871794871795	0.07	KEGG:04933	KEGG	AGE-RAGE signaling pathway in diabetic complications	8484	390		0.5520833333333334	0.5567010309278351	100	8384	7	32	93	8352	8484	0.10559450196191161
M1	cpdb	0	network_modules	57	TRUE	2.3209677963785065e-5	61	39	6	0.15384615384615385	0.09836065573770492	KEGG:04213	KEGG	Longevity regulating pathway - multiple species	8484	290		0.5625	0.5670103092783505	61	8423	6	33	55	8390	8484	0.11796009013824382
M1	cpdb	0	network_modules	57	TRUE	2.3545147836186102e-5	406	46	11	0.2391304347826087	0.027093596059113302	GO:0042110	GO:BP	T cell activation	16175	9970		0.358974358974359	0.3670886075949367	406	15769	11	35	395	15734	16175	0.07306829671811398
M1	cpdb	0	network_modules	57	TRUE	2.4216579189386356e-5	632	46	13	0.2826086956521739	0.020569620253164556	GO:0030036	GO:BP	actin cytoskeleton organization	16175	6660		0.3717948717948718	0.379746835443038	632	15543	13	33	619	15510	16175	0.06712074745587293
M1	cpdb	0	network_modules	57	TRUE	2.462781776444539e-5	101	39	7	0.1794871794871795	0.06930693069306931	KEGG:05142	KEGG	Chagas disease	8484	434		0.5729166666666666	0.5773195876288659	101	8383	7	32	94	8351	8484	0.10500286955796809
M1	cpdb	0	network_modules	57	TRUE	2.6974638978214625e-5	519	46	12	0.2608695652173913	0.023121387283236993	GO:0070848	GO:BP	response to growth factor	16175	16340		0.38461538461538464	0.3924050632911392	519	15656	12	34	507	15622	16175	0.06932967623765497
M1	cpdb	0	network_modules	57	TRUE	2.8755719860264515e-5	522	46	12	0.2608695652173913	0.022988505747126436	GO:0042327	GO:BP	positive regulation of phosphorylation	16175	10095		0.3974358974358974	0.4050632911392405	522	15653	12	34	510	15619	16175	0.06908074197660365
M1	cpdb	0	network_modules	57	TRUE	3.102619642292398e-5	64	39	6	0.15384615384615385	0.09375	KEGG:04929	KEGG	GnRH secretion	8484	386		0.5833333333333334	0.5876288659793815	64	8420	6	33	58	8387	8484	0.11490501313268045
M1	cpdb	0	network_modules	57	TRUE	3.1384989633889176e-5	155	39	8	0.20512820512820512	0.05161290322580645	KEGG:04150	KEGG	mTOR signaling pathway	8484	284		0.59375	0.5979381443298969	155	8329	8	31	147	8298	8484	0.09481646580536984
M1	cpdb	0	network_modules	57	TRUE	3.181732434662357e-5	12	42	4	0.09523809523809523	0.3333333333333333	REAC:R-HSA-9027276	REAC	Erythropoietin activates Phosphoinositide-3-kinase (PI3K)	10916	857		0.6326530612244898	0.6464646464646465	12	10904	4	38	8	10866	10916	0.17655441493565222
M1	cpdb	0	network_modules	57	TRUE	3.181732434662357e-5	12	42	4	0.09523809523809523	0.3333333333333333	REAC:R-HSA-9027284	REAC	Erythropoietin activates RAS	10916	859		0.6326530612244898	0.6464646464646465	12	10904	4	38	8	10866	10916	0.17655441493565222
M1	cpdb	0	network_modules	57	TRUE	3.377516155836375e-5	781	46	14	0.30434782608695654	0.01792573623559539	GO:0030334	GO:BP	regulation of cell migration	16175	6780		0.41025641025641024	0.4177215189873418	781	15394	14	32	767	15362	16175	0.0637919379647685
M1	cpdb	0	network_modules	57	TRUE	3.6132467098737936e-5	31	42	5	0.11904761904761904	0.16129032258064516	REAC:R-HSA-187687	REAC	Signalling to ERKs	10916	2331		0.6530612244897959	0.6666666666666666	31	10885	5	37	26	10848	10916	0.13571677790521885
M1	cpdb	0	network_modules	57	TRUE	3.6132467098737936e-5	31	42	5	0.11904761904761904	0.16129032258064516	REAC:R-HSA-389356	REAC	Co-stimulation by CD28	10916	378		0.6530612244897959	0.6666666666666666	31	10885	5	37	26	10848	10916	0.13571677790521885
M1	cpdb	0	network_modules	57	TRUE	3.9064608853991005e-5	328	46	10	0.21739130434782608	0.03048780487804878	GO:0006644	GO:BP	phospholipid metabolic process	16175	2355		0.4230769230769231	0.43037974683544306	328	15847	10	36	318	15811	16175	0.07468347467838102
M1	cpdb	0	network_modules	57	TRUE	4.1403196688282926e-5	104	42	7	0.16666666666666666	0.0673076923076923	REAC:R-HSA-194138	REAC	Signaling by VEGF	10916	2313		0.673469387755102	0.6767676767676768	104	10812	7	35	97	10777	10916	0.10053304105419562
M1	cpdb	0	network_modules	57	TRUE	4.154559686497197e-5	109	39	7	0.1794871794871795	0.06422018348623854	KEGG:04066	KEGG	HIF-1 signaling pathway	8484	257		0.6041666666666666	0.6082474226804123	109	8375	7	32	102	8343	8484	0.10055538778931292
M1	cpdb	0	network_modules	57	TRUE	4.402460429221413e-5	162	39	8	0.20512820512820512	0.04938271604938271	KEGG:05161	KEGG	Hepatitis B	8484	442		0.6145833333333334	0.6185567010309279	162	8322	8	31	154	8291	8484	0.09237464592325112
M1	cpdb	0	network_modules	57	TRUE	4.831029953722133e-5	112	46	7	0.15217391304347827	0.0625	GO:0038127	GO:BP	ERBB signaling pathway	16175	9716		0.4358974358974359	0.4430379746835443	112	16063	7	39	105	16024	16175	0.09354320148486392
M1	cpdb	0	network_modules	57	TRUE	4.9758467125779945e-5	12	46	4	0.08695652173913043	0.3333333333333333	GO:0036092	GO:BP	phosphatidylinositol-3-phosphate biosynthetic process	16175	9435		0.44871794871794873	0.45569620253164556	12	16163	4	42	8	16121	16175	0.16910205067194428
M1	cpdb	0	network_modules	57	TRUE	5.0459737157416826e-5	337	46	10	0.21739130434782608	0.02967359050445104	GO:0046486	GO:BP	glycerolipid metabolic process	16175	12190		0.46153846153846156	0.46835443037974683	337	15838	10	36	327	15802	16175	0.0734923575208614
M1	cpdb	0	network_modules	57	TRUE	5.642486843724357e-5	114	39	7	0.1794871794871795	0.06140350877192982	KEGG:04670	KEGG	Leukocyte transendothelial migration	8484	343		0.625	0.6288659793814433	114	8370	7	32	107	8338	8484	0.09800701891555286
M1	cpdb	0	network_modules	57	TRUE	6.758663118586382e-5	564	46	12	0.2608695652173913	0.02127659574468085	GO:0045937	GO:BP	positive regulation of phosphate metabolic process	16175	11731		0.47435897435897434	0.4936708860759494	564	15611	12	34	552	15577	16175	0.06579226189328861
M1	cpdb	0	network_modules	57	TRUE	6.758663118586382e-5	564	46	12	0.2608695652173913	0.02127659574468085	GO:0010562	GO:BP	positive regulation of phosphorus metabolic process	16175	4215		0.47435897435897434	0.4936708860759494	564	15611	12	34	552	15577	16175	0.06579226189328861
M1	cpdb	0	network_modules	57	TRUE	6.82577343855639e-5	35	42	5	0.11904761904761904	0.14285714285714285	REAC:R-HSA-114604	REAC	GPVI-mediated activation cascade	10916	1021		0.6836734693877551	0.696969696969697	35	10881	5	37	30	10844	10916	0.12734695487609995
M1	cpdb	0	network_modules	57	TRUE	6.82577343855639e-5	35	42	5	0.11904761904761904	0.14285714285714285	REAC:R-HSA-2172127	REAC	DAP12 interactions	10916	432		0.6836734693877551	0.696969696969697	35	10881	5	37	30	10844	10916	0.12734695487609995
M1	cpdb	0	network_modules	57	TRUE	7.44704191396058e-5	569	46	12	0.2608695652173913	0.0210896309314587	GO:0046649	GO:BP	lymphocyte activation	16175	12286		0.5	0.5063291139240507	569	15606	12	34	557	15572	16175	0.06542343941109907
M1	cpdb	0	network_modules	57	TRUE	7.554985382107755e-5	119	39	7	0.1794871794871795	0.058823529411764705	KEGG:04660	KEGG	T cell receptor signaling pathway	8484	338		0.6354166666666666	0.6391752577319587	119	8365	7	32	112	8333	8484	0.09561405610983659
M1	cpdb	0	network_modules	57	TRUE	7.783247454358892e-5	69	42	6	0.14285714285714285	0.08695652173913043	REAC:R-HSA-2730905	REAC	Role of LAT2/NTAL/LAB on calcium mobilization	10916	2108		0.7040816326530612	0.7070707070707071	69	10847	6	36	63	10811	10916	0.10706851588031967
M1	cpdb	0	network_modules	57	TRUE	7.965898631636361e-5	699	46	13	0.2826086956521739	0.01859799713876967	GO:0045321	GO:BP	leukocyte activation	16175	11356		0.5128205128205128	0.5189873417721519	699	15476	13	33	686	15443	16175	0.06287305156189163
M1	cpdb	0	network_modules	57	TRUE	7.99634448574459e-5	120	39	7	0.1794871794871795	0.058333333333333334	KEGG:04071	KEGG	Sphingolipid signaling pathway	8484	260		0.6458333333333334	0.6494845360824743	120	8364	7	32	113	8332	8484	0.09515269048900572
M1	cpdb	0	network_modules	57	TRUE	8.700768927720571e-5	15	42	4	0.09523809523809523	0.26666666666666666	REAC:R-HSA-9706369	REAC	Negative regulation of FLT3	10916	1572		0.7142857142857143	0.7171717171717171	15	10901	4	38	11	10863	10916	0.1574757214383488
M1	cpdb	0	network_modules	57	TRUE	9.255970370688036e-5	708	46	13	0.2826086956521739	0.018361581920903956	GO:0030029	GO:BP	actin filament-based process	16175	6653		0.5256410256410257	0.5316455696202531	708	15467	13	33	695	15434	16175	0.06234508579086328
M1	cpdb	0	network_modules	57	TRUE	1.1568720099356881e-4	16	42	4	0.09523809523809523	0.25	REAC:R-HSA-1839117	REAC	Signaling by cytosolic FGFR1 fusion mutants	10916	2318		0.7244897959183674	0.7272727272727273	16	10900	4	38	12	10862	10916	0.15233338731847706
M1	cpdb	0	network_modules	57	TRUE	1.364103632166813e-4	40	42	5	0.11904761904761904	0.125	REAC:R-HSA-8875878	REAC	MET promotes cell motility	10916	1368		0.7346938775510204	0.7373737373737373	40	10876	5	37	35	10839	10916	0.11867842316606109
M1	cpdb	0	network_modules	57	TRUE	1.5086200480591986e-4	17	42	4	0.09523809523809523	0.23529411764705882	REAC:R-HSA-9703465	REAC	Signaling by FLT3 fusion proteins	10916	2255		0.7448979591836735	0.7474747474747475	17	10899	4	38	13	10861	10916	0.14764749111371728
M1	cpdb	0	network_modules	57	TRUE	1.622122334114556e-4	40	46	5	0.10869565217391304	0.125	GO:0038084	GO:BP	vascular endothelial growth factor signaling pathway	16175	9685		0.5384615384615384	0.5443037974683544	40	16135	5	41	35	16094	16175	0.11421478860909336
M1	cpdb	0	network_modules	57	TRUE	1.6522895710090698e-4	744	46	13	0.2826086956521739	0.01747311827956989	GO:0072359	GO:BP	circulatory system development	16175	17370		0.5512820512820513	0.5569620253164557	744	15431	13	33	731	15398	16175	0.060321531055560235
M1	cpdb	0	network_modules	57	TRUE	1.8293565610853833e-4	5	42	3	0.07142857142857142	0.6	REAC:R-HSA-8851907	REAC	MET activates PI3K/AKT signaling	10916	1361		0.7551020408163265	0.7575757575757576	5	10911	3	39	2	10872	10916	0.206136199721145
M1	cpdb	0	network_modules	57	TRUE	1.9703229034119784e-4	622	46	12	0.2608695652173913	0.01929260450160772	GO:0030155	GO:BP	regulation of cell adhesion	16175	6688		0.5641025641025641	0.569620253164557	622	15553	12	34	610	15519	16175	0.061770567625477904
M1	cpdb	0	network_modules	57	TRUE	1.974146850308811e-4	500	46	11	0.2391304347826087	0.022	GO:0001934	GO:BP	positive regulation of protein phosphorylation	16175	548		0.5769230769230769	0.5822784810126582	500	15675	11	35	489	15640	16175	0.06424659139484185
M1	cpdb	0	network_modules	57	TRUE	2.1123794857316974e-4	626	46	12	0.2608695652173913	0.019169329073482427	GO:0035295	GO:BP	tube development	16175	8953		0.5897435897435898	0.5949367088607594	626	15549	12	34	614	15515	16175	0.06151235120460328
M1	cpdb	0	network_modules	57	TRUE	2.139469066921275e-4	504	46	11	0.2391304347826087	0.021825396825396824	GO:0001944	GO:BP	vasculature development	16175	555		0.6025641025641025	0.6075949367088608	504	15671	11	35	493	15636	16175	0.06392329289545201
M1	cpdb	0	network_modules	57	TRUE	2.2116051329983962e-4	89	39	6	0.15384615384615385	0.06741573033707865	KEGG:05235	KEGG	PD-L1 expression and PD-1 checkpoint pathway in cancer	8484	480		0.65625	0.6701030927835051	89	8395	6	33	83	8362	8484	0.09561876043383977
M1	cpdb	0	network_modules	57	TRUE	2.2116051329983962e-4	89	39	6	0.15384615384615385	0.06741573033707865	KEGG:04211	KEGG	Longevity regulating pathway	8484	288		0.65625	0.6701030927835051	89	8395	6	33	83	8362	8484	0.09561876043383977
M1	cpdb	0	network_modules	57	TRUE	2.3183670451238812e-4	84	46	6	0.13043478260869565	0.07142857142857142	GO:0008286	GO:BP	insulin receptor signaling pathway	16175	3153		0.6153846153846154	0.620253164556962	84	16091	6	40	78	16051	16175	0.09305439135062937
M1	cpdb	0	network_modules	57	TRUE	2.595274495518677e-4	638	46	12	0.2608695652173913	0.018808777429467086	GO:0018193	GO:BP	peptidyl-amino acid modification	16175	5353		0.6282051282051282	0.6329113924050633	638	15537	12	34	626	15503	16175	0.06075109865767541
M1	cpdb	0	network_modules	57	TRUE	2.6023662034111036e-4	143	39	7	0.1794871794871795	0.04895104895104895	KEGG:04550	KEGG	Signaling pathways regulating pluripotency of stem cells	8484	319		0.6770833333333334	0.6804123711340206	143	8341	7	32	136	8309	8484	0.08585426074844434
M1	cpdb	0	network_modules	57	TRUE	2.686687747576869e-4	92	39	6	0.15384615384615385	0.06521739130434782	KEGG:05222	KEGG	Small cell lung cancer	8484	473		0.6875	0.6907216494845361	92	8392	6	33	86	8359	8484	0.09383162581563866
M1	cpdb	0	network_modules	57	TRUE	3.121238128154507e-4	210	39	8	0.20512820512820512	0.0380952380952381	KEGG:05170	KEGG	Human immunodeficiency virus 1 infection	8484	451		0.6979166666666666	0.7010309278350515	210	8274	8	31	202	8243	8484	0.07889397392353206
M1	cpdb	0	network_modules	57	TRUE	3.470295133714661e-4	48	42	5	0.11904761904761904	0.10416666666666667	REAC:R-HSA-177929	REAC	Signaling by EGFR	10916	2229		0.7653061224489796	0.7676767676767676	48	10868	5	37	43	10831	10916	0.10768957512967134
M1	cpdb	0	network_modules	57	TRUE	3.725908462509648e-4	47	46	5	0.10869565217391304	0.10638297872340426	GO:0038093	GO:BP	Fc receptor signaling pathway	16175	9693		0.6410256410256411	0.6455696202531646	47	16128	5	41	42	16087	16175	0.10496019814374709
M1	cpdb	0	network_modules	57	TRUE	3.835431483545587e-4	210	42	8	0.19047619047619047	0.0380952380952381	REAC:R-HSA-1483257	REAC	Phospholipid metabolism	10916	1748		0.7755102040816326	0.7777777777777778	210	10706	8	34	202	10672	10916	0.07747673978916876
M1	cpdb	0	network_modules	57	TRUE	3.88709331495228e-4	98	39	6	0.15384615384615385	0.061224489795918366	KEGG:04750	KEGG	Inflammatory mediator regulation of TRP channels	8484	364		0.7083333333333334	0.711340206185567	98	8386	6	33	92	8353	8484	0.09049660891499062
M1	cpdb	0	network_modules	57	TRUE	4.4469389811140785e-4	155	39	7	0.1794871794871795	0.04516129032258064	KEGG:04218	KEGG	Cellular senescence	8484	295		0.71875	0.7216494845360825	155	8329	7	32	148	8297	8484	0.08180559845141837
M1	cpdb	0	network_modules	57	TRUE	4.572597380595946e-4	22	42	4	0.09523809523809523	0.18181818181818182	REAC:R-HSA-389357	REAC	CD28 dependent PI3K/Akt signaling	10916	267		0.7857142857142857	0.7878787878787878	22	10894	4	38	18	10856	10916	0.12918443270759158
M1	cpdb	0	network_modules	57	TRUE	4.633194960580397e-4	101	39	6	0.15384615384615385	0.0594059405940594	KEGG:05146	KEGG	Amoebiasis	8484	438		0.7291666666666666	0.7319587628865979	101	8383	6	33	95	8350	8484	0.08893685672942651
M1	cpdb	0	network_modules	57	TRUE	4.7205571613641523e-4	51	42	5	0.11904761904761904	0.09803921568627451	REAC:R-HSA-8848021	REAC	Signaling by PTK6	10916	2295		0.7959183673469388	0.8080808080808081	51	10865	5	37	46	10828	10916	0.10423818871945102
M1	cpdb	0	network_modules	57	TRUE	4.7205571613641523e-4	51	42	5	0.11904761904761904	0.09803921568627451	REAC:R-HSA-9006927	REAC	Signaling by Non-Receptor Tyrosine Kinases	10916	2288		0.7959183673469388	0.8080808080808081	51	10865	5	37	46	10828	10916	0.10423818871945102
M1	cpdb	0	network_modules	57	TRUE	4.906297930411539e-4	102	39	6	0.15384615384615385	0.058823529411764705	KEGG:04914	KEGG	Progesterone-mediated oocyte maturation	8484	371		0.7395833333333334	0.7422680412371134	102	8382	6	33	96	8349	8484	0.08843160180490765
M1	cpdb	0	network_modules	57	TRUE	5.048306859059275e-4	158	39	7	0.1794871794871795	0.04430379746835443	KEGG:05160	KEGG	Hepatitis C	8484	441		0.75	0.7525773195876289	158	8326	7	32	151	8294	8484	0.08086208819129766
M1	cpdb	0	network_modules	57	TRUE	5.330227294160222e-4	552	46	11	0.2391304347826087	0.019927536231884056	GO:0035239	GO:BP	tube morphogenesis	16175	8921		0.6538461538461539	0.6582278481012658	552	15623	11	35	541	15588	16175	0.06030168114304769
M1	cpdb	0	network_modules	57	TRUE	5.346881342824602e-4	434	46	10	0.21739130434782608	0.02304147465437788	GO:0002521	GO:BP	leukocyte differentiation	16175	1043		0.6666666666666666	0.6708860759493671	434	15741	10	36	424	15705	16175	0.06297811963282539
M1	cpdb	0	network_modules	57	TRUE	5.482526482173776e-4	97	46	6	0.13043478260869565	0.061855670103092786	GO:0007173	GO:BP	epidermal growth factor receptor signaling pathway	16175	2736		0.6794871794871795	0.6835443037974683	97	16078	6	40	91	16038	16175	0.08607364346548291
M1	cpdb	0	network_modules	57	TRUE	5.491808150426629e-4	104	39	6	0.15384615384615385	0.057692307692307696	KEGG:04625	KEGG	C-type lectin receptor signaling pathway	8484	330		0.7604166666666666	0.7628865979381443	104	8380	6	33	98	8347	8484	0.08744203286725138
M1	cpdb	0	network_modules	57	TRUE	5.51984004868258e-4	23	42	4	0.09523809523809523	0.17391304347826086	REAC:R-HSA-373753	REAC	Nephrin family interactions	10916	1582		0.8163265306122449	0.8181818181818182	23	10893	4	38	19	10855	10916	0.1262265038471724
M1	cpdb	0	network_modules	57	TRUE	5.697012827192456e-4	437	46	10	0.21739130434782608	0.02288329519450801	GO:0002764	GO:BP	immune response-regulating signaling pathway	16175	1275		0.6923076923076923	0.6962025316455697	437	15738	10	36	427	15702	16175	0.06270646535512697
M1	cpdb	0	network_modules	57	TRUE	6.132871360703721e-4	106	39	6	0.15384615384615385	0.05660377358490566	KEGG:04620	KEGG	Toll-like receptor signaling pathway	8484	325		0.7708333333333334	0.7731958762886598	106	8378	6	33	100	8345	8484	0.08647929267223349
M1	cpdb	0	network_modules	57	TRUE	6.833421563885213e-4	108	39	6	0.15384615384615385	0.05555555555555555	KEGG:04931	KEGG	Insulin resistance	8484	388		0.78125	0.7835051546391752	108	8376	6	33	102	8343	8484	0.08554214463725118
M1	cpdb	0	network_modules	57	TRUE	7.832488964390885e-4	103	46	6	0.13043478260869565	0.05825242718446602	GO:0007265	GO:BP	Ras protein signal transduction	16175	2793		0.7051282051282052	0.7088607594936709	103	16072	6	40	97	16032	16175	0.08329557860486471
M1	cpdb	0	network_modules	57	TRUE	7.841645329169539e-4	25	42	4	0.09523809523809523	0.16	REAC:R-HSA-201556	REAC	Signaling by ALK	10916	2217		0.826530612244898	0.8282828282828283	25	10891	4	38	21	10853	10916	0.12084511759323284
M1	cpdb	0	network_modules	57	TRUE	8.872532111699987e-4	113	39	6	0.15384615384615385	0.05309734513274336	KEGG:04725	KEGG	Cholinergic synapse	8484	355		0.7916666666666666	0.8041237113402062	113	8371	6	33	107	8338	8484	0.08330381862637441
M1	cpdb	0	network_modules	57	TRUE	8.872532111699987e-4	113	39	6	0.15384615384615385	0.05309734513274336	KEGG:04668	KEGG	TNF signaling pathway	8484	342		0.7916666666666666	0.8041237113402062	113	8371	6	33	107	8338	8484	0.08330381862637441
M1	cpdb	0	network_modules	57	TRUE	0.001002552834366164	246	39	8	0.20512820512820512	0.032520325203252036	KEGG:05131	KEGG	Shigellosis	8484	428		0.8125	0.8144329896907216	246	8238	8	31	238	8207	8484	0.07133358671754535
M1	cpdb	0	network_modules	57	TRUE	0.0010754924250148698	357	46	9	0.1956521739130435	0.025210084033613446	GO:1903131	GO:BP	mononuclear cell differentiation	16175	22787		0.717948717948718	0.7215189873417721	357	15818	9	37	348	15781	16175	0.06309747323382375
M1	cpdb	0	network_modules	57	TRUE	0.0010873999871437517	58	46	5	0.10869565217391304	0.08620689655172414	GO:0035924	GO:BP	cellular response to vascular endothelial growth factor stimulus	16175	9346		0.7307692307692307	0.7341772151898734	58	16117	5	41	53	16076	16175	0.09390892957499981
M1	cpdb	0	network_modules	57	TRUE	0.001095232328456364	109	46	6	0.13043478260869565	0.05504587155963303	GO:0030183	GO:BP	B cell differentiation	16175	6700		0.7435897435897436	0.7468354430379747	109	16066	6	40	103	16026	16175	0.08074357389084647
M1	cpdb	0	network_modules	57	TRUE	0.0012529790912696453	120	39	6	0.15384615384615385	0.05	KEGG:04152	KEGG	AMPK signaling pathway	8484	286		0.8229166666666666	0.8247422680412371	120	8364	6	33	114	8331	8484	0.08039661411793157
M1	cpdb	0	network_modules	57	TRUE	0.001269654726009803	265	46	8	0.17391304347826086	0.03018867924528302	GO:0002429	GO:BP	immune response-activating cell surface receptor signaling pathway	16175	952		0.7564102564102564	0.759493670886076	265	15910	8	38	257	15872	16175	0.06627107300196665
M1	cpdb	0	network_modules	57	TRUE	0.0013139384409687272	121	39	6	0.15384615384615385	0.049586776859504134	KEGG:04919	KEGG	Thyroid hormone signaling pathway	8484	376		0.8333333333333334	0.8350515463917526	121	8363	6	33	115	8330	8484	0.08000093889831424
M1	cpdb	0	network_modules	57	TRUE	0.001498854972275978	73	39	5	0.1282051282051282	0.0684931506849315	KEGG:00562	KEGG	Inositol phosphate metabolism	8484	86		0.84375	0.845360824742268	73	8411	5	34	68	8377	8484	0.0879997823568891
M1	cpdb	0	network_modules	57	TRUE	0.0015113552380564821	124	39	6	0.15384615384615385	0.04838709677419355	KEGG:04611	KEGG	Platelet activation	8484	321		0.8541666666666666	0.8556701030927835	124	8360	6	33	118	8327	8484	0.07884120373505712
M1	cpdb	0	network_modules	57	TRUE	0.001520256930610951	9	42	3	0.07142857142857142	0.3333333333333333	REAC:R-HSA-74749	REAC	Signal attenuation	10916	2214		0.8367346938775511	0.8686868686868687	9	10907	3	39	6	10868	10916	0.15287957917442463
M1	cpdb	0	network_modules	57	TRUE	0.001520256930610951	9	42	3	0.07142857142857142	0.3333333333333333	REAC:R-HSA-8875656	REAC	MET receptor recycling	10916	1369		0.8367346938775511	0.8686868686868687	9	10907	3	39	6	10868	10916	0.15287957917442463
M1	cpdb	0	network_modules	57	TRUE	0.001520256930610951	9	42	3	0.07142857142857142	0.3333333333333333	REAC:R-HSA-9634285	REAC	Constitutive Signaling by Overexpressed ERBB2	10916	408		0.8367346938775511	0.8686868686868687	9	10907	3	39	6	10868	10916	0.15287957917442463
M1	cpdb	0	network_modules	57	TRUE	0.001520256930610951	9	42	3	0.07142857142857142	0.3333333333333333	REAC:R-HSA-5655291	REAC	Signaling by FGFR4 in disease	10916	2253		0.8367346938775511	0.8686868686868687	9	10907	3	39	6	10868	10916	0.15287957917442463
M1	cpdb	0	network_modules	57	TRUE	0.0015957478690401673	756	46	12	0.2608695652173913	0.015873015873015872	GO:0050776	GO:BP	regulation of immune response	16175	13250		0.7692307692307693	0.7721518987341772	756	15419	12	34	744	15385	16175	0.0541763275944173
M1	cpdb	0	network_modules	57	TRUE	0.0018259194961740984	182	42	7	0.16666666666666666	0.038461538461538464	REAC:R-HSA-2454202	REAC	Fc epsilon receptor (FCERI) signaling	10916	938		0.8775510204081632	0.8787878787878788	182	10734	7	35	175	10699	10916	0.07280322113057962
M1	cpdb	0	network_modules	57	TRUE	0.0018365533755849291	259	42	8	0.19047619047619047	0.03088803088803089	REAC:R-HSA-76002	REAC	Platelet activation, signaling and aggregation	10916	1762		0.8877551020408163	0.8888888888888888	259	10657	8	34	251	10623	10916	0.06809117292092555
M1	cpdb	0	network_modules	57	TRUE	0.0018548588711713007	67	42	5	0.11904761904761904	0.07462686567164178	REAC:R-HSA-388841	REAC	Regulation of T cell activation by CD28 family	10916	2007		0.8979591836734694	0.898989898989899	67	10849	5	37	62	10812	10916	0.0898448199137909
M1	cpdb	0	network_modules	57	TRUE	0.0019319262841414036	194	39	7	0.1794871794871795	0.03608247422680412	KEGG:05167	KEGG	Kaposi sarcoma-associated herpesvirus infection	8484	448		0.8645833333333334	0.865979381443299	194	8290	7	32	187	8258	8484	0.07120392093463691
M1	cpdb	0	network_modules	57	TRUE	0.0019624929688254636	184	42	7	0.16666666666666666	0.03804347826086957	REAC:R-HSA-9013149	REAC	RAC1 GTPase cycle	10916	1836		0.9081632653061225	0.9090909090909091	184	10732	7	35	177	10697	10916	0.07232476421956542
M1	cpdb	0	network_modules	57	TRUE	0.0019706926801578597	630	46	11	0.2391304347826087	0.01746031746031746	GO:0043069	GO:BP	negative regulation of programmed cell death	16175	10515		0.782051282051282	0.7848101265822784	630	15545	11	35	619	15510	16175	0.05525577239103639
M1	cpdb	0	network_modules	57	TRUE	0.002032875775359009	632	46	11	0.2391304347826087	0.01740506329113924	GO:0031401	GO:BP	positive regulation of protein modification process	16175	7157		0.7948717948717948	0.7974683544303798	632	15543	11	35	621	15508	16175	0.05513774397250075
M1	cpdb	0	network_modules	57	TRUE	0.0021860675132699577	32	42	4	0.09523809523809523	0.125	REAC:R-HSA-5654741	REAC	Signaling by FGFR3	10916	2249		0.9183673469387755	0.9191919191919192	32	10884	4	38	28	10846	10916	0.10611019039151555
M1	cpdb	0	network_modules	57	TRUE	0.0022079890438713944	196	46	7	0.15217391304347827	0.03571428571428571	GO:0043542	GO:BP	endothelial cell migration	16175	10759		0.8076923076923077	0.810126582278481	196	15979	7	39	189	15940	16175	0.0683627866687314
M1	cpdb	0	network_modules	57	TRUE	0.0024503140558846536	135	39	6	0.15384615384615385	0.044444444444444446	KEGG:04210	KEGG	Apoptosis	8484	287		0.875	0.8762886597938144	135	8349	6	33	129	8316	8484	0.07490656374374205
M1	cpdb	0	network_modules	57	TRUE	0.0025069214141967906	202	39	7	0.1794871794871795	0.034653465346534656	KEGG:05415	KEGG	Diabetic cardiomyopathy	8484	492		0.8854166666666666	0.8865979381443299	202	8282	7	32	195	8250	8484	0.06939307322563916
M1	cpdb	0	network_modules	57	TRUE	0.002570063939436919	791	46	12	0.2608695652173913	0.015170670037926675	GO:1901701	GO:BP	cellular response to oxygen-containing compound	16175	21654		0.8205128205128205	0.8227848101265823	791	15384	12	34	779	15350	16175	0.052488568967036284
M1	cpdb	0	network_modules	57	TRUE	0.0026043560793981633	792	46	12	0.2608695652173913	0.015151515151515152	GO:0042325	GO:BP	regulation of phosphorylation	16175	10093		0.8333333333333334	0.8354430379746836	792	15383	12	34	780	15349	16175	0.052441826707279794
M1	cpdb	0	network_modules	57	TRUE	0.002774603626694226	138	39	6	0.15384615384615385	0.043478260869565216	KEGG:05418	KEGG	Fluid shear stress and atherosclerosis	8484	495		0.8958333333333334	0.9072164948453608	138	8346	6	33	132	8313	8484	0.07391123696155845
M1	cpdb	0	network_modules	57	TRUE	0.002774603626694226	138	39	6	0.15384615384615385	0.043478260869565216	KEGG:05162	KEGG	Measles	8484	443		0.8958333333333334	0.9072164948453608	138	8346	6	33	132	8313	8484	0.07391123696155845
M1	cpdb	0	network_modules	57	TRUE	0.002988935227790648	297	46	8	0.17391304347826086	0.026936026936026935	GO:0030098	GO:BP	lymphocyte differentiation	16175	6676		0.8461538461538461	0.8481012658227848	297	15878	8	38	289	15840	16175	0.06187528510297291
M1	cpdb	0	network_modules	57	TRUE	0.0030787359767903665	206	46	7	0.15217391304347827	0.03398058252427184	GO:0030217	GO:BP	T cell differentiation	16175	6725		0.8589743589743589	0.8607594936708861	206	15969	7	39	199	15930	16175	0.06640928615633329
M1	cpdb	0	network_modules	57	TRUE	0.003132575746767804	141	39	6	0.15384615384615385	0.0425531914893617	KEGG:05017	KEGG	Spinocerebellar ataxia	8484	415		0.9166666666666666	0.9175257731958762	141	8343	6	33	135	8310	8484	0.07294589739360666
M1	cpdb	0	network_modules	57	TRUE	0.003156553182000255	35	42	4	0.09523809523809523	0.11428571428571428	REAC:R-HSA-5654743	REAC	Signaling by FGFR4	10916	2252		0.9285714285714286	0.9292929292929293	35	10881	4	38	31	10843	10916	0.10117261182530903
M1	cpdb	0	network_modules	57	TRUE	0.0033156575501877487	211	39	7	0.1794871794871795	0.03317535545023697	KEGG:05207	KEGG	Chemical carcinogenesis - receptor activation	8484	459		0.9270833333333334	0.9278350515463918	211	8273	7	32	204	8241	8484	0.06747100458888235
M1	cpdb	0	network_modules	57	TRUE	0.003556332520849422	304	46	8	0.17391304347826086	0.02631578947368421	GO:0050900	GO:BP	leukocyte migration	16175	13342		0.8717948717948718	0.8734177215189873	304	15871	8	38	296	15833	16175	0.06100205203025293
M1	cpdb	0	network_modules	57	TRUE	0.004083631015349963	218	39	7	0.1794871794871795	0.03211009174311927	KEGG:05166	KEGG	Human T-cell leukemia virus 1 infection	8484	447		0.9375	0.9381443298969072	218	8266	7	32	211	8234	8484	0.0660526484591151
M1	cpdb	0	network_modules	57	TRUE	0.0040923420730927355	215	46	7	0.15217391304347827	0.03255813953488372	GO:0110053	GO:BP	regulation of actin filament organization	16175	19377		0.8846153846153846	0.8860759493670886	215	15960	7	39	208	15921	16175	0.06476332438445061
M1	cpdb	0	network_modules	57	TRUE	0.004750642308085399	140	46	6	0.13043478260869565	0.04285714285714286	GO:0032869	GO:BP	cellular response to insulin stimulus	16175	7866		0.8974358974358975	0.8987341772151899	140	16035	6	40	134	15995	16175	0.07020935667557458
M1	cpdb	0	network_modules	57	TRUE	0.00485027993824536	93	39	5	0.1282051282051282	0.053763440860215055	KEGG:04520	KEGG	Adherens junction	8484	316		0.9479166666666666	0.9484536082474226	93	8391	5	34	88	8357	8484	0.07651963700349519
M1	cpdb	0	network_modules	57	TRUE	0.00501763869511359	35	46	4	0.08695652173913043	0.11428571428571428	GO:0048008	GO:BP	platelet-derived growth factor receptor signaling pathway	16175	12464		0.9102564102564102	0.9113924050632911	35	16140	4	42	31	16098	16175	0.09745230218926838
M1	cpdb	0	network_modules	57	TRUE	0.005116215119254806	79	46	5	0.10869565217391304	0.06329113924050633	GO:0035023	GO:BP	regulation of Rho protein signal transduction	16175	8766		0.9230769230769231	0.9240506329113924	79	16096	5	41	74	16055	16175	0.0795229941725002
M1	cpdb	0	network_modules	57	TRUE	0.005120885621324447	13	42	3	0.07142857142857142	0.23076923076923078	REAC:R-HSA-1963642	REAC	PI3K events in ERBB2 signaling	10916	1672		0.9387755102040817	0.9393939393939394	13	10903	3	39	10	10864	10916	0.12656652430947055
M1	cpdb	0	network_modules	57	TRUE	0.005137669087840805	154	39	6	0.15384615384615385	0.03896103896103896	KEGG:04932	KEGG	Non-alcoholic fatty liver disease	8484	389		0.9583333333333334	0.9587628865979382	154	8330	6	33	148	8297	8484	0.06907358611885064
M1	cpdb	0	network_modules	57	TRUE	0.006500040657894076	14	42	3	0.07142857142857142	0.21428571428571427	REAC:R-HSA-8983432	REAC	Interleukin-15 signaling	10916	1237		0.9489795918367347	0.9696969696969697	14	10902	3	39	11	10863	10916	0.12180906900349268
M1	cpdb	0	network_modules	57	TRUE	0.006500040657894076	14	42	3	0.07142857142857142	0.21428571428571427	REAC:R-HSA-169893	REAC	Prolonged ERK activation events	10916	1807		0.9489795918367347	0.9696969696969697	14	10902	3	39	11	10863	10916	0.12180906900349268
M1	cpdb	0	network_modules	57	TRUE	0.006500040657894076	14	42	3	0.07142857142857142	0.21428571428571427	REAC:R-HSA-9034015	REAC	Signaling by NTRK3 (TRKC)	10916	2286		0.9489795918367347	0.9696969696969697	14	10902	3	39	11	10863	10916	0.12180906900349268
M1	cpdb	0	network_modules	57	TRUE	0.006617452784099657	42	42	4	0.09523809523809523	0.09523809523809523	REAC:R-HSA-5654736	REAC	Signaling by FGFR1	10916	2241		0.9795918367346939	0.9797979797979798	42	10874	4	38	38	10836	10916	0.09174352102437444
M1	cpdb	0	network_modules	57	TRUE	0.006880756045277101	447	46	9	0.1956521739130435	0.020134228187919462	GO:0048514	GO:BP	blood vessel morphogenesis	16175	12799		0.9358974358974359	0.9367088607594937	447	15728	9	37	438	15691	16175	0.054737130770973697
M1	cpdb	0	network_modules	57	TRUE	0.007046804542789208	577	46	10	0.21739130434782608	0.01733102253032929	GO:0043085	GO:BP	positive regulation of catalytic activity	16175	10518		0.9487179487179487	0.9493670886075949	577	15598	10	36	567	15562	16175	0.05232357234156997
M1	cpdb	0	network_modules	57	TRUE	0.007090172151259105	88	42	5	0.11904761904761904	0.056818181818181816	REAC:R-HSA-9013404	REAC	RAC2 GTPase cycle	10916	1837		0.9897959183673469	0.98989898989899	88	10828	5	37	83	10791	10916	0.07713411034496769
M1	cpdb	0	network_modules	57	TRUE	0.007540447438044164	165	39	6	0.15384615384615385	0.03636363636363636	KEGG:04140	KEGG	Autophagy - animal	8484	277		0.96875	0.9690721649484536	165	8319	6	33	159	8286	8484	0.06613748843624595
M1	cpdb	0	network_modules	57	TRUE	0.007651369947966923	152	46	6	0.13043478260869565	0.039473684210526314	GO:0032868	GO:BP	response to insulin	16175	7865		0.9615384615384616	0.9620253164556962	152	16023	6	40	146	15983	16175	0.06699554908007513
M1	cpdb	0	network_modules	57	TRUE	0.00806046162513128	167	39	6	0.15384615384615385	0.03592814371257485	KEGG:05164	KEGG	Influenza A	8484	445		0.9791666666666666	0.979381443298969	167	8317	6	33	161	8284	8484	0.0656328422237329
M1	cpdb	0	network_modules	57	TRUE	0.008197927081115976	330	39	8	0.20512820512820512	0.024242424242424242	KEGG:05165	KEGG	Human papillomavirus infection	8484	446		0.9895833333333334	0.9896907216494846	330	8154	8	31	322	8123	8484	0.05842571390769855
M1	cpdb	0	network_modules	57	TRUE	0.008239746094620894	239	46	7	0.15217391304347827	0.029288702928870293	GO:0070372	GO:BP	regulation of ERK1 and ERK2 cascade	16175	16083		0.9743589743589743	0.9746835443037974	239	15936	7	39	232	15897	16175	0.06081509103393791
M1	cpdb	0	network_modules	57	TRUE	0.008704159023805969	241	46	7	0.15217391304347827	0.029045643153526972	GO:0045860	GO:BP	positive regulation of protein kinase activity	16175	11672		0.9871794871794872	0.9873417721518988	241	15934	7	39	234	15895	16175	0.060511516496379085
M1	cpdb	0	network_modules	57	TRUE	0.00976719938656864	94	42	5	0.11904761904761904	0.05319148936170213	REAC:R-HSA-9013423	REAC	RAC3 GTPase cycle	10916	1838		1	1	94	10822	5	37	89	10785	10916	0.07428276852080841
M1	cpdb	0	network_modules	57	TRUE	0.00985957215701703	744	46	11	0.2391304347826087	0.01478494623655914	GO:0001932	GO:BP	regulation of protein phosphorylation	16175	546		1	1	744	15431	11	35	733	15396	16175	0.04923723429128526
M1	cpdb	0	network_modules	57	TRUE	0.0099367272424109	251	39	7	0.1794871794871795	0.027888446215139442	KEGG:04020	KEGG	Calcium signaling pathway	8484	250		1	1	251	8233	7	32	244	8201	8484	0.06012081670063348
M1	cpdb	0	network_modules	58	TRUE	5.777372882470496e-39	298	40	31	0.775	0.1040268456375839	REAC:R-HSA-1474244	REAC	Extracellular matrix organization	10916	889		0	0.029411764705882353	298	10618	31	9	267	10609	10916	0.27826409571580146
M1	cpdb	0	network_modules	58	TRUE	2.221100479828388e-31	60	40	19	0.475	0.31666666666666665	REAC:R-HSA-2022090	REAC	Assembly of collagen fibrils and other multimeric structures	10916	177		0.030303030303030304	0.058823529411764705	60	10856	19	21	41	10835	10916	0.3851121294874017
M1	cpdb	0	network_modules	58	TRUE	7.92854329908732e-30	89	40	20	0.5	0.2247191011235955	REAC:R-HSA-1474290	REAC	Collagen formation	10916	387		0.06060606060606061	0.08823529411764706	89	10827	20	20	69	10807	10916	0.3316956136650105
M1	cpdb	0	network_modules	58	TRUE	1.5311463875845125e-29	140	40	22	0.55	0.15714285714285714	REAC:R-HSA-1474228	REAC	Degradation of the extracellular matrix	10916	726		0.09090909090909091	0.11764705882352941	140	10776	22	18	118	10758	10916	0.28952211064628464
M1	cpdb	0	network_modules	58	TRUE	4.860442740132185e-26	84	40	18	0.45	0.21428571428571427	REAC:R-HSA-216083	REAC	Integrin cell surface interactions	10916	1216		0.12121212121212122	0.14705882352941177	84	10832	18	22	66	10810	10916	0.30696345841707023
M1	cpdb	0	network_modules	58	TRUE	8.386502447707854e-26	67	40	17	0.425	0.2537313432835821	REAC:R-HSA-1650814	REAC	Collagen biosynthesis and modifying enzymes	10916	384		0.15151515151515152	0.17647058823529413	67	10849	17	23	50	10826	10916	0.3252354360290291
M1	cpdb	0	network_modules	58	TRUE	9.338484952870633e-25	76	40	17	0.425	0.2236842105263158	REAC:R-HSA-3000178	REAC	ECM proteoglycans	10916	812		0.18181818181818182	0.20588235294117646	76	10840	17	23	59	10817	10916	0.3048968798262479
M1	cpdb	0	network_modules	58	TRUE	1.9753814223338926e-22	59	40	15	0.375	0.2542372881355932	REAC:R-HSA-3000171	REAC	Non-integrin membrane-ECM interactions	10916	1603		0.21212121212121213	0.23529411764705882	59	10857	15	25	44	10832	10916	0.3057061609827255
M1	cpdb	0	network_modules	58	TRUE	2.4542741185629765e-22	44	40	14	0.35	0.3181818181818182	REAC:R-HSA-8948216	REAC	Collagen chain trimerization	10916	385		0.24242424242424243	0.2647058823529412	44	10872	14	26	30	10846	10916	0.3311428062764697
M1	cpdb	0	network_modules	58	TRUE	7.813546032657606e-22	64	40	15	0.375	0.234375	REAC:R-HSA-1442490	REAC	Collagen degradation	10916	386		0.2727272727272727	0.29411764705882354	64	10852	15	25	49	10827	10916	0.2932254603491479
M1	cpdb	0	network_modules	58	TRUE	1.107033179526063e-20	89	31	15	0.4838709677419355	0.16853932584269662	KEGG:04512	KEGG	ECM-receptor interaction	8484	314		0	0.1111111111111111	89	8395	15	16	74	8379	8484	0.28137221198415213
M1	cpdb	0	network_modules	58	TRUE	6.654609139780984e-19	356	31	20	0.6451612903225806	0.056179775280898875	KEGG:04151	KEGG	PI3K-Akt signaling pathway	8484	285		0.125	0.2222222222222222	356	8128	20	11	336	8117	8484	0.18218831685637232
M1	cpdb	0	network_modules	58	TRUE	9.594003577762893e-18	103	31	14	0.45161290322580644	0.13592233009708737	KEGG:04974	KEGG	Protein digestion and absorption	8484	405		0.25	0.3333333333333333	103	8381	14	17	89	8364	8484	0.24301951425527824
M1	cpdb	0	network_modules	58	TRUE	4.722797547748414e-17	236	45	17	0.37777777777777777	0.07203389830508475	GO:0030198	GO:BP	extracellular matrix organization	16175	6707		0	0.02631578947368421	236	15939	17	28	219	15911	16175	0.15998436860906193
M1	cpdb	0	network_modules	58	TRUE	5.079315780154673e-17	237	45	17	0.37777777777777777	0.07172995780590717	GO:0043062	GO:BP	extracellular structure organization	16175	10509		0.02702702702702703	0.05263157894736842	237	15938	17	28	220	15910	16175	0.15962432355977102
M1	cpdb	0	network_modules	58	TRUE	5.4609736079100735e-17	238	45	17	0.37777777777777777	0.07142857142857142	GO:0045229	GO:BP	external encapsulating structure organization	16175	11340		0.05405405405405406	0.07894736842105263	238	15937	17	28	221	15909	16175	0.15926650223940952
M1	cpdb	0	network_modules	58	TRUE	5.98801638477229e-17	507	40	22	0.55	0.04339250493096647	REAC:R-HSA-9006934	REAC	Signaling by Receptor Tyrosine Kinases	10916	2302		0.30303030303030304	0.3235294117647059	507	10409	22	18	485	10391	10916	0.14510983483929676
M1	cpdb	0	network_modules	58	TRUE	9.120454130578376e-17	202	31	16	0.5161290322580645	0.07920792079207921	KEGG:04510	KEGG	Focal adhesion	8484	313		0.375	0.4444444444444444	202	8282	16	15	186	8267	8484	0.1955599059617056
M1	cpdb	0	network_modules	58	TRUE	1.1143457053717445e-16	54	40	12	0.3	0.2222222222222222	REAC:R-HSA-186797	REAC	Signaling by PDGF	10916	2291		0.3333333333333333	0.35294117647058826	54	10862	12	28	42	10834	10916	0.2550394567314758
M1	cpdb	0	network_modules	58	TRUE	5.356770396511506e-16	42	40	11	0.275	0.2619047619047619	REAC:R-HSA-419037	REAC	NCAM1 interactions	10916	1512		0.36363636363636365	0.38235294117647056	42	10874	11	29	31	10845	10916	0.2656153230466724
M1	cpdb	0	network_modules	58	TRUE	1.4023310999819146e-15	30	40	10	0.25	0.3333333333333333	REAC:R-HSA-8874081	REAC	MET activates PTK2 signaling	10916	1362		0.3939393939393939	0.4117647058823529	30	10886	10	30	20	10856	10916	0.28642009761258913
M1	cpdb	0	network_modules	58	TRUE	3.359651150884684e-14	59	40	11	0.275	0.1864406779661017	REAC:R-HSA-375165	REAC	NCAM signaling for neurite out-growth	10916	1511		0.42424242424242425	0.4411764705882353	59	10857	11	29	48	10828	10916	0.22299235621664712
M1	cpdb	0	network_modules	58	TRUE	3.718669582487413e-14	15	40	8	0.2	0.5333333333333333	REAC:R-HSA-2214320	REAC	Anchoring fibril formation	10916	146		0.45454545454545453	0.47058823529411764	15	10901	8	32	7	10869	10916	0.3251740925435319
M1	cpdb	0	network_modules	58	TRUE	3.858417550327157e-14	40	40	10	0.25	0.25	REAC:R-HSA-8875878	REAC	MET promotes cell motility	10916	1368		0.48484848484848486	0.5	40	10876	10	30	30	10846	10916	0.24724163295329166
M1	cpdb	0	network_modules	58	TRUE	1.7522305636758828e-11	50	45	9	0.2	0.18	GO:0030199	GO:BP	collagen fibril organization	16175	6708		0.08108108108108109	0.10526315789473684	50	16125	9	36	41	16089	16175	0.1873542917745608
M1	cpdb	0	network_modules	58	TRUE	3.969276715572904e-11	76	40	10	0.25	0.13157894736842105	REAC:R-HSA-6806834	REAC	Signaling by MET	10916	2270		0.5151515151515151	0.5294117647058824	76	10840	10	30	66	10810	10916	0.17726018937589808
M1	cpdb	0	network_modules	58	TRUE	1.4221678578109132e-10	330	31	14	0.45161290322580644	0.04242424242424243	KEGG:05165	KEGG	Human papillomavirus infection	8484	446		0.5	0.5555555555555556	330	8154	14	17	316	8137	8484	0.12926627052493456
M1	cpdb	0	network_modules	58	TRUE	1.6385019937998647e-9	27	40	7	0.175	0.25925925925925924	REAC:R-HSA-3000170	REAC	Syndecan interactions	10916	2367		0.5454545454545454	0.5588235294117647	27	10889	7	33	20	10856	10916	0.21063911510329814
M1	cpdb	0	network_modules	58	TRUE	4.22415297395634e-8	43	45	7	0.15555555555555556	0.16279069767441862	GO:0035987	GO:BP	endodermal cell differentiation	16175	9378		0.10810810810810811	0.13157894736842105	43	16132	7	38	36	16094	16175	0.1568391093453838
M1	cpdb	0	network_modules	58	TRUE	1.2906025883748154e-7	50	45	7	0.15555555555555556	0.14	GO:0001706	GO:BP	endoderm formation	16175	398		0.13513513513513514	0.15789473684210525	50	16125	7	38	43	16087	16175	0.14506640523064285
M1	cpdb	0	network_modules	58	TRUE	1.8842867157077267e-7	770	45	16	0.35555555555555557	0.02077922077922078	GO:0048646	GO:BP	anatomical structure formation involved in morphogenesis	16175	12904		0.16216216216216217	0.18421052631578946	770	15405	16	29	754	15376	16175	0.07639045357678144
M1	cpdb	0	network_modules	58	TRUE	3.3671953919317527e-7	57	45	7	0.15555555555555556	0.12280701754385964	GO:0007492	GO:BP	endoderm development	16175	2978		0.1891891891891892	0.21052631578947367	57	16118	7	38	50	16080	16175	0.13551089752572176
M1	cpdb	0	network_modules	58	TRUE	3.476399267397861e-7	30	40	6	0.15	0.2	REAC:R-HSA-3000157	REAC	Laminin interactions	10916	1303		0.5757575757575758	0.5882352941176471	30	10886	6	34	24	10852	10916	0.17057860870784577
M1	cpdb	0	network_modules	58	TRUE	1.6104913079512733e-6	18	40	5	0.125	0.2777777777777778	REAC:R-HSA-2243919	REAC	Crosslinking of collagen fibrils	10916	417		0.6060606060606061	0.6176470588235294	18	10898	5	35	13	10863	10916	0.1843707828021446
M1	cpdb	0	network_modules	58	TRUE	3.858494131128644e-6	80	45	7	0.15555555555555556	0.0875	GO:0001704	GO:BP	formation of primary germ layer	16175	396		0.21621621621621623	0.23684210526315788	80	16095	7	38	73	16057	16175	0.11339546383158605
M1	cpdb	0	network_modules	58	TRUE	7.612784382857953e-6	283	45	10	0.2222222222222222	0.0353356890459364	GO:0001501	GO:BP	skeletal system development	16175	318		0.24324324324324326	0.2631578947368421	283	15892	10	35	273	15857	16175	0.08247532784994191
M1	cpdb	0	network_modules	58	TRUE	1.764875247001517e-5	512	45	12	0.26666666666666666	0.0234375	GO:0009790	GO:BP	embryo development	16175	3677		0.2702702702702703	0.2894736842105263	512	15663	12	33	500	15630	16175	0.07090103462111325
M1	cpdb	0	network_modules	58	TRUE	3.3908905239128226e-5	543	45	12	0.26666666666666666	0.022099447513812154	GO:0009887	GO:BP	animal organ morphogenesis	16175	3747		0.2972972972972973	0.3157894736842105	543	15632	12	33	531	15599	16175	0.06835363781317308
M1	cpdb	0	network_modules	58	TRUE	4.951050078092332e-5	115	45	7	0.15555555555555556	0.06086956521739131	GO:0007369	GO:BP	gastrulation	16175	2871		0.32432432432432434	0.34210526315789475	115	16060	7	38	108	16022	16175	0.09332105502469268
M1	cpdb	0	network_modules	58	TRUE	5.2828355180491e-5	450	45	11	0.24444444444444444	0.024444444444444446	GO:0030335	GO:BP	positive regulation of cell migration	16175	6781		0.35135135135135137	0.3684210526315789	450	15725	11	34	439	15691	16175	0.06957253294838399
M1	cpdb	0	network_modules	58	TRUE	8.237785078006501e-5	470	45	11	0.24444444444444444	0.023404255319148935	GO:2000147	GO:BP	positive regulation of cell motility	16175	25495		0.3783783783783784	0.39473684210526316	470	15705	11	34	459	15671	16175	0.06773068525383967
M1	cpdb	0	network_modules	58	TRUE	9.993073885518935e-5	479	45	11	0.24444444444444444	0.022964509394572025	GO:0040017	GO:BP	positive regulation of locomotion	16175	9905		0.40540540540540543	0.42105263157894735	479	15696	11	34	468	15662	16175	0.06693723115001435
M1	cpdb	0	network_modules	58	TRUE	1.0016451117624987e-4	101	31	6	0.1935483870967742	0.0594059405940594	KEGG:05146	KEGG	Amoebiasis	8484	438		0.625	0.6666666666666666	101	8383	6	25	95	8358	8484	0.10142285070290163
M1	cpdb	0	network_modules	58	TRUE	1.0207334271849499e-4	480	45	11	0.24444444444444444	0.022916666666666665	GO:0001568	GO:BP	blood vessel development	16175	353		0.43243243243243246	0.4473684210526316	480	15695	11	34	469	15661	16175	0.06685035503032273
M1	cpdb	0	network_modules	58	TRUE	1.1980009096886274e-4	77	45	6	0.13333333333333333	0.07792207792207792	GO:0043406	GO:BP	positive regulation of MAP kinase activity	16175	10674		0.4594594594594595	0.47368421052631576	77	16098	6	39	71	16059	16175	0.09866235555447078
M1	cpdb	0	network_modules	58	TRUE	1.324504743866096e-4	41	40	5	0.125	0.12195121951219512	REAC:R-HSA-3560782	REAC	Diseases associated with glycosaminoglycan metabolism	10916	750		0.6363636363636364	0.6470588235294118	41	10875	5	35	36	10840	10916	0.12020230081810526
M1	cpdb	0	network_modules	58	TRUE	1.6744188485551845e-4	504	45	11	0.24444444444444444	0.021825396825396824	GO:0001944	GO:BP	vasculature development	16175	555		0.4864864864864865	0.5	504	15671	11	34	493	15637	16175	0.06483814145485546
M1	cpdb	0	network_modules	58	TRUE	2.739856550785122e-4	20	40	4	0.1	0.2	REAC:R-HSA-3560783	REAC	Defective B4GALT7 causes EDS, progeroid type	10916	495		0.6666666666666666	0.7352941176470589	20	10896	4	36	16	10860	10916	0.13921292420097398
M1	cpdb	0	network_modules	58	TRUE	2.739856550785122e-4	20	40	4	0.1	0.2	REAC:R-HSA-3560801	REAC	Defective B3GAT3 causes JDSSDHD	10916	492		0.6666666666666666	0.7352941176470589	20	10896	4	36	16	10860	10916	0.13921292420097398
M1	cpdb	0	network_modules	58	TRUE	2.739856550785122e-4	20	40	4	0.1	0.2	REAC:R-HSA-4420332	REAC	Defective B3GALT6 causes EDSP2 and SEMDJL1	10916	490		0.6666666666666666	0.7352941176470589	20	10896	4	36	16	10860	10916	0.13921292420097398
M1	cpdb	0	network_modules	58	TRUE	4.40822037861996e-4	236	45	8	0.17777777777777778	0.03389830508474576	GO:0050678	GO:BP	regulation of epithelial cell proliferation	16175	13212		0.5135135135135135	0.5263157894736842	236	15939	8	37	228	15902	16175	0.07188418340256238
M1	cpdb	0	network_modules	58	TRUE	5.743052026419438e-4	100	45	6	0.13333333333333333	0.06	GO:0010595	GO:BP	positive regulation of endothelial cell migration	16175	4243		0.5405405405405406	0.5526315789473685	100	16075	6	39	94	16036	16175	0.08567961211488401
M1	cpdb	0	network_modules	58	TRUE	6.688063035520131e-4	168	45	7	0.15555555555555556	0.041666666666666664	GO:0043588	GO:BP	skin development	16175	10792		0.5675675675675675	0.5789473684210527	168	16007	7	38	161	15969	16175	0.07563069711447037
M1	cpdb	0	network_modules	58	TRUE	8.321338515491216e-4	26	40	4	0.1	0.15384615384615385	REAC:R-HSA-1971475	REAC	A tetrasaccharide linker sequence is required for GAG synthesis	10916	6		0.7575757575757576	0.7647058823529411	26	10890	4	36	22	10854	10916	0.12144761602385662
M1	cpdb	0	network_modules	58	TRUE	0.0010388569526500317	744	45	12	0.26666666666666666	0.016129032258064516	GO:0072359	GO:BP	circulatory system development	16175	17370		0.5945945945945946	0.6052631578947368	744	15431	12	33	732	15398	16175	0.05564071185005066
M1	cpdb	0	network_modules	58	TRUE	0.0012954239201129975	272	45	8	0.17777777777777778	0.029411764705882353	GO:0050673	GO:BP	epithelial cell proliferation	16175	13207		0.6216216216216216	0.631578947368421	272	15903	8	37	264	15866	16175	0.06611986237468509
M1	cpdb	0	network_modules	58	TRUE	0.0014394019890402998	9	40	3	0.075	0.3333333333333333	REAC:R-HSA-190377	REAC	FGFR2b ligand binding and activation	10916	908		0.7878787878787878	0.7941176470588235	9	10907	3	37	6	10870	10916	0.15672765087886065
M1	cpdb	0	network_modules	58	TRUE	0.001568911316321413	279	45	8	0.17777777777777778	0.02867383512544803	GO:0031589	GO:BP	cell-substrate adhesion	16175	7233		0.6486486486486487	0.6578947368421053	279	15896	8	37	271	15859	16175	0.065123939421128485
M1	cpdb	0	network_modules	58	TRUE	0.0016072960713296863	119	45	6	0.13333333333333333	0.05042016806722689	GO:0001936	GO:BP	regulation of endothelial cell proliferation	16175	550		0.6756756756756757	0.6842105263157895	119	16056	6	39	113	16017	16175	0.07786280656817081
M1	cpdb	0	network_modules	58	TRUE	0.0017376993491938766	781	45	12	0.26666666666666666	0.015364916773367477	GO:0030334	GO:BP	regulation of cell migration	16175	6780		0.7027027027027027	0.7105263157894737	781	15394	12	33	769	15361	16175	0.05380832768362009
M1	cpdb	0	network_modules	58	TRUE	0.0019520084930852036	123	45	6	0.13333333333333333	0.04878048780487805	GO:0071902	GO:BP	positive regulation of protein serine/threonine kinase activity	16175	16973		0.7297297297297297	0.7368421052631579	123	16052	6	39	117	16013	16175	0.07644546244772236
M1	cpdb	0	network_modules	58	TRUE	0.0019609801705393858	790	45	12	0.26666666666666666	0.015189873417721518	GO:0007167	GO:BP	enzyme-linked receptor protein signaling pathway	16175	2731		0.7567567567567568	0.7631578947368421	790	15385	12	33	778	15352	16175	0.05338023849804157
M1	cpdb	0	network_modules	58	TRUE	0.0020470175373297223	124	45	6	0.13333333333333333	0.04838709677419355	GO:0043405	GO:BP	regulation of MAP kinase activity	16175	10673		0.7837837837837838	0.7894736842105263	124	16051	6	39	118	16012	16175	0.07610152304723229
M1	cpdb	0	network_modules	58	TRUE	0.0026252433303536643	407	45	9	0.2	0.022113022113022112	GO:0009611	GO:BP	response to wounding	16175	3539		0.8108108108108109	0.8157894736842105	407	15768	9	36	398	15732	16175	0.058963461071592865
M1	cpdb	0	network_modules	58	TRUE	0.0028130448712005178	11	40	3	0.075	0.2727272727272727	REAC:R-HSA-446107	REAC	Type I hemidesmosome assembly	10916	2612		0.8181818181818182	0.8529411764705882	11	10905	3	37	8	10868	10916	0.14142829363778636
M1	cpdb	0	network_modules	58	TRUE	0.0028130448712005178	11	40	3	0.075	0.2727272727272727	REAC:R-HSA-430116	REAC	GP1b-IX-V activation signalling	10916	1017		0.8181818181818182	0.8529411764705882	11	10905	3	37	8	10868	10916	0.14142829363778636
M1	cpdb	0	network_modules	58	TRUE	0.0033659036259402497	135	45	6	0.13333333333333333	0.044444444444444446	GO:0001935	GO:BP	endothelial cell proliferation	16175	549		0.8378378378378378	0.8421052631578947	135	16040	6	39	129	16001	16175	0.07256539396849421
M1	cpdb	0	network_modules	58	TRUE	0.0033727840975391883	309	45	8	0.17777777777777778	0.025889967637540454	GO:0048598	GO:BP	embryonic morphogenesis	16175	12865		0.8648648648648649	0.868421052631579	309	15866	8	37	301	15829	16175	0.0612247158115317
M1	cpdb	0	network_modules	58	TRUE	0.004090562733204939	140	40	6	0.15	0.04285714285714286	REAC:R-HSA-3781865	REAC	Diseases of glycosylation	10916	765		0.8787878787878788	0.8823529411764706	140	10776	6	34	134	10742	10916	0.07393335524433757
M1	cpdb	0	network_modules	58	TRUE	0.005805499215627785	205	31	6	0.1935483870967742	0.02926829268292683	KEGG:05205	KEGG	Proteoglycans in cancer	8484	457		0.75	0.7777777777777778	205	8279	6	25	199	8254	8484	0.06680143725432214
M1	cpdb	0	network_modules	58	TRUE	0.006158568349617164	14	40	3	0.075	0.21428571428571427	REAC:R-HSA-3656237	REAC	Defective EXT2 causes exostoses 2	10916	539		0.9090909090909091	0.9411764705882353	14	10902	3	37	11	10865	10916	0.1249143380394237
M1	cpdb	0	network_modules	58	TRUE	0.006158568349617164	14	40	3	0.075	0.21428571428571427	REAC:R-HSA-3656253	REAC	Defective EXT1 causes exostoses 1, TRPS2 and CHDS	10916	538		0.9090909090909091	0.9411764705882353	14	10902	3	37	11	10865	10916	0.1249143380394237
M1	cpdb	0	network_modules	58	TRUE	0.006210135042936434	150	45	6	0.13333333333333333	0.04	GO:0051897	GO:BP	positive regulation of phosphatidylinositol 3-kinase/protein kinase B signal transduction	16175	13981		0.8918918918918919	0.8947368421052632	150	16025	6	39	144	15986	16175	0.06836277149037923
M1	cpdb	0	network_modules	58	TRUE	0.006635217378250993	210	31	6	0.1935483870967742	0.02857142857142857	KEGG:04015	KEGG	Rap1 signaling pathway	8484	248		0.875	0.8888888888888888	210	8274	6	25	204	8249	8484	0.06579162157646842
M1	cpdb	0	network_modules	58	TRUE	0.006709422721178103	339	45	8	0.17777777777777778	0.02359882005899705	GO:0042060	GO:BP	wound healing	16175	9947		0.918918918918919	0.9210526315789473	339	15836	8	37	331	15799	16175	0.05782436286454884
M1	cpdb	0	network_modules	58	TRUE	0.007507220170117821	155	45	6	0.13333333333333333	0.03870967741935484	GO:0010594	GO:BP	regulation of endothelial cell migration	16175	4242		0.9459459459459459	0.9473684210526315	155	16020	6	39	149	15981	16175	0.06709400631899709
M1	cpdb	0	network_modules	58	TRUE	0.007678656110565988	15	40	3	0.075	0.2	REAC:R-HSA-75892	REAC	Platelet Adhesion to exposed collagen	10916	1760		0.9696969696969697	0.9705882352941176	15	10901	3	37	12	10864	10916	0.1205342764400132
M1	cpdb	0	network_modules	58	TRUE	0.00823681466161573	748	45	11	0.24444444444444444	0.014705882352941176	GO:0097435	GO:BP	supramolecular fiber organization	16175	18657		0.972972972972973	0.9736842105263158	748	15427	11	34	737	15393	16175	0.049847800578568136
M1	cpdb	0	network_modules	58	TRUE	0.008910741284643668	72	31	4	0.12903225806451613	0.05555555555555555	KEGG:05218	KEGG	Melanoma	8484	469		1	1	72	8412	4	27	68	8385	8484	0.07958145913076252
M1	cpdb	0	network_modules	58	TRUE	0.009265351982315307	249	45	7	0.15555555555555556	0.028112449799196786	GO:0050878	GO:BP	regulation of body fluid levels	16175	13323		1	1	249	15926	7	38	242	15888	16175	0.06013244315087897
M1	cpdb	0	network_modules	58	TRUE	0.009426650306752786	16	40	3	0.075	0.1875	REAC:R-HSA-190241	REAC	FGFR2 ligand binding and activation	10916	906		1	1	16	10900	3	37	13	10863	10916	0.11656694615548616
M1	cpdb	0	network_modules	59	TRUE	1.1859976875083684e-5	41	26	5	0.19230769230769232	0.12195121951219512	REAC:R-HSA-6782315	REAC	tRNA modification in the nucleus and cytosol	10916	2742		0	0.3333333333333333	41	10875	5	21	36	10854	10916	0.15061223015116368
M1	cpdb	0	network_modules	59	TRUE	5.931743814659379e-5	248	20	7	0.35	0.028225806451612902	KEGG:04144	KEGG	Endocytosis	8484	280		0	0.25	248	8236	7	13	241	8223	8484	0.09256259925320227
M1	cpdb	0	network_modules	59	TRUE	1.1502854409637165e-4	170	20	6	0.3	0.03529411764705882	KEGG:04530	KEGG	Tight junction	8484	317		0.3333333333333333	0.5	170	8314	6	14	164	8300	8484	0.0971175872211933
M1	cpdb	0	network_modules	59	TRUE	0.001253923390949768	103	26	5	0.19230769230769232	0.04854368932038835	REAC:R-HSA-72306	REAC	tRNA processing	10916	2743		0.5	0.6666666666666666	103	10813	5	21	98	10792	10916	0.09242549083855327
M1	cpdb	0	network_modules	59	TRUE	0.0017204385763701512	77	20	4	0.2	0.05194805194805195	KEGG:05100	KEGG	Bacterial invasion of epithelial cells	8484	423		0.6666666666666666	0.75	77	8407	4	16	73	8391	8484	0.0978639360249419
M1	cpdb	0	network_modules	59	TRUE	0.0041034409252754	96	20	4	0.2	0.041666666666666664	KEGG:04666	KEGG	Fc gamma R-mediated phagocytosis	8484	341		1	1	96	8388	4	16	92	8372	8484	0.08671603633995364
M1	cpdb	0	network_modules	59	TRUE	0.007726227540900469	24	26	3	0.11538461538461539	0.125	REAC:R-HSA-163560	REAC	Triglyceride catabolism	10916	2606		1	1	24	10892	3	23	21	10869	10916	0.11807815706818106
M1	cpdb	0	network_modules	59	TRUE	0.008909070713829088	182	41	6	0.14634146341463414	0.03296703296703297	GO:0006457	GO:BP	protein folding	16175	2203		0	0.5	182	15993	6	35	176	15958	16175	0.06456337490141673
M1	cpdb	0	network_modules	59	TRUE	0.009218774826399517	2	41	2	0.04878048780487805	1	GO:0106004	GO:BP	tRNA (guanine-N7)-methylation	16175	19204		1	1	2	16173	2	39	0	16134	16175	0.22059659391357025
M1	cpdb	0	network_modules	60	TRUE	0.0025976306122133075	223	16	5	0.3125	0.02242152466367713	KEGG:04024	KEGG	cAMP signaling pathway	8484	252		NA	1	223	8261	5	11	218	8250	8484	0.07776679870575248
M1	cpdb	0	network_modules	61	TRUE	3.364083528345401e-18	52	41	12	0.2926829268292683	0.23076923076923078	GO:0001836	GO:BP	release of cytochrome c from mitochondria	16175	493		0	0.02857142857142857	52	16123	12	29	40	16094	16175	0.25777529158435447
M1	cpdb	0	network_modules	61	TRUE	5.283739665245014e-17	91	41	13	0.3170731707317073	0.14285714285714285	GO:0008637	GO:BP	apoptotic mitochondrial changes	16175	3220		0.029411764705882353	0.05714285714285714	91	16084	13	28	78	16056	16175	0.20990940636173447
M1	cpdb	0	network_modules	61	TRUE	8.653169121577874e-13	24	41	8	0.1951219512195122	0.3333333333333333	GO:0090200	GO:BP	positive regulation of release of cytochrome c from mitochondria	16175	18102		0.058823529411764705	0.08571428571428572	24	16151	8	33	16	16118	16175	0.2536009370770286
M1	cpdb	0	network_modules	61	TRUE	1.4807125165825007e-12	9	24	6	0.25	0.6666666666666666	REAC:R-HSA-111453	REAC	BH3-only proteins associate with and inactivate anti-apoptotic BCL-2 members	10916	202		0	0.125	9	10907	6	18	3	10889	10916	0.40751800099121926
M1	cpdb	0	network_modules	61	TRUE	2.9500883906740264e-12	32	28	8	0.2857142857142857	0.25	KEGG:04215	KEGG	Apoptosis - multiple species	8484	292		0	0.14285714285714285	32	8452	8	20	24	8432	8484	0.26466893540391684
M1	cpdb	0	network_modules	61	TRUE	4.459350710441707e-11	54	24	8	0.3333333333333333	0.14814814814814814	REAC:R-HSA-109606	REAC	Intrinsic Pathway for Apoptosis	10916	1268		0.14285714285714285	0.25	54	10862	8	16	46	10846	10916	0.21970948333342488
M1	cpdb	0	network_modules	61	TRUE	1.0899684108730865e-10	41	41	8	0.1951219512195122	0.1951219512195122	GO:0090199	GO:BP	regulation of release of cytochrome c from mitochondria	16175	18101		0.08823529411764706	0.11428571428571428	41	16134	8	33	33	16101	16175	0.1930765811934802
M1	cpdb	0	network_modules	61	TRUE	1.9920326838257633e-10	364	41	14	0.34146341463414637	0.038461538461538464	GO:0007005	GO:BP	mitochondrion organization	16175	2617		0.11764705882352941	0.14285714285714285	364	15811	14	27	350	15784	16175	0.10841027374535031
M1	cpdb	0	network_modules	61	TRUE	2.0107873119842446e-10	44	41	8	0.1951219512195122	0.18181818181818182	GO:0097192	GO:BP	extrinsic apoptotic signaling pathway in absence of ligand	16175	18536		0.14705882352941177	0.17142857142857143	44	16131	8	33	36	16098	16175	0.1862160548150764
M1	cpdb	0	network_modules	61	TRUE	2.6728210561169014e-10	463	41	15	0.36585365853658536	0.032397408207343416	GO:0097190	GO:BP	apoptotic signaling pathway	16175	18534		0.17647058823529413	0.2	463	15712	15	26	448	15686	16175	0.10194928447310646
M1	cpdb	0	network_modules	61	TRUE	2.9496594296330333e-10	46	41	8	0.1951219512195122	0.17391304347826086	GO:0038034	GO:BP	signal transduction in absence of ligand	16175	9674		0.20588235294117646	0.22857142857142856	46	16129	8	33	38	16096	16175	0.1820171365755032
M1	cpdb	0	network_modules	61	TRUE	4.4906297905415153e-10	79	41	9	0.21951219512195122	0.11392405063291139	GO:0008630	GO:BP	intrinsic apoptotic signaling pathway in response to DNA damage	16175	3218		0.23529411764705882	0.2571428571428571	79	16096	9	32	70	16064	16175	0.15519555376671829
M1	cpdb	0	network_modules	61	TRUE	4.819517143000216e-10	135	28	10	0.35714285714285715	0.07407407407407407	KEGG:04210	KEGG	Apoptosis	8484	287		0.16666666666666666	0.2857142857142857	135	8349	10	18	125	8331	8484	0.15691374288392593
M1	cpdb	0	network_modules	61	TRUE	8.35733949689423e-10	244	41	12	0.2926829268292683	0.04918032786885246	GO:0097193	GO:BP	intrinsic apoptotic signaling pathway	16175	18537		0.2647058823529412	0.2857142857142857	244	15931	12	29	232	15902	16175	0.1148061004304297
M1	cpdb	0	network_modules	61	TRUE	7.440958533467302e-9	107	41	9	0.21951219512195122	0.08411214953271028	GO:0010821	GO:BP	regulation of mitochondrion organization	16175	4433		0.29411764705882354	0.3142857142857143	107	16068	9	32	98	16036	16175	0.13239208788030643
M1	cpdb	0	network_modules	61	TRUE	9.123050671493294e-9	385	41	13	0.3170731707317073	0.033766233766233764	GO:0043065	GO:BP	positive regulation of apoptotic process	16175	10511		0.3235294117647059	0.34285714285714286	385	15790	13	28	372	15762	16175	0.09698685840361052
M1	cpdb	0	network_modules	61	TRUE	1.0160106701223609e-8	30	24	6	0.25	0.2	REAC:R-HSA-114452	REAC	Activation of BH3-only proteins	10916	77		0.2857142857142857	0.375	30	10886	6	18	24	10868	10916	0.22169704106231383
M1	cpdb	0	network_modules	61	TRUE	1.5212998853941376e-8	401	41	13	0.3170731707317073	0.032418952618453865	GO:0043068	GO:BP	positive regulation of programmed cell death	16175	10514		0.35294117647058826	0.37142857142857144	401	15774	13	28	388	15746	16175	0.0947597483752393
M1	cpdb	0	network_modules	61	TRUE	1.568817045543581e-8	170	41	10	0.24390243902439024	0.058823529411764705	GO:0097191	GO:BP	extrinsic apoptotic signaling pathway	16175	18535		0.38235294117647056	0.4	170	16005	10	31	160	15974	16175	0.11537177856220501
M1	cpdb	0	network_modules	61	TRUE	7.094363345500178e-7	176	24	8	0.3333333333333333	0.045454545454545456	REAC:R-HSA-109581	REAC	Apoptosis	10916	158		0.42857142857142855	0.5	176	10740	8	16	168	10724	10916	0.11822355545223405
M1	cpdb	0	network_modules	61	TRUE	1.7503048751703258e-6	44	41	6	0.14634146341463414	0.13636363636363635	GO:2001244	GO:BP	positive regulation of intrinsic apoptotic signaling pathway	16175	26433		0.4117647058823529	0.42857142857142855	44	16131	6	35	38	16096	16175	0.13900384304301674
M1	cpdb	0	network_modules	61	TRUE	2.3938395123869103e-6	137	41	8	0.1951219512195122	0.058394160583941604	GO:2001242	GO:BP	regulation of intrinsic apoptotic signaling pathway	16175	26431		0.4411764705882353	0.45714285714285713	137	16038	8	33	129	16005	16175	0.10267451527141361
M1	cpdb	0	network_modules	61	TRUE	2.6538881464214765e-6	208	24	8	0.3333333333333333	0.038461538461538464	REAC:R-HSA-5357801	REAC	Programmed Cell Death	10916	1803		0.5714285714285714	0.625	208	10708	8	16	200	10692	10916	0.10790572290426485
M1	cpdb	0	network_modules	61	TRUE	3.629798709572677e-6	8	41	4	0.0975609756097561	0.5	GO:1902237	GO:BP	positive regulation of endoplasmic reticulum stress-induced intrinsic apoptotic signaling pathway	16175	22136		0.47058823529411764	0.4857142857142857	8	16167	4	37	4	16130	16175	0.2200768368267282
M1	cpdb	0	network_modules	61	TRUE	7.0425998607541296e-6	55	41	6	0.14634146341463414	0.10909090909090909	GO:0070059	GO:BP	intrinsic apoptotic signaling pathway in response to endoplasmic reticulum stress	16175	15896		0.5	0.5142857142857142	55	16120	6	35	49	16085	16175	0.12378231844090494
M1	cpdb	0	network_modules	61	TRUE	2.2890987723902237e-5	32	41	5	0.12195121951219512	0.15625	GO:1905898	GO:BP	positive regulation of response to endoplasmic reticulum stress	16175	24996		0.5294117647058824	0.5428571428571428	32	16143	5	36	27	16107	16175	0.13610719476186897
M1	cpdb	0	network_modules	61	TRUE	2.6249262121104477e-5	20	24	4	0.16666666666666666	0.2	REAC:R-HSA-6803204	REAC	TP53 Regulates Transcription of Genes Involved in Cytochrome C Release	10916	2458		0.7142857142857143	0.75	20	10896	4	20	16	10876	10916	0.18093179213255337
M1	cpdb	0	network_modules	61	TRUE	3.333326636785979e-5	275	41	9	0.21951219512195122	0.03272727272727273	GO:2001233	GO:BP	regulation of apoptotic signaling pathway	16175	26422		0.5588235294117647	0.5714285714285714	275	15900	9	32	266	15868	16175	0.07896745633402626
M1	cpdb	0	network_modules	61	TRUE	3.673776698829782e-5	13	41	4	0.0975609756097561	0.3076923076923077	GO:1900103	GO:BP	positive regulation of endoplasmic reticulum unfolded protein response	16175	20395		0.5882352941176471	0.6	13	16162	4	37	9	16125	16175	0.17211929286660982
M1	cpdb	0	network_modules	61	TRUE	5.7567598666859975e-5	56	28	5	0.17857142857142858	0.08928571428571429	KEGG:04340	KEGG	Hedgehog signaling pathway	8484	302		0.3333333333333333	0.42857142857142855	56	8428	5	23	51	8405	8484	0.12220684818827814
M1	cpdb	0	network_modules	61	TRUE	7.369468847326492e-5	40	41	5	0.12195121951219512	0.125	GO:0046902	GO:BP	regulation of mitochondrial membrane permeability	16175	12429		0.6176470588235294	0.6285714285714286	40	16135	5	36	35	16099	16175	0.12126616044517959
M1	cpdb	0	network_modules	61	TRUE	1.4172700339328776e-4	90	41	6	0.14634146341463414	0.06666666666666667	GO:2001235	GO:BP	positive regulation of apoptotic signaling pathway	16175	26424		0.6470588235294118	0.6571428571428571	90	16085	6	35	84	16050	16175	0.0954038939626949
M1	cpdb	0	network_modules	61	TRUE	1.702777801353928e-4	156	41	7	0.17073170731707318	0.04487179487179487	GO:0006839	GO:BP	mitochondrial transport	16175	2508		0.6764705882352942	0.6857142857142857	156	16019	7	34	149	15985	16175	0.08308951205198158
M1	cpdb	0	network_modules	61	TRUE	1.9600591080503447e-4	95	41	6	0.14634146341463414	0.06315789473684211	GO:0007006	GO:BP	mitochondrial membrane organization	16175	2618		0.7058823529411765	0.7142857142857143	95	16080	6	35	89	16045	16175	0.09266983519309668
M1	cpdb	0	network_modules	61	TRUE	2.0334981282130212e-4	72	28	5	0.17857142857142858	0.06944444444444445	KEGG:01524	KEGG	Platinum drug resistance	8484	198		0.5	0.5714285714285714	72	8412	5	23	67	8389	8484	0.10669571531722351
M1	cpdb	0	network_modules	61	TRUE	2.330612472498217e-4	74	28	5	0.17857142857142858	0.06756756756756757	KEGG:04115	KEGG	p53 signaling pathway	8484	269		0.6666666666666666	0.7142857142857143	74	8410	5	23	69	8387	8484	0.10511063301357203
M1	cpdb	0	network_modules	61	TRUE	2.577673945511734e-4	51	41	5	0.12195121951219512	0.09803921568627451	GO:0090559	GO:BP	regulation of membrane permeability	16175	18353		0.7352941176470589	0.7428571428571429	51	16124	5	36	46	16088	16175	0.10682024985583287
M1	cpdb	0	network_modules	61	TRUE	4.903325764263362e-4	86	28	5	0.17857142857142858	0.05813953488372093	KEGG:05210	KEGG	Colorectal cancer	8484	461		0.8333333333333334	0.8571428571428571	86	8398	5	23	81	8375	8484	0.09675905018275592
M1	cpdb	0	network_modules	61	TRUE	5.917883909352941e-4	798	41	12	0.2926829268292683	0.015037593984962405	GO:0006974	GO:BP	DNA damage response	16175	2601		0.7647058823529411	0.7714285714285715	798	15377	12	29	786	15348	16175	0.05664412673956778
M1	cpdb	0	network_modules	61	TRUE	7.100122719866452e-4	44	24	4	0.16666666666666666	0.09090909090909091	REAC:R-HSA-5633008	REAC	TP53 Regulates Transcription of Cell Death Genes	10916	2455		0.8571428571428571	0.875	44	10872	4	20	40	10852	10916	0.12048990218086543
M1	cpdb	0	network_modules	61	TRUE	7.500807514507593e-4	26	41	4	0.0975609756097561	0.15384615384615385	GO:1902235	GO:BP	regulation of endoplasmic reticulum stress-induced intrinsic apoptotic signaling pathway	16175	22134		0.7941176470588235	0.8	26	16149	4	37	22	16112	16175	0.12074433881771884
M1	cpdb	0	network_modules	61	TRUE	0.0012144732338539859	420	41	9	0.21951219512195122	0.02142857142857143	GO:0010638	GO:BP	positive regulation of organelle organization	16175	4284		0.8235294117647058	0.8285714285714286	420	15755	9	32	411	15723	16175	0.06135020064614564
M1	cpdb	0	network_modules	61	TRUE	0.0012339728528898998	8	41	3	0.07317073170731707	0.375	GO:1903896	GO:BP	positive regulation of IRE1-mediated unfolded protein response	16175	23363		0.8529411764705882	0.8571428571428571	8	16167	3	38	5	16129	16175	0.1647772836720596
M1	cpdb	0	network_modules	61	TRUE	0.001364947122735664	30	41	4	0.0975609756097561	0.13333333333333333	GO:1900101	GO:BP	regulation of endoplasmic reticulum unfolded protein response	16175	20393		0.8823529411764706	0.8857142857142857	30	16145	4	37	26	16108	16175	0.11213105069464156
M1	cpdb	0	network_modules	61	TRUE	0.0014299037347152072	2	24	2	0.08333333333333333	1	REAC:R-HSA-111452	REAC	Activation and oligomerization of BAK protein	10916	70		1	1	2	10914	2	22	0	10892	10916	0.2883840379923303
M1	cpdb	0	network_modules	61	TRUE	0.0018113593834347002	75	41	5	0.12195121951219512	0.06666666666666667	GO:1905897	GO:BP	regulation of response to endoplasmic reticulum stress	16175	24995		0.9117647058823529	0.9142857142857143	75	16100	5	36	70	16064	16175	0.0870508613273959
M1	cpdb	0	network_modules	61	TRUE	0.0031243129426689626	310	28	7	0.25	0.02258064516129032	KEGG:05206	KEGG	MicroRNAs in cancer	8484	458		1	1	310	8174	7	21	303	8153	8484	0.0654661521088167
M1	cpdb	0	network_modules	61	TRUE	0.00665357599134592	173	41	6	0.14634146341463414	0.03468208092485549	GO:0031334	GO:BP	positive regulation of protein-containing complex assembly	16175	7125		0.9411764705882353	0.9428571428571428	173	16002	6	35	167	15967	16175	0.06647553241110758
M1	cpdb	0	network_modules	61	TRUE	0.007219924584287029	45	41	4	0.0975609756097561	0.08888888888888889	GO:0051881	GO:BP	regulation of mitochondrial membrane potential	16175	13966		0.9705882352941176	0.9714285714285714	45	16130	4	37	41	16093	16175	0.09070963835435701
M1	cpdb	0	network_modules	61	TRUE	0.009903066023324013	15	41	3	0.07317073170731707	0.2	GO:1903894	GO:BP	regulation of IRE1-mediated unfolded protein response	16175	23361		1	1	15	16160	3	38	12	16122	16175	0.11964564862587004
M1	cpdb	0	network_modules	63	TRUE	1.2236223449790991e-14	12	22	7	0.3181818181818182	0.5833333333333334	REAC:R-HSA-4641265	REAC	Repression of WNT target genes	10916	2063		0	0.1111111111111111	12	10904	7	15	5	10889	10916	0.43000146074991524
M1	cpdb	0	network_modules	63	TRUE	4.020066866584787e-10	42	22	7	0.3181818181818182	0.16666666666666666	REAC:R-HSA-3769402	REAC	Deactivation of the beta-catenin transactivating complex	10916	452		0.125	0.2222222222222222	42	10874	7	15	35	10859	10916	0.22816739485799423
M1	cpdb	0	network_modules	63	TRUE	5.8878600409602454e-8	83	22	7	0.3181818181818182	0.08433734939759036	REAC:R-HSA-195253	REAC	Degradation of beta-catenin by the destruction complex	10916	724		0.25	0.3333333333333333	83	10833	7	15	76	10818	10916	0.16067150924862111
M1	cpdb	0	network_modules	63	TRUE	1.0505853863411494e-7	90	22	7	0.3181818181818182	0.07777777777777778	REAC:R-HSA-201722	REAC	Formation of the beta-catenin:TCF transactivating complex	10916	968		0.375	0.4444444444444444	90	10826	7	15	83	10811	10916	0.15402790085180576
M1	cpdb	0	network_modules	63	TRUE	1.7207019009418917e-7	174	20	8	0.4	0.04597701149425287	KEGG:04310	KEGG	Wnt signaling pathway	8484	299		0	0.2	174	8310	8	12	166	8298	8484	0.13015293113557053
M1	cpdb	0	network_modules	63	TRUE	4.3990285809047264e-5	327	22	8	0.36363636363636365	0.024464831804281346	REAC:R-HSA-195721	REAC	Signaling by WNT	10916	2314		0.5	0.5555555555555556	327	10589	8	14	319	10575	10916	0.08796510903130696
M1	cpdb	0	network_modules	63	TRUE	5.6822865695920784e-5	309	39	9	0.23076923076923078	0.02912621359223301	GO:0048598	GO:BP	embryonic morphogenesis	16175	12865		0	0.05555555555555555	309	15866	9	30	300	15836	16175	0.07601794468303005
M1	cpdb	0	network_modules	63	TRUE	5.792062094786982e-5	543	39	11	0.28205128205128205	0.020257826887661142	GO:0009887	GO:BP	animal organ morphogenesis	16175	3747		0.058823529411764705	0.1111111111111111	543	15632	11	28	532	15604	16175	0.06782106013917001
M1	cpdb	0	network_modules	63	TRUE	7.526685589844922e-5	231	22	7	0.3181818181818182	0.030303030303030304	REAC:R-HSA-201681	REAC	TCF dependent signaling in response to WNT	10916	2421		0.625	0.6666666666666666	231	10685	7	15	224	10670	10916	0.09274146349534151
M1	cpdb	0	network_modules	63	TRUE	0.00013177416819013259	8	22	3	0.13636363636363635	0.375	REAC:R-HSA-4411364	REAC	Binding of TCF/LEF:CTNNB1 to target gene promoters	10916	225		0.75	0.8888888888888888	8	10908	3	19	5	10889	10916	0.22522772086011703
M1	cpdb	0	network_modules	63	TRUE	0.00013177416819013259	8	22	3	0.13636363636363635	0.375	REAC:R-HSA-8951430	REAC	RUNX3 regulates WNT signaling	10916	1936		0.75	0.8888888888888888	8	10908	3	19	5	10889	10916	0.22522772086011703
M1	cpdb	0	network_modules	63	TRUE	1.459438151467765e-4	345	39	9	0.23076923076923078	0.02608695652173913	GO:0016055	GO:BP	Wnt signaling pathway	16175	5087		0.11764705882352941	0.16666666666666666	345	15830	9	30	336	15800	16175	0.07126697316594381
M1	cpdb	0	network_modules	63	TRUE	2.1526141728244304e-4	257	39	8	0.20512820512820512	0.0311284046692607	GO:0060070	GO:BP	canonical Wnt signaling pathway	16175	14332		0.17647058823529413	0.2222222222222222	257	15918	8	31	249	15887	16175	0.07440114217525637
M1	cpdb	0	network_modules	63	TRUE	3.7857454887827775e-4	512	39	10	0.2564102564102564	0.01953125	GO:0009790	GO:BP	embryo development	16175	3677		0.23529411764705882	0.2777777777777778	512	15663	10	29	502	15634	16175	0.06311293800401525
M1	cpdb	0	network_modules	63	TRUE	6.360994168611218e-4	60	20	4	0.2	0.06666666666666667	KEGG:04330	KEGG	Notch signaling pathway	8484	301		0.25	0.4	60	8424	4	16	56	8408	8484	0.11191491844733541
M1	cpdb	0	network_modules	63	TRUE	0.0014219889984516303	225	39	7	0.1794871794871795	0.03111111111111111	GO:0003002	GO:BP	regionalization	16175	1453		0.29411764705882354	0.3333333333333333	225	15950	7	32	218	15918	16175	0.06950348727122244
M1	cpdb	0	network_modules	63	TRUE	0.0017452620275907388	59	22	4	0.18181818181818182	0.06779661016949153	REAC:R-HSA-4086398	REAC	Ca2+ pathway	10916	296		1	1	59	10857	4	18	55	10839	10916	0.10812634213743627
M1	cpdb	0	network_modules	63	TRUE	0.001831216866384666	146	39	6	0.15384615384615385	0.0410958904109589	GO:0030178	GO:BP	negative regulation of Wnt signaling pathway	16175	6698		0.35294117647058826	0.3888888888888889	146	16029	6	33	140	15996	16175	0.07527957999525198
M1	cpdb	0	network_modules	63	TRUE	0.0028733936613877563	250	39	7	0.1794871794871795	0.028	GO:0007389	GO:BP	pattern specification process	16175	2889		0.4117647058823529	0.4444444444444444	250	15925	7	32	243	15893	16175	0.06537255575164087
M1	cpdb	0	network_modules	63	TRUE	0.0029525116245140226	38	39	4	0.10256410256410256	0.10526315789473684	GO:2000027	GO:BP	regulation of animal organ morphogenesis	16175	25390		0.47058823529411764	0.5	38	16137	4	35	34	16102	16175	0.10176707876190151
M1	cpdb	0	network_modules	63	TRUE	0.003102904737335309	11	39	3	0.07692307692307693	0.2727272727272727	GO:0051256	GO:BP	mitotic spindle midzone assembly	16175	13603		0.5294117647058824	0.5555555555555556	11	16164	3	36	8	16128	16175	0.14378313524319236
M1	cpdb	0	network_modules	63	TRUE	0.003623024839651367	93	20	4	0.2	0.043010752688172046	KEGG:04520	KEGG	Adherens junction	8484	316		0.5	0.6	93	8391	4	16	89	8375	8484	0.08825291210018536
M1	cpdb	0	network_modules	63	TRUE	0.004130302474991433	12	39	3	0.07692307692307693	0.25	GO:0051255	GO:BP	spindle midzone assembly	16175	13602		0.5882352941176471	0.6666666666666666	12	16163	3	36	9	16127	16175	0.13755449933414057
M1	cpdb	0	network_modules	63	TRUE	0.004130302474991433	12	39	3	0.07692307692307693	0.25	GO:0000022	GO:BP	mitotic spindle elongation	16175	8		0.5882352941176471	0.6666666666666666	12	16163	3	36	9	16127	16175	0.13755449933414057
M1	cpdb	0	network_modules	63	TRUE	0.005005351934184812	101	20	4	0.2	0.039603960396039604	KEGG:04916	KEGG	Melanogenesis	8484	373		0.75	0.8	101	8383	4	16	97	8367	8484	0.08430342347876404
M1	cpdb	0	network_modules	63	TRUE	0.005228888500744766	37	20	3	0.15	0.08108108108108109	KEGG:05216	KEGG	Thyroid cancer	8484	467		1	1	37	8447	3	17	34	8430	8484	0.10743677441529953
M1	cpdb	0	network_modules	63	TRUE	0.005360433761152209	13	39	3	0.07692307692307693	0.23076923076923078	GO:0051231	GO:BP	spindle elongation	16175	13582		0.7058823529411765	0.7777777777777778	13	16162	3	36	10	16126	16175	0.13205492223235
M1	cpdb	0	network_modules	63	TRUE	0.005360433761152209	13	39	3	0.07692307692307693	0.23076923076923078	GO:0072074	GO:BP	kidney mesenchyme development	16175	17108		0.7058823529411765	0.7777777777777778	13	16162	3	36	10	16126	16175	0.13205492223235
M1	cpdb	0	network_modules	63	TRUE	0.005666680548312387	277	39	7	0.1794871794871795	0.02527075812274368	GO:0030111	GO:BP	regulation of Wnt signaling pathway	16175	6681		0.8235294117647058	0.8333333333333334	277	15898	7	32	270	15866	16175	0.06152503580294009
M1	cpdb	0	network_modules	63	TRUE	0.006541103264082396	701	39	10	0.2564102564102564	0.014265335235378032	GO:0060429	GO:BP	epithelium development	16175	14627		0.8823529411764706	0.8888888888888888	701	15474	10	29	691	15445	16175	0.051445129032487186
M1	cpdb	0	network_modules	63	TRUE	0.00833062456873419	2	39	2	0.05128205128205128	1	GO:0072095	GO:BP	regulation of branch elongation involved in ureteric bud branching	16175	17128		0.9411764705882353	0.9444444444444444	2	16173	2	37	0	16136	16175	0.22619622029119613
M1	cpdb	0	network_modules	63	TRUE	0.00849952942409849	15	39	3	0.07692307692307693	0.2	GO:0090189	GO:BP	regulation of branching involved in ureteric bud morphogenesis	16175	18095		1	1	15	16160	3	36	12	16124	16175	0.12274434022930093
M1	cpdb	0	network_modules	64	TRUE	4.869728723078281e-20	182	34	18	0.5294117647058824	0.0989010989010989	KEGG:04621	KEGG	NOD-like receptor signaling pathway	8484	326		0	0.1	182	8302	18	16	164	8286	8484	0.2223893034454171
M1	cpdb	0	network_modules	64	TRUE	6.196525372723124e-18	594	37	21	0.5675675675675675	0.03535353535353535	GO:0006954	GO:BP	inflammatory response	16175	2585		0	0.012048192771084338	594	15581	21	16	573	15565	16175	0.13514391937145986
M1	cpdb	0	network_modules	64	TRUE	2.870929946047816e-16	81	37	12	0.32432432432432434	0.14814814814814814	GO:0032651	GO:BP	regulation of interleukin-1 beta production	16175	7698		0.012195121951219513	0.03614457831325301	81	16094	12	25	69	16069	16175	0.21660440241632908
M1	cpdb	0	network_modules	64	TRUE	2.870929946047816e-16	81	37	12	0.32432432432432434	0.14814814814814814	GO:0032611	GO:BP	interleukin-1 beta production	16175	7659		0.012195121951219513	0.03614457831325301	81	16094	12	25	69	16069	16175	0.21660440241632908
M1	cpdb	0	network_modules	64	TRUE	1.4497853972709492e-15	92	37	12	0.32432432432432434	0.13043478260869565	GO:0032612	GO:BP	interleukin-1 production	16175	7660		0.036585365853658534	0.060240963855421686	92	16083	12	25	80	16058	16175	0.20287961928572268
M1	cpdb	0	network_modules	64	TRUE	1.4497853972709492e-15	92	37	12	0.32432432432432434	0.13043478260869565	GO:0032652	GO:BP	regulation of interleukin-1 production	16175	7699		0.036585365853658534	0.060240963855421686	92	16083	12	25	80	16058	16175	0.20287961928572268
M1	cpdb	0	network_modules	64	TRUE	2.892773423173065e-14	55	29	10	0.3448275862068966	0.18181818181818182	REAC:R-HSA-168643	REAC	Nucleotide-binding domain, leucine rich repeat containing receptor (NLR) signaling pathways	10916	1628		0	0.045454545454545456	55	10861	10	19	45	10842	10916	0.2476860912382989
M1	cpdb	0	network_modules	64	TRUE	5.5370225359717094e-14	56	37	10	0.2702702702702703	0.17857142857142858	GO:0032731	GO:BP	positive regulation of interleukin-1 beta production	16175	7776		0.06097560975609756	0.07228915662650602	56	16119	10	27	46	16092	16175	0.21749851976045237
M1	cpdb	0	network_modules	64	TRUE	1.1713502381402182e-13	12	29	7	0.2413793103448276	0.5833333333333334	REAC:R-HSA-6803207	REAC	TP53 Regulates Transcription of Caspase Activators and Caspases	10916	2453		0.047619047619047616	0.09090909090909091	12	10904	7	22	5	10882	10916	0.3742333654535654
M1	cpdb	0	network_modules	64	TRUE	1.9663476320843447e-13	63	37	10	0.2702702702702703	0.15873015873015872	GO:0032732	GO:BP	positive regulation of interleukin-1 production	16175	7777		0.07317073170731707	0.08433734939759036	63	16112	10	27	53	16085	16175	0.2047714292881118
M1	cpdb	0	network_modules	64	TRUE	2.700889539419854e-12	299	37	14	0.3783783783783784	0.046822742474916385	GO:0050727	GO:BP	regulation of inflammatory response	16175	13226		0.08536585365853659	0.0963855421686747	299	15876	14	23	285	15853	16175	0.1279344865237978
M1	cpdb	0	network_modules	64	TRUE	2.0268459736365685e-11	654	37	17	0.4594594594594595	0.02599388379204893	GO:0031347	GO:BP	regulation of defense response	16175	7138		0.0975609756097561	0.10843373493975904	654	15521	17	20	637	15501	16175	0.10186224918955102
M1	cpdb	0	network_modules	64	TRUE	2.4863494379645257e-10	634	37	16	0.43243243243243246	0.025236593059936908	GO:0001817	GO:BP	regulation of cytokine production	16175	474		0.10975609756097561	0.12048192771084337	634	15541	16	21	618	15520	16175	0.09702633190518258
M1	cpdb	0	network_modules	64	TRUE	2.738982294949489e-10	638	37	16	0.43243243243243246	0.025078369905956112	GO:0001816	GO:BP	cytokine production	16175	473		0.12195121951219512	0.13253012048192772	638	15537	16	21	622	15516	16175	0.09667331218729111
M1	cpdb	0	network_modules	64	TRUE	3.219275861672865e-10	423	37	14	0.3783783783783784	0.03309692671394799	GO:0031349	GO:BP	positive regulation of defense response	16175	7140		0.13414634146341464	0.14457831325301204	423	15752	14	23	409	15729	16175	0.10568291737515442
M1	cpdb	0	network_modules	64	TRUE	1.1847335128749583e-9	33	37	7	0.1891891891891892	0.21212121212121213	GO:0070269	GO:BP	pyroptotic inflammatory response	16175	16029		0.14634146341463414	0.1566265060240964	33	16142	7	30	26	16112	16175	0.19859676683709224
M1	cpdb	0	network_modules	64	TRUE	1.7920286942379747e-9	8	29	5	0.1724137931034483	0.625	REAC:R-HSA-9012546	REAC	Interleukin-18 signaling	10916	1239		0.09523809523809523	0.13636363636363635	8	10908	5	24	3	10884	10916	0.3274258006711434
M1	cpdb	0	network_modules	64	TRUE	2.3037302754001746e-9	36	37	7	0.1891891891891892	0.19444444444444445	GO:0140632	GO:BP	canonical inflammasome complex assembly	16175	19839		0.15853658536585366	0.1686746987951807	36	16139	7	30	29	16109	16175	0.1899711445238283
M1	cpdb	0	network_modules	64	TRUE	3.266193177123301e-9	227	37	11	0.2972972972972973	0.048458149779735685	GO:0002221	GO:BP	pattern recognition receptor signaling pathway	16175	755		0.17073170731707318	0.18072289156626506	227	15948	11	26	216	15922	16175	0.11530404820322755
M1	cpdb	0	network_modules	64	TRUE	3.930692145480556e-9	403	37	13	0.35135135135135137	0.03225806451612903	GO:0001819	GO:BP	positive regulation of cytokine production	16175	476		0.18292682926829268	0.1927710843373494	403	15772	13	24	390	15748	16175	0.10028198314174702
M1	cpdb	0	network_modules	64	TRUE	4.2240566527949285e-9	39	37	7	0.1891891891891892	0.1794871794871795	GO:0141084	GO:BP	inflammasome-mediated signaling pathway	16175	20015		0.1951219512195122	0.20481927710843373	39	16136	7	30	32	16106	16175	0.18235425943051972
M1	cpdb	0	network_modules	64	TRUE	5.355766621589217e-9	44	29	7	0.2413793103448276	0.1590909090909091	REAC:R-HSA-5633008	REAC	TP53 Regulates Transcription of Cell Death Genes	10916	2455		0.14285714285714285	0.18181818181818182	44	10872	7	22	37	10850	10916	0.1933365214357685
M1	cpdb	0	network_modules	64	TRUE	6.858164088351037e-9	243	37	11	0.2972972972972973	0.04526748971193416	GO:0002758	GO:BP	innate immune response-activating signaling pathway	16175	1269		0.2073170731707317	0.21686746987951808	243	15932	11	26	232	15906	16175	0.11110997812488511
M1	cpdb	0	network_modules	64	TRUE	7.011611703206968e-9	531	37	14	0.3783783783783784	0.026365348399246705	GO:0032103	GO:BP	positive regulation of response to external stimulus	16175	7367		0.21951219512195122	0.2289156626506024	531	15644	14	23	517	15621	16175	0.09285599601757528
M1	cpdb	0	network_modules	64	TRUE	1.3567264582754302e-8	345	37	12	0.32432432432432434	0.034782608695652174	GO:0051090	GO:BP	regulation of DNA-binding transcription factor activity	16175	13485		0.23170731707317074	0.24096385542168675	345	15830	12	25	333	15805	16175	0.1004166928422863
M1	cpdb	0	network_modules	64	TRUE	1.6172572773522e-8	263	37	11	0.2972972972972973	0.04182509505703422	GO:0002218	GO:BP	activation of innate immune response	16175	753		0.24390243902439024	0.25301204819277107	263	15912	11	26	252	15886	16175	0.10640070907940713
M1	cpdb	0	network_modules	64	TRUE	4.0370162050438736e-8	151	29	9	0.3103448275862069	0.059602649006622516	REAC:R-HSA-446652	REAC	Interleukin-1 family signaling	10916	1231		0.19047619047619047	0.22727272727272727	151	10765	9	20	142	10745	10916	0.13102527604531325
M1	cpdb	0	network_modules	64	TRUE	5.021591691282703e-8	386	37	12	0.32432432432432434	0.031088082901554404	GO:0045088	GO:BP	regulation of innate immune response	16175	11271		0.25609756097560976	0.26506024096385544	386	15789	12	25	374	15764	16175	0.09426196321686364
M1	cpdb	0	network_modules	64	TRUE	6.03091024375407e-8	149	37	9	0.24324324324324326	0.06040268456375839	GO:0002753	GO:BP	cytoplasmic pattern recognition receptor signaling pathway	16175	1264		0.2682926829268293	0.27710843373493976	149	16026	9	28	140	15998	16175	0.11729753958283924
M1	cpdb	0	network_modules	64	TRUE	1.291063672816687e-7	319	37	11	0.2972972972972973	0.034482758620689655	GO:0045089	GO:BP	positive regulation of innate immune response	16175	11272		0.2804878048780488	0.2891566265060241	319	15856	11	26	308	15830	16175	0.09558929826343927
M1	cpdb	0	network_modules	64	TRUE	1.3057435149927268e-7	36	29	6	0.20689655172413793	0.16666666666666666	REAC:R-HSA-168638	REAC	NOD1/2 Signaling Pathway	10916	1529		0.23809523809523808	0.2727272727272727	36	10880	6	23	30	10857	10916	0.18328106085767792
M1	cpdb	0	network_modules	64	TRUE	1.3101005808406633e-7	32	37	6	0.16216216216216217	0.1875	GO:2000116	GO:BP	regulation of cysteine-type endopeptidase activity	16175	25465		0.2926829268292683	0.30120481927710846	32	16143	6	31	26	16112	16175	0.17261231482132644
M1	cpdb	0	network_modules	64	TRUE	1.9379670183697194e-7	34	37	6	0.16216216216216217	0.17647058823529413	GO:0044546	GO:BP	NLRP3 inflammasome complex assembly	16175	11065		0.3048780487804878	0.3132530120481928	34	16141	6	31	28	16110	16175	0.16733964600243717
M1	cpdb	0	network_modules	64	TRUE	2.4714570872509857e-7	339	37	11	0.2972972972972973	0.032448377581120944	GO:0002833	GO:BP	positive regulation of response to biotic stimulus	16175	1343		0.3170731707317073	0.3253012048192771	339	15836	11	26	328	15810	16175	0.09237191056498271
M1	cpdb	0	network_modules	64	TRUE	3.0316092458311404e-7	451	37	12	0.32432432432432434	0.026607538802660754	GO:0002831	GO:BP	regulation of response to biotic stimulus	16175	1341		0.32926829268292684	0.3373493975903614	451	15724	12	25	439	15699	16175	0.08621640970227665
M1	cpdb	0	network_modules	64	TRUE	4.094877944876714e-7	721	37	14	0.3783783783783784	0.019417475728155338	GO:0045087	GO:BP	innate immune response	16175	11270		0.34146341463414637	0.3493975903614458	721	15454	14	23	707	15431	16175	0.07745027917937256
M1	cpdb	0	network_modules	64	TRUE	4.853298564417666e-7	20	29	5	0.1724137931034483	0.25	REAC:R-HSA-622312	REAC	Inflammasomes	10916	1184		0.2857142857142857	0.3181818181818182	20	10896	5	24	15	10872	10916	0.20586954482231654
M1	cpdb	0	network_modules	64	TRUE	4.909041809964765e-7	124	37	8	0.21621621621621623	0.06451612903225806	GO:0051092	GO:BP	positive regulation of NF-kappaB transcription factor activity	16175	13487		0.35365853658536583	0.37349397590361444	124	16051	8	29	116	16022	16175	0.11449031094405185
M1	cpdb	0	network_modules	64	TRUE	4.909041809964765e-7	124	37	8	0.21621621621621623	0.06451612903225806	GO:0050729	GO:BP	positive regulation of inflammatory response	16175	13228		0.35365853658536583	0.37349397590361444	124	16051	8	29	116	16022	16175	0.11449031094405185
M1	cpdb	0	network_modules	64	TRUE	7.621398443507989e-7	756	37	14	0.3783783783783784	0.018518518518518517	GO:0050776	GO:BP	regulation of immune response	16175	13250		0.3780487804878049	0.3855421686746988	756	15419	14	23	742	15396	16175	0.0752311421837157
M1	cpdb	0	network_modules	64	TRUE	9.612356610583486e-7	627	37	13	0.35135135135135137	0.02073365231259968	GO:0050778	GO:BP	positive regulation of immune response	16175	13252		0.3902439024390244	0.39759036144578314	627	15548	13	24	614	15524	16175	0.07753920097724905
M1	cpdb	0	network_modules	64	TRUE	1.9658896717831917e-6	49	37	6	0.16216216216216217	0.12244897959183673	GO:0010803	GO:BP	regulation of tumor necrosis factor-mediated signaling pathway	16175	4417		0.4024390243902439	0.40963855421686746	49	16126	6	31	43	16095	16175	0.13864960005784213
M1	cpdb	0	network_modules	64	TRUE	2.1571584062211882e-6	416	37	11	0.2972972972972973	0.026442307692307692	GO:0002757	GO:BP	immune response-activating signaling pathway	16175	1268		0.4146341463414634	0.42168674698795183	416	15759	11	26	405	15733	16175	0.0821494841890424
M1	cpdb	0	network_modules	64	TRUE	2.4948705856250734e-6	27	29	5	0.1724137931034483	0.18518518518518517	REAC:R-HSA-5620971	REAC	Pyroptosis	10916	1831		0.3333333333333333	0.36363636363636365	27	10889	5	24	22	10865	10916	0.1765749396275095
M1	cpdb	0	network_modules	64	TRUE	3.6160681419100814e-6	437	37	11	0.2972972972972973	0.02517162471395881	GO:0002764	GO:BP	immune response-regulating signaling pathway	16175	1275		0.4268292682926829	0.43373493975903615	437	15738	11	26	426	15712	16175	0.07982137273193221
M1	cpdb	0	network_modules	64	TRUE	5.51027995002785e-6	56	34	6	0.17647058823529413	0.10714285714285714	KEGG:05134	KEGG	Legionellosis	8484	431		0.1111111111111111	0.2	56	8428	6	28	50	8400	8484	0.13306749766958303
M1	cpdb	0	network_modules	64	TRUE	5.9358758169606494e-6	27	37	5	0.13513513513513514	0.18518518518518517	GO:0032692	GO:BP	negative regulation of interleukin-1 production	16175	7738		0.43902439024390244	0.4457831325301205	27	16148	5	32	22	16116	16175	0.15654865412321875
M1	cpdb	0	network_modules	64	TRUE	7.769720482247317e-6	10	37	4	0.10810810810810811	0.4	GO:0035655	GO:BP	interleukin-18-mediated signaling pathway	16175	9141		0.45121951219512196	0.4819277108433735	10	16165	4	33	6	16132	16175	0.20706179727743715
M1	cpdb	0	network_modules	64	TRUE	7.769720482247317e-6	10	37	4	0.10810810810810811	0.4	GO:0070673	GO:BP	response to interleukin-18	16175	16254		0.45121951219512196	0.4819277108433735	10	16165	4	33	6	16132	16175	0.20706179727743715
M1	cpdb	0	network_modules	64	TRUE	7.769720482247317e-6	10	37	4	0.10810810810810811	0.4	GO:0071351	GO:BP	cellular response to interleukin-18	16175	16603		0.45121951219512196	0.4819277108433735	10	16165	4	33	6	16132	16175	0.20706179727743715
M1	cpdb	0	network_modules	64	TRUE	8.632787936952597e-6	475	37	11	0.2972972972972973	0.023157894736842106	GO:0002253	GO:BP	activation of immune response	16175	785		0.4878048780487805	0.4939759036144578	475	15700	11	26	464	15674	16175	0.07598828022973006
M1	cpdb	0	network_modules	64	TRUE	1.2282619526204236e-5	625	37	12	0.32432432432432434	0.0192	GO:1901652	GO:BP	response to peptide	16175	21619		0.5	0.5180722891566265	625	15550	12	25	613	15525	16175	0.07097439340703045
M1	cpdb	0	network_modules	64	TRUE	1.2282619526204236e-5	625	37	12	0.32432432432432434	0.0192	GO:0034097	GO:BP	response to cytokine	16175	8408		0.5	0.5180722891566265	625	15550	12	25	613	15525	16175	0.07097439340703045
M1	cpdb	0	network_modules	64	TRUE	1.616488696155643e-5	208	29	8	0.27586206896551724	0.038461538461538464	REAC:R-HSA-5357801	REAC	Programmed Cell Death	10916	1803		0.38095238095238093	0.4090909090909091	208	10708	8	21	200	10687	10916	0.09694607224943486
M1	cpdb	0	network_modules	64	TRUE	1.7278739479787726e-5	33	37	5	0.13513513513513514	0.15151515151515152	GO:1900225	GO:BP	regulation of NLRP3 inflammasome complex assembly	16175	20497		0.524390243902439	0.5301204819277109	33	16142	5	32	28	16110	16175	0.14123626714797458
M1	cpdb	0	network_modules	64	TRUE	2.6324711999602618e-5	13	37	4	0.10810810810810811	0.3076923076923077	GO:1900226	GO:BP	negative regulation of NLRP3 inflammasome complex assembly	16175	20498		0.5365853658536586	0.54216867469879515	13	16162	4	33	9	16129	16175	0.18130867896924197
M1	cpdb	0	network_modules	64	TRUE	2.731051023023344e-5	36	37	5	0.13513513513513514	0.1388888888888889	GO:0141085	GO:BP	regulation of inflammasome-mediated signaling pathway	16175	20016		0.5487804878048781	0.5542168674698795	36	16139	5	32	31	16107	16175	0.13504754317838358
M1	cpdb	0	network_modules	64	TRUE	2.954741240454468e-5	208	37	8	0.21621621621621623	0.038461538461538464	GO:0051091	GO:BP	positive regulation of DNA-binding transcription factor activity	16175	13486		0.5609756097560976	0.5662650602409639	208	15967	8	29	200	15938	16175	0.08642428684722601
M1	cpdb	0	network_modules	64	TRUE	3.1040562087311063e-5	302	37	9	0.24324324324324326	0.029801324503311258	GO:0030522	GO:BP	intracellular receptor signaling pathway	16175	6836		0.573170731707317	0.5783132530120482	302	15873	9	28	293	15845	16175	0.07944083545620653
M1	cpdb	0	network_modules	64	TRUE	3.1829631364904995e-5	77	37	6	0.16216216216216217	0.07792207792207792	GO:0052548	GO:BP	regulation of endopeptidase activity	16175	14134		0.5853658536585366	0.5903614457831325	77	16098	6	31	71	16067	16175	0.10949605474938381
M1	cpdb	0	network_modules	64	TRUE	3.674213062784824e-5	419	37	10	0.2702702702702703	0.02386634844868735	GO:0019221	GO:BP	cytokine-mediated signaling pathway	16175	5598		0.5975609756097561	0.6024096385542169	419	15756	10	27	409	15729	16175	0.07365992136766875
M1	cpdb	0	network_modules	64	TRUE	4.311341259228586e-5	555	37	11	0.2972972972972973	0.01981981981981982	GO:0071345	GO:BP	cellular response to cytokine stimulus	16175	16597		0.6097560975609756	0.6144578313253012	555	15620	11	26	544	15594	16175	0.0691774280683994
M1	cpdb	0	network_modules	64	TRUE	5.00923364621717e-5	15	37	4	0.10810810810810811	0.26666666666666666	GO:0141086	GO:BP	negative regulation of inflammasome-mediated signaling pathway	16175	20017		0.6219512195121951	0.6265060240963856	15	16160	4	33	11	16127	16175	0.1686051298987469
M1	cpdb	0	network_modules	64	TRUE	5.39442461165578e-5	84	37	6	0.16216216216216217	0.07142857142857142	GO:0033209	GO:BP	tumor necrosis factor-mediated signaling pathway	16175	8075		0.6341463414634146	0.6385542168674698	84	16091	6	31	78	16060	16175	0.10456899254962054
M1	cpdb	0	network_modules	64	TRUE	5.961987247900512e-5	197	34	8	0.23529411764705882	0.04060913705583756	KEGG:05130	KEGG	Pathogenic Escherichia coli infection	8484	427		0.2222222222222222	0.3	197	8287	8	26	189	8261	8484	0.08932381908002761
M1	cpdb	0	network_modules	64	TRUE	6.21576517234909e-5	443	37	10	0.2702702702702703	0.022573363431151242	GO:0009617	GO:BP	response to bacterium	16175	3543		0.6463414634146342	0.6506024096385542	443	15732	10	27	433	15705	16175	0.07125615384917705
M1	cpdb	0	network_modules	64	TRUE	6.247562719830255e-5	135	34	7	0.20588235294117646	0.05185185185185185	KEGG:04210	KEGG	Apoptosis	8484	287		0.3333333333333333	0.4	135	8349	7	27	128	8322	8484	0.09629700504895919
M1	cpdb	0	network_modules	64	TRUE	8.147635969219425e-5	21	29	4	0.13793103448275862	0.19047619047619047	REAC:R-HSA-9008059	REAC	Interleukin-37 signaling	10916	1250		0.42857142857142855	0.45454545454545453	21	10895	4	25	17	10870	10916	0.1601943588154428
M1	cpdb	0	network_modules	64	TRUE	1.0205034152730434e-4	244	37	8	0.21621621621621623	0.03278688524590164	GO:0042742	GO:BP	defense response to bacterium	16175	10335		0.6585365853658537	0.6626506024096386	244	15931	8	29	236	15902	16175	0.07901023015327274
M1	cpdb	0	network_modules	64	TRUE	1.3089533771618833e-4	252	37	8	0.21621621621621623	0.031746031746031744	GO:0043122	GO:BP	regulation of canonical NF-kappaB signal transduction	16175	10541		0.6707317073170732	0.6746987951807228	252	15923	8	29	244	15894	16175	0.07757428414617006
M1	cpdb	0	network_modules	64	TRUE	1.3376887491374395e-4	58	29	5	0.1724137931034483	0.08620689655172414	REAC:R-HSA-5218859	REAC	Regulated Necrosis	10916	1959		0.47619047619047616	0.5	58	10858	5	24	53	10834	10916	0.11863073643570037
M1	cpdb	0	network_modules	64	TRUE	1.3986538492593212e-4	483	37	10	0.2702702702702703	0.020703933747412008	GO:0051604	GO:BP	protein maturation	16175	13821		0.6829268292682927	0.6867469879518072	483	15692	10	27	473	15665	16175	0.06763305078554414
M1	cpdb	0	network_modules	64	TRUE	1.7095079467592476e-4	25	29	4	0.13793103448275862	0.16	REAC:R-HSA-9660826	REAC	Purinergic signaling in leishmaniasis infection	10916	1826		0.5238095238095238	0.5909090909090909	25	10891	4	25	21	10866	10916	0.1464518736427528
M1	cpdb	0	network_modules	64	TRUE	1.7095079467592476e-4	25	29	4	0.13793103448275862	0.16	REAC:R-HSA-9664424	REAC	Cell recruitment (pro-inflammatory response)	10916	325		0.5238095238095238	0.5909090909090909	25	10891	4	25	21	10866	10916	0.1464518736427528
M1	cpdb	0	network_modules	64	TRUE	1.8390676902465506e-4	103	37	6	0.16216216216216217	0.05825242718446602	GO:0052547	GO:BP	regulation of peptidase activity	16175	14133		0.6951219512195121	0.6987951807228916	103	16072	6	31	97	16041	16175	0.09378174624802438
M1	cpdb	0	network_modules	64	TRUE	2.1749347651386816e-4	21	37	4	0.10810810810810811	0.19047619047619047	GO:2001056	GO:BP	positive regulation of cysteine-type endopeptidase activity	16175	26298		0.7073170731707317	0.7108433734939759	21	16154	4	33	17	16121	16175	0.1420305420877621
M1	cpdb	0	network_modules	64	TRUE	2.9398340499831526e-4	280	37	8	0.21621621621621623	0.02857142857142857	GO:0007249	GO:BP	canonical NF-kappaB signal transduction	16175	2783		0.7195121951219512	0.7228915662650602	280	15895	8	29	272	15866	16175	0.07302270537088114
M1	cpdb	0	network_modules	64	TRUE	3.2073908888229525e-4	23	37	4	0.10810810810810811	0.17391304347826086	GO:0032691	GO:BP	negative regulation of interleukin-1 beta production	16175	7737		0.7317073170731707	0.7349397590361446	23	16152	4	33	19	16119	16175	0.13556616519032536
M1	cpdb	0	network_modules	64	TRUE	3.4661957905687227e-4	249	34	8	0.23529411764705882	0.0321285140562249	KEGG:05132	KEGG	Salmonella infection	8484	429		0.4444444444444444	0.5	249	8235	8	26	241	8209	8484	0.07739822885401446
M1	cpdb	0	network_modules	64	TRUE	4.50649555378682e-4	198	37	7	0.1891891891891892	0.03535353535353535	GO:0016485	GO:BP	protein processing	16175	5233		0.7439024390243902	0.7469879518072289	198	15977	7	30	191	15947	16175	0.0770523571113522
M1	cpdb	0	network_modules	64	TRUE	7.907611327300592e-4	472	29	9	0.3103448275862069	0.019067796610169493	REAC:R-HSA-449147	REAC	Signaling by Interleukins	10916	2261		0.6190476190476191	0.6363636363636364	472	10444	9	20	463	10424	10916	0.06777770961034335
M1	cpdb	0	network_modules	64	TRUE	8.028078409726653e-4	132	37	6	0.16216216216216217	0.045454545454545456	GO:0001959	GO:BP	regulation of cytokine-mediated signaling pathway	16175	568		0.7560975609756098	0.7590361445783133	132	16043	6	31	126	16012	16175	0.0819625128168491
M1	cpdb	0	network_modules	64	TRUE	9.588568045212358e-4	11	29	3	0.10344827586206896	0.2727272727272727	REAC:R-HSA-111458	REAC	Formation of apoptosome	10916	955		0.6666666666666666	0.7272727272727273	11	10905	3	26	8	10879	10916	0.16663693494509232
M1	cpdb	0	network_modules	64	TRUE	9.588568045212358e-4	11	29	3	0.10344827586206896	0.2727272727272727	REAC:R-HSA-9627069	REAC	Regulation of the apoptosome activity	10916	2051		0.6666666666666666	0.7272727272727273	11	10905	3	26	8	10879	10916	0.16663693494509232
M1	cpdb	0	network_modules	64	TRUE	9.873928924554287e-4	8	37	3	0.08108108108108109	0.375	GO:0002579	GO:BP	positive regulation of antigen processing and presentation	16175	1100		0.7682926829268293	0.7710843373493976	8	16167	3	34	5	16133	16175	0.17354928425912225
M1	cpdb	0	network_modules	64	TRUE	0.0010621609355554573	136	34	6	0.17647058823529413	0.04411764705882353	KEGG:05135	KEGG	Yersinia infection	8484	432		0.5555555555555556	0.6	136	8348	6	28	130	8320	8484	0.0810335495455884
M1	cpdb	0	network_modules	64	TRUE	0.0010960093576746213	74	37	5	0.13513513513513514	0.06756756756756757	GO:1901222	GO:BP	regulation of non-canonical NF-kappaB signal transduction	16175	21316		0.7804878048780488	0.7831325301204819	74	16101	5	32	69	16069	16175	0.0926379061604858
M1	cpdb	0	network_modules	64	TRUE	0.0011684786071560213	228	37	7	0.1891891891891892	0.03070175438596491	GO:0001818	GO:BP	negative regulation of cytokine production	16175	475		0.7926829268292683	0.7951807228915663	228	15947	7	30	221	15917	16175	0.07111857689785234
M1	cpdb	0	network_modules	64	TRUE	0.001252276378799969	82	34	5	0.14705882352941177	0.06097560975609756	KEGG:04623	KEGG	Cytosolic DNA-sensing pathway	8484	328		0.6666666666666666	0.7	82	8402	5	29	77	8373	8484	0.08907993909973325
M1	cpdb	0	network_modules	64	TRUE	0.0012859037577309367	143	37	6	0.16216216216216217	0.04195804195804196	GO:0060759	GO:BP	regulation of response to cytokine stimulus	16175	14927		0.8048780487804879	0.8072289156626506	143	16032	6	31	137	16001	16175	0.07842618391712076
M1	cpdb	0	network_modules	64	TRUE	0.0013376416686674832	77	37	5	0.13513513513513514	0.06493506493506493	GO:0032088	GO:BP	negative regulation of NF-kappaB transcription factor activity	16175	7355		0.8170731707317073	0.8192771084337349	77	16098	5	32	72	16066	16175	0.09069478209228587
M1	cpdb	0	network_modules	64	TRUE	0.0016560865169449608	13	29	3	0.10344827586206896	0.23076923076923078	REAC:R-HSA-111461	REAC	Cytochrome c-mediated apoptotic response	10916	424		0.7619047619047619	0.7727272727272727	13	10903	3	26	10	10877	10916	0.15302356768846626
M1	cpdb	0	network_modules	64	TRUE	0.002224280780939648	251	37	7	0.1891891891891892	0.027888446215139442	GO:0071214	GO:BP	cellular response to abiotic stimulus	16175	16476		0.8292682926829268	0.8433734939759037	251	15924	7	30	244	15894	16175	0.0672799551021943
M1	cpdb	0	network_modules	64	TRUE	0.002224280780939648	251	37	7	0.1891891891891892	0.027888446215139442	GO:0104004	GO:BP	cellular response to environmental stimulus	16175	19202		0.8292682926829268	0.8433734939759037	251	15924	7	30	244	15894	16175	0.0672799551021943
M1	cpdb	0	network_modules	64	TRUE	0.0023828830556321227	2	29	2	0.06896551724137931	1	REAC:R-HSA-844623	REAC	The IPAF inflammasome	10916	2495		0.8095238095238095	0.8181818181818182	2	10914	2	27	0	10887	10916	0.2622878273233484
M1	cpdb	0	network_modules	64	TRUE	0.002625280473112849	15	29	3	0.10344827586206896	0.2	REAC:R-HSA-844456	REAC	The NLRP3 inflammasome	10916	2497		0.8571428571428571	0.8636363636363636	15	10901	3	26	12	10875	10916	0.14221498861055198
M1	cpdb	0	network_modules	64	TRUE	0.002865438854647952	164	37	6	0.16216216216216217	0.036585365853658534	GO:0071356	GO:BP	cellular response to tumor necrosis factor	16175	16608		0.8536585365853658	0.8554216867469879	164	16011	6	31	158	15980	16175	0.07266053797556832
M1	cpdb	0	network_modules	64	TRUE	0.0032196197985584207	40	37	4	0.10810810810810811	0.1	GO:0010950	GO:BP	positive regulation of endopeptidase activity	16175	4528		0.8658536585365854	0.8674698795180723	40	16135	4	33	36	16102	16175	0.10183903921300223
M1	cpdb	0	network_modules	64	TRUE	0.0032750427014870374	246	34	7	0.20588235294117646	0.028455284552845527	KEGG:05131	KEGG	Shigellosis	8484	428		0.7777777777777778	0.8	246	8238	7	27	239	8211	8484	0.06686952550675475
M1	cpdb	0	network_modules	64	TRUE	0.0034039150797793927	167	34	6	0.17647058823529413	0.03592814371257485	KEGG:05164	KEGG	Influenza A	8484	445		0.8888888888888888	0.9	167	8317	6	28	161	8289	8484	0.07159435471092243
M1	cpdb	0	network_modules	64	TRUE	0.0037796896568879695	172	37	6	0.16216216216216217	0.03488372093023256	GO:0071216	GO:BP	cellular response to biotic stimulus	16175	16478		0.8780487804878049	0.8795180722891566	172	16003	6	31	166	15972	16175	0.07073748301806197
M1	cpdb	0	network_modules	64	TRUE	0.004052362949116836	54	29	4	0.13793103448275862	0.07407407407407407	REAC:R-HSA-109606	REAC	Intrinsic Pathway for Apoptosis	10916	1268		0.9047619047619048	0.9090909090909091	54	10862	4	25	50	10837	10916	0.0978265131664637
M1	cpdb	0	network_modules	64	TRUE	0.004919346875142897	180	37	6	0.16216216216216217	0.03333333333333333	GO:0034612	GO:BP	response to tumor necrosis factor	16175	8690		0.8902439024390244	0.891566265060241	180	15995	6	31	174	15964	16175	0.06893920867831113
M1	cpdb	0	network_modules	64	TRUE	0.005410968986030183	102	37	5	0.13513513513513514	0.049019607843137254	GO:0038061	GO:BP	non-canonical NF-kappaB signal transduction	16175	9680		0.9024390243902439	0.9036144578313253	102	16073	5	32	97	16041	16175	0.07792660125921916
M1	cpdb	0	network_modules	64	TRUE	0.00555115269947759	19	29	3	0.10344827586206896	0.15789473684210525	REAC:R-HSA-111471	REAC	Apoptotic factor-mediated response	10916	163		0.9523809523809523	0.9545454545454546	19	10897	3	26	16	10871	10916	0.12593081709305207
M1	cpdb	0	network_modules	64	TRUE	0.00567765583383659	103	37	5	0.13513513513513514	0.04854368932038835	GO:0039531	GO:BP	regulation of cytoplasmic pattern recognition receptor signaling pathway	16175	9804		0.9146341463414634	0.9156626506024096	103	16072	5	32	98	16040	16175	0.07751259122103143
M1	cpdb	0	network_modules	64	TRUE	0.006357598075721754	14	37	3	0.08108108108108109	0.21428571428571427	GO:0032495	GO:BP	response to muramyl dipeptide	16175	7606		0.926829268292683	0.927710843373494	14	16161	3	34	11	16127	16175	0.13061128938503644
M1	cpdb	0	network_modules	64	TRUE	0.006765989164785047	48	37	4	0.10810810810810811	0.08333333333333333	GO:0071496	GO:BP	cellular response to external stimulus	16175	16729		0.9390243902439024	0.9518072289156626	48	16127	4	33	44	16094	16175	0.0925535738349119
M1	cpdb	0	network_modules	64	TRUE	0.006765989164785047	48	37	4	0.10810810810810811	0.08333333333333333	GO:0071260	GO:BP	cellular response to mechanical stimulus	16175	16518		0.9390243902439024	0.9518072289156626	48	16127	4	33	44	16094	16175	0.0925535738349119
M1	cpdb	0	network_modules	64	TRUE	0.0071368592012555285	3	29	2	0.06896551724137931	0.6666666666666666	REAC:R-HSA-844615	REAC	The AIM2 inflammasome	10916	2494		1	1	3	10913	2	27	1	10886	10916	0.2138816848696318
M1	cpdb	0	network_modules	64	TRUE	0.007355391956076502	49	37	4	0.10810810810810811	0.08163265306122448	GO:0039532	GO:BP	negative regulation of cytoplasmic pattern recognition receptor signaling pathway	16175	9805		0.9634146341463414	0.963855421686747	49	16126	4	33	45	16093	16175	0.09155325555023278
M1	cpdb	0	network_modules	64	TRUE	0.007651123528318111	62	34	4	0.11764705882352941	0.06451612903225806	KEGG:05321	KEGG	Inflammatory bowel disease	8484	483		1	1	62	8422	4	30	58	8392	8484	0.08217468975397677
M1	cpdb	0	network_modules	64	TRUE	0.007981949253355576	50	37	4	0.10810810810810811	0.08	GO:1901224	GO:BP	positive regulation of non-canonical NF-kappaB signal transduction	16175	21318		0.975609756097561	0.9759036144578314	50	16125	4	33	46	16092	16175	0.09058258299799783
M1	cpdb	0	network_modules	64	TRUE	0.009352449335266686	52	37	4	0.10810810810810811	0.07692307692307693	GO:0010952	GO:BP	positive regulation of peptidase activity	16175	4530		0.9878048780487805	0.9879518072289156	52	16123	4	33	48	16090	16175	0.0887244515000158
M1	cpdb	0	network_modules	64	TRUE	0.009750119221205791	16	37	3	0.08108108108108109	0.1875	GO:0016045	GO:BP	detection of bacterium	16175	5078		1	1	16	16159	3	34	13	16125	16175	0.12199489618678971
M1	cpdb	0	network_modules	65	TRUE	4.711763958306687e-4	8	30	3	0.1	0.375	GO:0032060	GO:BP	bleb assembly	16175	7334		NA	1	8	16167	3	27	5	16140	16175	0.1929180533726307
M1	cpdb	0	network_modules	66	TRUE	9.960097731617804e-74	34	31	29	0.9354838709677419	0.8529411764705882	KEGG:03020	KEGG	RNA polymerase	8484	212		0	0.25	34	8450	29	2	5	8448	8484	0.89285324514813
M1	cpdb	0	network_modules	66	TRUE	8.283676177681752e-45	18	37	18	0.4864864864864865	1	REAC:R-HSA-73780	REAC	RNA Polymerase III Chain Elongation	10916	1897		0	0.012048192771084338	18	10898	18	19	0	10879	10916	0.6968775551656138
M1	cpdb	0	network_modules	66	TRUE	2.7644270951231763e-40	23	37	18	0.4864864864864865	0.782608695652174	REAC:R-HSA-73980	REAC	RNA Polymerase III Transcription Termination	10916	1903		0.012195121951219513	0.024096385542168676	23	10893	18	19	5	10874	10916	0.6160528545489931
M1	cpdb	0	network_modules	66	TRUE	3.8250625426194774e-38	27	37	18	0.4864864864864865	0.6666666666666666	REAC:R-HSA-76066	REAC	RNA Polymerase III Transcription Initiation From Type 2 Promoter	10916	1901		0.024390243902439025	0.03614457831325301	27	10889	18	19	9	10870	10916	0.5682652425909931
M1	cpdb	0	network_modules	66	TRUE	1.0692472191160407e-37	28	37	18	0.4864864864864865	0.6428571428571429	REAC:R-HSA-76061	REAC	RNA Polymerase III Transcription Initiation From Type 1 Promoter	10916	1900		0.036585365853658534	0.060240963855421686	28	10888	18	19	10	10869	10916	0.5579453938791793
M1	cpdb	0	network_modules	66	TRUE	1.0692472191160407e-37	28	37	18	0.4864864864864865	0.6428571428571429	REAC:R-HSA-76071	REAC	RNA Polymerase III Transcription Initiation From Type 3 Promoter	10916	1902		0.036585365853658534	0.060240963855421686	28	10888	18	19	10	10869	10916	0.5579453938791793
M1	cpdb	0	network_modules	66	TRUE	7.297007443790889e-35	36	37	18	0.4864864864864865	0.5	REAC:R-HSA-76046	REAC	RNA Polymerase III Transcription Initiation	10916	1899		0.06097560975609756	0.07228915662650602	36	10880	18	19	18	10861	10916	0.4914969866943431
M1	cpdb	0	network_modules	66	TRUE	1.611720293602544e-33	41	37	18	0.4864864864864865	0.43902439024390244	REAC:R-HSA-74158	REAC	RNA Polymerase III Transcription	10916	1898		0.07317073170731707	0.0963855421686747	41	10875	18	19	23	10856	10916	0.4602227758869777
M1	cpdb	0	network_modules	66	TRUE	1.611720293602544e-33	41	37	18	0.4864864864864865	0.43902439024390244	REAC:R-HSA-749476	REAC	RNA Polymerase III Abortive And Retractive Initiation	10916	1896		0.07317073170731707	0.0963855421686747	41	10875	18	19	23	10856	10916	0.4602227758869777
M1	cpdb	0	network_modules	66	TRUE	1.1732530101318537e-31	64	37	19	0.5135135135135135	0.296875	REAC:R-HSA-1834949	REAC	Cytosolic sensors of pathogen-associated DNA 	10916	428		0.0975609756097561	0.10843373493975904	64	10852	19	18	45	10834	10916	0.3877840041735247
M1	cpdb	0	network_modules	66	TRUE	9.75821281205116e-28	82	31	18	0.5806451612903226	0.21951219512195122	KEGG:04623	KEGG	Cytosolic DNA-sensing pathway	8484	328		0.3333333333333333	0.5	82	8402	18	13	64	8389	8484	0.353426113184313
M1	cpdb	0	network_modules	66	TRUE	5.649189710252932e-23	56	37	14	0.3783783783783784	0.25	GO:0006383	GO:BP	transcription by RNA polymerase III	16175	2148		0	0.09090909090909091	56	16119	14	23	42	16096	16175	0.30562684193696554
M1	cpdb	0	network_modules	66	TRUE	1.0222938999098342e-21	26	37	12	0.32432432432432434	0.46153846153846156	REAC:R-HSA-77075	REAC	RNA Pol II CTD phosphorylation and interaction with CE	10916	1879		0.10975609756097561	0.13253012048192772	26	10890	12	25	14	10865	10916	0.3851656939195716
M1	cpdb	0	network_modules	66	TRUE	1.0222938999098342e-21	26	37	12	0.32432432432432434	0.46153846153846156	REAC:R-HSA-167160	REAC	RNA Pol II CTD phosphorylation and interaction with CE during HIV infection	10916	1880		0.10975609756097561	0.13253012048192772	26	10890	12	25	14	10865	10916	0.3851656939195716
M1	cpdb	0	network_modules	66	TRUE	1.433322204705122e-21	18	37	11	0.2972972972972973	0.6111111111111112	REAC:R-HSA-8851708	REAC	Signaling by FGFR2 IIIa TM	10916	2245		0.13414634146341464	0.14457831325301204	18	10898	11	26	7	10872	10916	0.4249479060694199
M1	cpdb	0	network_modules	66	TRUE	1.5124010063590016e-21	73	37	15	0.40540540540540543	0.2054794520547945	REAC:R-HSA-6807505	REAC	RNA polymerase II transcribes snRNA genes	10916	1904		0.14634146341463414	0.1566265060240964	73	10843	15	22	58	10821	10916	0.28529854428236884
M1	cpdb	0	network_modules	66	TRUE	3.2065955041718786e-21	28	37	12	0.32432432432432434	0.42857142857142855	REAC:R-HSA-72086	REAC	mRNA Capping	10916	2702		0.15853658536585366	0.1686746987951807	28	10888	12	25	16	10863	10916	0.3709777930487415
M1	cpdb	0	network_modules	66	TRUE	9.078196818342495e-21	30	37	12	0.32432432432432434	0.4	REAC:R-HSA-167243	REAC	Tat-mediated HIV elongation arrest and recovery	10916	2484		0.17073170731707318	0.1927710843373494	30	10886	12	25	18	10861	10916	0.35822741961979665
M1	cpdb	0	network_modules	66	TRUE	9.078196818342495e-21	30	37	12	0.32432432432432434	0.4	REAC:R-HSA-167238	REAC	Pausing and recovery of Tat-mediated HIV elongation	10916	1720		0.17073170731707318	0.1927710843373494	30	10886	12	25	18	10861	10916	0.35822741961979665
M1	cpdb	0	network_modules	66	TRUE	1.4780406588432926e-20	31	37	12	0.32432432432432434	0.3870967741935484	REAC:R-HSA-73863	REAC	RNA Polymerase I Transcription Termination	10916	1886		0.1951219512195122	0.20481927710843373	31	10885	12	25	19	10860	10916	0.35231798763119443
M1	cpdb	0	network_modules	66	TRUE	2.359853217960693e-20	32	37	12	0.32432432432432434	0.375	REAC:R-HSA-167287	REAC	HIV elongation arrest and recovery	10916	1106		0.2073170731707317	0.2289156626506024	32	10884	12	25	20	10859	10916	0.34668643772250657
M1	cpdb	0	network_modules	66	TRUE	2.359853217960693e-20	32	37	12	0.32432432432432434	0.375	REAC:R-HSA-167290	REAC	Pausing and recovery of HIV elongation	10916	1719		0.2073170731707317	0.2289156626506024	32	10884	12	25	20	10859	10916	0.34668643772250657
M1	cpdb	0	network_modules	66	TRUE	3.149496624394869e-20	22	37	11	0.2972972972972973	0.5	REAC:R-HSA-167242	REAC	Abortive elongation of HIV-1 transcript in the absence of Tat	10916	51		0.23170731707317074	0.24096385542168675	22	10894	11	26	11	10868	10916	0.3839739061011238
M1	cpdb	0	network_modules	66	TRUE	6.023332034564346e-20	23	37	11	0.2972972972972973	0.4782608695652174	REAC:R-HSA-203927	REAC	MicroRNA (miRNA) biogenesis	10916	1449		0.24390243902439024	0.25301204819277107	23	10893	11	26	12	10867	10916	0.3754346140229287
M1	cpdb	0	network_modules	66	TRUE	1.9770361148217698e-19	25	37	11	0.2972972972972973	0.44	REAC:R-HSA-6803529	REAC	FGFR2 alternative splicing	10916	905		0.25609756097560976	0.26506024096385544	25	10891	11	26	14	10865	10916	0.35991376595831165
M1	cpdb	0	network_modules	66	TRUE	9.462284297587443e-19	28	37	11	0.2972972972972973	0.39285714285714285	REAC:R-HSA-5601884	REAC	PIWI-interacting RNA (piRNA) biogenesis	10916	1685		0.2682926829268293	0.27710843373493976	28	10888	11	26	17	10862	10916	0.3398165262436686
M1	cpdb	0	network_modules	66	TRUE	1.131458403246648e-18	42	37	12	0.32432432432432434	0.2857142857142857	REAC:R-HSA-167169	REAC	HIV Transcription Elongation	10916	1104		0.2804878048780488	0.3132530120481928	42	10874	12	25	30	10849	10916	0.30188889231937216
M1	cpdb	0	network_modules	66	TRUE	1.131458403246648e-18	42	37	12	0.32432432432432434	0.2857142857142857	REAC:R-HSA-167200	REAC	Formation of HIV-1 elongation complex containing HIV-1 Tat	10916	947		0.2804878048780488	0.3132530120481928	42	10874	12	25	30	10849	10916	0.30188889231937216
M1	cpdb	0	network_modules	66	TRUE	1.131458403246648e-18	42	37	12	0.32432432432432434	0.2857142857142857	REAC:R-HSA-167246	REAC	Tat-mediated elongation of the HIV-1 transcript	10916	2485		0.2804878048780488	0.3132530120481928	42	10874	12	25	30	10849	10916	0.30188889231937216
M1	cpdb	0	network_modules	66	TRUE	1.5211433962887138e-18	29	37	11	0.2972972972972973	0.3793103448275862	REAC:R-HSA-1839126	REAC	FGFR2 mutant receptor activation	10916	907		0.3170731707317073	0.3253012048192771	29	10887	11	26	18	10861	10916	0.3338177680286288
M1	cpdb	0	network_modules	66	TRUE	2.1488384542304896e-18	44	37	12	0.32432432432432434	0.2727272727272727	REAC:R-HSA-167152	REAC	Formation of HIV elongation complex in the absence of HIV Tat	10916	946		0.32926829268292684	0.3373493975903614	44	10872	12	25	32	10847	10916	0.294806479920288
M1	cpdb	0	network_modules	66	TRUE	5.289859531935231e-18	47	37	12	0.32432432432432434	0.2553191489361702	REAC:R-HSA-73762	REAC	RNA Polymerase I Transcription Initiation	10916	1885		0.34146341463414637	0.3493975903614458	47	10869	12	25	35	10844	10916	0.2850372098848819
M1	cpdb	0	network_modules	66	TRUE	5.6356733040220225e-18	32	37	11	0.2972972972972973	0.34375	REAC:R-HSA-167158	REAC	Formation of the HIV-1 Early Elongation Complex	10916	965		0.35365853658536583	0.37349397590361444	32	10884	11	26	21	10858	10916	0.317532385936955
M1	cpdb	0	network_modules	66	TRUE	5.6356733040220225e-18	32	37	11	0.2972972972972973	0.34375	REAC:R-HSA-113418	REAC	Formation of the Early Elongation Complex	10916	963		0.35365853658536583	0.37349397590361444	32	10884	11	26	21	10858	10916	0.317532385936955
M1	cpdb	0	network_modules	66	TRUE	8.614631855964436e-18	69	37	13	0.35135135135135137	0.18840579710144928	REAC:R-HSA-167172	REAC	Transcription of the HIV genome	10916	2540		0.3780487804878049	0.3855421686746988	69	10847	13	24	56	10823	10916	0.2538913119602896
M1	cpdb	0	network_modules	66	TRUE	3.693832484545416e-17	37	37	11	0.2972972972972973	0.2972972972972973	REAC:R-HSA-5655253	REAC	Signaling by FGFR2 in disease	10916	2248		0.3902439024390244	0.39759036144578314	37	10879	11	26	26	10853	10916	0.29490737175267007
M1	cpdb	0	network_modules	66	TRUE	7.009927367677684e-17	57	37	12	0.32432432432432434	0.21052631578947367	REAC:R-HSA-75955	REAC	RNA Polymerase II Transcription Elongation	10916	1891		0.4024390243902439	0.42168674698795183	57	10859	12	25	45	10834	10916	0.25820695834068214
M1	cpdb	0	network_modules	66	TRUE	7.009927367677684e-17	57	37	12	0.32432432432432434	0.21052631578947367	REAC:R-HSA-112382	REAC	Formation of RNA Pol II elongation complex 	10916	949		0.4024390243902439	0.42168674698795183	57	10859	12	25	45	10834	10916	0.25820695834068214
M1	cpdb	0	network_modules	66	TRUE	9.922237801407844e-17	40	37	11	0.2972972972972973	0.275	REAC:R-HSA-168325	REAC	Viral Messenger RNA Synthesis	10916	2648		0.4268292682926829	0.43373493975903615	40	10876	11	26	29	10850	10916	0.28340668872247565
M1	cpdb	0	network_modules	66	TRUE	1.7119408090930735e-16	61	37	12	0.32432432432432434	0.19672131147540983	REAC:R-HSA-6796648	REAC	TP53 Regulates Transcription of DNA Repair Genes	10916	2456		0.43902439024390244	0.4457831325301205	61	10855	12	25	49	10830	10916	0.24935693753686775
M1	cpdb	0	network_modules	66	TRUE	5.651018282640363e-16	46	37	11	0.2972972972972973	0.2391304347826087	REAC:R-HSA-73776	REAC	RNA Polymerase II Promoter Escape	10916	1889		0.45121951219512196	0.5180722891566265	46	10870	11	26	35	10844	10916	0.2638561886792499
M1	cpdb	0	network_modules	66	TRUE	5.651018282640363e-16	46	37	11	0.2972972972972973	0.2391304347826087	REAC:R-HSA-167161	REAC	HIV Transcription Initiation	10916	1105		0.45121951219512196	0.5180722891566265	46	10870	11	26	35	10844	10916	0.2638561886792499
M1	cpdb	0	network_modules	66	TRUE	5.651018282640363e-16	46	37	11	0.2972972972972973	0.2391304347826087	REAC:R-HSA-75953	REAC	RNA Polymerase II Transcription Initiation	10916	1892		0.45121951219512196	0.5180722891566265	46	10870	11	26	35	10844	10916	0.2638561886792499
M1	cpdb	0	network_modules	66	TRUE	5.651018282640363e-16	46	37	11	0.2972972972972973	0.2391304347826087	REAC:R-HSA-167162	REAC	RNA Polymerase II HIV Promoter Escape	10916	1887		0.45121951219512196	0.5180722891566265	46	10870	11	26	35	10844	10916	0.2638561886792499
M1	cpdb	0	network_modules	66	TRUE	5.651018282640363e-16	46	37	11	0.2972972972972973	0.2391304347826087	REAC:R-HSA-76042	REAC	RNA Polymerase II Transcription Initiation And Promoter Clearance	10916	1893		0.45121951219512196	0.5180722891566265	46	10870	11	26	35	10844	10916	0.2638561886792499
M1	cpdb	0	network_modules	66	TRUE	5.651018282640363e-16	46	37	11	0.2972972972972973	0.2391304347826087	REAC:R-HSA-73779	REAC	RNA Polymerase II Transcription Pre-Initiation And Promoter Opening	10916	1894		0.45121951219512196	0.5180722891566265	46	10870	11	26	35	10844	10916	0.2638561886792499
M1	cpdb	0	network_modules	66	TRUE	9.529200893740567e-16	48	37	11	0.2972972972972973	0.22916666666666666	REAC:R-HSA-72165	REAC	mRNA Splicing - Minor Pathway	10916	2708		0.524390243902439	0.5301204819277109	48	10868	11	26	37	10842	10916	0.25816297710413627
M1	cpdb	0	network_modules	66	TRUE	2.5251840801244966e-15	52	37	11	0.2972972972972973	0.21153846153846154	REAC:R-HSA-6781823	REAC	Formation of TC-NER Pre-Incision Complex	10916	951		0.5365853658536586	0.54216867469879515	52	10864	11	26	41	10838	10916	0.24777026012765094
M1	cpdb	0	network_modules	66	TRUE	5.49760000727932e-15	61	31	11	0.3548387096774194	0.18032786885245902	KEGG:03420	KEGG	Nucleotide excision repair	8484	238		0.6666666666666666	0.75	61	8423	11	20	50	8403	8484	0.24918297716249807
M1	cpdb	0	network_modules	66	TRUE	5.685949830987271e-15	80	37	12	0.32432432432432434	0.15	REAC:R-HSA-674695	REAC	RNA Polymerase II Pre-transcription Events	10916	1888		0.5487804878048781	0.5542168674698795	80	10836	12	25	68	10811	10916	0.21674230497110075
M1	cpdb	0	network_modules	66	TRUE	6.170472243993619e-15	56	37	11	0.2972972972972973	0.19642857142857142	REAC:R-HSA-1226099	REAC	Signaling by FGFR in disease	10916	2240		0.5609756097560976	0.5662650602409639	56	10860	11	26	45	10834	10916	0.23850223456178257
M1	cpdb	0	network_modules	66	TRUE	2.19778963461292e-14	89	37	12	0.32432432432432434	0.1348314606741573	REAC:R-HSA-5250924	REAC	B-WICH complex positively regulates rRNA expression	10916	198		0.573170731707317	0.5783132530120482	89	10827	12	25	77	10802	10916	0.20504211561538863
M1	cpdb	0	network_modules	66	TRUE	2.5129070677578714e-14	63	37	11	0.2972972972972973	0.1746031746031746	REAC:R-HSA-6782210	REAC	Gap-filling DNA repair synthesis and ligation in TC-NER	10916	1038		0.5853658536585366	0.5903614457831325	63	10853	11	26	52	10827	10916	0.2244408720139417
M1	cpdb	0	network_modules	66	TRUE	2.530514131156902e-14	90	37	12	0.32432432432432434	0.13333333333333333	REAC:R-HSA-73772	REAC	RNA Polymerase I Promoter Escape	10916	1882		0.5975609756097561	0.6024096385542169	90	10826	12	25	78	10801	10916	0.2038501462914557
M1	cpdb	0	network_modules	66	TRUE	3.027797961896605e-14	64	37	11	0.2972972972972973	0.171875	REAC:R-HSA-5654738	REAC	Signaling by FGFR2	10916	2244		0.6097560975609756	0.6265060240963856	64	10852	11	26	53	10826	10916	0.2226208059231415
M1	cpdb	0	network_modules	66	TRUE	3.027797961896605e-14	64	37	11	0.2972972972972973	0.171875	REAC:R-HSA-6782135	REAC	Dual incision in TC-NER	10916	808		0.6097560975609756	0.6265060240963856	64	10852	11	26	53	10826	10916	0.2226208059231415
M1	cpdb	0	network_modules	66	TRUE	4.354319146391724e-14	66	37	11	0.2972972972972973	0.16666666666666666	REAC:R-HSA-9670095	REAC	Inhibition of DNA recombination at telomere	10916	1189		0.6341463414634146	0.6385542168674698	66	10850	11	26	55	10824	10916	0.21910418740419296
M1	cpdb	0	network_modules	66	TRUE	6.306296870019263e-14	132	37	13	0.35135135135135137	0.09848484848484848	REAC:R-HSA-162599	REAC	Late Phase of HIV Life Cycle	10916	1304		0.6463414634146342	0.6506024096385542	132	10784	13	24	119	10760	10916	0.1810190934777482
M1	cpdb	0	network_modules	66	TRUE	1.5500784248207417e-13	104	37	12	0.32432432432432434	0.11538461538461539	REAC:R-HSA-5250913	REAC	Positive epigenetic regulation of rRNA expression	10916	1771		0.6585365853658537	0.6626506024096386	104	10812	12	25	92	10787	10916	0.18898652166167387
M1	cpdb	0	network_modules	66	TRUE	1.7463599111075814e-13	105	37	12	0.32432432432432434	0.11428571428571428	REAC:R-HSA-427413	REAC	NoRC negatively regulates rRNA expression	10916	1602		0.6707317073170732	0.6746987951807228	105	10811	12	25	93	10786	10916	0.18803839470442485
M1	cpdb	0	network_modules	66	TRUE	2.2025874806543876e-13	145	37	13	0.35135135135135137	0.0896551724137931	REAC:R-HSA-162587	REAC	HIV Life Cycle	10916	1103		0.6829268292682927	0.6867469879518072	145	10771	13	24	132	10747	10916	0.1722114708624515
M1	cpdb	0	network_modules	66	TRUE	2.2713313003225749e-13	76	37	11	0.2972972972972973	0.14473684210526316	REAC:R-HSA-190236	REAC	Signaling by FGFR	10916	2239		0.6951219512195121	0.6987951807228916	76	10840	11	26	65	10814	10916	0.20363288615248287
M1	cpdb	0	network_modules	66	TRUE	2.479392312222629e-13	108	37	12	0.32432432432432434	0.1111111111111111	REAC:R-HSA-5250941	REAC	Negative epigenetic regulation of rRNA expression	10916	1566		0.7073170731707317	0.7108433734939759	108	10808	12	25	96	10783	10916	0.1852721519952772
M1	cpdb	0	network_modules	66	TRUE	2.6440689511725373e-13	77	37	11	0.2972972972972973	0.14285714285714285	REAC:R-HSA-6781827	REAC	Transcription-Coupled Nucleotide Excision Repair (TC-NER)	10916	2541		0.7195121951219512	0.7228915662650602	77	10839	11	26	66	10813	10916	0.2022517694314034
M1	cpdb	0	network_modules	66	TRUE	2.780183594317388e-13	109	37	12	0.32432432432432434	0.11009174311926606	REAC:R-HSA-73854	REAC	RNA Polymerase I Promoter Clearance	10916	1881		0.7317073170731707	0.7349397590361446	109	10807	12	25	97	10782	10916	0.18437512081396734
M1	cpdb	0	network_modules	66	TRUE	3.113963235240326e-13	110	37	12	0.32432432432432434	0.10909090909090909	REAC:R-HSA-73864	REAC	RNA Polymerase I Transcription	10916	1884		0.7439024390243902	0.7469879518072289	110	10806	12	25	98	10781	10916	0.18349014014699122
M1	cpdb	0	network_modules	66	TRUE	6.672598216441284e-12	102	37	11	0.2972972972972973	0.10784313725490197	REAC:R-HSA-5578749	REAC	Transcriptional regulation by small RNAs	10916	2555		0.7560975609756098	0.7590361445783133	102	10814	11	26	91	10788	10916	0.17454144386449907
M1	cpdb	0	network_modules	66	TRUE	1.4151697511177766e-11	109	37	11	0.2972972972972973	0.10091743119266056	REAC:R-HSA-5696398	REAC	Nucleotide Excision Repair	10916	1622		0.7682926829268293	0.7710843373493976	109	10807	11	26	98	10781	10916	0.16852245326928544
M1	cpdb	0	network_modules	66	TRUE	1.737703103079623e-11	111	37	11	0.2972972972972973	0.0990990990990991	REAC:R-HSA-157579	REAC	Telomere Maintenance	10916	2489		0.7804878048780488	0.7831325301204819	111	10805	11	26	100	10779	10916	0.1669062835108778
M1	cpdb	0	network_modules	66	TRUE	4.1782438723691033e-11	120	37	11	0.2972972972972973	0.09166666666666666	REAC:R-HSA-5617472	REAC	Activation of anterior HOX genes in hindbrain development during early embryogenesis	10916	99		0.7926829268292683	0.8072289156626506	120	10796	11	26	109	10770	10916	0.16013108601814174
M1	cpdb	0	network_modules	66	TRUE	4.1782438723691033e-11	120	37	11	0.2972972972972973	0.09166666666666666	REAC:R-HSA-5619507	REAC	Activation of HOX genes during differentiation	10916	84		0.7926829268292683	0.8072289156626506	120	10796	11	26	109	10770	10916	0.16013108601814174
M1	cpdb	0	network_modules	66	TRUE	6.898019458337786e-11	225	37	13	0.35135135135135137	0.057777777777777775	REAC:R-HSA-162906	REAC	HIV Infection	10916	1102		0.8170731707317073	0.8192771084337349	225	10691	13	24	212	10667	10916	0.1357548700515148
M1	cpdb	0	network_modules	66	TRUE	1.319849401336253e-10	133	37	11	0.2972972972972973	0.08270676691729323	REAC:R-HSA-168273	REAC	Influenza Viral RNA Transcription and Replication	10916	1186		0.8292682926829268	0.8313253012048193	133	10783	11	26	122	10757	10916	0.15156252299140804
M1	cpdb	0	network_modules	66	TRUE	1.4347155188369994e-10	134	37	11	0.2972972972972973	0.08208955223880597	REAC:R-HSA-211000	REAC	Gene Silencing by RNA	10916	1041		0.8414634146341463	0.8433734939759037	134	10782	11	26	123	10756	10916	0.15095441603890028
M1	cpdb	0	network_modules	66	TRUE	1.7574633904256666e-10	185	37	12	0.32432432432432434	0.06486486486486487	REAC:R-HSA-212165	REAC	Epigenetic regulation of gene expression	10916	852		0.8536585365853658	0.8554216867469879	185	10731	12	25	173	10706	10916	0.1388784680734034
M1	cpdb	0	network_modules	66	TRUE	1.9902077671228456e-10	138	37	11	0.2972972972972973	0.07971014492753623	REAC:R-HSA-73886	REAC	Chromosome Maintenance	10916	357		0.8658536585365854	0.8674698795180723	138	10778	11	26	127	10752	10916	0.148586908929789
M1	cpdb	0	network_modules	66	TRUE	4.010866940004247e-10	147	37	11	0.2972972972972973	0.07482993197278912	REAC:R-HSA-9018519	REAC	Estrogen-dependent gene expression	10916	866		0.8780487804878049	0.8795180722891566	147	10769	11	26	136	10743	10916	0.1436094787837176
M1	cpdb	0	network_modules	66	TRUE	6.241418931006824e-10	153	37	11	0.2972972972972973	0.0718954248366013	REAC:R-HSA-168255	REAC	Influenza Infection	10916	1185		0.8902439024390244	0.891566265060241	153	10763	11	26	142	10737	10916	0.14053200063053062
M1	cpdb	0	network_modules	66	TRUE	1.3028970591518764e-8	202	37	11	0.2972972972972973	0.054455445544554455	REAC:R-HSA-72163	REAC	mRNA Splicing - Major Pathway	10916	2707		0.9024390243902439	0.9036144578313253	202	10714	11	26	191	10688	10916	0.12064219998553677
M1	cpdb	0	network_modules	66	TRUE	1.8837084215485932e-8	209	37	11	0.2972972972972973	0.05263157894736842	REAC:R-HSA-72172	REAC	mRNA Splicing	10916	2706		0.9146341463414634	0.9156626506024096	209	10707	11	26	198	10681	10916	0.11837053820577506
M1	cpdb	0	network_modules	66	TRUE	2.6883248699497072e-8	216	37	11	0.2972972972972973	0.05092592592592592	REAC:R-HSA-8939211	REAC	ESR-mediated signaling	10916	830		0.926829268292683	0.927710843373494	216	10700	11	26	205	10674	10916	0.11620625534594595
M1	cpdb	0	network_modules	66	TRUE	3.487880461847977e-8	11	37	5	0.13513513513513514	0.45454545454545453	GO:0042797	GO:BP	tRNA transcription by RNA polymerase III	16175	10374		0.1	0.18181818181818182	11	16164	5	32	6	16132	16175	0.24696006238506493
M1	cpdb	0	network_modules	66	TRUE	5.969362705439817e-8	12	37	5	0.13513513513513514	0.4166666666666667	GO:0009304	GO:BP	tRNA transcription	16175	3451		0.2	0.2727272727272727	12	16163	5	32	7	16131	16175	0.23634484883392454
M1	cpdb	0	network_modules	66	TRUE	3.4083324703515387e-7	305	31	11	0.3548387096774194	0.036065573770491806	KEGG:05016	KEGG	Huntington disease	8484	414		1	1	305	8179	11	20	294	8159	8484	0.10373257521770245
M1	cpdb	0	network_modules	66	TRUE	3.69236187793618e-7	276	37	11	0.2972972972972973	0.03985507246376811	REAC:R-HSA-72203	REAC	Processing of Capped Intron-Containing Pre-mRNA	10916	1796		0.9390243902439024	0.9397590361445783	276	10640	11	26	265	10614	10916	0.10104962394348636
M1	cpdb	0	network_modules	66	TRUE	3.9519598007011116e-7	38	37	6	0.16216216216216217	0.15789473684210525	GO:0032728	GO:BP	positive regulation of interferon-beta production	16175	7773		0.3	0.36363636363636365	38	16137	6	31	32	16106	16175	0.15806248860278346
M1	cpdb	0	network_modules	66	TRUE	4.11490156001723e-7	359	37	12	0.32432432432432434	0.033426183844011144	REAC:R-HSA-3700989	REAC	Transcriptional Regulation by TP53	10916	2546		0.9512195121951219	0.9518072289156626	359	10557	12	25	347	10532	10916	0.09530086327570532
M1	cpdb	0	network_modules	66	TRUE	6.228909255232542e-7	290	37	11	0.2972972972972973	0.03793103448275862	REAC:R-HSA-9006931	REAC	Signaling by Nuclear Receptors	10916	2289		0.9634146341463414	0.963855421686747	290	10626	11	26	279	10600	10916	0.0981801396582102
M1	cpdb	0	network_modules	66	TRUE	2.340733599020461e-6	329	37	11	0.2972972972972973	0.03343465045592705	REAC:R-HSA-73894	REAC	DNA Repair	10916	444		0.975609756097561	0.9759036144578314	329	10587	11	26	318	10561	10916	0.09112840385093801
M1	cpdb	0	network_modules	66	TRUE	2.5235060074532994e-6	51	37	6	0.16216216216216217	0.11764705882352941	GO:0032648	GO:BP	regulation of interferon-beta production	16175	7695		0.4	0.5454545454545454	51	16124	6	31	45	16093	16175	0.13580661492772744
M1	cpdb	0	network_modules	66	TRUE	2.5235060074532994e-6	51	37	6	0.16216216216216217	0.11764705882352941	GO:0032608	GO:BP	interferon-beta production	16175	7656		0.4	0.5454545454545454	51	16124	6	31	45	16093	16175	0.13580661492772744
M1	cpdb	0	network_modules	66	TRUE	6.960534366078764e-6	173	37	8	0.21621621621621623	0.046242774566473986	GO:0006352	GO:BP	DNA-templated transcription initiation	16175	2129		0.6	0.6363636363636364	173	16002	8	29	165	15973	16175	0.09566777608600374
M1	cpdb	0	network_modules	66	TRUE	7.653240606393893e-6	61	37	6	0.16216216216216217	0.09836065573770492	GO:0006360	GO:BP	transcription by RNA polymerase I	16175	2136		0.7	0.7272727272727273	61	16114	6	31	55	16083	16175	0.12373254711084819
M1	cpdb	0	network_modules	66	TRUE	1.242067913163812e-5	66	37	6	0.16216216216216217	0.09090909090909091	GO:0032481	GO:BP	positive regulation of type I interferon production	16175	7592		0.8	0.8181818181818182	66	16109	6	31	60	16078	16175	0.11873968310256136
M1	cpdb	0	network_modules	66	TRUE	2.768152865834093e-5	418	37	11	0.2972972972972973	0.02631578947368421	REAC:R-HSA-5663202	REAC	Diseases of signal transduction by growth factor receptors and second messengers	10916	773		0.9878048780487805	0.9879518072289156	418	10498	11	26	407	10472	10916	0.07871118061669961
M1	cpdb	0	network_modules	66	TRUE	1.9377311198152995e-4	507	37	11	0.2972972972972973	0.021696252465483234	REAC:R-HSA-9006934	REAC	Signaling by Receptor Tyrosine Kinases	10916	2302		1	1	507	10409	11	26	496	10383	10916	0.06951499365973199
M1	cpdb	0	network_modules	66	TRUE	2.723265553137866e-4	110	37	6	0.16216216216216217	0.05454545454545454	GO:0032479	GO:BP	regulation of type I interferon production	16175	7590		0.9	1	110	16065	6	31	104	16034	16175	0.0905163674386529
M1	cpdb	0	network_modules	66	TRUE	2.723265553137866e-4	110	37	6	0.16216216216216217	0.05454545454545454	GO:0032606	GO:BP	type I interferon production	16175	7654		0.9	1	110	16065	6	31	104	16034	16175	0.0905163674386529
M1	cpdb	0	network_modules	67	TRUE	6.711897583997613e-24	236	39	20	0.5128205128205128	0.0847457627118644	GO:0030198	GO:BP	extracellular matrix organization	16175	6707		0	0.1111111111111111	236	15939	20	19	216	15920	16175	0.20427822282462837
M1	cpdb	0	network_modules	67	TRUE	7.322193337786943e-24	237	39	20	0.5128205128205128	0.08438818565400844	GO:0043062	GO:BP	extracellular structure organization	16175	10509		0.125	0.2222222222222222	237	15938	20	19	217	15919	16175	0.20382789993426573
M1	cpdb	0	network_modules	67	TRUE	7.984889050527028e-24	238	39	20	0.5128205128205128	0.08403361344537816	GO:0045229	GO:BP	external encapsulating structure organization	16175	11340		0.25	0.3333333333333333	238	15937	20	19	218	15918	16175	0.20338037747075366
M1	cpdb	0	network_modules	67	TRUE	2.3781684461526617e-23	298	32	21	0.65625	0.07046979865771812	REAC:R-HSA-1474244	REAC	Extracellular matrix organization	10916	889		0	0.05	298	10618	21	11	277	10607	10916	0.20928172612973636
M1	cpdb	0	network_modules	67	TRUE	1.0773251337915747e-21	30	32	12	0.375	0.4	REAC:R-HSA-3000157	REAC	Laminin interactions	10916	1303		0.05263157894736842	0.1	30	10886	12	20	18	10866	10916	0.3855548710758596
M1	cpdb	0	network_modules	67	TRUE	3.70098395702175e-21	67	32	14	0.4375	0.208955223880597	REAC:R-HSA-1650814	REAC	Collagen biosynthesis and modifying enzymes	10916	384		0.10526315789473684	0.15	67	10849	14	18	53	10831	10916	0.29947053597284584
M1	cpdb	0	network_modules	67	TRUE	3.800290126199345e-20	140	32	16	0.5	0.11428571428571428	REAC:R-HSA-1474228	REAC	Degradation of the extracellular matrix	10916	726		0.15789473684210525	0.2	140	10776	16	16	124	10760	10916	0.23476656543539334
M1	cpdb	0	network_modules	67	TRUE	2.5652717851930095e-19	44	32	12	0.375	0.2727272727272727	REAC:R-HSA-8948216	REAC	Collagen chain trimerization	10916	385		0.21052631578947367	0.25	44	10872	12	20	32	10852	10916	0.31746881125656556
M1	cpdb	0	network_modules	67	TRUE	2.7897470648609574e-19	89	32	14	0.4375	0.15730337078651685	REAC:R-HSA-1474290	REAC	Collagen formation	10916	387		0.2631578947368421	0.3	89	10827	14	18	75	10809	10916	0.2588829441337056
M1	cpdb	0	network_modules	67	TRUE	3.861088728259995e-17	64	32	12	0.375	0.1875	REAC:R-HSA-1442490	REAC	Collagen degradation	10916	386		0.3157894736842105	0.35	64	10852	12	20	52	10832	10916	0.26217242018586007
M1	cpdb	0	network_modules	67	TRUE	3.573389230981216e-16	76	32	12	0.375	0.15789473684210525	REAC:R-HSA-3000178	REAC	ECM proteoglycans	10916	812		0.3684210526315789	0.4	76	10840	12	20	64	10820	10916	0.24000217130425172
M1	cpdb	0	network_modules	67	TRUE	1.5891196203977923e-15	103	25	12	0.48	0.11650485436893204	KEGG:04974	KEGG	Protein digestion and absorption	8484	405		0	0.1111111111111111	103	8381	12	13	91	8368	8484	0.2322523257124208
M1	cpdb	0	network_modules	67	TRUE	2.095447308681556e-15	60	32	11	0.34375	0.18333333333333332	REAC:R-HSA-2022090	REAC	Assembly of collagen fibrils and other multimeric structures	10916	177		0.42105263157894735	0.45	60	10856	11	21	49	10835	10916	0.2480709911877068
M1	cpdb	0	network_modules	67	TRUE	2.322080732495498e-14	89	25	11	0.44	0.12359550561797752	KEGG:04512	KEGG	ECM-receptor interaction	8484	314		0.125	0.2222222222222222	89	8395	11	14	78	8381	8484	0.2291810682139601
M1	cpdb	0	network_modules	67	TRUE	1.0883677832760444e-13	84	32	11	0.34375	0.13095238095238096	REAC:R-HSA-216083	REAC	Integrin cell surface interactions	10916	1216		0.47368421052631576	0.5	84	10832	11	21	73	10811	10916	0.2085261279161179
M1	cpdb	0	network_modules	67	TRUE	1.8980129709363347e-13	59	32	10	0.3125	0.1694915254237288	REAC:R-HSA-3000171	REAC	Non-integrin membrane-ECM interactions	10916	1603		0.5263157894736842	0.55	59	10857	10	22	49	10835	10916	0.227109968639267
M1	cpdb	0	network_modules	67	TRUE	2.5544092199197545e-12	92	25	10	0.4	0.10869565217391304	KEGG:05222	KEGG	Small cell lung cancer	8484	473		0.25	0.3333333333333333	92	8392	10	15	82	8377	8484	0.20427174385574165
M1	cpdb	0	network_modules	67	TRUE	6.707387844440809e-12	101	25	10	0.4	0.09900990099009901	KEGG:05146	KEGG	Amoebiasis	8484	438		0.375	0.4444444444444444	101	8383	10	15	91	8368	8484	0.19453110141814065
M1	cpdb	0	network_modules	67	TRUE	2.3191524869674817e-10	202	25	11	0.44	0.054455445544554455	KEGG:04510	KEGG	Focal adhesion	8484	313		0.5	0.5555555555555556	202	8282	11	14	191	8268	8484	0.1484089156064841
M1	cpdb	0	network_modules	67	TRUE	6.410431915402238e-10	15	32	6	0.1875	0.4	REAC:R-HSA-2214320	REAC	Anchoring fibril formation	10916	146		0.5789473684210527	0.6	15	10901	6	26	9	10875	10916	0.2724408281031653
M1	cpdb	0	network_modules	67	TRUE	2.3631411705325275e-9	18	32	6	0.1875	0.3333333333333333	REAC:R-HSA-2243919	REAC	Crosslinking of collagen fibrils	10916	417		0.631578947368421	0.65	18	10898	6	26	12	10872	10916	0.24837026523963182
M1	cpdb	0	network_modules	67	TRUE	5.165811426665944e-9	356	25	12	0.48	0.033707865168539325	KEGG:04151	KEGG	PI3K-Akt signaling pathway	8484	285		0.625	0.6666666666666666	356	8128	12	13	344	8115	8484	0.11876999768045059
M1	cpdb	0	network_modules	67	TRUE	4.686981726273887e-8	330	25	11	0.44	0.03333333333333333	KEGG:05165	KEGG	Human papillomavirus infection	8484	446		0.75	0.7777777777777778	330	8154	11	14	319	8140	8484	0.11277816204639281
M1	cpdb	0	network_modules	67	TRUE	6.357657819023066e-7	42	32	6	0.1875	0.14285714285714285	REAC:R-HSA-419037	REAC	NCAM1 interactions	10916	1512		0.6842105263157895	0.7	42	10874	6	26	36	10848	10916	0.16085021110577755
M1	cpdb	0	network_modules	67	TRUE	1.8168335238865511e-6	21	39	5	0.1282051282051282	0.23809523809523808	GO:0071711	GO:BP	basement membrane organization	16175	16875		0.375	0.4444444444444444	21	16154	5	34	16	16120	16175	0.17326624120542583
M1	cpdb	0	network_modules	67	TRUE	3.05415078859664e-6	54	32	6	0.1875	0.1111111111111111	REAC:R-HSA-186797	REAC	Signaling by PDGF	10916	2291		0.7368421052631579	0.75	54	10862	6	26	48	10836	10916	0.14108529847049914
M1	cpdb	0	network_modules	67	TRUE	5.273903512627393e-6	59	32	6	0.1875	0.1016949152542373	REAC:R-HSA-375165	REAC	NCAM signaling for neurite out-growth	10916	1511		0.7894736842105263	0.8	59	10857	6	26	53	10831	10916	0.1346671161645769
M1	cpdb	0	network_modules	67	TRUE	2.2321940666644962e-5	100	25	6	0.24	0.06	KEGG:04933	KEGG	AGE-RAGE signaling pathway in diabetic complications	8484	390		0.875	0.8888888888888888	100	8384	6	19	94	8365	8484	0.11495453277826309
M1	cpdb	0	network_modules	67	TRUE	1.0070016655787134e-4	129	25	6	0.24	0.046511627906976744	KEGG:04926	KEGG	Relaxin signaling pathway	8484	383		1	1	129	8355	6	19	123	8336	8484	0.09986873273866817
M1	cpdb	0	network_modules	67	TRUE	3.6966085559751483e-4	507	32	10	0.3125	0.01972386587771203	REAC:R-HSA-9006934	REAC	Signaling by Receptor Tyrosine Kinases	10916	2302		0.8421052631578947	0.85	507	10409	10	22	497	10387	10916	0.06854980705000681
M1	cpdb	0	network_modules	67	TRUE	5.337689798581926e-4	30	32	4	0.125	0.13333333333333333	REAC:R-HSA-8874081	REAC	MET activates PTK2 signaling	10916	1362		0.8947368421052632	0.9	30	10886	4	28	26	10858	10916	0.1266206411838894
M1	cpdb	0	network_modules	67	TRUE	0.0017438161669696326	40	32	4	0.125	0.1	REAC:R-HSA-8875878	REAC	MET promotes cell motility	10916	1368		0.9473684210526315	0.95	40	10876	4	28	36	10848	10916	0.10888500868951265
M1	cpdb	0	network_modules	67	TRUE	0.003102904737335309	11	39	3	0.07692307692307693	0.2727272727272727	GO:0110011	GO:BP	regulation of basement membrane organization	16175	19343		0.5	0.5555555555555556	11	16164	3	36	8	16128	16175	0.14378313524319236
M1	cpdb	0	network_modules	67	TRUE	0.004130302474991433	12	39	3	0.07692307692307693	0.25	GO:2001046	GO:BP	positive regulation of integrin-mediated signaling pathway	16175	26291		0.625	0.6666666666666666	12	16163	3	36	9	16127	16175	0.13755449933414057
M1	cpdb	0	network_modules	67	TRUE	0.00614620163953786	101	39	5	0.1282051282051282	0.04950495049504951	GO:0007229	GO:BP	integrin-mediated signaling pathway	16175	2779		0.75	0.7777777777777778	101	16074	5	34	96	16040	16175	0.07611612804593554
M1	cpdb	0	network_modules	67	TRUE	0.00725666715850641	19	32	3	0.09375	0.15789473684210525	REAC:R-HSA-3000480	REAC	Scavenging by Class A Receptors	10916	2180		1	1	19	10897	3	29	16	10868	10916	0.11968682346539561
M1	cpdb	0	network_modules	67	TRUE	0.00833062456873419	2	39	2	0.05128205128205128	1	GO:0001507	GO:BP	acetylcholine catabolic process in synaptic cleft	16175	322		0.875	0.8888888888888888	2	16173	2	37	0	16136	16175	0.22619622029119613
M1	cpdb	0	network_modules	67	TRUE	0.009022295775055783	50	39	4	0.10256410256410256	0.08	GO:0030199	GO:BP	collagen fibril organization	16175	6708		1	1	50	16125	4	35	46	16090	16175	0.08809446455190707
M1	cpdb	0	network_modules	68	TRUE	0.007347153250999477	44	19	3	0.15789473684210525	0.06818181818181818	KEGG:00970	KEGG	Aminoacyl-tRNA biosynthesis	8484	153		NA	1	44	8440	3	16	41	8424	8484	0.10072322899666504
M1	cpdb	0	network_modules	68	TRUE	0.008303875390306035	2	36	2	0.05555555555555555	1	GO:0019075	GO:BP	virus maturation	16175	5567		NA	1	2	16173	2	34	0	16139	16175	0.23545437524377763
M1	cpdb	0	network_modules	68	TRUE	0.008456917761153215	24	27	3	0.1111111111111111	0.125	REAC:R-HSA-379716	REAC	Cytosolic tRNA aminoacylation	10916	430		NA	1	24	10892	3	24	21	10868	10916	0.11578964281504067
M1	cpdb	0	network_modules	69	TRUE	1.1877672199289092e-23	324	42	22	0.5238095238095238	0.06790123456790123	GO:0006816	GO:BP	calcium ion transport	16175	2495		0	0.025	324	15851	22	20	302	15831	16175	0.18346374524243778
M1	cpdb	0	network_modules	69	TRUE	2.4979333762808766e-17	249	42	17	0.40476190476190477	0.06827309236947791	GO:0070588	GO:BP	calcium ion transmembrane transport	16175	16193		0.02564102564102564	0.05	249	15926	17	25	232	15901	16175	0.1613683458594597
M1	cpdb	0	network_modules	69	TRUE	1.2469986678017974e-16	677	42	22	0.5238095238095238	0.03249630723781388	GO:0030001	GO:BP	metal ion transport	16175	6646		0.05128205128205128	0.075	677	15498	22	20	655	15478	16175	0.12279636858572535
M1	cpdb	0	network_modules	69	TRUE	1.0594281726594186e-15	748	42	22	0.5238095238095238	0.029411764705882353	GO:0006812	GO:BP	monoatomic cation transport	16175	2492		0.07692307692307693	0.1	748	15427	22	20	726	15407	16175	0.11602527602336124
M1	cpdb	0	network_modules	69	TRUE	1.24113637689493e-14	16	33	8	0.24242424242424243	0.5	REAC:R-HSA-139853	REAC	Elevation of cytosolic Ca2+ levels	10916	839		0	0.047619047619047616	16	10900	8	25	8	10875	10916	0.3468288375892233
M1	cpdb	0	network_modules	69	TRUE	1.6571033740077188e-14	233	42	15	0.35714285714285715	0.06437768240343347	GO:0006874	GO:BP	intracellular calcium ion homeostasis	16175	2532		0.10256410256410256	0.125	233	15942	15	27	218	15915	16175	0.14676555810094016
M1	cpdb	0	network_modules	69	TRUE	3.757188962060346e-14	246	42	15	0.35714285714285715	0.06097560975609756	GO:0055074	GO:BP	calcium ion homeostasis	16175	14230		0.1282051282051282	0.15	246	15929	15	27	231	15902	16175	0.1425581664803045
M1	cpdb	0	network_modules	69	TRUE	1.678720205264832e-12	577	42	18	0.42857142857142855	0.03119584055459272	GO:0098655	GO:BP	monoatomic cation transmembrane transport	16175	18811		0.15384615384615385	0.175	577	15598	18	24	559	15574	16175	0.10808614590593171
M1	cpdb	0	network_modules	69	TRUE	2.181355206311815e-12	105	33	11	0.3333333333333333	0.10476190476190476	REAC:R-HSA-2672351	REAC	Stimuli-sensing channels	10916	2354		0.05	0.09523809523809523	105	10811	11	22	94	10789	10916	0.18263358826607148
M1	cpdb	0	network_modules	69	TRUE	2.7588847704261807e-12	407	42	16	0.38095238095238093	0.03931203931203931	GO:0098771	GO:BP	inorganic ion homeostasis	16175	18886		0.1794871794871795	0.2	407	15768	16	26	391	15742	16175	0.11590968055419522
M1	cpdb	0	network_modules	69	TRUE	2.9248290239399495e-12	28	33	8	0.24242424242424243	0.2857142857142857	REAC:R-HSA-418360	REAC	Platelet calcium homeostasis	10916	1763		0.1	0.19047619047619047	28	10888	8	25	20	10863	10916	0.26112562468686923
M1	cpdb	0	network_modules	69	TRUE	2.9248290239399495e-12	28	33	8	0.24242424242424243	0.2857142857142857	REAC:R-HSA-3295583	REAC	TRP channels	10916	2474		0.1	0.19047619047619047	28	10888	8	25	20	10863	10916	0.26112562468686923
M1	cpdb	0	network_modules	69	TRUE	1.0926228561544298e-11	54	33	9	0.2727272727272727	0.16666666666666666	REAC:R-HSA-5578775	REAC	Ion homeostasis	10916	1273		0.2	0.23809523809523808	54	10862	9	24	45	10838	10916	0.21017119737826606
M1	cpdb	0	network_modules	69	TRUE	1.3390337901277257e-11	85	33	10	0.30303030303030304	0.11764705882352941	REAC:R-HSA-418346	REAC	Platelet homeostasis	10916	1765		0.25	0.2857142857142857	85	10831	10	23	75	10808	10916	0.18496215920819087
M1	cpdb	0	network_modules	69	TRUE	2.3004121248284493e-11	671	42	18	0.42857142857142855	0.026825633383010434	GO:0034220	GO:BP	monoatomic ion transmembrane transport	16175	8508		0.20512820512820512	0.225	671	15504	18	24	653	15480	16175	0.09904613916221486
M1	cpdb	0	network_modules	69	TRUE	2.3591565299885738e-11	467	42	16	0.38095238095238093	0.034261241970021415	GO:0055080	GO:BP	monoatomic cation homeostasis	16175	14233		0.23076923076923078	0.25	467	15708	16	26	451	15682	16175	0.10728392585128546
M1	cpdb	0	network_modules	69	TRUE	2.9531744822365774e-11	182	33	12	0.36363636363636365	0.06593406593406594	REAC:R-HSA-983712	REAC	Ion channel transport	10916	1272		0.3	0.3333333333333333	182	10734	12	21	170	10713	10916	0.1492153820799385
M1	cpdb	0	network_modules	69	TRUE	3.0712211781243486e-11	475	42	16	0.38095238095238093	0.03368421052631579	GO:0050801	GO:BP	monoatomic ion homeostasis	16175	13267		0.2564102564102564	0.275	475	15700	16	26	459	15674	16175	0.10625427259341959
M1	cpdb	0	network_modules	69	TRUE	3.190899884183623e-11	575	42	17	0.40476190476190477	0.029565217391304348	GO:0098662	GO:BP	inorganic cation transmembrane transport	16175	18818		0.28205128205128205	0.3	575	15600	17	25	558	15575	16175	0.10174015320927096
M1	cpdb	0	network_modules	69	TRUE	3.460433131143928e-11	10	33	6	0.18181818181818182	0.6	REAC:R-HSA-418890	REAC	Role of second messengers in netrin-1 signaling	10916	2110		0.35	0.38095238095238093	10	10906	6	27	4	10879	10916	0.32927369172184157
M1	cpdb	0	network_modules	69	TRUE	1.1181359643729631e-10	422	42	15	0.35714285714285715	0.035545023696682464	GO:0030003	GO:BP	intracellular monoatomic cation homeostasis	16175	6648		0.3076923076923077	0.325	422	15753	15	27	407	15726	16175	0.10596716422858495
M1	cpdb	0	network_modules	69	TRUE	1.1515086646779595e-10	40	42	8	0.19047619047619047	0.2	GO:0051480	GO:BP	regulation of cytosolic calcium ion concentration	16175	13738		0.3333333333333333	0.35	40	16135	8	34	32	16101	16175	0.1931355484634948
M1	cpdb	0	network_modules	69	TRUE	1.2829454609194206e-10	426	42	15	0.35714285714285715	0.035211267605633804	GO:0006873	GO:BP	intracellular monoatomic ion homeostasis	16175	2531		0.358974358974359	0.375	426	15749	15	27	411	15722	16175	0.10540309080035964
M1	cpdb	0	network_modules	69	TRUE	1.4171631168908493e-10	630	42	17	0.40476190476190477	0.026984126984126985	GO:0098660	GO:BP	inorganic ion transmembrane transport	16175	18816		0.38461538461538464	0.4	630	15545	17	25	613	15520	16175	0.09647277193701394
M1	cpdb	0	network_modules	69	TRUE	1.0450739625761747e-9	130	33	10	0.30303030303030304	0.07692307692307693	REAC:R-HSA-5576891	REAC	Cardiac conduction	10916	306		0.4	0.42857142857142855	130	10786	10	23	120	10763	10916	0.14778082929823533
M1	cpdb	0	network_modules	69	TRUE	3.1224136130235866e-9	763	42	17	0.40476190476190477	0.022280471821756225	GO:0048878	GO:BP	chemical homeostasis	16175	13119		0.41025641025641024	0.425	763	15412	17	25	746	15387	16175	0.08606080045993394
M1	cpdb	0	network_modules	69	TRUE	3.343753837923878e-9	203	33	11	0.3333333333333333	0.054187192118226604	REAC:R-HSA-397014	REAC	Muscle contraction	10916	1496		0.45	0.47619047619047616	203	10713	11	22	192	10691	10916	0.12828920246493639
M1	cpdb	0	network_modules	69	TRUE	3.364716077225173e-9	534	42	15	0.35714285714285715	0.028089887640449437	GO:0055082	GO:BP	intracellular chemical homeostasis	16175	14235		0.4358974358974359	0.45	534	15641	15	27	519	15614	16175	0.09256062941055182
M1	cpdb	0	network_modules	69	TRUE	3.997183993305088e-9	17	42	6	0.14285714285714285	0.35294117647058826	GO:0002115	GO:BP	store-operated calcium entry	16175	693		0.46153846153846156	0.475	17	16158	6	36	11	16122	16175	0.22329969772291636
M1	cpdb	0	network_modules	69	TRUE	5.8935863303748134e-9	101	42	9	0.21428571428571427	0.0891089108910891	GO:0051209	GO:BP	release of sequestered calcium ion into cytosol	16175	13568		0.48717948717948717	0.5	101	16074	9	33	92	16041	16175	0.13475307879831436
M1	cpdb	0	network_modules	69	TRUE	6.452017037375961e-9	102	42	9	0.21428571428571427	0.08823529411764706	GO:0051283	GO:BP	negative regulation of sequestering of calcium ion	16175	13619		0.5128205128205128	0.525	102	16073	9	33	93	16040	16175	0.1340552196433651
M1	cpdb	0	network_modules	69	TRUE	7.056729652499387e-9	103	42	9	0.21428571428571427	0.08737864077669903	GO:0051282	GO:BP	regulation of sequestering of calcium ion	16175	13618		0.5384615384615384	0.55	103	16072	9	33	94	16039	16175	0.13336737261667225
M1	cpdb	0	network_modules	69	TRUE	9.067267072965342e-9	115	30	9	0.3	0.0782608695652174	KEGG:04724	KEGG	Glutamatergic synapse	8484	354		0	0.05555555555555555	115	8369	9	21	106	8348	8484	0.14756583446034957
M1	cpdb	0	network_modules	69	TRUE	9.182502207815759e-9	106	42	9	0.21428571428571427	0.08490566037735849	GO:0051208	GO:BP	sequestering of calcium ion	16175	13567		0.5641025641025641	0.575	106	16069	9	33	97	16036	16175	0.13136153964600905
M1	cpdb	0	network_modules	69	TRUE	1.1835525810624115e-8	160	42	10	0.23809523809523808	0.0625	GO:0097553	GO:BP	calcium ion transmembrane import into cytosol	16175	18700		0.5897435897435898	0.6	160	16015	10	32	150	15983	16175	0.11765491437324024
M1	cpdb	0	network_modules	69	TRUE	3.027985168730464e-8	623	42	15	0.35714285714285715	0.024077046548956663	GO:0019725	GO:BP	cellular homeostasis	16175	6020		0.6153846153846154	0.625	623	15552	15	27	608	15525	16175	0.08448046361508288
M1	cpdb	0	network_modules	69	TRUE	4.704711195404438e-8	27	33	6	0.18181818181818182	0.2222222222222222	REAC:R-HSA-114508	REAC	Effects of PIP2 hydrolysis	10916	833		0.5	0.5238095238095238	27	10889	6	27	21	10862	10916	0.19881949452027545
M1	cpdb	0	network_modules	69	TRUE	1.2492637700614084e-7	154	30	9	0.3	0.05844155844155844	KEGG:04921	KEGG	Oxytocin signaling pathway	8484	378		0.058823529411764705	0.1111111111111111	154	8330	9	21	145	8309	8484	0.12576579675801183
M1	cpdb	0	network_modules	69	TRUE	5.379995576930402e-7	110	42	8	0.19047619047619047	0.07272727272727272	GO:0051592	GO:BP	response to calcium ion	16175	13809		0.6410256410256411	0.65	110	16065	8	34	102	16031	16175	0.11403182151057738
M1	cpdb	0	network_modules	69	TRUE	5.477138178119476e-7	251	30	10	0.3333333333333333	0.0398406374501992	KEGG:04020	KEGG	Calcium signaling pathway	8484	250		0.11764705882352941	0.16666666666666666	251	8233	10	20	241	8213	8484	0.10678936540270068
M1	cpdb	0	network_modules	69	TRUE	1.0354780894971297e-6	179	42	9	0.21428571428571427	0.05027932960893855	GO:0051924	GO:BP	regulation of calcium ion transport	16175	13997		0.6666666666666666	0.675	179	15996	9	33	170	15963	16175	0.09911605466851332
M1	cpdb	0	network_modules	69	TRUE	1.2000010031692515e-6	182	42	9	0.21428571428571427	0.04945054945054945	GO:0051651	GO:BP	maintenance of location in cell	16175	13864		0.6923076923076923	0.7	182	15993	9	33	173	15960	16175	0.09821526892629404
M1	cpdb	0	network_modules	69	TRUE	2.12099957196281e-6	49	33	6	0.18181818181818182	0.12244897959183673	REAC:R-HSA-373752	REAC	Netrin-1 signaling	10916	1586		0.55	0.5714285714285714	49	10867	6	27	43	10840	10916	0.14607434605701353
M1	cpdb	0	network_modules	69	TRUE	3.2490969065517216e-6	59	30	6	0.2	0.1016949152542373	KEGG:04730	KEGG	Long-term depression	8484	359		0.17647058823529413	0.2222222222222222	59	8425	6	24	53	8401	8484	0.13838193905671106
M1	cpdb	0	network_modules	69	TRUE	4.785130038214288e-6	164	30	8	0.26666666666666666	0.04878048780487805	KEGG:04022	KEGG	cGMP-PKG signaling pathway	8484	251		0.23529411764705882	0.2777777777777778	164	8320	8	22	156	8298	8484	0.10701242262080672
M1	cpdb	0	network_modules	69	TRUE	5.3409467862767825e-6	64	30	6	0.2	0.09375	KEGG:04929	KEGG	GnRH secretion	8484	386		0.29411764705882354	0.3333333333333333	64	8420	6	24	58	8396	8484	0.1325001788779275
M1	cpdb	0	network_modules	69	TRUE	1.2737322266267144e-5	10	42	4	0.09523809523809523	0.4	GO:0071415	GO:BP	cellular response to purine-containing compound	16175	16667		0.717948717948718	0.725	10	16165	4	38	6	16127	16175	0.19422530026150764
M1	cpdb	0	network_modules	69	TRUE	2.1385257250168578e-5	133	30	7	0.23333333333333334	0.05263157894736842	KEGG:04270	KEGG	Vascular smooth muscle contraction	8484	298		0.35294117647058826	0.3888888888888889	133	8351	7	23	126	8328	8484	0.1043775922614947
M1	cpdb	0	network_modules	69	TRUE	4.303673365593304e-5	274	42	9	0.21428571428571427	0.032846715328467155	GO:0051235	GO:BP	maintenance of location	16175	13585		0.7435897435897436	0.75	274	15901	9	33	265	15868	16175	0.07802830610437891
M1	cpdb	0	network_modules	69	TRUE	4.312347428821775e-5	13	42	4	0.09523809523809523	0.3076923076923077	GO:0007216	GO:BP	G protein-coupled glutamate receptor signaling pathway	16175	2770		0.7692307692307693	0.775	13	16162	4	38	9	16124	16175	0.17002872584561193
M1	cpdb	0	network_modules	69	TRUE	5.722813604971371e-5	84	33	6	0.18181818181818182	0.07142857142857142	REAC:R-HSA-983695	REAC	Antigen activates B Cell Receptor (BCR) leading to generation of second messengers	10916	152		0.6	0.6190476190476191	84	10832	6	27	78	10805	10916	0.10972573355026492
M1	cpdb	0	network_modules	69	TRUE	5.860497016083432e-5	284	42	9	0.21428571428571427	0.03169014084507042	GO:0010959	GO:BP	regulation of metal ion transport	16175	4536		0.7948717948717948	0.8	284	15891	9	33	275	15858	16175	0.07642619156442426
M1	cpdb	0	network_modules	69	TRUE	6.495134625440785e-5	97	30	6	0.2	0.061855670103092786	KEGG:04713	KEGG	Circadian entrainment	8484	348		0.4117647058823529	0.4444444444444444	97	8387	6	24	91	8363	8484	0.10565888161431342
M1	cpdb	0	network_modules	69	TRUE	9.952884895144719e-5	213	42	8	0.19047619047619047	0.03755868544600939	GO:0010038	GO:BP	response to metal ion	16175	3847		0.8205128205128205	0.825	213	15962	8	34	205	15928	16175	0.07936071271552222
M1	cpdb	0	network_modules	69	TRUE	1.5788953500840892e-4	163	33	7	0.21212121212121213	0.04294478527607362	REAC:R-HSA-983705	REAC	Signaling by the B Cell Receptor (BCR)	10916	2328		0.65	0.6666666666666666	163	10753	7	26	156	10727	10916	0.08953034280486472
M1	cpdb	0	network_modules	69	TRUE	2.2177508433031607e-4	56	33	5	0.15151515151515152	0.08928571428571429	REAC:R-HSA-6794361	REAC	Neurexins and neuroligins	10916	1587		0.7	0.7142857142857143	56	10860	5	28	51	10832	10916	0.11283245374259007
M1	cpdb	0	network_modules	69	TRUE	2.670931072666602e-4	69	30	5	0.16666666666666666	0.07246376811594203	KEGG:04924	KEGG	Renin secretion	8484	381		0.47058823529411764	0.5	69	8415	5	25	64	8390	8484	0.10514779855280372
M1	cpdb	0	network_modules	69	TRUE	2.7938467109604926e-4	341	42	9	0.21428571428571427	0.026392961876832845	GO:0043269	GO:BP	regulation of monoatomic ion transport	16175	10593		0.8461538461538461	0.85	341	15834	9	33	332	15801	16175	0.06862060090146146
M1	cpdb	0	network_modules	69	TRUE	5.109159922927428e-4	138	30	6	0.2	0.043478260869565216	KEGG:04371	KEGG	Apelin signaling pathway	8484	308		0.5294117647058824	0.5555555555555556	138	8346	6	24	132	8322	8484	0.08652491261313763
M1	cpdb	0	network_modules	69	TRUE	8.838618410955409e-4	7	42	3	0.07142857142857142	0.42857142857142855	GO:0071313	GO:BP	cellular response to caffeine	16175	16569		0.8717948717948718	0.9	7	16168	3	39	4	16129	16175	0.17416740619700813
M1	cpdb	0	network_modules	69	TRUE	8.838618410955409e-4	7	42	3	0.07142857142857142	0.42857142857142855	GO:0031000	GO:BP	response to caffeine	16175	6991		0.8717948717948718	0.9	7	16168	3	39	4	16129	16175	0.17416740619700813
M1	cpdb	0	network_modules	69	TRUE	8.884417232787924e-4	88	30	5	0.16666666666666666	0.056818181818181816	KEGG:04540	KEGG	Gap junction	8484	318		0.5882352941176471	0.6111111111111112	88	8396	5	25	83	8371	8484	0.09189576101954183
M1	cpdb	0	network_modules	69	TRUE	9.537425334124553e-4	213	33	7	0.21212121212121213	0.03286384976525822	REAC:R-HSA-416476	REAC	G alpha (q) signalling events	10916	988		0.75	0.7619047619047619	213	10703	7	26	206	10677	10916	0.0766794916587005
M1	cpdb	0	network_modules	69	TRUE	0.0010468713704938936	91	30	5	0.16666666666666666	0.054945054945054944	KEGG:04970	KEGG	Salivary secretion	8484	401		0.6470588235294118	0.6666666666666666	91	8393	5	25	86	8368	8484	0.09017996077820381
M1	cpdb	0	network_modules	69	TRUE	0.0014386360466176868	11	33	3	0.09090909090909091	0.2727272727272727	REAC:R-HSA-5607763	REAC	CLEC7A (Dectin-1) induces NFAT activation	10916	274		0.8	0.8095238095238095	11	10905	3	30	8	10875	10916	0.1560283225067308
M1	cpdb	0	network_modules	69	TRUE	0.0015025894134940777	98	30	5	0.16666666666666666	0.05102040816326531	KEGG:04925	KEGG	Aldosterone synthesis and secretion	8484	382		0.7058823529411765	0.7222222222222222	98	8386	5	25	93	8361	8484	0.08647586761764668
M1	cpdb	0	network_modules	69	TRUE	0.0018248099952902926	102	30	5	0.16666666666666666	0.049019607843137254	KEGG:04972	KEGG	Pancreatic secretion	8484	403		0.7647058823529411	0.7777777777777778	102	8382	5	25	97	8357	8484	0.08452582659728546
M1	cpdb	0	network_modules	69	TRUE	0.001896078126611865	86	33	5	0.15151515151515152	0.05813953488372093	REAC:R-HSA-6794362	REAC	Protein-protein interactions at synapses	10916	1819		0.85	0.8571428571428571	86	10830	5	28	81	10802	10916	0.08946403322301484
M1	cpdb	0	network_modules	69	TRUE	0.0021767799752466493	75	42	5	0.11904761904761904	0.06666666666666667	GO:0014074	GO:BP	response to purine-containing compound	16175	4639		0.9230769230769231	0.925	75	16100	5	37	70	16063	16175	0.08592804853937958
M1	cpdb	0	network_modules	69	TRUE	0.0030139760381132736	10	42	3	0.07142857142857142	0.3	GO:2001256	GO:BP	regulation of store-operated calcium entry	16175	26442		0.9487179487179487	0.95	10	16165	3	39	7	16126	16175	0.14535171233789398
M1	cpdb	0	network_modules	69	TRUE	0.003934551735295183	15	33	3	0.09090909090909091	0.2	REAC:R-HSA-418457	REAC	cGMP effects	10916	2691		0.9	0.9047619047619048	15	10901	3	30	12	10871	10916	0.13309447660274673
M1	cpdb	0	network_modules	69	TRUE	0.004672108903697571	124	30	5	0.16666666666666666	0.04032258064516129	KEGG:04611	KEGG	Platelet activation	8484	321		0.8235294117647058	0.8333333333333334	124	8360	5	25	119	8335	8484	0.07547536719965713
M1	cpdb	0	network_modules	69	TRUE	0.004832548874040493	16	33	3	0.09090909090909091	0.1875	REAC:R-HSA-5218921	REAC	VEGFR2 mediated cell proliferation	10916	2635		0.95	0.9523809523809523	16	10900	3	30	13	10870	10916	0.12874222519729
M1	cpdb	0	network_modules	69	TRUE	0.004975835227996712	64	30	4	0.13333333333333333	0.0625	KEGG:04927	KEGG	Cortisol synthesis and secretion	8484	384		0.8823529411764706	0.8888888888888888	64	8420	4	26	60	8394	8484	0.08660227272080122
M1	cpdb	0	network_modules	69	TRUE	0.005794567697401324	41	42	4	0.09523809523809523	0.0975609756097561	GO:0007215	GO:BP	glutamate receptor signaling pathway	16175	2769		0.9743589743589743	0.975	41	16134	4	38	37	16096	16175	0.09406838713293872
M1	cpdb	0	network_modules	69	TRUE	0.005958510025072529	67	30	4	0.13333333333333333	0.05970149253731343	KEGG:04720	KEGG	Long-term potentiation	8484	350		0.9411764705882353	0.9444444444444444	67	8417	4	26	63	8391	8484	0.0844183180965376
M1	cpdb	0	network_modules	69	TRUE	0.006333377341421232	93	42	5	0.11904761904761904	0.053763440860215055	GO:0051928	GO:BP	positive regulation of calcium ion transport	16175	13999		1	1	93	16082	5	37	88	16045	16175	0.07645785834544959
M1	cpdb	0	network_modules	69	TRUE	0.00860192314788206	141	30	5	0.16666666666666666	0.03546099290780142	KEGG:05017	KEGG	Spinocerebellar ataxia	8484	415		1	1	141	8343	5	25	136	8318	8484	0.0699177157383179
M1	cpdb	0	network_modules	69	TRUE	0.009865632956878511	59	33	4	0.12121212121212122	0.06779661016949153	REAC:R-HSA-4086398	REAC	Ca2+ pathway	10916	296		1	1	59	10857	4	29	55	10828	10916	0.0869762862710853
M1	cpdb	0	network_modules	70	TRUE	7.990914298598262e-26	73	23	15	0.6521739130434783	0.2054794520547945	REAC:R-HSA-6807505	REAC	RNA polymerase II transcribes snRNA genes	10916	1904		NA	1	73	10843	15	8	58	10835	10916	0.3639189624488546
M1	cpdb	0	network_modules	70	TRUE	2.873402400638969e-24	34	35	13	0.37142857142857144	0.38235294117647056	GO:0016180	GO:BP	snRNA processing	16175	5161		0	0.125	34	16141	13	22	21	16119	16175	0.37551942953302664
M1	cpdb	0	network_modules	70	TRUE	7.274574633064552e-21	81	35	14	0.4	0.1728395061728395	GO:0034243	GO:BP	regulation of transcription elongation by RNA polymerase II	16175	8519		0.14285714285714285	0.25	81	16094	14	21	67	16073	16175	0.26057973445691324
M1	cpdb	0	network_modules	70	TRUE	7.36318261856767e-21	57	35	13	0.37142857142857144	0.22807017543859648	GO:0016073	GO:BP	snRNA metabolic process	16175	5100		0.2857142857142857	0.375	57	16118	13	22	44	16096	16175	0.28911377080290857
M1	cpdb	0	network_modules	70	TRUE	9.374574860065386e-20	96	35	14	0.4	0.14583333333333334	GO:0032784	GO:BP	regulation of DNA-templated transcription elongation	16175	7819		0.42857142857142855	0.5	96	16079	14	21	82	16058	16175	0.23890716898394698
M1	cpdb	0	network_modules	70	TRUE	2.6728273093319515e-19	103	35	14	0.4	0.13592233009708737	GO:0006368	GO:BP	transcription elongation by RNA polymerase II	16175	2143		0.5714285714285714	0.625	103	16072	14	21	89	16051	16175	0.23044300647938673
M1	cpdb	0	network_modules	70	TRUE	1.989876335251638e-18	118	35	14	0.4	0.11864406779661017	GO:0006354	GO:BP	DNA-templated transcription elongation	16175	2131		0.7142857142857143	0.75	118	16057	14	21	104	16036	16175	0.21489164927412147
M1	cpdb	0	network_modules	70	TRUE	2.9534987708254524e-16	22	35	9	0.2571428571428571	0.4090909090909091	GO:0034472	GO:BP	snRNA 3'-end processing	16175	8649		0.8571428571428571	0.875	22	16153	9	26	13	16127	16175	0.3231914281279081
M1	cpdb	0	network_modules	70	TRUE	1.265798931429156e-10	80	35	9	0.2571428571428571	0.1125	GO:0031123	GO:BP	RNA 3'-end processing	16175	7048		1	1	80	16095	9	26	71	16069	16175	0.16740788030607454
M1	cpdb	0	network_modules	70	TRUE	0.007412491838691486	116	8	3	0.375	0.02586206896551724	KEGG:03082	KEGG	ATP-dependent chromatin remodeling	8484	219		NA	1	116	8368	3	5	113	8363	8484	0.09558968040010071
M1	cpdb	0	network_modules	71	TRUE	2.2149651323819308e-5	17	27	4	0.14814814814814814	0.23529411764705882	REAC:R-HSA-1482922	REAC	Acyl chain remodelling of PI	10916	115		0	0.16666666666666666	17	10899	4	23	13	10876	10916	0.18511445873127344
M1	cpdb	0	network_modules	71	TRUE	6.106737545173351e-5	61	26	5	0.19230769230769232	0.08196721311475409	KEGG:00590	KEGG	Arachidonic acid metabolism	8484	92		0	0.25	61	8423	5	21	56	8402	8484	0.12147952698567309
M1	cpdb	0	network_modules	71	TRUE	6.344838709176865e-5	26	26	4	0.15384615384615385	0.15384615384615385	KEGG:00592	KEGG	alpha-Linolenic acid metabolism	8484	94		0.3333333333333333	0.5	26	8458	4	22	22	8436	8484	0.1512450661185587
M1	cpdb	0	network_modules	71	TRUE	1.1534507814978218e-4	30	26	4	0.15384615384615385	0.13333333333333333	KEGG:00591	KEGG	Linoleic acid metabolism	8484	93		0.6666666666666666	0.75	30	8454	4	22	26	8432	8484	0.1403944266069589
M1	cpdb	0	network_modules	71	TRUE	1.6059684472906937e-4	27	27	4	0.14814814814814814	0.14814814814814814	REAC:R-HSA-1482788	REAC	Acyl chain remodelling of PC	10916	112		0.2	0.3333333333333333	27	10889	4	23	23	10866	10916	0.1460359248034884
M1	cpdb	0	network_modules	71	TRUE	2.1660861819990232e-4	29	27	4	0.14814814814814814	0.13793103448275862	REAC:R-HSA-1482839	REAC	Acyl chain remodelling of PE	10916	113		0.4	0.5	29	10887	4	23	25	10864	10916	0.14074595211939764
M1	cpdb	0	network_modules	71	TRUE	9.298447536883358e-4	50	26	4	0.15384615384615385	0.08	KEGG:00565	KEGG	Ether lipid metabolism	8484	89		1	1	50	8434	4	22	46	8412	8484	0.10717034025582045
M1	cpdb	0	network_modules	71	TRUE	0.001888405475738017	2	27	2	0.07407407407407407	1	REAC:R-HSA-1299316	REAC	TWIK-releated acid-sensitive K+ channel (TASK)	10916	2478		0.6	0.6666666666666666	2	10914	2	25	0	10889	10916	0.271853632203404
M1	cpdb	0	network_modules	71	TRUE	0.003443423667529107	18	27	3	0.1111111111111111	0.16666666666666666	REAC:R-HSA-1482925	REAC	Acyl chain remodelling of PG	10916	114		0.8	0.8333333333333334	18	10898	3	24	15	10874	10916	0.13434012607631576
M1	cpdb	0	network_modules	71	TRUE	0.005067213740249552	14	34	3	0.08823529411764706	0.21428571428571427	GO:0036151	GO:BP	phosphatidylcholine acyl-chain remodeling	16175	9464		0	0.3333333333333333	14	16161	3	31	11	16130	16175	0.13635828904223973
M1	cpdb	0	network_modules	71	TRUE	0.006455874978624031	22	27	3	0.1111111111111111	0.13636363636363635	REAC:R-HSA-1482801	REAC	Acyl chain remodelling of PS	10916	116		1	1	22	10894	3	24	19	10870	10916	0.12113066474511494
M1	cpdb	0	network_modules	71	TRUE	0.007126507316855415	117	34	5	0.14705882352941177	0.042735042735042736	GO:0099587	GO:BP	inorganic ion import across plasma membrane	16175	19152		0.5	1	117	16058	5	29	112	16029	16175	0.07572966958465276
M1	cpdb	0	network_modules	71	TRUE	0.007126507316855415	117	34	5	0.14705882352941177	0.042735042735042736	GO:0098659	GO:BP	inorganic cation import across plasma membrane	16175	18815		0.5	1	117	16058	5	29	112	16029	16175	0.07572966958465276
M1	cpdb	0	network_modules	72	TRUE	2.2409267481883128e-4	42	19	4	0.21052631578947367	0.09523809523809523	REAC:R-HSA-3769402	REAC	Deactivation of the beta-catenin transactivating complex	10916	452		0	0.25	42	10874	4	15	38	10859	10916	0.13940019271875287
M1	cpdb	0	network_modules	72	TRUE	0.0027579290447909063	171	19	5	0.2631578947368421	0.029239766081871343	REAC:R-HSA-9010553	REAC	Regulation of expression of SLITs and ROBOs	10916	2031		0.3333333333333333	0.5	171	10745	5	14	166	10731	10916	0.08322392305956053
M1	cpdb	0	network_modules	72	TRUE	0.0029439707684876517	192	10	4	0.4	0.020833333333333332	KEGG:05202	KEGG	Transcriptional misregulation in cancer	8484	454		NA	1	192	8292	4	6	188	8286	8484	0.08716508949483322
M1	cpdb	0	network_modules	72	TRUE	0.004852045351436474	90	19	4	0.21052631578947367	0.044444444444444446	REAC:R-HSA-201722	REAC	Formation of the beta-catenin:TCF transactivating complex	10916	968		0.6666666666666666	0.75	90	10826	4	15	86	10811	10916	0.0934088083893881
M1	cpdb	0	network_modules	72	TRUE	0.008745964450894334	217	19	5	0.2631578947368421	0.02304147465437788	REAC:R-HSA-376176	REAC	Signaling by ROBO receptors	10916	2301		1	1	217	10699	5	14	212	10685	10916	0.07277625252928083
M1	cpdb	0	network_modules	73	TRUE	7.208680227289316e-20	516	40	22	0.55	0.04263565891472868	GO:0099536	GO:BP	synaptic signaling	16175	19115		0	0.011904761904761904	516	15659	22	18	494	15641	16175	0.14678971343392438
M1	cpdb	0	network_modules	73	TRUE	3.423786629323323e-17	492	40	20	0.5	0.04065040650406504	GO:0099537	GO:BP	trans-synaptic signaling	16175	19116		0.012048192771084338	0.023809523809523808	492	15683	20	20	472	15663	16175	0.1361459592655636
M1	cpdb	0	network_modules	73	TRUE	6.146504635377682e-17	400	33	19	0.5757575757575758	0.0475	REAC:R-HSA-112316	REAC	Neuronal System	10916	1590		0	0.03225806451612903	400	10516	19	14	381	10502	10916	0.15800528073969394
M1	cpdb	0	network_modules	73	TRUE	1.0729692485194075e-16	18	33	9	0.2727272727272727	0.5	REAC:R-HSA-442982	REAC	Ras activation upon Ca2+ influx through NMDA receptor	10916	1941		0.03333333333333333	0.06451612903225806	18	10898	9	24	9	10874	10916	0.3679012884157803
M1	cpdb	0	network_modules	73	TRUE	3.691945734560102e-16	20	33	9	0.2727272727272727	0.45	REAC:R-HSA-9617324	REAC	Negative regulation of NMDA receptor-mediated neuronal transmission	10916	1575		0.06666666666666667	0.12903225806451613	20	10896	9	24	11	10872	10916	0.34881791864085077
M1	cpdb	0	network_modules	73	TRUE	3.691945734560102e-16	20	33	9	0.2727272727272727	0.45	REAC:R-HSA-438066	REAC	Unblocking of NMDA receptors, glutamate binding and activation	10916	2621		0.06666666666666667	0.12903225806451613	20	10896	9	24	11	10872	10916	0.34881791864085077
M1	cpdb	0	network_modules	73	TRUE	6.448101083415426e-16	21	33	9	0.2727272727272727	0.42857142857142855	REAC:R-HSA-9620244	REAC	Long-term potentiation	10916	1321		0.13333333333333333	0.16129032258064516	21	10895	9	24	12	10871	10916	0.34031193197619697
M1	cpdb	0	network_modules	73	TRUE	8.944374772409811e-16	487	40	19	0.475	0.039014373716632446	GO:0007268	GO:BP	chemical synaptic transmission	16175	2796		0.024096385542168676	0.047619047619047616	487	15688	19	21	468	15667	16175	0.1296271397956192
M1	cpdb	0	network_modules	73	TRUE	8.944374772409811e-16	487	40	19	0.475	0.039014373716632446	GO:0098916	GO:BP	anterograde trans-synaptic signaling	16175	18949		0.024096385542168676	0.047619047619047616	487	15688	19	21	468	15667	16175	0.1296271397956192
M1	cpdb	0	network_modules	73	TRUE	1.0430604565913174e-15	196	33	15	0.45454545454545453	0.07653061224489796	REAC:R-HSA-112314	REAC	Neurotransmitter receptors and postsynaptic signal transmission	10916	1594		0.16666666666666666	0.1935483870967742	196	10720	15	18	181	10702	10916	0.18104840235830114
M1	cpdb	0	network_modules	73	TRUE	1.8209809267447987e-15	259	33	16	0.48484848484848486	0.06177606177606178	REAC:R-HSA-112315	REAC	Transmission across Chemical Synapses	10916	2580		0.2	0.22580645161290322	259	10657	16	17	243	10640	10916	0.16683782299774488
M1	cpdb	0	network_modules	73	TRUE	4.351678911675698e-15	89	33	12	0.36363636363636365	0.1348314606741573	REAC:R-HSA-442755	REAC	Activation of NMDA receptors and postsynaptic events	10916	89		0.23333333333333334	0.25806451612903225	89	10827	12	21	77	10806	10916	0.21767882486136483
M1	cpdb	0	network_modules	73	TRUE	6.786830142283414e-15	26	33	9	0.2727272727272727	0.34615384615384615	REAC:R-HSA-442742	REAC	CREB1 phosphorylation through NMDA receptor-mediated activation of RAS signaling	10916	283		0.26666666666666666	0.2903225806451613	26	10890	9	24	17	10866	10916	0.30539690380184575
M1	cpdb	0	network_modules	73	TRUE	8.89596747333919e-15	43	33	10	0.30303030303030304	0.23255813953488372	REAC:R-HSA-9609736	REAC	Assembly and cell surface presentation of NMDA receptors	10916	173		0.3	0.3225806451612903	43	10873	10	23	33	10850	10916	0.2629303961820007
M1	cpdb	0	network_modules	73	TRUE	5.2924580030230727e-14	76	33	11	0.3333333333333333	0.14473684210526316	REAC:R-HSA-438064	REAC	Post NMDA receptor activation events	10916	1772		0.3333333333333333	0.3548387096774194	76	10840	11	22	65	10818	10916	0.2161406277710387
M1	cpdb	0	network_modules	73	TRUE	1.611268157820779e-13	56	33	10	0.30303030303030304	0.17857142857142858	REAC:R-HSA-6794361	REAC	Neurexins and neuroligins	10916	1587		0.36666666666666664	0.3870967741935484	56	10860	10	23	46	10837	10916	0.2296191359331113
M1	cpdb	0	network_modules	73	TRUE	2.219079872861246e-13	86	33	11	0.3333333333333333	0.12790697674418605	REAC:R-HSA-6794362	REAC	Protein-protein interactions at synapses	10916	1819		0.4	0.41935483870967744	86	10830	11	22	75	10808	10916	0.20270929471222246
M1	cpdb	0	network_modules	73	TRUE	7.658432026287156e-13	13	40	7	0.175	0.5384615384615384	GO:1990806	GO:BP	ligand-gated ion channel signaling pathway	16175	25299		0.04819277108433735	0.07142857142857142	13	16162	7	33	6	16129	16175	0.3060620447960912
M1	cpdb	0	network_modules	73	TRUE	7.658432026287156e-13	13	40	7	0.175	0.5384615384615384	GO:0035235	GO:BP	ionotropic glutamate receptor signaling pathway	16175	8919		0.04819277108433735	0.07142857142857142	13	16162	7	33	6	16129	16175	0.3060620447960912
M1	cpdb	0	network_modules	73	TRUE	1.2135134271761398e-12	69	30	10	0.3333333333333333	0.14492753623188406	KEGG:05031	KEGG	Amphetamine addiction	8484	419		0	0.045454545454545456	69	8415	10	20	59	8395	8484	0.2156897964365691
M1	cpdb	0	network_modules	73	TRUE	1.3388946947945127e-12	262	40	14	0.35	0.05343511450381679	GO:0050804	GO:BP	modulation of chemical synaptic transmission	16175	13270		0.07228915662650602	0.08333333333333333	262	15913	14	26	248	15887	16175	0.13165952099390907
M1	cpdb	0	network_modules	73	TRUE	1.4120232173111406e-12	263	40	14	0.35	0.053231939163498096	GO:0099177	GO:BP	regulation of trans-synaptic signaling	16175	19085		0.08433734939759036	0.09523809523809523	263	15912	14	26	249	15886	16175	0.1313887693730586
M1	cpdb	0	network_modules	73	TRUE	5.4883594776469375e-12	115	30	11	0.36666666666666664	0.09565217391304348	KEGG:04724	KEGG	Glutamatergic synapse	8484	354		0.047619047619047616	0.09090909090909091	115	8369	11	19	104	8350	8484	0.18191001846609958
M1	cpdb	0	network_modules	73	TRUE	3.3777460210173507e-11	37	40	8	0.2	0.21621621621621623	GO:0048168	GO:BP	regulation of neuronal synaptic plasticity	16175	12562		0.0963855421686747	0.10714285714285714	37	16138	8	32	29	16106	16175	0.20606216222915605
M1	cpdb	0	network_modules	73	TRUE	4.2246655733996666e-11	97	30	10	0.3333333333333333	0.10309278350515463	KEGG:04713	KEGG	Circadian entrainment	8484	348		0.09523809523809523	0.13636363636363635	97	8387	10	20	87	8367	8484	0.18036904968664202
M1	cpdb	0	network_modules	73	TRUE	4.644590064624033e-11	21	33	7	0.21212121212121213	0.3333333333333333	REAC:R-HSA-8849932	REAC	Synaptic adhesion-like molecules	10916	2366		0.43333333333333335	0.45161290322580644	21	10895	7	26	14	10869	10916	0.26414982088656863
M1	cpdb	0	network_modules	73	TRUE	6.141401198700317e-11	67	30	9	0.3	0.13432835820895522	KEGG:04720	KEGG	Long-term potentiation	8484	350		0.14285714285714285	0.18181818181818182	67	8417	9	21	58	8396	8484	0.19658473586434833
M1	cpdb	0	network_modules	73	TRUE	1.531559773475583e-10	44	40	8	0.2	0.18181818181818182	GO:0060079	GO:BP	excitatory postsynaptic potential	16175	14338		0.10843373493975904	0.11904761904761904	44	16131	8	32	36	16099	16175	0.18858855424669405
M1	cpdb	0	network_modules	73	TRUE	2.584381870777421e-10	49	30	8	0.26666666666666666	0.16326530612244897	KEGG:05030	KEGG	Cocaine addiction	8484	418		0.19047619047619047	0.22727272727272727	49	8435	8	22	41	8413	8484	0.20509205077685097
M1	cpdb	0	network_modules	73	TRUE	5.435101924292075e-10	51	40	8	0.2	0.1568627450980392	GO:0099565	GO:BP	chemical synaptic transmission, postsynaptic	16175	19143		0.12048192771084337	0.13095238095238096	51	16124	8	32	43	16092	16175	0.17482240363896107
M1	cpdb	0	network_modules	73	TRUE	5.995274368697447e-10	127	40	10	0.25	0.07874015748031496	GO:0048167	GO:BP	regulation of synaptic plasticity	16175	12561		0.13253012048192772	0.14285714285714285	127	16048	10	30	117	16018	16175	0.13660262487656535
M1	cpdb	0	network_modules	73	TRUE	1.136394428416863e-9	31	40	7	0.175	0.22580645161290322	GO:0098815	GO:BP	modulation of excitatory postsynaptic potential	16175	18902		0.14457831325301204	0.15476190476190477	31	16144	7	33	24	16111	16175	0.19704206598846383
M1	cpdb	0	network_modules	73	TRUE	1.3333952746163343e-9	251	30	12	0.4	0.04780876494023904	KEGG:04020	KEGG	Calcium signaling pathway	8484	250		0.23809523809523808	0.2727272727272727	251	8233	12	18	239	8215	8484	0.1302274969788619
M1	cpdb	0	network_modules	73	TRUE	2.0821055841188877e-9	354	40	13	0.325	0.03672316384180791	GO:0034762	GO:BP	regulation of transmembrane transport	16175	8731		0.1566265060240964	0.16666666666666666	354	15821	13	27	341	15794	16175	0.1031520196161583
M1	cpdb	0	network_modules	73	TRUE	2.4696181052390537e-9	61	40	8	0.2	0.13114754098360656	GO:0060078	GO:BP	regulation of postsynaptic membrane potential	16175	14337		0.1686746987951807	0.17857142857142858	61	16114	8	32	53	16082	16175	0.1593990893936124
M1	cpdb	0	network_modules	73	TRUE	5.271040020917682e-9	381	40	13	0.325	0.03412073490813648	GO:0044057	GO:BP	regulation of system process	16175	10893		0.18072289156626506	0.19047619047619047	381	15794	13	27	368	15767	16175	0.0989667980556818
M1	cpdb	0	network_modules	73	TRUE	9.543514032263751e-9	41	40	7	0.175	0.17073170731707318	GO:0007215	GO:BP	glutamate receptor signaling pathway	16175	2769		0.1927710843373494	0.20238095238095238	41	16134	7	33	34	16101	16175	0.1707766077273347
M1	cpdb	0	network_modules	73	TRUE	1.5123051192940125e-8	308	33	12	0.36363636363636365	0.03896103896103896	REAC:R-HSA-5683057	REAC	MAPK family signaling cascades	10916	1348		0.4666666666666667	0.4838709677419355	308	10608	12	21	296	10587	10916	0.11154347970558097
M1	cpdb	0	network_modules	73	TRUE	1.555114559497631e-8	22	40	6	0.15	0.2727272727272727	GO:2000463	GO:BP	positive regulation of excitatory postsynaptic potential	16175	25775		0.20481927710843373	0.21428571428571427	22	16153	6	34	16	16119	16175	0.20081086115108482
M1	cpdb	0	network_modules	73	TRUE	2.9042868942217588e-8	341	40	12	0.3	0.03519061583577713	GO:0043269	GO:BP	regulation of monoatomic ion transport	16175	10593		0.21686746987951808	0.2261904761904762	341	15834	12	28	329	15806	16175	0.09667049951902591
M1	cpdb	0	network_modules	73	TRUE	4.704711195404438e-8	27	33	6	0.18181818181818182	0.2222222222222222	REAC:R-HSA-399721	REAC	Glutamate binding, activation of AMPA receptors and synaptic plasticity	10916	1057		0.5	0.5483870967741935	27	10889	6	27	21	10862	10916	0.19881949452027545
M1	cpdb	0	network_modules	73	TRUE	4.704711195404438e-8	27	33	6	0.18181818181818182	0.2222222222222222	REAC:R-HSA-399719	REAC	Trafficking of AMPA receptors	10916	2532		0.5	0.5483870967741935	27	10889	6	27	21	10862	10916	0.19881949452027545
M1	cpdb	0	network_modules	73	TRUE	5.723263367156046e-8	264	33	11	0.3333333333333333	0.041666666666666664	REAC:R-HSA-5673001	REAC	RAF/MAP kinase cascade	10916	1841		0.5666666666666667	0.5806451612903226	264	10652	11	22	253	10630	10916	0.11081434781270832
M1	cpdb	0	network_modules	73	TRUE	6.996958063290509e-8	269	33	11	0.3333333333333333	0.040892193308550186	REAC:R-HSA-5684996	REAC	MAPK1/MAPK3 signaling	10916	1351		0.6	0.6129032258064516	269	10647	11	22	258	10625	10916	0.10964272737941001
M1	cpdb	0	network_modules	73	TRUE	2.158327054273381e-7	229	40	10	0.25	0.043668122270742356	GO:1904062	GO:BP	regulation of monoatomic cation transmembrane transport	16175	23501		0.2289156626506024	0.23809523809523808	229	15946	10	30	219	15916	16175	0.09939578578748327
M1	cpdb	0	network_modules	73	TRUE	2.899298027460057e-7	235	30	10	0.3333333333333333	0.0425531914893617	KEGG:04014	KEGG	Ras signaling pathway	8484	247		0.2857142857142857	0.3181818181818182	235	8249	10	20	225	8229	8484	0.1109423700541728
M1	cpdb	0	network_modules	73	TRUE	3.364619161855669e-7	324	40	11	0.275	0.033950617283950615	GO:0006816	GO:BP	calcium ion transport	16175	2495		0.24096385542168675	0.25	324	15851	11	29	313	15822	16175	0.09061007559801751
M1	cpdb	0	network_modules	73	TRUE	5.202895105702442e-7	677	40	14	0.35	0.0206794682422452	GO:0030001	GO:BP	metal ion transport	16175	6646		0.25301204819277107	0.2619047619047619	677	15498	14	26	663	15472	16175	0.07661488705967348
M1	cpdb	0	network_modules	73	TRUE	5.547371536323855e-7	118	40	8	0.2	0.06779661016949153	GO:0007611	GO:BP	learning or memory	16175	3068		0.26506024096385544	0.27380952380952384	118	16057	8	32	110	16025	16175	0.11274806721919119
M1	cpdb	0	network_modules	73	TRUE	6.531517654146373e-7	73	40	7	0.175	0.0958904109589041	GO:0031644	GO:BP	regulation of nervous system process	16175	7254		0.27710843373493976	0.2857142857142857	73	16102	7	33	66	16069	16175	0.1266424714334865
M1	cpdb	0	network_modules	73	TRUE	8.042104666653866e-7	262	40	10	0.25	0.03816793893129771	GO:0034765	GO:BP	regulation of monoatomic ion transmembrane transport	16175	8734		0.2891566265060241	0.2976190476190476	262	15913	10	30	252	15883	16175	0.0922171400692162
M1	cpdb	0	network_modules	73	TRUE	1.4645854026250943e-6	141	30	8	0.26666666666666666	0.05673758865248227	KEGG:05017	KEGG	Spinocerebellar ataxia	8484	415		0.3333333333333333	0.36363636363636365	141	8343	8	22	133	8321	8484	0.11651487994286534
M1	cpdb	0	network_modules	73	TRUE	1.5499119008807541e-6	7	40	4	0.1	0.5714285714285714	GO:0098976	GO:BP	excitatory chemical synaptic transmission	16175	18986		0.30120481927710846	0.30952380952380953	7	16168	4	36	3	16132	16175	0.23835763610482583
M1	cpdb	0	network_modules	73	TRUE	1.6422347530546837e-6	282	40	10	0.25	0.03546099290780142	GO:0042391	GO:BP	regulation of membrane potential	16175	10141		0.3132530120481928	0.32142857142857145	282	15893	10	30	272	15863	16175	0.08847242770516363
M1	cpdb	0	network_modules	73	TRUE	1.6583261286298994e-6	740	40	14	0.35	0.01891891891891892	GO:0098657	GO:BP	import into cell	16175	18813		0.3253012048192771	0.3333333333333333	740	15435	14	26	726	15409	16175	0.07250229630176099
M1	cpdb	0	network_modules	73	TRUE	1.9063623934128654e-6	748	40	14	0.35	0.01871657754010695	GO:0006812	GO:BP	monoatomic cation transport	16175	2492		0.3373493975903614	0.34523809523809523	748	15427	14	26	734	15401	16175	0.07201497842660995
M1	cpdb	0	network_modules	73	TRUE	3.1001434996866567e-6	638	40	13	0.325	0.02037617554858934	GO:0018193	GO:BP	peptidyl-amino acid modification	16175	5353		0.3493975903614458	0.35714285714285715	638	15537	13	27	625	15510	16175	0.07304454660546468
M1	cpdb	0	network_modules	73	TRUE	3.767387713273735e-6	150	40	8	0.2	0.05333333333333334	GO:0016358	GO:BP	dendrite development	16175	5220		0.3614457831325301	0.36904761904761907	150	16025	8	32	142	15993	16175	0.09907316347528902
M1	cpdb	0	network_modules	73	TRUE	4.932951120059577e-6	97	40	7	0.175	0.07216494845360824	GO:0050806	GO:BP	positive regulation of synaptic transmission	16175	13272		0.37349397590361444	0.38095238095238093	97	16078	7	33	90	16045	16175	0.10898897521628266
M1	cpdb	0	network_modules	73	TRUE	5.974670271509613e-6	159	40	8	0.2	0.050314465408805034	GO:0050890	GO:BP	cognition	16175	13334		0.3855421686746988	0.39285714285714285	159	16016	8	32	151	15984	16175	0.0959745865067241
M1	cpdb	0	network_modules	73	TRUE	6.2780061061253175e-6	160	40	8	0.2	0.05	GO:0097553	GO:BP	calcium ion transmembrane import into cytosol	16175	18700		0.39759036144578314	0.40476190476190477	160	16015	8	32	152	15983	16175	0.0956460783837067
M1	cpdb	0	network_modules	73	TRUE	1.59962114332645e-5	593	40	12	0.3	0.02023608768971332	GO:0007417	GO:BP	central nervous system development	16175	2912		0.40963855421686746	0.4166666666666667	593	15582	12	28	581	15554	16175	0.0697694318919639
M1	cpdb	0	network_modules	73	TRUE	1.679628272138159e-5	40	30	5	0.16666666666666666	0.125	KEGG:05033	KEGG	Nicotine addiction	8484	421		0.38095238095238093	0.4090909090909091	40	8444	5	25	35	8419	8484	0.14083549688259306
M1	cpdb	0	network_modules	73	TRUE	1.7297500509581663e-5	182	40	8	0.2	0.04395604395604396	GO:0032412	GO:BP	regulation of monoatomic ion transmembrane transporter activity	16175	7550		0.42168674698795183	0.42857142857142855	182	15993	8	32	174	15961	16175	0.08909875846878855
M1	cpdb	0	network_modules	73	TRUE	1.927751352068351e-5	131	30	7	0.23333333333333334	0.05343511450381679	KEGG:04728	KEGG	Dopaminergic synapse	8484	358		0.42857142857142855	0.45454545454545453	131	8353	7	23	124	8330	8484	0.1052726525046337
M1	cpdb	0	network_modules	73	TRUE	1.9715104295708422e-5	35	33	5	0.15151515151515152	0.14285714285714285	REAC:R-HSA-111933	REAC	Calmodulin induced events	10916	301		0.6333333333333333	0.6774193548387096	35	10881	5	28	30	10853	10916	0.1444590714495404
M1	cpdb	0	network_modules	73	TRUE	1.9715104295708422e-5	35	33	5	0.15151515151515152	0.14285714285714285	REAC:R-HSA-111997	REAC	CaM pathway	10916	297		0.6333333333333333	0.6774193548387096	35	10881	5	28	30	10853	10916	0.1444590714495404
M1	cpdb	0	network_modules	73	TRUE	2.422022756287891e-5	190	40	8	0.2	0.042105263157894736	GO:0022898	GO:BP	regulation of transmembrane transporter activity	16175	6629		0.43373493975903615	0.44047619047619047	190	15985	8	32	182	15953	16175	0.0869960806041579
M1	cpdb	0	network_modules	73	TRUE	2.635913795635907e-5	37	33	5	0.15151515151515152	0.13513513513513514	REAC:R-HSA-111996	REAC	Ca-dependent events	10916	294		0.7	0.7096774193548387	37	10879	5	28	32	10851	10916	0.1403398625831084
M1	cpdb	0	network_modules	73	TRUE	3.227129799412123e-5	210	30	8	0.26666666666666666	0.0380952380952381	KEGG:04015	KEGG	Rap1 signaling pathway	8484	248		0.47619047619047616	0.5	210	8274	8	22	202	8252	8484	0.09275217575137412
M1	cpdb	0	network_modules	73	TRUE	3.294336368999665e-5	284	40	9	0.225	0.03169014084507042	GO:0010959	GO:BP	regulation of metal ion transport	16175	4536		0.4457831325301205	0.4523809523809524	284	15891	9	31	275	15860	16175	0.07864150049714903
M1	cpdb	0	network_modules	73	TRUE	4.0580745144600985e-5	203	40	8	0.2	0.03940886699507389	GO:0032409	GO:BP	regulation of transporter activity	16175	7547		0.4578313253012048	0.4642857142857143	203	15972	8	32	195	15940	16175	0.0838391830983051
M1	cpdb	0	network_modules	73	TRUE	4.133320876341392e-5	76	40	6	0.15	0.07894736842105263	GO:0018107	GO:BP	peptidyl-threonine phosphorylation	16175	5326		0.46987951807228917	0.4880952380952381	76	16099	6	34	70	16065	16175	0.10579212137437036
M1	cpdb	0	network_modules	73	TRUE	4.133320876341392e-5	76	40	6	0.15	0.07894736842105263	GO:0035249	GO:BP	synaptic transmission, glutamatergic	16175	8924		0.46987951807228917	0.4880952380952381	76	16099	6	34	70	16065	16175	0.10579212137437036
M1	cpdb	0	network_modules	73	TRUE	4.4930248075238024e-5	41	33	5	0.15151515151515152	0.12195121951219512	REAC:R-HSA-1489509	REAC	DAG and IP3 signaling	10916	431		0.7333333333333333	0.7419354838709677	41	10875	5	28	36	10847	10916	0.13301301671267274
M1	cpdb	0	network_modules	73	TRUE	5.101615367177106e-5	223	30	8	0.26666666666666666	0.03587443946188341	KEGG:04024	KEGG	cAMP signaling pathway	8484	252		0.5238095238095238	0.5454545454545454	223	8261	8	22	215	8239	8484	0.08950827303630293
M1	cpdb	0	network_modules	73	TRUE	7.751396454888154e-5	684	40	12	0.3	0.017543859649122806	GO:0031175	GO:BP	neuron projection development	16175	7086		0.4939759036144578	0.5	684	15491	12	28	672	15463	16175	0.06376135515670983
M1	cpdb	0	network_modules	73	TRUE	8.729883997445938e-5	86	40	6	0.15	0.06976744186046512	GO:0018210	GO:BP	peptidyl-threonine modification	16175	5369		0.5060240963855421	0.5119047619047619	86	16089	6	34	80	16055	16175	0.09905901682799612
M1	cpdb	0	network_modules	73	TRUE	1.0353226830637686e-4	17	40	4	0.1	0.23529411764705882	GO:0045471	GO:BP	response to ethanol	16175	11399		0.5180722891566265	0.5238095238095238	17	16158	4	36	13	16122	16175	0.152048775399505
M1	cpdb	0	network_modules	73	TRUE	1.1238485261975719e-4	49	33	5	0.15151515151515152	0.10204081632653061	REAC:R-HSA-112043	REAC	PLC beta mediated events	10916	1693		0.7666666666666667	0.7741935483870968	49	10867	5	28	44	10839	10916	0.12111234662749272
M1	cpdb	0	network_modules	73	TRUE	1.8440097031432862e-4	54	33	5	0.15151515151515152	0.09259259259259259	REAC:R-HSA-112040	REAC	G-protein mediated events	10916	998		0.8	0.8064516129032258	54	10862	5	28	49	10834	10916	0.11503616843086076
M1	cpdb	0	network_modules	73	TRUE	1.9671399644142167e-4	249	40	8	0.2	0.0321285140562249	GO:0070588	GO:BP	calcium ion transmembrane transport	16175	16193		0.5301204819277109	0.5357142857142857	249	15926	8	32	241	15894	16175	0.07465902000193006
M1	cpdb	0	network_modules	73	TRUE	2.1385185616535103e-4	187	30	7	0.23333333333333334	0.0374331550802139	KEGG:05034	KEGG	Alcoholism	8484	422		0.5714285714285714	0.5909090909090909	187	8297	7	23	180	8274	8484	0.08572974844480254
M1	cpdb	0	network_modules	73	TRUE	2.3610709670816762e-4	255	40	8	0.2	0.03137254901960784	GO:0007610	GO:BP	behavior	16175	3067		0.54216867469879515	0.5476190476190477	255	15920	8	32	247	15888	16175	0.07364108064932053
M1	cpdb	0	network_modules	73	TRUE	2.366326395052909e-4	52	40	5	0.125	0.09615384615384616	GO:0060291	GO:BP	long-term synaptic potentiation	16175	14506		0.5542168674698795	0.5595238095238095	52	16123	5	35	47	16088	16175	0.10711729092476743
M1	cpdb	0	network_modules	73	TRUE	2.4788550639463476e-4	761	40	12	0.3	0.01576872536136662	GO:0048666	GO:BP	neuron development	16175	12924		0.5662650602409639	0.5714285714285714	761	15414	12	28	749	15386	16175	0.05948097251021761
M1	cpdb	0	network_modules	73	TRUE	2.6081056898266105e-4	53	40	5	0.125	0.09433962264150944	GO:0007612	GO:BP	learning	16175	3069		0.5783132530120482	0.5833333333333334	53	16122	5	35	48	16087	16175	0.1060513648414695
M1	cpdb	0	network_modules	73	TRUE	3.046669067293333e-4	382	30	9	0.3	0.02356020942408377	KEGG:05010	KEGG	Alzheimer disease	8484	411		0.6190476190476191	0.6363636363636364	382	8102	9	21	373	8081	8484	0.07324843986608867
M1	cpdb	0	network_modules	73	TRUE	3.0769405404403976e-4	7	33	3	0.09090909090909091	0.42857142857142855	REAC:R-HSA-447038	REAC	NrCAM interactions	10916	1611		0.8333333333333334	0.8387096774193549	7	10909	3	30	4	10879	10916	0.19635306986478257
M1	cpdb	0	network_modules	73	TRUE	3.1502670012052925e-4	55	40	5	0.125	0.09090909090909091	GO:0051966	GO:BP	regulation of synaptic transmission, glutamatergic	16175	14035		0.5903614457831325	0.5952380952380952	55	16120	5	35	50	16085	16175	0.10400600324324749
M1	cpdb	0	network_modules	73	TRUE	3.286309145802895e-4	630	40	11	0.275	0.01746031746031746	GO:0098660	GO:BP	inorganic ion transmembrane transport	16175	18816		0.6024096385542169	0.6071428571428571	630	15545	11	29	619	15516	16175	0.06074772459305809
M1	cpdb	0	network_modules	73	TRUE	3.4389051042181903e-4	179	40	7	0.175	0.03910614525139665	GO:0051924	GO:BP	regulation of calcium ion transport	16175	13997		0.6144578313253012	0.6190476190476191	179	15996	7	33	172	15963	16175	0.07802349540600036
M1	cpdb	0	network_modules	73	TRUE	3.8110450771402637e-4	23	40	4	0.1	0.17391304347826086	GO:0051968	GO:BP	positive regulation of synaptic transmission, glutamatergic	16175	14037		0.6265060240963856	0.6309523809523809	23	16152	4	36	19	16116	16175	0.1302545681627528
M1	cpdb	0	network_modules	73	TRUE	4.041629803040751e-4	75	30	5	0.16666666666666666	0.06666666666666667	KEGG:05214	KEGG	Glioma	8484	465		0.6666666666666666	0.6818181818181818	75	8409	5	25	70	8384	8484	0.10044013197493531
M1	cpdb	0	network_modules	73	TRUE	4.301949167655951e-4	185	40	7	0.175	0.03783783783783784	GO:0018105	GO:BP	peptidyl-serine phosphorylation	16175	5324		0.6385542168674698	0.6428571428571429	185	15990	7	33	178	15957	16175	0.07658852410168297
M1	cpdb	0	network_modules	73	TRUE	4.3156003233588e-4	76	30	5	0.16666666666666666	0.06578947368421052	KEGG:04971	KEGG	Gastric acid secretion	8484	402		0.7142857142857143	0.7272727272727273	76	8408	5	25	71	8383	8484	0.09970856624788825
M1	cpdb	0	network_modules	73	TRUE	4.703749808187624e-4	653	40	11	0.275	0.016845329249617153	GO:0051050	GO:BP	positive regulation of transport	16175	13460		0.6506024096385542	0.6547619047619048	653	15522	11	29	642	15493	16175	0.05935279365593497
M1	cpdb	0	network_modules	73	TRUE	4.835592143739337e-4	301	30	8	0.26666666666666666	0.026578073089700997	KEGG:04010	KEGG	MAPK signaling pathway	8484	243		0.7619047619047619	0.7727272727272727	301	8183	8	22	293	8161	8484	0.07444853449892598
M1	cpdb	0	network_modules	73	TRUE	4.912957221954818e-4	8	33	3	0.09090909090909091	0.375	REAC:R-HSA-9010642	REAC	ROBO receptors bind AKAP5	10916	1908		0.8666666666666667	0.8709677419354839	8	10908	3	30	5	10878	10916	0.1834934892576661
M1	cpdb	0	network_modules	73	TRUE	6.167230884547517e-4	671	40	11	0.275	0.01639344262295082	GO:0034220	GO:BP	monoatomic ion transmembrane transport	16175	8508		0.6626506024096386	0.6666666666666666	671	15504	11	29	660	15475	16175	0.05830740702505738
M1	cpdb	0	network_modules	73	TRUE	6.583248471573077e-4	197	40	7	0.175	0.03553299492385787	GO:0018209	GO:BP	peptidyl-serine modification	16175	5368		0.6746987951807228	0.6785714285714286	197	15978	7	33	190	15945	16175	0.07391032729316886
M1	cpdb	0	network_modules	73	TRUE	6.702934451050059e-4	533	40	10	0.25	0.01876172607879925	GO:0006897	GO:BP	endocytosis	16175	2551		0.6867469879518072	0.6904761904761905	533	15642	10	30	523	15612	16175	0.0605390595418393
M1	cpdb	0	network_modules	73	TRUE	6.793256018746174e-4	64	40	5	0.125	0.078125	GO:0060996	GO:BP	dendritic spine development	16175	15120		0.6987951807228916	0.7023809523809523	64	16111	5	35	59	16076	16175	0.09600176903726577
M1	cpdb	0	network_modules	73	TRUE	0.0010468713704938936	91	30	5	0.16666666666666666	0.054945054945054944	KEGG:04970	KEGG	Salivary secretion	8484	401		0.8095238095238095	0.8181818181818182	91	8393	5	25	86	8368	8484	0.09017996077820381
M1	cpdb	0	network_modules	73	TRUE	0.0010484414168081043	10	33	3	0.09090909090909091	0.3	REAC:R-HSA-451308	REAC	Activation of Ca-permeable Kainate Receptor	10916	81		0.9	0.9354838709677419	10	10906	3	30	7	10876	10916	0.1638031264499687
M1	cpdb	0	network_modules	73	TRUE	0.0010484414168081043	10	33	3	0.09090909090909091	0.3	REAC:R-HSA-451306	REAC	Ionotropic activity of kainate receptors	10916	1276		0.9	0.9354838709677419	10	10906	3	30	7	10876	10916	0.1638031264499687
M1	cpdb	0	network_modules	73	TRUE	0.0011454739959249642	71	40	5	0.125	0.07042253521126761	GO:0106027	GO:BP	neuron projection organization	16175	19219		0.7108433734939759	0.7142857142857143	71	16104	5	35	66	16069	16175	0.09084037092236633
M1	cpdb	0	network_modules	73	TRUE	0.0013392910200191368	575	40	10	0.25	0.017391304347826087	GO:0098662	GO:BP	inorganic cation transmembrane transport	16175	18818		0.7228915662650602	0.7261904761904762	575	15600	10	30	565	15570	16175	0.05766632692125187
M1	cpdb	0	network_modules	73	TRUE	0.001375361415414654	441	40	9	0.225	0.02040816326530612	GO:0048812	GO:BP	neuron projection morphogenesis	16175	13058		0.7349397590361446	0.7380952380952381	441	15734	9	31	432	15703	16175	0.06045552894180345
M1	cpdb	0	network_modules	73	TRUE	0.0013822040338651738	577	40	10	0.25	0.01733102253032929	GO:0098655	GO:BP	monoatomic cation transmembrane transport	16175	18811		0.7469879518072289	0.75	577	15598	10	30	567	15568	16175	0.057536795520192516
M1	cpdb	0	network_modules	73	TRUE	0.0015025894134940777	98	30	5	0.16666666666666666	0.05102040816326531	KEGG:04750	KEGG	Inflammatory mediator regulation of TRP channels	8484	364		0.8571428571428571	0.9090909090909091	98	8386	5	25	93	8361	8484	0.08647586761764668
M1	cpdb	0	network_modules	73	TRUE	0.0015025894134940777	98	30	5	0.16666666666666666	0.05102040816326531	KEGG:04925	KEGG	Aldosterone synthesis and secretion	8484	382		0.8571428571428571	0.9090909090909091	98	8386	5	25	93	8361	8484	0.08647586761764668
M1	cpdb	0	network_modules	73	TRUE	0.0017396444726189124	101	30	5	0.16666666666666666	0.04950495049504951	KEGG:04916	KEGG	Melanogenesis	8484	373		0.9523809523809523	0.9545454545454546	101	8383	5	25	96	8358	8484	0.08500291353736769
M1	cpdb	0	network_modules	73	TRUE	0.0018150750274706353	456	40	9	0.225	0.019736842105263157	GO:0120039	GO:BP	plasma membrane bounded cell projection morphogenesis	16175	19473		0.7590361445783133	0.7619047619047619	456	15719	9	31	447	15688	16175	0.059202280162164306
M1	cpdb	0	network_modules	73	TRUE	0.0018339999343293693	78	40	5	0.125	0.0641025641025641	GO:0006942	GO:BP	regulation of striated muscle contraction	16175	2580		0.7710843373493976	0.7738095238095238	78	16097	5	35	73	16062	16175	0.08637619559390773
M1	cpdb	0	network_modules	73	TRUE	0.0019511099091399375	460	40	9	0.225	0.01956521739130435	GO:0048858	GO:BP	cell projection morphogenesis	16175	13102		0.7831325301204819	0.7857142857142857	460	15715	9	31	451	15684	16175	0.05887774350227795
M1	cpdb	0	network_modules	73	TRUE	0.002245350369856176	89	33	5	0.15151515151515152	0.056179775280898875	REAC:R-HSA-111885	REAC	Opioid Signalling	10916	1642		0.9666666666666667	0.967741935483871	89	10827	5	28	84	10799	10916	0.08778718169782877
M1	cpdb	0	network_modules	73	TRUE	0.0023071968149303594	10	40	3	0.075	0.3	GO:0048169	GO:BP	regulation of long-term neuronal synaptic plasticity	16175	12563		0.7951807228915663	0.7976190476190477	10	16165	3	37	7	16128	16175	0.1489938723147514
M1	cpdb	0	network_modules	73	TRUE	0.002477134392007687	36	40	4	0.1	0.1111111111111111	GO:0097120	GO:BP	receptor localization to synapse	16175	18510		0.8072289156626506	0.8214285714285714	36	16139	4	36	32	16103	16175	0.10330590481434206
M1	cpdb	0	network_modules	73	TRUE	0.002477134392007687	36	40	4	0.1	0.1111111111111111	GO:0043113	GO:BP	receptor clustering	16175	10537		0.8072289156626506	0.8214285714285714	36	16139	4	36	32	16103	16175	0.10330590481434206
M1	cpdb	0	network_modules	73	TRUE	0.0027566099785236928	154	40	6	0.15	0.03896103896103896	GO:0090257	GO:BP	regulation of muscle system process	16175	18146		0.8313253012048193	0.8333333333333334	154	16021	6	34	148	15987	16175	0.0720271867333838
M1	cpdb	0	network_modules	73	TRUE	0.0027724503820919723	37	40	4	0.1	0.10810810810810811	GO:0099601	GO:BP	regulation of neurotransmitter receptor activity	16175	19157		0.8433734939759037	0.8452380952380952	37	16138	4	36	33	16102	16175	0.10183903921300223
M1	cpdb	0	network_modules	73	TRUE	0.0034404713003980993	39	40	4	0.1	0.10256410256410256	GO:0045197	GO:BP	establishment or maintenance of epithelial cell apical/basal polarity	16175	11321		0.8554216867469879	0.8571428571428571	39	16136	4	36	35	16100	16175	0.09907403499792901
M1	cpdb	0	network_modules	73	TRUE	0.003610932654429199	366	40	8	0.2	0.02185792349726776	GO:0051336	GO:BP	regulation of hydrolase activity	16175	13663		0.8674698795180723	0.8690476190476191	366	15809	8	32	358	15777	16175	0.05938589644130249
M1	cpdb	0	network_modules	73	TRUE	0.0038344255674323067	163	40	6	0.15	0.03680981595092025	GO:0043270	GO:BP	positive regulation of monoatomic ion transport	16175	10594		0.8795180722891566	0.8809523809523809	163	16012	6	34	157	15978	16175	0.06975276808301516
M1	cpdb	0	network_modules	73	TRUE	0.004100810680393677	651	40	10	0.25	0.015360983102918587	GO:0000902	GO:BP	cell morphogenesis	16175	240		0.891566265060241	0.8928571428571429	651	15524	10	30	641	15494	16175	0.05313798215719454
M1	cpdb	0	network_modules	73	TRUE	0.004215364106626255	12	40	3	0.075	0.25	GO:0008542	GO:BP	visual learning	16175	3190		0.9036144578313253	0.9047619047619048	12	16163	3	37	9	16126	16175	0.1357944772851887
M1	cpdb	0	network_modules	73	TRUE	0.004394311574874365	93	40	5	0.125	0.053763440860215055	GO:0048813	GO:BP	dendrite morphogenesis	16175	13059		0.9156626506024096	0.9166666666666666	93	16082	5	35	88	16047	16175	0.07853045105169923
M1	cpdb	0	network_modules	73	TRUE	0.0046771417601511045	379	40	8	0.2	0.021108179419525065	GO:0048667	GO:BP	cell morphogenesis involved in neuron differentiation	16175	12925		0.927710843373494	0.9285714285714286	379	15796	8	32	371	15764	16175	0.058117984712838563
M1	cpdb	0	network_modules	73	TRUE	0.00488136896721284	95	40	5	0.125	0.05263157894736842	GO:2001257	GO:BP	regulation of cation channel activity	16175	26443		0.9397590361445783	0.9404761904761905	95	16080	5	35	90	16045	16175	0.07762367999934784
M1	cpdb	0	network_modules	73	TRUE	0.005125463682365918	43	40	4	0.1	0.09302325581395349	GO:0035088	GO:BP	establishment or maintenance of apical/basal cell polarity	16175	8802		0.9518072289156626	0.9642857142857143	43	16132	4	36	39	16096	16175	0.09412605160554757
M1	cpdb	0	network_modules	73	TRUE	0.005125463682365918	43	40	4	0.1	0.09302325581395349	GO:0061245	GO:BP	establishment or maintenance of bipolar cell polarity	16175	15338		0.9518072289156626	0.9642857142857143	43	16132	4	36	39	16096	16175	0.09412605160554757
M1	cpdb	0	network_modules	73	TRUE	0.006530491851891139	533	40	9	0.225	0.016885553470919325	GO:0034330	GO:BP	cell junction organization	16175	8572		0.9759036144578314	0.9761904761904762	533	15642	9	31	524	15611	16175	0.05356605314655873
M1	cpdb	0	network_modules	73	TRUE	0.008009658568428835	48	40	4	0.1	0.08333333333333333	GO:0061097	GO:BP	regulation of protein tyrosine kinase activity	16175	15207		0.9879518072289156	0.9880952380952381	48	16127	4	36	44	16091	16175	0.08881972397184346
M1	cpdb	0	network_modules	73	TRUE	0.008651576883467496	412	40	8	0.2	0.019417475728155338	GO:0045859	GO:BP	regulation of protein kinase activity	16175	11671		1	1	412	15763	8	32	404	15731	16175	0.055155438684768916
M1	cpdb	0	network_modules	73	TRUE	0.00926500184705202	75	30	4	0.13333333333333333	0.05333333333333334	KEGG:04918	KEGG	Thyroid hormone synthesis	8484	375		1	1	75	8409	4	26	71	8383	8484	0.07922693606566593
M1	cpdb	0	network_modules	73	TRUE	0.009865632956878511	59	33	4	0.12121212121212122	0.06779661016949153	REAC:R-HSA-8986944	REAC	Transcriptional Regulation by MECP2	10916	2544		1	1	59	10857	4	29	55	10828	10916	0.0869762862710853
M1	cpdb	0	network_modules	74	TRUE	1.6826944781200544e-4	20	36	4	0.1111111111111111	0.2	GO:0002475	GO:BP	antigen processing and presentation via MHC class Ib	16175	998		0	0.1111111111111111	20	16155	4	32	16	16123	16175	0.147667932907318
M1	cpdb	0	network_modules	74	TRUE	2.7835374430697316e-4	124	18	5	0.2777777777777778	0.04032258064516129	KEGG:04650	KEGG	Natural killer cell mediated cytotoxicity	8484	334		NA	1	124	8360	5	13	119	8347	8484	0.10111300737266166
M1	cpdb	0	network_modules	74	TRUE	7.021541261267593e-4	28	36	4	0.1111111111111111	0.14285714285714285	GO:0019883	GO:BP	antigen processing and presentation of endogenous antigen	16175	6061		0.125	0.2222222222222222	28	16147	4	32	24	16115	16175	0.12427116992879121
M1	cpdb	0	network_modules	74	TRUE	0.001575342764899338	34	36	4	0.1111111111111111	0.11764705882352941	GO:0001916	GO:BP	positive regulation of T cell mediated cytotoxicity	16175	533		0.25	0.3333333333333333	34	16141	4	32	30	16109	16175	0.11241268289343703
M1	cpdb	0	network_modules	74	TRUE	0.0037542788314115917	42	36	4	0.1111111111111111	0.09523809523809523	GO:0001914	GO:BP	regulation of T cell mediated cytotoxicity	16175	531		0.375	0.4444444444444444	42	16133	4	32	38	16101	16175	0.1007077367988413
M1	cpdb	0	network_modules	74	TRUE	0.004973804796679685	45	36	4	0.1111111111111111	0.08888888888888889	GO:0001913	GO:BP	T cell mediated cytotoxicity	16175	530		0.5	0.5555555555555556	45	16130	4	32	41	16098	16175	0.09713565720574535
M1	cpdb	0	network_modules	74	TRUE	0.00624821086171651	14	36	3	0.08333333333333333	0.21428571428571427	GO:0002484	GO:BP	antigen processing and presentation of endogenous peptide antigen via MHC class I via ER pathway	16175	1007		0.625	0.7777777777777778	14	16161	3	33	11	16128	16175	0.13244742079327596
M1	cpdb	0	network_modules	74	TRUE	0.00624821086171651	14	36	3	0.08333333333333333	0.21428571428571427	GO:0002486	GO:BP	antigen processing and presentation of endogenous peptide antigen via MHC class I via ER pathway, TAP-independent	16175	1009		0.625	0.7777777777777778	14	16161	3	33	11	16128	16175	0.13244742079327596
M1	cpdb	0	network_modules	74	TRUE	0.007798317540910174	15	36	3	0.08333333333333333	0.2	GO:0002476	GO:BP	antigen processing and presentation of endogenous peptide antigen via MHC class Ib	16175	999		0.875	1	15	16160	3	33	12	16127	16175	0.12786439562882096
M1	cpdb	0	network_modules	74	TRUE	0.007798317540910174	15	36	3	0.08333333333333333	0.2	GO:0002428	GO:BP	antigen processing and presentation of peptide antigen via MHC class Ib	16175	951		0.875	1	15	16160	3	33	12	16127	16175	0.12786439562882096
M1	cpdb	0	network_modules	75	TRUE	5.377510605915438e-19	32	31	11	0.3548387096774194	0.34375	REAC:R-HSA-8963899	REAC	Plasma lipoprotein remodeling	10916	1758		0	0.08333333333333333	32	10884	11	20	21	10864	10916	0.3473674293639501
M1	cpdb	0	network_modules	75	TRUE	2.5371260883113727e-18	51	21	11	0.5238095238095238	0.21568627450980393	KEGG:04979	KEGG	Cholesterol metabolism	8484	410		0	0.3333333333333333	51	8433	11	10	40	8423	8484	0.33368181720834356
M1	cpdb	0	network_modules	75	TRUE	9.217975930380354e-17	71	31	12	0.3870967741935484	0.16901408450704225	REAC:R-HSA-174824	REAC	Plasma lipoprotein assembly, remodeling, and clearance	10916	1756		0.09090909090909091	0.16666666666666666	71	10845	12	19	59	10826	10916	0.25266582205758337
M1	cpdb	0	network_modules	75	TRUE	2.4832816952694777e-15	67	36	11	0.3055555555555556	0.16417910447761194	GO:0097006	GO:BP	regulation of plasma lipoprotein particle levels	16175	18441		0	0.012987012987012988	67	16108	11	25	56	16083	16175	0.221646826013064
M1	cpdb	0	network_modules	75	TRUE	3.942856677930074e-15	45	36	10	0.2777777777777778	0.2222222222222222	GO:0071827	GO:BP	plasma lipoprotein particle organization	16175	16930		0.013157894736842105	0.025974025974025976	45	16130	10	26	35	16104	16175	0.24658105244698802
M1	cpdb	0	network_modules	75	TRUE	6.381010678040947e-15	47	36	10	0.2777777777777778	0.2127659574468085	GO:0071825	GO:BP	protein-lipid complex organization	16175	16928		0.02631578947368421	0.03896103896103896	47	16128	10	26	37	16102	16175	0.2411840803898357
M1	cpdb	0	network_modules	75	TRUE	1.1636276231990302e-14	346	36	16	0.4444444444444444	0.046242774566473986	GO:0010876	GO:BP	lipid localization	16175	4462		0.039473684210526314	0.05194805194805195	346	15829	16	20	330	15809	16175	0.13809807946122032
M1	cpdb	0	network_modules	75	TRUE	1.519168004718798e-14	31	36	9	0.25	0.2903225806451613	GO:0034369	GO:BP	plasma lipoprotein particle remodeling	16175	8594		0.05263157894736842	0.07792207792207792	31	16144	9	27	22	16117	16175	0.26789747583017004
M1	cpdb	0	network_modules	75	TRUE	1.519168004718798e-14	31	36	9	0.25	0.2903225806451613	GO:0034368	GO:BP	protein-lipid complex remodeling	16175	8593		0.05263157894736842	0.07792207792207792	31	16144	9	27	22	16117	16175	0.26789747583017004
M1	cpdb	0	network_modules	75	TRUE	1.9352898320269995e-14	52	36	10	0.2777777777777778	0.19230769230769232	GO:0033344	GO:BP	cholesterol efflux	16175	8154		0.07894736842105263	0.09090909090909091	52	16123	10	26	42	16097	16175	0.22907333932160492
M1	cpdb	0	network_modules	75	TRUE	2.897495921495394e-14	33	36	9	0.25	0.2727272727272727	GO:0034367	GO:BP	protein-containing complex remodeling	16175	8592		0.09210526315789473	0.1038961038961039	33	16142	9	27	24	16115	16175	0.25953915738892136
M1	cpdb	0	network_modules	75	TRUE	1.002407819138571e-13	92	36	11	0.3055555555555556	0.11956521739130435	GO:0030301	GO:BP	cholesterol transport	16175	6760		0.10526315789473684	0.11688311688311688	92	16083	11	25	81	16058	16175	0.18832569035687377
M1	cpdb	0	network_modules	75	TRUE	1.635255692379967e-13	96	36	11	0.3055555555555556	0.11458333333333333	GO:0015918	GO:BP	sterol transport	16175	5013		0.11842105263157894	0.12987012987012986	96	16079	11	25	85	16054	16175	0.18423136782692903
M1	cpdb	0	network_modules	75	TRUE	1.9703187687573356e-13	12	36	7	0.19444444444444445	0.5833333333333334	GO:0034370	GO:BP	triglyceride-rich lipoprotein particle remodeling	16175	8595		0.13157894736842105	0.15584415584415584	12	16163	7	29	5	16134	16175	0.3360013151257156
M1	cpdb	0	network_modules	75	TRUE	1.9703187687573356e-13	12	36	7	0.19444444444444445	0.5833333333333334	GO:0034372	GO:BP	very-low-density lipoprotein particle remodeling	16175	8597		0.13157894736842105	0.15584415584415584	12	16163	7	29	5	16134	16175	0.3360013151257156
M1	cpdb	0	network_modules	75	TRUE	2.002258869937192e-12	301	36	14	0.3888888888888889	0.046511627906976744	GO:0006869	GO:BP	lipid transport	16175	2530		0.15789473684210525	0.16883116883116883	301	15874	14	22	287	15852	16175	0.12940795063759894
M1	cpdb	0	network_modules	75	TRUE	2.2245107950915e-12	51	36	9	0.25	0.17647058823529413	GO:0032374	GO:BP	regulation of cholesterol transport	16175	7528		0.17105263157894737	0.19480519480519481	51	16124	9	27	42	16097	16175	0.2079522267528094
M1	cpdb	0	network_modules	75	TRUE	2.2245107950915e-12	51	36	9	0.25	0.17647058823529413	GO:0032371	GO:BP	regulation of sterol transport	16175	7525		0.17105263157894737	0.19480519480519481	51	16124	9	27	42	16097	16175	0.2079522267528094
M1	cpdb	0	network_modules	75	TRUE	3.424326350712952e-12	31	36	8	0.2222222222222222	0.25806451612903225	GO:0070328	GO:BP	triglyceride homeostasis	16175	16059		0.19736842105263158	0.22077922077922077	31	16144	8	28	23	16116	16175	0.237901133120107
M1	cpdb	0	network_modules	75	TRUE	3.424326350712952e-12	31	36	8	0.2222222222222222	0.25806451612903225	GO:0055090	GO:BP	acylglycerol homeostasis	16175	14240		0.19736842105263158	0.22077922077922077	31	16144	8	28	23	16116	16175	0.237901133120107
M1	cpdb	0	network_modules	75	TRUE	2.1790854437378853e-11	10	31	6	0.1935483870967742	0.6	REAC:R-HSA-8963901	REAC	Chylomicron remodeling	10916	360		0.18181818181818182	0.25	10	10906	6	25	4	10881	10916	0.3398024626616015
M1	cpdb	0	network_modules	75	TRUE	7.806012934045287e-11	74	36	9	0.25	0.12162162162162163	GO:0042632	GO:BP	cholesterol homeostasis	16175	10265		0.2236842105263158	0.23376623376623376	74	16101	9	27	65	16074	16175	0.17176465922553807
M1	cpdb	0	network_modules	75	TRUE	8.857100050902144e-11	75	36	9	0.25	0.12	GO:0055092	GO:BP	sterol homeostasis	16175	14242		0.23684210526315788	0.24675324675324675	75	16100	9	27	66	16073	16175	0.17057803709399363
M1	cpdb	0	network_modules	75	TRUE	2.2933087165931094e-10	13	36	6	0.16666666666666666	0.46153846153846156	GO:0033700	GO:BP	phospholipid efflux	16175	8356		0.25	0.2597402597402597	13	16162	6	30	7	16132	16175	0.2764314207679143
M1	cpdb	0	network_modules	75	TRUE	2.482002670321215e-10	128	36	10	0.2777777777777778	0.078125	GO:1905952	GO:BP	regulation of lipid localization	16175	25042		0.2631578947368421	0.2727272727272727	128	16047	10	26	118	16021	16175	0.14384699836113696
M1	cpdb	0	network_modules	75	TRUE	3.394311121354671e-10	132	36	10	0.2777777777777778	0.07575757575757576	GO:0055088	GO:BP	lipid homeostasis	16175	14238		0.27631578947368424	0.2857142857142857	132	16043	10	26	122	16017	16175	0.1415385693231202
M1	cpdb	0	network_modules	75	TRUE	1.0651119881851864e-9	16	36	6	0.16666666666666666	0.375	GO:0034375	GO:BP	high-density lipoprotein particle remodeling	16175	8600		0.2894736842105263	0.2987012987012987	16	16159	6	30	10	16129	16175	0.24891638929263551
M1	cpdb	0	network_modules	75	TRUE	1.1773153557273634e-9	99	36	9	0.25	0.09090909090909091	GO:0032368	GO:BP	regulation of lipid transport	16175	7522		0.3026315789473684	0.3116883116883117	99	16076	9	27	90	16049	16175	0.14768140939105281
M1	cpdb	0	network_modules	75	TRUE	1.595796842256671e-9	218	36	11	0.3055555555555556	0.05045871559633028	GO:0015850	GO:BP	organic hydroxy compound transport	16175	4959		0.3157894736842105	0.3246753246753247	218	15957	11	25	207	15932	16175	0.11963332027092204
M1	cpdb	0	network_modules	75	TRUE	1.8962419475561427e-9	18	31	6	0.1935483870967742	0.3333333333333333	REAC:R-HSA-8963889	REAC	Assembly of active LPL and LIPC lipase complexes	10916	176		0.2727272727272727	0.3333333333333333	18	10898	6	25	12	10873	10916	0.2524028130747012
M1	cpdb	0	network_modules	75	TRUE	1.1666417451216065e-8	80	36	8	0.2222222222222222	0.1	GO:0015914	GO:BP	phospholipid transport	16175	5010		0.32894736842105265	0.33766233766233766	80	16095	8	28	72	16067	16175	0.14627804186092647
M1	cpdb	0	network_modules	75	TRUE	5.520734043358147e-8	12	36	5	0.1388888888888889	0.4166666666666667	GO:0051004	GO:BP	regulation of lipoprotein lipase activity	16175	13435		0.34210526315789475	0.35064935064935066	12	16163	5	31	7	16132	16175	0.23963325554474074
M1	cpdb	0	network_modules	75	TRUE	1.4337925961431905e-7	33	36	6	0.16666666666666666	0.18181818181818182	GO:0010874	GO:BP	regulation of cholesterol efflux	16175	4460		0.35526315789473684	0.36363636363636365	33	16142	6	30	27	16112	16175	0.17231428525848433
M1	cpdb	0	network_modules	75	TRUE	1.7382634716983206e-7	34	36	6	0.16666666666666666	0.17647058823529413	GO:0060191	GO:BP	regulation of lipase activity	16175	14423		0.3684210526315789	0.37662337662337664	34	16141	6	30	28	16111	16175	0.16970284439703978
M1	cpdb	0	network_modules	75	TRUE	4.2790739028072486e-7	17	36	5	0.1388888888888889	0.29411764705882354	GO:0043691	GO:BP	reverse cholesterol transport	16175	10840		0.3815789473684211	0.38961038961038963	17	16158	5	31	12	16127	16175	0.20091278076238275
M1	cpdb	0	network_modules	75	TRUE	5.326408785371659e-7	6	36	4	0.1111111111111111	0.6666666666666666	GO:0010901	GO:BP	regulation of very-low-density lipoprotein particle remodeling	16175	4487		0.39473684210526316	0.4025974025974026	6	16169	4	32	2	16137	16175	0.27160965407504334
M1	cpdb	0	network_modules	75	TRUE	5.34249099540007e-7	128	36	8	0.2222222222222222	0.0625	GO:0015748	GO:BP	organophosphate ester transport	16175	4867		0.40789473684210525	0.4155844155844156	128	16047	8	28	120	16019	16175	0.1142339706729137
M1	cpdb	0	network_modules	75	TRUE	5.924561758104348e-7	78	36	7	0.19444444444444445	0.08974358974358974	GO:0006641	GO:BP	triglyceride metabolic process	16175	2352		0.42105263157894735	0.42857142857142855	78	16097	7	29	71	16068	16175	0.12927859059625676
M1	cpdb	0	network_modules	75	TRUE	1.224446167710523e-6	75	21	6	0.2857142857142857	0.08	KEGG:03320	KEGG	PPAR signaling pathway	8484	236		0.5	0.6666666666666666	75	8409	6	15	69	8394	8484	0.1473423817303378
M1	cpdb	0	network_modules	75	TRUE	2.2129434818281607e-6	9	31	4	0.12903225806451613	0.4444444444444444	REAC:R-HSA-8964058	REAC	HDL remodeling	10916	1095		0.36363636363636365	0.4166666666666667	9	10907	4	27	5	10880	10916	0.23838044540052267
M1	cpdb	0	network_modules	75	TRUE	2.238331651443968e-6	94	36	7	0.19444444444444445	0.07446808510638298	GO:0008203	GO:BP	cholesterol metabolic process	16175	3130		0.4342105263157895	0.44155844155844154	94	16081	7	29	87	16052	16175	0.1172072467097749
M1	cpdb	0	network_modules	75	TRUE	3.6553788344464675e-6	337	36	10	0.2777777777777778	0.02967359050445104	GO:0046486	GO:BP	glycerolipid metabolic process	16175	12190		0.4473684210526316	0.45454545454545453	337	15838	10	26	327	15812	16175	0.08496286802794834
M1	cpdb	0	network_modules	75	TRUE	4.2717432506017814e-6	103	36	7	0.19444444444444445	0.06796116504854369	GO:1902652	GO:BP	secondary alcohol metabolic process	16175	22418		0.4605263157894737	0.4675324675324675	103	16072	7	29	96	16043	16175	0.11167048523470863
M1	cpdb	0	network_modules	75	TRUE	4.521466440039965e-6	57	36	6	0.16666666666666666	0.10526315789473684	GO:0046503	GO:BP	glycerolipid catabolic process	16175	12206		0.47368421052631576	0.4805194805194805	57	16118	6	30	51	16088	16175	0.13002650744668706
M1	cpdb	0	network_modules	75	TRUE	5.229357448753902e-6	106	36	7	0.19444444444444445	0.0660377358490566	GO:0006638	GO:BP	neutral lipid metabolic process	16175	2349		0.4868421052631579	0.5064935064935064	106	16069	7	29	99	16040	16175	0.10998061133391984
M1	cpdb	0	network_modules	75	TRUE	5.229357448753902e-6	106	36	7	0.19444444444444445	0.0660377358490566	GO:0006639	GO:BP	acylglycerol metabolic process	16175	2350		0.4868421052631579	0.5064935064935064	106	16069	7	29	99	16040	16175	0.10998061133391984
M1	cpdb	0	network_modules	75	TRUE	5.586604957615033e-6	107	36	7	0.19444444444444445	0.06542056074766354	GO:0016125	GO:BP	sterol metabolic process	16175	5143		0.5131578947368421	0.5194805194805194	107	16068	7	29	100	16039	16175	0.10943286339528659
M1	cpdb	0	network_modules	75	TRUE	6.874432316227722e-6	61	36	6	0.16666666666666666	0.09836065573770492	GO:0046470	GO:BP	phosphatidylcholine metabolic process	16175	12178		0.5263157894736842	0.5324675324675324	61	16114	6	30	55	16084	16175	0.1255161158914455
M1	cpdb	0	network_modules	75	TRUE	1.1489424604612959e-05	31	36	5	0.1388888888888889	0.16129032258064516	GO:0032376	GO:BP	positive regulation of cholesterol transport	16175	7530		0.5394736842105263	0.5584415584415584	31	16144	5	31	26	16113	16175	0.14791210498991778
M1	cpdb	0	network_modules	75	TRUE	1.1489424604612959e-05	31	36	5	0.1388888888888889	0.16129032258064516	GO:0032373	GO:BP	positive regulation of sterol transport	16175	7527		0.5394736842105263	0.5584415584415584	31	16144	5	31	26	16113	16175	0.14791210498991778
M1	cpdb	0	network_modules	75	TRUE	1.3595337074854695e-5	32	36	5	0.1388888888888889	0.15625	GO:0046464	GO:BP	acylglycerol catabolic process	16175	12172		0.5657894736842105	0.5844155844155844	32	16143	5	31	27	16112	16175	0.14552143183323474
M1	cpdb	0	network_modules	75	TRUE	1.3595337074854695e-5	32	36	5	0.1388888888888889	0.15625	GO:0046461	GO:BP	neutral lipid catabolic process	16175	12169		0.5657894736842105	0.5844155844155844	32	16143	5	31	27	16112	16175	0.14552143183323474
M1	cpdb	0	network_modules	75	TRUE	2.5289270474484963e-5	36	36	5	0.1388888888888889	0.1388888888888889	GO:0034381	GO:BP	plasma lipoprotein particle clearance	16175	8606		0.5921052631578947	0.5974025974025974	36	16139	5	31	31	16108	16175	0.1369680759512843
M1	cpdb	0	network_modules	75	TRUE	3.609437840543775e-5	80	36	6	0.16666666666666666	0.075	GO:1905954	GO:BP	positive regulation of lipid localization	16175	25044		0.6052631578947368	0.6103896103896104	80	16095	6	30	74	16065	16175	0.10887609233357133
M1	cpdb	0	network_modules	75	TRUE	4.410764646177288e-5	44	31	5	0.16129032258064516	0.11363636363636363	REAC:R-HSA-975634	REAC	Retinoid metabolism and transport	10916	2093		0.45454545454545453	0.5	44	10872	5	26	39	10846	10916	0.13245431281508815
M1	cpdb	0	network_modules	75	TRUE	5.20898867227042e-5	328	36	9	0.25	0.027439024390243903	GO:0006644	GO:BP	phospholipid metabolic process	16175	2355		0.618421052631579	0.6233766233766234	328	15847	9	27	319	15820	16175	0.07697487197122567
M1	cpdb	0	network_modules	75	TRUE	5.2793071288122684e-5	18	31	4	0.12903225806451613	0.2222222222222222	REAC:R-HSA-8963898	REAC	Plasma lipoprotein assembly	10916	1755		0.5454545454545454	0.5833333333333334	18	10898	4	27	14	10871	10916	0.16754559210936695
M1	cpdb	0	network_modules	75	TRUE	6.899311213726254e-5	48	31	5	0.16129032258064516	0.10416666666666667	REAC:R-HSA-6806667	REAC	Metabolism of fat-soluble vitamins	10916	1424		0.6363636363636364	0.6666666666666666	48	10868	5	26	43	10842	10916	0.12654313471371448
M1	cpdb	0	network_modules	75	TRUE	8.391222967018849e-5	243	36	8	0.2222222222222222	0.03292181069958848	GO:0019216	GO:BP	regulation of lipid metabolic process	16175	5593		0.631578947368421	0.6363636363636364	243	15932	8	28	235	15904	16175	0.0804464119511082
M1	cpdb	0	network_modules	75	TRUE	9.823008063838448e-5	248	36	8	0.2222222222222222	0.03225806451612903	GO:0016042	GO:BP	lipid catabolic process	16175	5076		0.6447368421052632	0.6493506493506493	248	15927	8	28	240	15899	16175	0.07952500931708885
M1	cpdb	0	network_modules	75	TRUE	1.389831017826191e-4	50	36	5	0.1388888888888889	0.1	GO:0050994	GO:BP	regulation of lipid catabolic process	16175	13429		0.6578947368421053	0.6623376623376623	50	16125	5	31	45	16094	16175	0.11553532107261447
M1	cpdb	0	network_modules	75	TRUE	2.0753327428221153e-4	21	36	4	0.1111111111111111	0.19047619047619047	GO:0019433	GO:BP	triglyceride catabolic process	16175	5785		0.6710526315789473	0.6753246753246753	21	16154	4	32	17	16122	16175	0.1440325176618291
M1	cpdb	0	network_modules	75	TRUE	2.5325032962937653e-4	22	36	4	0.1111111111111111	0.18181818181818182	GO:0034377	GO:BP	plasma lipoprotein particle assembly	16175	8602		0.6842105263157895	0.6883116883116883	22	16153	4	32	18	16121	16175	0.14064611112510816
M1	cpdb	0	network_modules	75	TRUE	3.0608099912709396e-4	23	36	4	0.1111111111111111	0.17391304347826086	GO:0010875	GO:BP	positive regulation of cholesterol efflux	16175	4461		0.6973684210526315	0.7142857142857143	23	16152	4	32	19	16120	16175	0.13748138009506247
M1	cpdb	0	network_modules	75	TRUE	3.0608099912709396e-4	23	36	4	0.1111111111111111	0.17391304347826086	GO:0050996	GO:BP	positive regulation of lipid catabolic process	16175	13431		0.6973684210526315	0.7142857142857143	23	16152	4	32	19	16120	16175	0.13748138009506247
M1	cpdb	0	network_modules	75	TRUE	0.00034753917421722063	6	36	3	0.08333333333333333	0.5	GO:0034382	GO:BP	chylomicron remnant clearance	16175	8607		0.7236842105263158	0.7402597402597403	6	16169	3	33	3	16136	16175	0.2034797900054474
M1	cpdb	0	network_modules	75	TRUE	0.00034753917421722063	6	36	3	0.08333333333333333	0.5	GO:0071830	GO:BP	triglyceride-rich lipoprotein particle clearance	16175	16933		0.7236842105263158	0.7402597402597403	6	16169	3	33	3	16136	16175	0.2034797900054474
M1	cpdb	0	network_modules	75	TRUE	3.525712797712651e-4	60	36	5	0.1388888888888889	0.08333333333333333	GO:0032370	GO:BP	positive regulation of lipid transport	16175	7524		0.75	0.7532467532467533	60	16115	5	31	55	16084	16175	0.10502124404691669
M1	cpdb	0	network_modules	75	TRUE	3.667159019966261e-4	24	36	4	0.1111111111111111	0.16666666666666666	GO:0065005	GO:BP	protein-lipid complex assembly	16175	15889		0.7631578947368421	0.7662337662337663	24	16151	4	32	20	16119	16175	0.13451501842518168
M1	cpdb	0	network_modules	75	TRUE	6.072629089234312e-4	7	36	3	0.08333333333333333	0.42857142857142855	GO:0051006	GO:BP	positive regulation of lipoprotein lipase activity	16175	13437		0.7763157894736842	0.7792207792207793	7	16168	3	33	4	16135	16175	0.18825111540602296
M1	cpdb	0	network_modules	75	TRUE	8.184931290876087e-4	10	31	3	0.0967741935483871	0.3	REAC:R-HSA-8963888	REAC	Chylomicron assembly	10916	358		0.7272727272727273	0.75	10	10906	3	28	7	10878	10916	0.16909324523390037
M1	cpdb	0	network_modules	75	TRUE	9.701339779040485e-4	8	36	3	0.08333333333333333	0.375	GO:0061365	GO:BP	positive regulation of triglyceride lipase activity	16175	15437		0.7894736842105263	0.8051948051948052	8	16167	3	33	5	16134	16175	0.17596691334509712
M1	cpdb	0	network_modules	75	TRUE	9.701339779040485e-4	8	36	3	0.08333333333333333	0.375	GO:0051838	GO:BP	cytolysis by host of symbiont cells	16175	13951		0.7894736842105263	0.8051948051948052	8	16167	3	33	5	16134	16175	0.17596691334509712
M1	cpdb	0	network_modules	75	TRUE	0.0015297339111131352	242	36	7	0.19444444444444445	0.028925619834710745	GO:0008202	GO:BP	steroid metabolic process	16175	3129		0.8157894736842105	0.8181818181818182	242	15933	7	29	235	15904	16175	0.06982714602370017
M1	cpdb	0	network_modules	75	TRUE	0.0020725021747958904	10	36	3	0.08333333333333333	0.3	GO:0034380	GO:BP	high-density lipoprotein particle assembly	16175	8605		0.8289473684210527	0.8831168831168831	10	16165	3	33	7	16132	16175	0.15716438917246794
M1	cpdb	0	network_modules	75	TRUE	0.0020725021747958904	10	36	3	0.08333333333333333	0.3	GO:0034384	GO:BP	high-density lipoprotein particle clearance	16175	8609		0.8289473684210527	0.8831168831168831	10	16165	3	33	7	16132	16175	0.15716438917246794
M1	cpdb	0	network_modules	75	TRUE	0.0020725021747958904	10	36	3	0.08333333333333333	0.3	GO:0032375	GO:BP	negative regulation of cholesterol transport	16175	7529		0.8289473684210527	0.8831168831168831	10	16165	3	33	7	16132	16175	0.15716438917246794
M1	cpdb	0	network_modules	75	TRUE	0.0020725021747958904	10	36	3	0.08333333333333333	0.3	GO:0060192	GO:BP	negative regulation of lipase activity	16175	14424		0.8289473684210527	0.8831168831168831	10	16165	3	33	7	16132	16175	0.15716438917246794
M1	cpdb	0	network_modules	75	TRUE	0.0020725021747958904	10	36	3	0.08333333333333333	0.3	GO:0032372	GO:BP	negative regulation of sterol transport	16175	7526		0.8289473684210527	0.8831168831168831	10	16165	3	33	7	16132	16175	0.15716438917246794
M1	cpdb	0	network_modules	75	TRUE	0.002287572365973956	257	36	7	0.19444444444444445	0.027237354085603113	GO:0006066	GO:BP	alcohol metabolic process	16175	1933		0.8947368421052632	0.8961038961038961	257	15918	7	29	250	15889	16175	0.06744041003274066
M1	cpdb	0	network_modules	75	TRUE	0.0023553904472306863	97	31	5	0.16129032258064516	0.05154639175257732	REAC:R-HSA-2187338	REAC	Visual phototransduction	10916	2654		0.8181818181818182	0.8333333333333334	97	10819	5	26	92	10793	10916	0.08666583065560098
M1	cpdb	0	network_modules	75	TRUE	0.0024366741443940985	45	31	4	0.12903225806451613	0.08888888888888889	REAC:R-HSA-9024446	REAC	NR1H2 and NR1H3-mediated signaling	10916	1546		0.9090909090909091	0.9166666666666666	45	10871	4	27	41	10844	10916	0.10403654116221266
M1	cpdb	0	network_modules	75	TRUE	0.003787970877251623	12	36	3	0.08333333333333333	0.25	GO:2001140	GO:BP	positive regulation of phospholipid transport	16175	26360		0.9078947368421053	0.9090909090909091	12	16163	3	33	9	16130	16175	0.14326519596376586
M1	cpdb	0	network_modules	75	TRUE	0.0042590014632919275	189	31	6	0.1935483870967742	0.031746031746031744	REAC:R-HSA-196854	REAC	Metabolism of vitamins and cofactors	10916	1440		1	1	189	10727	6	25	183	10702	10916	0.07210255963785998
M1	cpdb	0	network_modules	75	TRUE	0.004337970349106521	99	36	5	0.1388888888888889	0.050505050505050504	GO:0045834	GO:BP	positive regulation of lipid metabolic process	16175	11650		0.9210526315789473	0.922077922077922	99	16076	5	31	94	16045	16175	0.08039797932154329
M1	cpdb	0	network_modules	75	TRUE	0.004538869835689296	44	36	4	0.1111111111111111	0.09090909090909091	GO:0009395	GO:BP	phospholipid catabolic process	16175	3464		0.9342105263157895	0.935064935064935	44	16131	4	32	40	16099	16175	0.09828628555497232
M1	cpdb	0	network_modules	75	TRUE	0.004916829375616961	13	36	3	0.08333333333333333	0.23076923076923078	GO:2001138	GO:BP	regulation of phospholipid transport	16175	26358		0.9473684210526315	0.961038961038961	13	16162	3	33	10	16129	16175	0.1375459691023551
M1	cpdb	0	network_modules	75	TRUE	0.004916829375616961	13	36	3	0.08333333333333333	0.23076923076923078	GO:0055091	GO:BP	phospholipid homeostasis	16175	14241		0.9473684210526315	0.961038961038961	13	16162	3	33	10	16129	16175	0.1375459691023551
M1	cpdb	0	network_modules	75	TRUE	0.00521150830907268	185	36	6	0.16666666666666666	0.032432432432432434	GO:0046434	GO:BP	organophosphate catabolic process	16175	12142		0.9736842105263158	0.974025974025974	185	15990	6	30	179	15960	16175	0.06894785016121918
M1	cpdb	0	network_modules	75	TRUE	0.005698690006799743	36	21	3	0.14285714285714285	0.08333333333333333	KEGG:05143	KEGG	African trypanosomiasis	8484	435		1	1	36	8448	3	18	33	8430	8484	0.10622496476149967
M1	cpdb	0	network_modules	75	TRUE	0.00737044351717753	763	36	10	0.2777777777777778	0.01310615989515072	GO:0048878	GO:BP	chemical homeostasis	16175	13119		0.9868421052631579	0.987012987012987	763	15412	10	26	753	15386	16175	0.05137318252019638
M1	cpdb	0	network_modules	75	TRUE	0.008303875390306035	2	36	2	0.05555555555555555	1	GO:0010902	GO:BP	positive regulation of very-low-density lipoprotein particle remodeling	16175	4488		1	1	2	16173	2	34	0	16139	16175	0.23545437524377763
M1	cpdb	0	network_modules	76	TRUE	8.550964226979119e-29	44	33	16	0.48484848484848486	0.36363636363636365	REAC:R-HSA-1566948	REAC	Elastic fibre formation	10916	836		0	0.1111111111111111	44	10872	16	17	28	10855	10916	0.41787421411074754
M1	cpdb	0	network_modules	76	TRUE	1.1747633968256638e-26	298	33	23	0.696969696969697	0.07718120805369127	REAC:R-HSA-1474244	REAC	Extracellular matrix organization	10916	889		0.125	0.2222222222222222	298	10618	23	10	275	10608	10916	0.22629644999077383
M1	cpdb	0	network_modules	76	TRUE	4.370832671045132e-25	37	33	14	0.42424242424242425	0.3783783783783784	REAC:R-HSA-2129379	REAC	Molecules associated with elastic fibres	10916	1490		0.25	0.3333333333333333	37	10879	14	19	23	10860	10916	0.39873206370409836
M1	cpdb	0	network_modules	76	TRUE	4.109625571215001e-12	236	37	13	0.35135135135135137	0.05508474576271186	GO:0030198	GO:BP	extracellular matrix organization	16175	6707		0	0.045454545454545456	236	15939	13	24	223	15915	16175	0.13447930761661128
M1	cpdb	0	network_modules	76	TRUE	4.342066787997832e-12	237	37	13	0.35135135135135137	0.05485232067510549	GO:0043062	GO:BP	extracellular structure organization	16175	10509		0.047619047619047616	0.09090909090909091	237	15938	13	24	224	15914	16175	0.13417486910523876
M1	cpdb	0	network_modules	76	TRUE	4.5865361838958454e-12	238	37	13	0.35135135135135137	0.0546218487394958	GO:0045229	GO:BP	external encapsulating structure organization	16175	11340		0.09523809523809523	0.13636363636363635	238	15937	13	24	225	15913	16175	0.13387230723880106
M1	cpdb	0	network_modules	76	TRUE	1.1532189201569747e-6	20	37	5	0.13513513513513514	0.25	GO:0048048	GO:BP	embryonic eye morphogenesis	16175	12484		0.14285714285714285	0.18181818181818182	20	16155	5	32	15	16123	16175	0.18244335275507553
M1	cpdb	0	network_modules	76	TRUE	1.767744245600143e-5	283	37	9	0.24324324324324326	0.03180212014134275	GO:0001501	GO:BP	skeletal system development	16175	318		0.19047619047619047	0.22727272727272727	283	15892	9	28	274	15864	16175	0.08244417827659355
M1	cpdb	0	network_modules	76	TRUE	1.7771671012416865e-5	3	37	3	0.08108108108108109	1	GO:0048050	GO:BP	post-embryonic eye morphogenesis	16175	12485		0.23809523809523808	0.2727272727272727	3	16172	3	34	0	16138	16175	0.2844479148814264
M1	cpdb	0	network_modules	76	TRUE	3.130785966434043e-5	76	33	6	0.18181818181818182	0.07894736842105263	REAC:R-HSA-3000178	REAC	ECM proteoglycans	10916	812		0.375	0.4444444444444444	76	10840	6	27	70	10813	10916	0.11579907680697288
M1	cpdb	0	network_modules	76	TRUE	7.097459460845628e-5	4	37	3	0.08108108108108109	0.75	GO:0035583	GO:BP	sequestering of TGFbeta in extracellular matrix	16175	9104		0.2857142857142857	0.3181818181818182	4	16171	3	34	1	16137	16175	0.24615846845627437
M1	cpdb	0	network_modules	76	TRUE	8.130816883876196e-5	46	33	5	0.15151515151515152	0.10869565217391304	REAC:R-HSA-2173789	REAC	TGF-beta receptor signaling activates SMADs	10916	2428		0.5	0.5555555555555556	46	10870	5	28	41	10842	10916	0.12521565881561247
M1	cpdb	0	network_modules	76	TRUE	4.1523486512063827e-4	543	37	10	0.2702702702702703	0.01841620626151013	GO:0009887	GO:BP	animal organ morphogenesis	16175	3747		0.3333333333333333	0.36363636363636365	543	15632	10	27	533	15605	16175	0.06292326741249209
M1	cpdb	0	network_modules	76	TRUE	6.180949515065011e-4	7	37	3	0.08108108108108109	0.42857142857142855	GO:0071694	GO:BP	maintenance of protein location in extracellular region	16175	16862		0.38095238095238093	0.4090909090909091	7	16168	3	34	4	16134	16175	0.18566858204039244
M1	cpdb	0	network_modules	76	TRUE	9.873928924554287e-4	8	37	3	0.08108108108108109	0.375	GO:0048251	GO:BP	elastic fiber assembly	16175	12607		0.42857142857142855	0.45454545454545453	8	16167	3	34	5	16133	16175	0.17354928425912225
M1	cpdb	0	network_modules	76	TRUE	0.0011944390267822045	35	33	4	0.12121212121212122	0.11428571428571428	REAC:R-HSA-5083635	REAC	Defective B3GALTL causes PpS	10916	491		0.625	0.6666666666666666	35	10881	4	29	31	10852	10916	0.11494264236309804
M1	cpdb	0	network_modules	76	TRUE	0.0013408881583742425	36	33	4	0.12121212121212122	0.1111111111111111	REAC:R-HSA-5173214	REAC	O-glycosylation of TSR domain-containing proteins	10916	1630		0.75	0.7777777777777778	36	10880	4	29	32	10851	10916	0.11325219538707436
M1	cpdb	0	network_modules	76	TRUE	0.0014581624715679878	33	37	4	0.10810810810810811	0.12121212121212122	GO:0085029	GO:BP	extracellular matrix assembly	16175	17872		0.47619047619047616	0.5	33	16142	4	33	29	16109	16175	0.11255601730341576
M1	cpdb	0	network_modules	76	TRUE	0.0016195129725970804	80	37	5	0.13513513513513514	0.0625	GO:0048592	GO:BP	eye morphogenesis	16175	12861		0.5238095238095238	0.5454545454545454	80	16095	5	32	75	16063	16175	0.08885970628480573
M1	cpdb	0	network_modules	76	TRUE	0.0021091767073540186	10	37	3	0.08108108108108109	0.3	GO:0035581	GO:BP	sequestering of extracellular ligand from receptor	16175	9102		0.5714285714285714	0.5909090909090909	10	16165	3	34	7	16131	16175	0.15499861414417823
M1	cpdb	0	network_modules	76	TRUE	0.0026431772758740944	92	33	5	0.15151515151515152	0.05434782608695652	REAC:R-HSA-170834	REAC	Signaling by TGF-beta Receptor Complex	10916	2308		0.875	0.8888888888888888	92	10824	5	28	87	10796	10916	0.08619042622010237
M1	cpdb	0	network_modules	76	TRUE	0.003854644282407897	12	37	3	0.08108108108108109	0.25	GO:1900116	GO:BP	extracellular negative regulation of signal transduction	16175	20402		0.6190476190476191	0.6818181818181818	12	16163	3	34	9	16129	16175	0.1412850353319482
M1	cpdb	0	network_modules	76	TRUE	0.003854644282407897	12	37	3	0.08108108108108109	0.25	GO:1900115	GO:BP	extracellular regulation of signal transduction	16175	20401		0.6190476190476191	0.6818181818181818	12	16163	3	34	9	16129	16175	0.1412850353319482
M1	cpdb	0	network_modules	76	TRUE	0.004318916319416499	176	37	6	0.16216216216216217	0.03409090909090909	GO:0007179	GO:BP	transforming growth factor beta receptor signaling pathway	16175	2741		0.7142857142857143	0.7272727272727273	176	15999	6	31	170	15968	16175	0.06982363043327189
M1	cpdb	0	network_modules	76	TRUE	0.005533055696656258	107	33	5	0.15151515151515152	0.04672897196261682	REAC:R-HSA-8957275	REAC	Post-translational protein phosphorylation	10916	1777		1	1	107	10809	5	28	102	10781	10916	0.07920841215229316
M1	cpdb	0	network_modules	76	TRUE	0.007934474510536641	15	37	3	0.08108108108108109	0.2	GO:0032331	GO:BP	negative regulation of chondrocyte differentiation	16175	7490		0.7619047619047619	0.7727272727272727	15	16160	3	34	12	16126	16175	0.12608914305468685
M1	cpdb	0	network_modules	76	TRUE	0.007981949253355576	50	37	4	0.10810810810810811	0.08	GO:0030199	GO:BP	collagen fibril organization	16175	6708		0.8095238095238095	0.8181818181818182	50	16125	4	33	46	16092	16175	0.09058258299799783
M1	cpdb	0	network_modules	76	TRUE	0.008776018486034456	199	37	6	0.16216216216216217	0.03015075376884422	GO:0001654	GO:BP	eye development	16175	368		0.8571428571428571	0.8636363636363636	199	15976	6	31	193	15945	16175	0.06509433813068505
M1	cpdb	0	network_modules	76	TRUE	0.009563834220889597	202	37	6	0.16216216216216217	0.0297029702970297	GO:0071560	GO:BP	cellular response to transforming growth factor beta stimulus	16175	16762		0.9047619047619048	0.9545454545454546	202	15973	6	31	196	15942	16175	0.06453525301080888
M1	cpdb	0	network_modules	76	TRUE	0.009563834220889597	202	37	6	0.16216216216216217	0.0297029702970297	GO:0150063	GO:BP	visual system development	16175	20119		0.9047619047619048	0.9545454545454546	202	15973	6	31	196	15942	16175	0.06453525301080888
M1	cpdb	0	network_modules	76	TRUE	0.009750119221205791	16	37	3	0.08108108108108109	0.1875	GO:0061037	GO:BP	negative regulation of cartilage development	16175	15154		1	1	16	16159	3	34	13	16125	16175	0.12199489618678971
M1	cpdb	0	network_modules	77	TRUE	1.8508980438725e-22	33	26	12	0.46153846153846156	0.36363636363636365	REAC:R-HSA-68962	REAC	Activation of the pre-replicative complex	10916	107		0	0.058823529411764705	33	10883	12	14	21	10869	10916	0.40809275131281086
M1	cpdb	0	network_modules	77	TRUE	9.617633400467647e-22	37	26	12	0.46153846153846156	0.32432432432432434	REAC:R-HSA-176187	REAC	Activation of ATR in response to replication stress	10916	75		0.0625	0.11764705882352941	37	10879	12	14	25	10865	10916	0.3851656939195716
M1	cpdb	0	network_modules	77	TRUE	1.0304109039742111e-19	8	26	8	0.3076923076923077	1	REAC:R-HSA-68689	REAC	CDC6 association with the ORC:origin complex	10916	270		0.125	0.17647058823529413	8	10908	8	18	0	10890	10916	0.554242333830886
M1	cpdb	0	network_modules	77	TRUE	8.232089095725359e-16	147	26	13	0.5	0.08843537414965986	REAC:R-HSA-453279	REAC	Mitotic G1 phase and G1/S transition	10916	1480		0.1875	0.23529411764705882	147	10769	13	13	134	10756	10916	0.20625414240437814
M1	cpdb	0	network_modules	77	TRUE	1.5179226987812637e-15	231	37	15	0.40540540540540543	0.06493506493506493	GO:0006260	GO:BP	DNA replication	16175	2077		0	0.25	231	15944	15	22	216	15922	16175	0.1578447885695517
M1	cpdb	0	network_modules	77	TRUE	2.1233399715024064e-15	9	26	7	0.2692307692307692	0.7777777777777778	REAC:R-HSA-113507	REAC	E2F-enabled inhibition of pre-replication complex formation	10916	810		0.25	0.29411764705882354	9	10907	7	19	2	10888	10916	0.4569356482188255
M1	cpdb	0	network_modules	77	TRUE	8.01244835634576e-15	147	37	13	0.35135135135135137	0.08843537414965986	GO:0006261	GO:BP	DNA-templated DNA replication	16175	2078		0.3333333333333333	0.5	147	16028	13	24	134	16004	16175	0.17269598252413507
M1	cpdb	0	network_modules	77	TRUE	1.3391856855220373e-14	130	26	12	0.46153846153846156	0.09230769230769231	REAC:R-HSA-69206	REAC	G1/S Transition	10916	1002		0.3125	0.35294117647058826	130	10786	12	14	118	10772	10916	0.2025298388809178
M1	cpdb	0	network_modules	77	TRUE	2.605535204867985e-14	32	37	9	0.24324324324324326	0.28125	GO:0006270	GO:BP	DNA replication initiation	16175	2085		0.6666666666666666	0.75	32	16143	9	28	23	16115	16175	0.25998440270133466
M1	cpdb	0	network_modules	77	TRUE	1.5984699836631865e-13	159	26	12	0.46153846153846156	0.07547169811320754	REAC:R-HSA-69002	REAC	DNA Replication Pre-Initiation	10916	446		0.375	0.4117647058823529	159	10757	12	14	147	10743	10916	0.1822943044262846
M1	cpdb	0	network_modules	77	TRUE	2.913618046683907e-13	167	26	12	0.46153846153846156	0.0718562874251497	REAC:R-HSA-69481	REAC	G2/M Checkpoints	10916	1005		0.4375	0.47058823529411764	167	10749	12	14	155	10735	10916	0.17764881432802204
M1	cpdb	0	network_modules	77	TRUE	5.639284375101314e-13	157	20	11	0.55	0.07006369426751592	KEGG:04110	KEGG	Cell cycle	8484	264		NA	1	157	8327	11	9	146	8318	8484	0.1917046115977239
M1	cpdb	0	network_modules	77	TRUE	1.1553026825330612e-12	187	26	12	0.46153846153846156	0.06417112299465241	REAC:R-HSA-69306	REAC	DNA Replication	10916	445		0.5	0.5294117647058824	187	10729	12	14	175	10715	10916	0.16734677832363468
M1	cpdb	0	network_modules	77	TRUE	6.0385170498328565e-12	289	26	13	0.5	0.04498269896193772	REAC:R-HSA-69620	REAC	Cell Cycle Checkpoints	10916	321		0.5625	0.5882352941176471	289	10627	13	13	276	10614	10916	0.1441202492705939
M1	cpdb	0	network_modules	77	TRUE	9.86140720969423e-12	22	26	7	0.2692307692307692	0.3181818181818182	REAC:R-HSA-113510	REAC	E2F mediated regulation of DNA replication	10916	809		0.625	0.6470588235294118	22	10894	7	19	15	10875	10916	0.29113383725717745
M1	cpdb	0	network_modules	77	TRUE	9.992499980160036e-10	71	26	8	0.3076923076923077	0.11267605633802817	REAC:R-HSA-68949	REAC	Orc1 removal from chromatin	10916	1644		0.6875	0.7058823529411765	71	10845	8	18	63	10827	10916	0.18307544914849944
M1	cpdb	0	network_modules	77	TRUE	1.640410470458285e-9	121	26	9	0.34615384615384615	0.0743801652892562	REAC:R-HSA-69239	REAC	Synthesis of DNA	10916	2376		0.75	0.7647058823529411	121	10795	9	17	112	10778	10916	0.15637479777068192
M1	cpdb	0	network_modules	77	TRUE	8.475757807085214e-9	92	26	8	0.3076923076923077	0.08695652173913043	REAC:R-HSA-69052	REAC	Switching of origins to a post-replicative state	10916	2365		0.8125	0.8235294117647058	92	10824	8	18	84	10806	10916	0.15995704960865512
M1	cpdb	0	network_modules	77	TRUE	2.3141903636526544e-8	162	26	9	0.34615384615384615	0.05555555555555555	REAC:R-HSA-69242	REAC	S Phase	10916	2111		0.875	0.8823529411764706	162	10754	9	17	153	10737	10916	0.13388518905054272
M1	cpdb	0	network_modules	77	TRUE	2.8367634505505983e-7	142	26	8	0.3076923076923077	0.056338028169014086	REAC:R-HSA-68867	REAC	Assembly of the pre-replicative complex	10916	181		0.9375	0.9411764705882353	142	10774	8	18	134	10756	10916	0.1270749601804667
M1	cpdb	0	network_modules	77	TRUE	3.203776038653651e-6	68	26	6	0.23076923076923078	0.08823529411764706	REAC:R-HSA-68616	REAC	Assembly of the ORC complex at the origin of replication	10916	178		1	1	68	10848	6	20	62	10828	10916	0.13944417608686901
M1	cpdb	0	network_modules	77	TRUE	3.0318269468476716e-4	112	37	6	0.16216216216216217	0.05357142857142857	GO:0006275	GO:BP	regulation of DNA replication	16175	2090		1	1	112	16063	6	31	106	16032	16175	0.08963873181711206
M1	cpdb	0	network_modules	78	TRUE	3.471898434000006e-18	744	39	23	0.5897435897435898	0.030913978494623656	GO:0001932	GO:BP	regulation of protein phosphorylation	16175	546		0	0.015625	744	15431	23	16	721	15415	16175	0.1276120736503999
M1	cpdb	0	network_modules	78	TRUE	3.788284319771445e-18	301	37	20	0.5405405405405406	0.0664451827242525	KEGG:04010	KEGG	MAPK signaling pathway	8484	243		0	0.012987012987012988	301	8183	20	17	281	8166	8484	0.18069887106969443
M1	cpdb	0	network_modules	78	TRUE	1.4240018045426246e-17	792	39	23	0.5897435897435898	0.02904040404040404	GO:0042325	GO:BP	regulation of phosphorylation	16175	10093		0.015873015873015872	0.03125	792	15383	23	16	769	15367	16175	0.12320135064019185
M1	cpdb	0	network_modules	78	TRUE	2.590318019520561e-15	632	39	20	0.5128205128205128	0.03164556962025317	GO:0031401	GO:BP	positive regulation of protein modification process	16175	7157		0.031746031746031744	0.046875	632	15543	20	19	612	15524	16175	0.12019875181781257
M1	cpdb	0	network_modules	78	TRUE	2.4710719106111658e-14	500	39	18	0.46153846153846156	0.036	GO:0001934	GO:BP	positive regulation of protein phosphorylation	16175	548		0.047619047619047616	0.0625	500	15675	18	21	482	15654	16175	0.12231808870346618
M1	cpdb	0	network_modules	78	TRUE	5.285979320859511e-14	522	39	18	0.46153846153846156	0.034482758620689655	GO:0042327	GO:BP	positive regulation of phosphorylation	16175	10095		0.06349206349206349	0.078125	522	15653	18	21	504	15632	16175	0.1194184801611722
M1	cpdb	0	network_modules	78	TRUE	2.0635956116751883e-13	564	39	18	0.46153846153846156	0.031914893617021274	GO:0010562	GO:BP	positive regulation of phosphorus metabolic process	16175	4215		0.07936507936507936	0.109375	564	15611	18	21	546	15590	16175	0.11434460496667485
M1	cpdb	0	network_modules	78	TRUE	2.0635956116751883e-13	564	39	18	0.46153846153846156	0.031914893617021274	GO:0045937	GO:BP	positive regulation of phosphate metabolic process	16175	11731		0.07936507936507936	0.109375	564	15611	18	21	546	15590	16175	0.11434460496667485
M1	cpdb	0	network_modules	78	TRUE	5.272942098965512e-13	595	39	18	0.46153846153846156	0.030252100840336135	GO:0000165	GO:BP	MAPK cascade	16175	55		0.1111111111111111	0.125	595	15580	18	21	577	15559	16175	0.11093617857544669
M1	cpdb	0	network_modules	78	TRUE	1.261648308853876e-11	182	39	12	0.3076923076923077	0.06593406593406594	GO:0006457	GO:BP	protein folding	16175	2203		0.12698412698412698	0.140625	182	15993	12	27	170	15966	16175	0.13817050428198308
M1	cpdb	0	network_modules	78	TRUE	8.060096159486708e-11	35	38	8	0.21052631578947367	0.22857142857142856	REAC:R-HSA-6802948	REAC	Signaling by high-kinase activity BRAF mutants	10916	2321		0	0.012195121951219513	35	10881	8	30	27	10851	10916	0.21674725117179983
M1	cpdb	0	network_modules	78	TRUE	8.937346529529331e-11	87	38	10	0.2631578947368421	0.11494252873563218	REAC:R-HSA-3371556	REAC	Cellular response to heat stress	10916	334		0.012345679012345678	0.024390243902439025	87	10829	10	28	77	10801	10916	0.1696239393389553
M1	cpdb	0	network_modules	78	TRUE	1.406819598631934e-10	58	37	9	0.24324324324324326	0.15517241379310345	KEGG:05213	KEGG	Endometrial cancer	8484	464		0.013157894736842105	0.025974025974025976	58	8426	9	28	49	8398	8484	0.18988278737049755
M1	cpdb	0	network_modules	78	TRUE	1.8360284895004328e-10	25	39	7	0.1794871794871795	0.28	GO:0042026	GO:BP	protein refolding	16175	9932		0.14285714285714285	0.15625	25	16150	7	32	18	16118	16175	0.22268954908610308
M1	cpdb	0	network_modules	78	TRUE	2.0863892815838523e-10	39	38	8	0.21052631578947367	0.20512820512820512	REAC:R-HSA-5674135	REAC	MAP2K and MAPK activation	10916	1346		0.024691358024691357	0.036585365853658534	39	10877	8	30	31	10847	10916	0.20500614101517126
M1	cpdb	0	network_modules	78	TRUE	2.4704758604895827e-10	119	39	10	0.2564102564102564	0.08403361344537816	GO:0035966	GO:BP	response to topologically incorrect protein	16175	9369		0.15873015873015872	0.171875	119	16056	10	29	109	16027	16175	0.14327771864352992
M1	cpdb	0	network_modules	78	TRUE	2.6016006727511487e-10	40	38	8	0.21052631578947367	0.2	REAC:R-HSA-9656223	REAC	Signaling by RAF1 mutants	10916	2296		0.037037037037037035	0.04878048780487805	40	10876	8	30	32	10846	10916	0.20234704148153668
M1	cpdb	0	network_modules	78	TRUE	2.716088338590407e-10	235	39	12	0.3076923076923077	0.05106382978723404	GO:0071900	GO:BP	regulation of protein serine/threonine kinase activity	16175	16971		0.1746031746031746	0.1875	235	15940	12	27	223	15913	16175	0.12045110149209991
M1	cpdb	0	network_modules	78	TRUE	3.460597242728764e-10	123	39	10	0.2564102564102564	0.08130081300813008	GO:0071902	GO:BP	positive regulation of protein serine/threonine kinase activity	16175	16973		0.19047619047619047	0.203125	123	16052	10	29	113	16023	16175	0.14080635099084324
M1	cpdb	0	network_modules	78	TRUE	3.9732996827129156e-10	42	38	8	0.21052631578947367	0.19047619047619047	REAC:R-HSA-5675221	REAC	Negative regulation of MAPK pathway	10916	1573		0.04938271604938271	0.06097560975609756	42	10874	8	30	34	10844	10916	0.1973137362202923
M1	cpdb	0	network_modules	78	TRUE	4.829428999684023e-10	412	39	14	0.358974358974359	0.03398058252427184	GO:0045859	GO:BP	regulation of protein kinase activity	16175	11671		0.20634920634920634	0.21875	412	15763	14	25	398	15738	16175	0.1040663416205817
M1	cpdb	0	network_modules	78	TRUE	4.931763370579121e-10	97	37	10	0.2702702702702703	0.10309278350515463	KEGG:05215	KEGG	Prostate cancer	8484	466		0.02631578947368421	0.03896103896103896	97	8387	10	27	87	8360	8484	0.1611340849027925
M1	cpdb	0	network_modules	78	TRUE	5.50031253495115e-10	136	37	11	0.2972972972972973	0.08088235294117647	KEGG:04915	KEGG	Estrogen signaling pathway	8484	372		0.039473684210526314	0.05194805194805195	136	8348	11	26	125	8322	8484	0.14822060141388899
M1	cpdb	0	network_modules	78	TRUE	7.203074104975775e-10	45	38	8	0.21052631578947367	0.17777777777777778	REAC:R-HSA-6802955	REAC	Paradoxical activation of RAF signaling by kinase inactive BRAF	10916	1715		0.06172839506172839	0.10975609756097561	45	10871	8	30	37	10841	10916	0.19039596854752652
M1	cpdb	0	network_modules	78	TRUE	7.203074104975775e-10	45	38	8	0.21052631578947367	0.17777777777777778	REAC:R-HSA-6802949	REAC	Signaling by RAS mutants	10916	2299		0.06172839506172839	0.10975609756097561	45	10871	8	30	37	10841	10916	0.19039596854752652
M1	cpdb	0	network_modules	78	TRUE	7.203074104975775e-10	45	38	8	0.21052631578947367	0.17777777777777778	REAC:R-HSA-9649948	REAC	Signaling downstream of RAS mutants	10916	2329		0.06172839506172839	0.10975609756097561	45	10871	8	30	37	10841	10916	0.19039596854752652
M1	cpdb	0	network_modules	78	TRUE	7.203074104975775e-10	45	38	8	0.21052631578947367	0.17777777777777778	REAC:R-HSA-6802946	REAC	Signaling by moderate kinase activity BRAF mutants	10916	2325		0.06172839506172839	0.10975609756097561	45	10871	8	30	37	10841	10916	0.19039596854752652
M1	cpdb	0	network_modules	78	TRUE	8.686314229486494e-10	6	38	5	0.13157894736842105	0.8333333333333334	REAC:R-HSA-5674499	REAC	Negative feedback regulation of MAPK pathway	10916	1567		0.1111111111111111	0.12195121951219512	6	10910	5	33	1	10877	10916	0.3304161020575335
M1	cpdb	0	network_modules	78	TRUE	1.1214493688345387e-9	418	38	15	0.39473684210526316	0.03588516746411483	REAC:R-HSA-5663202	REAC	Diseases of signal transduction by growth factor receptors and second messengers	10916	773		0.12345679012345678	0.13414634146341464	418	10498	15	23	403	10475	10916	0.10978201612437823
M1	cpdb	0	network_modules	78	TRUE	1.2941119637190971e-9	443	39	14	0.358974358974359	0.03160270880361174	GO:0043549	GO:BP	regulation of kinase activity	16175	10763		0.2222222222222222	0.234375	443	15732	14	25	429	15707	16175	0.09988069303340118
M1	cpdb	0	network_modules	78	TRUE	3.5939873390907615e-9	118	37	10	0.2702702702702703	0.0847457627118644	KEGG:04722	KEGG	Neurotrophin signaling pathway	8484	352		0.05263157894736842	0.06493506493506493	118	8366	10	27	108	8339	8484	0.14487836820513236
M1	cpdb	0	network_modules	78	TRUE	3.745622645067162e-9	162	37	11	0.2972972972972973	0.06790123456790123	KEGG:05161	KEGG	Hepatitis B	8484	442		0.06578947368421052	0.07792207792207792	162	8322	11	26	151	8296	8484	0.13453645750335747
M1	cpdb	0	network_modules	78	TRUE	3.984053551687789e-9	214	37	12	0.32432432432432434	0.056074766355140186	KEGG:05417	KEGG	Lipid and atherosclerosis	8484	494		0.07894736842105263	0.09090909090909091	214	8270	12	25	202	8245	8484	0.1262430819892148
M1	cpdb	0	network_modules	78	TRUE	7.451340588130427e-9	71	39	8	0.20512820512820512	0.11267605633802817	GO:0009408	GO:BP	response to heat	16175	3473		0.23809523809523808	0.25	71	16104	8	31	63	16073	16175	0.14928416217207993
M1	cpdb	0	network_modules	78	TRUE	9.12025694423246e-9	512	39	14	0.358974358974359	0.02734375	GO:0051338	GO:BP	regulation of transferase activity	16175	13665		0.25396825396825395	0.265625	512	15663	14	25	498	15638	16175	0.09191354096390993
M1	cpdb	0	network_modules	78	TRUE	1.0914365789752463e-8	241	39	11	0.28205128205128205	0.04564315352697095	GO:0045860	GO:BP	positive regulation of protein kinase activity	16175	11672		0.2698412698412698	0.28125	241	15934	11	28	230	15906	16175	0.10840910001138147
M1	cpdb	0	network_modules	78	TRUE	1.4117109885270087e-8	64	38	8	0.21052631578947367	0.125	REAC:R-HSA-6802952	REAC	Signaling by BRAF and RAF1 fusions	10916	2225		0.13580246913580246	0.14634146341463414	64	10852	8	30	56	10822	10916	0.15844408221831
M1	cpdb	0	network_modules	78	TRUE	1.4493137581684144e-8	530	39	14	0.358974358974359	0.026415094339622643	GO:0043408	GO:BP	regulation of MAPK cascade	16175	10676		0.2857142857142857	0.296875	530	15645	14	25	516	15620	16175	0.09008390381976532
M1	cpdb	0	network_modules	78	TRUE	1.5994702399811922e-8	137	37	10	0.2702702702702703	0.072992700729927	KEGG:04910	KEGG	Insulin signaling pathway	8484	367		0.09210526315789473	0.1038961038961039	137	8347	10	27	127	8320	8484	0.13343428625010478
M1	cpdb	0	network_modules	78	TRUE	1.768173147997035e-8	507	38	15	0.39473684210526316	0.029585798816568046	REAC:R-HSA-9006934	REAC	Signaling by Receptor Tyrosine Kinases	10916	2302		0.14814814814814814	0.15853658536585366	507	10409	15	23	492	10386	10916	0.09781712354857024
M1	cpdb	0	network_modules	78	TRUE	2.2828980155200238e-8	258	39	11	0.28205128205128205	0.04263565891472868	GO:0033674	GO:BP	positive regulation of kinase activity	16175	8346		0.30158730158730157	0.3125	258	15917	11	28	247	15889	16175	0.10442014049255614
M1	cpdb	0	network_modules	78	TRUE	2.5546587539160907e-8	41	37	7	0.1891891891891892	0.17073170731707318	KEGG:05219	KEGG	Bladder cancer	8484	470		0.10526315789473684	0.11688311688311688	41	8443	7	30	34	8413	8484	0.1759416071865197
M1	cpdb	0	network_modules	78	TRUE	2.6523822679316883e-8	102	37	9	0.24324324324324326	0.08823529411764706	KEGG:04914	KEGG	Progesterone-mediated oocyte maturation	8484	371		0.11842105263157894	0.12987012987012986	102	8382	9	28	93	8354	8484	0.14041157400112905
M1	cpdb	0	network_modules	78	TRUE	4.3998004074149465e-8	72	37	8	0.21621621621621623	0.1111111111111111	KEGG:05223	KEGG	Non-small cell lung cancer	8484	474		0.13157894736842105	0.15584415584415584	72	8412	8	29	64	8383	8484	0.14987627503754594
M1	cpdb	0	network_modules	78	TRUE	4.3998004074149465e-8	72	37	8	0.21621621621621623	0.1111111111111111	KEGG:05218	KEGG	Melanoma	8484	469		0.13157894736842105	0.15584415584415584	72	8412	8	29	64	8383	8484	0.14987627503754594
M1	cpdb	0	network_modules	78	TRUE	6.145126831070978e-8	75	37	8	0.21621621621621623	0.10666666666666667	KEGG:05214	KEGG	Glioma	8484	465		0.15789473684210525	0.16883116883116883	75	8409	8	29	67	8380	8484	0.1466243356910679
M1	cpdb	0	network_modules	78	TRUE	7.51801903824529e-8	483	39	13	0.3333333333333333	0.026915113871635612	GO:0051604	GO:BP	protein maturation	16175	13821		0.31746031746031744	0.328125	483	15692	13	26	470	15666	16175	0.08765671421491553
M1	cpdb	0	network_modules	78	TRUE	9.38699819566669e-8	79	37	8	0.21621621621621623	0.10126582278481013	KEGG:01521	KEGG	EGFR tyrosine kinase inhibitor resistance	8484	195		0.17105263157894737	0.18181818181818182	79	8405	8	29	71	8376	8484	0.14257321898136305
M1	cpdb	0	network_modules	78	TRUE	1.0773877850591296e-7	308	38	12	0.3157894736842105	0.03896103896103896	REAC:R-HSA-5683057	REAC	MAPK family signaling cascades	10916	1348		0.16049382716049382	0.17073170731707318	308	10608	12	26	296	10582	10916	0.10264512262246461
M1	cpdb	0	network_modules	78	TRUE	1.0876168145206151e-7	82	38	8	0.21052631578947367	0.0975609756097561	REAC:R-HSA-6802957	REAC	Oncogenic MAPK signaling	10916	1641		0.1728395061728395	0.18292682926829268	82	10834	8	30	74	10804	10916	0.13896528243468853
M1	cpdb	0	network_modules	78	TRUE	1.197916943020243e-7	301	39	11	0.28205128205128205	0.036544850498338874	GO:0051347	GO:BP	positive regulation of transferase activity	16175	13674		0.3333333333333333	0.34375	301	15874	11	28	290	15846	16175	0.0958380023824947
M1	cpdb	0	network_modules	78	TRUE	1.232457659142228e-7	27	38	6	0.15789473684210525	0.2222222222222222	REAC:R-HSA-8863795	REAC	Downregulation of ERBB2 signaling	10916	784		0.18518518518518517	0.1951219512195122	27	10889	6	32	21	10857	10916	0.1849334466021488
M1	cpdb	0	network_modules	78	TRUE	1.2402388012886358e-7	100	39	8	0.20512820512820512	0.08	GO:0009266	GO:BP	response to temperature stimulus	16175	3431		0.3492063492063492	0.359375	100	16075	8	31	92	16044	16175	0.12477799098638344
M1	cpdb	0	network_modules	78	TRUE	1.544771974756058e-7	84	37	8	0.21621621621621623	0.09523809523809523	KEGG:04012	KEGG	ErbB signaling pathway	8484	245		0.18421052631578946	0.19480519480519481	84	8400	8	29	76	8371	8484	0.13791206740766226
M1	cpdb	0	network_modules	78	TRUE	1.7049785420276563e-7	104	39	8	0.20512820512820512	0.07692307692307693	GO:0006986	GO:BP	response to unfolded protein	16175	2608		0.36507936507936506	0.375	104	16071	8	31	96	16040	16175	0.12221800309475991
M1	cpdb	0	network_modules	78	TRUE	1.8686895217797665e-7	86	37	8	0.21621621621621623	0.09302325581395349	KEGG:05210	KEGG	Colorectal cancer	8484	461		0.19736842105263158	0.2077922077922078	86	8398	8	29	78	8369	8484	0.1361594790882953
M1	cpdb	0	network_modules	78	TRUE	2.1883268586895957e-7	129	37	9	0.24324324324324326	0.06976744186046512	KEGG:04926	KEGG	Relaxin signaling pathway	8484	383		0.21052631578947367	0.22077922077922077	129	8355	9	28	120	8327	8484	0.12333595588676487
M1	cpdb	0	network_modules	78	TRUE	2.464548690732605e-7	89	37	8	0.21621621621621623	0.0898876404494382	KEGG:05235	KEGG	PD-L1 expression and PD-1 checkpoint pathway in cancer	8484	480		0.2236842105263158	0.23376623376623376	89	8395	8	29	81	8366	8484	0.1336391956510619
M1	cpdb	0	network_modules	78	TRUE	2.5094074140010844e-7	131	37	9	0.24324324324324326	0.06870229007633588	KEGG:04068	KEGG	FoxO signaling pathway	8484	258		0.23684210526315788	0.24675324675324675	131	8353	9	28	122	8325	8484	0.12227895178139939
M1	cpdb	0	network_modules	78	TRUE	2.770319256465379e-7	66	39	7	0.1794871794871795	0.10606060606060606	GO:0061077	GO:BP	chaperone-mediated protein folding	16175	15193		0.38095238095238093	0.390625	66	16109	7	32	59	16077	16175	0.1352754036616489
M1	cpdb	0	network_modules	78	TRUE	3.3872710458462404e-7	264	38	11	0.2894736842105263	0.041666666666666664	REAC:R-HSA-5673001	REAC	RAF/MAP kinase cascade	10916	1841		0.19753086419753085	0.2073170731707317	264	10652	11	27	253	10625	10916	0.10206633028894795
M1	cpdb	0	network_modules	78	TRUE	3.510599190020901e-7	93	37	8	0.21621621621621623	0.08602150537634409	KEGG:04912	KEGG	GnRH signaling pathway	8484	369		0.25	0.2597402597402597	93	8391	8	29	85	8362	8484	0.13046512295808005
M1	cpdb	0	network_modules	78	TRUE	3.5925477514354403e-7	95	38	8	0.21052631578947367	0.08421052631578947	REAC:R-HSA-975871	REAC	MyD88 cascade initiated on plasma membrane	10916	1497		0.20987654320987653	0.24390243902439024	95	10821	8	30	87	10791	10916	0.12842720113453476
M1	cpdb	0	network_modules	78	TRUE	3.5925477514354403e-7	95	38	8	0.21052631578947367	0.08421052631578947	REAC:R-HSA-168176	REAC	Toll Like Receptor 5 (TLR5) Cascade	10916	2517		0.20987654320987653	0.24390243902439024	95	10821	8	30	87	10791	10916	0.12842720113453476
M1	cpdb	0	network_modules	78	TRUE	3.5925477514354403e-7	95	38	8	0.21052631578947367	0.08421052631578947	REAC:R-HSA-168142	REAC	Toll Like Receptor 10 (TLR10) Cascade	10916	2513		0.20987654320987653	0.24390243902439024	95	10821	8	30	87	10791	10916	0.12842720113453476
M1	cpdb	0	network_modules	78	TRUE	3.6655780654278e-7	59	37	7	0.1891891891891892	0.11864406779661017	KEGG:04730	KEGG	Long-term depression	8484	359		0.2631578947368421	0.2727272727272727	59	8425	7	30	52	8395	8484	0.1451345865993064
M1	cpdb	0	network_modules	78	TRUE	4.132266136365773e-7	269	38	11	0.2894736842105263	0.040892193308550186	REAC:R-HSA-5684996	REAC	MAPK1/MAPK3 signaling	10916	1351		0.24691358024691357	0.25609756097560976	269	10647	11	27	258	10620	10916	0.10096242713958134
M1	cpdb	0	network_modules	78	TRUE	4.1644162997781464e-7	95	37	8	0.21621621621621623	0.08421052631578947	KEGG:01522	KEGG	Endocrine resistance	8484	196		0.27631578947368424	0.2857142857142857	95	8389	8	29	87	8360	8484	0.1289516140079313
M1	cpdb	0	network_modules	78	TRUE	4.5422650133051064e-7	33	38	6	0.15789473684210525	0.18181818181818182	REAC:R-HSA-5673000	REAC	RAF activation	10916	1839		0.25925925925925924	0.2682926829268293	33	10883	6	32	27	10851	10916	0.16673295337469943
M1	cpdb	0	network_modules	78	TRUE	5.88563592862717e-7	101	38	8	0.21052631578947367	0.07920792079207921	REAC:R-HSA-975138	REAC	TRAF6 mediated induction of NFkB and MAP kinases upon TLR7/8 or 9 activation	10916	2468		0.2716049382716049	0.2804878048780488	101	10815	8	30	93	10785	10916	0.12424936753488998
M1	cpdb	0	network_modules	78	TRUE	6.195489372010417e-7	63	38	7	0.18421052631578946	0.1111111111111111	REAC:R-HSA-450294	REAC	MAP kinase activation	10916	1345		0.2839506172839506	0.2926829268292683	63	10853	7	31	56	10822	10916	0.13922776268073725
M1	cpdb	0	network_modules	78	TRUE	6.370853549028591e-7	102	38	8	0.21052631578947367	0.0784313725490196	REAC:R-HSA-975155	REAC	MyD88 dependent cascade initiated on endosome	10916	1500		0.2962962962962963	0.3048780487804878	102	10814	8	30	94	10784	10916	0.12358824221201391
M1	cpdb	0	network_modules	78	TRUE	6.390354545451465e-7	185	39	9	0.23076923076923078	0.04864864864864865	GO:0018105	GO:BP	peptidyl-serine phosphorylation	16175	5324		0.3968253968253968	0.40625	185	15990	9	30	176	15960	16175	0.10140753151536151
M1	cpdb	0	network_modules	78	TRUE	6.571825445366993e-7	64	37	7	0.1891891891891892	0.109375	KEGG:04929	KEGG	GnRH secretion	8484	386		0.2894736842105263	0.2987012987012987	64	8420	7	30	57	8390	8484	0.13894056836304586
M1	cpdb	0	network_modules	78	TRUE	6.746155719733095e-7	577	39	13	0.3333333333333333	0.022530329289428077	GO:0043085	GO:BP	positive regulation of catalytic activity	16175	10518		0.4126984126984127	0.421875	577	15598	13	26	564	15572	16175	0.07890022130755749
M1	cpdb	0	network_modules	78	TRUE	6.890378779945347e-7	103	38	8	0.21052631578947367	0.07766990291262135	REAC:R-HSA-168181	REAC	Toll Like Receptor 7/8 (TLR7/8) Cascade	10916	2518		0.30864197530864196	0.3170731707317073	103	10813	8	30	95	10783	10916	0.12293651802306393
M1	cpdb	0	network_modules	78	TRUE	8.675565650399832e-7	106	38	8	0.21052631578947367	0.07547169811320754	REAC:R-HSA-168138	REAC	Toll Like Receptor 9 (TLR9) Cascade	10916	2519		0.32098765432098764	0.32926829268292684	106	10810	8	30	98	10780	10916	0.1210355355739413
M1	cpdb	0	network_modules	78	TRUE	9.114508617661176e-7	67	37	7	0.1891891891891892	0.1044776119402985	KEGG:05221	KEGG	Acute myeloid leukemia	8484	472		0.3026315789473684	0.3116883116883117	67	8417	7	30	60	8387	8484	0.13555413818627174
M1	cpdb	0	network_modules	78	TRUE	9.264210254109164e-7	105	37	8	0.21621621621621623	0.0761904761904762	KEGG:04928	KEGG	Parathyroid hormone synthesis, secretion and action	8484	385		0.3157894736842105	0.3246753246753247	105	8379	8	29	97	8350	8484	0.12202502212884435
M1	cpdb	0	network_modules	78	TRUE	9.641541115159016e-7	67	38	7	0.18421052631578946	0.1044776119402985	REAC:R-HSA-3371453	REAC	Regulation of HSF1-mediated heat shock response	10916	1977		0.3333333333333333	0.34146341463414637	67	10849	7	31	60	10818	10916	0.13475534497921876
M1	cpdb	0	network_modules	78	TRUE	1.0128869911793957e-6	68	37	7	0.1891891891891892	0.10294117647058823	KEGG:05211	KEGG	Renal cell carcinoma	8484	462		0.32894736842105265	0.33766233766233766	68	8416	7	30	61	8386	8484	0.13447423190378582
M1	cpdb	0	network_modules	78	TRUE	1.089218883976069e-6	211	37	10	0.2702702702702703	0.04739336492890995	KEGG:05207	KEGG	Chemical carcinogenesis - receptor activation	8484	459		0.34210526315789475	0.35064935064935066	211	8273	10	27	201	8246	8484	0.1042922321202216
M1	cpdb	0	network_modules	78	TRUE	1.1161133286962694e-6	197	39	9	0.23076923076923078	0.04568527918781726	GO:0018209	GO:BP	peptidyl-serine modification	16175	5368		0.42857142857142855	0.4375	197	15978	9	30	188	15948	16175	0.09797482650310796
M1	cpdb	0	network_modules	78	TRUE	1.2731738137514236e-6	376	39	11	0.28205128205128205	0.02925531914893617	GO:0043410	GO:BP	positive regulation of MAPK cascade	16175	10678		0.4444444444444444	0.453125	376	15799	11	28	365	15771	16175	0.08443907831494125
M1	cpdb	0	network_modules	78	TRUE	1.3122091253357286e-6	158	37	9	0.24324324324324326	0.056962025316455694	KEGG:05160	KEGG	Hepatitis C	8484	441		0.35526315789473684	0.36363636363636365	158	8326	9	28	149	8298	8484	0.1099643366683521
M1	cpdb	0	network_modules	78	TRUE	1.3311370751792332e-6	610	39	13	0.3333333333333333	0.021311475409836064	GO:0043066	GO:BP	negative regulation of apoptotic process	16175	10512		0.4603174603174603	0.46875	610	15565	13	26	597	15539	16175	0.07629115304460622
M1	cpdb	0	network_modules	78	TRUE	1.3478055694447868e-6	112	38	8	0.21052631578947367	0.07142857142857142	REAC:R-HSA-168188	REAC	Toll Like Receptor TLR6:TLR2 Cascade	10916	2521		0.345679012345679	0.36585365853658536	112	10804	8	30	104	10774	10916	0.11745920086983667
M1	cpdb	0	network_modules	78	TRUE	1.3478055694447868e-6	112	38	8	0.21052631578947367	0.07142857142857142	REAC:R-HSA-166058	REAC	MyD88:MAL(TIRAP) cascade initiated on plasma membrane	10916	1502		0.345679012345679	0.36585365853658536	112	10804	8	30	104	10774	10916	0.11745920086983667
M1	cpdb	0	network_modules	78	TRUE	1.4597651188922851e-6	71	38	7	0.18421052631578946	0.09859154929577464	REAC:R-HSA-448424	REAC	Interleukin-17 signaling	10916	1238		0.37037037037037035	0.3780487804878049	71	10845	7	31	64	10814	10916	0.13065911138379002
M1	cpdb	0	network_modules	78	TRUE	1.6642678739507665e-6	115	38	8	0.21052631578947367	0.06956521739130435	REAC:R-HSA-168179	REAC	Toll Like Receptor TLR1:TLR2 Cascade	10916	2520		0.38271604938271603	0.4024390243902439	115	10801	8	30	107	10771	10916	0.11577400161613353
M1	cpdb	0	network_modules	78	TRUE	1.6642678739507665e-6	115	38	8	0.21052631578947367	0.06956521739130435	REAC:R-HSA-181438	REAC	Toll Like Receptor 2 (TLR2) Cascade	10916	2514		0.38271604938271603	0.4024390243902439	115	10801	8	30	107	10771	10916	0.11577400161613353
M1	cpdb	0	network_modules	78	TRUE	1.9713478540913396e-6	630	39	13	0.3333333333333333	0.020634920634920634	GO:0043069	GO:BP	negative regulation of programmed cell death	16175	10515		0.47619047619047616	0.484375	630	15545	13	26	617	15519	16175	0.07480449803180467
M1	cpdb	0	network_modules	78	TRUE	2.227987475969721e-6	76	37	7	0.1891891891891892	0.09210526315789473	KEGG:05212	KEGG	Pancreatic cancer	8484	463		0.3684210526315789	0.38961038961038963	76	8408	7	30	69	8378	8484	0.1265980400777749
M1	cpdb	0	network_modules	78	TRUE	2.227987475969721e-6	76	37	7	0.1891891891891892	0.09210526315789473	KEGG:05220	KEGG	Chronic myeloid leukemia	8484	471		0.3684210526315789	0.38961038961038963	76	8408	7	30	69	8378	8484	0.1265980400777749
M1	cpdb	0	network_modules	78	TRUE	2.504053595797275e-6	49	39	6	0.15384615384615385	0.12244897959183673	GO:0034605	GO:BP	cellular response to heat	16175	8685		0.49206349206349204	0.5	49	16126	6	33	43	16093	16175	0.13491709093137558
M1	cpdb	0	network_modules	78	TRUE	2.6663681096514368e-6	120	37	8	0.21621621621621623	0.06666666666666667	KEGG:04935	KEGG	Growth hormone synthesis, secretion and action	8484	392		0.39473684210526316	0.4155844155844156	120	8364	8	29	112	8335	8484	0.11325533280985334
M1	cpdb	0	network_modules	78	TRUE	2.6663681096514368e-6	120	37	8	0.21621621621621623	0.06666666666666667	KEGG:04071	KEGG	Sphingolipid signaling pathway	8484	260		0.39473684210526316	0.4155844155844156	120	8364	8	29	112	8335	8484	0.11325533280985334
M1	cpdb	0	network_modules	78	TRUE	2.840533872523393e-6	50	39	6	0.15384615384615385	0.12	GO:0031098	GO:BP	stress-activated protein kinase signaling cascade	16175	7024		0.5079365079365079	0.515625	50	16125	6	33	44	16092	16175	0.13351049528105757
M1	cpdb	0	network_modules	78	TRUE	3.6615471019375427e-6	22	38	5	0.13157894736842105	0.22727272727272727	REAC:R-HSA-9613829	REAC	Chaperone Mediated Autophagy	10916	344		0.4074074074074074	0.4146341463414634	22	10894	5	33	17	10861	10916	0.17074918328382013
M1	cpdb	0	network_modules	78	TRUE	3.7176590027814105e-6	46	38	6	0.15789473684210525	0.13043478260869565	REAC:R-HSA-1227986	REAC	Signaling by ERBB2	10916	2232		0.41975308641975306	0.4268292682926829	46	10870	6	32	40	10838	10916	0.14021889829943637
M1	cpdb	0	network_modules	78	TRUE	5.273157742236729e-6	249	37	10	0.2702702702702703	0.040160642570281124	KEGG:05132	KEGG	Salmonella infection	8484	429		0.42105263157894735	0.42857142857142855	249	8235	10	27	239	8208	8484	0.09446986365546288
M1	cpdb	0	network_modules	78	TRUE	5.821803277409972e-6	26	39	5	0.1282051282051282	0.19230769230769232	GO:0051085	GO:BP	chaperone cofactor-dependent protein refolding	16175	13482		0.5238095238095238	0.53125	26	16149	5	34	21	16115	16175	0.15536207273127006
M1	cpdb	0	network_modules	78	TRUE	7.88249836295045e-6	168	39	8	0.20512820512820512	0.047619047619047616	GO:0031396	GO:BP	regulation of protein ubiquitination	16175	7152		0.5396825396825397	0.546875	168	16007	8	31	160	15976	16175	0.0944339663464025
M1	cpdb	0	network_modules	78	TRUE	9.331149700555077e-6	143	38	8	0.21052631578947367	0.055944055944055944	REAC:R-HSA-166016	REAC	Toll Like Receptor 4 (TLR4) Cascade	10916	2516		0.43209876543209874	0.43902439024390244	143	10773	8	30	135	10743	10916	0.1026241114624445
M1	cpdb	0	network_modules	78	TRUE	1.3011946675024585e-5	147	37	8	0.21621621621621623	0.05442176870748299	KEGG:05224	KEGG	Breast cancer	8484	475		0.4342105263157895	0.44155844155844154	147	8337	8	29	139	8308	8484	0.10087847927234263
M1	cpdb	0	network_modules	78	TRUE	1.3173817705799631e-5	59	37	6	0.16216216216216217	0.1016949152542373	KEGG:04370	KEGG	VEGF signaling pathway	8484	307		0.4473684210526316	0.45454545454545453	59	8425	6	31	53	8394	8484	0.12360986266418682
M1	cpdb	0	network_modules	78	TRUE	1.3453178191996574e-5	472	38	12	0.3157894736842105	0.025423728813559324	REAC:R-HSA-449147	REAC	Signaling by Interleukins	10916	2261		0.4444444444444444	0.45121951219512196	472	10444	12	26	460	10418	10916	0.07919957650001695
M1	cpdb	0	network_modules	78	TRUE	1.3713264674167996e-5	148	37	8	0.21621621621621623	0.05405405405405406	KEGG:05226	KEGG	Gastric cancer	8484	477		0.4605263157894737	0.4675324675324675	148	8336	8	29	140	8307	8484	0.10048354066976191
M1	cpdb	0	network_modules	78	TRUE	1.4906534955832666e-5	31	39	5	0.1282051282051282	0.16129032258064516	GO:0051084	GO:BP	'de novo' post-translational protein folding	16175	13481		0.5555555555555556	0.5625	31	16144	5	34	26	16110	16175	0.14195684693198787
M1	cpdb	0	network_modules	78	TRUE	1.510542506278674e-5	11	38	4	0.10526315789473684	0.36363636363636365	REAC:R-HSA-170968	REAC	Frs2-mediated activation	10916	980		0.4567901234567901	0.4634146341463415	11	10905	4	34	7	10871	10916	0.19420948691862297
M1	cpdb	0	network_modules	78	TRUE	1.5389229248681905e-5	210	37	9	0.24324324324324326	0.04285714285714286	KEGG:04015	KEGG	Rap1 signaling pathway	8484	248		0.47368421052631576	0.4805194805194805	210	8274	9	28	201	8246	8484	0.09307133863386183
M1	cpdb	0	network_modules	78	TRUE	2.007782074736503e-5	103	38	7	0.18421052631578946	0.06796116504854369	REAC:R-HSA-168164	REAC	Toll Like Receptor 3 (TLR3) Cascade	10916	2515		0.4691358024691358	0.47560975609756095	103	10813	7	31	96	10782	10916	0.10684839096118265
M1	cpdb	0	network_modules	78	TRUE	2.2619912239032538e-5	106	37	7	0.1891891891891892	0.0660377358490566	KEGG:04620	KEGG	Toll-like receptor signaling pathway	8484	325		0.4868421052631579	0.4935064935064935	106	8378	7	30	99	8348	8484	0.1052813942120453
M1	cpdb	0	network_modules	78	TRUE	2.3775538125669417e-5	221	37	9	0.24324324324324326	0.04072398190045249	KEGG:05208	KEGG	Chemical carcinogenesis - reactive oxygen species	8484	460		0.5	0.5064935064935064	221	8263	9	28	212	8235	8484	0.09024715184522529
M1	cpdb	0	network_modules	78	TRUE	2.5719869297050727e-5	108	37	7	0.1891891891891892	0.06481481481481481	KEGG:05145	KEGG	Toxoplasmosis	8484	437		0.5131578947368421	0.5194805194805194	108	8376	7	30	101	8346	8484	0.10417529165148838
M1	cpdb	0	network_modules	78	TRUE	2.616096554233573e-5	107	38	7	0.18421052631578946	0.06542056074766354	REAC:R-HSA-937061	REAC	TRIF (TICAM1)-mediated TLR4 signaling 	10916	2471		0.48148148148148145	0.5	107	10809	7	31	100	10778	10916	0.10463176496880996
M1	cpdb	0	network_modules	78	TRUE	2.616096554233573e-5	107	38	7	0.18421052631578946	0.06542056074766354	REAC:R-HSA-166166	REAC	MyD88-independent TLR4 cascade 	10916	1501		0.48148148148148145	0.5	107	10809	7	31	100	10778	10916	0.10463176496880996
M1	cpdb	0	network_modules	78	TRUE	2.7212478121408004e-5	164	38	8	0.21052631578947367	0.04878048780487805	REAC:R-HSA-168898	REAC	Toll-like Receptor Cascades	10916	2522		0.5061728395061729	0.5121951219512195	164	10752	8	30	156	10722	10916	0.09498752155269077
M1	cpdb	0	network_modules	78	TRUE	2.767756410713475e-5	638	39	12	0.3076923076923077	0.018808777429467086	GO:0018193	GO:BP	peptidyl-amino acid modification	16175	5353		0.5714285714285714	0.578125	638	15537	12	27	626	15510	16175	0.06775204205620743
M1	cpdb	0	network_modules	78	TRUE	2.828132443993121e-5	35	39	5	0.1282051282051282	0.14285714285714285	GO:0006458	GO:BP	'de novo' protein folding	16175	2204		0.5873015873015873	0.59375	35	16140	5	34	30	16106	16175	0.13335389957254448
M1	cpdb	0	network_modules	78	TRUE	2.8452996064073915e-5	67	37	6	0.16216216216216217	0.08955223880597014	KEGG:04664	KEGG	Fc epsilon RI signaling pathway	8484	340		0.5263157894736842	0.5454545454545454	67	8417	6	31	61	8386	8484	0.11534571230684441
M1	cpdb	0	network_modules	78	TRUE	2.8452996064073915e-5	67	37	6	0.16216216216216217	0.08955223880597014	KEGG:04720	KEGG	Long-term potentiation	8484	350		0.5263157894736842	0.5454545454545454	67	8417	6	31	61	8386	8484	0.11534571230684441
M1	cpdb	0	network_modules	78	TRUE	3.169243585940992e-5	165	37	8	0.21621621621621623	0.048484848484848485	KEGG:04140	KEGG	Autophagy - animal	8484	277		0.5526315789473685	0.5584415584415584	165	8319	8	29	157	8290	8484	0.09430329445723051
M1	cpdb	0	network_modules	78	TRUE	3.319479379287647e-5	166	37	8	0.21621621621621623	0.04819277108433735	KEGG:05225	KEGG	Hepatocellular carcinoma	8484	476		0.5657894736842105	0.5714285714285714	166	8318	8	29	158	8289	8484	0.09396814763083089
M1	cpdb	0	network_modules	78	TRUE	3.39641807328973e-5	69	37	6	0.16216216216216217	0.08695652173913043	KEGG:04612	KEGG	Antigen processing and presentation	8484	322		0.5789473684210527	0.5844155844155844	69	8415	6	31	63	8384	8484	0.11350153787351168
M1	cpdb	0	network_modules	78	TRUE	3.4288676477234975e-5	66	38	6	0.15789473684210525	0.09090909090909091	REAC:R-HSA-9824439	REAC	Bacterial Infection Pathways	10916	204		0.5185185185185185	0.524390243902439	66	10850	6	32	60	10818	10916	0.11577229868857265
M1	cpdb	0	network_modules	78	TRUE	3.507272117326365e-5	113	37	7	0.1891891891891892	0.061946902654867256	KEGG:04668	KEGG	TNF signaling pathway	8484	342		0.5921052631578947	0.5974025974025974	113	8371	7	30	106	8341	8484	0.10153461957961714
M1	cpdb	0	network_modules	78	TRUE	3.638355000707557e-5	168	37	8	0.21621621621621623	0.047619047619047616	KEGG:04141	KEGG	Protein processing in endoplasmic reticulum	8484	278		0.6052631578947368	0.6103896103896104	168	8316	8	29	160	8287	8484	0.09330638326416463
M1	cpdb	0	network_modules	78	TRUE	3.64565196899699e-5	519	39	11	0.28205128205128205	0.02119460500963391	GO:0070848	GO:BP	response to growth factor	16175	16340		0.6031746031746031	0.609375	519	15656	11	28	508	15628	16175	0.0697321887255099
M1	cpdb	0	network_modules	78	TRUE	3.7031629823946914e-5	70	37	6	0.16216216216216217	0.08571428571428572	KEGG:05230	KEGG	Central carbon metabolism in cancer	8484	478		0.618421052631579	0.6233766233766234	70	8414	6	31	64	8383	8484	0.11260835440838869
M1	cpdb	0	network_modules	78	TRUE	3.8951952486579247e-5	206	39	8	0.20512820512820512	0.038834951456310676	GO:1903320	GO:BP	regulation of protein modification by small protein conjugation or removal	16175	22904		0.6190476190476191	0.625	206	15969	8	31	198	15938	16175	0.08435179366083428
M1	cpdb	0	network_modules	78	TRUE	4.359057394534063e-5	209	39	8	0.20512820512820512	0.03827751196172249	GO:1901873	GO:BP	regulation of post-translational protein modification	16175	21817		0.6349206349206349	0.640625	209	15966	8	31	201	15935	16175	0.08367133798189685
M1	cpdb	0	network_modules	78	TRUE	4.547807870741615e-5	14	38	4	0.10526315789473684	0.2857142857142857	REAC:R-HSA-169893	REAC	Prolonged ERK activation events	10916	1807		0.5308641975308642	0.5487804878048781	14	10902	4	34	10	10868	10916	0.1717181355006958
M1	cpdb	0	network_modules	78	TRUE	4.547807870741615e-5	14	38	4	0.10526315789473684	0.2857142857142857	REAC:R-HSA-1295596	REAC	Spry regulation of FGF signaling	10916	2350		0.5308641975308642	0.5487804878048781	14	10902	4	34	10	10868	10916	0.1717181355006958
M1	cpdb	0	network_modules	78	TRUE	4.992850017477273e-5	119	37	7	0.1891891891891892	0.058823529411764705	KEGG:04660	KEGG	T cell receptor signaling pathway	8484	338		0.631578947368421	0.6363636363636364	119	8365	7	30	112	8335	8484	0.09857928569169627
M1	cpdb	0	network_modules	78	TRUE	5.494509370962863e-5	81	39	6	0.15384615384615385	0.07407407407407407	GO:0033138	GO:BP	positive regulation of peptidyl-serine phosphorylation	16175	8053		0.6507936507936508	0.65625	81	16094	6	33	75	16061	16175	0.10366191094896236
M1	cpdb	0	network_modules	78	TRUE	5.7955665489984635e-5	4	38	3	0.07894736842105263	0.75	REAC:R-HSA-9652169	REAC	Signaling by MAP2K mutants	10916	2268		0.5555555555555556	0.5609756097560976	4	10912	3	35	1	10877	10916	0.24266984305761174
M1	cpdb	0	network_modules	78	TRUE	6.311836277404102e-5	73	38	6	0.15789473684210525	0.0821917808219178	REAC:R-HSA-9009391	REAC	Extra-nuclear estrogen signaling	10916	888		0.5679012345679012	0.573170731707317	73	10843	6	32	67	10811	10916	0.10965221618313979
M1	cpdb	0	network_modules	78	TRUE	7.610672052015826e-5	4	39	3	0.07692307692307693	0.75	GO:0090170	GO:BP	regulation of Golgi inheritance	16175	18078		0.6666666666666666	0.671875	4	16171	3	36	1	16135	16175	0.23973885586857743
M1	cpdb	0	network_modules	78	TRUE	9.282218118666684e-5	190	37	8	0.21621621621621623	0.042105263157894736	KEGG:04062	KEGG	Chemokine signaling pathway	8484	255		0.6447368421052632	0.6493506493506493	190	8294	8	29	182	8265	8484	0.08669470170546789
M1	cpdb	0	network_modules	78	TRUE	1.0458680096548491e-4	45	39	5	0.1282051282051282	0.1111111111111111	GO:0051403	GO:BP	stress-activated MAPK cascade	16175	13696		0.6825396825396826	0.6875	45	16130	5	34	40	16096	16175	0.11706648859192435
M1	cpdb	0	network_modules	78	TRUE	1.0732336674997708e-4	17	38	4	0.10526315789473684	0.23529411764705882	REAC:R-HSA-5637815	REAC	Signaling by Ligand-Responsive EGFR Variants in Cancer	10916	2267		0.5802469135802469	0.5975609756097561	17	10899	4	34	13	10865	10916	0.15544118652808794
M1	cpdb	0	network_modules	78	TRUE	1.0732336674997708e-4	17	38	4	0.10526315789473684	0.23529411764705882	REAC:R-HSA-1236382	REAC	Constitutive Signaling by Ligand-Responsive EGFR Cancer Variants	10916	403		0.5802469135802469	0.5975609756097561	17	10899	4	34	13	10865	10916	0.15544118652808794
M1	cpdb	0	network_modules	78	TRUE	1.2335798226296177e-4	136	37	7	0.1891891891891892	0.051470588235294115	KEGG:05135	KEGG	Yersinia infection	8484	432		0.6578947368421053	0.6623376623376623	136	8348	7	30	129	8318	8484	0.09125038520424669
M1	cpdb	0	network_modules	78	TRUE	1.36094249094049e-4	138	37	7	0.1891891891891892	0.050724637681159424	KEGG:05418	KEGG	Fluid shear stress and atherosclerosis	8484	495		0.6710526315789473	0.6753246753246753	138	8346	7	30	131	8316	8484	0.09047425136281655
M1	cpdb	0	network_modules	78	TRUE	1.446300605377378e-4	88	37	6	0.16216216216216217	0.06818181818181818	KEGG:04540	KEGG	Gap junction	8484	318		0.6842105263157895	0.6883116883116883	88	8396	6	31	82	8365	8484	0.09915509065080007
M1	cpdb	0	network_modules	78	TRUE	1.4474333205749833e-4	356	37	10	0.2702702702702703	0.028089887640449437	KEGG:04151	KEGG	PI3K-Akt signaling pathway	8484	285		0.6973684210526315	0.7012987012987013	356	8128	10	27	346	8101	8484	0.07536267917948503
M1	cpdb	0	network_modules	78	TRUE	1.6457673821019034e-4	205	37	8	0.21621621621621623	0.03902439024390244	KEGG:05205	KEGG	Proteoglycans in cancer	8484	457		0.7105263157894737	0.7142857142857143	205	8279	8	29	197	8250	8484	0.0827762393972012
M1	cpdb	0	network_modules	78	TRUE	1.800130022219147e-4	290	38	9	0.23684210526315788	0.03103448275862069	REAC:R-HSA-9006931	REAC	Signaling by Nuclear Receptors	10916	2289		0.6049382716049383	0.6097560975609756	290	10626	9	29	281	10597	10916	0.07728331968112893
M1	cpdb	0	network_modules	78	TRUE	1.9716877377209965e-4	210	37	8	0.21621621621621623	0.0380952380952381	KEGG:05170	KEGG	Human immunodeficiency virus 1 infection	8484	451		0.7236842105263158	0.7272727272727273	210	8274	8	29	202	8245	8484	0.08155853373242883
M1	cpdb	0	network_modules	78	TRUE	2.0273939669930173e-4	255	39	8	0.20512820512820512	0.03137254901960784	GO:0070371	GO:BP	ERK1 and ERK2 cascade	16175	16082		0.6984126984126984	0.703125	255	15920	8	31	247	15889	16175	0.07473644994632284
M1	cpdb	0	network_modules	78	TRUE	2.1685063260297007e-4	20	38	4	0.10526315789473684	0.2	REAC:R-HSA-445144	REAC	Signal transduction by L1	10916	2216		0.6172839506172839	0.6219512195121951	20	10896	4	34	16	10862	10916	0.14294958974127753
M1	cpdb	0	network_modules	78	TRUE	2.1973077041516923e-4	102	39	6	0.15384615384615385	0.058823529411764705	GO:0033135	GO:BP	regulation of peptidyl-serine phosphorylation	16175	8051		0.7142857142857143	0.71875	102	16073	6	33	96	16040	16175	0.09163053918430242
M1	cpdb	0	network_modules	78	TRUE	2.2605061600843626e-4	216	38	8	0.21052631578947367	0.037037037037037035	REAC:R-HSA-8939211	REAC	ESR-mediated signaling	10916	830		0.6296296296296297	0.6341463414634146	216	10700	8	30	208	10670	10916	0.08094708028599601
M1	cpdb	0	network_modules	78	TRUE	2.5993948808745223e-4	175	39	7	0.1794871794871795	0.04	GO:0070374	GO:BP	positive regulation of ERK1 and ERK2 cascade	16175	16085		0.7301587301587301	0.734375	175	16000	7	32	168	15968	16175	0.08015532256646121
M1	cpdb	0	network_modules	78	TRUE	2.7221418135341135e-4	98	37	6	0.16216216216216217	0.061224489795918366	KEGG:05231	KEGG	Choline metabolism in cancer	8484	479		0.7368421052631579	0.7402597402597403	98	8386	6	31	92	8355	8484	0.09328601050334177
M1	cpdb	0	network_modules	78	TRUE	3.15470138379722e-4	502	39	10	0.2564102564102564	0.0199203187250996	GO:0071363	GO:BP	cellular response to growth factor stimulus	16175	16615		0.746031746031746	0.75	502	15673	10	29	492	15644	16175	0.06389338562140216
M1	cpdb	0	network_modules	78	TRUE	3.5231383585637347e-4	227	37	8	0.21621621621621623	0.03524229074889868	KEGG:04810	KEGG	Regulation of actin cytoskeleton	8484	365		0.75	0.7532467532467533	227	8257	8	29	219	8228	8484	0.07770405196673992
M1	cpdb	0	network_modules	78	TRUE	3.635120073262838e-4	23	39	4	0.10256410256410256	0.17391304347826086	GO:0051131	GO:BP	chaperone-mediated protein complex assembly	16175	13515		0.7619047619047619	0.765625	23	16152	4	35	19	16117	16175	0.13195740990793545
M1	cpdb	0	network_modules	78	TRUE	3.9337371975215515e-4	23	38	4	0.10526315789473684	0.17391304347826086	REAC:R-HSA-450302	REAC	activated TAK1 mediates p38 MAPK activation	10916	2685		0.6419753086419753	0.6707317073170732	23	10893	4	34	19	10859	10916	0.13296529183690892
M1	cpdb	0	network_modules	78	TRUE	3.9337371975215515e-4	23	38	4	0.10526315789473684	0.17391304347826086	REAC:R-HSA-1643713	REAC	Signaling by EGFR in Cancer	10916	2230		0.6419753086419753	0.6707317073170732	23	10893	4	34	19	10859	10916	0.13296529183690892
M1	cpdb	0	network_modules	78	TRUE	3.9337371975215515e-4	23	38	4	0.10526315789473684	0.17391304347826086	REAC:R-HSA-5654732	REAC	Negative regulation of FGFR3 signaling	10916	1570		0.6419753086419753	0.6707317073170732	23	10893	4	34	19	10859	10916	0.13296529183690892
M1	cpdb	0	network_modules	78	TRUE	5.329612843396117e-4	57	38	5	0.13157894736842105	0.08771929824561403	REAC:R-HSA-3371497	REAC	HSP90 chaperone cycle for steroid hormone receptors (SHR) in the presence of ligand	10916	1111		0.6790123456790124	0.6829268292682927	57	10859	5	33	52	10826	10916	0.10362120406224992
M1	cpdb	0	network_modules	78	TRUE	5.591659335957334e-4	25	38	4	0.10526315789473684	0.16	REAC:R-HSA-5339562	REAC	Uptake and actions of bacterial toxins	10916	2626		0.691358024691358	0.6951219512195121	25	10891	4	34	21	10857	10916	0.12732099807476066
M1	cpdb	0	network_modules	78	TRUE	6.591862214750699e-4	26	38	4	0.10526315789473684	0.15384615384615385	REAC:R-HSA-5654726	REAC	Negative regulation of FGFR1 signaling	10916	1568		0.7037037037037037	0.7073170731707317	26	10890	4	34	22	10856	10916	0.12474316735928408
M1	cpdb	0	network_modules	78	TRUE	7.600613636314507e-4	701	39	11	0.28205128205128205	0.015691868758915834	GO:0009628	GO:BP	response to abiotic stimulus	16175	3549		0.7777777777777778	0.78125	701	15474	11	28	690	15446	16175	0.05763602830487174
M1	cpdb	0	network_modules	78	TRUE	7.718996257776626e-4	27	38	4	0.10526315789473684	0.14814814814814814	REAC:R-HSA-5654733	REAC	Negative regulation of FGFR4 signaling	10916	1571		0.7160493827160493	0.7195121951219512	27	10889	4	34	23	10855	10916	0.12230793076194232
M1	cpdb	0	network_modules	78	TRUE	8.036024083707461e-4	8	38	3	0.07894736842105263	0.375	REAC:R-HSA-9660537	REAC	Signaling by MRAS-complex mutants	10916	2271		0.7283950617283951	0.7560975609756098	8	10908	3	35	5	10873	10916	0.17082463799286546
M1	cpdb	0	network_modules	78	TRUE	8.036024083707461e-4	8	38	3	0.07894736842105263	0.375	REAC:R-HSA-9726840	REAC	SHOC2 M1731 mutant abolishes MRAS complex function	10916	2141		0.7283950617283951	0.7560975609756098	8	10908	3	35	5	10873	10916	0.17082463799286546
M1	cpdb	0	network_modules	78	TRUE	8.036024083707461e-4	8	38	3	0.07894736842105263	0.375	REAC:R-HSA-9726842	REAC	Gain-of-function MRAS complexes activate RAF signaling	10916	1028		0.7283950617283951	0.7560975609756098	8	10908	3	35	5	10873	10916	0.17082463799286546
M1	cpdb	0	network_modules	78	TRUE	8.039368441909112e-4	112	38	6	0.15789473684210525	0.05357142857142857	REAC:R-HSA-187037	REAC	Signaling by NTRK1 (TRKA)	10916	2284		0.7654320987654321	0.7682926829268293	112	10804	6	32	106	10772	10916	0.08658996366126731
M1	cpdb	0	network_modules	78	TRUE	8.983062750721524e-4	28	38	4	0.10526315789473684	0.14285714285714285	REAC:R-HSA-5654727	REAC	Negative regulation of FGFR2 signaling	10916	1569		0.7777777777777778	0.7804878048780488	28	10888	4	34	24	10854	10916	0.12000247458747305
M1	cpdb	0	network_modules	78	TRUE	9.024209572849104e-4	70	37	5	0.13513513513513514	0.07142857142857142	KEGG:04917	KEGG	Prolactin signaling pathway	8484	374		0.7631578947368421	0.7662337662337663	70	8414	5	32	65	8382	8484	0.09283418379943953
M1	cpdb	0	network_modules	78	TRUE	0.0010567228316774237	188	37	7	0.1891891891891892	0.03723404255319149	KEGG:04613	KEGG	Neutrophil extracellular trap formation	8484	323		0.7763157894736842	0.7792207792207793	188	8296	7	30	181	8266	8484	0.07509845780692888
M1	cpdb	0	network_modules	78	TRUE	0.0010639787454964067	124	37	6	0.16216216216216217	0.04838709677419355	KEGG:04650	KEGG	Natural killer cell mediated cytotoxicity	8484	334		0.7894736842105263	0.7922077922077922	124	8360	6	31	118	8329	8484	0.08137011969356645
M1	cpdb	0	network_modules	78	TRUE	0.0013701840052099843	31	38	4	0.10526315789473684	0.12903225806451613	REAC:R-HSA-5675482	REAC	Regulation of necroptotic cell death	10916	2045		0.7901234567901234	0.8170731707317073	31	10885	4	34	27	10851	10916	0.11375865682944551
M1	cpdb	0	network_modules	78	TRUE	0.0013701840052099843	31	38	4	0.10526315789473684	0.12903225806451613	REAC:R-HSA-187687	REAC	Signalling to ERKs	10916	2331		0.7901234567901234	0.8170731707317073	31	10885	4	34	27	10851	10916	0.11375865682944551
M1	cpdb	0	network_modules	78	TRUE	0.0013701840052099843	31	38	4	0.10526315789473684	0.12903225806451613	REAC:R-HSA-5213460	REAC	RIPK1-mediated regulated necrosis	10916	1877		0.7901234567901234	0.8170731707317073	31	10885	4	34	27	10851	10916	0.11375865682944551
M1	cpdb	0	network_modules	78	TRUE	0.0014012683973525651	37	37	4	0.10810810810810811	0.10810810810810811	KEGG:05216	KEGG	Thyroid cancer	8484	467		0.8026315789473685	0.8051948051948052	37	8447	4	33	33	8414	8484	0.10420139566582093
M1	cpdb	0	network_modules	78	TRUE	0.0014990172146893447	595	39	10	0.2564102564102564	0.01680672268907563	GO:0051248	GO:BP	negative regulation of protein metabolic process	16175	13595		0.7936507936507936	0.796875	595	15580	10	29	585	15551	16175	0.05736122286564504
M1	cpdb	0	network_modules	78	TRUE	0.0015620242922144971	32	38	4	0.10526315789473684	0.125	REAC:R-HSA-5654741	REAC	Signaling by FGFR3	10916	2249		0.8271604938271605	0.8292682926829268	32	10884	4	34	28	10850	10916	0.11187206416538588
M1	cpdb	0	network_modules	78	TRUE	0.0015880041730406236	133	37	6	0.16216216216216217	0.045112781954887216	KEGG:04270	KEGG	Vascular smooth muscle contraction	8484	298		0.8157894736842105	0.8181818181818182	133	8351	6	31	127	8320	8484	0.07804590670446414
M1	cpdb	0	network_modules	78	TRUE	0.0016854376211167567	202	37	7	0.1891891891891892	0.034653465346534656	KEGG:04510	KEGG	Focal adhesion	8484	313		0.8289473684210527	0.8311688311688312	202	8282	7	30	195	8252	8484	0.07179415458963213
M1	cpdb	0	network_modules	78	TRUE	0.0017137349333916979	10	38	3	0.07894736842105263	0.3	REAC:R-HSA-937042	REAC	IRAK2 mediated activation of TAK1 complex	10916	1156		0.8395061728395061	0.8414634146341463	10	10906	3	35	7	10871	10916	0.15244626667643107
M1	cpdb	0	network_modules	78	TRUE	0.001728829103826597	135	37	6	0.16216216216216217	0.044444444444444446	KEGG:04210	KEGG	Apoptosis	8484	287		0.8421052631578947	0.8441558441558441	135	8349	6	31	129	8318	8484	0.07735022994024401
M1	cpdb	0	network_modules	78	TRUE	0.0018452926567586244	81	37	5	0.13513513513513514	0.06172839506172839	KEGG:04662	KEGG	B cell receptor signaling pathway	8484	339		0.8552631578947368	0.8571428571428571	81	8403	5	32	76	8371	8484	0.08547475599335551
M1	cpdb	0	network_modules	78	TRUE	0.002001751701537308	131	38	6	0.15789473684210525	0.04580152671755725	REAC:R-HSA-166520	REAC	Signaling by NTRKs	10916	2287		0.8518518518518519	0.8536585365853658	131	10785	6	32	125	10753	10916	0.07919039676843755
M1	cpdb	0	network_modules	78	TRUE	0.0020507384929418756	346	39	8	0.20512820512820512	0.023121387283236993	GO:0043254	GO:BP	regulation of protein-containing complex assembly	16175	10588		0.8095238095238095	0.8125	346	15829	8	31	338	15798	16175	0.06243252262307675
M1	cpdb	0	network_modules	78	TRUE	0.0021292310266770582	239	39	7	0.1794871794871795	0.029288702928870293	GO:0070372	GO:BP	regulation of ERK1 and ERK2 cascade	16175	16083		0.8253968253968254	0.828125	239	15936	7	32	232	15904	16175	0.06711404423452806
M1	cpdb	0	network_modules	78	TRUE	0.0021517292516834963	382	37	9	0.24324324324324326	0.02356020942408377	KEGG:05010	KEGG	Alzheimer disease	8484	411		0.868421052631579	0.8701298701298701	382	8102	9	28	373	8074	8484	0.06326507926543924
M1	cpdb	0	network_modules	78	TRUE	0.0022574532455186406	35	38	4	0.10526315789473684	0.11428571428571428	REAC:R-HSA-5654743	REAC	Signaling by FGFR4	10916	2252		0.8641975308641975	0.8658536585365854	35	10881	4	34	31	10847	10916	0.10669757588672961
M1	cpdb	0	network_modules	78	TRUE	0.0023032300104233747	142	37	6	0.16216216216216217	0.04225352112676056	KEGG:04936	KEGG	Alcoholic liver disease	8484	393		0.881578947368421	0.8831168831168831	142	8342	6	31	136	8311	8484	0.07502558799677836
M1	cpdb	0	network_modules	78	TRUE	0.0023251882232344697	83	39	5	0.1282051282051282	0.060240963855421686	GO:0043535	GO:BP	regulation of blood vessel endothelial cell migration	16175	10756		0.8412698412698413	0.84375	83	16092	5	34	78	16058	16175	0.08468374094306746
M1	cpdb	0	network_modules	78	TRUE	0.002350720999015044	11	38	3	0.07894736842105263	0.2727272727272727	REAC:R-HSA-9645460	REAC	Alpha-protein kinase 1 signaling pathway	10916	135		0.8765432098765432	0.8902439024390244	11	10905	3	35	8	10870	10916	0.14518782574293762
M1	cpdb	0	network_modules	78	TRUE	0.002350720999015044	11	38	3	0.07894736842105263	0.2727272727272727	REAC:R-HSA-9014325	REAC	TICAM1,TRAF6-dependent induction of TAK1 complex	10916	2441		0.8765432098765432	0.8902439024390244	11	10905	3	35	8	10870	10916	0.14518782574293762
M1	cpdb	0	network_modules	78	TRUE	0.0024672998845242677	790	39	11	0.28205128205128205	0.013924050632911392	GO:0007167	GO:BP	enzyme-linked receptor protein signaling pathway	16175	2731		0.8571428571428571	0.859375	790	15385	11	28	779	15357	16175	0.05319421619671382
M1	cpdb	0	network_modules	78	TRUE	0.0028006840864740266	147	37	6	0.16216216216216217	0.04081632653061224	KEGG:04072	KEGG	Phospholipase D signaling pathway	8484	261		0.8947368421052632	0.8961038961038961	147	8337	6	31	141	8306	8484	0.07346179200290003
M1	cpdb	0	network_modules	78	TRUE	0.0031267607755353184	12	38	3	0.07894736842105263	0.25	REAC:R-HSA-3371511	REAC	HSF1 activation	10916	1109		0.9012345679012346	0.9024390243902439	12	10904	3	35	9	10869	10916	0.13884974094882474
M1	cpdb	0	network_modules	78	TRUE	0.0036388147663013403	154	37	6	0.16216216216216217	0.03896103896103896	KEGG:04921	KEGG	Oxytocin signaling pathway	8484	378		0.9078947368421053	0.9090909090909091	154	8330	6	31	148	8299	8484	0.07139390063257775
M1	cpdb	0	network_modules	78	TRUE	0.003773421461139612	155	37	6	0.16216216216216217	0.03870967741935484	KEGG:04150	KEGG	mTOR signaling pathway	8484	284		0.9210526315789473	0.935064935064935	155	8329	6	31	149	8298	8484	0.07110924810742761
M1	cpdb	0	network_modules	78	TRUE	0.003773421461139612	155	37	6	0.16216216216216217	0.03870967741935484	KEGG:04218	KEGG	Cellular senescence	8484	295		0.9210526315789473	0.935064935064935	155	8329	6	31	149	8298	8484	0.07110924810742761
M1	cpdb	0	network_modules	78	TRUE	0.004055019359284281	13	38	3	0.07894736842105263	0.23076923076923078	REAC:R-HSA-5637812	REAC	Signaling by EGFRvIII in Cancer	10916	2231		0.9135802469135802	0.926829268292683	13	10903	3	35	10	10868	10916	0.13325164338745266
M1	cpdb	0	network_modules	78	TRUE	0.004055019359284281	13	38	3	0.07894736842105263	0.23076923076923078	REAC:R-HSA-5637810	REAC	Constitutive Signaling by EGFRvIII	10916	402		0.9135802469135802	0.926829268292683	13	10903	3	35	10	10868	10916	0.13325164338745266
M1	cpdb	0	network_modules	78	TRUE	0.004742265321259507	42	38	4	0.10526315789473684	0.09523809523809523	REAC:R-HSA-5654736	REAC	Signaling by FGFR1	10916	2241		0.9382716049382716	0.9390243902439024	42	10874	4	34	38	10840	10916	0.09682025679227425
M1	cpdb	0	network_modules	78	TRUE	0.005148530617623446	14	38	3	0.07894736842105263	0.21428571428571427	REAC:R-HSA-3371568	REAC	Attenuation phase	10916	189		0.9506172839506173	0.9634146341463414	14	10902	3	35	11	10867	10916	0.12825909888923342
M1	cpdb	0	network_modules	78	TRUE	0.005148530617623446	14	38	3	0.07894736842105263	0.21428571428571427	REAC:R-HSA-9665348	REAC	Signaling by ERBB2 ECD mutants	10916	2233		0.9506172839506173	0.9634146341463414	14	10902	3	35	11	10867	10916	0.12825909888923342
M1	cpdb	0	network_modules	78	TRUE	0.0051741233632978945	164	37	6	0.16216216216216217	0.036585365853658534	KEGG:04022	KEGG	cGMP-PKG signaling pathway	8484	251		0.9473684210526315	0.948051948051948	164	8320	6	31	158	8289	8484	0.06865800250971794
M1	cpdb	0	network_modules	78	TRUE	0.005311567049129589	330	37	8	0.21621621621621623	0.024242424242424242	KEGG:05165	KEGG	Human papillomavirus infection	8484	446		0.9605263157894737	0.961038961038961	330	8154	8	29	322	8125	8484	0.060696601422768164
M1	cpdb	0	network_modules	78	TRUE	0.005944386887851841	246	37	7	0.1891891891891892	0.028455284552845527	KEGG:05131	KEGG	Shigellosis	8484	428		0.9736842105263158	0.974025974025974	246	8238	7	30	239	8208	8484	0.06318537023033177
M1	cpdb	0	network_modules	78	TRUE	0.006179632180297151	180	39	6	0.15384615384615385	0.03333333333333333	GO:0046777	GO:BP	protein autophosphorylation	16175	12365		0.873015873015873	0.875	180	15995	6	33	174	15962	16175	0.06688498426987709
M1	cpdb	0	network_modules	78	TRUE	0.006420198016733701	15	38	3	0.07894736842105263	0.2	REAC:R-HSA-937072	REAC	TRAF6-mediated induction of TAK1 complex within TLR4 complex	10916	2469		0.9753086419753086	0.9878048780487805	15	10901	3	35	12	10866	10916	0.12376958149364892
M1	cpdb	0	network_modules	78	TRUE	0.006420198016733701	15	38	3	0.07894736842105263	0.2	REAC:R-HSA-975163	REAC	IRAK2 mediated activation of TAK1 complex upon TLR7/8 or 9 stimulation	10916	1157		0.9753086419753086	0.9878048780487805	15	10901	3	35	12	10866	10916	0.12376958149364892
M1	cpdb	0	network_modules	78	TRUE	0.006451689828667881	102	39	5	0.1282051282051282	0.049019607843137254	GO:0043534	GO:BP	blood vessel endothelial cell migration	16175	10755		0.8888888888888888	0.890625	102	16073	5	34	97	16039	16175	0.07570605092461001
M1	cpdb	0	network_modules	78	TRUE	0.007232318829572709	551	39	9	0.23076923076923078	0.016333938294010888	GO:1902532	GO:BP	negative regulation of intracellular signal transduction	16175	22341		0.9047619047619048	0.90625	551	15624	9	30	542	15594	16175	0.05331146588477779
M1	cpdb	0	network_modules	78	TRUE	0.007703328077286462	109	37	5	0.13513513513513514	0.045871559633027525	KEGG:04066	KEGG	HIF-1 signaling pathway	8484	257		0.9868421052631579	0.987012987012987	109	8375	5	32	104	8343	8484	0.07186648545935849
M1	cpdb	0	network_modules	78	TRUE	0.008162653469891408	107	39	5	0.1282051282051282	0.04672897196261682	GO:0034614	GO:BP	cellular response to reactive oxygen species	16175	8691		0.9206349206349206	0.921875	107	16068	5	34	102	16034	16175	0.07374008634652536
M1	cpdb	0	network_modules	78	TRUE	0.00833062456873419	2	39	2	0.05128205128205128	1	GO:1902949	GO:BP	positive regulation of tau-protein kinase activity	16175	22637		0.9365079365079365	0.9375	2	16173	2	37	0	16136	16175	0.22619622029119613
M1	cpdb	0	network_modules	78	TRUE	0.00849952942409849	15	39	3	0.07692307692307693	0.2	GO:1904031	GO:BP	positive regulation of cyclin-dependent protein kinase activity	16175	23472		0.9523809523809523	0.953125	15	16160	3	36	12	16124	16175	0.12274434022930093
M1	cpdb	0	network_modules	78	TRUE	0.008762465917893201	112	37	5	0.13513513513513514	0.044642857142857144	KEGG:04726	KEGG	Serotonergic synapse	8484	356		1	1	112	8372	5	32	107	8340	8484	0.07070511217393899
M1	cpdb	0	network_modules	78	TRUE	0.008960913928331517	297	39	7	0.1794871794871795	0.02356902356902357	GO:0031647	GO:BP	regulation of protein stability	16175	7257		0.9682539682539683	0.96875	297	15878	7	32	290	15846	16175	0.059002013479188445
M1	cpdb	0	network_modules	78	TRUE	0.009022295775055783	50	39	4	0.10256410256410256	0.08	GO:0043536	GO:BP	positive regulation of blood vessel endothelial cell migration	16175	10757		0.9841269841269841	0.984375	50	16125	4	35	46	16090	16175	0.08809446455190707
M1	cpdb	0	network_modules	78	TRUE	0.009348224798710964	110	39	5	0.1282051282051282	0.045454545454545456	GO:0072655	GO:BP	establishment of protein localization to mitochondrion	16175	17476		1	1	110	16065	5	34	105	16031	16175	0.07262343105227892
M1	cpdb	0	network_modules	78	TRUE	0.009796629640099854	259	38	7	0.18421052631578946	0.02702702702702703	REAC:R-HSA-76002	REAC	Platelet activation, signaling and aggregation	10916	1762		1	1	259	10657	7	31	252	10626	10916	0.06232250002937714
M1	cpdb	0	network_modules	79	TRUE	1.3875009743707932e-35	162	37	26	0.7027027027027027	0.16049382716049382	KEGG:04630	KEGG	JAK-STAT signaling pathway	8484	332		0	0.043478260869565216	162	8322	26	11	136	8311	8484	0.33058717984249947
M1	cpdb	0	network_modules	79	TRUE	6.384410564622894e-28	419	38	25	0.6578947368421053	0.059665871121718374	GO:0019221	GO:BP	cytokine-mediated signaling pathway	16175	5598		0	0.007462686567164179	419	15756	25	13	394	15743	16175	0.19306577133922456
M1	cpdb	0	network_modules	79	TRUE	7.744657732900817e-25	555	38	25	0.6578947368421053	0.04504504504504504	GO:0071345	GO:BP	cellular response to cytokine stimulus	16175	16597		0.007518796992481203	0.014925373134328358	555	15620	25	13	530	15607	16175	0.16623850293116882
M1	cpdb	0	network_modules	79	TRUE	1.518386784313295e-23	625	38	25	0.6578947368421053	0.04	GO:0034097	GO:BP	response to cytokine	16175	8408		0.015037593984962405	0.029850746268656716	625	15550	25	13	600	15537	16175	0.1559153617956564
M1	cpdb	0	network_modules	79	TRUE	1.518386784313295e-23	625	38	25	0.6578947368421053	0.04	GO:1901652	GO:BP	response to peptide	16175	21619		0.015037593984962405	0.029850746268656716	625	15550	25	13	600	15537	16175	0.1559153617956564
M1	cpdb	0	network_modules	79	TRUE	1.5198543897753273e-22	142	38	17	0.4473684210526316	0.11971830985915492	GO:0007259	GO:BP	cell surface receptor signaling pathway via JAK-STAT	16175	2789		0.03007518796992481	0.03731343283582089	142	16033	17	21	125	16012	16175	0.2281556834449843
M1	cpdb	0	network_modules	79	TRUE	2.244412066267916e-22	23	38	12	0.3157894736842105	0.5217391304347826	REAC:R-HSA-982772	REAC	Growth hormone receptor signaling	10916	1085		0	0.01694915254237288	23	10893	12	26	11	10867	10916	0.4043275962429285
M1	cpdb	0	network_modules	79	TRUE	3.584791766957839e-22	149	38	17	0.4473684210526316	0.11409395973154363	GO:0097696	GO:BP	cell surface receptor signaling pathway via STAT	16175	18727		0.03759398496240601	0.04477611940298507	149	16026	17	21	132	16005	16175	0.22256066818557346
M1	cpdb	0	network_modules	79	TRUE	5.894355998736982e-20	199	38	17	0.4473684210526316	0.08542713567839195	GO:0071375	GO:BP	cellular response to peptide hormone stimulus	16175	16627		0.045112781954887216	0.05223880597014925	199	15976	17	21	182	15955	16175	0.19152203791807793
M1	cpdb	0	network_modules	79	TRUE	1.1442787405783724e-18	236	38	17	0.4473684210526316	0.07203389830508475	GO:0043434	GO:BP	response to peptide hormone	16175	10691		0.05263157894736842	0.05970149253731343	236	15939	17	21	219	15918	16175	0.1751472531685219
M1	cpdb	0	network_modules	79	TRUE	2.639559102637425e-18	472	38	22	0.5789473684210527	0.046610169491525424	REAC:R-HSA-449147	REAC	Signaling by Interleukins	10916	2261		0.017241379310344827	0.03389830508474576	472	10444	22	16	450	10428	10916	0.15566987237765148
M1	cpdb	0	network_modules	79	TRUE	3.2848165364352336e-17	9	38	8	0.21052631578947367	0.8888888888888888	REAC:R-HSA-2586552	REAC	Signaling by Leptin	10916	2266		0.034482758620689655	0.05084745762711865	9	10907	8	30	1	10877	10916	0.4318263343686092
M1	cpdb	0	network_modules	79	TRUE	3.898849421604161e-17	36	38	11	0.2894736842105263	0.3055555555555556	REAC:R-HSA-1266695	REAC	Interleukin-7 signaling	10916	1255		0.05172413793103448	0.06779661016949153	36	10880	11	27	25	10853	10916	0.2950176263281676
M1	cpdb	0	network_modules	79	TRUE	6.607784905398598e-16	510	38	19	0.5	0.03725490196078431	GO:0007169	GO:BP	cell surface receptor protein tyrosine kinase signaling pathway	16175	2733		0.06015037593984962	0.06716417910447761	510	15665	19	19	491	15646	16175	0.13009363725547535
M1	cpdb	0	network_modules	79	TRUE	7.671210247314771e-16	30	38	10	0.2631578947368421	0.3333333333333333	REAC:R-HSA-9674555	REAC	Signaling by CSF3 (G-CSF)	10916	2227		0.06896551724137931	0.0847457627118644	30	10886	10	28	20	10858	10916	0.29399710576286314
M1	cpdb	0	network_modules	79	TRUE	2.2593445511199696e-15	451	38	18	0.47368421052631576	0.03991130820399113	GO:0032870	GO:BP	cellular response to hormone stimulus	16175	7867		0.06766917293233082	0.07462686567164178	451	15724	18	20	433	15704	16175	0.13140037246791247
M1	cpdb	0	network_modules	79	TRUE	3.602965026630701e-15	26	38	9	0.23684210526315788	0.34615384615384615	GO:0060396	GO:BP	growth hormone receptor signaling pathway	16175	14599		0.07518796992481203	0.08955223880597014	26	16149	9	29	17	16120	16175	0.2849486197699596
M1	cpdb	0	network_modules	79	TRUE	3.602965026630701e-15	26	38	9	0.23684210526315788	0.34615384615384615	GO:0071378	GO:BP	cellular response to growth hormone stimulus	16175	16630		0.07518796992481203	0.08955223880597014	26	16149	9	29	17	16120	16175	0.2849486197699596
M1	cpdb	0	network_modules	79	TRUE	4.466369415490764e-15	790	38	21	0.5526315789473685	0.026582278481012658	GO:0007167	GO:BP	enzyme-linked receptor protein signaling pathway	16175	2731		0.09022556390977443	0.09701492537313433	790	15385	21	17	769	15368	16175	0.11342599644169929
M1	cpdb	0	network_modules	79	TRUE	1.1492566395540084e-14	29	38	9	0.23684210526315788	0.3103448275862069	GO:0060416	GO:BP	response to growth hormone	16175	14617		0.09774436090225563	0.1044776119402985	29	16146	9	29	20	16117	16175	0.26961994776903575
M1	cpdb	0	network_modules	79	TRUE	1.9784064050495898e-14	25	38	9	0.23684210526315788	0.36	REAC:R-HSA-9705462	REAC	Inactivation of CSF3 (G-CSF) signaling	10916	1178		0.08620689655172414	0.1016949152542373	25	10891	9	29	16	10862	10916	0.2900119208382676
M1	cpdb	0	network_modules	79	TRUE	3.2869256352182797e-14	431	38	17	0.4473684210526316	0.03944315545243619	GO:1901699	GO:BP	cellular response to nitrogen compound	16175	21652		0.10526315789473684	0.11194029850746269	431	15744	17	21	414	15723	16175	0.12677222385995351
M1	cpdb	0	network_modules	79	TRUE	3.9774265219643065e-14	10	38	7	0.18421052631578946	0.7	GO:0060397	GO:BP	growth hormone receptor signaling pathway via JAK-STAT	16175	14600		0.11278195488721804	0.11940298507462686	10	16165	7	31	3	16134	16175	0.35841920202129113
M1	cpdb	0	network_modules	79	TRUE	5.320880737295202e-14	539	38	18	0.47368421052631576	0.03339517625231911	GO:0009725	GO:BP	response to hormone	16175	3623		0.12030075187969924	0.12686567164179105	539	15636	18	20	521	15616	16175	0.11906291266994394
M1	cpdb	0	network_modules	79	TRUE	6.1309995938829e-14	44	38	10	0.2631578947368421	0.22727272727272727	REAC:R-HSA-451927	REAC	Interleukin-2 family signaling	10916	1240		0.10344827586206896	0.11864406779661017	44	10872	10	28	34	10844	10916	0.24172000608446284
M1	cpdb	0	network_modules	79	TRUE	1.2705034858728616e-13	47	38	10	0.2631578947368421	0.2127659574468085	REAC:R-HSA-512988	REAC	Interleukin-3, Interleukin-5 and GM-CSF signaling	10916	1246		0.1206896551724138	0.13559322033898305	47	10869	10	28	37	10841	10916	0.23366253459158037
M1	cpdb	0	network_modules	79	TRUE	4.206720945998459e-13	11	38	7	0.18421052631578946	0.6363636363636364	REAC:R-HSA-1059683	REAC	Interleukin-6 signaling	10916	1254		0.13793103448275862	0.15254237288135594	11	10905	7	31	4	10874	10916	0.341274470445679
M1	cpdb	0	network_modules	79	TRUE	1.617970204772407e-12	214	38	13	0.34210526315789475	0.06074766355140187	GO:0018108	GO:BP	peptidyl-tyrosine phosphorylation	16175	5327		0.12781954887218044	0.13432835820895522	214	15961	13	25	201	15936	16175	0.13967496573333305
M1	cpdb	0	network_modules	79	TRUE	1.7195982730187262e-12	215	38	13	0.34210526315789475	0.06046511627906977	GO:0018212	GO:BP	peptidyl-tyrosine modification	16175	5371		0.13533834586466165	0.1417910447761194	215	15960	13	25	202	15935	16175	0.1393279305845426
M1	cpdb	0	network_modules	79	TRUE	1.984395044098479e-12	39	38	9	0.23684210526315788	0.23076923076923078	REAC:R-HSA-1433557	REAC	Signaling by SCF-KIT	10916	2306		0.15517241379310345	0.1694915254237288	39	10877	9	29	30	10848	10916	0.2310742983588053
M1	cpdb	0	network_modules	79	TRUE	2.2539272877968124e-12	791	38	19	0.5	0.02402022756005057	GO:1901701	GO:BP	cellular response to oxygen-containing compound	16175	21654		0.14285714285714285	0.14925373134328357	791	15384	19	19	772	15365	16175	0.10150141770937235
M1	cpdb	0	network_modules	79	TRUE	3.795854131505571e-12	25	38	8	0.21052631578947367	0.32	REAC:R-HSA-8854691	REAC	Interleukin-20 family signaling	10916	1242		0.1724137931034483	0.1864406779661017	25	10891	8	30	17	10861	10916	0.2574737362855662
M1	cpdb	0	network_modules	79	TRUE	3.974255089206562e-12	507	38	18	0.47368421052631576	0.03550295857988166	REAC:R-HSA-9006934	REAC	Signaling by Receptor Tyrosine Kinases	10916	2302		0.1896551724137931	0.2033898305084746	507	10409	18	20	489	10389	10916	0.11998938403812946
M1	cpdb	0	network_modules	79	TRUE	4.342429106237662e-12	14	38	7	0.18421052631578946	0.5	REAC:R-HSA-8983432	REAC	Interleukin-15 signaling	10916	1237		0.20689655172413793	0.22033898305084745	14	10902	7	31	7	10871	10916	0.302095245335083
M1	cpdb	0	network_modules	79	TRUE	1.3453055317104561e-11	619	38	17	0.4473684210526316	0.027463651050080775	GO:1901698	GO:BP	response to nitrogen compound	16175	21651		0.15037593984962405	0.15671641791044777	619	15556	17	21	602	15535	16175	0.10348069380267583
M1	cpdb	0	network_modules	79	TRUE	1.4067244670827636e-11	9	38	6	0.15789473684210525	0.6666666666666666	GO:0071352	GO:BP	cellular response to interleukin-2	16175	16604		0.15789473684210525	0.17164179104477612	9	16166	6	32	3	16134	16175	0.3237700423420975
M1	cpdb	0	network_modules	79	TRUE	1.4067244670827636e-11	9	38	6	0.15789473684210525	0.6666666666666666	GO:0038110	GO:BP	interleukin-2-mediated signaling pathway	16175	9704		0.15789473684210525	0.17164179104477612	9	16166	6	32	3	16134	16175	0.3237700423420975
M1	cpdb	0	network_modules	79	TRUE	2.931649957536181e-11	356	37	16	0.43243243243243246	0.0449438202247191	KEGG:04151	KEGG	PI3K-Akt signaling pathway	8484	285		0.045454545454545456	0.08695652173913043	356	8128	16	21	340	8107	8484	0.1288909180162393
M1	cpdb	0	network_modules	79	TRUE	3.0739613148415865e-11	105	37	11	0.2972972972972973	0.10476190476190476	KEGG:04659	KEGG	Th17 cell differentiation	8484	337		0.09090909090909091	0.13043478260869565	105	8379	11	26	94	8353	8484	0.17056270733401643
M1	cpdb	0	network_modules	79	TRUE	3.5108450279239094e-11	10	38	6	0.15789473684210525	0.6	GO:0070669	GO:BP	response to interleukin-2	16175	16250		0.17293233082706766	0.1791044776119403	10	16165	6	32	4	16133	16175	0.30704403615045606
M1	cpdb	0	network_modules	79	TRUE	3.659562481536717e-11	9	38	6	0.15789473684210525	0.6666666666666666	REAC:R-HSA-8985947	REAC	Interleukin-9 signaling	10916	1256		0.22413793103448276	0.23728813559322035	9	10907	6	32	3	10875	10916	0.3234453014215203
M1	cpdb	0	network_modules	79	TRUE	7.710755576399114e-11	11	38	6	0.15789473684210525	0.5454545454545454	GO:0035723	GO:BP	interleukin-15-mediated signaling pathway	16175	9193		0.18045112781954886	0.20149253731343283	11	16164	6	32	5	16132	16175	0.2926489747604027
M1	cpdb	0	network_modules	79	TRUE	7.710755576399114e-11	11	38	6	0.15789473684210525	0.5454545454545454	GO:0071350	GO:BP	cellular response to interleukin-15	16175	16602		0.18045112781954886	0.20149253731343283	11	16164	6	32	5	16132	16175	0.2926489747604027
M1	cpdb	0	network_modules	79	TRUE	7.710755576399114e-11	11	38	6	0.15789473684210525	0.5454545454545454	GO:0070672	GO:BP	response to interleukin-15	16175	16253		0.18045112781954886	0.20149253731343283	11	16164	6	32	5	16132	16175	0.2926489747604027
M1	cpdb	0	network_modules	79	TRUE	9.125903249678564e-11	10	38	6	0.15789473684210525	0.6	REAC:R-HSA-9020958	REAC	Interleukin-21 signaling	10916	1243		0.2413793103448276	0.2542372881355932	10	10906	6	32	4	10874	10916	0.3066822510165128
M1	cpdb	0	network_modules	79	TRUE	3.4561543319565007e-10	83	38	9	0.23684210526315788	0.10843373493975904	GO:0046425	GO:BP	regulation of receptor signaling pathway via JAK-STAT	16175	12135		0.20300751879699247	0.208955223880597	83	16092	9	29	74	16063	16175	0.15737175021585667
M1	cpdb	0	network_modules	79	TRUE	3.9952302773379156e-10	12	38	6	0.15789473684210525	0.5	REAC:R-HSA-877312	REAC	Regulation of IFNG signaling	10916	1980		0.25862068965517243	0.288135593220339	12	10904	6	32	6	10872	10916	0.2796601991611409
M1	cpdb	0	network_modules	79	TRUE	3.9952302773379156e-10	12	38	6	0.15789473684210525	0.5	REAC:R-HSA-9020558	REAC	Interleukin-2 signaling	10916	1241		0.25862068965517243	0.288135593220339	12	10904	6	32	6	10872	10916	0.2796601991611409
M1	cpdb	0	network_modules	79	TRUE	4.2714446835219443e-10	24	38	7	0.18421052631578946	0.2916666666666667	REAC:R-HSA-912694	REAC	Regulation of IFNA/IFNB signaling	10916	1979		0.29310344827586204	0.3220338983050847	24	10892	7	31	17	10861	10916	0.2296789472597689
M1	cpdb	0	network_modules	79	TRUE	4.2714446835219443e-10	24	38	7	0.18421052631578946	0.2916666666666667	REAC:R-HSA-6783589	REAC	Interleukin-6 family signaling	10916	1253		0.29310344827586204	0.3220338983050847	24	10892	7	31	17	10861	10916	0.2296789472597689
M1	cpdb	0	network_modules	79	TRUE	5.278276723807751e-10	291	37	14	0.3783783783783784	0.048109965635738834	KEGG:04060	KEGG	Cytokine-cytokine receptor interaction	8484	253		0.13636363636363635	0.17391304347826086	291	8193	14	23	277	8170	8484	0.12512378234847119
M1	cpdb	0	network_modules	79	TRUE	7.342344264679609e-10	90	38	9	0.23684210526315788	0.1	GO:1904892	GO:BP	regulation of receptor signaling pathway via STAT	16175	24199		0.21052631578947367	0.21641791044776118	90	16085	9	29	81	16056	16175	0.15087842939774299
M1	cpdb	0	network_modules	79	TRUE	8.077891927291894e-10	26	38	7	0.18421052631578946	0.2692307692307692	REAC:R-HSA-912526	REAC	Interleukin receptor SHC signaling	10916	1230		0.3275862068965517	0.3389830508474576	26	10890	7	31	19	10859	10916	0.22046650705095702
M1	cpdb	0	network_modules	79	TRUE	1.2919280762272776e-9	14	38	6	0.15789473684210525	0.42857142857142855	REAC:R-HSA-1170546	REAC	Prolactin receptor signaling	10916	1805		0.3448275862068966	0.3559322033898305	14	10902	6	32	8	10870	10916	0.2586362087236206
M1	cpdb	0	network_modules	79	TRUE	1.7261509226896287e-9	7	38	5	0.13157894736842105	0.7142857142857143	GO:0071355	GO:BP	cellular response to interleukin-9	16175	16607		0.21804511278195488	0.23134328358208955	7	16168	5	33	2	16135	16175	0.3059871337105436
M1	cpdb	0	network_modules	79	TRUE	1.7261509226896287e-9	7	38	5	0.13157894736842105	0.7142857142857143	GO:0038113	GO:BP	interleukin-9-mediated signaling pathway	16175	9707		0.21804511278195488	0.23134328358208955	7	16168	5	33	2	16135	16175	0.3059871337105436
M1	cpdb	0	network_modules	79	TRUE	3.032547410083638e-9	7	38	5	0.13157894736842105	0.7142857142857143	REAC:R-HSA-9027283	REAC	Erythropoietin activates STAT5	10916	860		0.3620689655172414	0.3728813559322034	7	10909	5	33	2	10876	10916	0.30570600629431727
M1	cpdb	0	network_modules	79	TRUE	4.255425901352177e-9	120	37	10	0.2702702702702703	0.08333333333333333	KEGG:04935	KEGG	Growth hormone synthesis, secretion and action	8484	392		0.18181818181818182	0.21739130434782608	120	8364	10	27	110	8337	8484	0.14355102720885685
M1	cpdb	0	network_modules	79	TRUE	4.595240710874022e-9	8	38	5	0.13157894736842105	0.625	GO:0071104	GO:BP	response to interleukin-9	16175	16454		0.23308270676691728	0.23880597014925373	8	16167	5	33	3	16134	16175	0.28609867298924757
M1	cpdb	0	network_modules	79	TRUE	7.653290134892294e-9	89	37	9	0.24324324324324326	0.10112359550561797	KEGG:04658	KEGG	Th1 and Th2 cell differentiation	8484	336		0.22727272727272727	0.2608695652173913	89	8395	9	28	80	8367	8484	0.15119590814124614
M1	cpdb	0	network_modules	79	TRUE	2.0985504432995273e-8	686	38	15	0.39473684210526316	0.021865889212827987	GO:0008284	GO:BP	positive regulation of cell population proliferation	16175	3151		0.24060150375939848	0.2462686567164179	686	15489	15	23	671	15466	16175	0.08483894922352274
M1	cpdb	0	network_modules	79	TRUE	2.4558030404463824e-8	84	38	8	0.21052631578947367	0.09523809523809523	GO:0008286	GO:BP	insulin receptor signaling pathway	16175	3153		0.24812030075187969	0.2537313432835821	84	16091	8	30	76	16061	16175	0.13862850072036043
M1	cpdb	0	network_modules	79	TRUE	3.4915596020557467e-8	70	37	8	0.21621621621621623	0.11428571428571428	KEGG:04917	KEGG	Prolactin signaling pathway	8484	374		0.2727272727272727	0.30434782608695654	70	8414	8	29	62	8385	8484	0.152156695626287
M1	cpdb	0	network_modules	79	TRUE	3.979363881857681e-8	111	38	9	0.23684210526315788	0.08108108108108109	REAC:R-HSA-6785807	REAC	Interleukin-4 and Interleukin-13 signaling	10916	1252		0.3793103448275862	0.3898305084745763	111	10805	9	29	102	10776	10916	0.1335388895290277
M1	cpdb	0	network_modules	79	TRUE	6.604596457517682e-8	11	38	5	0.13157894736842105	0.45454545454545453	REAC:R-HSA-9020956	REAC	Interleukin-27 signaling	10916	1245		0.39655172413793105	0.4067796610169492	11	10905	5	33	6	10872	10916	0.2432311480943083
M1	cpdb	0	network_modules	79	TRUE	1.1293627996620774e-7	12	38	5	0.13157894736842105	0.4166666666666667	REAC:R-HSA-8984722	REAC	Interleukin-35 Signalling	10916	1248		0.41379310344827586	0.423728813559322	12	10904	5	33	7	10871	10916	0.2327233797570355
M1	cpdb	0	network_modules	79	TRUE	1.1682815250523764e-7	638	38	14	0.3684210526315789	0.0219435736677116	GO:0030097	GO:BP	hemopoiesis	16175	6675		0.2556390977443609	0.26119402985074625	638	15537	14	24	624	15513	16175	0.08201568530250294
M1	cpdb	0	network_modules	79	TRUE	1.210560531121422e-7	406	38	12	0.3157894736842105	0.029556650246305417	GO:0042110	GO:BP	T cell activation	16175	9970		0.2631578947368421	0.26865671641791045	406	15769	12	26	394	15743	16175	0.09017542702838283
M1	cpdb	0	network_modules	79	TRUE	3.712447085507081e-7	37	38	6	0.15789473684210525	0.16216216216216217	GO:0072538	GO:BP	T-helper 17 type immune response	16175	17436		0.2706766917293233	0.27611940298507465	37	16138	6	32	31	16106	16175	0.15806248860278346
M1	cpdb	0	network_modules	79	TRUE	3.892229299241375e-7	699	38	14	0.3684210526315789	0.020028612303290415	GO:0045321	GO:BP	leukocyte activation	16175	11356		0.2781954887218045	0.2835820895522388	699	15476	14	24	685	15452	16175	0.07760962347031146
M1	cpdb	0	network_modules	79	TRUE	3.9831201749246616e-7	138	37	9	0.24324324324324326	0.06521739130434782	KEGG:05162	KEGG	Measles	8484	443		0.3181818181818182	0.34782608695652173	138	8346	9	28	129	8318	8484	0.11875558029550641
M1	cpdb	0	network_modules	79	TRUE	4.0333385838078643e-7	569	38	13	0.34210526315789475	0.022847100175746926	GO:0046649	GO:BP	lymphocyte activation	16175	12286		0.2857142857142857	0.291044776119403	569	15606	13	25	556	15581	16175	0.08084600861120003
M1	cpdb	0	network_modules	79	TRUE	6.190625179807171e-7	125	38	8	0.21052631578947367	0.064	GO:0046631	GO:BP	alpha-beta T cell activation	16175	12268		0.2932330827067669	0.29850746268656714	125	16050	8	30	117	16020	16175	0.11238194913401449
M1	cpdb	0	network_modules	79	TRUE	8.3596967993466e-7	276	38	10	0.2631578947368421	0.036231884057971016	GO:0002460	GO:BP	adaptive immune response based on somatic recombination of immune receptors built from immunoglobulin superfamily domains	16175	983		0.3007518796992481	0.30597014925373134	276	15899	10	28	266	15871	16175	0.09221194761132478
M1	cpdb	0	network_modules	79	TRUE	1.2447237617016933e-6	70	37	7	0.1891891891891892	0.1	KEGG:04920	KEGG	Adipocytokine signaling pathway	8484	377		0.36363636363636365	0.391304347826087	70	8414	7	30	63	8384	8484	0.13238252501733785
M1	cpdb	0	network_modules	79	TRUE	1.5328990422444972e-6	140	38	8	0.21052631578947367	0.05714285714285714	GO:0032869	GO:BP	cellular response to insulin stimulus	16175	7866		0.3082706766917293	0.31343283582089554	140	16035	8	30	132	16005	16175	0.1057547996999945
M1	cpdb	0	network_modules	79	TRUE	1.6369193091899817e-6	638	38	13	0.34210526315789475	0.02037617554858934	GO:0018193	GO:BP	peptidyl-amino acid modification	16175	5353		0.3157894736842105	0.3208955223880597	638	15537	13	25	625	15512	16175	0.07545503077312209
M1	cpdb	0	network_modules	79	TRUE	2.3699220070088043e-6	76	38	7	0.18421052631578946	0.09210526315789473	REAC:R-HSA-909733	REAC	Interferon alpha/beta signaling	10916	1228		0.43103448275862066	0.4406779661016949	76	10840	7	31	69	10809	10916	0.12599153397269203
M1	cpdb	0	network_modules	79	TRUE	2.852918919208636e-6	46	37	6	0.16216216216216217	0.13043478260869565	KEGG:04930	KEGG	Type II diabetes mellitus	8484	387		0.4090909090909091	0.43478260869565216	46	8438	6	31	40	8407	8484	0.14126415342847592
M1	cpdb	0	network_modules	79	TRUE	2.9491418804774735e-6	152	38	8	0.21052631578947367	0.05263157894736842	GO:0032868	GO:BP	response to insulin	16175	7865		0.3233082706766917	0.3283582089552239	152	16023	8	30	144	15993	16175	0.10115931584033543
M1	cpdb	0	network_modules	79	TRUE	3.2282585256893238e-6	8	38	4	0.10526315789473684	0.5	REAC:R-HSA-112411	REAC	MAPK1 (ERK2) activation	10916	1350		0.4482758620689655	0.4576271186440678	8	10908	4	34	4	10874	10916	0.2282997257850649
M1	cpdb	0	network_modules	79	TRUE	4.666850319383185e-6	23	38	5	0.13157894736842105	0.21739130434782608	REAC:R-HSA-9006335	REAC	Signaling by Erythropoietin	10916	2238		0.46551724137931033	0.4745762711864407	23	10893	5	33	18	10860	10916	0.16688557988766137
M1	cpdb	0	network_modules	79	TRUE	4.9012970293987925e-6	9	38	4	0.10526315789473684	0.4444444444444444	GO:0035771	GO:BP	interleukin-4-mediated signaling pathway	16175	9230		0.3308270676691729	0.3358208955223881	9	16166	4	34	5	16132	16175	0.21546503272793058
M1	cpdb	0	network_modules	79	TRUE	5.283484186480793e-6	334	38	10	0.2631578947368421	0.029940119760479042	GO:0002250	GO:BP	adaptive immune response	16175	782		0.3383458646616541	0.34328358208955223	334	15841	10	28	324	15813	16175	0.08275372685331887
M1	cpdb	0	network_modules	79	TRUE	5.796382402163199e-6	9	38	4	0.10526315789473684	0.4444444444444444	REAC:R-HSA-110056	REAC	MAPK3 (ERK1) activation	10916	1352		0.4827586206896552	0.4915254237288136	9	10907	4	34	5	10873	10916	0.21506426847443139
M1	cpdb	0	network_modules	79	TRUE	6.708296770104766e-6	269	38	10	0.2631578947368421	0.03717472118959108	REAC:R-HSA-5684996	REAC	MAPK1/MAPK3 signaling	10916	1351		0.5	0.5084745762711864	269	10647	10	28	259	10619	10916	0.09092996719587725
M1	cpdb	0	network_modules	79	TRUE	7.331609738664218e-6	25	38	5	0.13157894736842105	0.2	REAC:R-HSA-201556	REAC	Signaling by ALK	10916	2217		0.5172413793103449	0.5254237288135594	25	10891	5	33	20	10858	10916	0.15985918262746204
M1	cpdb	0	network_modules	79	TRUE	8.985092437487018e-6	175	38	8	0.21052631578947367	0.045714285714285714	GO:0050730	GO:BP	regulation of peptidyl-tyrosine phosphorylation	16175	13229		0.3458646616541353	0.35074626865671643	175	16000	8	30	167	15970	16175	0.09367836177997113
M1	cpdb	0	network_modules	79	TRUE	1.2577351021450066e-5	65	38	6	0.15789473684210525	0.09230769230769231	GO:0007260	GO:BP	tyrosine phosphorylation of STAT protein	16175	2790		0.3533834586466165	0.3582089552238806	65	16110	6	32	59	16078	16175	0.11802979785867003
M1	cpdb	0	network_modules	79	TRUE	2.2163131948771002e-5	792	38	13	0.34210526315789475	0.016414141414141416	GO:0042325	GO:BP	regulation of phosphorylation	16175	10093		0.3609022556390977	0.3656716417910448	792	15383	13	25	779	15358	16175	0.06592010092665879
M1	cpdb	0	network_modules	79	TRUE	2.2715640072288715e-5	158	37	8	0.21621621621621623	0.05063291139240506	KEGG:04217	KEGG	Necroptosis	8484	294		0.45454545454545453	0.4782608695652174	158	8326	8	29	150	8297	8484	0.0967330583774104
M1	cpdb	0	network_modules	79	TRUE	2.3509150678509334e-5	72	38	6	0.15789473684210525	0.08333333333333333	GO:0043367	GO:BP	CD4-positive, alpha-beta T cell differentiation	16175	10644		0.3684210526315789	0.373134328358209	72	16103	6	32	66	16071	16175	0.11185446420729508
M1	cpdb	0	network_modules	79	TRUE	2.4194571759325282e-5	308	38	10	0.2631578947368421	0.032467532467532464	REAC:R-HSA-5683057	REAC	MAPK family signaling cascades	10916	1348		0.5344827586206896	0.5423728813559322	308	10608	10	28	298	10580	10916	0.08385908951692468
M1	cpdb	0	network_modules	79	TRUE	2.7529960941318326e-05	162	37	8	0.21621621621621623	0.04938271604938271	KEGG:05161	KEGG	Hepatitis B	8484	442		0.5	0.5217391304347826	162	8322	8	29	154	8293	8484	0.09532631303552906
M1	cpdb	0	network_modules	79	TRUE	3.225022644318938e-5	206	38	8	0.21052631578947367	0.038834951456310676	GO:0030217	GO:BP	T cell differentiation	16175	6725		0.37593984962406013	0.3805970149253731	206	15969	8	30	198	15939	16175	0.0855968717218767
M1	cpdb	0	network_modules	79	TRUE	5.113219597431115e-5	40	38	5	0.13157894736842105	0.125	GO:0046427	GO:BP	positive regulation of receptor signaling pathway via JAK-STAT	16175	12137		0.38345864661654133	0.3880597014925373	40	16135	5	33	35	16102	16175	0.12614110108773058
M1	cpdb	0	network_modules	79	TRUE	5.7955665489984635e-5	4	38	3	0.07894736842105263	0.75	REAC:R-HSA-8849474	REAC	PTK6 Activates STAT3	10916	1704		0.5517241379310345	0.559322033898305	4	10912	3	35	1	10877	10916	0.24266984305761174
M1	cpdb	0	network_modules	79	TRUE	6.375506359477027e-5	434	38	10	0.2631578947368421	0.02304147465437788	GO:0002521	GO:BP	leukocyte differentiation	16175	1043		0.39097744360902253	0.39552238805970147	434	15741	10	28	424	15713	16175	0.07097016880475034
M1	cpdb	0	network_modules	79	TRUE	6.436982719745644e-5	85	38	6	0.15789473684210525	0.07058823529411765	GO:0046632	GO:BP	alpha-beta T cell differentiation	16175	12269		0.39849624060150374	0.40298507462686567	85	16090	6	32	79	16058	16175	0.10244829756227687
M1	cpdb	0	network_modules	79	TRUE	7.874134577992703e-5	263	38	9	0.23684210526315788	0.034220532319391636	REAC:R-HSA-913531	REAC	Interferon Signaling	10916	1227		0.5689655172413793	0.576271186440678	263	10653	9	29	254	10624	10916	0.08200390819380367
M1	cpdb	0	network_modules	79	TRUE	7.935578864735413e-5	88	38	6	0.15789473684210525	0.06818181818181818	GO:0035710	GO:BP	CD4-positive, alpha-beta T cell activation	16175	9184		0.40601503759398494	0.41044776119402987	88	16087	6	32	82	16055	16175	0.10057391009536118
M1	cpdb	0	network_modules	79	TRUE	8.381832479774378e-5	44	38	5	0.13157894736842105	0.11363636363636363	GO:1904894	GO:BP	positive regulation of receptor signaling pathway via STAT	16175	24201		0.41353383458646614	0.417910447761194	44	16131	5	33	39	16098	16175	0.1200553311974479
M1	cpdb	0	network_modules	79	TRUE	9.134178703526024e-5	17	38	4	0.10526315789473684	0.23529411764705882	GO:0071353	GO:BP	cellular response to interleukin-4	16175	16605		0.42105263157894735	0.4253731343283582	17	16158	4	34	13	16124	16175	0.156071927886988
M1	cpdb	0	network_modules	79	TRUE	1.0732336674997708e-4	17	38	4	0.10526315789473684	0.23529411764705882	REAC:R-HSA-6788467	REAC	IL-6-type cytokine receptor ligand interactions	10916	1146		0.5862068965517241	0.6271186440677966	17	10899	4	34	13	10865	10916	0.15544118652808794
M1	cpdb	0	network_modules	79	TRUE	1.0732336674997708e-4	17	38	4	0.10526315789473684	0.23529411764705882	REAC:R-HSA-9669938	REAC	Signaling by KIT in disease	10916	2262		0.5862068965517241	0.6271186440677966	17	10899	4	34	13	10865	10916	0.15544118652808794
M1	cpdb	0	network_modules	79	TRUE	1.0732336674997708e-4	17	38	4	0.10526315789473684	0.23529411764705882	REAC:R-HSA-9670439	REAC	Signaling by phosphorylated juxtamembrane, extracellular and kinase domain KIT mutants	10916	2326		0.5862068965517241	0.6271186440677966	17	10899	4	34	13	10865	10916	0.15544118652808794
M1	cpdb	0	network_modules	79	TRUE	1.1166955328299569e-4	744	38	12	0.3157894736842105	0.016129032258064516	GO:0001932	GO:BP	regulation of protein phosphorylation	16175	546		0.42857142857142855	0.43283582089552236	744	15431	12	26	732	15405	16175	0.06249872557832144
M1	cpdb	0	network_modules	79	TRUE	1.1724195317519386e-4	18	38	4	0.10526315789473684	0.2222222222222222	GO:0070102	GO:BP	interleukin-6-mediated signaling pathway	16175	15914		0.43609022556390975	0.4552238805970149	18	16157	4	34	14	16123	16175	0.15158936062305448
M1	cpdb	0	network_modules	79	TRUE	1.1724195317519386e-4	18	38	4	0.10526315789473684	0.2222222222222222	GO:0072540	GO:BP	T-helper 17 cell lineage commitment	16175	17438		0.43609022556390975	0.4552238805970149	18	16157	4	34	14	16123	16175	0.15158936062305448
M1	cpdb	0	network_modules	79	TRUE	1.1724195317519386e-4	18	38	4	0.10526315789473684	0.2222222222222222	GO:0070670	GO:BP	response to interleukin-4	16175	16251		0.43609022556390975	0.4552238805970149	18	16157	4	34	14	16123	16175	0.15158936062305448
M1	cpdb	0	network_modules	79	TRUE	1.2959500471745379e-4	137	37	7	0.1891891891891892	0.051094890510948905	KEGG:04910	KEGG	Insulin signaling pathway	8484	367		0.5454545454545454	0.5652173913043478	137	8347	7	30	130	8317	8484	0.09086030004411931
M1	cpdb	0	network_modules	79	TRUE	1.3391489862146506e-4	96	38	6	0.15789473684210525	0.0625	GO:0140888	GO:BP	interferon-mediated signaling pathway	16175	19923		0.45864661654135336	0.4626865671641791	96	16079	6	32	90	16047	16175	0.09600367186268834
M1	cpdb	0	network_modules	79	TRUE	1.4013771470905954e-4	249	38	8	0.21052631578947367	0.0321285140562249	GO:0051251	GO:BP	positive regulation of lymphocyte activation	16175	13598		0.46616541353383456	0.4701492537313433	249	15926	8	30	241	15896	16175	0.07691314595387534
M1	cpdb	0	network_modules	79	TRUE	1.4454067955106762e-4	5	38	3	0.07894736842105263	0.6	REAC:R-HSA-74713	REAC	IRS activation	10916	1163		0.6379310344827587	0.6440677966101694	5	10911	3	35	2	10876	10916	0.21680740594638515
M1	cpdb	0	network_modules	79	TRUE	1.482798905696352e-4	165	38	7	0.18421052631578946	0.04242424242424243	GO:0001659	GO:BP	temperature homeostasis	16175	373		0.47368421052631576	0.47761194029850745	165	16010	7	31	158	15979	16175	0.0840350100178107
M1	cpdb	0	network_modules	79	TRUE	1.5777188244011904e-4	357	38	9	0.23684210526315788	0.025210084033613446	GO:1903131	GO:BP	mononuclear cell differentiation	16175	22787		0.48120300751879697	0.48507462686567165	357	15818	9	29	348	15789	16175	0.07093988003600048
M1	cpdb	0	network_modules	79	TRUE	1.6104011117147048e-4	99	38	6	0.15789473684210525	0.06060606060606061	GO:0120162	GO:BP	positive regulation of cold-induced thermogenesis	16175	19528		0.48872180451127817	0.4925373134328358	99	16076	6	32	93	16044	16175	0.09443130434431066
M1	cpdb	0	network_modules	79	TRUE	1.760806055549516e-4	622	38	11	0.2894736842105263	0.017684887459807074	GO:0030155	GO:BP	regulation of cell adhesion	16175	6688		0.49624060150375937	0.5	622	15553	11	27	611	15526	16175	0.06334750115176532
M1	cpdb	0	network_modules	79	TRUE	1.7872797512767717e-4	257	38	8	0.21052631578947367	0.0311284046692607	GO:0022409	GO:BP	positive regulation of cell-cell adhesion	16175	6600		0.5037593984962406	0.5074626865671642	257	15918	8	30	249	15888	16175	0.07553367479212508
M1	cpdb	0	network_modules	79	TRUE	1.8066773285064925e-4	5	38	3	0.07894736842105263	0.6	GO:0038154	GO:BP	interleukin-11-mediated signaling pathway	16175	9733		0.5112781954887218	0.5149253731343284	5	16170	3	35	2	16135	16175	0.21707935024778444
M1	cpdb	0	network_modules	79	TRUE	1.8500931061372623e-4	20	38	4	0.10526315789473684	0.2	GO:0002295	GO:BP	T-helper cell lineage commitment	16175	827		0.518796992481203	0.5223880597014925	20	16155	4	34	16	16121	16175	0.1436484536060909
M1	cpdb	0	network_modules	79	TRUE	2.090074385065884e-4	369	38	9	0.23684210526315788	0.024390243902439025	GO:0051249	GO:BP	regulation of lymphocyte activation	16175	13596		0.5263157894736842	0.5298507462686567	369	15806	9	29	360	15777	16175	0.06956221249428045
M1	cpdb	0	network_modules	79	TRUE	2.3617994045874017e-4	91	38	6	0.15789473684210525	0.06593406593406594	REAC:R-HSA-877300	REAC	Interferon gamma signaling	10916	1229		0.6551724137931034	0.6610169491525424	91	10825	6	32	85	10793	10916	0.09722026806711474
M1	cpdb	0	network_modules	79	TRUE	2.88386128017194e-4	6	38	3	0.07894736842105263	0.5	REAC:R-HSA-9645135	REAC	STAT5 Activation	10916	2159		0.6724137931034483	0.6779661016949152	6	10910	3	35	3	10875	10916	0.19769523916159462
M1	cpdb	0	network_modules	79	TRUE	3.0028033887056425e-4	275	38	8	0.21052631578947367	0.02909090909090909	GO:0002696	GO:BP	positive regulation of leukocyte activation	16175	1214		0.5338345864661654	0.5373134328358209	275	15900	8	30	267	15870	16175	0.07264342957145323
M1	cpdb	0	network_modules	79	TRUE	3.061980769905446e-4	386	38	9	0.23684210526315788	0.023316062176165803	GO:0022407	GO:BP	regulation of cell-cell adhesion	16175	6598		0.5413533834586466	0.5447761194029851	386	15789	9	29	377	15760	16175	0.06771559638228304
M1	cpdb	0	network_modules	79	TRUE	3.2577252506819427e-4	22	38	4	0.10526315789473684	0.18181818181818182	REAC:R-HSA-112409	REAC	RAF-independent MAPK1/3 activation	10916	1840		0.6896551724137931	0.6949152542372882	22	10894	4	34	18	10860	10916	0.13606813824202607
M1	cpdb	0	network_modules	79	TRUE	3.364308032029628e-4	23	38	4	0.10526315789473684	0.17391304347826086	GO:0002363	GO:BP	alpha-beta T cell lineage commitment	16175	895		0.5488721804511278	0.5597014925373134	23	16152	4	34	19	16118	16175	0.13372646337388627
M1	cpdb	0	network_modules	79	TRUE	3.364308032029628e-4	23	38	4	0.10526315789473684	0.17391304347826086	GO:0043373	GO:BP	CD4-positive, alpha-beta T cell lineage commitment	16175	10650		0.5488721804511278	0.5597014925373134	23	16152	4	34	19	16118	16175	0.13372646337388627
M1	cpdb	0	network_modules	79	TRUE	3.6074902387354555e-4	6	38	3	0.07894736842105263	0.5	GO:0038043	GO:BP	interleukin-5-mediated signaling pathway	16175	9677		0.5639097744360902	0.5671641791044776	6	16169	3	35	3	16134	16175	0.1980157575422673
M1	cpdb	0	network_modules	79	TRUE	3.766517516311104e-4	59	38	5	0.13157894736842105	0.0847457627118644	GO:0042093	GO:BP	T-helper cell differentiation	16175	9964		0.5714285714285714	0.5746268656716418	59	16116	5	33	54	16083	16175	0.1029786068502716
M1	cpdb	0	network_modules	79	TRUE	3.839959603871459e-4	284	38	8	0.21052631578947367	0.028169014084507043	GO:0050863	GO:BP	regulation of T cell activation	16175	13311		0.5789473684210527	0.582089552238806	284	15891	8	30	276	15861	16175	0.0712977789638447
M1	cpdb	0	network_modules	79	TRUE	4.0303814807734654e-4	24	38	4	0.10526315789473684	0.16666666666666666	GO:0002360	GO:BP	T cell lineage commitment	16175	892		0.5864661654135338	0.5970149253731343	24	16151	4	34	20	16117	16175	0.13083696409617954
M1	cpdb	0	network_modules	79	TRUE	4.0303814807734654e-4	24	38	4	0.10526315789473684	0.16666666666666666	GO:0043369	GO:BP	CD4-positive or CD8-positive, alpha-beta T cell lineage commitment	16175	10646		0.5864661654135338	0.5970149253731343	24	16151	4	34	20	16117	16175	0.13083696409617954
M1	cpdb	0	network_modules	79	TRUE	4.160250463460787e-4	287	38	8	0.21052631578947367	0.027874564459930314	GO:1903037	GO:BP	regulation of leukocyte cell-cell adhesion	16175	22717		0.6015037593984962	0.6044776119402985	287	15888	8	30	279	15858	16175	0.07086268412507912
M1	cpdb	0	network_modules	79	TRUE	4.4605829045065934e-4	61	38	5	0.13157894736842105	0.08196721311475409	GO:0002294	GO:BP	CD4-positive, alpha-beta T cell differentiation involved in immune response	16175	826		0.6090225563909775	0.6119402985074627	61	16114	5	33	56	16081	16175	0.10118475743919403
M1	cpdb	0	network_modules	79	TRUE	4.503217589796481e-4	290	38	8	0.21052631578947367	0.027586206896551724	GO:0050867	GO:BP	positive regulation of cell activation	16175	13315		0.6165413533834586	0.6194029850746269	290	15885	8	30	282	15855	16175	0.0704340285910312
M1	cpdb	0	network_modules	79	TRUE	4.6309713351223793e-4	195	38	7	0.18421052631578946	0.035897435897435895	GO:0050870	GO:BP	positive regulation of T cell activation	16175	13318		0.6240601503759399	0.6268656716417911	195	15980	7	31	188	15949	16175	0.07654879265504598
M1	cpdb	0	network_modules	79	TRUE	4.7951425056675436e-4	108	37	6	0.16216216216216217	0.05555555555555555	KEGG:05145	KEGG	Toxoplasmosis	8484	437		0.5909090909090909	0.6521739130434783	108	8376	6	31	102	8345	8484	0.08821950066413953
M1	cpdb	0	network_modules	79	TRUE	4.7951425056675436e-4	108	37	6	0.16216216216216217	0.05555555555555555	KEGG:04931	KEGG	Insulin resistance	8484	388		0.5909090909090909	0.6521739130434783	108	8376	6	31	102	8345	8484	0.08821950066413953
M1	cpdb	0	network_modules	79	TRUE	4.820363877021617e-4	119	38	6	0.15789473684210525	0.05042016806722689	GO:0070665	GO:BP	positive regulation of leukocyte proliferation	16175	16246		0.631578947368421	0.6343283582089553	119	16056	6	32	113	16024	16175	0.08548261844649324
M1	cpdb	0	network_modules	79	TRUE	4.8436089580980213e-4	62	38	5	0.13157894736842105	0.08064516129032258	GO:0002293	GO:BP	alpha-beta T cell differentiation involved in immune response	16175	825		0.6390977443609023	0.6492537313432836	62	16113	5	33	57	16080	16175	0.10031999775833597
M1	cpdb	0	network_modules	79	TRUE	4.8436089580980213e-4	62	38	5	0.13157894736842105	0.08064516129032258	GO:0002287	GO:BP	alpha-beta T cell activation involved in immune response	16175	819		0.6390977443609023	0.6492537313432836	62	16113	5	33	57	16080	16175	0.10031999775833597
M1	cpdb	0	network_modules	79	TRUE	5.034621021788502e-4	7	38	3	0.07894736842105263	0.42857142857142855	REAC:R-HSA-9027277	REAC	Erythropoietin activates Phospholipase C gamma (PLCG)	10916	858		0.7068965517241379	0.711864406779661	7	10909	3	35	4	10874	10916	0.1828247320479437
M1	cpdb	0	network_modules	79	TRUE	5.252212050469893e-4	63	38	5	0.13157894736842105	0.07936507936507936	GO:0042509	GO:BP	regulation of tyrosine phosphorylation of STAT protein	16175	10226		0.6541353383458647	0.6567164179104478	63	16112	5	33	58	16079	16175	0.09947554541479318
M1	cpdb	0	network_modules	79	TRUE	5.329612843396117e-4	57	38	5	0.13157894736842105	0.08771929824561403	REAC:R-HSA-447115	REAC	Interleukin-12 family signaling	10916	1235		0.7241379310344828	0.7288135593220338	57	10859	5	33	52	10826	10916	0.10362120406224992
M1	cpdb	0	network_modules	79	TRUE	5.399189058890584e-4	297	38	8	0.21052631578947367	0.026936026936026935	GO:0030098	GO:BP	lymphocyte differentiation	16175	6676		0.6616541353383458	0.664179104477612	297	15878	8	30	289	15848	16175	0.06945796516821619
M1	cpdb	0	network_modules	79	TRUE	5.651397961705433e-4	26	38	4	0.10526315789473684	0.15384615384615385	GO:0046326	GO:BP	positive regulation of D-glucose import	16175	12059		0.6691729323308271	0.6716417910447762	26	16149	4	34	22	16115	16175	0.12556209384511519
M1	cpdb	0	network_modules	79	TRUE	6.302862447310536e-4	7	38	3	0.07894736842105263	0.42857142857142855	GO:0038156	GO:BP	interleukin-3-mediated signaling pathway	16175	9735		0.6766917293233082	0.6791044776119403	7	16168	3	35	4	16133	16175	0.18318839193808537
M1	cpdb	0	network_modules	79	TRUE	6.363996259951338e-4	421	38	9	0.23684210526315788	0.021377672209026127	GO:0002694	GO:BP	regulation of leukocyte activation	16175	1212		0.6842105263157895	0.6865671641791045	421	15754	9	29	412	15725	16175	0.06425223728274783
M1	cpdb	0	network_modules	79	TRUE	6.591862214750699e-4	26	38	4	0.10526315789473684	0.15384615384615385	REAC:R-HSA-186763	REAC	Downstream signal transduction	10916	790		0.7413793103448276	0.7457627118644068	26	10890	4	34	22	10856	10916	0.12474316735928408
M1	cpdb	0	network_modules	79	TRUE	6.64397935929192e-4	66	38	5	0.13157894736842105	0.07575757575757576	GO:0002292	GO:BP	T cell differentiation involved in immune response	16175	824		0.6917293233082706	0.6940298507462687	66	16109	5	33	61	16076	16175	0.09705630766704215
M1	cpdb	0	network_modules	79	TRUE	8.933141992126091e-4	29	38	4	0.10526315789473684	0.13793103448275862	GO:0071354	GO:BP	cellular response to interleukin-6	16175	16606		0.6992481203007519	0.7089552238805971	29	16146	4	34	25	16112	16175	0.11868853999166028
M1	cpdb	0	network_modules	79	TRUE	8.933141992126091e-4	29	38	4	0.10526315789473684	0.13793103448275862	GO:0072539	GO:BP	T-helper 17 cell differentiation	16175	17437		0.6992481203007519	0.7089552238805971	29	16146	4	34	25	16112	16175	0.11868853999166028
M1	cpdb	0	network_modules	79	TRUE	8.959441167536599e-4	215	38	7	0.18421052631578946	0.03255813953488372	GO:1903039	GO:BP	positive regulation of leukocyte cell-cell adhesion	16175	22719		0.7142857142857143	0.7164179104477612	215	15960	7	31	208	15929	16175	0.07242322430201688
M1	cpdb	0	network_modules	79	TRUE	0.0010068214734378776	8	38	3	0.07894736842105263	0.375	GO:0019694	GO:BP	alkanesulfonate metabolic process	16175	6011		0.7218045112781954	0.7313432835820896	8	16167	3	35	5	16132	16175	0.17122741569813588
M1	cpdb	0	network_modules	79	TRUE	0.0010068214734378776	8	38	3	0.07894736842105263	0.375	GO:0019530	GO:BP	taurine metabolic process	16175	5867		0.7218045112781954	0.7313432835820896	8	16167	3	35	5	16132	16175	0.17122741569813588
M1	cpdb	0	network_modules	79	TRUE	0.0010238681030996773	264	38	8	0.21052631578947367	0.030303030303030304	REAC:R-HSA-5673001	REAC	RAF/MAP kinase cascade	10916	1841		0.7586206896551724	0.7627118644067796	264	10652	8	30	256	10622	10916	0.07169240545613137
M1	cpdb	0	network_modules	79	TRUE	0.0010436339078481968	324	38	8	0.21052631578947367	0.024691358024691357	GO:0007159	GO:BP	leukocyte cell-cell adhesion	16175	2723		0.7368421052631579	0.7388059701492538	324	15851	8	30	316	15821	16175	0.06597939848760369
M1	cpdb	0	network_modules	79	TRUE	0.0011794745425559162	31	38	4	0.10526315789473684	0.12903225806451613	GO:0043368	GO:BP	positive T cell selection	16175	10645		0.7443609022556391	0.746268656716418	31	16144	4	34	27	16110	16175	0.11466596868994104
M1	cpdb	0	network_modules	79	TRUE	0.0011813731249349776	74	38	5	0.13157894736842105	0.06756756756756757	GO:0060337	GO:BP	type I interferon-mediated signaling pathway	16175	14549		0.7518796992481203	0.753731343283582	74	16101	5	33	69	16068	16175	0.09132711839140473
M1	cpdb	0	network_modules	79	TRUE	0.0012025054213550407	9	38	3	0.07894736842105263	0.3333333333333333	REAC:R-HSA-9020933	REAC	Interleukin-23 signaling	10916	1244		0.7758620689655172	0.7966101694915254	9	10907	3	35	6	10872	10916	0.1608737520008869
M1	cpdb	0	network_modules	79	TRUE	0.0012025054213550407	9	38	3	0.07894736842105263	0.3333333333333333	REAC:R-HSA-74749	REAC	Signal attenuation	10916	2214		0.7758620689655172	0.7966101694915254	9	10907	3	35	6	10872	10916	0.1608737520008869
M1	cpdb	0	network_modules	79	TRUE	0.001263603755141502	75	38	5	0.13157894736842105	0.06666666666666667	GO:0071357	GO:BP	cellular response to type I interferon	16175	16609		0.7593984962406015	0.7611940298507462	75	16100	5	33	70	16067	16175	0.09067488424109098
M1	cpdb	0	network_modules	79	TRUE	0.0012967142486350692	194	37	7	0.1891891891891892	0.03608247422680412	KEGG:05167	KEGG	Kaposi sarcoma-associated herpesvirus infection	8484	448		0.6818181818181818	0.6956521739130435	194	8290	7	30	187	8260	8484	0.0736416403669185
M1	cpdb	0	network_modules	79	TRUE	0.0013457047620363907	32	38	4	0.10526315789473684	0.125	GO:0010828	GO:BP	positive regulation of D-glucose transmembrane transport	16175	4438		0.7669172932330827	0.7761194029850746	32	16143	4	34	28	16109	16175	0.11279607110152182
M1	cpdb	0	network_modules	79	TRUE	0.0013457047620363907	32	38	4	0.10526315789473684	0.125	GO:0070741	GO:BP	response to interleukin-6	16175	16280		0.7669172932330827	0.7761194029850746	32	16143	4	34	28	16109	16175	0.11279607110152182
M1	cpdb	0	network_modules	79	TRUE	0.0014012683973525651	37	37	4	0.10810810810810811	0.10810810810810811	KEGG:05340	KEGG	Primary immunodeficiency	8484	488		0.7272727272727273	0.7391304347826086	37	8447	4	33	33	8414	8484	0.10420139566582093
M1	cpdb	0	network_modules	79	TRUE	0.0014565943740870429	131	37	6	0.16216216216216217	0.04580152671755725	KEGG:04068	KEGG	FoxO signaling pathway	8484	258		0.7727272727272727	0.782608695652174	131	8353	6	31	125	8322	8484	0.0787565436825562
M1	cpdb	0	network_modules	79	TRUE	0.0015404132058390745	468	38	9	0.23684210526315788	0.019230769230769232	GO:0050865	GO:BP	regulation of cell activation	16175	13313		0.7819548872180451	0.7835820895522388	468	15707	9	29	459	15678	16175	0.06019044059956477
M1	cpdb	0	network_modules	79	TRUE	0.0016281605333355422	235	38	7	0.18421052631578946	0.029787234042553193	GO:0043491	GO:BP	phosphatidylinositol 3-kinase/protein kinase B signal transduction	16175	10736		0.7894736842105263	0.7910447761194029	235	15940	7	31	228	15909	16175	0.06881485529416842
M1	cpdb	0	network_modules	79	TRUE	0.0016321365534456077	201	37	7	0.1891891891891892	0.03482587064676617	KEGG:05203	KEGG	Viral carcinogenesis	8484	455		0.8181818181818182	0.8260869565217391	201	8283	7	30	194	8253	8484	0.07201947367019453
M1	cpdb	0	network_modules	79	TRUE	0.0017137349333916979	10	38	3	0.07894736842105263	0.3	REAC:R-HSA-9702518	REAC	STAT5 activation downstream of FLT3 ITD mutants	10916	2160		0.8103448275862069	0.8135593220338984	10	10906	3	35	7	10871	10916	0.15244626667643107
M1	cpdb	0	network_modules	79	TRUE	0.0017416927128503005	148	38	6	0.15789473684210525	0.04054054054054054	GO:0120161	GO:BP	regulation of cold-induced thermogenesis	16175	19527		0.7969924812030075	0.7985074626865671	148	16027	6	32	142	15995	16175	0.07580704104836472
M1	cpdb	0	network_modules	79	TRUE	0.001811684525595629	149	38	6	0.15789473684210525	0.040268456375838924	GO:0106106	GO:BP	cold-induced thermogenesis	16175	19254		0.8045112781954887	0.8059701492537313	149	16026	6	32	143	15994	16175	0.07552318062679184
M1	cpdb	0	network_modules	79	TRUE	0.0018567575155114101	81	38	5	0.13157894736842105	0.06172839506172839	GO:0034340	GO:BP	response to type I interferon	16175	8578		0.8120300751879699	0.8134328358208955	81	16094	5	33	76	16061	16175	0.08701320075589568
M1	cpdb	0	network_modules	79	TRUE	0.0018839620004386882	150	38	6	0.15789473684210525	0.04	GO:0051897	GO:BP	positive regulation of phosphatidylinositol 3-kinase/protein kinase B signal transduction	16175	13981		0.8195488721804511	0.8208955223880597	150	16025	6	32	144	15993	16175	0.0752420648455988
M1	cpdb	0	network_modules	79	TRUE	0.0019495646554714228	35	38	4	0.10526315789473684	0.11428571428571428	GO:0032355	GO:BP	response to estradiol	16175	7514		0.8270676691729323	0.8283582089552238	35	16140	4	34	31	16106	16175	0.1076700022052462
M1	cpdb	0	network_modules	79	TRUE	0.002396531825880629	143	37	6	0.16216216216216217	0.04195804195804196	KEGG:04550	KEGG	Signaling pathways regulating pluripotency of stem cells	8484	319		0.8636363636363636	0.8695652173913043	143	8341	6	31	137	8310	8484	0.07470668206435
M1	cpdb	0	network_modules	79	TRUE	0.0024508493749000318	37	38	4	0.10526315789473684	0.10810810810810811	GO:0046324	GO:BP	regulation of D-glucose import	16175	12057		0.8345864661654135	0.8507462686567164	37	16138	4	34	33	16104	16175	0.10460046791878819
M1	cpdb	0	network_modules	79	TRUE	0.0024508493749000318	37	38	4	0.10526315789473684	0.10810810810810811	GO:0045058	GO:BP	T cell selection	16175	11256		0.8345864661654135	0.8507462686567164	37	16138	4	34	33	16104	16175	0.10460046791878819
M1	cpdb	0	network_modules	79	TRUE	0.0024508493749000318	37	38	4	0.10526315789473684	0.10810810810810811	GO:0050732	GO:BP	negative regulation of peptidyl-tyrosine phosphorylation	16175	13231		0.8345864661654135	0.8507462686567164	37	16138	4	34	33	16104	16175	0.10460046791878819
M1	cpdb	0	network_modules	79	TRUE	0.0025333101383997873	36	38	4	0.10526315789473684	0.1111111111111111	REAC:R-HSA-9607240	REAC	FLT3 Signaling	10916	917		0.8275862068965517	0.8305084745762712	36	10880	4	34	32	10846	10916	0.10511562424753323
M1	cpdb	0	network_modules	79	TRUE	0.0026634546634086444	500	38	9	0.23684210526315788	0.018	GO:0001934	GO:BP	positive regulation of protein phosphorylation	16175	548		0.8571428571428571	0.8582089552238806	500	15675	9	29	491	15646	16175	0.057737232258438055
M1	cpdb	0	network_modules	79	TRUE	0.002846996910749306	161	38	6	0.15789473684210525	0.037267080745341616	GO:1990845	GO:BP	adaptive thermogenesis	16175	25314		0.8646616541353384	0.8656716417910447	161	16014	6	32	155	15982	16175	0.07231871410217273
M1	cpdb	0	network_modules	79	TRUE	0.0029149858502683936	89	37	5	0.13513513513513514	0.056179775280898875	KEGG:05235	KEGG	PD-L1 expression and PD-1 checkpoint pathway in cancer	8484	480		0.9090909090909091	0.9130434782608695	89	8395	5	32	84	8363	8484	0.08096905818050912
M1	cpdb	0	network_modules	79	TRUE	0.0030014099828426957	373	38	8	0.21052631578947367	0.021447721179624665	GO:0045785	GO:BP	positive regulation of cell adhesion	16175	11617		0.8721804511278195	0.8731343283582089	373	15802	8	30	365	15772	16175	0.06060896160473909
M1	cpdb	0	network_modules	79	TRUE	0.0031267607755353184	12	38	3	0.07894736842105263	0.25	REAC:R-HSA-9027284	REAC	Erythropoietin activates RAS	10916	859		0.8448275862068966	0.864406779661017	12	10904	3	35	9	10869	10916	0.13884974094882474
M1	cpdb	0	network_modules	79	TRUE	0.0031267607755353184	12	38	3	0.07894736842105263	0.25	REAC:R-HSA-9027276	REAC	Erythropoietin activates Phosphoinositide-3-kinase (PI3K)	10916	857		0.8448275862068966	0.864406779661017	12	10904	3	35	9	10869	10916	0.13884974094882474
M1	cpdb	0	network_modules	79	TRUE	0.0031355489526159503	510	38	9	0.23684210526315788	0.01764705882352941	GO:0048871	GO:BP	multicellular organismal-level homeostasis	16175	13114		0.8796992481203008	0.8805970149253731	510	15665	9	29	501	15636	16175	0.057014938802391814
M1	cpdb	0	network_modules	79	TRUE	0.003678342536025102	520	38	9	0.23684210526315788	0.01730769230769231	GO:0033993	GO:BP	response to lipid	16175	8371		0.8872180451127819	0.8880597014925373	520	15655	9	29	511	15626	16175	0.0563120083172107
M1	cpdb	0	network_modules	79	TRUE	0.0037961340726165795	522	38	9	0.23684210526315788	0.017241379310344827	GO:0042327	GO:BP	positive regulation of phosphorylation	16175	10095		0.8947368421052632	0.8955223880597015	522	15653	9	29	513	15624	16175	0.056173665026995376
M1	cpdb	0	network_modules	79	TRUE	0.004055019359284281	13	38	3	0.07894736842105263	0.23076923076923078	REAC:R-HSA-1433559	REAC	Regulation of KIT signaling	10916	1982		0.8793103448275862	0.8813559322033898	13	10903	3	35	10	10868	10916	0.13325164338745266
M1	cpdb	0	network_modules	79	TRUE	0.00463583266534478	98	37	5	0.13513513513513514	0.05102040816326531	KEGG:04061	KEGG	Viral protein interaction with cytokine and cytokine receptor	8484	254		0.9545454545454546	0.9565217391304348	98	8386	5	32	93	8354	8484	0.07654590912193072
M1	cpdb	0	network_modules	79	TRUE	0.004715820221839013	536	38	9	0.23684210526315788	0.016791044776119403	GO:0002252	GO:BP	immune effector process	16175	784		0.9022556390977443	0.9029850746268657	536	15639	9	29	527	15610	16175	0.05522535640766634
M1	cpdb	0	network_modules	79	TRUE	0.005215632760766706	43	38	4	0.10526315789473684	0.09302325581395349	REAC:R-HSA-2428924	REAC	IGF1R signaling cascade	10916	1142		0.896551724137931	0.9152542372881356	43	10873	4	34	39	10839	10916	0.0956057785946183
M1	cpdb	0	network_modules	79	TRUE	0.005215632760766706	43	38	4	0.10526315789473684	0.09302325581395349	REAC:R-HSA-2428928	REAC	IRS-related events triggered by IGF1R	10916	1165		0.896551724137931	0.9152542372881356	43	10873	4	34	39	10839	10916	0.0956057785946183
M1	cpdb	0	network_modules	79	TRUE	0.005282297070360042	100	38	5	0.13157894736842105	0.05	GO:0002286	GO:BP	T cell activation involved in immune response	16175	818		0.9097744360902256	0.9104477611940298	100	16075	5	33	95	16042	16175	0.07763093998373859
M1	cpdb	0	network_modules	79	TRUE	0.005455111646941497	45	38	4	0.10526315789473684	0.08888888888888889	GO:0046626	GO:BP	regulation of insulin receptor signaling pathway	16175	12263		0.9172932330827067	0.9253731343283582	45	16130	4	34	41	16096	16175	0.09441586361662485
M1	cpdb	0	network_modules	79	TRUE	0.005455111646941497	45	38	4	0.10526315789473684	0.08888888888888889	GO:1900076	GO:BP	regulation of cellular response to insulin stimulus	16175	20373		0.9172932330827067	0.9253731343283582	45	16130	4	34	41	16096	16175	0.09441586361662485
M1	cpdb	0	network_modules	79	TRUE	0.005722911515717479	44	38	4	0.10526315789473684	0.09090909090909091	REAC:R-HSA-2404192	REAC	Signaling by Type 1 Insulin-like Growth Factor 1 Receptor (IGF1R)	10916	2312		0.9310344827586207	0.9322033898305084	44	10872	4	34	40	10838	10916	0.09443199701826031
M1	cpdb	0	network_modules	79	TRUE	0.006256053811345623	248	37	7	0.1891891891891892	0.028225806451612902	KEGG:04144	KEGG	Endocytosis	8484	280		1	1	248	8236	7	30	241	8206	8484	0.06284509710824718
M1	cpdb	0	network_modules	79	TRUE	0.006265605736788597	45	38	4	0.10526315789473684	0.08888888888888889	REAC:R-HSA-74751	REAC	Insulin receptor signalling cascade	10916	1211		0.9482758620689655	0.9661016949152542	45	10871	4	34	41	10837	10916	0.09329664865382195
M1	cpdb	0	network_modules	79	TRUE	0.006265605736788597	45	38	4	0.10526315789473684	0.08888888888888889	REAC:R-HSA-6783783	REAC	Interleukin-10 signaling	10916	1234		0.9482758620689655	0.9661016949152542	45	10871	4	34	41	10837	10916	0.09329664865382195
M1	cpdb	0	network_modules	79	TRUE	0.006408448527000135	104	38	5	0.13157894736842105	0.04807692307692308	GO:0050671	GO:BP	positive regulation of lymphocyte proliferation	16175	13205		0.9323308270676691	0.9328358208955224	104	16071	5	33	99	16038	16175	0.07598273035584699
M1	cpdb	0	network_modules	79	TRUE	0.006420198016733701	15	38	3	0.07894736842105263	0.2	REAC:R-HSA-9703648	REAC	Signaling by FLT3 ITD and TKD mutants	10916	2254		0.9827586206896551	0.9830508474576272	15	10901	3	35	12	10866	10916	0.12376958149364892
M1	cpdb	0	network_modules	79	TRUE	0.006480890017208707	14	38	3	0.07894736842105263	0.21428571428571427	GO:0045725	GO:BP	positive regulation of glycogen biosynthetic process	16175	11567		0.9398496240601504	0.9402985074626866	14	16161	3	35	11	16126	16175	0.1288476693809798
M1	cpdb	0	network_modules	79	TRUE	0.006717423784417814	105	38	5	0.13157894736842105	0.047619047619047616	GO:0032946	GO:BP	positive regulation of mononuclear cell proliferation	16175	7931		0.9473684210526315	0.9477611940298507	105	16070	5	33	100	16037	16175	0.07558503751683944
M1	cpdb	0	network_modules	79	TRUE	0.00714473737839947	564	38	9	0.23684210526315788	0.015957446808510637	GO:0010562	GO:BP	positive regulation of phosphorus metabolic process	16175	4215		0.9548872180451128	0.9626865671641791	564	15611	9	29	555	15582	16175	0.0534274103849666
M1	cpdb	0	network_modules	79	TRUE	0.00714473737839947	564	38	9	0.23684210526315788	0.015957446808510637	GO:0045937	GO:BP	positive regulation of phosphate metabolic process	16175	11731		0.9548872180451128	0.9626865671641791	564	15611	9	29	555	15582	16175	0.0534274103849666
M1	cpdb	0	network_modules	79	TRUE	0.0074270498477009015	190	38	6	0.15789473684210525	0.031578947368421054	GO:0070663	GO:BP	regulation of leukocyte proliferation	16175	16244		0.9699248120300752	0.9701492537313433	190	15985	6	32	184	15953	16175	0.06582412293128996
M1	cpdb	0	network_modules	79	TRUE	0.00770533819501843	49	38	4	0.10526315789473684	0.08163265306122448	GO:0010827	GO:BP	regulation of D-glucose transmembrane transport	16175	4437		0.9774436090225563	0.9776119402985075	49	16126	4	34	45	16092	16175	0.09027298190761329
M1	cpdb	0	network_modules	79	TRUE	0.007882795445205195	16	38	3	0.07894736842105263	0.1875	REAC:R-HSA-1839117	REAC	Signaling by cytosolic FGFR1 fusion mutants	10916	2318		1	1	16	10900	3	35	13	10865	10916	0.11970335052489056
M1	cpdb	0	network_modules	79	TRUE	0.008087971561124991	15	38	3	0.07894736842105263	0.2	GO:0070875	GO:BP	positive regulation of glycogen metabolic process	16175	16351		0.9849624060150376	0.9850746268656716	15	16160	3	35	12	16125	16175	0.1243839630022159
M1	cpdb	0	network_modules	79	TRUE	0.008361292427594808	50	38	4	0.10526315789473684	0.08	GO:0046323	GO:BP	D-glucose import	16175	12056		0.9924812030075187	0.9925373134328358	50	16125	4	34	46	16091	16175	0.08931441995969656
M1	cpdb	0	network_modules	79	TRUE	0.009938280245601163	16	38	3	0.07894736842105263	0.1875	GO:0034112	GO:BP	positive regulation of homotypic cell-cell adhesion	16175	8420		1	1	16	16159	3	35	13	16124	16175	0.12034254458480281
M1	cpdb	0	network_modules	80	TRUE	1.5169692822641489e-7	105	38	8	0.21052631578947367	0.0761904761904762	GO:0006470	GO:BP	protein dephosphorylation	16175	2209		0	0.06666666666666667	105	16070	8	30	97	16040	16175	0.12328958255819515
M1	cpdb	0	network_modules	80	TRUE	2.9612038221131496e-7	174	38	9	0.23684210526315788	0.05172413793103448	GO:0016311	GO:BP	dephosphorylation	16175	5199		0.07142857142857142	0.13333333333333333	174	16001	9	29	165	15972	16175	0.1063525229059658
M1	cpdb	0	network_modules	80	TRUE	4.481690084053301e-5	39	38	5	0.13157894736842105	0.1282051282051282	GO:0035337	GO:BP	fatty-acyl-CoA metabolic process	16175	8981		0.14285714285714285	0.2	39	16136	5	33	34	16103	16175	0.12780527198177175
M1	cpdb	0	network_modules	80	TRUE	1.4592628369271832e-4	49	38	5	0.13157894736842105	0.10204081632653061	GO:1901570	GO:BP	fatty acid derivative biosynthetic process	16175	21572		0.21428571428571427	0.26666666666666666	49	16126	5	33	44	16093	16175	0.11350996402600733
M1	cpdb	0	network_modules	80	TRUE	1.7513930854266743e-4	7	28	3	0.10714285714285714	0.42857142857142855	REAC:R-HSA-9652817	REAC	Signaling by MAPK mutants	10916	2269		0	0.25	7	10909	3	25	4	10884	10916	0.21334531690152742
M1	cpdb	0	network_modules	80	TRUE	4.0303814807734654e-4	24	38	4	0.10526315789473684	0.16666666666666666	GO:0035336	GO:BP	long-chain fatty-acyl-CoA metabolic process	16175	8980		0.2857142857142857	0.3333333333333333	24	16151	4	34	20	16117	16175	0.13083696409617954
M1	cpdb	0	network_modules	80	TRUE	5.651397961705433e-4	26	38	4	0.10526315789473684	0.15384615384615385	GO:0046949	GO:BP	fatty-acyl-CoA biosynthetic process	16175	12443		0.35714285714285715	0.4	26	16149	4	34	22	16115	16175	0.12556209384511519
M1	cpdb	0	network_modules	80	TRUE	8.024869390644554e-4	38	28	4	0.14285714285714285	0.10526315789473684	REAC:R-HSA-75105	REAC	Fatty acyl-CoA biosynthesis	10916	937		0.3333333333333333	0.5	38	10878	4	24	34	10854	10916	0.12000247458747305
M1	cpdb	0	network_modules	80	TRUE	9.597342907176642e-4	71	38	5	0.13157894736842105	0.07042253521126761	GO:1901568	GO:BP	fatty acid derivative metabolic process	16175	21570		0.42857142857142855	0.4666666666666667	71	16104	5	33	66	16071	16175	0.09336406396660395
M1	cpdb	0	network_modules	80	TRUE	0.001528744882724011	33	38	4	0.10526315789473684	0.12121212121212122	GO:0000038	GO:BP	very long-chain fatty acid metabolic process	16175	15		0.5	0.5333333333333333	33	16142	4	34	29	16108	16175	0.11101084479136392
M1	cpdb	0	network_modules	80	TRUE	0.0018564788587505045	625	38	10	0.2631578947368421	0.016	GO:0008610	GO:BP	lipid biosynthetic process	16175	3206		0.5714285714285714	0.6	625	15550	10	28	615	15522	16175	0.05652891935054341
M1	cpdb	0	network_modules	80	TRUE	0.002805371677771421	88	38	5	0.13157894736842105	0.056818181818181816	GO:0006637	GO:BP	acyl-CoA metabolic process	16175	2348		0.6428571428571429	0.7333333333333333	88	16087	5	33	83	16054	16175	0.08321341027899438
M1	cpdb	0	network_modules	80	TRUE	0.002805371677771421	88	38	5	0.13157894736842105	0.056818181818181816	GO:0035383	GO:BP	thioester metabolic process	16175	9012		0.6428571428571429	0.7333333333333333	88	16087	5	33	83	16054	16175	0.08321341027899438
M1	cpdb	0	network_modules	80	TRUE	0.0032381857075378545	512	38	9	0.23684210526315788	0.017578125	GO:0090407	GO:BP	organophosphate biosynthetic process	16175	18274		0.7857142857142857	0.8	512	15663	9	29	503	15634	16175	0.05687283352970496
M1	cpdb	0	network_modules	80	TRUE	0.00411879441579148	42	38	4	0.10526315789473684	0.09523809523809523	GO:0035384	GO:BP	thioester biosynthetic process	16175	9013		0.8571428571428571	0.9333333333333333	42	16133	4	34	38	16099	16175	0.09789747241120611
M1	cpdb	0	network_modules	80	TRUE	0.00411879441579148	42	38	4	0.10526315789473684	0.09523809523809523	GO:0071616	GO:BP	acyl-CoA biosynthetic process	16175	16800		0.8571428571428571	0.9333333333333333	42	16133	4	34	38	16099	16175	0.09789747241120611
M1	cpdb	0	network_modules	80	TRUE	0.00413535160827261	27	25	3	0.12	0.1111111111111111	KEGG:01040	KEGG	Biosynthesis of unsaturated fatty acids	8484	164		0	1	27	8457	3	22	24	8435	8484	0.11275327279651272
M1	cpdb	0	network_modules	80	TRUE	0.00413535160827261	27	25	3	0.12	0.1111111111111111	KEGG:00062	KEGG	Fatty acid elongation	8484	10		0	1	27	8457	3	22	24	8435	8484	0.11275327279651272
M1	cpdb	0	network_modules	80	TRUE	0.006480890017208707	14	38	3	0.07894736842105263	0.21428571428571427	GO:0030497	GO:BP	fatty acid elongation	16175	6820		1	1	14	16161	3	35	11	16126	16175	0.1288476693809798
M1	cpdb	0	network_modules	80	TRUE	0.0075099873481305314	22	28	3	0.10714285714285714	0.13636363636363635	REAC:R-HSA-112409	REAC	RAF-independent MAPK1/3 activation	10916	1840		0.6666666666666666	0.75	22	10894	3	25	19	10869	10916	0.11887202489388837
M1	cpdb	0	network_modules	80	TRUE	0.009836409163664104	24	28	3	0.10714285714285714	0.125	REAC:R-HSA-75876	REAC	Synthesis of very long-chain fatty acyl-CoAs	10916	2412		1	1	24	10892	3	25	21	10867	10916	0.11362337779738162
M1	cpdb	0	network_modules	81	TRUE	1.7882370137401463e-60	66	35	28	0.8	0.42424242424242425	GO:0060260	GO:BP	regulation of transcription initiation by RNA polymerase II	16175	14477		0	0.0625	66	16109	28	7	38	16102	16175	0.5814193794259495
M1	cpdb	0	network_modules	81	TRUE	4.0541472196787536e-60	55	35	27	0.7714285714285715	0.4909090909090909	GO:0060261	GO:BP	positive regulation of transcription initiation by RNA polymerase II	16175	14478		0.06666666666666667	0.125	55	16120	27	8	28	16112	16175	0.6143839822322613
M1	cpdb	0	network_modules	81	TRUE	3.947974549447902e-59	72	35	28	0.8	0.3888888888888889	GO:2000142	GO:BP	regulation of DNA-templated transcription initiation	16175	25490		0.13333333333333333	0.1875	72	16103	28	7	44	16096	16175	0.5565108866049927
M1	cpdb	0	network_modules	81	TRUE	1.6689845649972346e-58	61	35	27	0.7714285714285715	0.4426229508196721	GO:2000144	GO:BP	positive regulation of DNA-templated transcription initiation	16175	25492		0.2	0.25	61	16114	27	8	34	16106	16175	0.5832131992784194
M1	cpdb	0	network_modules	81	TRUE	4.3147620536614244e-58	83	36	30	0.8333333333333334	0.3614457831325301	REAC:R-HSA-9843745	REAC	Adipogenesis	10916	122		0	0.5	83	10833	30	6	53	10827	10916	0.5467954327834014
M1	cpdb	0	network_modules	81	TRUE	4.3147620536614244e-58	83	36	30	0.8333333333333334	0.3614457831325301	REAC:R-HSA-381340	REAC	Transcriptional regulation of white adipocyte differentiation	10916	2562		0	0.5	83	10833	30	6	53	10827	10916	0.5467954327834014
M1	cpdb	0	network_modules	81	TRUE	9.507126941997463e-56	48	35	25	0.7142857142857143	0.5208333333333334	GO:0032968	GO:BP	positive regulation of transcription elongation by RNA polymerase II	16175	7952		0.26666666666666666	0.3125	48	16127	25	10	23	16117	16175	0.608965989665764
M1	cpdb	0	network_modules	81	TRUE	1.136238264672826e-54	64	35	26	0.7428571428571429	0.40625	GO:0051123	GO:BP	RNA polymerase II preinitiation complex assembly	16175	13507		0.3333333333333333	0.375	64	16111	26	9	38	16102	16175	0.5481017940876785
M1	cpdb	0	network_modules	81	TRUE	5.0979084631696724e-54	67	35	26	0.7428571428571429	0.3880597014925373	GO:0070897	GO:BP	transcription preinitiation complex assembly	16175	16360		0.4	0.4375	67	16108	26	9	41	16099	16175	0.5356057388424886
M1	cpdb	0	network_modules	81	TRUE	2.601451941773482e-53	113	36	30	0.8333333333333334	0.26548672566371684	REAC:R-HSA-1989781	REAC	PPARA activates gene expression	10916	1700		0.6666666666666666	0.75	113	10803	30	6	83	10797	10916	0.4677125487888661
M1	cpdb	0	network_modules	81	TRUE	3.0330198749261404e-53	57	35	25	0.7142857142857143	0.43859649122807015	GO:0032786	GO:BP	positive regulation of DNA-templated transcription, elongation	16175	7821		0.4666666666666667	0.5	57	16118	25	10	32	16108	16175	0.5585442629905625
M1	cpdb	0	network_modules	81	TRUE	3.528644851760036e-53	114	36	30	0.8333333333333334	0.2631578947368421	REAC:R-HSA-400206	REAC	Regulation of lipid metabolism by PPARalpha	10916	2041		1	1	114	10802	30	6	84	10796	10916	0.46562637709271215
M1	cpdb	0	network_modules	81	TRUE	2.19190354596753e-49	143	35	28	0.8	0.1958041958041958	GO:0006367	GO:BP	transcription initiation at RNA polymerase II promoter	16175	2142		0.5333333333333333	0.5625	143	16032	28	7	115	16025	16175	0.3935759533498198
M1	cpdb	0	network_modules	81	TRUE	1.5827924587905854e-48	81	35	25	0.7142857142857143	0.30864197530864196	GO:0034243	GO:BP	regulation of transcription elongation by RNA polymerase II	16175	8519		0.6	0.625	81	16094	25	10	56	16084	16175	0.4679166718414638
M1	cpdb	0	network_modules	81	TRUE	3.128213798955233e-48	103	35	26	0.7428571428571429	0.2524271844660194	GO:0006368	GO:BP	transcription elongation by RNA polymerase II	16175	2143		0.6666666666666666	0.6875	103	16072	26	9	77	16063	16175	0.43116093848436315
M1	cpdb	0	network_modules	81	TRUE	7.536670872248158e-47	173	35	28	0.8	0.16184971098265896	GO:0006352	GO:BP	DNA-templated transcription initiation	16175	2129		0.7333333333333333	0.75	173	16002	28	7	145	15995	16175	0.35732296642852013
M1	cpdb	0	network_modules	81	TRUE	1.713311133028829e-46	118	35	26	0.7428571428571429	0.22033898305084745	GO:0006354	GO:BP	DNA-templated transcription elongation	16175	2131		0.8	0.8125	118	16057	26	9	92	16048	16175	0.40250620992591607
M1	cpdb	0	network_modules	81	TRUE	2.2433297314833386e-46	96	35	25	0.7142857142857143	0.2604166666666667	GO:0032784	GO:BP	regulation of DNA-templated transcription elongation	16175	7819		0.8666666666666667	0.875	96	16079	25	10	71	16069	16175	0.4294471216553745
M1	cpdb	0	network_modules	81	TRUE	4.534825700084253e-41	183	35	26	0.7428571428571429	0.14207650273224043	GO:0065004	GO:BP	protein-DNA complex assembly	16175	15888		0.9333333333333333	0.9375	183	15992	26	9	157	15983	16175	0.3220992396872523
M1	cpdb	0	network_modules	81	TRUE	1.2091114388421464e-39	206	35	26	0.7428571428571429	0.1262135922330097	GO:0071824	GO:BP	protein-DNA complex organization	16175	16927		1	1	206	15969	26	9	180	15960	16175	0.30321394935745327
M1	cpdb	0	network_modules	81	TRUE	2.0818104960689622e-19	121	14	12	0.8571428571428571	0.09917355371900827	KEGG:04919	KEGG	Thyroid hormone signaling pathway	8484	376		NA	1	121	8363	12	2	109	8361	8484	0.2890116551465302
M1	cpdb	0	network_modules	82	TRUE	2.5813091340877734e-15	18	29	8	0.27586206896551724	0.4444444444444444	GO:0048490	GO:BP	anterograde synaptic vesicle transport	16175	12783		0	0.075	18	16157	8	21	10	16136	16175	0.34924540414705024
M1	cpdb	0	network_modules	82	TRUE	2.5813091340877734e-15	18	29	8	0.27586206896551724	0.4444444444444444	GO:0099514	GO:BP	synaptic vesicle cytoskeletal transport	16175	19104		0	0.075	18	16157	8	21	10	16136	16175	0.34924540414705024
M1	cpdb	0	network_modules	82	TRUE	2.5813091340877734e-15	18	29	8	0.27586206896551724	0.4444444444444444	GO:0099517	GO:BP	synaptic vesicle transport along microtubule	16175	19106		0	0.075	18	16157	8	21	10	16136	16175	0.34924540414705024
M1	cpdb	0	network_modules	82	TRUE	3.9204843033734133e-13	54	29	9	0.3103448275862069	0.16666666666666666	GO:0098930	GO:BP	axonal transport	16175	18959		0.07692307692307693	0.1	54	16121	9	20	45	16101	16175	0.22556166553157933
M1	cpdb	0	network_modules	82	TRUE	8.049534604385496e-13	33	29	8	0.27586206896551724	0.24242424242424243	GO:0048489	GO:BP	synaptic vesicle transport	16175	12782		0.10256410256410256	0.125	33	16142	8	21	25	16121	16175	0.25718363259902527
M1	cpdb	0	network_modules	82	TRUE	1.268515260014556e-12	61	29	9	0.3103448275862069	0.14754098360655737	GO:0008088	GO:BP	axo-dendritic transport	16175	3119		0.1282051282051282	0.15	61	16114	9	20	52	16094	16175	0.21197221415431164
M1	cpdb	0	network_modules	82	TRUE	3.5422585873003747e-12	39	29	8	0.27586206896551724	0.20512820512820512	GO:0032438	GO:BP	melanosome organization	16175	7566		0.15384615384615385	0.2	39	16136	8	21	31	16115	16175	0.2362979695170924
M1	cpdb	0	network_modules	82	TRUE	3.5422585873003747e-12	39	29	8	0.27586206896551724	0.20512820512820512	GO:0048753	GO:BP	pigment granule organization	16175	13004		0.15384615384615385	0.2	39	16136	8	21	31	16115	16175	0.2362979695170924
M1	cpdb	0	network_modules	82	TRUE	4.422704271324024e-12	40	29	8	0.27586206896551724	0.2	GO:0097479	GO:BP	synaptic vesicle localization	16175	18670		0.20512820512820512	0.225	40	16135	8	21	32	16114	16175	0.2332800264013632
M1	cpdb	0	network_modules	82	TRUE	6.772100287452214e-12	42	29	8	0.27586206896551724	0.19047619047619047	GO:0008089	GO:BP	anterograde axonal transport	16175	3120		0.23076923076923078	0.275	42	16133	8	21	34	16112	16175	0.2275691348169675
M1	cpdb	0	network_modules	82	TRUE	6.772100287452214e-12	42	29	8	0.27586206896551724	0.19047619047619047	GO:0047496	GO:BP	vesicle transport along microtubule	16175	12458		0.23076923076923078	0.275	42	16133	8	21	34	16112	16175	0.2275691348169675
M1	cpdb	0	network_modules	82	TRUE	7.0068079051984425e-12	73	29	9	0.3103448275862069	0.1232876712328767	GO:0072384	GO:BP	organelle transport along microtubule	16175	17378		0.28205128205128205	0.3	73	16102	9	20	64	16082	16175	0.1933712736085766
M1	cpdb	0	network_modules	82	TRUE	1.0796053466674785e-10	58	29	8	0.27586206896551724	0.13793103448275862	GO:0033059	GO:BP	cellular pigmentation	16175	8013		0.3076923076923077	0.325	58	16117	8	21	50	16096	16175	0.19304765758761483
M1	cpdb	0	network_modules	82	TRUE	3.6355327352031576e-10	67	29	8	0.27586206896551724	0.11940298507462686	GO:0099518	GO:BP	vesicle cytoskeletal trafficking	16175	19107		0.3333333333333333	0.35	67	16108	8	21	59	16087	16175	0.17929740635722874
M1	cpdb	0	network_modules	82	TRUE	1.7639791460099672e-9	81	29	8	0.27586206896551724	0.09876543209876543	GO:0043473	GO:BP	pigmentation	16175	10719		0.358974358974359	0.375	81	16094	8	21	73	16073	16175	0.16261930726902116
M1	cpdb	0	network_modules	82	TRUE	3.789660964470042e-9	144	29	9	0.3103448275862069	0.0625	GO:0010970	GO:BP	transport along microtubule	16175	4546		0.38461538461538464	0.4	144	16031	9	20	135	16011	16175	0.13600451057278035
M1	cpdb	0	network_modules	82	TRUE	1.3026153870675049e-8	165	29	9	0.3103448275862069	0.05454545454545454	GO:0099111	GO:BP	microtubule-based transport	16175	19044		0.41025641025641024	0.425	165	16010	9	20	156	15990	16175	0.12659096131210718
M1	cpdb	0	network_modules	82	TRUE	1.674302840495909e-8	54	15	6	0.4	0.1111111111111111	REAC:R-HSA-432722	REAC	Golgi Associated Vesicle Biogenesis	10916	1082		0	0.5	54	10862	6	9	48	10853	10916	0.20887175601658614
M1	cpdb	0	network_modules	82	TRUE	3.654656943017689e-8	185	29	9	0.3103448275862069	0.04864864864864865	GO:0030705	GO:BP	cytoskeleton-dependent intracellular transport	16175	6886		0.4358974358974359	0.45	185	15990	9	20	176	15970	16175	0.1191344653694037
M1	cpdb	0	network_modules	82	TRUE	9.999920093039745e-8	72	15	6	0.4	0.08333333333333333	REAC:R-HSA-199992	REAC	trans-Golgi Network Vesicle Budding	10916	2749		1	1	72	10844	6	9	66	10835	10916	0.18028265746696417
M1	cpdb	0	network_modules	82	TRUE	1.0441255950271805e-6	178	29	8	0.27586206896551724	0.0449438202247191	GO:0051650	GO:BP	establishment of vesicle localization	16175	13863		0.46153846153846156	0.475	178	15997	8	21	170	15976	16175	0.10759540010523112
M1	cpdb	0	network_modules	82	TRUE	1.4807284011985683e-6	186	29	8	0.27586206896551724	0.043010752688172046	GO:0051648	GO:BP	vesicle localization	16175	13861		0.48717948717948717	0.5	186	15989	8	21	178	15968	16175	0.10508581638710551
M1	cpdb	0	network_modules	82	TRUE	9.846315892445616e-6	348	29	9	0.3103448275862069	0.02586206896551724	GO:0007018	GO:BP	microtubule-based movement	16175	2626		0.5128205128205128	0.525	348	15827	9	20	339	15807	16175	0.08436540748255038
M1	cpdb	0	network_modules	82	TRUE	4.078636153870709e-5	410	29	9	0.3103448275862069	0.02195121951219512	GO:0051656	GO:BP	establishment of organelle localization	16175	13869		0.5384615384615384	0.55	410	15765	9	20	401	15745	16175	0.07684441194097254
M1	cpdb	0	network_modules	82	TRUE	9.180137484904514e-5	315	29	8	0.27586206896551724	0.025396825396825397	GO:0016050	GO:BP	vesicle organization	16175	5082		0.5641025641025641	0.575	315	15860	8	21	307	15839	16175	0.07863228826962368
M1	cpdb	0	network_modules	82	TRUE	1.3928554177576374e-4	24	29	4	0.13793103448275862	0.16666666666666666	GO:0060155	GO:BP	platelet dense granule organization	16175	14393		0.5897435897435898	0.6	24	16151	4	25	20	16126	16175	0.15023472075636082
M1	cpdb	0	network_modules	82	TRUE	3.063752291275162e-4	519	29	9	0.3103448275862069	0.017341040462427744	GO:0051640	GO:BP	organelle localization	16175	13853		0.6153846153846154	0.625	519	15656	9	20	510	15636	16175	0.06691674633860807
M1	cpdb	0	network_modules	82	TRUE	4.6520466850329475e-4	8	29	3	0.10344827586206896	0.375	GO:0062196	GO:BP	regulation of lysosome size	16175	15860		0.6410256410256411	0.65	8	16167	3	26	5	16141	16175	0.196242469013387
M1	cpdb	0	network_modules	82	TRUE	6.969657264544413e-4	9	29	3	0.10344827586206896	0.3333333333333333	GO:0035646	GO:BP	endosome to melanosome transport	16175	9136		0.6666666666666666	0.725	9	16166	3	26	6	16140	16175	0.18491378886285995
M1	cpdb	0	network_modules	82	TRUE	6.969657264544413e-4	9	29	3	0.10344827586206896	0.3333333333333333	GO:0048757	GO:BP	pigment granule maturation	16175	13008		0.6666666666666666	0.725	9	16166	3	26	6	16140	16175	0.18491378886285995
M1	cpdb	0	network_modules	82	TRUE	6.969657264544413e-4	9	29	3	0.10344827586206896	0.3333333333333333	GO:0043485	GO:BP	endosome to pigment granule transport	16175	10731		0.6666666666666666	0.725	9	16166	3	26	6	16140	16175	0.18491378886285995
M1	cpdb	0	network_modules	82	TRUE	9.944649866122962e-4	10	29	3	0.10344827586206896	0.3	GO:0051036	GO:BP	regulation of endosome size	16175	13449		0.7435897435897436	0.75	10	16165	3	26	7	16139	16175	0.1753246398155495
M1	cpdb	0	network_modules	82	TRUE	0.0013657409346240256	11	29	3	0.10344827586206896	0.2727272727272727	GO:0043482	GO:BP	cellular pigment accumulation	16175	10728		0.7692307692307693	0.8	11	16164	3	26	8	16138	16175	0.16707014900356779
M1	cpdb	0	network_modules	82	TRUE	0.0013657409346240256	11	29	3	0.10344827586206896	0.2727272727272727	GO:0043476	GO:BP	pigment accumulation	16175	10722		0.7692307692307693	0.8	11	16164	3	26	8	16138	16175	0.16707014900356779
M1	cpdb	0	network_modules	82	TRUE	0.0030947135042159474	684	29	9	0.3103448275862069	0.013157894736842105	GO:0031175	GO:BP	neuron projection development	16175	7086		0.8205128205128205	0.825	684	15491	9	20	675	15471	16175	0.0564508845241248
M1	cpdb	0	network_modules	82	TRUE	0.003427803668950228	52	29	4	0.13793103448275862	0.07692307692307693	GO:0033363	GO:BP	secretory granule organization	16175	8173		0.8461538461538461	0.85	52	16123	4	25	48	16098	16175	0.10085699607431889
M1	cpdb	0	network_modules	82	TRUE	0.004607372357850566	16	29	3	0.10344827586206896	0.1875	GO:0097494	GO:BP	regulation of vesicle size	16175	18677		0.8717948717948718	0.875	16	16159	3	26	13	16133	16175	0.1381319357800513
M1	cpdb	0	network_modules	82	TRUE	0.006697425953667751	18	29	3	0.10344827586206896	0.16666666666666666	GO:0032402	GO:BP	melanosome transport	16175	7546		0.8974358974358975	0.925	18	16157	3	26	15	16131	16175	0.13008292443451058
M1	cpdb	0	network_modules	82	TRUE	0.006697425953667751	18	29	3	0.10344827586206896	0.16666666666666666	GO:0051904	GO:BP	pigment granule transport	16175	13987		0.8974358974358975	0.925	18	16157	3	26	15	16131	16175	0.13008292443451058
M1	cpdb	0	network_modules	82	TRUE	0.007437927755408664	761	29	9	0.3103448275862069	0.011826544021024968	GO:0048666	GO:BP	neuron development	16175	12924		0.9487179487179487	0.95	761	15414	9	20	752	15394	16175	0.052699510062514006
M1	cpdb	0	network_modules	82	TRUE	0.007943607957187633	19	29	3	0.10344827586206896	0.15789473684210525	GO:0032401	GO:BP	establishment of melanosome localization	16175	7545		0.9743589743589743	1	19	16156	3	26	16	16130	16175	0.12654084640823748
M1	cpdb	0	network_modules	82	TRUE	0.007943607957187633	19	29	3	0.10344827586206896	0.15789473684210525	GO:0051905	GO:BP	establishment of pigment granule localization	16175	13988		0.9743589743589743	1	19	16156	3	26	16	16130	16175	0.12654084640823748
M1	cpdb	0	network_modules	83	TRUE	1.6688399990059476e-14	250	32	14	0.4375	0.056	GO:0007389	GO:BP	pattern specification process	16175	2889		0	0.1	250	15925	14	18	236	15907	16175	0.1523264116932892
M1	cpdb	0	network_modules	83	TRUE	1.6122936783903728e-8	225	32	10	0.3125	0.044444444444444446	GO:0003002	GO:BP	regionalization	16175	1453		0.1111111111111111	0.2	225	15950	10	22	215	15928	16175	0.11350899908320124
M1	cpdb	0	network_modules	83	TRUE	4.055676361333915e-7	120	12	6	0.5	0.05	REAC:R-HSA-5617472	REAC	Activation of anterior HOX genes in hindbrain development during early embryogenesis	10916	99		0	1	120	10796	6	6	114	10790	10916	0.1555801586782736
M1	cpdb	0	network_modules	83	TRUE	4.055676361333915e-7	120	12	6	0.5	0.05	REAC:R-HSA-5619507	REAC	Activation of HOX genes during differentiation	10916	84		0	1	120	10796	6	6	114	10790	10916	0.1555801586782736
M1	cpdb	0	network_modules	83	TRUE	4.719044470088676e-7	192	14	7	0.5	0.036458333333333336	KEGG:05202	KEGG	Transcriptional misregulation in cancer	8484	454		NA	1	192	8292	7	7	185	8285	8484	0.130495962459384
M1	cpdb	0	network_modules	83	TRUE	1.1331881834990913e-6	99	32	7	0.21875	0.0707070707070707	GO:0009952	GO:BP	anterior/posterior pattern specification	16175	3790		0.2222222222222222	0.3	99	16076	7	25	92	16051	16175	0.1213791136411842
M1	cpdb	0	network_modules	83	TRUE	2.9845679130276774e-6	512	32	11	0.34375	0.021484375	GO:0009790	GO:BP	embryo development	16175	3677		0.3333333333333333	0.4	512	15663	11	21	501	15642	16175	0.07936759125515279
M1	cpdb	0	network_modules	83	TRUE	5.520228888322624e-6	543	32	11	0.34375	0.020257826887661142	GO:0009887	GO:BP	animal organ morphogenesis	16175	3747		0.4444444444444444	0.5	543	15632	11	21	532	15611	16175	0.07667138426891325
M1	cpdb	0	network_modules	83	TRUE	2.183685663875761e-4	211	32	7	0.21875	0.03317535545023697	GO:0048568	GO:BP	embryonic organ development	16175	12840		0.5555555555555556	0.6	211	15964	7	25	204	15939	16175	0.08071612258674878
M1	cpdb	0	network_modules	83	TRUE	3.8142262539958815e-4	71	32	5	0.15625	0.07042253521126761	GO:0045638	GO:BP	negative regulation of myeloid cell differentiation	16175	11489		0.6666666666666666	0.7	71	16104	5	27	66	16077	16175	0.10227652269538585
M1	cpdb	0	network_modules	83	TRUE	0.003282794653942902	199	32	6	0.1875	0.03015075376884422	GO:0001654	GO:BP	eye development	16175	368		0.7777777777777778	0.8	199	15976	6	26	193	15950	16175	0.07076091063470845
M1	cpdb	0	network_modules	83	TRUE	0.0035803313700408885	202	32	6	0.1875	0.0297029702970297	GO:0150063	GO:BP	visual system development	16175	20119		0.8888888888888888	0.9	202	15973	6	26	196	15947	16175	0.07016572869602805
M1	cpdb	0	network_modules	83	TRUE	0.0042416115299482166	208	32	6	0.1875	0.028846153846153848	GO:0048880	GO:BP	sensory system development	16175	13120		1	1	208	15967	6	26	202	15941	16175	0.06901272276366825
M1	cpdb	0	network_modules	85	TRUE	2.810782195033779e-26	84	23	16	0.6956521739130435	0.19047619047619047	KEGG:03083	KEGG	Polycomb repressive complex	8484	220		NA	1	84	8400	16	7	68	8393	8484	0.36111124309137854
M1	cpdb	0	network_modules	85	TRUE	5.6497009994933e-5	36	16	4	0.25	0.1111111111111111	REAC:R-HSA-8939243	REAC	RUNX1 interacts with co-factors whose precise effect on RUNX1 targets is not known	10916	1916		0	0.3333333333333333	36	10880	4	12	32	10868	10916	0.16486079800460265
M1	cpdb	0	network_modules	85	TRUE	8.424736340883948e-4	529	32	9	0.28125	0.017013232514177693	GO:0006325	GO:BP	chromatin organization	16175	2122		NA	1	529	15646	9	23	520	15623	16175	0.0622161383321052
M1	cpdb	0	network_modules	85	TRUE	0.004820242455881382	34	16	3	0.1875	0.08823529411764706	REAC:R-HSA-8953750	REAC	Transcriptional Regulation by E2F6	10916	2543		0.5	0.6666666666666666	34	10882	3	13	31	10869	10916	0.12677766783824462
M1	cpdb	0	network_modules	85	TRUE	0.009861258865681318	43	16	3	0.1875	0.06976744186046512	REAC:R-HSA-4570464	REAC	SUMOylation of RNA binding proteins	10916	2171		1	1	43	10873	3	13	40	10860	10916	0.11227455849040158
M1	cpdb	0	network_modules	86	TRUE	5.747270592526041e-14	245	28	14	0.5	0.05714285714285714	REAC:R-HSA-425407	REAC	SLC-mediated transmembrane transport	10916	2146		0	0.14285714285714285	245	10671	14	14	231	10657	10916	0.1634959813427062
M1	cpdb	0	network_modules	86	TRUE	3.5522323239320676e-10	87	36	9	0.25	0.10344827586206896	GO:0150104	GO:BP	transport across blood-brain barrier	16175	20143		0	0.09523809523809523	87	16088	9	27	78	16061	16175	0.1579577342275357
M1	cpdb	0	network_modules	86	TRUE	3.5522323239320676e-10	87	36	9	0.25	0.10344827586206896	GO:0010232	GO:BP	vascular transport	16175	4011		0	0.09523809523809523	87	16088	9	27	78	16061	16175	0.1579577342275357
M1	cpdb	0	network_modules	86	TRUE	7.49072902048279e-8	15	28	5	0.17857142857142858	0.3333333333333333	REAC:R-HSA-549132	REAC	Organic cation/anion/zwitterion transport	10916	1650		0.16666666666666666	0.2857142857142857	15	10901	5	23	10	10878	10916	0.2425754158438634
M1	cpdb	0	network_modules	86	TRUE	1.2453313584287093e-7	326	36	11	0.3055555555555556	0.03374233128834356	GO:0015711	GO:BP	organic anion transport	16175	4831		0.1	0.14285714285714285	326	15849	11	25	315	15824	16175	0.09591863298778908
M1	cpdb	0	network_modules	86	TRUE	3.5454710361035954e-7	38	36	6	0.16666666666666666	0.15789473684210525	GO:0042908	GO:BP	xenobiotic transport	16175	10439		0.15	0.19047619047619047	38	16137	6	30	32	16107	16175	0.16030146286645522
M1	cpdb	0	network_modules	86	TRUE	3.9567411426425526e-7	188	36	9	0.25	0.047872340425531915	GO:0003018	GO:BP	vascular process in circulatory system	16175	1469		0.2	0.23809523809523808	188	15987	9	27	179	15960	16175	0.10504113232722387
M1	cpdb	0	network_modules	86	TRUE	1.3595337074854695e-5	32	36	5	0.1388888888888889	0.15625	GO:0072337	GO:BP	modified amino acid transport	16175	17357		0.25	0.2857142857142857	32	16143	5	31	27	16112	16175	0.14552143183323474
M1	cpdb	0	network_modules	86	TRUE	2.8377968872226547e-5	135	36	7	0.19444444444444445	0.05185185185185185	GO:0015718	GO:BP	monocarboxylic acid transport	16175	4838		0.3	0.3333333333333333	135	16040	7	29	128	16011	16175	0.0966118521183818
M1	cpdb	0	network_modules	86	TRUE	3.5097259918637767e-5	14	36	4	0.1111111111111111	0.2857142857142857	GO:0015697	GO:BP	quaternary ammonium group transport	16175	4817		0.35	0.38095238095238093	14	16161	4	32	10	16129	16175	0.17705992430905526
M1	cpdb	0	network_modules	86	TRUE	7.254042195571486e-5	105	28	6	0.21428571428571427	0.05714285714285714	REAC:R-HSA-425393	REAC	Transport of inorganic cations/anions and amino acids/oligopeptides	10916	2596		0.3333333333333333	0.42857142857142855	105	10811	6	22	99	10789	10916	0.10633795791767904
M1	cpdb	0	network_modules	86	TRUE	9.823008063838448e-5	248	36	8	0.2222222222222222	0.03225806451612903	GO:0046942	GO:BP	carboxylic acid transport	16175	12438		0.4	0.42857142857142855	248	15927	8	28	240	15899	16175	0.07952500931708885
M1	cpdb	0	network_modules	86	TRUE	1.0133324296414702e-4	249	36	8	0.2222222222222222	0.0321285140562249	GO:0015849	GO:BP	organic acid transport	16175	4958		0.45	0.47619047619047616	249	15926	8	28	241	15898	16175	0.07934393452812541
M1	cpdb	0	network_modules	86	TRUE	2.222752856751141e-4	182	36	7	0.19444444444444445	0.038461538461538464	GO:0098739	GO:BP	import across plasma membrane	16175	18866		0.5	0.5238095238095238	182	15993	7	29	175	15964	16175	0.08202840845156728
M1	cpdb	0	network_modules	86	TRUE	2.730678065737382e-4	112	36	6	0.16666666666666666	0.05357142857142857	GO:0006820	GO:BP	monoatomic anion transport	16175	2497		0.55	0.5714285714285714	112	16063	6	30	106	16033	16175	0.09098191951285886
M1	cpdb	0	network_modules	86	TRUE	0.00034753917421722063	6	36	3	0.08333333333333333	0.5	GO:0015747	GO:BP	urate transport	16175	4866		0.6	0.6190476190476191	6	16169	3	33	3	16136	16175	0.2034797900054474
M1	cpdb	0	network_modules	86	TRUE	5.973884822655061e-4	10	28	3	0.10714285714285714	0.3	REAC:R-HSA-549127	REAC	Organic cation transport	10916	1649		0.5	0.5714285714285714	10	10906	3	25	7	10881	10916	0.17806137342203324
M1	cpdb	0	network_modules	86	TRUE	6.072629089234312e-4	7	36	3	0.08333333333333333	0.42857142857142855	GO:0015879	GO:BP	carnitine transport	16175	4985		0.65	0.6666666666666666	7	16168	3	33	4	16135	16175	0.18825111540602296
M1	cpdb	0	network_modules	86	TRUE	6.23286619104046e-4	439	36	9	0.25	0.02050113895216401	GO:0003013	GO:BP	circulatory system process	16175	1464		0.7	0.7142857142857143	439	15736	9	27	430	15709	16175	0.06477518417883008
M1	cpdb	0	network_modules	86	TRUE	6.819986726148756e-4	84	28	5	0.17857142857142858	0.05952380952380952	REAC:R-HSA-425366	REAC	Transport of bile salts and organic acids, metal ions and amine compounds	10916	2590		0.6666666666666666	0.7142857142857143	84	10832	5	23	79	10809	10916	0.09916452934473707
M1	cpdb	0	network_modules	86	TRUE	0.0012554010495352693	95	28	5	0.17857142857142858	0.05263157894736842	REAC:R-HSA-5619102	REAC	SLC transporter disorders	10916	2145		0.8333333333333334	0.8571428571428571	95	10821	5	23	90	10798	10916	0.09274406150345076
M1	cpdb	0	network_modules	86	TRUE	0.0020725021747958904	10	36	3	0.08333333333333333	0.3	GO:1990961	GO:BP	xenobiotic detoxification by transmembrane export across the plasma membrane	16175	25355		0.75	0.8571428571428571	10	16165	3	33	7	16132	16175	0.15716438917246794
M1	cpdb	0	network_modules	86	TRUE	0.0020725021747958904	10	36	3	0.08333333333333333	0.3	GO:0046415	GO:BP	urate metabolic process	16175	12132		0.75	0.8571428571428571	10	16165	3	33	7	16132	16175	0.15716438917246794
M1	cpdb	0	network_modules	86	TRUE	0.0020725021747958904	10	36	3	0.08333333333333333	0.3	GO:0015838	GO:BP	amino-acid betaine transport	16175	4948		0.75	0.8571428571428571	10	16165	3	33	7	16132	16175	0.15716438917246794
M1	cpdb	0	network_modules	86	TRUE	0.0021150141328265793	2	28	2	0.07142857142857142	1	REAC:R-HSA-8942233	REAC	Intestinal infectious diseases	10916	1259		1	1	2	10914	2	26	0	10888	10916	0.26694270903326517
M1	cpdb	0	network_modules	86	TRUE	0.004916829375616961	13	36	3	0.08333333333333333	0.23076923076923078	GO:0046618	GO:BP	xenobiotic export from cell	16175	12258		0.9	0.9047619047619048	13	16162	3	33	10	16129	16175	0.1375459691023551
M1	cpdb	0	network_modules	86	TRUE	0.00624821086171651	14	36	3	0.08333333333333333	0.21428571428571427	GO:0043252	GO:BP	sodium-independent organic anion transport	16175	10587		0.95	0.9523809523809523	14	16161	3	33	11	16128	16175	0.13244742079327596
M1	cpdb	0	network_modules	86	TRUE	0.009073267549053477	115	36	5	0.1388888888888889	0.043478260869565216	GO:0015698	GO:BP	inorganic anion transport	16175	4818		1	1	115	16060	5	31	110	16029	16175	0.07407680552262676
M1	cpdb	0	network_modules	87	TRUE	5.581248000791545e-12	131	20	10	0.5	0.07633587786259542	KEGG:04114	KEGG	Oocyte meiosis	8484	268		0	0.1	131	8353	10	10	121	8343	8484	0.19103711845560312
M1	cpdb	0	network_modules	87	TRUE	1.8700012118793406e-11	188	24	11	0.4583333333333333	0.05851063829787234	REAC:R-HSA-2467813	REAC	Separation of Sister Chromatids	10916	2204		0	0.023255813953488372	188	10728	11	13	177	10715	10916	0.15915666173220533
M1	cpdb	0	network_modules	87	TRUE	5.2317328487209635e-11	92	24	9	0.375	0.09782608695652174	REAC:R-HSA-141424	REAC	Amplification of signal from the kinetochores	10916	144		0.023809523809523808	0.06976744186046512	92	10824	9	15	83	10809	10916	0.18822912365595226
M1	cpdb	0	network_modules	87	TRUE	5.2317328487209635e-11	92	24	9	0.375	0.09782608695652174	REAC:R-HSA-141444	REAC	Amplification  of signal from unattached  kinetochores via a MAD2  inhibitory signal	10916	143		0.023809523809523808	0.06976744186046512	92	10824	9	15	83	10809	10916	0.18822912365595226
M1	cpdb	0	network_modules	87	TRUE	5.2562137097993744e-11	14	24	6	0.25	0.42857142857142855	REAC:R-HSA-4839748	REAC	Signaling by AMER1 mutants	10916	2220		0.07142857142857142	0.20930232558139536	14	10902	6	18	8	10884	10916	0.3262154543587794
M1	cpdb	0	network_modules	87	TRUE	5.2562137097993744e-11	14	24	6	0.25	0.42857142857142855	REAC:R-HSA-5467348	REAC	Truncations of AMER1 destabilize the destruction complex	10916	2609		0.07142857142857142	0.20930232558139536	14	10902	6	18	8	10884	10916	0.3262154543587794
M1	cpdb	0	network_modules	87	TRUE	5.2562137097993744e-11	14	24	6	0.25	0.42857142857142855	REAC:R-HSA-5467340	REAC	AXIN missense mutants destabilize the destruction complex	10916	42		0.07142857142857142	0.20930232558139536	14	10902	6	18	8	10884	10916	0.3262154543587794
M1	cpdb	0	network_modules	87	TRUE	5.2562137097993744e-11	14	24	6	0.25	0.42857142857142855	REAC:R-HSA-4839735	REAC	Signaling by AXIN mutants	10916	2222		0.07142857142857142	0.20930232558139536	14	10902	6	18	8	10884	10916	0.3262154543587794
M1	cpdb	0	network_modules	87	TRUE	5.2562137097993744e-11	14	24	6	0.25	0.42857142857142855	REAC:R-HSA-4839744	REAC	Signaling by APC mutants	10916	2221		0.07142857142857142	0.20930232558139536	14	10902	6	18	8	10884	10916	0.3262154543587794
M1	cpdb	0	network_modules	87	TRUE	5.2562137097993744e-11	14	24	6	0.25	0.42857142857142855	REAC:R-HSA-5467337	REAC	APC truncation mutants have impaired AXIN binding	10916	22		0.07142857142857142	0.20930232558139536	14	10902	6	18	8	10884	10916	0.3262154543587794
M1	cpdb	0	network_modules	87	TRUE	8.747962547836654e-11	15	24	6	0.25	0.4	REAC:R-HSA-5358752	REAC	CTNNB1 T41 mutants aren't phosphorylated	10916	292		0.21428571428571427	0.3488372093023256	15	10901	6	18	9	10883	10916	0.31505244074929833
M1	cpdb	0	network_modules	87	TRUE	8.747962547836654e-11	15	24	6	0.25	0.4	REAC:R-HSA-5358749	REAC	CTNNB1 S37 mutants aren't phosphorylated	10916	290		0.21428571428571427	0.3488372093023256	15	10901	6	18	9	10883	10916	0.31505244074929833
M1	cpdb	0	network_modules	87	TRUE	8.747962547836654e-11	15	24	6	0.25	0.4	REAC:R-HSA-5358747	REAC	CTNNB1 S33 mutants aren't phosphorylated	10916	289		0.21428571428571427	0.3488372093023256	15	10901	6	18	9	10883	10916	0.31505244074929833
M1	cpdb	0	network_modules	87	TRUE	8.747962547836654e-11	15	24	6	0.25	0.4	REAC:R-HSA-5339716	REAC	Signaling by GSK3beta mutants	10916	2257		0.21428571428571427	0.3488372093023256	15	10901	6	18	9	10883	10916	0.31505244074929833
M1	cpdb	0	network_modules	87	TRUE	8.747962547836654e-11	15	24	6	0.25	0.4	REAC:R-HSA-5358751	REAC	CTNNB1 S45 mutants aren't phosphorylated	10916	291		0.21428571428571427	0.3488372093023256	15	10901	6	18	9	10883	10916	0.31505244074929833
M1	cpdb	0	network_modules	87	TRUE	8.747962547836654e-11	15	24	6	0.25	0.4	REAC:R-HSA-4839743	REAC	Signaling by CTNNB1 phospho-site mutants	10916	2228		0.21428571428571427	0.3488372093023256	15	10901	6	18	9	10883	10916	0.31505244074929833
M1	cpdb	0	network_modules	87	TRUE	1.5746410215857954e-10	228	24	11	0.4583333333333333	0.04824561403508772	REAC:R-HSA-68882	REAC	Mitotic Anaphase	10916	1479		0.35714285714285715	0.37209302325581395	228	10688	11	13	217	10675	10916	0.14359016439732278
M1	cpdb	0	network_modules	87	TRUE	1.6522572227742897e-10	229	24	11	0.4583333333333333	0.048034934497816595	REAC:R-HSA-2555396	REAC	Mitotic Metaphase and Anaphase	10916	1482		0.38095238095238093	0.3953488372093023	229	10687	11	13	218	10674	10916	0.14325300301553343
M1	cpdb	0	network_modules	87	TRUE	2.157015878157978e-10	17	24	6	0.25	0.35294117647058826	REAC:R-HSA-432142	REAC	Platelet sensitization by LDL	10916	1766		0.40476190476190477	0.4418604651162791	17	10899	6	18	11	10881	10916	0.29574928457815824
M1	cpdb	0	network_modules	87	TRUE	2.157015878157978e-10	17	24	6	0.25	0.35294117647058826	REAC:R-HSA-196299	REAC	Beta-catenin phosphorylation cascade	10916	217		0.40476190476190477	0.4418604651162791	17	10899	6	18	11	10881	10916	0.29574928457815824
M1	cpdb	0	network_modules	87	TRUE	2.5136422335688037e-10	109	24	9	0.375	0.08256880733944955	REAC:R-HSA-69618	REAC	Mitotic Spindle Checkpoint	10916	1486		0.4523809523809524	0.46511627906976744	109	10807	9	15	100	10792	10916	0.1723295726285832
M1	cpdb	0	network_modules	87	TRUE	4.1150983282765595e-10	115	24	9	0.375	0.0782608695652174	REAC:R-HSA-9648025	REAC	EML4 and NUDC in mitotic spindle formation	10916	817		0.47619047619047616	0.4883720930232558	115	10801	9	15	106	10786	10916	0.1675676826525188
M1	cpdb	0	network_modules	87	TRUE	6.726852243288045e-10	20	24	6	0.25	0.3	REAC:R-HSA-389513	REAC	Co-inhibition by CTLA4	10916	376		0.5	0.5116279069767442	20	10896	6	18	14	10878	10916	0.2724032372473622
M1	cpdb	0	network_modules	87	TRUE	7.624248357562425e-10	123	24	9	0.375	0.07317073170731707	REAC:R-HSA-2500257	REAC	Resolution of Sister Chromatid Cohesion	10916	2079		0.5238095238095238	0.5348837209302325	123	10793	9	15	114	10778	10916	0.16176082776419243
M1	cpdb	0	network_modules	87	TRUE	1.8048660894140595e-9	157	20	9	0.45	0.05732484076433121	KEGG:04110	KEGG	Cell cycle	8484	264		0.1111111111111111	0.2	157	8327	9	11	148	8316	8484	0.15563564315997241
M1	cpdb	0	network_modules	87	TRUE	1.907919509003445e-9	136	24	9	0.375	0.0661764705882353	REAC:R-HSA-5663220	REAC	RHO GTPases Activate Formins	10916	1848		0.5476190476190477	0.5581395348837209	136	10780	9	15	127	10765	10916	0.15342420919431995
M1	cpdb	0	network_modules	87	TRUE	1.2580694232956211e-8	31	24	6	0.25	0.1935483870967742	REAC:R-HSA-4641262	REAC	Disassembly of the destruction complex and recruitment of AXIN to the membrane	10916	746		0.5714285714285714	0.5813953488372093	31	10885	6	18	25	10867	10916	0.2180211801999324
M1	cpdb	0	network_modules	87	TRUE	1.8871248183847737e-8	33	24	6	0.25	0.18181818181818182	REAC:R-HSA-5673000	REAC	RAF activation	10916	1839		0.5952380952380952	0.6046511627906976	33	10883	6	18	27	10865	10916	0.21117398131466733
M1	cpdb	0	network_modules	87	TRUE	2.2882637036130935e-8	34	24	6	0.25	0.17647058823529413	REAC:R-HSA-4791275	REAC	Signaling by WNT in cancer	10916	2315		0.6190476190476191	0.627906976744186	34	10882	6	18	28	10864	10916	0.20797769217090376
M1	cpdb	0	network_modules	87	TRUE	5.9134833593260125e-8	199	24	9	0.375	0.04522613065326633	REAC:R-HSA-68877	REAC	Mitotic Prometaphase	10916	1484		0.6428571428571429	0.6511627906976745	199	10717	9	15	190	10702	10916	0.12518155992827062
M1	cpdb	0	network_modules	87	TRUE	8.207235420387008e-8	406	24	11	0.4583333333333333	0.027093596059113302	REAC:R-HSA-68886	REAC	M Phase	10916	1343		0.6666666666666666	0.6744186046511628	406	10510	11	13	395	10497	10916	0.10446665255814025
M1	cpdb	0	network_modules	87	TRUE	8.824715605707436e-8	42	24	6	0.25	0.14285714285714285	REAC:R-HSA-5675221	REAC	Negative regulation of MAPK pathway	10916	1573		0.6904761904761905	0.6976744186046512	42	10874	6	18	36	10856	10916	0.18663803845507373
M1	cpdb	0	network_modules	87	TRUE	3.996951553433516e-7	120	20	7	0.35	0.058333333333333334	KEGG:04071	KEGG	Sphingolipid signaling pathway	8484	260		0.2222222222222222	0.3	120	8364	7	13	113	8351	8484	0.13825567132839675
M1	cpdb	0	network_modules	87	TRUE	1.6072992566119319e-6	289	24	9	0.375	0.031141868512110725	REAC:R-HSA-69620	REAC	Cell Cycle Checkpoints	10916	321		0.7142857142857143	0.7209302325581395	289	10627	9	15	280	10612	10916	0.10190491505151338
M1	cpdb	0	network_modules	87	TRUE	1.6203158643281805e-6	67	24	6	0.25	0.08955223880597014	REAC:R-HSA-388841	REAC	Regulation of T cell activation by CD28 family	10916	2007		0.7380952380952381	0.7441860465116279	67	10849	6	18	61	10831	10916	0.1465640980480994
M1	cpdb	0	network_modules	87	TRUE	3.70647261883476e-6	318	24	9	0.375	0.02830188679245283	REAC:R-HSA-195258	REAC	RHO GTPase Effectors	10916	1846		0.7619047619047619	0.7674418604651163	318	10598	9	15	309	10583	10916	0.09653854779387538
M1	cpdb	0	network_modules	87	TRUE	3.865729382092169e-6	96	20	6	0.3	0.0625	KEGG:03015	KEGG	mRNA surveillance pathway	8484	210		0.3333333333333333	0.4	96	8388	6	14	90	8374	8484	0.13267423550962923
M1	cpdb	0	network_modules	87	TRUE	5.99068420557865e-6	83	24	6	0.25	0.07228915662650602	REAC:R-HSA-195253	REAC	Degradation of beta-catenin by the destruction complex	10916	724		0.7857142857142857	0.7906976744186046	83	10833	6	18	77	10815	10916	0.13098700935606827
M1	cpdb	0	network_modules	87	TRUE	6.921798303867402e-6	85	24	6	0.25	0.07058823529411765	REAC:R-HSA-418346	REAC	Platelet homeostasis	10916	1765		0.8095238095238095	0.813953488372093	85	10831	6	18	79	10813	10916	0.12935091779787639
M1	cpdb	0	network_modules	87	TRUE	1.1173711474000614e-5	92	24	6	0.25	0.06521739130434782	REAC:R-HSA-6811558	REAC	PI5P, PP2A and IER3 Regulate PI3K/AKT Signaling	10916	1677		0.8333333333333334	0.8372093023255814	92	10824	6	18	86	10806	10916	0.12404353344514461
M1	cpdb	0	network_modules	87	TRUE	1.400291814340847e-5	119	20	6	0.3	0.05042016806722689	KEGG:04660	KEGG	T cell receptor signaling pathway	8484	338		0.4444444444444444	0.5	119	8365	6	14	113	8351	8484	0.11820812142378212
M1	cpdb	0	network_modules	87	TRUE	1.4718877248043483e-5	120	20	6	0.3	0.05	KEGG:04152	KEGG	AMPK signaling pathway	8484	286		0.5555555555555556	0.6	120	8364	6	14	114	8350	8484	0.11767307296470408
M1	cpdb	0	network_modules	87	TRUE	1.738473182835156e-5	99	24	6	0.25	0.06060606060606061	REAC:R-HSA-199418	REAC	Negative regulation of the PI3K/AKT network	10916	1580		0.8571428571428571	0.8604651162790697	99	10817	6	18	93	10799	10916	0.11929892790878005
M1	cpdb	0	network_modules	87	TRUE	2.479051321818058e-5	131	20	6	0.3	0.04580152671755725	KEGG:04728	KEGG	Dopaminergic synapse	8484	358		0.6666666666666666	0.7	131	8353	6	14	125	8339	8484	0.11218725647665218
M1	cpdb	0	network_modules	87	TRUE	6.201261626753531e-5	153	20	6	0.3	0.0392156862745098	KEGG:04261	KEGG	Adrenergic signaling in cardiomyocytes	8484	297		0.7777777777777778	0.8	153	8331	6	14	147	8317	8484	0.10299837523026636
M1	cpdb	0	network_modules	87	TRUE	3.9989480777045554e-4	330	20	7	0.35	0.021212121212121213	KEGG:05165	KEGG	Human papillomavirus infection	8484	446		0.8888888888888888	0.9	330	8154	7	13	323	8141	8484	0.07821500174882684
M1	cpdb	0	network_modules	87	TRUE	0.002540304626151516	231	24	6	0.25	0.025974025974025976	REAC:R-HSA-201681	REAC	TCF dependent signaling in response to WNT	10916	2421		0.8809523809523809	0.8837209302325582	231	10685	6	18	225	10667	10916	0.07463645186803408
M1	cpdb	0	network_modules	87	TRUE	0.0042731437491347404	253	24	6	0.25	0.023715415019762844	REAC:R-HSA-1257604	REAC	PIP3 activates AKT signaling	10916	1679		0.9047619047619048	0.9069767441860465	253	10663	6	18	247	10645	10916	0.07076238786474659
M1	cpdb	0	network_modules	87	TRUE	0.004534207085800236	54	31	4	0.12903225806451613	0.07407407407407407	GO:0045132	GO:BP	meiotic chromosome segregation	16175	11292		NA	1	54	16121	4	27	50	16094	16175	0.09548616581071
M1	cpdb	0	network_modules	87	TRUE	0.005443660171549461	264	24	6	0.25	0.022727272727272728	REAC:R-HSA-5673001	REAC	RAF/MAP kinase cascade	10916	1841		0.9285714285714286	0.9302325581395349	264	10652	6	18	258	10634	10916	0.06900033286361638
M1	cpdb	0	network_modules	87	TRUE	0.00605527005808223	269	24	6	0.25	0.022304832713754646	REAC:R-HSA-5684996	REAC	MAPK1/MAPK3 signaling	10916	1351		0.9523809523809523	0.9534883720930233	269	10647	6	18	263	10629	10916	0.0682334207899862
M1	cpdb	0	network_modules	87	TRUE	0.006963462125170502	418	24	7	0.2916666666666667	0.01674641148325359	REAC:R-HSA-5663202	REAC	Diseases of signal transduction by growth factor receptors and second messengers	10916	773		0.9761904761904762	0.9767441860465116	418	10498	7	17	411	10481	10916	0.06197783276198487
M1	cpdb	0	network_modules	87	TRUE	0.007773044292345762	356	20	6	0.3	0.016853932584269662	KEGG:04151	KEGG	PI3K-Akt signaling pathway	8484	285		1	1	356	8128	6	14	350	8114	8484	0.06255985932822092
M1	cpdb	0	network_modules	87	TRUE	0.009814865296247944	293	24	6	0.25	0.020477815699658702	REAC:R-HSA-9006925	REAC	Intracellular signaling by second messengers	10916	1266		1	1	293	10623	6	18	287	10605	10916	0.06481442724135426
M1	cpdb	0	network_modules	88	TRUE	1.683429011931421e-12	126	34	11	0.3235294117647059	0.0873015873015873	GO:0006888	GO:BP	endoplasmic reticulum to Golgi vesicle-mediated transport	16175	2544		0	0.08333333333333333	126	16049	11	23	115	16026	16175	0.1648307899243626
M1	cpdb	0	network_modules	88	TRUE	4.4109100918185057e-10	284	34	12	0.35294117647058826	0.04225352112676056	GO:0048193	GO:BP	Golgi vesicle transport	16175	12570		0.09090909090909091	0.16666666666666666	284	15891	12	22	272	15869	16175	0.11719931436004608
M1	cpdb	0	network_modules	88	TRUE	5.029602826547843e-10	186	23	10	0.43478260869565216	0.053763440860215055	REAC:R-HSA-948021	REAC	Transport to the Golgi and subsequent modification	10916	2604		0	0.1111111111111111	186	10730	10	13	176	10717	10916	0.14832247283512479
M1	cpdb	0	network_modules	88	TRUE	6.831589032150454e-8	305	23	10	0.43478260869565216	0.03278688524590164	REAC:R-HSA-446203	REAC	Asparagine N-linked glycosylation	10916	169		0.125	0.2222222222222222	305	10611	10	13	295	10598	10916	0.11343612068761304
M1	cpdb	0	network_modules	88	TRUE	1.8562746259261668e-7	155	23	8	0.34782608695652173	0.05161290322580645	REAC:R-HSA-199977	REAC	ER to Golgi Anterograde Transport	10916	823		0.25	0.3333333333333333	155	10761	8	15	147	10746	10916	0.12957534944645288
M1	cpdb	0	network_modules	88	TRUE	1.9587813825113345e-6	33	23	5	0.21739130434782608	0.15151515151515152	REAC:R-HSA-5694530	REAC	Cargo concentration in the ER	10916	308		0.375	0.4444444444444444	33	10883	5	18	28	10865	10916	0.17942493946929594
M1	cpdb	0	network_modules	88	TRUE	1.3400666633411577e-5	34	34	5	0.14705882352941177	0.14705882352941177	GO:0035459	GO:BP	vesicle cargo loading	16175	9047		0.18181818181818182	0.25	34	16141	5	29	29	16112	16175	0.14526215665623166
M1	cpdb	0	network_modules	88	TRUE	1.510318016421087e-5	74	34	6	0.17647058823529413	0.08108108108108109	GO:0006900	GO:BP	vesicle budding from membrane	16175	2553		0.2727272727272727	0.3333333333333333	74	16101	6	28	68	16073	16175	0.11690714975461698
M1	cpdb	0	network_modules	88	TRUE	2.807320364386283e-5	144	34	7	0.20588235294117646	0.04861111111111111	GO:0007030	GO:BP	Golgi organization	16175	2635		0.36363636363636365	0.4166666666666667	144	16031	7	27	137	16004	16175	0.09624507244669206
M1	cpdb	0	network_modules	88	TRUE	3.140613475297236e-5	40	34	5	0.14705882352941177	0.125	GO:0090114	GO:BP	COPII-coated vesicle budding	16175	18031		0.45454545454545453	0.5	40	16135	5	29	35	16106	16175	0.13360721318856142
M1	cpdb	0	network_modules	88	TRUE	4.2012859059103316e-5	202	23	7	0.30434782608695654	0.034653465346534656	REAC:R-HSA-6811442	REAC	Intra-Golgi and retrograde Golgi-to-ER traffic	10916	1262		0.5	0.5555555555555556	202	10714	7	16	195	10698	10916	0.09746070872365097
M1	cpdb	0	network_modules	88	TRUE	8.183111794113483e-5	133	23	6	0.2608695652173913	0.045112781954887216	REAC:R-HSA-8856688	REAC	Golgi-to-ER retrograde transport	10916	1084		0.625	0.6666666666666666	133	10783	6	17	127	10766	10916	0.10416186201361376
M1	cpdb	0	network_modules	88	TRUE	8.198121300574867e-5	68	23	5	0.21739130434782608	0.07352941176470588	REAC:R-HSA-204005	REAC	COPII-mediated vesicle transport	10916	280		0.75	0.7777777777777778	68	10848	5	18	63	10830	10916	0.12332183921415271
M1	cpdb	0	network_modules	88	TRUE	1.267878727726394e-4	524	34	10	0.29411764705882354	0.019083969465648856	GO:0006886	GO:BP	intracellular protein transport	16175	2542		0.5454545454545454	0.5833333333333334	524	15651	10	24	514	15627	16175	0.06784565323798779
M1	cpdb	0	network_modules	88	TRUE	2.816403587986634e-4	6	34	3	0.08823529411764706	0.5	GO:0048205	GO:BP	COPI coating of Golgi vesicle	16175	12581		0.6363636363636364	0.8333333333333334	6	16169	3	31	3	16138	16175	0.2094180109807884
M1	cpdb	0	network_modules	88	TRUE	2.816403587986634e-4	6	34	3	0.08823529411764706	0.5	GO:0048200	GO:BP	Golgi transport vesicle coating	16175	12576		0.6363636363636364	0.8333333333333334	6	16169	3	31	3	16138	16175	0.2094180109807884
M1	cpdb	0	network_modules	88	TRUE	2.816403587986634e-4	6	34	3	0.08823529411764706	0.5	GO:0035964	GO:BP	COPI-coated vesicle budding	16175	9367		0.6363636363636364	0.8333333333333334	6	16169	3	31	3	16138	16175	0.2094180109807884
M1	cpdb	0	network_modules	88	TRUE	5.389445145420552e-4	99	23	5	0.21739130434782608	0.050505050505050504	REAC:R-HSA-6811434	REAC	COPI-dependent Golgi-to-ER retrograde traffic	10916	277		0.875	0.8888888888888888	99	10817	5	18	94	10799	10916	0.10097594305324803
M1	cpdb	0	network_modules	88	TRUE	6.250288782040601e-4	102	23	5	0.21739130434782608	0.049019607843137254	REAC:R-HSA-6807878	REAC	COPI-mediated anterograde transport	10916	279		1	1	102	10814	5	18	97	10796	10916	0.09936246257019446
M1	cpdb	0	network_modules	88	TRUE	0.0011777959722424531	9	34	3	0.08823529411764706	0.3333333333333333	GO:0048194	GO:BP	Golgi vesicle budding	16175	12571		0.9090909090909091	0.9166666666666666	9	16166	3	31	6	16135	16175	0.17064398330395733
M1	cpdb	0	network_modules	88	TRUE	0.007773326277342256	16	34	3	0.08823529411764706	0.1875	GO:0090110	GO:BP	COPII-coated vesicle cargo loading	16175	18028		1	1	16	16159	3	31	13	16128	16175	0.1273788682887789
M1	cpdb	0	network_modules	89	TRUE	2.212438194471728e-19	196	27	16	0.5925925925925926	0.08163265306122448	REAC:R-HSA-112314	REAC	Neurotransmitter receptors and postsynaptic signal transmission	10916	1594		0	0.041666666666666664	196	10720	16	11	180	10709	10916	0.21548636384856706
M1	cpdb	0	network_modules	89	TRUE	3.377464603423459e-18	27	27	10	0.37037037037037035	0.37037037037037035	REAC:R-HSA-399721	REAC	Glutamate binding, activation of AMPA receptors and synaptic plasticity	10916	1057		0.043478260869565216	0.125	27	10889	10	17	17	10872	10916	0.36880916181127404
M1	cpdb	0	network_modules	89	TRUE	3.377464603423459e-18	27	27	10	0.37037037037037035	0.37037037037037035	REAC:R-HSA-399719	REAC	Trafficking of AMPA receptors	10916	2532		0.043478260869565216	0.125	27	10889	10	17	17	10872	10916	0.36880916181127404
M1	cpdb	0	network_modules	89	TRUE	8.50515100378245e-18	76	31	12	0.3870967741935484	0.15789473684210525	GO:0035249	GO:BP	synaptic transmission, glutamatergic	16175	8924		0	0.08333333333333333	76	16099	12	19	64	16080	16175	0.24503556044245425
M1	cpdb	0	network_modules	89	TRUE	2.1035060249817813e-17	259	27	16	0.5925925925925926	0.06177606177606178	REAC:R-HSA-112315	REAC	Transmission across Chemical Synapses	10916	2580		0.13043478260869565	0.16666666666666666	259	10657	16	11	243	10646	10916	0.18612040411490552
M1	cpdb	0	network_modules	89	TRUE	2.273585794030579e-14	400	27	16	0.5925925925925926	0.04	REAC:R-HSA-112316	REAC	Neuronal System	10916	1590		0.17391304347826086	0.20833333333333334	400	10516	16	11	384	10505	10916	0.1473435683805888
M1	cpdb	0	network_modules	89	TRUE	8.671175068846616e-13	262	31	13	0.41935483870967744	0.04961832061068702	GO:0050804	GO:BP	modulation of chemical synaptic transmission	16175	13270		0.09090909090909091	0.16666666666666666	262	15913	13	18	249	15895	16175	0.13994812761021866
M1	cpdb	0	network_modules	89	TRUE	9.112517932141194e-13	263	31	13	0.41935483870967744	0.049429657794676805	GO:0099177	GO:BP	regulation of trans-synaptic signaling	16175	19085		0.18181818181818182	0.25	263	15912	13	18	250	15894	16175	0.13966478150086825
M1	cpdb	0	network_modules	89	TRUE	5.908007885059897e-12	20	27	7	0.25925925925925924	0.35	REAC:R-HSA-438066	REAC	Unblocking of NMDA receptors, glutamate binding and activation	10916	2621		0.21739130434782608	0.25	20	10896	7	20	13	10876	10916	0.2997485605418505
M1	cpdb	0	network_modules	89	TRUE	8.655029186279039e-12	41	31	8	0.25806451612903225	0.1951219512195122	GO:0007215	GO:BP	glutamate receptor signaling pathway	16175	2769		0.2727272727272727	0.3333333333333333	41	16134	8	23	33	16111	16175	0.22268863879914827
M1	cpdb	0	network_modules	89	TRUE	8.931644329364506e-12	115	23	10	0.43478260869565216	0.08695652173913043	KEGG:04724	KEGG	Glutamatergic synapse	8484	354		0	0.05555555555555555	115	8369	10	13	105	8356	8484	0.18992622234443934
M1	cpdb	0	network_modules	89	TRUE	6.857988764500814e-11	13	27	6	0.2222222222222222	0.46153846153846156	REAC:R-HSA-416993	REAC	Trafficking of GluR2-containing AMPA receptors	10916	2533		0.2608695652173913	0.2916666666666667	13	10903	6	21	7	10882	10916	0.3191247776651688
M1	cpdb	0	network_modules	89	TRUE	6.978038293799689e-11	365	23	13	0.5652173913043478	0.03561643835616438	KEGG:04080	KEGG	Neuroactive ligand-receptor interaction	8484	263		0.058823529411764705	0.1111111111111111	365	8119	13	10	352	8109	8484	0.13418035280630686
M1	cpdb	0	network_modules	89	TRUE	9.637390085367527e-11	487	31	14	0.45161290322580644	0.028747433264887063	GO:0098916	GO:BP	anterograde trans-synaptic signaling	16175	18949		0.36363636363636365	0.5	487	15688	14	17	473	15671	16175	0.10808706506058936
M1	cpdb	0	network_modules	89	TRUE	9.637390085367527e-11	487	31	14	0.45161290322580644	0.028747433264887063	GO:0007268	GO:BP	chemical synaptic transmission	16175	2796		0.36363636363636365	0.5	487	15688	14	17	473	15671	16175	0.10808706506058936
M1	cpdb	0	network_modules	89	TRUE	1.1084525581306814e-10	492	31	14	0.45161290322580644	0.028455284552845527	GO:0099537	GO:BP	trans-synaptic signaling	16175	19116		0.5454545454545454	0.5833333333333334	492	15683	14	17	478	15666	16175	0.10747470388739369
M1	cpdb	0	network_modules	89	TRUE	2.126143682828993e-10	516	31	14	0.45161290322580644	0.027131782945736434	GO:0099536	GO:BP	synaptic signaling	16175	19115		0.6363636363636364	0.6666666666666666	516	15659	14	17	502	15642	16175	0.10465594423077852
M1	cpdb	0	network_modules	89	TRUE	3.6064550802879106e-10	69	23	8	0.34782608695652173	0.11594202898550725	KEGG:05031	KEGG	Amphetamine addiction	8484	419		0.11764705882352941	0.16666666666666666	69	8415	8	15	61	8400	8484	0.19719181735747507
M1	cpdb	0	network_modules	89	TRUE	1.6553999366895763e-9	131	23	9	0.391304347826087	0.06870229007633588	KEGG:04728	KEGG	Dopaminergic synapse	8484	358		0.17647058823529413	0.2222222222222222	131	8353	9	14	122	8339	8484	0.15893773372657047
M1	cpdb	0	network_modules	89	TRUE	5.010608647595592e-9	10	27	5	0.18518518518518517	0.5	REAC:R-HSA-451308	REAC	Activation of Ca-permeable Kainate Receptor	10916	81		0.30434782608695654	0.375	10	10906	5	22	5	10884	10916	0.3032991373860823
M1	cpdb	0	network_modules	89	TRUE	5.010608647595592e-9	10	27	5	0.18518518518518517	0.5	REAC:R-HSA-451306	REAC	Ionotropic activity of kainate receptors	10916	1276		0.30434782608695654	0.375	10	10906	5	22	5	10884	10916	0.3032991373860823
M1	cpdb	0	network_modules	89	TRUE	5.962928240562559e-9	97	23	8	0.34782608695652173	0.08247422680412371	KEGG:04713	KEGG	Circadian entrainment	8484	348		0.23529411764705882	0.2777777777777778	97	8387	8	15	89	8372	8484	0.16497237794826813
M1	cpdb	0	network_modules	89	TRUE	9.513019715268224e-9	4	27	4	0.14814814814814814	1	REAC:R-HSA-399710	REAC	Activation of AMPA receptors	10916	72		0.391304347826087	0.4166666666666667	4	10912	4	23	0	10889	10916	0.38449432471638845
M1	cpdb	0	network_modules	89	TRUE	2.3072891963299078e-8	30	27	6	0.2222222222222222	0.2	REAC:R-HSA-451326	REAC	Activation of kainate receptors upon glutamate binding	10916	102		0.43478260869565216	0.4583333333333333	30	10886	6	21	24	10865	10916	0.208756315516789
M1	cpdb	0	network_modules	89	TRUE	3.971886348270335e-7	21	27	5	0.18518518518518517	0.23809523809523808	REAC:R-HSA-9620244	REAC	Long-term potentiation	10916	1321		0.4782608695652174	0.5	21	10895	5	22	16	10873	10916	0.2082567822970364
M1	cpdb	0	network_modules	89	TRUE	4.6992347258029916e-7	89	27	7	0.25925925925925924	0.07865168539325842	REAC:R-HSA-442755	REAC	Activation of NMDA receptors and postsynaptic events	10916	89		0.5217391304347826	0.5416666666666666	89	10827	7	20	82	10807	10916	0.13904634692889922
M1	cpdb	0	network_modules	89	TRUE	1.1272714661958815e-6	67	23	6	0.2608695652173913	0.08955223880597014	KEGG:04720	KEGG	Long-term potentiation	8484	350		0.29411764705882354	0.3333333333333333	67	8417	6	17	61	8400	8484	0.14900838759489296
M1	cpdb	0	network_modules	89	TRUE	2.6890371743325855e-5	59	23	5	0.21739130434782608	0.0847457627118644	KEGG:04730	KEGG	Long-term depression	8484	359		0.35294117647058826	0.3888888888888889	59	8425	5	18	54	8407	8484	0.13202766694673995
M1	cpdb	0	network_modules	89	TRUE	5.82327343409275e-5	19	31	4	0.12903225806451613	0.21052631578947367	GO:0099637	GO:BP	neurotransmitter receptor transport	16175	19177		0.7272727272727273	0.75	19	16156	4	27	15	16129	16175	0.16356953043991923
M1	cpdb	0	network_modules	89	TRUE	8.685090534720931e-5	223	23	7	0.30434782608695654	0.03139013452914798	KEGG:04024	KEGG	cAMP signaling pathway	8484	252		0.4117647058823529	0.4444444444444444	223	8261	7	16	216	8245	8484	0.09062088042882899
M1	cpdb	0	network_modules	89	TRUE	1.5701540923329405e-4	153	23	6	0.2608695652173913	0.0392156862745098	KEGG:04261	KEGG	Adrenergic signaling in cardiomyocytes	8484	297		0.47058823529411764	0.5	153	8331	6	17	147	8314	8484	0.0951419036535938
M1	cpdb	0	network_modules	89	TRUE	1.63097343153381e-4	154	23	6	0.2608695652173913	0.03896103896103896	KEGG:04921	KEGG	Oxytocin signaling pathway	8484	378		0.5294117647058824	0.5555555555555556	154	8330	6	17	148	8313	8484	0.09479215722684148
M1	cpdb	0	network_modules	89	TRUE	2.2601265609283915e-4	40	23	4	0.17391304347826086	0.1	KEGG:05033	KEGG	Nicotine addiction	8484	421		0.5882352941176471	0.6111111111111112	40	8444	4	19	36	8425	8484	0.1287791583400201
M1	cpdb	0	network_modules	89	TRUE	3.2629799487134456e-4	32	27	4	0.14814814814814814	0.125	REAC:R-HSA-5576892	REAC	Phase 0 - rapid depolarisation	10916	1732		0.5652173913043478	0.5833333333333334	32	10884	4	23	28	10861	10916	0.13375149108665302
M1	cpdb	0	network_modules	89	TRUE	3.287107896121312e-4	76	27	5	0.18518518518518517	0.06578947368421052	REAC:R-HSA-438064	REAC	Post NMDA receptor activation events	10916	1772		0.6086956521739131	0.625	76	10840	5	22	71	10818	10916	0.10673172957179158
M1	cpdb	0	network_modules	89	TRUE	5.131149511002429e-4	10	27	3	0.1111111111111111	0.3	REAC:R-HSA-111932	REAC	CaMK IV-mediated phosphorylation of CREB	10916	298		0.6521739130434783	0.6666666666666666	10	10906	3	24	7	10882	10916	0.18137634660329918
M1	cpdb	0	network_modules	89	TRUE	6.829207042398121e-4	34	31	4	0.12903225806451613	0.11764705882352941	GO:0099072	GO:BP	regulation of postsynaptic membrane neurotransmitter receptor levels	16175	19029		0.8181818181818182	0.8333333333333334	34	16141	4	27	30	16114	16175	0.1214451053156106
M1	cpdb	0	network_modules	89	TRUE	8.651040474834987e-4	36	31	4	0.12903225806451613	0.1111111111111111	GO:0097120	GO:BP	receptor localization to synapse	16175	18510		0.9090909090909091	0.9166666666666666	36	16139	4	27	32	16112	16175	0.11791576227985472
M1	cpdb	0	network_modules	89	TRUE	0.0018681609198519245	49	27	4	0.14814814814814814	0.08163265306122448	REAC:R-HSA-112043	REAC	PLC beta mediated events	10916	1693		0.6956521739130435	0.7083333333333334	49	10867	4	23	45	10844	10916	0.10701196931448947
M1	cpdb	0	network_modules	89	TRUE	0.001888405475738017	2	27	2	0.07407407407407407	1	REAC:R-HSA-451307	REAC	Activation of Na-permeable kainate receptors	10916	91		0.7391304347826086	0.75	2	10914	2	25	0	10889	10916	0.271853632203404
M1	cpdb	0	network_modules	89	TRUE	0.002533871284634277	148	23	5	0.21739130434782608	0.033783783783783786	KEGG:04723	KEGG	Retrograde endocannabinoid signaling	8484	353		0.6470588235294118	0.6666666666666666	148	8336	5	18	143	8318	8484	0.07962661729367346
M1	cpdb	0	network_modules	89	TRUE	0.0027650239498311796	54	27	4	0.14814814814814814	0.07407407407407407	REAC:R-HSA-112040	REAC	G-protein mediated events	10916	998		0.782608695652174	0.7916666666666666	54	10862	4	23	50	10839	10916	0.1016357589346268
M1	cpdb	0	network_modules	89	TRUE	0.002974196233312303	76	23	4	0.17391304347826086	0.05263157894736842	KEGG:04971	KEGG	Gastric acid secretion	8484	402		0.7058823529411765	0.7222222222222222	76	8408	4	19	72	8389	8484	0.0912779923956967
M1	cpdb	0	network_modules	89	TRUE	0.003443423667529107	18	27	3	0.1111111111111111	0.16666666666666666	REAC:R-HSA-442982	REAC	Ras activation upon Ca2+ influx through NMDA receptor	10916	1941		0.8260869565217391	0.8333333333333334	18	10898	3	24	15	10874	10916	0.13434012607631576
M1	cpdb	0	network_modules	89	TRUE	0.003945781541133773	59	27	4	0.14814814814814814	0.06779661016949153	REAC:R-HSA-8986944	REAC	Transcriptional Regulation by MECP2	10916	2544		0.8695652173913043	0.875	59	10857	4	23	55	10834	10916	0.09694513713505748
M1	cpdb	0	network_modules	89	TRUE	0.004618558510225626	85	23	4	0.17391304347826086	0.047058823529411764	KEGG:04911	KEGG	Insulin secretion	8484	368		0.7647058823529411	0.7777777777777778	85	8399	4	19	81	8380	8484	0.08580133009872232
M1	cpdb	0	network_modules	89	TRUE	0.004794818174573051	20	27	3	0.1111111111111111	0.15	REAC:R-HSA-9617324	REAC	Negative regulation of NMDA receptor-mediated neuronal transmission	10916	1575		0.9130434782608695	0.9166666666666666	20	10896	3	24	17	10872	10916	0.1272445913898661
M1	cpdb	0	network_modules	89	TRUE	0.0048833012831647725	55	31	4	0.12903225806451613	0.07272727272727272	GO:0051966	GO:BP	regulation of synaptic transmission, glutamatergic	16175	14035		1	1	55	16120	4	27	51	16093	16175	0.09457052400565402
M1	cpdb	0	network_modules	89	TRUE	0.005584733688895644	21	27	3	0.1111111111111111	0.14285714285714285	REAC:R-HSA-8849932	REAC	Synaptic adhesion-like molecules	10916	2366		0.9565217391304348	0.9583333333333334	21	10895	3	24	18	10871	10916	0.12407960141264007
M1	cpdb	0	network_modules	89	TRUE	0.006564875225411648	93	23	4	0.17391304347826086	0.043010752688172046	KEGG:04912	KEGG	GnRH signaling pathway	8484	369		0.8235294117647058	0.8333333333333334	93	8391	4	19	89	8372	8484	0.08159490601535238
M1	cpdb	0	network_modules	89	TRUE	0.008049356296252952	98	23	4	0.17391304347826086	0.04081632653061224	KEGG:04925	KEGG	Aldosterone synthesis and secretion	8484	382		0.8823529411764706	0.9444444444444444	98	8386	4	19	94	8367	8484	0.07922228366109091
M1	cpdb	0	network_modules	89	TRUE	0.008049356296252952	98	23	4	0.17391304347826086	0.04081632653061224	KEGG:04750	KEGG	Inflammatory mediator regulation of TRP channels	8484	364		0.8823529411764706	0.9444444444444444	98	8386	4	19	94	8367	8484	0.07922228366109091
M1	cpdb	0	network_modules	89	TRUE	0.008456917761153215	24	27	3	0.1111111111111111	0.125	REAC:R-HSA-3371571	REAC	HSF1-dependent transactivation	10916	1110		1	1	24	10892	3	24	21	10868	10916	0.11578964281504067
M1	cpdb	0	network_modules	89	TRUE	0.009049175125398105	101	23	4	0.17391304347826086	0.039603960396039604	KEGG:04916	KEGG	Melanogenesis	8484	373		1	1	101	8383	4	19	97	8364	8484	0.07788082184808018
M1	cpdb	0	network_modules	90	TRUE	1.0984522711052119e-50	329	36	35	0.9722222222222222	0.10638297872340426	REAC:R-HSA-73894	REAC	DNA Repair	10916	444		0	0.010101010101010102	329	10587	35	1	294	10586	10916	0.3169604542398936
M1	cpdb	0	network_modules	90	TRUE	3.167453721653381e-42	528	37	33	0.8918918918918919	0.0625	GO:0006281	GO:BP	DNA repair	16175	2095		0	0.006622516556291391	528	15647	33	4	495	15643	16175	0.23152974337243545
M1	cpdb	0	network_modules	90	TRUE	2.0393358335611092e-38	798	37	34	0.918918918918919	0.042606516290726815	GO:0006974	GO:BP	DNA damage response	16175	2601		0.006666666666666667	0.013245033112582781	798	15377	34	3	764	15374	16175	0.1922623940869768
M1	cpdb	0	network_modules	90	TRUE	7.28621015378747e-38	168	36	26	0.7222222222222222	0.15476190476190477	REAC:R-HSA-5693532	REAC	DNA Double-Strand Break Repair	10916	443		0.01020408163265306	0.020202020202020204	168	10748	26	10	142	10738	10916	0.33029199179711133
M1	cpdb	0	network_modules	90	TRUE	7.036745496392278e-33	152	37	22	0.5945945945945946	0.14473684210526316	GO:0000723	GO:BP	telomere maintenance	16175	202		0.013333333333333334	0.019867549668874173	152	16023	22	15	130	16008	16175	0.2904216283295825
M1	cpdb	0	network_modules	90	TRUE	8.359052768347581e-33	281	37	25	0.6756756756756757	0.08896797153024912	GO:0006310	GO:BP	DNA recombination	16175	2115		0.02	0.026490066225165563	281	15894	25	12	256	15882	16175	0.2412550924739228
M1	cpdb	0	network_modules	90	TRUE	3.2762934239129852e-31	138	36	22	0.6111111111111112	0.15942028985507245	REAC:R-HSA-5693538	REAC	Homology Directed Repair	10916	1130		0.02040816326530612	0.030303030303030304	138	10778	22	14	116	10764	10916	0.3081296152567163
M1	cpdb	0	network_modules	90	TRUE	4.7417756157282065e-31	182	37	22	0.5945945945945946	0.12087912087912088	GO:0032200	GO:BP	telomere organization	16175	7392		0.02666666666666667	0.033112582781456956	182	15993	22	15	160	15978	16175	0.26481548259146825
M1	cpdb	0	network_modules	90	TRUE	4.263168025009026e-30	298	37	24	0.6486486486486487	0.08053691275167785	GO:0006302	GO:BP	double-strand break repair	16175	2109		0.03333333333333333	0.039735099337748346	298	15877	24	13	274	15864	16175	0.22440042522300252
M1	cpdb	0	network_modules	90	TRUE	2.140792398942857e-29	50	36	17	0.4722222222222222	0.34	REAC:R-HSA-9675135	REAC	Diseases of DNA repair	10916	758		0.030612244897959183	0.04040404040404041	50	10866	17	19	33	10847	10916	0.39837657292354484
M1	cpdb	0	network_modules	90	TRUE	4.712328255503983e-29	68	36	18	0.5	0.2647058823529412	REAC:R-HSA-5685942	REAC	HDR through Homologous Recombination (HRR)	10916	1097		0.04081632653061224	0.050505050505050504	68	10848	18	18	50	10830	10916	0.36099091587320303
M1	cpdb	0	network_modules	90	TRUE	2.0506756876690944e-27	132	36	20	0.5555555555555556	0.15151515151515152	REAC:R-HSA-5693567	REAC	HDR through Homologous Recombination (HRR) or Single Strand Annealing (SSA)	10916	1098		0.05102040816326531	0.06060606060606061	132	10784	20	16	112	10768	10916	0.2860181395449545
M1	cpdb	0	network_modules	90	TRUE	1.2003751111446517e-26	231	37	21	0.5675675675675675	0.09090909090909091	GO:0006260	GO:BP	DNA replication	16175	2077		0.04	0.046357615894039736	231	15944	21	16	210	15928	16175	0.22328808836993871
M1	cpdb	0	network_modules	90	TRUE	2.4968859291498866e-26	40	36	15	0.4166666666666667	0.375	REAC:R-HSA-5693616	REAC	Presynaptic phase of homologous DNA pairing and strand exchange	10916	1793		0.061224489795918366	0.0707070707070707	40	10876	15	21	25	10855	10916	0.39317711046757
M1	cpdb	0	network_modules	90	TRUE	4.549318692172559e-26	435	37	24	0.6486486486486487	0.05517241379310345	GO:0051052	GO:BP	regulation of DNA metabolic process	16175	13462		0.04666666666666667	0.052980132450331126	435	15740	24	13	411	15727	16175	0.18403176681079017
M1	cpdb	0	network_modules	90	TRUE	9.355028753845297e-26	43	36	15	0.4166666666666667	0.3488372093023256	REAC:R-HSA-5693579	REAC	Homologous DNA Pairing and Strand Exchange	10916	1129		0.07142857142857142	0.08080808080808081	43	10873	15	21	28	10852	10916	0.37901361344816553
M1	cpdb	0	network_modules	90	TRUE	1.843281337175799e-25	545	37	25	0.6756756756756757	0.045871559633027525	GO:0051276	GO:BP	chromosome organization	16175	13613		0.05333333333333334	0.059602649006622516	545	15630	25	12	520	15618	16175	0.17035904878901456
M1	cpdb	0	network_modules	90	TRUE	7.176306615475111e-25	35	36	14	0.3888888888888889	0.4	REAC:R-HSA-9709570	REAC	Impaired BRCA2 binding to RAD51	10916	1173		0.08163265306122448	0.09090909090909091	35	10881	14	22	21	10859	10916	0.3924297584330533
M1	cpdb	0	network_modules	90	TRUE	1.5057510044654567e-24	147	37	18	0.4864864864864865	0.12244897959183673	GO:0006261	GO:BP	DNA-templated DNA replication	16175	2078		0.06	0.06622516556291391	147	16028	18	19	129	16009	16175	0.24088120185393755
M1	cpdb	0	network_modules	90	TRUE	1.0777969707589096e-23	41	36	14	0.3888888888888889	0.34146341463414637	REAC:R-HSA-9701190	REAC	Defective homologous recombination repair (HRR) due to BRCA2 loss of function	10916	698		0.09183673469387756	0.1111111111111111	41	10875	14	22	27	10853	10916	0.3621632902565343
M1	cpdb	0	network_modules	90	TRUE	1.0777969707589096e-23	41	36	14	0.3888888888888889	0.34146341463414637	REAC:R-HSA-9675136	REAC	Diseases of DNA Double-Strand Break Repair	10916	757		0.09183673469387756	0.1111111111111111	41	10875	14	22	27	10853	10916	0.3621632902565343
M1	cpdb	0	network_modules	90	TRUE	1.493552969309596e-23	262	37	20	0.5405405405405406	0.07633587786259542	GO:0010948	GO:BP	negative regulation of cell cycle process	16175	4526		0.06666666666666667	0.0728476821192053	262	15913	20	17	242	15896	16175	0.1988881226766372
M1	cpdb	0	network_modules	90	TRUE	1.9920197211685475e-22	116	36	17	0.4722222222222222	0.14655172413793102	REAC:R-HSA-1500620	REAC	Meiosis	10916	1410		0.11224489795918367	0.12121212121212122	116	10800	17	19	99	10781	10916	0.2589531126684737
M1	cpdb	0	network_modules	90	TRUE	2.2800397304991195e-22	114	37	16	0.43243243243243246	0.14035087719298245	GO:0000077	GO:BP	DNA damage checkpoint signaling	16175	28		0.07333333333333333	0.07947019867549669	114	16061	16	21	98	16040	16175	0.24347998126947898
M1	cpdb	0	network_modules	90	TRUE	5.01544824950804e-22	94	36	16	0.4444444444444444	0.1702127659574468	REAC:R-HSA-69473	REAC	G2/M DNA damage checkpoint	10916	1006		0.12244897959183673	0.13131313131313133	94	10822	16	20	78	10802	10916	0.27133322670068405
M1	cpdb	0	network_modules	90	TRUE	5.184916376540315e-22	37	36	13	0.3611111111111111	0.35135135135135137	REAC:R-HSA-5685938	REAC	HDR through Single Strand Annealing (SSA)	10916	1100		0.1326530612244898	0.1414141414141414	37	10879	13	23	24	10856	10916	0.35403820739072317
M1	cpdb	0	network_modules	90	TRUE	8.276144333855834e-22	123	37	16	0.43243243243243246	0.13008130081300814	GO:0031570	GO:BP	DNA integrity checkpoint signaling	16175	7220		0.08	0.08609271523178808	123	16052	16	21	107	16031	16175	0.2341619923492239
M1	cpdb	0	network_modules	90	TRUE	2.2470543786406984e-21	19	36	11	0.3055555555555556	0.5789473684210527	REAC:R-HSA-174414	REAC	Processive synthesis on the C-strand of the telomere	10916	1801		0.14285714285714285	0.15151515151515152	19	10897	11	25	8	10872	10916	0.4192559679802878
M1	cpdb	0	network_modules	90	TRUE	2.2645619908947166e-21	41	32	13	0.40625	0.3170731707317073	KEGG:03440	KEGG	Homologous recombination	8484	240		0	0.1	41	8443	13	19	28	8424	8484	0.35616541637191795
M1	cpdb	0	network_modules	90	TRUE	2.6729989997024827e-21	338	37	20	0.5405405405405406	0.05917159763313609	GO:0045786	GO:BP	negative regulation of cell cycle	16175	11618		0.08666666666666667	0.09271523178807947	338	15837	20	17	318	15820	16175	0.17395282423011543
M1	cpdb	0	network_modules	90	TRUE	2.706615433804853e-21	172	37	17	0.4594594594594595	0.09883720930232558	GO:0042770	GO:BP	signal transduction in response to DNA damage	16175	10355		0.09333333333333334	0.09933774834437085	172	16003	17	20	155	15983	16175	0.2095236977148032
M1	cpdb	0	network_modules	90	TRUE	4.059238383561481e-21	176	37	17	0.4594594594594595	0.09659090909090909	GO:0000725	GO:BP	recombinational repair	16175	204		0.1	0.11258278145695365	176	15999	17	20	159	15979	16175	0.20704081487339537
M1	cpdb	0	network_modules	90	TRUE	4.059238383561481e-21	176	37	17	0.4594594594594595	0.09659090909090909	GO:0000075	GO:BP	cell cycle checkpoint signaling	16175	26		0.1	0.11258278145695365	176	15999	17	20	159	15979	16175	0.20704081487339537
M1	cpdb	0	network_modules	90	TRUE	1.5967108964744062e-20	57	37	13	0.35135135135135137	0.22807017543859648	GO:0045005	GO:BP	DNA-templated DNA replication maintenance of fidelity	16175	11223		0.11333333333333333	0.11920529801324503	57	16118	13	24	44	16094	16175	0.28105484477060977
M1	cpdb	0	network_modules	90	TRUE	2.2326561543093597e-20	246	37	18	0.4864864864864865	0.07317073170731707	GO:0051054	GO:BP	positive regulation of DNA metabolic process	16175	13464		0.12	0.12582781456953643	246	15929	18	19	228	15910	16175	0.18438920727717314
M1	cpdb	0	network_modules	90	TRUE	3.170150823968016e-20	154	36	17	0.4722222222222222	0.11038961038961038	REAC:R-HSA-1474165	REAC	Reproduction	10916	2064		0.15306122448979592	0.16161616161616163	154	10762	17	19	137	10743	10916	0.2234433862613371
M1	cpdb	0	network_modules	90	TRUE	3.634416445407862e-20	34	36	12	0.3333333333333333	0.35294117647058826	REAC:R-HSA-174417	REAC	Telomere C-strand (Lagging Strand) Synthesis	10916	2486		0.16326530612244897	0.1717171717171717	34	10882	12	24	22	10858	10916	0.34088515900435806
M1	cpdb	0	network_modules	90	TRUE	8.661200276422002e-20	97	36	15	0.4166666666666667	0.15463917525773196	REAC:R-HSA-5693607	REAC	Processing of DNA double-strand break ends	10916	1798		0.17346938775510204	0.18181818181818182	97	10819	15	21	82	10798	10916	0.24994674899644553
M1	cpdb	0	network_modules	90	TRUE	2.4292708688910654e-19	17	36	10	0.2777777777777778	0.5882352941176471	REAC:R-HSA-174437	REAC	Removal of the Flap Intermediate from the C-strand	10916	2059		0.1836734693877551	0.1919191919191919	17	10899	10	26	7	10873	10916	0.40293810620103926
M1	cpdb	0	network_modules	90	TRUE	2.757474150247222e-19	224	37	17	0.4594594594594595	0.07589285714285714	GO:1901988	GO:BP	negative regulation of cell cycle phase transition	16175	21921		0.12666666666666668	0.13245033112582782	224	15951	17	20	207	15931	16175	0.1825820847797577
M1	cpdb	0	network_modules	90	TRUE	2.9649652624142267e-19	48	37	12	0.32432432432432434	0.25	GO:0031297	GO:BP	replication fork processing	16175	7119		0.13333333333333333	0.1390728476821192	48	16127	12	25	36	16102	16175	0.28288528278916786
M1	cpdb	0	network_modules	90	TRUE	5.974068765598562e-19	630	37	22	0.5945945945945946	0.03492063492063492	GO:0010564	GO:BP	regulation of cell cycle process	16175	4217		0.14	0.1456953642384106	630	15545	22	15	608	15530	16175	0.13751578013102583
M1	cpdb	0	network_modules	90	TRUE	8.403906321976551e-19	300	37	18	0.4864864864864865	0.06	GO:0009314	GO:BP	response to radiation	16175	3460		0.14666666666666667	0.152317880794702	300	15875	18	19	282	15856	16175	0.16607045099135945
M1	cpdb	0	network_modules	90	TRUE	3.4988090944596235e-18	92	36	14	0.3888888888888889	0.15217391304347827	REAC:R-HSA-6804756	REAC	Regulation of TP53 Activity through Phosphorylation	10916	2016		0.19387755102040816	0.20202020202020202	92	10824	14	22	78	10802	10916	0.2393991188002782
M1	cpdb	0	network_modules	90	TRUE	8.015046516557183e-18	167	36	16	0.4444444444444444	0.09580838323353294	REAC:R-HSA-69481	REAC	G2/M Checkpoints	10916	1005		0.20408163265306123	0.21212121212121213	167	10749	16	20	151	10729	10916	0.20112355155537553
M1	cpdb	0	network_modules	90	TRUE	1.0163615741920477e-17	51	36	12	0.3333333333333333	0.23529411764705882	REAC:R-HSA-180786	REAC	Extension of Telomeres	10916	887		0.21428571428571427	0.2222222222222222	51	10865	12	24	39	10841	10916	0.27723555999376037
M1	cpdb	0	network_modules	90	TRUE	1.023919781218973e-17	90	37	13	0.35135135135135137	0.14444444444444443	GO:0010212	GO:BP	response to ionizing radiation	16175	3993		0.15333333333333332	0.15894039735099338	90	16085	13	24	77	16061	16175	0.2225857887953808
M1	cpdb	0	network_modules	90	TRUE	1.6665439853681164e-17	172	37	15	0.40540540540540543	0.0872093023255814	GO:0000724	GO:BP	double-strand break repair via homologous recombination	16175	203		0.16	0.16556291390728478	172	16003	15	22	157	15981	16175	0.1842898404972139
M1	cpdb	0	network_modules	90	TRUE	2.4128765960656877e-17	24	36	10	0.2777777777777778	0.4166666666666667	REAC:R-HSA-9709603	REAC	Impaired BRCA2 binding to PALB2	10916	1172		0.22448979591836735	0.23232323232323232	24	10892	10	26	14	10866	10916	0.33844435957106705
M1	cpdb	0	network_modules	90	TRUE	4.012737312212672e-17	25	36	10	0.2777777777777778	0.4	REAC:R-HSA-9701193	REAC	Defective homologous recombination repair (HRR) due to PALB2 loss of function	10916	699		0.23469387755102042	0.2727272727272727	25	10891	10	26	15	10865	10916	0.3315113800275144
M1	cpdb	0	network_modules	90	TRUE	4.012737312212672e-17	25	36	10	0.2777777777777778	0.4	REAC:R-HSA-9704646	REAC	Defective HDR through Homologous Recombination Repair (HRR) due to PALB2 loss of BRCA2/RAD51/RAD51C binding function	10916	563		0.23469387755102042	0.2727272727272727	25	10891	10	26	15	10865	10916	0.3315113800275144
M1	cpdb	0	network_modules	90	TRUE	4.012737312212672e-17	25	36	10	0.2777777777777778	0.4	REAC:R-HSA-9701192	REAC	Defective homologous recombination repair (HRR) due to BRCA1 loss of function	10916	697		0.23469387755102042	0.2727272727272727	25	10891	10	26	15	10865	10916	0.3315113800275144
M1	cpdb	0	network_modules	90	TRUE	4.012737312212672e-17	25	36	10	0.2777777777777778	0.4	REAC:R-HSA-9704331	REAC	Defective HDR through Homologous Recombination Repair (HRR) due to PALB2 loss of BRCA1 binding function	10916	562		0.23469387755102042	0.2727272727272727	25	10891	10	26	15	10865	10916	0.3315113800275144
M1	cpdb	0	network_modules	90	TRUE	4.995984409080544e-17	376	37	18	0.4864864864864865	0.047872340425531915	GO:1901987	GO:BP	regulation of cell cycle phase transition	16175	21920		0.16666666666666666	0.17218543046357615	376	15799	18	19	358	15780	16175	0.14720356148368696
M1	cpdb	0	network_modules	90	TRUE	5.631219116416902e-17	111	36	14	0.3888888888888889	0.12612612612612611	REAC:R-HSA-157579	REAC	Telomere Maintenance	10916	2489		0.2755102040816326	0.2828282828282828	111	10805	14	22	97	10783	10916	0.21714261944961008
M1	cpdb	0	network_modules	90	TRUE	1.0311515312193335e-16	27	36	10	0.2777777777777778	0.37037037037037035	REAC:R-HSA-5693554	REAC	Resolution of D-loop Structures through Synthesis-Dependent Strand Annealing (SDSA)	10916	2078		0.2857142857142857	0.29292929292929293	27	10889	10	26	17	10863	10916	0.31881409476936456
M1	cpdb	0	network_modules	90	TRUE	1.1503120847379317e-16	86	36	13	0.3611111111111111	0.1511627906976744	REAC:R-HSA-912446	REAC	Meiotic recombination	10916	1411		0.29591836734693877	0.30303030303030304	86	10830	13	23	73	10807	10916	0.22982531263672912
M1	cpdb	0	network_modules	90	TRUE	1.5805638222147894e-16	88	36	13	0.3611111111111111	0.14772727272727273	REAC:R-HSA-73884	REAC	Base Excision Repair	10916	205		0.30612244897959184	0.31313131313131315	88	10828	13	23	75	10805	10916	0.22710177701237733
M1	cpdb	0	network_modules	90	TRUE	1.3406316765117937e-15	138	36	14	0.3888888888888889	0.10144927536231885	REAC:R-HSA-73886	REAC	Chromosome Maintenance	10916	357		0.3163265306122449	0.32323232323232326	138	10778	14	22	124	10756	10916	0.19371561157815603
M1	cpdb	0	network_modules	90	TRUE	1.5785655619768284e-15	34	36	10	0.2777777777777778	0.29411764705882354	REAC:R-HSA-5693568	REAC	Resolution of D-loop Structures through Holliday Junction Intermediates	10916	2077		0.32653061224489793	0.3333333333333333	34	10882	10	26	24	10856	10916	0.2835350820101596
M1	cpdb	0	network_modules	90	TRUE	2.2051945336951276e-15	35	36	10	0.2777777777777778	0.2857142857142857	REAC:R-HSA-5693537	REAC	Resolution of D-Loop Structures	10916	2076		0.336734693877551	0.3434343434343434	35	10881	10	26	25	10855	10916	0.2793748577163868
M1	cpdb	0	network_modules	90	TRUE	2.2393755522506976e-15	465	37	18	0.4864864864864865	0.03870967741935484	GO:0044770	GO:BP	cell cycle phase transition	16175	11146		0.17333333333333334	0.17880794701986755	465	15710	18	19	447	15691	16175	0.13116654876653702
M1	cpdb	0	network_modules	90	TRUE	2.313226259740466e-15	359	36	18	0.5	0.05013927576601671	REAC:R-HSA-3700989	REAC	Transcriptional Regulation by TP53	10916	2546		0.3469387755102041	0.35353535353535354	359	10557	18	18	341	10539	10916	0.15066220860498497
M1	cpdb	0	network_modules	90	TRUE	2.6101254863532133e-15	23	32	9	0.28125	0.391304347826087	KEGG:03430	KEGG	Mismatch repair	8484	239		0.1111111111111111	0.2	23	8461	9	23	14	8438	8484	0.329615157069456
M1	cpdb	0	network_modules	90	TRUE	4.171462517363072e-15	140	37	13	0.35135135135135137	0.09285714285714286	GO:0071897	GO:BP	DNA biosynthetic process	16175	16970		0.18	0.18543046357615894	140	16035	13	24	127	16011	16175	0.17714579808501998
M1	cpdb	0	network_modules	90	TRUE	5.911924763721295e-15	14	36	8	0.2222222222222222	0.5714285714285714	REAC:R-HSA-5358565	REAC	Mismatch repair (MMR) directed by MSH2:MSH6 (MutSalpha)	10916	1459		0.35714285714285715	0.36363636363636365	14	10902	8	28	6	10874	10916	0.35510516180882123
M1	cpdb	0	network_modules	90	TRUE	8.771822630632389e-15	148	37	13	0.35135135135135137	0.08783783783783784	GO:0071478	GO:BP	cellular response to radiation	16175	16711		0.18666666666666668	0.19205298013245034	148	16027	13	24	135	16003	16175	0.1720858407422105
M1	cpdb	0	network_modules	90	TRUE	1.1231188206658239e-14	160	36	14	0.3888888888888889	0.0875	REAC:R-HSA-5633007	REAC	Regulation of TP53 Activity	10916	2012		0.3673469387755102	0.37373737373737376	160	10756	14	22	146	10734	10916	0.17912462245007246
M1	cpdb	0	network_modules	90	TRUE	1.2639495229206734e-14	15	36	8	0.2222222222222222	0.5333333333333333	REAC:R-HSA-5358508	REAC	Mismatch Repair	10916	1457		0.37755102040816324	0.3838383838383838	15	10901	8	28	7	10873	10916	0.34293766216074417
M1	cpdb	0	network_modules	90	TRUE	3.0460604534639847e-14	53	37	10	0.2702702702702703	0.18867924528301888	GO:0071479	GO:BP	cellular response to ionizing radiation	16175	16712		0.19333333333333333	0.1986754966887417	53	16122	10	27	43	16095	16175	0.22370400944723148
M1	cpdb	0	network_modules	90	TRUE	4.046762696864976e-14	120	37	12	0.32432432432432434	0.1	GO:0051053	GO:BP	negative regulation of DNA metabolic process	16175	13463		0.2	0.2052980132450331	120	16055	12	25	108	16030	16175	0.1768293093341021
M1	cpdb	0	network_modules	90	TRUE	4.110417547460754e-14	68	36	11	0.3055555555555556	0.16176470588235295	REAC:R-HSA-5693571	REAC	Nonhomologous End-Joining (NHEJ)	10916	1605		0.3877551020408163	0.3939393939393939	68	10848	11	25	57	10823	10916	0.21883446429773823
M1	cpdb	0	network_modules	90	TRUE	4.6447923698030087e-14	84	37	11	0.2972972972972973	0.13095238095238096	GO:0010833	GO:BP	telomere maintenance via telomere lengthening	16175	4443		0.20666666666666667	0.2119205298013245	84	16091	11	26	73	16065	16175	0.19459280801502007
M1	cpdb	0	network_modules	90	TRUE	5.757003923036464e-14	289	36	16	0.4444444444444444	0.05536332179930796	REAC:R-HSA-69620	REAC	Cell Cycle Checkpoints	10916	321		0.3979591836734694	0.40404040404040403	289	10627	16	20	273	10607	10916	0.14975823282896517
M1	cpdb	0	network_modules	90	TRUE	1.3595568330325816e-13	701	37	19	0.5135135135135135	0.02710413694721826	GO:0009628	GO:BP	response to abiotic stimulus	16175	3549		0.21333333333333335	0.2185430463576159	701	15474	19	18	682	15456	16175	0.11056547851577982
M1	cpdb	0	network_modules	90	TRUE	1.5850103703902263e-13	134	37	12	0.32432432432432434	0.08955223880597014	GO:0007093	GO:BP	mitotic cell cycle checkpoint signaling	16175	2676		0.22	0.2251655629139073	134	16041	12	25	122	16016	16175	0.1669529667234707
M1	cpdb	0	network_modules	90	TRUE	1.9342797367954258e-13	54	32	10	0.3125	0.18518518518518517	KEGG:03460	KEGG	Fanconi anemia pathway	8484	242		0.2222222222222222	0.3	54	8430	10	22	44	8408	8484	0.23686360382655283
M1	cpdb	0	network_modules	90	TRUE	2.34146564021928e-13	251	37	14	0.3783783783783784	0.055776892430278883	GO:0071214	GO:BP	cellular response to abiotic stimulus	16175	16476		0.22666666666666666	0.23841059602649006	251	15924	14	23	237	15901	16175	0.14057146462177278
M1	cpdb	0	network_modules	90	TRUE	2.34146564021928e-13	251	37	14	0.3783783783783784	0.055776892430278883	GO:0104004	GO:BP	cellular response to environmental stimulus	16175	19202		0.22666666666666666	0.23841059602649006	251	15924	14	23	237	15901	16175	0.14057146462177278
M1	cpdb	0	network_modules	90	TRUE	2.7443780359494586e-13	98	37	11	0.2972972972972973	0.11224489795918367	GO:2001252	GO:BP	positive regulation of chromosome organization	16175	26441		0.24	0.24503311258278146	98	16077	11	26	87	16051	16175	0.1797022993672326
M1	cpdb	0	network_modules	90	TRUE	3.942473698011669e-13	21	36	8	0.2222222222222222	0.38095238095238093	REAC:R-HSA-5651801	REAC	PCNA-Dependent Long Patch Base Excision Repair	10916	1658		0.40816326530612246	0.41414141414141414	21	10895	8	28	13	10867	10916	0.28919347379783694
M1	cpdb	0	network_modules	90	TRUE	4.541032471978223e-13	36	36	9	0.25	0.25	REAC:R-HSA-73933	REAC	Resolution of Abasic Sites (AP sites)	10916	2075		0.41836734693877553	0.42424242424242425	36	10880	9	27	27	10853	10916	0.24751838235294119
M1	cpdb	0	network_modules	90	TRUE	5.183960284277468e-13	69	37	10	0.2702702702702703	0.14492753623188406	GO:0032206	GO:BP	positive regulation of telomere maintenance	16175	7398		0.24666666666666667	0.25165562913907286	69	16106	10	27	59	16079	16175	0.19542979165828514
M1	cpdb	0	network_modules	90	TRUE	7.018004032172741e-13	71	37	10	0.2702702702702703	0.14084507042253522	GO:0006278	GO:BP	RNA-templated DNA biosynthetic process	16175	2093		0.25333333333333335	0.26490066225165565	71	16104	10	27	61	16077	16175	0.1925800012534337
M1	cpdb	0	network_modules	90	TRUE	7.018004032172741e-13	71	37	10	0.2702702702702703	0.14084507042253522	GO:0007004	GO:BP	telomere maintenance via telomerase	16175	2616		0.25333333333333335	0.26490066225165565	71	16104	10	27	61	16077	16175	0.1925800012534337
M1	cpdb	0	network_modules	90	TRUE	7.416874015057776e-13	207	37	13	0.35135135135135137	0.06280193236714976	GO:0006282	GO:BP	regulation of DNA repair	16175	2096		0.26666666666666666	0.271523178807947	207	15968	13	24	194	15944	16175	0.14422401616235372
M1	cpdb	0	network_modules	90	TRUE	1.3926860179000569e-12	113	37	11	0.2972972972972973	0.09734513274336283	GO:0000018	GO:BP	regulation of DNA recombination	16175	6		0.2733333333333333	0.2781456953642384	113	16062	11	26	102	16036	16175	0.16689566858634525
M1	cpdb	0	network_modules	90	TRUE	1.6521565571472863e-12	77	37	10	0.2702702702702703	0.12987012987012986	GO:0044773	GO:BP	mitotic DNA damage checkpoint signaling	16175	11149		0.28	0.2847682119205298	77	16098	10	27	67	16071	16175	0.18470114537777557
M1	cpdb	0	network_modules	90	TRUE	2.0763999368572995e-12	25	36	8	0.2222222222222222	0.32	REAC:R-HSA-110373	REAC	Resolution of AP sites via the multiple-nucleotide patch replacement pathway	10916	2073		0.42857142857142855	0.43434343434343436	25	10891	8	28	17	10863	10916	0.26465791199905797
M1	cpdb	0	network_modules	90	TRUE	2.2280231177512897e-12	29	37	8	0.21621621621621623	0.27586206896551724	GO:0006298	GO:BP	mismatch repair	16175	2107		0.2866666666666667	0.2913907284768212	29	16146	8	29	21	16117	16175	0.24269501219909784
M1	cpdb	0	network_modules	90	TRUE	2.5350144494093456e-12	14	36	7	0.19444444444444445	0.5	REAC:R-HSA-5358606	REAC	Mismatch repair (MMR) directed by MSH2:MSH3 (MutSbeta)	10916	1458		0.4387755102040816	0.4444444444444444	14	10902	7	29	7	10873	10916	0.3104593502094352
M1	cpdb	0	network_modules	90	TRUE	2.811808558215391e-12	81	37	10	0.2702702702702703	0.12345679012345678	GO:0044774	GO:BP	mitotic DNA integrity checkpoint signaling	16175	11150		0.29333333333333333	0.2980132450331126	81	16094	10	27	71	16067	16175	0.1799375137847103
M1	cpdb	0	network_modules	90	TRUE	1.210077054266595e-11	35	37	8	0.21621621621621623	0.22857142857142856	GO:0033260	GO:BP	nuclear DNA replication	16175	8103		0.3	0.304635761589404	35	16140	8	29	27	16111	16175	0.22057413045542562
M1	cpdb	0	network_modules	90	TRUE	1.2612374307593946e-11	9	37	6	0.16216216216216217	0.6666666666666666	GO:0032201	GO:BP	telomere maintenance via semi-conservative replication	16175	7393		0.30666666666666664	0.31125827814569534	9	16166	6	31	3	16135	16175	0.32813651205176825
M1	cpdb	0	network_modules	90	TRUE	1.9786720485028122e-11	37	37	8	0.21621621621621623	0.21621621621621623	GO:0016233	GO:BP	telomere capping	16175	5178		0.31333333333333335	0.31788079470198677	37	16138	8	29	29	16109	16175	0.21441921534869857
M1	cpdb	0	network_modules	90	TRUE	2.0616630757413475e-11	437	37	15	0.40540540540540543	0.034324942791762014	GO:0080135	GO:BP	regulation of cellular response to stress	16175	17817		0.32	0.32450331125827814	437	15738	15	22	422	15716	16175	0.1117487375020552
M1	cpdb	0	network_modules	90	TRUE	2.35561978597649e-11	202	37	12	0.32432432432432434	0.0594059405940594	GO:0045930	GO:BP	negative regulation of mitotic cell cycle	16175	11724		0.32666666666666666	0.33112582781456956	202	15973	12	25	190	15948	16175	0.13445516799583837
M1	cpdb	0	network_modules	90	TRUE	3.143052046151868e-11	39	37	8	0.21621621621621623	0.20512820512820512	GO:0044786	GO:BP	cell cycle DNA replication	16175	11158		0.3333333333333333	0.33774834437086093	39	16136	8	29	31	16107	16175	0.20874115666163615
M1	cpdb	0	network_modules	90	TRUE	3.772443229607919e-11	104	37	10	0.2702702702702703	0.09615384615384616	GO:0032204	GO:BP	regulation of telomere maintenance	16175	7396		0.34	0.3443708609271523	104	16071	10	27	94	16044	16175	0.1580606607303879
M1	cpdb	0	network_modules	90	TRUE	5.646458357988148e-11	20	36	7	0.19444444444444445	0.35	REAC:R-HSA-69186	REAC	Lagging Strand Synthesis	10916	1302		0.4489795918367347	0.45454545454545453	20	10896	7	29	13	10867	10916	0.25908110310972604
M1	cpdb	0	network_modules	90	TRUE	6.000955951864903e-11	42	37	8	0.21621621621621623	0.19047619047619047	GO:0006284	GO:BP	base-excision repair	16175	2098		0.3466666666666667	0.3509933774834437	42	16133	8	29	34	16104	16175	0.20099220506719892
M1	cpdb	0	network_modules	90	TRUE	6.461176291975494e-11	159	37	11	0.2972972972972973	0.06918238993710692	GO:1901991	GO:BP	negative regulation of mitotic cell cycle phase transition	16175	21924		0.35333333333333333	0.3576158940397351	159	16016	11	26	148	15990	16175	0.13951894152731095
M1	cpdb	0	network_modules	90	TRUE	1.3787634640641435e-10	118	37	10	0.2702702702702703	0.0847457627118644	GO:0034502	GO:BP	protein localization to chromosome	16175	8668		0.36	0.36423841059602646	118	16057	10	27	108	16030	16175	0.14796590474865778
M1	cpdb	0	network_modules	90	TRUE	1.5860604925067015e-10	47	37	8	0.21621621621621623	0.1702127659574468	GO:0044818	GO:BP	mitotic G2/M transition checkpoint	16175	11174		0.36666666666666664	0.3708609271523179	47	16128	8	29	39	16099	16175	0.18975504798185527
M1	cpdb	0	network_modules	90	TRUE	2.1743594660740038e-10	13	32	6	0.1875	0.46153846153846156	KEGG:03450	KEGG	Non-homologous end-joining	8484	241		0.3333333333333333	0.4	13	8471	6	26	7	8445	8484	0.2925461700475293
M1	cpdb	0	network_modules	90	TRUE	2.4873666034539275e-10	12	36	6	0.16666666666666666	0.5	REAC:R-HSA-5685939	REAC	HDR through MMEJ (alt-NHEJ)	10916	1099		0.45918367346938777	0.46464646464646464	12	10904	6	30	6	10874	10916	0.2874031453712724
M1	cpdb	0	network_modules	90	TRUE	3.4607980732654196e-10	25	36	7	0.19444444444444445	0.28	REAC:R-HSA-5696397	REAC	Gap-filling DNA repair synthesis and ligation in GG-NER	10916	1037		0.46938775510204084	0.47474747474747475	25	10891	7	29	18	10862	10916	0.23123117798482976
M1	cpdb	0	network_modules	90	TRUE	7.099570825370378e-10	77	36	9	0.25	0.11688311688311688	REAC:R-HSA-5693565	REAC	Recruitment and ATM-mediated phosphorylation of repair and signaling proteins at DNA double strand breaks	10916	1949		0.47959183673469385	0.48484848484848486	77	10839	9	27	68	10812	10916	0.1669822665535465
M1	cpdb	0	network_modules	90	TRUE	7.316148044467648e-10	31	37	7	0.1891891891891892	0.22580645161290322	GO:0070198	GO:BP	protein localization to chromosome, telomeric region	16175	15981		0.37333333333333335	0.37748344370860926	31	16144	7	30	24	16114	16175	0.20502566703944006
M1	cpdb	0	network_modules	90	TRUE	7.441071102741207e-10	15	37	6	0.16216216216216217	0.4	GO:0090656	GO:BP	t-circle formation	16175	18390		0.38	0.3973509933774834	15	16160	6	31	9	16129	16175	0.253637103586867
M1	cpdb	0	network_modules	90	TRUE	7.441071102741207e-10	15	37	6	0.16216216216216217	0.4	GO:0090737	GO:BP	telomere maintenance via telomere trimming	16175	18437		0.38	0.3973509933774834	15	16160	6	31	9	16129	16175	0.253637103586867
M1	cpdb	0	network_modules	90	TRUE	7.441071102741207e-10	15	37	6	0.16216216216216217	0.4	GO:0001325	GO:BP	formation of extrachromosomal circular DNA	16175	311		0.38	0.3973509933774834	15	16160	6	31	9	16129	16175	0.253637103586867
M1	cpdb	0	network_modules	90	TRUE	8.007647609448652e-10	78	36	9	0.25	0.11538461538461539	REAC:R-HSA-5693606	REAC	DNA Double Strand Break Response	10916	442		0.4897959183673469	0.494949494949495	78	10838	9	27	69	10811	10916	0.16585350569032503
M1	cpdb	0	network_modules	90	TRUE	8.045871905048375e-10	14	36	6	0.16666666666666666	0.42857142857142855	REAC:R-HSA-69166	REAC	Removal of the Flap Intermediate	10916	2058		0.5	0.5050505050505051	14	10902	6	30	8	10872	10916	0.2658135386100492
M1	cpdb	0	network_modules	90	TRUE	1.0972014739027362e-9	59	37	8	0.21621621621621623	0.13559322033898305	GO:0010972	GO:BP	negative regulation of G2/M transition of mitotic cell cycle	16175	4548		0.4	0.40397350993377484	59	16116	8	29	51	16087	16175	0.1688358999712769
M1	cpdb	0	network_modules	90	TRUE	1.337817255818521e-9	15	36	6	0.16666666666666666	0.4	REAC:R-HSA-69183	REAC	Processive synthesis on the lagging strand	10916	1802		0.5102040816326531	0.5151515151515151	15	10901	6	30	9	10871	10916	0.25666980208454276
M1	cpdb	0	network_modules	90	TRUE	1.4524449130462487e-9	61	37	8	0.21621621621621623	0.13114754098360656	GO:0035825	GO:BP	homologous recombination	16175	9273		0.4066666666666667	0.41721854304635764	61	16114	8	29	53	16085	16175	0.16595874418274104
M1	cpdb	0	network_modules	90	TRUE	1.4524449130462487e-9	61	37	8	0.21621621621621623	0.13114754098360656	GO:1902750	GO:BP	negative regulation of cell cycle G2/M phase transition	16175	22476		0.4066666666666667	0.41721854304635764	61	16114	8	29	53	16085	16175	0.16595874418274104
M1	cpdb	0	network_modules	90	TRUE	1.4950007146291529e-9	286	37	12	0.32432432432432434	0.04195804195804196	GO:1901990	GO:BP	regulation of mitotic cell cycle phase transition	16175	21923		0.42	0.423841059602649	286	15889	12	25	274	15864	16175	0.1114093526919002
M1	cpdb	0	network_modules	90	TRUE	2.3840286734984956e-9	32	36	7	0.19444444444444445	0.21875	REAC:R-HSA-69190	REAC	DNA strand elongation	10916	449		0.5204081632653061	0.5252525252525253	32	10884	7	29	25	10855	10916	0.20376484581149645
M1	cpdb	0	network_modules	90	TRUE	3.065429669486687e-9	36	32	7	0.21875	0.19444444444444445	KEGG:03030	KEGG	DNA replication	8484	214		0.4444444444444444	0.5	36	8448	7	25	29	8423	8484	0.20305262161052665
M1	cpdb	0	network_modules	90	TRUE	3.5941921501369003e-9	229	37	11	0.2972972972972973	0.048034934497816595	GO:0033044	GO:BP	regulation of chromosome organization	16175	7999		0.4266666666666667	0.4304635761589404	229	15946	11	26	218	15920	16175	0.11475651753343384
M1	cpdb	0	network_modules	90	TRUE	4.248719989265982e-9	8	37	5	0.13513513513513514	0.625	GO:0110025	GO:BP	DNA strand resection involved in replication fork processing	16175	19356		0.43333333333333335	0.4370860927152318	8	16167	5	32	3	16135	16175	0.28995889975566175
M1	cpdb	0	network_modules	90	TRUE	5.296359428268249e-9	114	37	9	0.24324324324324326	0.07894736842105263	GO:0000086	GO:BP	G2/M transition of mitotic cell cycle	16175	34		0.44	0.44370860927152317	114	16061	9	28	105	16033	16175	0.13519258907664225
M1	cpdb	0	network_modules	90	TRUE	7.431308646885319e-9	656	37	15	0.40540540540540543	0.022865853658536585	GO:1903047	GO:BP	mitotic cell cycle process	16175	22727		0.44666666666666666	0.4503311258278146	656	15519	15	22	641	15497	16175	0.08856245752769976
M1	cpdb	0	network_modules	90	TRUE	8.150959949811953e-9	427	37	13	0.35135135135135137	0.03044496487119438	GO:0007346	GO:BP	regulation of mitotic cell cycle	16175	2855		0.4533333333333333	0.45695364238410596	427	15748	13	24	414	15724	16175	0.0970540482636808
M1	cpdb	0	network_modules	90	TRUE	1.4811842250248243e-8	23	37	6	0.16216216216216217	0.2608695652173913	GO:0010332	GO:BP	response to gamma radiation	16175	4062		0.46	0.46357615894039733	23	16152	6	31	17	16121	16175	0.2042526825031576
M1	cpdb	0	network_modules	90	TRUE	1.523842636099657e-8	128	37	9	0.24324324324324326	0.0703125	GO:0044839	GO:BP	cell cycle G2/M phase transition	16175	11188		0.4666666666666667	0.47019867549668876	128	16047	9	28	119	16019	16175	0.12717311352238073
M1	cpdb	0	network_modules	90	TRUE	2.51445784034413e-8	86	37	8	0.21621621621621623	0.09302325581395349	GO:0010389	GO:BP	regulation of G2/M transition of mitotic cell cycle	16175	4098		0.47333333333333333	0.4768211920529801	86	16089	8	29	78	16060	16175	0.13886149134242712
M1	cpdb	0	network_modules	90	TRUE	3.069333116841602e-8	370	37	12	0.32432432432432434	0.032432432432432434	GO:0044772	GO:BP	mitotic cell cycle phase transition	16175	11148		0.48	0.48344370860927155	370	15805	12	25	358	15780	16175	0.0965465538911643
M1	cpdb	0	network_modules	90	TRUE	4.42599998992214e-8	79	36	8	0.2222222222222222	0.10126582278481013	REAC:R-HSA-2559586	REAC	DNA Damage/Telomere Stress Induced Senescence	10916	441		0.5306122448979592	0.5353535353535354	79	10837	8	28	71	10809	10916	0.14589509377617282
M1	cpdb	0	network_modules	90	TRUE	5.996209225243381e-8	26	36	6	0.16666666666666666	0.23076923076923078	REAC:R-HSA-174411	REAC	Polymerase switching on the C-strand of the telomere	10916	1770		0.5408163265306123	0.5454545454545454	26	10890	6	30	20	10860	10916	0.19386401807205894
M1	cpdb	0	network_modules	90	TRUE	7.311659696915601e-8	84	36	8	0.2222222222222222	0.09523809523809523	REAC:R-HSA-5696399	REAC	Global Genome Nucleotide Excision Repair (GG-NER)	10916	1047		0.5510204081632653	0.5555555555555556	84	10832	8	28	76	10804	10916	0.14121749857990853
M1	cpdb	0	network_modules	90	TRUE	7.315523307596825e-8	98	37	8	0.21621621621621623	0.08163265306122448	GO:1902749	GO:BP	regulation of cell cycle G2/M phase transition	16175	22475		0.4866666666666667	0.4900662251655629	98	16077	8	29	90	16048	16175	0.12967301591296743
M1	cpdb	0	network_modules	90	TRUE	1.0662097446759187e-7	31	37	6	0.16216216216216217	0.1935483870967742	GO:0007095	GO:BP	mitotic G2 DNA damage checkpoint signaling	16175	2678		0.49333333333333335	0.4966887417218543	31	16144	6	31	25	16113	16175	0.17543654014243135
M1	cpdb	0	network_modules	90	TRUE	1.076767151836774e-7	792	37	15	0.40540540540540543	0.01893939393939394	GO:0000278	GO:BP	mitotic cell cycle	16175	76		0.5	0.5033112582781457	792	15383	15	22	777	15361	16175	0.07909058402137538
M1	cpdb	0	network_modules	90	TRUE	1.501602404146395e-7	61	32	7	0.21875	0.11475409836065574	KEGG:03420	KEGG	Nucleotide excision repair	8484	238		0.5555555555555556	0.6	61	8423	7	25	54	8398	8484	0.1540746307652398
M1	cpdb	0	network_modules	90	TRUE	1.5319154641190088e-7	30	36	6	0.16666666666666666	0.2	REAC:R-HSA-110314	REAC	Recognition of DNA damage by PCNA-containing replication complex	10916	1948		0.5612244897959183	0.5656565656565656	30	10886	6	30	24	10856	10916	0.18010810747017036
M1	cpdb	0	network_modules	90	TRUE	2.3269226277271613e-7	32	36	6	0.16666666666666666	0.1875	REAC:R-HSA-5656169	REAC	Termination of translesion DNA synthesis	10916	2492		0.5714285714285714	0.5757575757575758	32	10884	6	30	26	10854	10916	0.17421000848916993
M1	cpdb	0	network_modules	90	TRUE	2.887963999187166e-7	61	36	7	0.19444444444444445	0.11475409836065574	REAC:R-HSA-6796648	REAC	TP53 Regulates Transcription of DNA Repair Genes	10916	2456		0.5816326530612245	0.5858585858585859	61	10855	7	29	54	10826	10916	0.1457310231875864
M1	cpdb	0	network_modules	90	TRUE	3.3334475174540537e-7	37	37	6	0.16216216216216217	0.16216216216216217	GO:0032205	GO:BP	negative regulation of telomere maintenance	16175	7397		0.5066666666666667	0.5099337748344371	37	16138	6	31	31	16107	16175	0.16024123020033293
M1	cpdb	0	network_modules	90	TRUE	3.645404287605063e-7	63	36	7	0.19444444444444445	0.1111111111111111	REAC:R-HSA-6782210	REAC	Gap-filling DNA repair synthesis and ligation in TC-NER	10916	1038		0.5918367346938775	0.5959595959595959	63	10853	7	29	56	10824	10916	0.14327325834888907
M1	cpdb	0	network_modules	90	TRUE	4.0895723707234245e-7	16	36	5	0.1388888888888889	0.3125	REAC:R-HSA-110312	REAC	Translesion synthesis by REV1	10916	2576		0.6020408163265306	0.6060606060606061	16	10900	5	31	11	10869	10916	0.20662696192537508
M1	cpdb	0	network_modules	90	TRUE	4.6256085743169025e-7	17	37	5	0.13513513513513514	0.29411764705882354	GO:0071480	GO:BP	cellular response to gamma radiation	16175	16713		0.5133333333333333	0.5165562913907285	17	16158	5	32	12	16126	16175	0.1981433098327478
M1	cpdb	0	network_modules	90	TRUE	4.892440903668568e-7	6	36	4	0.1111111111111111	0.6666666666666666	REAC:R-HSA-5693548	REAC	Sensing of DNA Double Strand Breaks	10916	2195		0.6122448979591837	0.6161616161616161	6	10910	4	32	2	10878	10916	0.27134141861781136
M1	cpdb	0	network_modules	90	TRUE	5.779842203494976e-7	17	36	5	0.1388888888888889	0.29411764705882354	REAC:R-HSA-5655862	REAC	Translesion synthesis by POLK	10916	2575		0.6224489795918368	0.6363636363636364	17	10899	5	31	12	10868	10916	0.20033315874505
M1	cpdb	0	network_modules	90	TRUE	5.779842203494976e-7	17	36	5	0.1388888888888889	0.29411764705882354	REAC:R-HSA-5656121	REAC	Translesion synthesis by POLI	10916	2574		0.6224489795918368	0.6363636363636364	17	10899	5	31	12	10868	10916	0.20033315874505
M1	cpdb	0	network_modules	90	TRUE	6.016428513168329e-7	109	36	8	0.2222222222222222	0.07339449541284404	REAC:R-HSA-5696398	REAC	Nucleotide Excision Repair	10916	1622		0.6428571428571429	0.6464646464646465	109	10807	8	28	101	10779	10916	0.1227878392143683
M1	cpdb	0	network_modules	90	TRUE	6.742479710128059e-7	129	37	8	0.21621621621621623	0.06201550387596899	GO:0009411	GO:BP	response to UV	16175	3476		0.52	0.5231788079470199	129	16046	8	29	121	16017	16175	0.11210066120360525
M1	cpdb	0	network_modules	90	TRUE	7.460154741986973e-7	42	37	6	0.16216216216216217	0.14285714285714285	GO:0045910	GO:BP	negative regulation of DNA recombination	16175	11704		0.5266666666666666	0.5298013245033113	42	16133	6	31	36	16102	16175	0.15013337621120118
M1	cpdb	0	network_modules	90	TRUE	8.240404536754945e-7	39	36	6	0.16666666666666666	0.15384615384615385	REAC:R-HSA-110313	REAC	Translesion synthesis by Y family DNA polymerases bypasses lesions on DNA template	10916	2577		0.6530612244897959	0.6565656565656566	39	10877	6	30	33	10847	10916	0.1572357361039181
M1	cpdb	0	network_modules	90	TRUE	8.243025181604701e-7	44	32	6	0.1875	0.13636363636363635	KEGG:03410	KEGG	Base excision repair	8484	237		0.6666666666666666	0.7	44	8440	6	26	38	8414	8484	0.1561772631938263
M1	cpdb	0	network_modules	90	TRUE	8.663430279319122e-7	19	37	5	0.13513513513513514	0.2631578947368421	GO:2000001	GO:BP	regulation of DNA damage checkpoint	16175	25365		0.5333333333333333	0.5364238410596026	19	16156	5	32	14	16124	16175	0.1872635609201421
M1	cpdb	0	network_modules	90	TRUE	1.0005851464253322e-6	44	37	6	0.16216216216216217	0.13636363636363635	GO:0032508	GO:BP	DNA duplex unwinding	16175	7615		0.54	0.543046357615894	44	16131	6	31	38	16100	16175	0.14657699485892875
M1	cpdb	0	network_modules	90	TRUE	1.0809646339985572e-6	19	36	5	0.1388888888888889	0.2631578947368421	REAC:R-HSA-110320	REAC	Translesion Synthesis by POLH	10916	2573		0.6632653061224489	0.6666666666666666	19	10897	5	31	14	10866	10916	0.18926075156011787
M1	cpdb	0	network_modules	90	TRUE	1.130299902994681e-6	41	36	6	0.16666666666666666	0.14634146341463414	REAC:R-HSA-5696400	REAC	Dual Incision in GG-NER	10916	807		0.673469387755102	0.6767676767676768	41	10875	6	30	35	10845	10916	0.15319458362332722
M1	cpdb	0	network_modules	90	TRUE	1.1532189201569747e-6	20	37	5	0.13513513513513514	0.25	GO:0006312	GO:BP	mitotic recombination	16175	2117		0.5466666666666666	0.5496688741721855	20	16155	5	32	15	16123	16175	0.18244335275507553
M1	cpdb	0	network_modules	90	TRUE	1.301315989137604e-6	7	37	4	0.10810810810810811	0.5714285714285714	GO:1904354	GO:BP	negative regulation of telomere capping	16175	23741		0.5533333333333333	0.5562913907284768	7	16168	4	33	3	16135	16175	0.24789021454574503
M1	cpdb	0	network_modules	90	TRUE	1.5335234420209653e-6	77	36	7	0.19444444444444445	0.09090909090909091	REAC:R-HSA-6781827	REAC	Transcription-Coupled Nucleotide Excision Repair (TC-NER)	10916	2541		0.6836734693877551	0.6868686868686869	77	10839	7	29	70	10810	10916	0.1287977009908996
M1	cpdb	0	network_modules	90	TRUE	1.8884188375873892e-6	90	37	7	0.1891891891891892	0.07777777777777778	GO:2001251	GO:BP	negative regulation of chromosome organization	16175	26440		0.56	0.5629139072847682	90	16085	7	30	83	16055	16175	0.11820080340026758
M1	cpdb	0	network_modules	90	TRUE	2.385291524056117e-6	420	37	11	0.2972972972972973	0.02619047619047619	GO:0010638	GO:BP	positive regulation of organelle organization	16175	4284		0.5666666666666667	0.5695364238410596	420	15755	11	26	409	15729	16175	0.08169328182111903
M1	cpdb	0	network_modules	90	TRUE	2.8479669179767953e-6	52	37	6	0.16216216216216217	0.11538461538461539	GO:0032392	GO:BP	DNA geometric change	16175	7543		0.5733333333333334	0.5761589403973509	52	16123	6	31	46	16092	16175	0.1344463198258969
M1	cpdb	0	network_modules	90	TRUE	3.034212336128812e-6	48	36	6	0.16666666666666666	0.125	REAC:R-HSA-73893	REAC	DNA Damage Bypass	10916	438		0.6938775510204082	0.696969696969697	48	10868	6	30	42	10838	10916	0.1410722731982032
M1	cpdb	0	network_modules	90	TRUE	4.6694547813083404e-6	9	37	4	0.10810810810810811	0.4444444444444444	GO:0061820	GO:BP	telomeric D-loop disassembly	16175	15679		0.58	0.5827814569536424	9	16166	4	33	5	16133	16175	0.21838107955412353
M1	cpdb	0	network_modules	90	TRUE	6.911833361432788e-6	60	37	6	0.16216216216216217	0.1	GO:0071103	GO:BP	DNA conformation change	16175	16453		0.5866666666666667	0.5894039735099338	60	16115	6	31	54	16084	16175	0.12480421496184656
M1	cpdb	0	network_modules	90	TRUE	8.459291263279798e-6	62	37	6	0.16216216216216217	0.0967741935483871	GO:0006303	GO:BP	double-strand break repair via nonhomologous end joining	16175	2110		0.5933333333333334	0.5960264900662252	62	16113	6	31	56	16082	16175	0.12268654979976482
M1	cpdb	0	network_modules	90	TRUE	1.2189630012320985e-5	11	37	4	0.10810810810810811	0.36363636363636365	GO:0090657	GO:BP	telomeric loop disassembly	16175	18391		0.6	0.6026490066225165	11	16164	4	33	7	16131	16175	0.19731822949399735
M1	cpdb	0	network_modules	90	TRUE	1.7771671012416865e-5	3	37	3	0.08108108108108109	1	GO:0097695	GO:BP	establishment of protein-containing complex localization to telomere	16175	18726		0.6066666666666667	0.6158940397350994	3	16172	3	34	0	16138	16175	0.2844479148814264
M1	cpdb	0	network_modules	90	TRUE	1.7771671012416865e-5	3	37	3	0.08108108108108109	1	GO:0097694	GO:BP	establishment of RNA localization to telomere	16175	18725		0.6066666666666667	0.6158940397350994	3	16172	3	34	0	16138	16175	0.2844479148814264
M1	cpdb	0	network_modules	90	TRUE	1.7850035114293875e-5	64	36	6	0.16666666666666666	0.09375	REAC:R-HSA-6782135	REAC	Dual incision in TC-NER	10916	808		0.7040816326530612	0.7070707070707071	64	10852	6	30	58	10822	10916	0.12115784030167062
M1	cpdb	0	network_modules	90	TRUE	1.8254598204954324e-5	12	37	4	0.10810810810810811	0.3333333333333333	GO:0090399	GO:BP	replicative senescence	16175	18270		0.62	0.6225165562913907	12	16163	4	33	8	16130	16175	0.18881494208293637
M1	cpdb	0	network_modules	90	TRUE	2.245711371322898e-5	128	37	7	0.1891891891891892	0.0546875	GO:2000779	GO:BP	regulation of double-strand break repair	16175	26035		0.6266666666666667	0.6291390728476821	128	16047	7	30	121	16017	16175	0.09796209794822146
M1	cpdb	0	network_modules	90	TRUE	2.294038296066703e-5	13	36	4	0.1111111111111111	0.3076923076923077	REAC:R-HSA-3270619	REAC	IRF3-mediated induction of type I IFN	10916	1162		0.7142857142857143	0.7171717171717171	13	10903	4	32	9	10871	10916	0.1833298369725633
M1	cpdb	0	network_modules	90	TRUE	3.286286700510293e-5	304	37	9	0.24324324324324326	0.029605263157894735	GO:0010639	GO:BP	negative regulation of organelle organization	16175	4285		0.6333333333333333	0.6357615894039735	304	15871	9	28	295	15843	16175	0.07914047640752979
M1	cpdb	0	network_modules	90	TRUE	3.6327753500479215e-5	121	36	7	0.19444444444444445	0.05785123966942149	REAC:R-HSA-69239	REAC	Synthesis of DNA	10916	2376		0.7244897959183674	0.7272727272727273	121	10795	7	29	114	10766	10916	0.10073965128127263
M1	cpdb	0	network_modules	90	TRUE	3.7193529977902704e-5	79	37	6	0.16216216216216217	0.0759493670886076	GO:0006289	GO:BP	nucleotide-excision repair	16175	2102		0.64	0.6423841059602649	79	16096	6	31	73	16065	16175	0.1080229348162615
M1	cpdb	0	network_modules	90	TRUE	3.882894454487881e-5	37	36	5	0.1388888888888889	0.13513513513513514	REAC:R-HSA-176187	REAC	Activation of ATR in response to replication stress	10916	75		0.7346938775510204	0.7373737373737373	37	10879	5	31	32	10848	10916	0.13410416050493135
M1	cpdb	0	network_modules	90	TRUE	4.2169715569826573e-05	187	36	8	0.2222222222222222	0.0427807486631016	REAC:R-HSA-69306	REAC	DNA Replication	10916	445		0.7448979591836735	0.7474747474747475	187	10729	8	28	179	10701	10916	0.0909174746675878
M1	cpdb	0	network_modules	90	TRUE	4.573864228001615e-5	220	37	8	0.21621621621621623	0.03636363636363636	GO:0009416	GO:BP	response to light stimulus	16175	3480		0.6466666666666666	0.6490066225165563	220	15955	8	29	212	15926	16175	0.08375911918337296
M1	cpdb	0	network_modules	90	TRUE	5.0593273136097366e-5	76	36	6	0.16666666666666666	0.07894736842105263	REAC:R-HSA-1221632	REAC	Meiotic synapsis	10916	1412		0.7551020408163265	0.7575757575757576	76	10840	6	30	70	10810	10916	0.1104830868162135
M1	cpdb	0	network_modules	90	TRUE	5.104477801097332e-5	39	36	5	0.1388888888888889	0.1282051282051282	REAC:R-HSA-6783310	REAC	Fanconi Anemia Pathway	10916	932		0.7653061224489796	0.7676767676767676	39	10877	5	31	34	10846	10916	0.1304557121491286
M1	cpdb	0	network_modules	90	TRUE	5.3842539967486696e-5	41	37	5	0.13513513513513514	0.12195121951219512	GO:1901976	GO:BP	regulation of cell cycle checkpoint	16175	21911		0.6533333333333333	0.6556291390728477	41	16134	5	32	36	16102	16175	0.12627054118590467
M1	cpdb	0	network_modules	90	TRUE	5.598607686427499e-5	194	36	8	0.2222222222222222	0.041237113402061855	REAC:R-HSA-2559583	REAC	Cellular Senescence	10916	331		0.7755102040816326	0.7777777777777778	194	10722	8	28	186	10694	10916	0.08901208730239067
M1	cpdb	0	network_modules	90	TRUE	5.794575177604827e-5	85	37	6	0.16216216216216217	0.07058823529411765	GO:2000278	GO:BP	regulation of DNA biosynthetic process	16175	25603		0.66	0.6622516556291391	85	16090	6	31	79	16059	16175	0.10391434740144945
M1	cpdb	0	network_modules	90	TRUE	5.798377341585226e-5	16	36	4	0.1111111111111111	0.25	REAC:R-HSA-1834941	REAC	STING mediated induction of host immune responses	10916	2162		0.7857142857142857	0.7878787878787878	16	10900	4	32	12	10868	10916	0.16486079800460265
M1	cpdb	0	network_modules	90	TRUE	6.41976083930665e-5	577	37	11	0.2972972972972973	0.019064124783362217	GO:0043085	GO:BP	positive regulation of catalytic activity	16175	10518		0.6666666666666666	0.6688741721854304	577	15598	11	26	566	15572	16175	0.06754249695861778
M1	cpdb	0	network_modules	90	TRUE	7.097459460845628e-5	4	37	3	0.08108108108108109	0.75	GO:0031860	GO:BP	telomeric 3' overhang formation	16175	7276		0.6733333333333333	0.6754966887417219	4	16171	3	34	1	16137	16175	0.24615846845627437
M1	cpdb	0	network_modules	90	TRUE	1.0019887172808393e-4	155	32	7	0.21875	0.04516129032258064	KEGG:04218	KEGG	Cellular senescence	8484	295		0.7777777777777778	0.8	155	8329	7	25	148	8304	8484	0.0921096989018931
M1	cpdb	0	network_modules	90	TRUE	1.0787792810033924e-4	5	36	3	0.08333333333333333	0.6	REAC:R-HSA-5423599	REAC	Diseases of Mismatch Repair (MMR)	10916	760		0.7959183673469388	0.797979797979798	5	10911	3	33	2	10878	10916	0.22279637031326646
M1	cpdb	0	network_modules	90	TRUE	1.0912377380903937e-4	47	37	5	0.13513513513513514	0.10638297872340426	GO:0016445	GO:BP	somatic diversification of immunoglobulins	16175	5224		0.68	0.6821192052980133	47	16128	5	32	42	16096	16175	0.11762758772915846
M1	cpdb	0	network_modules	90	TRUE	1.0923064275512565e-4	157	32	7	0.21875	0.044585987261146494	KEGG:04110	KEGG	Cell cycle	8484	264		0.8888888888888888	0.9	157	8327	7	25	150	8302	8484	0.09142449327487032
M1	cpdb	0	network_modules	90	TRUE	1.7635397688776336e-4	20	37	4	0.10810810810810811	0.2	GO:0000729	GO:BP	DNA double-strand break processing	16175	206		0.6866666666666666	0.6887417218543046	20	16155	4	33	16	16122	16175	0.1456177306072831
M1	cpdb	0	network_modules	90	TRUE	1.7715672039774524e-4	5	37	3	0.08108108108108109	0.6	GO:0000019	GO:BP	regulation of mitotic recombination	16175	7		0.6933333333333334	0.695364238410596	5	16170	3	34	2	16136	16175	0.22000923774276243
M1	cpdb	0	network_modules	90	TRUE	1.833690430825374e-4	52	37	5	0.13513513513513514	0.09615384615384616	GO:0002200	GO:BP	somatic diversification of immune receptors	16175	738		0.7	0.7019867549668874	52	16123	5	32	47	16091	16175	0.11158538566295635
M1	cpdb	0	network_modules	90	TRUE	2.0213600020230923e-4	53	37	5	0.13513513513513514	0.09433962264150944	GO:0007131	GO:BP	reciprocal meiotic recombination	16175	2702		0.7066666666666667	0.7152317880794702	53	16122	5	32	48	16090	16175	0.11047930834737577
M1	cpdb	0	network_modules	90	TRUE	2.0213600020230923e-4	53	37	5	0.13513513513513514	0.09433962264150944	GO:0140527	GO:BP	reciprocal homologous recombination	16175	19808		0.7066666666666667	0.7152317880794702	53	16122	5	32	48	16090	16175	0.11047930834737577
M1	cpdb	0	network_modules	90	TRUE	2.0923736079547819e-4	808	37	12	0.32432432432432434	0.01485148514851485	GO:0033365	GO:BP	protein localization to organelle	16175	8175		0.72	0.7218543046357616	808	15367	12	25	796	15342	16175	0.06030562026255203
M1	cpdb	0	network_modules	90	TRUE	2.2239466313093138e-4	54	37	5	0.13513513513513514	0.09259259259259259	GO:0032210	GO:BP	regulation of telomere maintenance via telomerase	16175	7402		0.7266666666666667	0.7284768211920529	54	16121	5	32	49	16089	16175	0.10940364656480042
M1	cpdb	0	network_modules	90	TRUE	2.309217412191992e-4	107	37	6	0.16216216216216217	0.056074766355140186	GO:0061982	GO:BP	meiosis I cell cycle process	16175	15766		0.7333333333333333	0.7350993377483444	107	16068	6	31	101	16037	16175	0.0918775017257679
M1	cpdb	0	network_modules	90	TRUE	2.662772105138352e-4	162	36	7	0.19444444444444445	0.043209876543209874	REAC:R-HSA-69242	REAC	S Phase	10916	2111		0.8061224489795918	0.8080808080808081	162	10754	7	29	155	10725	10916	0.08544239878435639
M1	cpdb	0	network_modules	90	TRUE	3.0318269468476716e-4	112	37	6	0.16216216216216217	0.05357142857142857	GO:0006275	GO:BP	regulation of DNA replication	16175	2090		0.74	0.7417218543046358	112	16063	6	31	106	16032	16175	0.08963873181711206
M1	cpdb	0	network_modules	90	TRUE	3.833359755278713e-4	171	36	7	0.19444444444444445	0.04093567251461988	REAC:R-HSA-3108232	REAC	SUMO E3 ligases SUMOylate target proteins	10916	2163		0.8163265306122449	0.8181818181818182	171	10745	7	29	164	10716	10916	0.08281642071650172
M1	cpdb	0	network_modules	90	TRUE	4.5670434703300134e-4	25	37	4	0.10810810810810811	0.16	GO:1904353	GO:BP	regulation of telomere capping	16175	23740		0.7466666666666667	0.7483443708609272	25	16150	4	33	21	16117	16175	0.12988783621780656
M1	cpdb	0	network_modules	90	TRUE	4.7455456930841847e-4	72	32	5	0.15625	0.06944444444444445	KEGG:01524	KEGG	Platinum drug resistance	8484	198		1	1	72	8412	5	27	67	8385	8484	0.0991167399157523
M1	cpdb	0	network_modules	90	TRUE	4.8323939315125564e-4	177	36	7	0.19444444444444445	0.03954802259887006	REAC:R-HSA-2990846	REAC	SUMOylation	10916	2167		0.826530612244898	0.8282828282828283	177	10739	7	29	170	10710	10916	0.08117305383192187
M1	cpdb	0	network_modules	90	TRUE	4.869938949276848e-4	63	37	5	0.13513513513513514	0.07936507936507936	GO:1904356	GO:BP	regulation of telomere maintenance via telomere lengthening	16175	23743		0.7533333333333333	0.7549668874172185	63	16112	5	32	58	16080	16175	0.10088864653526526
M1	cpdb	0	network_modules	90	TRUE	5.33662697557989e-4	203	37	7	0.1891891891891892	0.034482758620689655	GO:0051321	GO:BP	meiotic cell cycle	16175	13648		0.76	0.7615894039735099	203	15972	7	30	196	15942	16175	0.07597647122903069
M1	cpdb	0	network_modules	90	TRUE	7.431766582300546e-4	66	36	5	0.1388888888888889	0.07575757575757576	REAC:R-HSA-9670095	REAC	Inhibition of DNA recombination at telomere	10916	1189		0.8367346938775511	0.8383838383838383	66	10850	5	31	61	10819	10916	0.09857147290916542
M1	cpdb	0	network_modules	90	TRUE	7.988048662824439e-4	583	37	10	0.2702702702702703	0.017152658662092625	GO:0051129	GO:BP	negative regulation of cellular component organization	16175	13513		0.7666666666666667	0.7682119205298014	583	15592	10	27	573	15565	16175	0.06016889690135957
M1	cpdb	0	network_modules	90	TRUE	8.012077079746903e-4	67	36	5	0.1388888888888889	0.07462686567164178	REAC:R-HSA-3371453	REAC	Regulation of HSF1-mediated heat shock response	10916	1977		0.8469387755102041	0.8484848484848485	67	10849	5	31	62	10818	10916	0.09777013912660028
M1	cpdb	0	network_modules	90	TRUE	8.902482605410346e-4	71	37	5	0.13513513513513514	0.07042253521126761	GO:0002377	GO:BP	immunoglobulin production	16175	907		0.7733333333333333	0.7880794701986755	71	16104	5	32	66	16072	16175	0.0947003257736385
M1	cpdb	0	network_modules	90	TRUE	8.902482605410346e-4	71	37	5	0.13513513513513514	0.07042253521126761	GO:0030330	GO:BP	DNA damage response, signal transduction by p53 class mediator	16175	6779		0.7733333333333333	0.7880794701986755	71	16104	5	32	66	16072	16175	0.0947003257736385
M1	cpdb	0	network_modules	90	TRUE	8.902482605410346e-4	71	37	5	0.13513513513513514	0.07042253521126761	GO:0010569	GO:BP	regulation of double-strand break repair via homologous recombination	16175	4222		0.7733333333333333	0.7880794701986755	71	16104	5	32	66	16072	16175	0.0947003257736385
M1	cpdb	0	network_modules	90	TRUE	0.0011249067819690199	31	37	4	0.10810810810810811	0.12903225806451613	GO:0044819	GO:BP	mitotic G1/S transition checkpoint signaling	16175	11175		0.7933333333333333	0.8013245033112583	31	16144	4	33	27	16111	16175	0.11625828634841391
M1	cpdb	0	network_modules	90	TRUE	0.0011249067819690199	31	37	4	0.10810810810810811	0.12903225806451613	GO:0031571	GO:BP	mitotic G1 DNA damage checkpoint signaling	16175	7221		0.7933333333333333	0.8013245033112583	31	16144	4	33	27	16111	16175	0.11625828634841391
M1	cpdb	0	network_modules	90	TRUE	0.0011470675502530403	72	36	5	0.1388888888888889	0.06944444444444445	REAC:R-HSA-3108214	REAC	SUMOylation of DNA damage response and repair proteins	10916	2168		0.8571428571428571	0.8585858585858586	72	10844	5	31	67	10813	10916	0.0940105101788787
M1	cpdb	0	network_modules	90	TRUE	0.0015208023524659936	79	37	5	0.13513513513513514	0.06329113924050633	GO:0008630	GO:BP	intrinsic apoptotic signaling pathway in response to DNA damage	16175	3218		0.8066666666666666	0.8079470198675497	79	16096	5	32	74	16064	16175	0.08946002544219211
M1	cpdb	0	network_modules	90	TRUE	0.0015731158814463637	148	37	6	0.16216216216216217	0.04054054054054054	GO:0072331	GO:BP	signal transduction by p53 class mediator	16175	17354		0.8133333333333334	0.8145695364238411	148	16027	6	31	142	15996	16175	0.07694660999383388
M1	cpdb	0	network_modules	90	TRUE	0.0018597367461617074	35	37	4	0.10810810810810811	0.11428571428571428	GO:0006301	GO:BP	postreplication repair	16175	2108		0.82	0.8211920529801324	35	16140	4	33	31	16107	16175	0.10917218486028073
M1	cpdb	0	network_modules	90	TRUE	0.002335906706710895	12	36	3	0.08333333333333333	0.25	REAC:R-HSA-3371511	REAC	HSF1 activation	10916	1109		0.8673469387755102	0.8686868686868687	12	10904	3	33	9	10871	10916	0.14274744937012845
M1	cpdb	0	network_modules	90	TRUE	0.0023381553993885207	37	37	4	0.10810810810810811	0.10810810810810811	GO:0022616	GO:BP	DNA strand elongation	16175	6623		0.8266666666666667	0.8278145695364238	37	16138	4	33	33	16105	16175	0.10606324505196732
M1	cpdb	0	network_modules	90	TRUE	0.0025732093433202996	161	37	6	0.16216216216216217	0.037267080745341616	GO:1903046	GO:BP	meiotic cell cycle process	16175	22726		0.8333333333333334	0.8344370860927153	161	16014	6	31	155	15983	16175	0.07341696673265324
M1	cpdb	0	network_modules	90	TRUE	0.0028955468613571646	11	37	3	0.08108108108108109	0.2727272727272727	GO:0000722	GO:BP	telomere maintenance via recombination	16175	201		0.84	0.8410596026490066	11	16164	3	34	8	16130	16175	0.1476763966029298
M1	cpdb	0	network_modules	90	TRUE	0.0029023932672743295	39	37	4	0.10810810810810811	0.10256410256410256	GO:0016447	GO:BP	somatic recombination of immunoglobulin gene segments	16175	5226		0.8466666666666667	0.847682119205298	39	16136	4	33	35	16103	16175	0.10319356773717044
M1	cpdb	0	network_modules	90	TRUE	0.002923370080406474	87	36	5	0.1388888888888889	0.05747126436781609	REAC:R-HSA-3371556	REAC	Cellular response to heat stress	10916	334		0.8775510204081632	0.8787878787878788	87	10829	5	31	82	10798	10916	0.08469328834692899
M1	cpdb	0	network_modules	90	TRUE	0.0030297966038359634	13	36	3	0.08333333333333333	0.23076923076923078	REAC:R-HSA-174430	REAC	Telomere C-strand synthesis initiation	10916	2487		0.8877551020408163	0.8888888888888888	13	10903	3	33	10	10870	10916	0.13700081344278045
M1	cpdb	0	network_modules	90	TRUE	0.0034786416658331943	2	36	2	0.05555555555555555	1	REAC:R-HSA-9699150	REAC	Defective DNA double strand break response due to BARD1 loss of function	10916	531		0.8979591836734694	0.9191919191919192	2	10914	2	34	0	10880	10916	0.23533483653940263
M1	cpdb	0	network_modules	90	TRUE	0.0034786416658331943	2	36	2	0.05555555555555555	1	REAC:R-HSA-5632968	REAC	Defective Mismatch Repair Associated With MSH6	10916	595		0.8979591836734694	0.9191919191919192	2	10914	2	34	0	10880	10916	0.23533483653940263
M1	cpdb	0	network_modules	90	TRUE	0.0034786416658331943	2	36	2	0.05555555555555555	1	REAC:R-HSA-9663199	REAC	Defective DNA double strand break response due to BRCA1 loss of function	10916	532		0.8979591836734694	0.9191919191919192	2	10914	2	34	0	10880	10916	0.23533483653940263
M1	cpdb	0	network_modules	90	TRUE	0.003690278797899944	43	36	4	0.1111111111111111	0.09302325581395349	REAC:R-HSA-5696395	REAC	Formation of Incision Complex in GG-NER	10916	948		0.9285714285714286	0.9292929292929293	43	10873	4	32	39	10841	10916	0.098417538127546
M1	cpdb	0	network_modules	90	TRUE	0.003847366258249225	14	36	3	0.08333333333333333	0.21428571428571427	REAC:R-HSA-69091	REAC	Polymerase switching	10916	1769		0.9387755102040817	0.9595959595959596	14	10902	3	33	11	10869	10916	0.1318761038118911
M1	cpdb	0	network_modules	90	TRUE	0.003847366258249225	14	36	3	0.08333333333333333	0.21428571428571427	REAC:R-HSA-162594	REAC	Early Phase of HIV Life Cycle	10916	831		0.9387755102040817	0.9595959595959596	14	10902	3	33	11	10869	10916	0.1318761038118911
M1	cpdb	0	network_modules	90	TRUE	0.003847366258249225	14	36	3	0.08333333333333333	0.21428571428571427	REAC:R-HSA-69109	REAC	Leading Strand Synthesis	10916	1308		0.9387755102040817	0.9595959595959596	14	10902	3	33	11	10869	10916	0.1318761038118911
M1	cpdb	0	network_modules	90	TRUE	0.0043264218503616236	43	37	4	0.10810810810810811	0.09302325581395349	GO:0090329	GO:BP	regulation of DNA-templated DNA replication	16175	18209		0.8533333333333334	0.8543046357615894	43	16132	4	33	39	16099	16175	0.09805895179251242
M1	cpdb	0	network_modules	90	TRUE	0.004669511490526527	99	37	5	0.13513513513513514	0.050505050505050504	GO:0007127	GO:BP	meiosis I	16175	2698		0.86	0.8609271523178808	99	16076	5	32	94	16044	16175	0.07920497994616066
M1	cpdb	0	network_modules	90	TRUE	0.004751299862666524	44	37	4	0.10810810810810811	0.09090909090909091	GO:0002562	GO:BP	somatic diversification of immune receptors via germline recombination within a single locus	16175	1083		0.8666666666666667	0.8741721854304636	44	16131	4	33	40	16098	16175	0.09688441051059875
M1	cpdb	0	network_modules	90	TRUE	0.004751299862666524	44	37	4	0.10810810810810811	0.09090909090909091	GO:0016444	GO:BP	somatic cell DNA recombination	16175	5223		0.8666666666666667	0.8741721854304636	44	16131	4	33	40	16098	16175	0.09688441051059875
M1	cpdb	0	network_modules	90	TRUE	0.004919346875142897	180	37	6	0.16216216216216217	0.03333333333333333	GO:0046777	GO:BP	protein autophosphorylation	16175	12365		0.88	0.8807947019867549	180	15995	6	31	174	15964	16175	0.06893920867831113
M1	cpdb	0	network_modules	90	TRUE	0.005003140153530381	13	37	3	0.08108108108108109	0.23076923076923078	GO:0006287	GO:BP	base-excision repair, gap-filling	16175	2100		0.8866666666666667	0.8940397350993378	13	16162	3	34	10	16128	16175	0.13564200894436634
M1	cpdb	0	network_modules	90	TRUE	0.005003140153530381	13	37	3	0.08108108108108109	0.23076923076923078	GO:0010165	GO:BP	response to X-ray	16175	3964		0.8866666666666667	0.8940397350993378	13	16162	3	34	10	16128	16175	0.13564200894436634
M1	cpdb	0	network_modules	90	TRUE	0.00567765583383659	103	37	5	0.13513513513513514	0.04854368932038835	GO:0002520	GO:BP	immune system development	16175	1042		0.9	0.9006622516556292	103	16072	5	32	98	16040	16175	0.07751259122103143
M1	cpdb	0	network_modules	90	TRUE	0.006357598075721754	14	37	3	0.08108108108108109	0.21428571428571427	GO:0006266	GO:BP	DNA ligation	16175	2081		0.9066666666666666	0.9072847682119205	14	16161	3	34	11	16127	16175	0.13061128938503644
M1	cpdb	0	network_modules	90	TRUE	0.007333690814442883	51	36	4	0.1111111111111111	0.0784313725490196	REAC:R-HSA-171306	REAC	Packaging Of Telomere Ends	10916	1712		0.9693877551020408	0.9696969696969697	51	10865	4	32	47	10833	10916	0.08978451642524551
M1	cpdb	0	network_modules	90	TRUE	0.007934474510536641	15	37	3	0.08108108108108109	0.2	GO:0031573	GO:BP	mitotic intra-S DNA damage checkpoint signaling	16175	7222		0.9133333333333333	0.9139072847682119	15	16160	3	34	12	16126	16175	0.12608914305468685
M1	cpdb	0	network_modules	90	TRUE	0.00821203529382338	2	37	2	0.05405405405405406	1	GO:0072695	GO:BP	regulation of DNA recombination at telomere	16175	17506		0.92	0.9933774834437086	2	16173	2	35	0	16138	16175	0.23224356964168827
M1	cpdb	0	network_modules	90	TRUE	0.00821203529382338	2	37	2	0.05405405405405406	1	GO:1904534	GO:BP	negative regulation of telomeric loop disassembly	16175	23893		0.92	0.9933774834437086	2	16173	2	35	0	16138	16175	0.23224356964168827
M1	cpdb	0	network_modules	90	TRUE	0.00821203529382338	2	37	2	0.05405405405405406	1	GO:1904868	GO:BP	telomerase catalytic core complex assembly	16175	24176		0.92	0.9933774834437086	2	16173	2	35	0	16138	16175	0.23224356964168827
M1	cpdb	0	network_modules	90	TRUE	0.00821203529382338	2	37	2	0.05405405405405406	1	GO:0032214	GO:BP	negative regulation of telomere maintenance via semi-conservative replication	16175	7406		0.92	0.9933774834437086	2	16173	2	35	0	16138	16175	0.23224356964168827
M1	cpdb	0	network_modules	90	TRUE	0.00821203529382338	2	37	2	0.05405405405405406	1	GO:1904884	GO:BP	positive regulation of telomerase catalytic core complex assembly	16175	24191		0.92	0.9933774834437086	2	16173	2	35	0	16138	16175	0.23224356964168827
M1	cpdb	0	network_modules	90	TRUE	0.00821203529382338	2	37	2	0.05405405405405406	1	GO:1905777	GO:BP	regulation of exonuclease activity	16175	24888		0.92	0.9933774834437086	2	16173	2	35	0	16138	16175	0.23224356964168827
M1	cpdb	0	network_modules	90	TRUE	0.00821203529382338	2	37	2	0.05405405405405406	1	GO:1905778	GO:BP	negative regulation of exonuclease activity	16175	24889		0.92	0.9933774834437086	2	16173	2	35	0	16138	16175	0.23224356964168827
M1	cpdb	0	network_modules	90	TRUE	0.00821203529382338	2	37	2	0.05405405405405406	1	GO:1905838	GO:BP	regulation of telomeric D-loop disassembly	16175	24948		0.92	0.9933774834437086	2	16173	2	35	0	16138	16175	0.23224356964168827
M1	cpdb	0	network_modules	90	TRUE	0.00821203529382338	2	37	2	0.05405405405405406	1	GO:1904882	GO:BP	regulation of telomerase catalytic core complex assembly	16175	24189		0.92	0.9933774834437086	2	16173	2	35	0	16138	16175	0.23224356964168827
M1	cpdb	0	network_modules	90	TRUE	0.00821203529382338	2	37	2	0.05405405405405406	1	GO:0048239	GO:BP	negative regulation of DNA recombination at telomere	16175	12598		0.92	0.9933774834437086	2	16173	2	35	0	16138	16175	0.23224356964168827
M1	cpdb	0	network_modules	90	TRUE	0.00821203529382338	2	37	2	0.05405405405405406	1	GO:0032213	GO:BP	regulation of telomere maintenance via semi-conservative replication	16175	7405		0.92	0.9933774834437086	2	16173	2	35	0	16138	16175	0.23224356964168827
M1	cpdb	0	network_modules	90	TRUE	0.00821203529382338	2	37	2	0.05405405405405406	1	GO:1905839	GO:BP	negative regulation of telomeric D-loop disassembly	16175	24949		0.92	0.9933774834437086	2	16173	2	35	0	16138	16175	0.23224356964168827
M1	cpdb	0	network_modules	90	TRUE	0.00921576704302917	54	36	4	0.1111111111111111	0.07407407407407407	REAC:R-HSA-110331	REAC	Cleavage of the damaged purine	10916	373		0.9795918367346939	1	54	10862	4	32	50	10830	10916	0.08704159136483579
M1	cpdb	0	network_modules	90	TRUE	0.00921576704302917	54	36	4	0.1111111111111111	0.07407407407407407	REAC:R-HSA-73927	REAC	Depurination	10916	731		0.9795918367346939	1	54	10862	4	32	50	10830	10916	0.08704159136483579
M1	cpdb	0	network_modules	90	TRUE	0.00921576704302917	54	36	4	0.1111111111111111	0.07407407407407407	REAC:R-HSA-110330	REAC	Recognition and association of DNA glycosylase with site containing an affected purine	10916	1946		0.9795918367346939	1	54	10862	4	32	50	10830	10916	0.08704159136483579
M1	cpdb	0	network_modules	90	TRUE	0.009352449335266686	52	37	4	0.10810810810810811	0.07692307692307693	GO:2000573	GO:BP	positive regulation of DNA biosynthetic process	16175	25874		1	1	52	16123	4	33	48	16090	16175	0.0887244515000158
M1	cpdb	0	network_modules	91	TRUE	1.6107298511807724e-17	144	34	15	0.4411764705882353	0.10416666666666667	REAC:R-HSA-8856828	REAC	Clathrin-mediated endocytosis	10916	372		0	0.1111111111111111	144	10772	15	19	129	10753	10916	0.20967544682391287
M1	cpdb	0	network_modules	91	TRUE	3.2961481522415448e-9	533	35	14	0.4	0.02626641651031895	GO:0006897	GO:BP	endocytosis	16175	2551		0	0.043478260869565216	533	15642	14	21	519	15621	16175	0.09575017152297832
M1	cpdb	0	network_modules	91	TRUE	7.578928717859633e-9	44	35	7	0.2	0.1590909090909091	GO:0006509	GO:BP	membrane protein ectodomain proteolysis	16175	2234		0.045454545454545456	0.08695652173913043	44	16131	7	28	37	16103	16175	0.17638111242071355
M1	cpdb	0	network_modules	91	TRUE	1.6860678135598568e-8	49	35	7	0.2	0.14285714285714285	GO:0140238	GO:BP	presynaptic endocytosis	16175	19709		0.09090909090909091	0.17391304347826086	49	16126	7	28	42	16098	16175	0.16690396758382445
M1	cpdb	0	network_modules	91	TRUE	1.6860678135598568e-8	49	35	7	0.2	0.14285714285714285	GO:0048488	GO:BP	synaptic vesicle endocytosis	16175	12781		0.09090909090909091	0.17391304347826086	49	16126	7	28	42	16098	16175	0.16690396758382445
M1	cpdb	0	network_modules	91	TRUE	1.7267199439047725e-8	740	35	15	0.42857142857142855	0.02027027027027027	GO:0098657	GO:BP	import into cell	16175	18813		0.18181818181818182	0.21739130434782608	740	15435	15	20	725	15415	16175	0.08532062880149521
M1	cpdb	0	network_modules	91	TRUE	6.595202803537649e-8	59	35	7	0.2	0.11864406779661017	GO:0036465	GO:BP	synaptic vesicle recycling	16175	9613		0.22727272727272727	0.30434782608695654	59	16116	7	28	52	16088	16175	0.1516729436414593
M1	cpdb	0	network_modules	91	TRUE	6.595202803537649e-8	59	35	7	0.2	0.11864406779661017	GO:0033619	GO:BP	membrane protein proteolysis	16175	8321		0.22727272727272727	0.30434782608695654	59	16116	7	28	52	16088	16175	0.1516729436414593
M1	cpdb	0	network_modules	91	TRUE	1.3146262893324006e-7	248	27	10	0.37037037037037035	0.04032258064516129	KEGG:04144	KEGG	Endocytosis	8484	280		0	0.3333333333333333	248	8236	10	17	238	8219	8484	0.11442517391047893
M1	cpdb	0	network_modules	91	TRUE	1.8589469037544844e-7	15	35	5	0.14285714285714285	0.3333333333333333	GO:0051044	GO:BP	positive regulation of membrane protein ectodomain proteolysis	16175	13454		0.3181818181818182	0.34782608695652173	15	16160	5	30	10	16130	16175	0.21713697636799767
M1	cpdb	0	network_modules	91	TRUE	2.1005417147864643e-7	117	35	8	0.22857142857142856	0.06837606837606838	GO:0099504	GO:BP	synaptic vesicle cycle	16175	19100		0.36363636363636365	0.391304347826087	117	16058	8	27	109	16031	16175	0.12163090994684123
M1	cpdb	0	network_modules	91	TRUE	2.7550119017588954e-7	121	35	8	0.22857142857142856	0.06611570247933884	GO:0099003	GO:BP	vesicle-mediated transport in synapse	16175	18999		0.4090909090909091	0.43478260869565216	121	16054	8	27	113	16027	16175	0.11948483876123377
M1	cpdb	0	network_modules	91	TRUE	7.153663813880688e-7	19	35	5	0.14285714285714285	0.2631578947368421	GO:0097320	GO:BP	plasma membrane tubulation	16175	18595		0.45454545454545453	0.4782608695652174	19	16156	5	30	14	16126	16175	0.19261894784094086
M1	cpdb	0	network_modules	91	TRUE	2.273478475175086e-6	48	34	6	0.17647058823529413	0.125	REAC:R-HSA-177929	REAC	Signaling by EGFR	10916	2229		0.125	0.2222222222222222	48	10868	6	28	42	10840	10916	0.14536734663088224
M1	cpdb	0	network_modules	91	TRUE	3.238403230051062e-6	25	35	5	0.14285714285714285	0.2	GO:0051043	GO:BP	regulation of membrane protein ectodomain proteolysis	16175	13453		0.5	0.5217391304347826	25	16150	5	30	20	16120	16175	0.167512774532379
M1	cpdb	0	network_modules	91	TRUE	6.754859249124143e-6	507	34	12	0.35294117647058826	0.023668639053254437	REAC:R-HSA-9006934	REAC	Signaling by Receptor Tyrosine Kinases	10916	2302		0.25	0.3333333333333333	507	10409	12	22	495	10387	10916	0.08140749171855088
M1	cpdb	0	network_modules	91	TRUE	2.6407960032652316e-5	137	35	7	0.2	0.051094890510948905	GO:0007009	GO:BP	plasma membrane organization	16175	2621		0.5454545454545454	0.5652173913043478	137	16038	7	28	130	16010	16175	0.0973258672375096
M1	cpdb	0	network_modules	91	TRUE	2.7234057578270748e-5	14	34	4	0.11764705882352941	0.2857142857142857	REAC:R-HSA-177504	REAC	Retrograde neurotrophin signalling	10916	2095		0.375	0.4444444444444444	14	10902	4	30	10	10872	10916	0.18174068754756642
M1	cpdb	0	network_modules	91	TRUE	2.7800916414345174e-5	96	27	6	0.2222222222222222	0.0625	KEGG:04666	KEGG	Fc gamma R-mediated phagocytosis	8484	341		0.5	0.6666666666666666	96	8388	6	21	90	8367	8484	0.11266788499615411
M1	cpdb	0	network_modules	91	TRUE	3.300013189308656e-4	6	35	3	0.08571428571428572	0.5	GO:0016191	GO:BP	synaptic vesicle uncoating	16175	5167		0.5909090909090909	0.6086956521739131	6	16169	3	32	3	16137	16175	0.20638540920552684
M1	cpdb	0	network_modules	91	TRUE	9.21263675524132e-4	8	35	3	0.08571428571428572	0.375	GO:0072318	GO:BP	clathrin coat disassembly	16175	17346		0.6363636363636364	0.6521739130434783	8	16167	3	32	5	16135	16175	0.1784870907077148
M1	cpdb	0	network_modules	91	TRUE	0.001379845226129801	9	35	3	0.08571428571428572	0.3333333333333333	GO:0072319	GO:BP	vesicle uncoating	16175	17347		0.6818181818181818	0.6956521739130435	9	16166	3	32	6	16134	16175	0.16816236330050074
M1	cpdb	0	network_modules	91	TRUE	0.0021125788188192953	522	35	9	0.2571428571428571	0.017241379310344827	GO:0010256	GO:BP	endomembrane system organization	16175	4029		0.7272727272727273	0.7391304347826086	522	15653	9	26	513	15627	16175	0.0592550855862953
M1	cpdb	0	network_modules	91	TRUE	0.0034812782104250424	14	34	3	0.08823529411764706	0.21428571428571427	REAC:R-HSA-8875360	REAC	InlB-mediated entry of Listeria monocytogenes into host cell	10916	1203		0.5	0.5555555555555556	14	10902	3	31	11	10871	10916	0.13580474827579567
M1	cpdb	0	network_modules	91	TRUE	0.0035138527371913015	97	35	5	0.14285714285714285	0.05154639175257732	GO:0007173	GO:BP	epidermal growth factor receptor signaling pathway	16175	2736		0.7727272727272727	0.782608695652174	97	16078	5	30	92	16048	16175	0.08254712374267895
M1	cpdb	0	network_modules	91	TRUE	0.004912226368678177	48	34	4	0.11764705882352941	0.08333333333333333	REAC:R-HSA-437239	REAC	Recycling pathway of L1	10916	1954		0.625	0.6666666666666666	48	10868	4	30	44	10838	10916	0.09567331068503762
M1	cpdb	0	network_modules	91	TRUE	0.005493966659618186	147	27	5	0.18518518518518517	0.034013605442176874	KEGG:04072	KEGG	Phospholipase D signaling pathway	8484	261		1	1	147	8337	5	22	142	8315	8484	0.07268654457366643
M1	cpdb	0	network_modules	91	TRUE	0.00714665532978335	112	35	5	0.14285714285714285	0.044642857142857144	GO:0038127	GO:BP	ERBB signaling pathway	16175	9716		0.8181818181818182	0.8260869565217391	112	16063	5	30	107	16033	16175	0.07633587958305751
M1	cpdb	0	network_modules	91	TRUE	0.00787914636037577	54	34	4	0.11764705882352941	0.07407407407407407	REAC:R-HSA-432722	REAC	Golgi Associated Vesicle Biogenesis	10916	1082		0.75	0.7777777777777778	54	10862	4	30	50	10832	10916	0.08978866220696859
M1	cpdb	0	network_modules	91	TRUE	0.008089957113382432	112	34	5	0.14705882352941177	0.044642857142857144	REAC:R-HSA-187037	REAC	Signaling by NTRK1 (TRKA)	10916	2284		0.875	0.8888888888888888	112	10804	5	29	107	10775	10916	0.07588031987194728
M1	cpdb	0	network_modules	91	TRUE	0.008122640014723953	2	35	2	0.05714285714285714	1	GO:0099050	GO:BP	vesicle scission	16175	19023		0.8636363636363636	0.9130434782608695	2	16173	2	33	0	16140	16175	0.23880171837541012
M1	cpdb	0	network_modules	91	TRUE	0.008122640014723953	2	35	2	0.05714285714285714	1	GO:0060988	GO:BP	lipid tube assembly	16175	15114		0.8636363636363636	0.9130434782608695	2	16173	2	33	0	16140	16175	0.23880171837541012
M1	cpdb	0	network_modules	91	TRUE	0.008907672289348407	53	35	4	0.11428571428571428	0.07547169811320754	GO:0042987	GO:BP	amyloid precursor protein catabolic process	16175	10471		0.9545454545454546	0.9565217391304348	53	16122	4	31	49	16091	16175	0.09045603558120205
M1	cpdb	0	network_modules	91	TRUE	0.009103873202138783	16	35	3	0.08571428571428572	0.1875	GO:1903729	GO:BP	regulation of plasma membrane organization	16175	23241		1	1	16	16159	3	32	13	16127	16175	0.1255080059505054
M1	cpdb	0	network_modules	91	TRUE	0.009169256043505786	19	34	3	0.08823529411764706	0.15789473684210525	REAC:R-HSA-8876384	REAC	Listeria monocytogenes entry into host cells	10916	1319		1	1	19	10897	3	31	16	10866	10916	0.11598664736432851
M1	cpdb	0	network_modules	92	TRUE	1.7212258698757374e-34	774	37	32	0.8648648648648649	0.041343669250646	GO:0007186	GO:BP	G protein-coupled receptor signaling pathway	16175	2744		0	0.03225806451612903	774	15401	32	5	742	15396	16175	0.18327551586451316
M1	cpdb	0	network_modules	92	TRUE	3.0768590674745225e-25	217	37	20	0.5405405405405406	0.09216589861751152	GO:0007188	GO:BP	adenylate cyclase-modulating G protein-coupled receptor signaling pathway	16175	2746		0.03333333333333333	0.06451612903225806	217	15958	20	17	197	15941	16175	0.21938888834229692
M1	cpdb	0	network_modules	92	TRUE	6.233158172274287e-21	460	36	23	0.6388888888888888	0.05	REAC:R-HSA-500792	REAC	GPCR ligand binding	10916	1019		0	0.045454545454545456	460	10456	23	13	437	10443	10916	0.17085601061203562
M1	cpdb	0	network_modules	92	TRUE	3.14998965515314e-19	328	36	20	0.5555555555555556	0.06097560975609756	REAC:R-HSA-373076	REAC	Class A/1 (Rhodopsin-like receptors)	10916	365		0.047619047619047616	0.09090909090909091	328	10588	20	16	308	10572	10916	0.17706621607939008
M1	cpdb	0	network_modules	92	TRUE	5.353303705898552e-16	365	34	19	0.5588235294117647	0.052054794520547946	KEGG:04080	KEGG	Neuroactive ligand-receptor interaction	8484	263		0	0.047619047619047616	365	8119	19	15	346	8104	8484	0.16124882264280116
M1	cpdb	0	network_modules	92	TRUE	6.368501427866844e-15	312	36	17	0.4722222222222222	0.05448717948717949	REAC:R-HSA-418594	REAC	G alpha (i) signalling events	10916	987		0.09523809523809523	0.13636363636363635	312	10604	17	19	295	10585	10916	0.15315077084060882
M1	cpdb	0	network_modules	92	TRUE	1.7617878770195735e-14	213	36	15	0.4166666666666667	0.07042253521126761	REAC:R-HSA-416476	REAC	G alpha (q) signalling events	10916	988		0.14285714285714285	0.18181818181818182	213	10703	15	21	198	10682	10916	0.1651645099868345
M1	cpdb	0	network_modules	92	TRUE	7.608964735457454e-12	8	36	6	0.16666666666666666	0.75	REAC:R-HSA-434316	REAC	Fatty Acids bound to GPR40 (FFAR1) regulate insulin secretion	10916	934		0.19047619047619047	0.22727272727272727	8	10908	6	30	2	10878	10916	0.35270987900391043
M1	cpdb	0	network_modules	92	TRUE	1.6503363276505645e-11	96	37	10	0.2702702702702703	0.10416666666666667	GO:0007200	GO:BP	phospholipase C-activating G protein-coupled receptor signaling pathway	16175	2758		0.06666666666666667	0.0967741935483871	96	16079	10	27	86	16052	16175	0.16478213934817457
M1	cpdb	0	network_modules	92	TRUE	1.2466219769070355e-10	11	36	6	0.16666666666666666	0.5454545454545454	REAC:R-HSA-400451	REAC	Free fatty acids regulate insulin secretion	10916	979		0.23809523809523808	0.2727272727272727	11	10905	6	30	5	10875	10916	0.3003351152428649
M1	cpdb	0	network_modules	92	TRUE	2.1795138185743492e-10	42	36	8	0.2222222222222222	0.19047619047619047	REAC:R-HSA-375280	REAC	Amine ligand-binding receptors	10916	139		0.2857142857142857	0.3181818181818182	42	10874	8	28	34	10846	10916	0.20290056670049023
M1	cpdb	0	network_modules	92	TRUE	2.334199814770434e-10	516	37	15	0.40540540540540543	0.029069767441860465	GO:0099536	GO:BP	synaptic signaling	16175	19115		0.1	0.12903225806451613	516	15659	15	22	501	15637	16175	0.10176749072687973
M1	cpdb	0	network_modules	92	TRUE	3.920619703397121e-10	251	34	13	0.38235294117647056	0.05179282868525897	KEGG:04020	KEGG	Calcium signaling pathway	8484	250		0.05	0.09523809523809523	251	8233	13	21	238	8212	8484	0.13206411674541008
M1	cpdb	0	network_modules	92	TRUE	7.062370126723571e-10	56	37	8	0.21621621621621623	0.14285714285714285	GO:0007193	GO:BP	adenylate cyclase-inhibiting G protein-coupled receptor signaling pathway	16175	2751		0.13333333333333333	0.1935483870967742	56	16119	8	29	48	16090	16175	0.17343435867219578
M1	cpdb	0	network_modules	92	TRUE	7.062370126723571e-10	56	37	8	0.21621621621621623	0.14285714285714285	GO:0007187	GO:BP	G protein-coupled receptor signaling pathway, coupled to cyclic nucleotide second messenger	16175	2745		0.13333333333333333	0.1935483870967742	56	16119	8	29	48	16090	16175	0.17343435867219578
M1	cpdb	0	network_modules	92	TRUE	1.86686946519188e-9	31	36	7	0.19444444444444445	0.22580645161290322	REAC:R-HSA-456926	REAC	Thrombin signalling through proteinase activated receptors (PARs)	10916	2506		0.3333333333333333	0.36363636363636365	31	10885	7	29	24	10856	10916	0.20711480478224115
M1	cpdb	0	network_modules	92	TRUE	2.7463737909298404e-9	18	37	6	0.16216216216216217	0.3333333333333333	GO:0007213	GO:BP	G protein-coupled acetylcholine receptor signaling pathway	16175	2767		0.2	0.22580645161290322	18	16157	6	31	12	16126	16175	0.23129306604251895
M1	cpdb	0	network_modules	92	TRUE	3.4715340136581825e-9	38	37	7	0.1891891891891892	0.18421052631578946	GO:1903350	GO:BP	response to dopamine	16175	22933		0.23333333333333334	0.2903225806451613	38	16137	7	30	31	16107	16175	0.18479349894478111
M1	cpdb	0	network_modules	92	TRUE	3.4715340136581825e-9	38	37	7	0.1891891891891892	0.18421052631578946	GO:1903351	GO:BP	cellular response to dopamine	16175	22934		0.23333333333333334	0.2903225806451613	38	16137	7	30	31	16107	16175	0.18479349894478111
M1	cpdb	0	network_modules	92	TRUE	4.248719989265982e-9	8	37	5	0.13513513513513514	0.625	GO:0060158	GO:BP	phospholipase C-activating dopamine receptor signaling pathway	16175	14396		0.3	0.3225806451612903	8	16167	5	32	3	16135	16175	0.28995889975566175
M1	cpdb	0	network_modules	92	TRUE	5.111748122671301e-9	40	37	7	0.1891891891891892	0.175	GO:0071867	GO:BP	response to monoamine	16175	16949		0.3333333333333333	0.45161290322580644	40	16135	7	30	33	16105	16175	0.1800063814751176
M1	cpdb	0	network_modules	92	TRUE	5.111748122671301e-9	40	37	7	0.1891891891891892	0.175	GO:0071870	GO:BP	cellular response to catecholamine stimulus	16175	16952		0.3333333333333333	0.45161290322580644	40	16135	7	30	33	16105	16175	0.1800063814751176
M1	cpdb	0	network_modules	92	TRUE	5.111748122671301e-9	40	37	7	0.1891891891891892	0.175	GO:0071869	GO:BP	response to catecholamine	16175	16951		0.3333333333333333	0.45161290322580644	40	16135	7	30	33	16105	16175	0.1800063814751176
M1	cpdb	0	network_modules	92	TRUE	5.111748122671301e-9	40	37	7	0.1891891891891892	0.175	GO:0071868	GO:BP	cellular response to monoamine stimulus	16175	16950		0.3333333333333333	0.45161290322580644	40	16135	7	30	33	16105	16175	0.1800063814751176
M1	cpdb	0	network_modules	92	TRUE	1.9056229899799393e-8	10	37	5	0.13513513513513514	0.5	GO:0098664	GO:BP	G protein-coupled serotonin receptor signaling pathway	16175	18819		0.4666666666666667	0.4838709677419355	10	16165	5	32	5	16133	16175	0.2591249804106961
M1	cpdb	0	network_modules	92	TRUE	2.3931677128764703e-8	10	36	5	0.1388888888888889	0.5	REAC:R-HSA-399997	REAC	Acetylcholine regulates insulin secretion	10916	56		0.38095238095238093	0.4090909090909091	10	10906	5	31	5	10875	10916	0.2623379185960718
M1	cpdb	0	network_modules	92	TRUE	3.3615064714064776e-8	26	37	6	0.16216216216216217	0.23076923076923078	GO:0095500	GO:BP	acetylcholine receptor signaling pathway	16175	18440		0.5	0.5161290322580645	26	16149	6	31	20	16118	16175	0.19190396374526014
M1	cpdb	0	network_modules	92	TRUE	3.5220686577282825e-8	24	36	6	0.16666666666666666	0.25	REAC:R-HSA-428930	REAC	Thromboxane signalling through TP receptor	10916	2507		0.42857142857142855	0.45454545454545453	24	10892	6	30	18	10862	10916	0.20198655396133935
M1	cpdb	0	network_modules	92	TRUE	5.482575484132443e-8	28	37	6	0.16216216216216217	0.21428571428571427	GO:0098926	GO:BP	postsynaptic signal transduction	16175	18956		0.5333333333333333	0.6129032258064516	28	16147	6	31	22	16116	16175	0.184792315412641
M1	cpdb	0	network_modules	92	TRUE	5.482575484132443e-8	28	37	6	0.16216216216216217	0.21428571428571427	GO:1905144	GO:BP	response to acetylcholine	16175	24392		0.5333333333333333	0.6129032258064516	28	16147	6	31	22	16116	16175	0.184792315412641
M1	cpdb	0	network_modules	92	TRUE	5.482575484132443e-8	28	37	6	0.16216216216216217	0.21428571428571427	GO:1905145	GO:BP	cellular response to acetylcholine	16175	24393		0.5333333333333333	0.6129032258064516	28	16147	6	31	22	16116	16175	0.184792315412641
M1	cpdb	0	network_modules	92	TRUE	7.485808450774153e-8	12	36	5	0.1388888888888889	0.4166666666666667	REAC:R-HSA-390666	REAC	Serotonin receptors	10916	2209		0.47619047619047616	0.5	12	10904	5	31	7	10873	10916	0.23918458003755771
M1	cpdb	0	network_modules	92	TRUE	2.3269226277271613e-7	32	36	6	0.16666666666666666	0.1875	REAC:R-HSA-392518	REAC	Signal amplification	10916	2213		0.5238095238095238	0.5454545454545454	32	10884	6	30	26	10854	10916	0.17421000848916993
M1	cpdb	0	network_modules	92	TRUE	6.742479710128059e-7	129	37	8	0.21621621621621623	0.06201550387596899	GO:0007204	GO:BP	positive regulation of cytosolic calcium ion concentration	16175	2759		0.6333333333333333	0.6451612903225806	129	16046	8	29	121	16017	16175	0.11210066120360525
M1	cpdb	0	network_modules	92	TRUE	1.2717477664447286e-6	120	34	8	0.23529411764705882	0.06666666666666667	KEGG:04071	KEGG	Sphingolipid signaling pathway	8484	260		0.1	0.14285714285714285	120	8364	8	26	112	8338	8484	0.11879571347939409
M1	cpdb	0	network_modules	92	TRUE	1.2976674718842138e-6	140	37	8	0.21621621621621623	0.05714285714285714	GO:0007189	GO:BP	adenylate cyclase-activating G protein-coupled receptor signaling pathway	16175	2747		0.6666666666666666	0.6774193548387096	140	16035	8	29	132	16006	16175	0.10729199170199752
M1	cpdb	0	network_modules	92	TRUE	3.1285184247041835e-6	431	37	11	0.2972972972972973	0.025522041763341066	GO:1901699	GO:BP	cellular response to nitrogen compound	16175	21652		0.7	0.7096774193548387	431	15744	11	26	420	15718	16175	0.08047002551891289
M1	cpdb	0	network_modules	92	TRUE	5.9358758169606494e-6	27	37	5	0.13513513513513514	0.18518518518518517	GO:0007212	GO:BP	G protein-coupled dopamine receptor signaling pathway	16175	2766		0.7333333333333333	0.7419354838709677	27	16148	5	32	22	16116	16175	0.15654865412321875
M1	cpdb	0	network_modules	92	TRUE	1.1187616601299328e-5	487	37	11	0.2972972972972973	0.022587268993839837	GO:0007268	GO:BP	chemical synaptic transmission	16175	2796		0.7666666666666667	0.8064516129032258	487	15688	11	26	476	15662	16175	0.0748670586628512
M1	cpdb	0	network_modules	92	TRUE	1.1187616601299328e-5	487	37	11	0.2972972972972973	0.022587268993839837	GO:0098916	GO:BP	anterograde trans-synaptic signaling	16175	18949		0.7666666666666667	0.8064516129032258	487	15688	11	26	476	15662	16175	0.0748670586628512
M1	cpdb	0	network_modules	92	TRUE	1.2438403053279852e-5	492	37	11	0.2972972972972973	0.022357723577235773	GO:0099537	GO:BP	trans-synaptic signaling	16175	19116		0.8333333333333334	0.8387096774193549	492	15683	11	26	481	15657	16175	0.07441134942623787
M1	cpdb	0	network_modules	92	TRUE	1.744149961994952e-5	112	34	7	0.20588235294117646	0.0625	KEGG:04726	KEGG	Serotonergic synapse	8484	356		0.15	0.19047619047619047	112	8372	7	27	105	8345	8484	0.1070846220700649
M1	cpdb	0	network_modules	92	TRUE	1.7771671012416865e-5	3	37	3	0.08108108108108109	1	GO:0007207	GO:BP	phospholipase C-activating G protein-coupled acetylcholine receptor signaling pathway	16175	2761		0.8666666666666667	0.8709677419354839	3	16172	3	34	0	16138	16175	0.2844479148814264
M1	cpdb	0	network_modules	92	TRUE	3.204120432074083e-5	14	36	4	0.1111111111111111	0.2857142857142857	REAC:R-HSA-419408	REAC	Lysosphingolipid and LPA receptors	10916	1342		0.5714285714285714	0.5909090909090909	14	10902	4	32	10	10870	10916	0.17652191541127712
M1	cpdb	0	network_modules	92	TRUE	5.3842539967486696e-5	41	37	5	0.13513513513513514	0.12195121951219512	GO:0007215	GO:BP	glutamate receptor signaling pathway	16175	2769		0.9	0.9032258064516129	41	16134	5	32	36	16102	16175	0.12627054118590467
M1	cpdb	0	network_modules	92	TRUE	5.916069933952921e-5	78	36	6	0.16666666666666666	0.07692307692307693	REAC:R-HSA-422356	REAC	Regulation of insulin secretion	10916	2040		0.6190476190476191	0.6363636363636364	78	10838	6	30	72	10808	10916	0.1089423756728603
M1	cpdb	0	network_modules	92	TRUE	1.1107785922860987e-4	147	34	7	0.20588235294117646	0.047619047619047616	KEGG:04072	KEGG	Phospholipase D signaling pathway	8484	261		0.2	0.23809523809523808	147	8337	7	27	140	8310	8484	0.09166165147507754
M1	cpdb	0	network_modules	92	TRUE	1.313306799956095e-4	619	37	11	0.2972972972972973	0.017770597738287562	GO:1901698	GO:BP	response to nitrogen compound	16175	21651		0.9333333333333333	0.9354838709677419	619	15556	11	26	608	15530	16175	0.06465071410012074
M1	cpdb	0	network_modules	92	TRUE	1.6509645443846255e-4	49	36	5	0.1388888888888889	0.10204081632653061	REAC:R-HSA-112043	REAC	PLC beta mediated events	10916	1693		0.6666666666666666	0.6818181818181818	49	10867	5	31	44	10836	10916	0.11565034572207114
M1	cpdb	0	network_modules	92	TRUE	2.3759893117979492e-4	105	34	6	0.17647058823529413	0.05714285714285714	KEGG:04928	KEGG	Parathyroid hormone synthesis, secretion and action	8484	385		0.25	0.2857142857142857	105	8379	6	28	99	8351	8484	0.0941487695930442
M1	cpdb	0	network_modules	92	TRUE	2.453789776260544e-4	59	34	5	0.14705882352941177	0.0847457627118644	KEGG:04730	KEGG	Long-term depression	8484	359		0.3	0.3333333333333333	59	8425	5	29	54	8396	8484	0.10694317252783186
M1	cpdb	0	network_modules	92	TRUE	2.705800246432829e-4	54	36	5	0.1388888888888889	0.09259259259259259	REAC:R-HSA-112040	REAC	G-protein mediated events	10916	998		0.7142857142857143	0.7272727272727273	54	10862	5	31	49	10831	10916	0.10981594446499274
M1	cpdb	0	network_modules	92	TRUE	3.3223635528460157e-4	24	36	4	0.1111111111111111	0.16666666666666666	REAC:R-HSA-202040	REAC	G-protein activation	10916	996		0.7619047619047619	0.8181818181818182	24	10892	4	32	20	10860	10916	0.1337576511564755
M1	cpdb	0	network_modules	92	TRUE	3.3223635528460157e-4	24	36	4	0.1111111111111111	0.16666666666666666	REAC:R-HSA-418592	REAC	ADP signalling through P2Y purinoceptor 1	10916	12		0.7619047619047619	0.8181818181818182	24	10892	4	32	20	10860	10916	0.1337576511564755
M1	cpdb	0	network_modules	92	TRUE	3.886625040012932e-4	107	36	6	0.16666666666666666	0.056074766355140186	REAC:R-HSA-163685	REAC	Integration of energy metabolism	10916	1213		0.8571428571428571	0.8636363636363636	107	10809	6	30	101	10779	10916	0.09158839878728181
M1	cpdb	0	network_modules	92	TRUE	5.045829427371666e-4	259	36	8	0.2222222222222222	0.03088803088803089	REAC:R-HSA-76002	REAC	Platelet activation, signaling and aggregation	10916	1762		0.9047619047619048	0.9090909090909091	259	10657	8	28	251	10629	10916	0.07502116614569472
M1	cpdb	0	network_modules	92	TRUE	6.180949515065011e-4	7	37	3	0.08108108108108109	0.42857142857142855	GO:0007198	GO:BP	adenylate cyclase-inhibiting serotonin receptor signaling pathway	16175	2756		0.9666666666666667	0.967741935483871	7	16168	3	34	4	16134	16175	0.18566858204039244
M1	cpdb	0	network_modules	92	TRUE	6.245477927977791e-4	124	34	6	0.17647058823529413	0.04838709677419355	KEGG:04611	KEGG	Platelet activation	8484	321		0.35	0.38095238095238093	124	8360	6	28	118	8332	8484	0.08555068197659417
M1	cpdb	0	network_modules	92	TRUE	9.346927906651267e-4	133	34	6	0.17647058823529413	0.045112781954887216	KEGG:04270	KEGG	Vascular smooth muscle contraction	8484	298		0.4	0.42857142857142855	133	8351	6	28	127	8323	8484	0.0821082122388769
M1	cpdb	0	network_modules	92	TRUE	0.0014925924077018149	85	34	5	0.14705882352941177	0.058823529411764705	KEGG:04742	KEGG	Taste transduction	8484	361		0.45	0.47619047619047616	85	8399	5	29	80	8370	8484	0.08728422253017165
M1	cpdb	0	network_modules	92	TRUE	0.0017424080288585544	223	34	7	0.20588235294117646	0.03139013452914798	KEGG:05163	KEGG	Human cytomegalovirus infection	8484	444		0.5	0.5714285714285714	223	8261	7	27	216	8234	8484	0.0712104131722087
M1	cpdb	0	network_modules	92	TRUE	0.0017424080288585544	223	34	7	0.20588235294117646	0.03139013452914798	KEGG:04024	KEGG	cAMP signaling pathway	8484	252		0.5	0.5714285714285714	223	8261	7	27	216	8234	8484	0.0712104131722087
M1	cpdb	0	network_modules	92	TRUE	0.0017674246361669768	88	34	5	0.14705882352941177	0.056818181818181816	KEGG:04540	KEGG	Gap junction	8484	318		0.6	0.6190476190476191	88	8396	5	29	83	8367	8484	0.08557745836187043
M1	cpdb	0	network_modules	92	TRUE	0.0019544417720957614	227	34	7	0.20588235294117646	0.030837004405286344	KEGG:04810	KEGG	Regulation of actin cytoskeleton	8484	365		0.65	0.6666666666666666	227	8257	7	27	220	8230	8484	0.07041198335788182
M1	cpdb	0	network_modules	92	TRUE	0.002233312885168233	38	36	4	0.1111111111111111	0.10526315789473684	REAC:R-HSA-6814122	REAC	Cooperation of PDCL (PhLP1) and TRiC/CCT in G-protein beta folding	10916	410		0.9523809523809523	0.9545454545454546	38	10878	4	32	34	10846	10916	0.10511562424753323
M1	cpdb	0	network_modules	92	TRUE	0.0029774830360685843	98	34	5	0.14705882352941177	0.05102040816326531	KEGG:04750	KEGG	Inflammatory mediator regulation of TRP channels	8484	364		0.7	0.7142857142857143	98	8386	5	29	93	8357	8484	0.08044242786794079
M1	cpdb	0	network_modules	92	TRUE	0.003074188514650397	164	34	6	0.17647058823529413	0.036585365853658534	KEGG:04022	KEGG	cGMP-PKG signaling pathway	8484	251		0.75	0.7619047619047619	164	8320	6	28	158	8292	8484	0.07239609762624508
M1	cpdb	0	network_modules	92	TRUE	0.0032684260842665617	89	36	5	0.1388888888888889	0.056179775280898875	REAC:R-HSA-111885	REAC	Opioid Signalling	10916	1642		1	1	89	10827	5	31	84	10796	10916	0.08362680764988516
M1	cpdb	0	network_modules	92	TRUE	0.003443172688388689	101	34	5	0.14705882352941177	0.04950495049504951	KEGG:05142	KEGG	Chagas disease	8484	434		0.8	0.8571428571428571	101	8383	5	29	96	8354	8484	0.07904609964349646
M1	cpdb	0	network_modules	92	TRUE	0.003443172688388689	101	34	5	0.14705882352941177	0.04950495049504951	KEGG:05146	KEGG	Amoebiasis	8484	438		0.8	0.8571428571428571	101	8383	5	29	96	8354	8484	0.07904609964349646
M1	cpdb	0	network_modules	92	TRUE	0.005003140153530381	13	37	3	0.08108108108108109	0.23076923076923078	GO:0007216	GO:BP	G protein-coupled glutamate receptor signaling pathway	16175	2770		1	1	13	16162	3	34	10	16128	16175	0.13564200894436634
M1	cpdb	0	network_modules	92	TRUE	0.005895820089730202	113	34	5	0.14705882352941177	0.04424778761061947	KEGG:04725	KEGG	Cholinergic synapse	8484	355		0.9	0.9047619047619048	113	8371	5	29	108	8342	8484	0.07400209300062596
M1	cpdb	0	network_modules	92	TRUE	0.006409798665287704	115	34	5	0.14705882352941177	0.043478260869565216	KEGG:04724	KEGG	Glutamatergic synapse	8484	354		0.95	0.9523809523809523	115	8369	5	29	110	8340	8484	0.07323522185398273
M1	cpdb	0	network_modules	92	TRUE	0.008665309580639336	64	34	4	0.11764705882352941	0.0625	KEGG:04929	KEGG	GnRH secretion	8484	386		1	1	64	8420	4	30	60	8390	8484	0.08071730403868517
M1	cpdb	0	network_modules	94	TRUE	7.086342540190688e-11	62	13	7	0.5384615384615384	0.11290322580645161	KEGG:03250	KEGG	Viral life cycle - HIV-1	8484	223		0	0.5	62	8422	7	6	55	8416	8484	0.24429901401513118
M1	cpdb	0	network_modules	94	TRUE	5.466423670377162e-9	57	23	7	0.30434782608695654	0.12280701754385964	REAC:R-HSA-112382	REAC	Formation of RNA Pol II elongation complex 	10916	949		0	0.2857142857142857	57	10859	7	16	50	10843	10916	0.19071098341333315
M1	cpdb	0	network_modules	94	TRUE	5.466423670377162e-9	57	23	7	0.30434782608695654	0.12280701754385964	REAC:R-HSA-75955	REAC	RNA Polymerase II Transcription Elongation	10916	1891		0	0.2857142857142857	57	10859	7	16	50	10843	10916	0.19071098341333315
M1	cpdb	0	network_modules	94	TRUE	6.376295929394102e-8	80	23	7	0.30434782608695654	0.0875	REAC:R-HSA-674695	REAC	RNA Polymerase II Pre-transcription Events	10916	1888		0.3333333333333333	0.42857142857142855	80	10836	7	16	73	10820	10916	0.1600142386204686
M1	cpdb	0	network_modules	94	TRUE	1.5692154479168086e-5	81	32	6	0.1875	0.07407407407407407	GO:0034243	GO:BP	regulation of transcription elongation by RNA polymerase II	16175	8519		0	0.1111111111111111	81	16094	6	26	75	16068	16175	0.11510577820291178
M1	cpdb	0	network_modules	94	TRUE	3.320118672570944e-5	16	32	4	0.125	0.25	GO:0042795	GO:BP	snRNA transcription by RNA polymerase II	16175	10372		0.125	0.2222222222222222	16	16159	4	28	12	16131	16175	0.17563841108400688
M1	cpdb	0	network_modules	94	TRUE	4.39049022697881e-5	96	32	6	0.1875	0.0625	GO:0032784	GO:BP	regulation of DNA-templated transcription elongation	16175	7819		0.25	0.3333333333333333	96	16079	6	26	90	16053	16175	0.10524317745741547
M1	cpdb	0	network_modules	94	TRUE	6.70649301952362e-5	103	32	6	0.1875	0.05825242718446602	GO:0006368	GO:BP	transcription elongation by RNA polymerase II	16175	2143		0.375	0.4444444444444444	103	16072	6	26	97	16046	16175	0.10138392933037542
M1	cpdb	0	network_modules	94	TRUE	8.789581770407148e-5	20	32	4	0.125	0.2	GO:0009301	GO:BP	snRNA transcription	16175	3448		0.5	0.5555555555555556	20	16155	4	28	16	16127	16175	0.15680190792955565
M1	cpdb	0	network_modules	94	TRUE	1.1731657116347879e-4	73	23	5	0.21739130434782608	0.0684931506849315	REAC:R-HSA-6807505	REAC	RNA polymerase II transcribes snRNA genes	10916	1904		0.5	0.5714285714285714	73	10843	5	18	68	10825	10916	0.11879278193092019
M1	cpdb	0	network_modules	94	TRUE	1.49275856899087e-4	31	23	4	0.17391304347826086	0.12903225806451613	REAC:R-HSA-73863	REAC	RNA Polymerase I Transcription Termination	10916	1886		0.6666666666666666	0.7142857142857143	31	10885	4	19	27	10866	10916	0.14772042424410556
M1	cpdb	0	network_modules	94	TRUE	1.5138198498540505e-4	118	32	6	0.1875	0.05084745762711865	GO:0006354	GO:BP	DNA-templated transcription elongation	16175	2131		0.625	0.6666666666666666	118	16057	6	26	112	16031	16175	0.09428015367402322
M1	cpdb	0	network_modules	94	TRUE	3.404874571947924e-4	192	13	5	0.38461538461538464	0.026041666666666668	KEGG:05202	KEGG	Transcriptional misregulation in cancer	8484	454		1	1	192	8292	5	8	187	8284	8484	0.0953486983864076
M1	cpdb	0	network_modules	94	TRUE	8.275219145694934e-4	47	23	4	0.17391304347826086	0.0851063829787234	REAC:R-HSA-73762	REAC	RNA Polymerase I Transcription Initiation	10916	1885		0.8333333333333334	0.8571428571428571	47	10869	4	19	43	10850	10916	0.11902956908105158
M1	cpdb	0	network_modules	94	TRUE	0.003395626883773551	48	32	4	0.125	0.08333333333333333	GO:0032968	GO:BP	positive regulation of transcription elongation by RNA polymerase II	16175	7952		0.75	0.7777777777777778	48	16127	4	28	44	16099	16175	0.09988611011958307
M1	cpdb	0	network_modules	94	TRUE	0.00345821527147718	67	23	4	0.17391304347826086	0.05970149253731343	REAC:R-HSA-427359	REAC	SIRT1 negatively regulates rRNA expression	10916	2142		1	1	67	10849	4	19	63	10830	10916	0.0987073217598757
M1	cpdb	0	network_modules	94	TRUE	0.0068079076621796915	57	32	4	0.125	0.07017543859649122	GO:0032786	GO:BP	positive regulation of DNA-templated transcription, elongation	16175	7821		0.875	1	57	16118	4	28	53	16090	16175	0.0912693146071633
M1	cpdb	0	network_modules	94	TRUE	0.0068079076621796915	57	32	4	0.125	0.07017543859649122	GO:0016073	GO:BP	snRNA metabolic process	16175	5100		0.875	1	57	16118	4	28	53	16090	16175	0.0912693146071633
M1	cpdb	0	network_modules	95	TRUE	5.587761140075804e-28	101	29	18	0.6206896551724138	0.1782178217821782	REAC:R-HSA-977606	REAC	Regulation of Complement cascade	10916	1971		0	0.1111111111111111	101	10815	18	11	83	10804	10916	0.32959932265160424
M1	cpdb	0	network_modules	95	TRUE	3.530403412784659e-27	111	29	18	0.6206896551724138	0.16216216216216217	REAC:R-HSA-166658	REAC	Complement cascade	10916	390		0.125	0.2222222222222222	111	10805	18	11	93	10794	10916	0.31407633478657837
M1	cpdb	0	network_modules	95	TRUE	1.1311017444305807e-24	86	21	15	0.7142857142857143	0.1744186046511628	KEGG:04610	KEGG	Complement and coagulation cascades	8484	320		0	0.14285714285714285	86	8398	15	6	71	8392	8484	0.3501672571949132
M1	cpdb	0	network_modules	95	TRUE	5.408746822908913e-17	56	32	11	0.34375	0.19642857142857142	GO:0006956	GO:BP	complement activation	16175	2587		0	0.125	56	16119	11	21	45	16098	16175	0.25793516732165883
M1	cpdb	0	network_modules	95	TRUE	1.1915715189606058e-15	8	29	7	0.2413793103448276	0.875	REAC:R-HSA-166665	REAC	Terminal pathway of complement	10916	2490		0.25	0.3333333333333333	8	10908	7	22	1	10886	10916	0.45895520525369293
M1	cpdb	0	network_modules	95	TRUE	4.40597296812695e-12	475	32	15	0.46875	0.031578947368421054	GO:0002253	GO:BP	activation of immune response	16175	785		0.14285714285714285	0.25	475	15700	15	17	460	15683	16175	0.11587092122801373
M1	cpdb	0	network_modules	95	TRUE	1.0689331456000668e-11	627	32	16	0.5	0.025518341307814992	GO:0050778	GO:BP	positive regulation of immune response	16175	13252		0.2857142857142857	0.375	627	15548	16	16	611	15532	16175	0.10638484473711161
M1	cpdb	0	network_modules	95	TRUE	1.9461243953908134e-10	756	32	16	0.5	0.021164021164021163	GO:0050776	GO:BP	regulation of immune response	16175	13250		0.42857142857142855	0.5	756	15419	16	16	740	15403	16175	0.09560634216977444
M1	cpdb	0	network_modules	95	TRUE	4.129873450068016e-10	224	32	11	0.34375	0.049107142857142856	GO:0006959	GO:BP	humoral immune response	16175	2590		0.5714285714285714	0.625	224	15951	11	21	213	15930	16175	0.12568789040574535
M1	cpdb	0	network_modules	95	TRUE	3.065630575262294e-8	132	21	8	0.38095238095238093	0.06060606060606061	KEGG:05322	KEGG	Systemic lupus erythematosus	8484	484		0.16666666666666666	0.2857142857142857	132	8352	8	13	124	8339	8484	0.1470709718734523
M1	cpdb	0	network_modules	95	TRUE	1.002242478343842e-7	231	21	9	0.42857142857142855	0.03896103896103896	KEGG:05171	KEGG	Coronavirus disease - COVID-19	8484	452		0.3333333333333333	0.42857142857142855	231	8253	9	12	222	8241	8484	0.12284364114980269
M1	cpdb	0	network_modules	95	TRUE	2.8144137726550044e-7	536	32	12	0.375	0.022388059701492536	GO:0002252	GO:BP	immune effector process	16175	784		0.7142857142857143	0.75	536	15639	12	20	524	15619	16175	0.08503381444072793
M1	cpdb	0	network_modules	95	TRUE	5.8949828204203005e-6	3	29	3	0.10344827586206896	1	REAC:R-HSA-3359462	REAC	Defective AMN causes MGA1	10916	486		0.375	0.5555555555555556	3	10913	3	26	0	10887	10916	0.3212503890332051
M1	cpdb	0	network_modules	95	TRUE	5.8949828204203005e-6	3	29	3	0.10344827586206896	1	REAC:R-HSA-3359463	REAC	Defective CUBN causes MGA1	10916	513		0.375	0.5555555555555556	3	10913	3	26	0	10887	10916	0.3212503890332051
M1	cpdb	0	network_modules	95	TRUE	4.8654847825790874e-5	227	21	7	0.3333333333333333	0.030837004405286344	KEGG:04810	KEGG	Regulation of actin cytoskeleton	8484	365		0.5	0.5714285714285714	227	8257	7	14	220	8243	8484	0.09463760874598912
M1	cpdb	0	network_modules	95	TRUE	1.0969958158040152e-4	86	21	5	0.23809523809523808	0.05813953488372093	KEGG:05150	KEGG	Staphylococcus aureus infection	8484	439		0.6666666666666666	0.7142857142857143	86	8398	5	16	81	8382	8484	0.11336181376212959
M1	cpdb	0	network_modules	95	TRUE	1.6002463741362515e-4	271	21	7	0.3333333333333333	0.025830258302583026	KEGG:05020	KEGG	Prion disease	8484	416		0.8333333333333334	0.8571428571428571	271	8213	7	14	264	8199	8484	0.08537734554805367
M1	cpdb	0	network_modules	95	TRUE	6.985982957970365e-4	10	29	3	0.10344827586206896	0.3	REAC:R-HSA-9758881	REAC	Uptake of dietary cobalamins into enterocytes	10916	2629		0.625	0.6666666666666666	10	10906	3	26	7	10880	10916	0.17491856218789162
M1	cpdb	0	network_modules	95	TRUE	8.618753117235394e-4	9	32	3	0.09375	0.3333333333333333	GO:0015889	GO:BP	cobalamin transport	16175	4995		0.8571428571428571	0.875	9	16166	3	29	6	16137	16175	0.17595055271848542
M1	cpdb	0	network_modules	95	TRUE	0.0021039819774438476	14	29	3	0.10344827586206896	0.21428571428571427	REAC:R-HSA-3296469	REAC	Defects in cobalamin (B12) metabolism	10916	714		0.75	0.7777777777777778	14	10902	3	26	11	10876	10916	0.14733185457919962
M1	cpdb	0	network_modules	95	TRUE	0.003116974324425871	47	32	4	0.125	0.0851063829787234	GO:0051180	GO:BP	vitamin transport	16175	13559		1	1	47	16128	4	28	43	16100	16175	0.10099114393709493
M1	cpdb	0	network_modules	95	TRUE	0.006237158959713951	101	21	4	0.19047619047619047	0.039603960396039604	KEGG:05146	KEGG	Amoebiasis	8484	438		1	1	101	8383	4	17	97	8366	8484	0.08201620873353188
M1	cpdb	0	network_modules	95	TRUE	0.008775094807126765	22	29	3	0.10344827586206896	0.13636363636363635	REAC:R-HSA-196741	REAC	Cobalamin (Cbl, vitamin B12) transport and metabolism	10916	381		0.875	1	22	10894	3	26	19	10868	10916	0.11672991499915114
M1	cpdb	0	network_modules	95	TRUE	0.008775094807126765	22	29	3	0.10344827586206896	0.13636363636363635	REAC:R-HSA-3296482	REAC	Defects in vitamin and cofactor metabolism	10916	715		0.875	1	22	10894	3	26	19	10868	10916	0.11672991499915114
M1	cpdb	0	network_modules	96	TRUE	3.764846378583833e-25	31	34	13	0.38235294117647056	0.41935483870967744	GO:0099022	GO:BP	vesicle tethering	16175	19011		0	0.047619047619047616	31	16144	13	21	18	16123	16175	0.3992217323828264
M1	cpdb	0	network_modules	96	TRUE	4.192595740992101e-24	36	34	13	0.38235294117647056	0.3611111111111111	GO:0006901	GO:BP	vesicle coating	16175	2554		0.05	0.09523809523809523	36	16139	13	21	23	16118	16175	0.37021840965964936
M1	cpdb	0	network_modules	96	TRUE	7.141935585067075e-21	59	34	13	0.38235294117647056	0.22033898305084745	GO:0006903	GO:BP	vesicle targeting	16175	2555		0.1	0.14285714285714285	59	16116	13	21	46	16095	16175	0.28831372640406017
M1	cpdb	0	network_modules	96	TRUE	1.8135170617426976e-19	74	34	13	0.38235294117647056	0.17567567567567569	GO:0006900	GO:BP	vesicle budding from membrane	16175	2553		0.15	0.19047619047619047	74	16101	13	21	61	16080	16175	0.25692885655816394
M1	cpdb	0	network_modules	96	TRUE	7.292842653137549e-19	23	34	10	0.29411764705882354	0.43478260869565216	GO:0048207	GO:BP	vesicle targeting, rough ER to cis-Golgi	16175	12583		0.2	0.2857142857142857	23	16152	10	24	13	16128	16175	0.3564985762915148
M1	cpdb	0	network_modules	96	TRUE	7.292842653137549e-19	23	34	10	0.29411764705882354	0.43478260869565216	GO:0048208	GO:BP	COPII vesicle coating	16175	12584		0.2	0.2857142857142857	23	16152	10	24	13	16128	16175	0.3564985762915148
M1	cpdb	0	network_modules	96	TRUE	2.9336727758962642e-18	126	34	14	0.4117647058823529	0.1111111111111111	GO:0006888	GO:BP	endoplasmic reticulum to Golgi vesicle-mediated transport	16175	2544		0.3	0.3333333333333333	126	16049	14	20	112	16029	16175	0.21089372483650715
M1	cpdb	0	network_modules	96	TRUE	6.036850326956097e-18	120	23	13	0.5652173913043478	0.10833333333333334	REAC:R-HSA-9007101	REAC	Rab regulation of trafficking	10916	1939		0	0.09090909090909091	120	10796	13	10	107	10786	10916	0.2442402510694925
M1	cpdb	0	network_modules	96	TRUE	1.432281502887243e-17	88	23	12	0.5217391304347826	0.13636363636363635	REAC:R-HSA-8876198	REAC	RAB GEFs exchange GTP for GDP on RABs	10916	1834		0.1	0.18181818181818182	88	10828	12	11	76	10817	10916	0.2639543572318572
M1	cpdb	0	network_modules	96	TRUE	1.8971829218550012e-17	30	34	10	0.29411764705882354	0.3333333333333333	GO:0048199	GO:BP	vesicle targeting, to, from or within Golgi	16175	12575		0.35	0.38095238095238093	30	16145	10	24	20	16121	16175	0.311754417018516
M1	cpdb	0	network_modules	96	TRUE	5.280639234507185e-16	40	34	10	0.29411764705882354	0.25	GO:0090114	GO:BP	COPII-coated vesicle budding	16175	18031		0.4	0.42857142857142855	40	16135	10	24	30	16111	16175	0.26949960288390074
M1	cpdb	0	network_modules	96	TRUE	7.365416360725543e-15	284	34	15	0.4411764705882353	0.0528169014084507	GO:0048193	GO:BP	Golgi vesicle transport	16175	12570		0.45	0.47619047619047616	284	15891	15	19	269	15872	16175	0.14803304562439315
M1	cpdb	0	network_modules	96	TRUE	2.8194437480094758e-14	178	34	13	0.38235294117647056	0.07303370786516854	GO:0051650	GO:BP	establishment of vesicle localization	16175	13863		0.5	0.5238095238095238	178	15997	13	21	165	15976	16175	0.16336939501324774
M1	cpdb	0	network_modules	96	TRUE	5.0433748588837435e-14	186	34	13	0.38235294117647056	0.06989247311827956	GO:0051648	GO:BP	vesicle localization	16175	13861		0.55	0.5714285714285714	186	15989	13	21	173	15968	16175	0.1596445284529834
M1	cpdb	0	network_modules	96	TRUE	2.0467517974866656e-12	68	23	9	0.391304347826087	0.1323529411764706	REAC:R-HSA-204005	REAC	COPII-mediated vesicle transport	10916	280		0.2	0.2727272727272727	68	10848	9	14	59	10834	10916	0.2248897580961273
M1	cpdb	0	network_modules	96	TRUE	4.8526090238122626e-11	315	34	13	0.38235294117647056	0.04126984126984127	GO:0016050	GO:BP	vesicle organization	16175	5082		0.6	0.6190476190476191	315	15860	13	21	302	15839	16175	0.12052380406900395
M1	cpdb	0	network_modules	96	TRUE	1.4090524585807336e-9	410	34	13	0.38235294117647056	0.03170731707317073	GO:0051656	GO:BP	establishment of organelle localization	16175	13869		0.65	0.6666666666666666	410	15765	13	21	397	15744	16175	0.10424473594197102
M1	cpdb	0	network_modules	96	TRUE	4.215578225789293e-9	155	23	9	0.391304347826087	0.05806451612903226	REAC:R-HSA-199977	REAC	ER to Golgi Anterograde Transport	10916	823		0.3	0.36363636363636365	155	10761	9	14	146	10747	10916	0.1464616180203755
M1	cpdb	0	network_modules	96	TRUE	2.1834457680269695e-8	186	23	9	0.391304347826087	0.04838709677419355	REAC:R-HSA-948021	REAC	Transport to the Golgi and subsequent modification	10916	2604		0.4	0.45454545454545453	186	10730	9	14	177	10716	10916	0.13288523752813003
M1	cpdb	0	network_modules	96	TRUE	2.748438353981004e-8	519	34	13	0.38235294117647056	0.025048169556840076	GO:0051640	GO:BP	organelle localization	16175	13853		0.7	0.7142857142857143	519	15656	13	21	506	15635	16175	0.09122059644631979
M1	cpdb	0	network_modules	96	TRUE	3.170587688315696e-8	657	34	14	0.4117647058823529	0.0213089802130898	GO:0061024	GO:BP	membrane organization	16175	15141		0.75	0.7619047619047619	657	15518	14	20	643	15498	16175	0.08629056296435611
M1	cpdb	0	network_modules	96	TRUE	6.831589032150454e-8	305	23	10	0.43478260869565216	0.03278688524590164	REAC:R-HSA-446203	REAC	Asparagine N-linked glycosylation	10916	169		0.5	0.5454545454545454	305	10611	10	13	295	10598	10916	0.11343612068761304
M1	cpdb	0	network_modules	96	TRUE	7.624675310180273e-7	20	34	5	0.14705882352941177	0.25	GO:0009301	GO:BP	snRNA transcription	16175	3448		0.8	0.8095238095238095	20	16155	5	29	15	16126	16175	0.19044699981297658
M1	cpdb	0	network_modules	96	TRUE	8.167285175403604e-7	28	23	5	0.21739130434782608	0.17857142857142858	REAC:R-HSA-76071	REAC	RNA Polymerase III Transcription Initiation From Type 3 Promoter	10916	1902		0.6	0.6363636363636364	28	10888	5	18	23	10870	10916	0.19515873463531397
M1	cpdb	0	network_modules	96	TRUE	3.098561145757661e-6	36	23	5	0.21739130434782608	0.1388888888888889	REAC:R-HSA-76046	REAC	RNA Polymerase III Transcription Initiation	10916	1899		0.7	0.7272727272727273	36	10880	5	18	31	10862	10916	0.17158971787980826
M1	cpdb	0	network_modules	96	TRUE	3.3906478349651503e-6	9	34	4	0.11764705882352941	0.4444444444444444	GO:0042796	GO:BP	snRNA transcription by RNA polymerase III	16175	10373		0.85	0.8571428571428571	9	16166	4	30	5	16136	16175	0.2278862826038497
M1	cpdb	0	network_modules	96	TRUE	6.117152607533315e-6	41	23	5	0.21739130434782608	0.12195121951219512	REAC:R-HSA-74158	REAC	RNA Polymerase III Transcription	10916	1898		0.8	0.9090909090909091	41	10875	5	18	36	10857	10916	0.16047975331868616
M1	cpdb	0	network_modules	96	TRUE	6.117152607533315e-6	41	23	5	0.21739130434782608	0.12195121951219512	REAC:R-HSA-749476	REAC	RNA Polymerase III Abortive And Retractive Initiation	10916	1896		0.8	0.9090909090909091	41	10875	5	18	36	10857	10916	0.16047975331868616
M1	cpdb	0	network_modules	96	TRUE	4.846951625805181e-5	16	34	4	0.11764705882352941	0.25	GO:0042795	GO:BP	snRNA transcription by RNA polymerase II	16175	10372		0.9	0.9047619047619048	16	16159	4	30	12	16129	16175	0.1703198906636981
M1	cpdb	0	network_modules	96	TRUE	1.1731657116347879e-4	73	23	5	0.21739130434782608	0.0684931506849315	REAC:R-HSA-6807505	REAC	RNA polymerase II transcribes snRNA genes	10916	1904		1	1	73	10843	5	18	68	10825	10916	0.11879278193092019
M1	cpdb	0	network_modules	96	TRUE	1.7800349869937328e-4	56	34	5	0.14705882352941177	0.08928571428571429	GO:0006383	GO:BP	transcription by RNA polymerase III	16175	2148		0.95	0.9523809523809523	56	16119	5	29	51	16090	16175	0.11220181934681926
M1	cpdb	0	network_modules	96	TRUE	1.9482746176895688e-4	57	34	5	0.14705882352941177	0.08771929824561403	GO:0016073	GO:BP	snRNA metabolic process	16175	5100		1	1	57	16118	5	29	52	16089	16175	0.11116880472104639
M1	cpdb	0	network_modules	98	TRUE	0.0035574894487904254	245	24	6	0.25	0.024489795918367346	REAC:R-HSA-425407	REAC	SLC-mediated transmembrane transport	10916	2146		0	0.3333333333333333	245	10671	6	18	239	10653	10916	0.07211370249670818
M1	cpdb	0	network_modules	98	TRUE	0.004937290989342017	2	31	2	0.06451612903225806	1	GO:0015819	GO:BP	lysine transport	16175	4931		0	0.5	2	16173	2	29	0	16144	16175	0.2537724263756736
M1	cpdb	0	network_modules	98	TRUE	0.005659617375167741	24	24	3	0.125	0.125	REAC:R-HSA-425410	REAC	Metal ion SLC transporters	10916	1442		0.5	0.6666666666666666	24	10892	3	21	21	10871	10916	0.1230719794344473
M1	cpdb	0	network_modules	98	TRUE	0.009516029220590517	84	24	4	0.16666666666666666	0.047619047619047616	REAC:R-HSA-425366	REAC	Transport of bile salts and organic acids, metal ions and amine compounds	10916	2590		1	1	84	10832	4	20	80	10812	10916	0.08539663243298506
M1	cpdb	0	network_modules	98	TRUE	0.009873841214350412	143	31	5	0.16129032258064516	0.03496503496503497	GO:0007043	GO:BP	cell-cell junction assembly	16175	2647		1	1	143	16032	5	26	138	16006	16175	0.07136475005256776
M1	cpdb	0	network_modules	99	TRUE	1.9522002074805847e-10	244	23	11	0.4782608695652174	0.045081967213114756	REAC:R-HSA-8951664	REAC	Neddylation	10916	1559		NA	1	244	10672	11	12	233	10660	10916	0.1417142188366688
M1	cpdb	0	network_modules	99	TRUE	9.81333804931135e-9	84	10	6	0.6	0.07142857142857142	KEGG:03083	KEGG	Polycomb repressive complex	8484	220		NA	1	84	8400	6	4	78	8396	8484	0.20473968459244632
M1	cpdb	0	network_modules	99	TRUE	0.0027154568619690614	57	26	4	0.15384615384615385	0.07017543859649122	GO:0006893	GO:BP	Golgi to plasma membrane transport	16175	2548		0	0.3333333333333333	57	16118	4	22	53	16096	16175	0.10178604912265703
M1	cpdb	0	network_modules	99	TRUE	0.00320770564458381	137	26	5	0.19230769230769232	0.0364963503649635	GO:0098876	GO:BP	vesicle-mediated transport to the plasma membrane	16175	18924		0.5	0.6666666666666666	137	16038	5	21	132	16017	16175	0.08049291330996321
M1	cpdb	0	network_modules	99	TRUE	0.009102464204842906	77	26	4	0.15384615384615385	0.05194805194805195	GO:0032088	GO:BP	negative regulation of NF-kappaB transcription factor activity	16175	7355		1	1	77	16098	4	22	73	16076	16175	0.08690862364672917
M1	cpdb	0	network_modules	100	TRUE	5.887817470813211e-4	745	29	10	0.3448275862068966	0.013422818791946308	GO:0098609	GO:BP	cell-cell adhesion	16175	18805		0	0.3333333333333333	745	15430	10	19	735	15411	16175	0.06040668949509921
M1	cpdb	0	network_modules	100	TRUE	0.001627727180226418	193	29	6	0.20689655172413793	0.031088082901554404	GO:0098742	GO:BP	cell-cell adhesion via plasma-membrane adhesion molecules	16175	18867		0.5	0.6666666666666666	193	15982	6	23	187	15959	16175	0.07609782880790539
M1	cpdb	0	network_modules	100	TRUE	0.0017359219389038083	44	29	4	0.13793103448275862	0.09090909090909091	GO:0016339	GO:BP	calcium-dependent cell-cell adhesion via plasma membrane cell adhesion molecules	16175	5214		1	1	44	16131	4	25	40	16106	16175	0.11001836121542809
M1	cpdb	0	network_modules	101	TRUE	3.4677514080557313e-11	168	19	10	0.5263157894736842	0.05952380952380952	KEGG:04141	KEGG	Protein processing in endoplasmic reticulum	8484	278		NA	1	168	8316	10	9	158	8307	8484	0.17224371666450705
M1	cpdb	0	network_modules	101	TRUE	2.9576644206895456e-6	66	30	6	0.2	0.09090909090909091	GO:0036503	GO:BP	ERAD pathway	16175	9635		0	0.1111111111111111	66	16109	6	24	60	16085	16175	0.132482215847057
M1	cpdb	0	network_modules	101	TRUE	1.022958683459581e-5	470	30	10	0.3333333333333333	0.02127659574468085	GO:0010498	GO:BP	proteasomal protein catabolic process	16175	4177		0.125	0.2222222222222222	470	15705	10	20	460	15685	16175	0.07808828771700381
M1	cpdb	0	network_modules	101	TRUE	2.3253037691911017e-5	673	30	11	0.36666666666666664	0.01634472511144131	GO:0051603	GO:BP	proteolysis involved in protein catabolic process	16175	13820		0.25	0.3333333333333333	673	15502	11	19	662	15483	16175	0.07016927990278689
M1	cpdb	0	network_modules	101	TRUE	2.8062413710138975e-4	28	30	4	0.13333333333333333	0.14285714285714285	GO:1903513	GO:BP	endoplasmic reticulum to cytosol transport	16175	23063		0.375	0.5555555555555556	28	16147	4	26	24	16121	16175	0.13646595659644098
M1	cpdb	0	network_modules	101	TRUE	2.8062413710138975e-4	28	30	4	0.13333333333333333	0.14285714285714285	GO:0030970	GO:BP	retrograde protein transport, ER to cytosol	16175	6980		0.375	0.5555555555555556	28	16147	4	26	24	16121	16175	0.13646595659644098
M1	cpdb	0	network_modules	101	TRUE	0.0022605478057214075	200	30	6	0.2	0.03	GO:0034976	GO:BP	response to endoplasmic reticulum stress	16175	8746		0.625	0.6666666666666666	200	15975	6	24	194	15951	16175	0.07319221104478897
M1	cpdb	0	network_modules	101	TRUE	0.002385564520583297	47	30	4	0.13333333333333333	0.0851063829787234	GO:0032527	GO:BP	protein exit from endoplasmic reticulum	16175	7621		0.75	0.7777777777777778	47	16128	4	26	43	16102	16175	0.10445187907564764
M1	cpdb	0	network_modules	101	TRUE	0.0048904476213216894	2	30	2	0.06666666666666667	1	GO:1904780	GO:BP	negative regulation of protein localization to centrosome	16175	24100		0.875	0.8888888888888888	2	16173	2	28	0	16145	16175	0.2579752855695965
M1	cpdb	0	network_modules	101	TRUE	0.009136830752797307	144	30	5	0.16666666666666666	0.034722222222222224	GO:0007030	GO:BP	Golgi organization	16175	2635		1	1	144	16031	5	25	139	16006	16175	0.07239896467071884
M1	cpdb	0	network_modules	102	TRUE	6.997520436455891e-54	108	33	30	0.9090909090909091	0.2777777777777778	KEGG:03013	KEGG	Nucleocytoplasmic transport	8484	209		0	0.5	108	8376	30	3	78	8373	8484	0.4996390231968404
M1	cpdb	0	network_modules	102	TRUE	7.978886929009592e-48	38	32	22	0.6875	0.5789473684210527	REAC:R-HSA-168276	REAC	NS1 Mediated Effects on Host Pathways	10916	1550		0	0.013333333333333334	38	10878	22	10	16	10868	10916	0.6297178553387826
M1	cpdb	0	network_modules	102	TRUE	3.302510236016554e-46	34	32	21	0.65625	0.6176470588235294	REAC:R-HSA-177243	REAC	Interactions of Rev with host cellular proteins	10916	1221		0.013513513513513514	0.02666666666666667	34	10882	21	11	13	10871	10916	0.6355556603692117
M1	cpdb	0	network_modules	102	TRUE	2.7388114692950395e-44	31	32	20	0.625	0.6451612903225806	REAC:R-HSA-180746	REAC	Nuclear import of Rev protein	10916	1619		0.02702702702702703	0.04	31	10885	20	12	11	10873	10916	0.6339446834907171
M1	cpdb	0	network_modules	102	TRUE	5.769305228853618e-44	261	35	29	0.8285714285714286	0.1111111111111111	GO:0051169	GO:BP	nuclear transport	16175	13552		0	0.05714285714285714	261	15914	29	6	232	15908	16175	0.30026551909571153
M1	cpdb	0	network_modules	102	TRUE	5.769305228853618e-44	261	35	29	0.8285714285714286	0.1111111111111111	GO:0006913	GO:BP	nucleocytoplasmic transport	16175	2562		0	0.05714285714285714	261	15914	29	6	232	15908	16175	0.30026551909571153
M1	cpdb	0	network_modules	102	TRUE	7.295829588883313e-44	32	32	20	0.625	0.625	REAC:R-HSA-165054	REAC	Rev-mediated nuclear export of HIV RNA	10916	2098		0.04054054054054054	0.05333333333333334	32	10884	20	12	12	10872	10916	0.6238974641675853
M1	cpdb	0	network_modules	102	TRUE	5.43193142806028e-42	29	32	19	0.59375	0.6551724137931034	REAC:R-HSA-168271	REAC	Transport of Ribonucleoproteins into the Host Nucleus	10916	2589		0.05405405405405406	0.06666666666666667	29	10887	19	13	10	10874	10916	0.6226546159695406
M1	cpdb	0	network_modules	102	TRUE	4.334868373094113e-40	71	32	22	0.6875	0.30985915492957744	REAC:R-HSA-1169408	REAC	ISG15 antiviral mechanism	10916	1166		0.06756756756756757	0.08	71	10845	22	10	49	10835	10916	0.45935105861124387
M1	cpdb	0	network_modules	102	TRUE	7.288541844047175e-39	29	32	18	0.5625	0.6206896551724138	REAC:R-HSA-168333	REAC	NEP/NS2 Interacts with the Cellular Export Machinery	10916	1514		0.08108108108108109	0.09333333333333334	29	10887	18	14	11	10873	10916	0.5897360308171572
M1	cpdb	0	network_modules	102	TRUE	1.8199158278313708e-38	30	32	18	0.5625	0.6	REAC:R-HSA-168274	REAC	Export of Viral Ribonucleoproteins from Nucleus	10916	883		0.0945945945945946	0.10666666666666667	30	10886	18	14	12	10872	10916	0.5797555434948373
M1	cpdb	0	network_modules	102	TRUE	4.334512314639036e-38	31	32	18	0.5625	0.5806451612903226	REAC:R-HSA-180910	REAC	Vpr-mediated nuclear import of PICs	10916	2665		0.10810810810810811	0.13333333333333333	31	10885	18	14	13	10871	10916	0.5702608492403244
M1	cpdb	0	network_modules	102	TRUE	4.334512314639036e-38	31	32	18	0.5625	0.5806451612903226	REAC:R-HSA-159227	REAC	Transport of the SLBP independent Mature mRNA	10916	2602		0.10810810810810811	0.13333333333333333	31	10885	18	14	13	10871	10916	0.5702608492403244
M1	cpdb	0	network_modules	102	TRUE	9.895385932662843e-38	32	32	18	0.5625	0.5625	REAC:R-HSA-159230	REAC	Transport of the SLBP Dependant Mature mRNA	10916	2601		0.13513513513513514	0.14666666666666667	32	10884	18	14	14	10870	10916	0.5612137081955163
M1	cpdb	0	network_modules	102	TRUE	4.6148259391381426e-37	34	32	18	0.5625	0.5294117647058824	REAC:R-HSA-176033	REAC	Interactions of Vpr with host cellular proteins	10916	1223		0.14864864864864866	0.16	34	10882	18	14	16	10868	10916	0.5443290146577834
M1	cpdb	0	network_modules	102	TRUE	1.6369466630369868e-36	153	32	24	0.75	0.1568627450980392	REAC:R-HSA-168255	REAC	Influenza Infection	10916	1185		0.16216216216216217	0.17333333333333334	153	10763	24	8	129	10755	10916	0.33946903392745914
M1	cpdb	0	network_modules	102	TRUE	3.2840852623919555e-36	28	32	17	0.53125	0.6071428571428571	REAC:R-HSA-5619107	REAC	Defective TPR may confer susceptibility towards thyroid papillary carcinoma (TPC)	10916	684		0.17567567567567569	0.2	28	10888	17	15	11	10873	10916	0.5667455670633025
M1	cpdb	0	network_modules	102	TRUE	3.2840852623919555e-36	28	32	17	0.53125	0.6071428571428571	REAC:R-HSA-170822	REAC	Regulation of Glucokinase by Glucokinase Regulatory Protein	10916	1975		0.17567567567567569	0.2	28	10888	17	15	11	10873	10916	0.5667455670633025
M1	cpdb	0	network_modules	102	TRUE	6.99660861102441e-36	38	32	18	0.5625	0.47368421052631576	REAC:R-HSA-159231	REAC	Transport of Mature mRNA Derived from an Intronless Transcript	10916	2585		0.20270270270270271	0.21333333333333335	38	10878	18	14	20	10864	10916	0.5146410128558055
M1	cpdb	0	network_modules	102	TRUE	1.2977861483188264e-35	39	32	18	0.5625	0.46153846153846156	REAC:R-HSA-159234	REAC	Transport of Mature mRNAs Derived from Intronless Transcripts	10916	2587		0.21621621621621623	0.22666666666666666	39	10877	18	14	21	10863	10916	0.5079403050959503
M1	cpdb	0	network_modules	102	TRUE	7.687433476046309e-35	24	32	16	0.5	0.6666666666666666	REAC:R-HSA-9615933	REAC	Postmitotic nuclear pore complex (NPC) reformation	10916	1778		0.22972972972972974	0.24	24	10892	16	16	8	10876	10916	0.5762897822358567
M1	cpdb	0	network_modules	102	TRUE	8.606758849458992e-35	32	32	17	0.53125	0.53125	REAC:R-HSA-4085377	REAC	SUMOylation of SUMOylation proteins	10916	2172		0.24324324324324326	0.25333333333333335	32	10884	17	15	15	10869	10916	0.5298718302094817
M1	cpdb	0	network_modules	102	TRUE	1.2599214918359033e-34	43	32	18	0.5625	0.4186046511627907	REAC:R-HSA-4615885	REAC	SUMOylation of DNA replication proteins	10916	2170		0.25675675675675674	0.26666666666666666	43	10873	18	14	25	10859	10916	0.48351038135491714
M1	cpdb	0	network_modules	102	TRUE	1.7728337845841875e-34	33	32	17	0.53125	0.5151515151515151	REAC:R-HSA-3301854	REAC	Nuclear Pore Complex (NPC) Disassembly	10916	1615		0.2702702702702703	0.28	33	10883	17	15	16	10868	10916	0.5217152013026768
M1	cpdb	0	network_modules	102	TRUE	4.296258725990383e-34	115	35	21	0.6	0.1826086956521739	GO:0006606	GO:BP	protein import into nucleus	16175	2323		0.058823529411764705	0.08571428571428572	115	16060	21	14	94	16046	16175	0.3286087879189601
M1	cpdb	0	network_modules	102	TRUE	6.802170470719564e-34	126	32	22	0.6875	0.1746031746031746	REAC:R-HSA-162909	REAC	Host Interactions of HIV factors	10916	1132		0.28378378378378377	0.29333333333333333	126	10790	22	10	104	10780	10916	0.34313697943018673
M1	cpdb	0	network_modules	102	TRUE	6.876417996768566e-34	35	32	17	0.53125	0.4857142857142857	REAC:R-HSA-3232142	REAC	SUMOylation of ubiquitinylation proteins	10916	2179		0.2972972972972973	0.30666666666666664	35	10881	17	15	18	10866	10916	0.5064606238070352
M1	cpdb	0	network_modules	102	TRUE	1.1400123270536621e-33	120	35	21	0.6	0.175	GO:0051170	GO:BP	import into nucleus	16175	13553		0.08823529411764706	0.11428571428571428	120	16055	21	14	99	16041	16175	0.32157227359484203
M1	cpdb	0	network_modules	102	TRUE	1.335956270010461e-32	40	32	17	0.53125	0.425	REAC:R-HSA-168325	REAC	Viral Messenger RNA Synthesis	10916	2648		0.3108108108108108	0.32	40	10876	17	15	23	10861	10916	0.47344837725103023
M1	cpdb	0	network_modules	102	TRUE	2.6594038000947144e-32	147	32	22	0.6875	0.14965986394557823	REAC:R-HSA-1169410	REAC	Antiviral mechanism by IFN-stimulated genes	10916	157		0.32432432432432434	0.3333333333333333	147	10769	22	10	125	10759	10916	0.31708769875498616
M1	cpdb	0	network_modules	102	TRUE	2.940516524778747e-32	55	32	18	0.5625	0.32727272727272727	REAC:R-HSA-6784531	REAC	tRNA processing in the nucleus	10916	2745		0.33783783783783783	0.3466666666666667	55	10861	18	14	37	10847	10916	0.4269164565105855
M1	cpdb	0	network_modules	102	TRUE	6.316423787654035e-32	43	32	17	0.53125	0.3953488372093023	REAC:R-HSA-4570464	REAC	SUMOylation of RNA binding proteins	10916	2171		0.35135135135135137	0.36	43	10873	17	15	26	10858	10916	0.456459255217774
M1	cpdb	0	network_modules	102	TRUE	4.089652917582722e-31	47	32	17	0.53125	0.3617021276595745	REAC:R-HSA-2980766	REAC	Nuclear Envelope Breakdown	10916	1613		0.36486486486486486	0.37333333333333335	47	10869	17	15	30	10854	10916	0.43638047876833397
M1	cpdb	0	network_modules	102	TRUE	4.210290952819171e-31	241	35	23	0.6571428571428571	0.0954356846473029	GO:0034504	GO:BP	protein localization to nucleus	16175	8670		0.11764705882352941	0.14285714285714285	241	15934	23	12	218	15922	16175	0.24686255241011176
M1	cpdb	0	network_modules	102	TRUE	2.1922699299021483e-30	51	32	17	0.53125	0.3333333333333333	REAC:R-HSA-191859	REAC	snRNP Assembly	10916	2736		0.3783783783783784	0.4	51	10865	17	15	34	10850	10916	0.4187038681170509
M1	cpdb	0	network_modules	102	TRUE	2.1922699299021483e-30	51	32	17	0.53125	0.3333333333333333	REAC:R-HSA-194441	REAC	Metabolism of non-coding RNA	10916	1431		0.3783783783783784	0.4	51	10865	17	15	34	10850	10916	0.4187038681170509
M1	cpdb	0	network_modules	102	TRUE	3.342131048858443e-30	145	32	21	0.65625	0.14482758620689656	REAC:R-HSA-162587	REAC	HIV Life Cycle	10916	1103		0.40540540540540543	0.41333333333333333	145	10771	21	11	124	10760	10916	0.3045234543409661
M1	cpdb	0	network_modules	102	TRUE	6.219068070290635e-30	71	32	18	0.5625	0.2535211267605634	REAC:R-HSA-159236	REAC	Transport of Mature mRNA derived from an Intron-Containing Transcript	10916	2586		0.4189189189189189	0.4266666666666667	71	10845	18	14	53	10831	10916	0.3750349974745306
M1	cpdb	0	network_modules	102	TRUE	6.768666102699968e-29	132	32	20	0.625	0.15151515151515152	REAC:R-HSA-162599	REAC	Late Phase of HIV Life Cycle	10916	1304		0.43243243243243246	0.44	132	10784	20	12	112	10772	10916	0.3040621712860907
M1	cpdb	0	network_modules	102	TRUE	7.031287558539044e-29	80	32	18	0.5625	0.225	REAC:R-HSA-72202	REAC	Transport of Mature Transcript to Cytoplasm	10916	2584		0.44594594594594594	0.4533333333333333	80	10836	18	14	62	10822	10916	0.3529325964601272
M1	cpdb	0	network_modules	102	TRUE	3.661684854405456e-28	66	32	17	0.53125	0.25757575757575757	REAC:R-HSA-4551638	REAC	SUMOylation of chromatin organization proteins	10916	2173		0.4594594594594595	0.4666666666666667	66	10850	17	15	49	10835	10916	0.3673544428057234
M1	cpdb	0	network_modules	102	TRUE	4.900253964760659e-28	67	32	17	0.53125	0.2537313432835821	REAC:R-HSA-3371453	REAC	Regulation of HSF1-mediated heat shock response	10916	1977		0.47297297297297297	0.48	67	10849	17	15	50	10834	10916	0.3645558897825005
M1	cpdb	0	network_modules	102	TRUE	5.238920955145946e-28	225	32	22	0.6875	0.09777777777777778	REAC:R-HSA-162906	REAC	HIV Infection	10916	1102		0.4864864864864865	0.49333333333333335	225	10691	22	10	203	10681	10916	0.25450526076600655
M1	cpdb	0	network_modules	102	TRUE	6.525144067013768e-28	68	32	17	0.53125	0.25	REAC:R-HSA-70171	REAC	Glycolysis	10916	1074		0.5	0.5066666666666667	68	10848	17	15	51	10833	10916	0.36181894988239555
M1	cpdb	0	network_modules	102	TRUE	1.9580467816361066e-27	72	32	17	0.53125	0.2361111111111111	REAC:R-HSA-3108214	REAC	SUMOylation of DNA damage response and repair proteins	10916	2168		0.5135135135135135	0.52	72	10844	17	15	55	10829	10916	0.3514442013277523
M1	cpdb	0	network_modules	102	TRUE	8.730487096891198e-27	102	32	18	0.5625	0.17647058823529413	REAC:R-HSA-5578749	REAC	Transcriptional regulation by small RNAs	10916	2555		0.527027027027027	0.5333333333333333	102	10814	18	14	84	10800	10916	0.31174431625866356
M1	cpdb	0	network_modules	102	TRUE	1.0566329627383797e-26	103	32	18	0.5625	0.17475728155339806	REAC:R-HSA-72306	REAC	tRNA processing	10916	2743		0.5405405405405406	0.5466666666666666	103	10813	18	14	85	10799	10916	0.3101902686625995
M1	cpdb	0	network_modules	102	TRUE	1.836442863794837e-26	263	32	22	0.6875	0.08365019011406843	REAC:R-HSA-913531	REAC	Interferon Signaling	10916	1227		0.5540540540540541	0.56	263	10653	22	10	241	10643	10916	0.2345904956540435
M1	cpdb	0	network_modules	102	TRUE	5.643565259926027e-26	86	32	17	0.53125	0.19767441860465115	REAC:R-HSA-70326	REAC	Glucose metabolism	10916	1053		0.5675675675675675	0.5733333333333334	86	10830	17	15	69	10815	10916	0.3209896246722156
M1	cpdb	0	network_modules	102	TRUE	7.004975894961286e-26	87	32	17	0.53125	0.19540229885057472	REAC:R-HSA-3371556	REAC	Cellular response to heat stress	10916	334		0.581081081081081	0.5866666666666667	87	10829	17	15	70	10814	10916	0.3190983966982765
M1	cpdb	0	network_modules	102	TRUE	2.0481976879550254e-25	120	32	18	0.5625	0.15	REAC:R-HSA-9705671	REAC	SARS-CoV-2 activates/modulates innate and adaptive immune responses	10916	2123		0.5945945945945946	0.6	120	10796	18	14	102	10782	10916	0.28679606482262776
M1	cpdb	0	network_modules	102	TRUE	2.432176776207094e-25	70	32	16	0.5	0.22857142857142856	REAC:R-HSA-2995410	REAC	Nuclear Envelope (NE) Reassembly	10916	1612		0.6081081081081081	0.6133333333333333	70	10846	16	16	54	10830	10916	0.3352930022826638
M1	cpdb	0	network_modules	102	TRUE	3.5936286400663283e-25	95	32	17	0.53125	0.17894736842105263	REAC:R-HSA-5619102	REAC	SLC transporter disorders	10916	2145		0.6216216216216216	0.6266666666666667	95	10821	17	15	78	10806	10916	0.30505226608652436
M1	cpdb	0	network_modules	102	TRUE	1.4730428327057982e-24	133	32	18	0.5625	0.13533834586466165	REAC:R-HSA-168273	REAC	Influenza Viral RNA Transcription and Replication	10916	1186		0.6351351351351351	0.64	133	10783	18	14	115	10769	10916	0.27199492797594416
M1	cpdb	0	network_modules	102	TRUE	1.6995273942772577e-24	134	32	18	0.5625	0.13432835820895522	REAC:R-HSA-211000	REAC	Gene Silencing by RNA	10916	1041		0.6486486486486487	0.6533333333333333	134	10782	18	14	116	10768	10916	0.27094557627763577
M1	cpdb	0	network_modules	102	TRUE	3.558431391142164e-24	177	32	19	0.59375	0.10734463276836158	REAC:R-HSA-2990846	REAC	SUMOylation	10916	2167		0.6621621621621622	0.6666666666666666	177	10739	19	13	158	10726	10916	0.24794434434691306
M1	cpdb	0	network_modules	102	TRUE	8.657047220077723e-24	113	32	17	0.53125	0.1504424778761062	REAC:R-HSA-9610379	REAC	HCMV Late Events	10916	1090		0.6756756756756757	0.68	113	10803	17	15	96	10788	10916	0.27905237011301925
M1	cpdb	0	network_modules	102	TRUE	7.347869582038173e-23	373	35	21	0.6	0.05630026809651475	GO:0072594	GO:BP	establishment of protein localization to organelle	16175	17458		0.14705882352941177	0.17142857142857143	373	15802	21	14	352	15788	16175	0.17899732569772
M1	cpdb	0	network_modules	102	TRUE	8.051317824354318e-23	114	35	16	0.45714285714285713	0.14035087719298245	GO:0050657	GO:BP	nucleic acid transport	16175	13197		0.17647058823529413	0.22857142857142856	114	16061	16	19	98	16042	16175	0.25054859042692074
M1	cpdb	0	network_modules	102	TRUE	8.051317824354318e-23	114	35	16	0.45714285714285713	0.14035087719298245	GO:0050658	GO:BP	RNA transport	16175	13198		0.17647058823529413	0.22857142857142856	114	16061	16	19	98	16042	16175	0.25054859042692074
M1	cpdb	0	network_modules	102	TRUE	9.724623332266836e-23	152	35	17	0.4857142857142857	0.1118421052631579	GO:0051168	GO:BP	nuclear export	16175	13551		0.23529411764705882	0.2571428571428571	152	16023	17	18	135	16005	16175	0.22989471093037386
M1	cpdb	0	network_modules	102	TRUE	1.25256889048275e-22	117	35	16	0.45714285714285713	0.13675213675213677	GO:0051236	GO:BP	establishment of RNA localization	16175	13586		0.2647058823529412	0.2857142857142857	117	16058	16	19	101	16039	16175	0.24723674967487486
M1	cpdb	0	network_modules	102	TRUE	1.7100683973714209e-22	171	32	18	0.5625	0.10526315789473684	REAC:R-HSA-3108232	REAC	SUMO E3 ligases SUMOylate target proteins	10916	2163		0.6891891891891891	0.6933333333333334	171	10745	18	14	153	10731	10916	0.23878070251032815
M1	cpdb	0	network_modules	102	TRUE	1.8790881041774314e-22	134	32	17	0.53125	0.12686567164179105	REAC:R-HSA-68875	REAC	Mitotic Prophase	10916	1485		0.7027027027027027	0.7066666666666667	134	10782	17	15	117	10767	10916	0.255557220863241
M1	cpdb	0	network_modules	102	TRUE	2.146982499382006e-22	135	32	17	0.53125	0.1259259259259259	REAC:R-HSA-9609690	REAC	HCMV Early Events	10916	1088		0.7162162162162162	0.72	135	10781	17	15	118	10766	10916	0.25457581597095363
M1	cpdb	0	network_modules	102	TRUE	2.3605349546498487e-22	90	35	15	0.42857142857142855	0.16666666666666666	GO:0006405	GO:BP	RNA export from nucleus	16175	2166		0.29411764705882354	0.3142857142857143	90	16085	15	20	75	16065	16175	0.2648150157805058
M1	cpdb	0	network_modules	102	TRUE	3.141773511762604e-22	406	32	22	0.6875	0.054187192118226604	REAC:R-HSA-68886	REAC	M Phase	10916	1343		0.7297297297297297	0.7333333333333333	406	10510	22	10	384	10500	10916	0.18633662687840208
M1	cpdb	0	network_modules	102	TRUE	1.9652227983960347e-21	524	35	22	0.6285714285714286	0.04198473282442748	GO:0006886	GO:BP	intracellular protein transport	16175	2542		0.3235294117647059	0.34285714285714286	524	15651	22	13	502	15638	16175	0.1568065386788913
M1	cpdb	0	network_modules	102	TRUE	2.4007022090324066e-21	197	32	18	0.5625	0.09137055837563451	REAC:R-HSA-9705683	REAC	SARS-CoV-2-host interactions	10916	2128		0.7432432432432432	0.7466666666666667	197	10719	18	14	179	10705	10916	0.2217657497552796
M1	cpdb	0	network_modules	102	TRUE	3.9598655312628e-21	159	32	17	0.53125	0.1069182389937107	REAC:R-HSA-9609646	REAC	HCMV Infection	10916	1089		0.7567567567567568	0.76	159	10757	17	15	142	10742	10916	0.2338435014688327
M1	cpdb	0	network_modules	102	TRUE	7.349682421890637e-21	149	35	16	0.45714285714285713	0.10738255033557047	GO:0006403	GO:BP	RNA localization	16175	2164		0.35294117647058826	0.37142857142857144	149	16026	16	19	133	16007	16175	0.21833937857522157
M1	cpdb	0	network_modules	102	TRUE	1.7576208684598855e-20	173	32	17	0.53125	0.09826589595375723	REAC:R-HSA-5619115	REAC	Disorders of transmembrane transporters	10916	778		0.7702702702702703	0.7733333333333333	173	10743	17	15	156	10728	10916	0.22377123572588206
M1	cpdb	0	network_modules	102	TRUE	5.412287204191795e-20	168	35	16	0.45714285714285713	0.09523809523809523	GO:0015931	GO:BP	nucleobase-containing compound transport	16175	5016		0.38235294117647056	0.4	168	16007	16	19	152	15988	16175	0.20520492151967873
M1	cpdb	0	network_modules	102	TRUE	7.265372032498089e-19	808	35	23	0.6571428571428571	0.028465346534653466	GO:0033365	GO:BP	protein localization to organelle	16175	8175		0.4117647058823529	0.42857142857142855	808	15367	23	12	785	15355	16175	0.12979273272349434
M1	cpdb	0	network_modules	102	TRUE	1.1898616452483403e-18	276	32	18	0.5625	0.06521739130434782	REAC:R-HSA-72203	REAC	Processing of Capped Intron-Containing Pre-mRNA	10916	1796		0.7837837837837838	0.7866666666666666	276	10640	18	14	258	10626	10916	0.18555294178686016
M1	cpdb	0	network_modules	102	TRUE	2.181539720448898e-18	228	32	17	0.53125	0.07456140350877193	REAC:R-HSA-68882	REAC	Mitotic Anaphase	10916	1479		0.7972972972972973	0.8	228	10688	17	15	211	10673	10916	0.19351203471734665
M1	cpdb	0	network_modules	102	TRUE	2.3533570876289203e-18	229	32	17	0.53125	0.07423580786026202	REAC:R-HSA-2555396	REAC	Mitotic Metaphase and Anaphase	10916	1482		0.8108108108108109	0.8133333333333334	229	10687	17	15	212	10672	10916	0.19306343018379257
M1	cpdb	0	network_modules	102	TRUE	3.0020844526862286e-18	15	35	9	0.2571428571428571	0.6	GO:0006999	GO:BP	nuclear pore organization	16175	2614		0.4411764705882353	0.45714285714285713	15	16160	9	26	6	16134	16175	0.3919815609480779
M1	cpdb	0	network_modules	102	TRUE	3.319942441420177e-18	292	32	18	0.5625	0.06164383561643835	REAC:R-HSA-9694516	REAC	SARS-CoV-2 Infection	10916	2122		0.8243243243243243	0.8266666666666667	292	10624	18	14	274	10610	10916	0.1800409083378179
M1	cpdb	0	network_modules	102	TRUE	6.726438438513301e-18	363	33	20	0.6060606060606061	0.05509641873278237	KEGG:05014	KEGG	Amyotrophic lateral sclerosis	8484	413		1	1	363	8121	20	13	343	8108	8484	0.1739263402674633
M1	cpdb	0	network_modules	102	TRUE	1.2172622173969122e-16	288	32	17	0.53125	0.059027777777777776	REAC:R-HSA-71387	REAC	Metabolism of carbohydrates	10916	1422		0.8378378378378378	0.84	288	10628	17	15	271	10613	10916	0.1708043658921995
M1	cpdb	0	network_modules	102	TRUE	3.489139497197218e-16	459	32	19	0.59375	0.04139433551198257	REAC:R-HSA-9679506	REAC	SARS-CoV Infections	10916	2112		0.8513513513513513	0.8533333333333334	459	10457	19	13	440	10444	10916	0.14905227888016417
M1	cpdb	0	network_modules	102	TRUE	2.2652697483477757e-14	121	35	12	0.34285714285714286	0.09917355371900827	GO:0006997	GO:BP	nucleus organization	16175	2612		0.47058823529411764	0.4857142857142857	121	16054	12	23	109	16031	16175	0.18124866305597928
M1	cpdb	0	network_modules	102	TRUE	1.0350950755789781e-11	19	35	7	0.2	0.3684210526315789	GO:0006607	GO:BP	NLS-bearing protein import into nucleus	16175	2324		0.5	0.5142857142857142	19	16156	7	28	12	16128	16175	0.27030530817823595
M1	cpdb	0	network_modules	102	TRUE	2.4343856913890482e-11	10	35	6	0.17142857142857143	0.6	GO:0051292	GO:BP	nuclear pore complex assembly	16175	13624		0.5294117647058824	0.5428571428571428	10	16165	6	29	4	16136	16175	0.32000210285372027
M1	cpdb	0	network_modules	102	TRUE	3.143194180281067e-11	69	35	9	0.2571428571428571	0.13043478260869565	GO:0006406	GO:BP	mRNA export from nucleus	16175	2167		0.5588235294117647	0.5714285714285714	69	16106	9	26	60	16080	16175	0.1806830901861025
M1	cpdb	0	network_modules	102	TRUE	7.821683390445887e-11	76	35	9	0.2571428571428571	0.11842105263157894	GO:0051028	GO:BP	mRNA transport	16175	13445		0.5882352941176471	0.6	76	16099	9	26	67	16073	16175	0.17190391989602552
M1	cpdb	0	network_modules	102	TRUE	1.1627527034210376e-9	92	32	9	0.28125	0.09782608695652174	REAC:R-HSA-141444	REAC	Amplification  of signal from unattached  kinetochores via a MAD2  inhibitory signal	10916	143		0.8648648648648649	0.88	92	10824	9	23	83	10801	10916	0.16182135726179478
M1	cpdb	0	network_modules	102	TRUE	1.1627527034210376e-9	92	32	9	0.28125	0.09782608695652174	REAC:R-HSA-141424	REAC	Amplification of signal from the kinetochores	10916	144		0.8648648648648649	0.88	92	10824	9	23	83	10801	10916	0.16182135726179478
M1	cpdb	0	network_modules	102	TRUE	1.3161547931591054e-9	7	35	5	0.14285714285714285	0.7142857142857143	GO:0000972	GO:BP	transcription-dependent tethering of RNA polymerase II gene DNA at nuclear periphery	16175	277		0.6176470588235294	0.6285714285714286	7	16168	5	30	2	16138	16175	0.3188847145068542
M1	cpdb	0	network_modules	102	TRUE	3.1019680484042267e-9	19	35	6	0.17142857142857143	0.3157894736842105	GO:0046931	GO:BP	pore complex assembly	16175	12434		0.6470588235294118	0.6571428571428571	19	16156	6	29	13	16127	16175	0.2314621280095884
M1	cpdb	0	network_modules	102	TRUE	5.5238411443663005e-9	109	32	9	0.28125	0.08256880733944955	REAC:R-HSA-69618	REAC	Mitotic Spindle Checkpoint	10916	1486		0.8918918918918919	0.8933333333333333	109	10807	9	23	100	10784	10916	0.14793523939444841
M1	cpdb	0	network_modules	102	TRUE	9.00712271969868e-9	115	32	9	0.28125	0.0782608695652174	REAC:R-HSA-9648025	REAC	EML4 and NUDC in mitotic spindle formation	10916	817		0.9054054054054054	0.9066666666666666	115	10801	9	23	106	10778	10916	0.14377245061432595
M1	cpdb	0	network_modules	102	TRUE	1.659942143649058e-8	123	32	9	0.28125	0.07317073170731707	REAC:R-HSA-2500257	REAC	Resolution of Sister Chromatid Cohesion	10916	2079		0.918918918918919	0.92	123	10793	9	23	114	10770	10916	0.13869334892097962
M1	cpdb	0	network_modules	102	TRUE	4.118132668603529e-8	136	32	9	0.28125	0.0661764705882353	REAC:R-HSA-5663220	REAC	RHO GTPases Activate Formins	10916	1848		0.9324324324324325	0.9333333333333333	136	10780	9	23	127	10757	10916	0.1313955023902448
M1	cpdb	0	network_modules	102	TRUE	7.412044274471914e-7	188	32	9	0.28125	0.047872340425531915	REAC:R-HSA-2467813	REAC	Separation of Sister Chromatids	10916	2204		0.9459459459459459	0.9466666666666667	188	10728	9	23	179	10705	10916	0.11004117729730939
M1	cpdb	0	network_modules	102	TRUE	1.2239087772272736e-6	199	32	9	0.28125	0.04522613065326633	REAC:R-HSA-68877	REAC	Mitotic Prometaphase	10916	1484		0.9594594594594594	0.96	199	10717	9	23	190	10694	10916	0.10660305967602843
M1	cpdb	0	network_modules	102	TRUE	1.394215662251891e-6	545	35	12	0.34285714285714286	0.022018348623853212	GO:0051276	GO:BP	chromosome organization	16175	13613		0.6764705882352942	0.6857142857142857	545	15630	12	23	533	15607	16175	0.07978781257207701
M1	cpdb	0	network_modules	102	TRUE	3.127547173066379e-5	80	35	6	0.17142857142857143	0.075	GO:0046822	GO:BP	regulation of nucleocytoplasmic transport	16175	12379		0.7058823529411765	0.7142857142857143	80	16095	6	29	74	16066	16175	0.11051089279528997
M1	cpdb	0	network_modules	102	TRUE	3.132247848382887e-5	289	32	9	0.28125	0.031141868512110725	REAC:R-HSA-69620	REAC	Cell Cycle Checkpoints	10916	321		0.972972972972973	0.9733333333333334	289	10627	9	23	280	10604	10916	0.08604922633779287
M1	cpdb	0	network_modules	102	TRUE	6.619658099174301e-5	4	35	3	0.08571428571428572	0.75	GO:0006404	GO:BP	RNA import into nucleus	16175	2165		0.7352941176470589	0.7428571428571429	4	16171	3	32	1	16139	16175	0.25312003612333916
M1	cpdb	0	network_modules	102	TRUE	7.083884399611791e-5	318	32	9	0.28125	0.02830188679245283	REAC:R-HSA-195258	REAC	RHO GTPase Effectors	10916	1846		0.9864864864864865	0.9866666666666667	318	10598	9	23	309	10575	10916	0.08128742390290962
M1	cpdb	0	network_modules	102	TRUE	4.342773702941205e-4	124	35	6	0.17142857142857143	0.04838709677419355	GO:0007052	GO:BP	mitotic spindle organization	16175	2651		0.7647058823529411	0.7714285714285715	124	16051	6	29	118	16022	16175	0.08743370938164241
M1	cpdb	0	network_modules	102	TRUE	0.001500330981612772	153	35	6	0.17142857142857143	0.0392156862745098	GO:1902850	GO:BP	microtubule cytoskeleton organization involved in mitosis	16175	22560		0.7941176470588235	0.8	153	16022	6	29	147	15993	16175	0.07792122803186648
M1	cpdb	0	network_modules	102	TRUE	0.0024224014704259302	90	35	5	0.14285714285714285	0.05555555555555555	GO:0072006	GO:BP	nephron development	16175	17042		0.8235294117647058	0.8285714285714286	90	16085	5	30	85	16055	16175	0.08594946070170086
M1	cpdb	0	network_modules	102	TRUE	0.003399284766358546	176	35	6	0.17142857142857143	0.03409090909090909	GO:0007051	GO:BP	spindle organization	16175	2650		0.8529411764705882	0.8571428571428571	176	15999	6	29	170	15970	16175	0.07206552634664994
M1	cpdb	0	network_modules	102	TRUE	0.00596465043825604	48	35	4	0.11428571428571428	0.08333333333333333	GO:0006611	GO:BP	protein export from nucleus	16175	2326		0.8823529411764706	0.8857142857142857	48	16127	4	31	44	16096	16175	0.09530050452261996
M1	cpdb	0	network_modules	102	TRUE	0.005975097210313492	108	35	5	0.14285714285714285	0.046296296296296294	GO:0050000	GO:BP	chromosome localization	16175	13183		0.9117647058823529	0.9142857142857143	108	16067	5	30	103	16037	16175	0.07786838201512374
M1	cpdb	0	network_modules	102	TRUE	0.007407884034981109	15	35	3	0.08571428571428572	0.2	GO:0046823	GO:BP	negative regulation of nucleocytoplasmic transport	16175	12380		0.9411764705882353	0.9428571428571428	15	16160	3	32	12	16128	16175	0.12971468407795753
M1	cpdb	0	network_modules	102	TRUE	0.008122640014723953	2	35	2	0.05714285714285714	1	GO:0046832	GO:BP	negative regulation of RNA export from nucleus	16175	12389		0.9705882352941176	0.9714285714285714	2	16173	2	33	0	16140	16175	0.23880171837541012
M1	cpdb	0	network_modules	102	TRUE	0.008422817101874452	3	32	2	0.0625	0.6666666666666666	REAC:R-HSA-9636249	REAC	Inhibition of nitric oxide production	10916	1197		1	1	3	10913	2	30	1	10883	10916	0.20355307370907774
M1	cpdb	0	network_modules	102	TRUE	0.008907672289348407	53	35	4	0.11428571428571428	0.07547169811320754	GO:0006998	GO:BP	nuclear envelope organization	16175	2613		1	1	53	16122	4	31	49	16091	16175	0.09045603558120205
M1	cpdb	0	network_modules	103	TRUE	2.7393680293906583e-13	112	33	11	0.3333333333333333	0.09821428571428571	GO:0006820	GO:BP	monoatomic anion transport	16175	2497		0	0.02564102564102564	112	16063	11	22	101	16041	16175	0.177976417888186
M1	cpdb	0	network_modules	103	TRUE	8.316627599597257e-12	65	33	9	0.2727272727272727	0.13846153846153847	GO:0098656	GO:BP	monoatomic anion transmembrane transport	16175	18812		0.02631578947368421	0.05128205128205128	65	16110	9	24	56	16086	16175	0.19204363091519483
M1	cpdb	0	network_modules	103	TRUE	1.0993274243405838e-9	245	26	11	0.4230769230769231	0.044897959183673466	REAC:R-HSA-425407	REAC	SLC-mediated transmembrane transport	10916	2146		0	0.25	245	10671	11	15	234	10656	10916	0.1321591284670722
M1	cpdb	0	network_modules	103	TRUE	1.3514209900678215e-9	326	33	12	0.36363636363636365	0.03680981595092025	GO:0015711	GO:BP	organic anion transport	16175	4831		0.05263157894736842	0.07692307692307693	326	15849	12	21	314	15828	16175	0.1105138198725656
M1	cpdb	0	network_modules	103	TRUE	2.8444659989177704e-9	182	33	10	0.30303030303030304	0.054945054945054944	GO:0098739	GO:BP	import across plasma membrane	16175	18866		0.07894736842105263	0.10256410256410256	182	15993	10	23	172	15970	16175	0.12507629857063934
M1	cpdb	0	network_modules	103	TRUE	2.4906047669303624e-8	105	26	8	0.3076923076923077	0.0761904761904762	REAC:R-HSA-425393	REAC	Transport of inorganic cations/anions and amino acids/oligopeptides	10916	2596		0.3333333333333333	0.5	105	10811	8	18	97	10793	10916	0.14922167095884586
M1	cpdb	0	network_modules	103	TRUE	3.874221447429813e-8	30	33	6	0.18181818181818182	0.2	GO:0006884	GO:BP	cell volume homeostasis	16175	2540		0.10526315789473684	0.1282051282051282	30	16145	6	27	24	16118	16175	0.1891155712171076
M1	cpdb	0	network_modules	103	TRUE	1.0664277326071995e-6	26	26	5	0.19230769230769232	0.19230769230769232	REAC:R-HSA-5223345	REAC	Miscellaneous transport and binding events	10916	1456		0.6666666666666666	0.75	26	10890	5	21	21	10869	10916	0.19037931765204494
M1	cpdb	0	network_modules	103	TRUE	1.3721677619488357e-6	98	33	7	0.21212121212121213	0.07142857142857142	GO:0006865	GO:BP	amino acid transport	16175	2527		0.13157894736842105	0.15384615384615385	98	16077	7	26	91	16051	16175	0.12006210830953637
M1	cpdb	0	network_modules	103	TRUE	1.7173021528742035e-6	248	33	9	0.2727272727272727	0.036290322580645164	GO:0046942	GO:BP	carboxylic acid transport	16175	12438		0.15789473684210525	0.1794871794871795	248	15927	9	24	239	15903	16175	0.09471740971851182
M1	cpdb	0	network_modules	103	TRUE	1.7792961284872921e-6	249	33	9	0.2727272727272727	0.03614457831325301	GO:0015849	GO:BP	organic acid transport	16175	4958		0.18421052631578946	0.20512820512820512	249	15926	9	24	240	15902	16175	0.09450728522454717
M1	cpdb	0	network_modules	103	TRUE	4.527569911302502e-6	10	33	4	0.12121212121212122	0.4	GO:0055081	GO:BP	monoatomic anion homeostasis	16175	14234		0.21052631578947367	0.2564102564102564	10	16165	4	29	6	16136	16175	0.21936130101981535
M1	cpdb	0	network_modules	103	TRUE	4.527569911302502e-6	10	33	4	0.12121212121212122	0.4	GO:0055064	GO:BP	chloride ion homeostasis	16175	14227		0.21052631578947367	0.2564102564102564	10	16165	4	29	6	16136	16175	0.21936130101981535
M1	cpdb	0	network_modules	103	TRUE	4.6591304499308e-6	64	33	6	0.18181818181818182	0.09375	GO:1901264	GO:BP	carbohydrate derivative transport	16175	21340		0.2631578947368421	0.28205128205128205	64	16111	6	27	58	16084	16175	0.12810120093361899
M1	cpdb	0	network_modules	103	TRUE	5.683166232411654e-6	671	33	12	0.36363636363636365	0.01788375558867362	GO:0034220	GO:BP	monoatomic ion transmembrane transport	16175	8508		0.2894736842105263	0.3076923076923077	671	15504	12	21	659	15483	16175	0.07304678032640909
M1	cpdb	0	network_modules	103	TRUE	6.174973025432017e-6	67	33	6	0.18181818181818182	0.08955223880597014	GO:0098661	GO:BP	inorganic anion transmembrane transport	16175	18817		0.3157894736842105	0.3333333333333333	67	16108	6	27	61	16081	16175	0.12508150923507516
M1	cpdb	0	network_modules	103	TRUE	9.598369890997079e-6	72	33	6	0.18181818181818182	0.08333333333333333	GO:0003333	GO:BP	amino acid transmembrane transport	16175	1753		0.34210526315789475	0.358974358974359	72	16103	6	27	66	16076	16175	0.12046903748163526
M1	cpdb	0	network_modules	103	TRUE	4.682574559868202e-5	4	33	3	0.09090909090909091	0.75	GO:0140157	GO:BP	ammonium import across plasma membrane	16175	19684		0.3684210526315789	0.38461538461538464	4	16171	3	30	1	16141	16175	0.2607044656113692
M1	cpdb	0	network_modules	103	TRUE	1.1490570971869995e-4	54	33	5	0.15151515151515152	0.09259259259259259	GO:1902476	GO:BP	chloride transmembrane transport	16175	22306		0.39473684210526316	0.41025641025641024	54	16121	5	28	49	16093	16175	0.11614741228055189
M1	cpdb	0	network_modules	103	TRUE	1.1690150017111401e-4	5	33	3	0.09090909090909091	0.6	GO:0140361	GO:BP	cyclic-GMP-AMP transmembrane import across plasma membrane	16175	19752		0.42105263157894735	0.4358974358974359	5	16170	3	30	2	16140	16175	0.23302935797773947
M1	cpdb	0	network_modules	103	TRUE	1.1797126853139903e-4	109	33	6	0.18181818181818182	0.05504587155963303	GO:1903825	GO:BP	organic acid transmembrane transport	16175	23308		0.4473684210526316	0.46153846153846156	109	16066	6	27	103	16039	16175	0.09675880049119187
M1	cpdb	0	network_modules	103	TRUE	1.3724605652272112e-4	7	26	3	0.11538461538461539	0.42857142857142855	REAC:R-HSA-426117	REAC	Cation-coupled Chloride cotransporters	10916	318		1	1	7	10909	3	23	4	10886	10916	0.22147377783952463
M1	cpdb	0	network_modules	103	TRUE	1.6251253843059958e-4	115	33	6	0.18181818181818182	0.05217391304347826	GO:0015698	GO:BP	inorganic anion transport	16175	4818		0.47368421052631576	0.48717948717948717	115	16060	6	27	109	16033	16175	0.09401881960044109
M1	cpdb	0	network_modules	103	TRUE	1.987192507449626e-4	740	33	11	0.3333333333333333	0.014864864864864866	GO:0098657	GO:BP	import into cell	16175	18813		0.5	0.5128205128205128	740	15435	11	22	729	15413	16175	0.062232565915726075
M1	cpdb	0	network_modules	103	TRUE	2.2007428988482687e-4	121	33	6	0.18181818181818182	0.049586776859504134	GO:0008361	GO:BP	regulation of cell size	16175	3180		0.5263157894736842	0.5384615384615384	121	16054	6	27	115	16027	16175	0.09148061837219655
M1	cpdb	0	network_modules	103	TRUE	2.2453673269735917e-4	24	33	4	0.12121212121212122	0.16666666666666666	GO:0055075	GO:BP	potassium ion homeostasis	16175	14231		0.5526315789473685	0.5897435897435898	24	16151	4	29	20	16122	16175	0.14064174805694146
M1	cpdb	0	network_modules	103	TRUE	2.2453673269735917e-4	24	33	4	0.12121212121212122	0.16666666666666666	GO:0015868	GO:BP	purine ribonucleotide transport	16175	4976		0.5526315789473685	0.5897435897435898	24	16151	4	29	20	16122	16175	0.14064174805694146
M1	cpdb	0	network_modules	103	TRUE	2.334777399978559e-4	6	33	3	0.09090909090909091	0.5	GO:1903790	GO:BP	guanine nucleotide transmembrane transport	16175	23281		0.6052631578947368	0.6153846153846154	6	16169	3	30	3	16139	16175	0.21258713991329356
M1	cpdb	0	network_modules	103	TRUE	3.1500102717293407e-4	26	33	4	0.12121212121212122	0.15384615384615385	GO:0051503	GO:BP	adenine nucleotide transport	16175	13755		0.631578947368421	0.6410256410256411	26	16149	4	29	22	16120	16175	0.13499303177641242
M1	cpdb	0	network_modules	103	TRUE	3.69253398833742e-4	27	33	4	0.12121212121212122	0.14814814814814814	GO:0072530	GO:BP	purine-containing compound transmembrane transport	16175	17432		0.6578947368421053	0.6923076923076923	27	16148	4	29	23	16119	16175	0.13240520091052038
M1	cpdb	0	network_modules	103	TRUE	3.69253398833742e-4	27	33	4	0.12121212121212122	0.14814814814814814	GO:0015865	GO:BP	purine nucleotide transport	16175	4973		0.6578947368421053	0.6923076923076923	27	16148	4	29	23	16119	16175	0.13240520091052038
M1	cpdb	0	network_modules	103	TRUE	4.0801765600043366e-4	7	33	3	0.09090909090909091	0.42857142857142855	GO:0001408	GO:BP	guanine nucleotide transport	16175	316		0.7105263157894737	0.717948717948718	7	16168	3	30	4	16138	16175	0.19668913305087454
M1	cpdb	0	network_modules	103	TRUE	4.20301242344856e-4	623	33	10	0.30303030303030304	0.016051364365971106	GO:0019725	GO:BP	cellular homeostasis	16175	6020		0.7368421052631579	0.7435897435897436	623	15552	10	23	613	15529	16175	0.06214901152698007
M1	cpdb	0	network_modules	103	TRUE	6.519201318929016e-4	8	33	3	0.09090909090909091	0.375	GO:0070729	GO:BP	cyclic nucleotide transport	16175	16277		0.7631578947368421	0.7692307692307693	8	16167	3	30	5	16137	16175	0.18386580285820447
M1	cpdb	0	network_modules	103	TRUE	8.535770791010962e-4	33	33	4	0.12121212121212122	0.12121212121212122	GO:0006862	GO:BP	nucleotide transport	16175	2524		0.7894736842105263	0.7948717948717948	33	16142	4	29	29	16113	16175	0.11941556564279894
M1	cpdb	0	network_modules	103	TRUE	9.765199754818417e-4	9	33	3	0.09090909090909091	0.3333333333333333	GO:0034214	GO:BP	protein hexamerization	16175	8506		0.8157894736842105	0.8205128205128205	9	16166	3	30	6	16136	16175	0.17323716536333697
M1	cpdb	0	network_modules	103	TRUE	0.0011395894653025585	85	33	5	0.15151515151515152	0.058823529411764705	GO:0006821	GO:BP	chloride transport	16175	2498		0.8421052631578947	0.8461538461538461	85	16090	5	28	80	16062	16175	0.09146628772096765
M1	cpdb	0	network_modules	103	TRUE	0.0018823757531302432	94	33	5	0.15151515151515152	0.05319148936170213	GO:0015695	GO:BP	organic cation transport	16175	4816		0.868421052631579	0.8717948717948718	94	16081	5	28	89	16053	16175	0.08667079046256691
M1	cpdb	0	network_modules	103	TRUE	0.0019128320005597909	11	33	3	0.09090909090909091	0.2727272727272727	GO:0072488	GO:BP	ammonium transmembrane transport	16175	17412		0.8947368421052632	0.8974358974358975	11	16164	3	30	8	16134	16175	0.1564941503252175
M1	cpdb	0	network_modules	103	TRUE	0.003577767020307057	107	33	5	0.15151515151515152	0.04672897196261682	GO:1905039	GO:BP	carboxylic acid transmembrane transport	16175	24314		0.9210526315789473	0.9230769230769231	107	16068	5	28	102	16040	16175	0.08081987733061459
M1	cpdb	0	network_modules	103	TRUE	0.005495316338931295	52	33	4	0.12121212121212122	0.07692307692307693	GO:0006970	GO:BP	response to osmotic stress	16175	2597		0.9473684210526315	0.9487179487179487	52	16123	4	29	48	16094	16175	0.09424753455312618
M1	cpdb	0	network_modules	103	TRUE	0.008637593201948821	128	33	5	0.15151515151515152	0.0390625	GO:0015748	GO:BP	organophosphate ester transport	16175	4867		0.9736842105263158	0.9743589743589743	128	16047	5	28	123	16019	16175	0.07327912459580117
M1	cpdb	0	network_modules	103	TRUE	0.009368121509167207	18	33	3	0.09090909090909091	0.16666666666666666	GO:1901679	GO:BP	nucleotide transmembrane transport	16175	21640		1	1	18	16157	3	30	15	16127	16175	0.12177670909042501
M1	cpdb	0	network_modules	104	TRUE	4.683326983675418e-19	23	33	10	0.30303030303030304	0.43478260869565216	GO:1902455	GO:BP	negative regulation of stem cell population maintenance	16175	22293		0	0.037037037037037035	23	16152	10	23	13	16129	16175	0.3619002520848311
M1	cpdb	0	network_modules	104	TRUE	4.483523677206586e-16	41	33	10	0.30303030303030304	0.24390243902439024	GO:1902459	GO:BP	positive regulation of stem cell population maintenance	16175	22297		0.038461538461538464	0.07407407407407407	41	16134	10	23	31	16111	16175	0.27020765289590926
M1	cpdb	0	network_modules	104	TRUE	2.4546784631369362e-14	59	33	10	0.30303030303030304	0.1694915254237288	GO:2000036	GO:BP	regulation of stem cell population maintenance	16175	25399		0.07692307692307693	0.1111111111111111	59	16116	10	23	49	16093	16175	0.22454048248590708
M1	cpdb	0	network_modules	104	TRUE	9.211567855141603e-13	83	33	10	0.30303030303030304	0.12048192771084337	GO:0030512	GO:BP	negative regulation of transforming growth factor beta receptor signaling pathway	16175	6828		0.11538461538461539	0.14814814814814814	83	16092	10	23	73	16069	16175	0.1885156757811119
M1	cpdb	0	network_modules	104	TRUE	5.778709464873881e-12	99	33	10	0.30303030303030304	0.10101010101010101	GO:0019827	GO:BP	stem cell population maintenance	16175	6046		0.15384615384615385	0.18518518518518517	99	16076	10	23	89	16053	16175	0.17212360999860157
M1	cpdb	0	network_modules	104	TRUE	6.412449167623619e-12	100	33	10	0.30303030303030304	0.1	GO:0098727	GO:BP	maintenance of cell number	16175	18856		0.19230769230769232	0.2222222222222222	100	16075	10	23	90	16052	16175	0.1712304946632892
M1	cpdb	0	network_modules	104	TRUE	5.393546748808199e-11	123	33	10	0.30303030303030304	0.08130081300813008	GO:0017015	GO:BP	regulation of transforming growth factor beta receptor signaling pathway	16175	5276		0.23076923076923078	0.25925925925925924	123	16052	10	23	113	16029	16175	0.15376381108737258
M1	cpdb	0	network_modules	104	TRUE	6.360237821907723e-11	125	33	10	0.30303030303030304	0.08	GO:1903844	GO:BP	regulation of cellular response to transforming growth factor beta stimulus	16175	23323		0.2692307692307692	0.2962962962962963	125	16050	10	23	115	16027	16175	0.15247440008237778
M1	cpdb	0	network_modules	104	TRUE	6.899550897655948e-11	126	33	10	0.30303030303030304	0.07936507936507936	GO:0090101	GO:BP	negative regulation of transmembrane receptor protein serine/threonine kinase signaling pathway	16175	18019		0.3076923076923077	0.3333333333333333	126	16049	10	23	116	16026	16175	0.15184107320967113
M1	cpdb	0	network_modules	104	TRUE	7.463739656744059e-10	791	33	16	0.48484848484848486	0.020227560050568902	GO:0000122	GO:BP	negative regulation of transcription by RNA polymerase II	16175	48		0.34615384615384615	0.37037037037037035	791	15384	16	17	775	15367	16175	0.0913970683371759
M1	cpdb	0	network_modules	104	TRUE	1.8377498934680713e-9	247	33	11	0.3333333333333333	0.044534412955465584	GO:0030336	GO:BP	negative regulation of cell migration	16175	6782		0.38461538461538464	0.4074074074074074	247	15928	11	22	236	15906	16175	0.11727526946567245
M1	cpdb	0	network_modules	104	TRUE	2.0324354461112546e-9	176	33	10	0.30303030303030304	0.056818181818181816	GO:0007179	GO:BP	transforming growth factor beta receptor signaling pathway	16175	2741		0.4230769230769231	0.4444444444444444	176	15999	10	23	166	15976	16175	0.12732823099049495
M1	cpdb	0	network_modules	104	TRUE	3.0827854918948402e-9	259	33	11	0.3333333333333333	0.04247104247104247	GO:2000146	GO:BP	negative regulation of cell motility	16175	25494		0.46153846153846156	0.48148148148148145	259	15916	11	22	248	15894	16175	0.11430217955252035
M1	cpdb	0	network_modules	104	TRUE	8.062344001341247e-9	202	33	10	0.30303030303030304	0.04950495049504951	GO:0071560	GO:BP	cellular response to transforming growth factor beta stimulus	16175	16762		0.5	0.5185185185185185	202	15973	10	23	192	15950	16175	0.11829391957389494
M1	cpdb	0	network_modules	104	TRUE	8.075133314698347e-9	283	33	11	0.3333333333333333	0.038869257950530034	GO:0040013	GO:BP	negative regulation of locomotion	16175	9901		0.5384615384615384	0.5555555555555556	283	15892	11	22	272	15870	16175	0.1089189306876186
M1	cpdb	0	network_modules	104	TRUE	1.0790914812525547e-8	208	33	10	0.30303030303030304	0.04807692307692308	GO:0071559	GO:BP	response to transforming growth factor beta	16175	16761		0.5769230769230769	0.5925925925925926	208	15967	10	23	198	15944	16175	0.11644831065875187
M1	cpdb	0	network_modules	104	TRUE	1.644119070183128e-8	217	33	10	0.30303030303030304	0.04608294930875576	GO:0090092	GO:BP	regulation of transmembrane receptor protein serine/threonine kinase signaling pathway	16175	18013		0.6153846153846154	0.6296296296296297	217	15958	10	23	207	15935	16175	0.11382138060777153
M1	cpdb	0	network_modules	104	TRUE	8.42726592826999e-8	256	33	10	0.30303030303030304	0.0390625	GO:0090287	GO:BP	regulation of cellular response to growth factor stimulus	16175	18171		0.6538461538461539	0.6666666666666666	256	15919	10	23	246	15896	16175	0.10404813623552654
M1	cpdb	0	network_modules	104	TRUE	1.70299061936616e-7	275	33	10	0.30303030303030304	0.03636363636363636	GO:0141091	GO:BP	transforming growth factor beta receptor superfamily signaling pathway	16175	20020		0.6923076923076923	0.7037037037037037	275	15900	10	23	265	15877	16175	0.10003854767496101
M1	cpdb	0	network_modules	104	TRUE	2.864760715991517e-7	290	33	10	0.30303030303030304	0.034482758620689655	GO:0007178	GO:BP	cell surface receptor protein serine/threonine kinase signaling pathway	16175	2740		0.7307692307692307	0.7407407407407407	290	15885	10	23	280	15862	16175	0.09714698571267735
M1	cpdb	0	network_modules	104	TRUE	2.7395974512300124e-6	94	19	6	0.3157894736842105	0.06382978723404255	REAC:R-HSA-3214815	REAC	HDACs deacetylate histones	10916	1092		0	0.14285714285714285	94	10822	6	13	88	10809	10916	0.13882242852072355
M1	cpdb	0	network_modules	104	TRUE	5.354108664837719e-6	105	19	6	0.3157894736842105	0.05714285714285714	REAC:R-HSA-427413	REAC	NoRC negatively regulates rRNA expression	10916	1602		0.16666666666666666	0.2857142857142857	105	10811	6	13	99	10798	10916	0.13098534411708065
M1	cpdb	0	network_modules	104	TRUE	6.346580878737577e-6	108	19	6	0.3157894736842105	0.05555555555555555	REAC:R-HSA-5250941	REAC	Negative epigenetic regulation of rRNA expression	10916	1566		0.3333333333333333	0.42857142857142855	108	10808	6	13	102	10795	10916	0.1290552673332082
M1	cpdb	0	network_modules	104	TRUE	3.784754472956149e-5	795	33	12	0.36363636363636365	0.01509433962264151	GO:0051241	GO:BP	negative regulation of multicellular organismal process	16175	13591		0.7692307692307693	0.7777777777777778	795	15380	12	21	783	15359	16175	0.06577529147885096
M1	cpdb	0	network_modules	104	TRUE	4.541196399488196e-5	150	19	6	0.3157894736842105	0.04	REAC:R-HSA-9679191	REAC	Potential therapeutics for SARS	10916	1782		0.5	0.5714285714285714	150	10766	6	13	144	10753	10916	0.1083403546613544
M1	cpdb	0	network_modules	104	TRUE	5.5952350189168186e-5	502	33	10	0.30303030303030304	0.0199203187250996	GO:0071363	GO:BP	cellular response to growth factor stimulus	16175	16615		0.8076923076923077	0.8148148148148148	502	15673	10	23	492	15650	16175	0.0709177895921941
M1	cpdb	0	network_modules	104	TRUE	6.68763441050784e-5	271	19	7	0.3684210526315789	0.025830258302583026	REAC:R-HSA-3247509	REAC	Chromatin modifying enzymes	10916	355		0.6666666666666666	0.8571428571428571	271	10645	7	12	264	10633	10916	0.09220964433601349
M1	cpdb	0	network_modules	104	TRUE	6.68763441050784e-5	271	19	7	0.3684210526315789	0.025830258302583026	REAC:R-HSA-4839726	REAC	Chromatin organization	10916	356		0.6666666666666666	0.8571428571428571	271	10645	7	12	264	10633	10916	0.09220964433601349
M1	cpdb	0	network_modules	104	TRUE	7.655428187635296e-5	519	33	10	0.30303030303030304	0.019267822736030827	GO:0070848	GO:BP	response to growth factor	16175	16340		0.8461538461538461	0.8518518518518519	519	15656	10	23	509	15633	16175	0.06951485791822312
M1	cpdb	0	network_modules	104	TRUE	1.5717229628605994e-4	185	19	6	0.3157894736842105	0.032432432432432434	REAC:R-HSA-212165	REAC	Epigenetic regulation of gene expression	10916	852		1	1	185	10731	6	13	179	10718	10916	0.09667681657539276
M1	cpdb	0	network_modules	104	TRUE	3.423848291369964e-4	781	33	11	0.3333333333333333	0.014084507042253521	GO:0030334	GO:BP	regulation of cell migration	16175	6780		0.8846153846153846	0.8888888888888888	781	15394	11	22	770	15372	16175	0.06012301705460442
M1	cpdb	0	network_modules	104	TRUE	3.8418222431996923e-4	790	33	11	0.3333333333333333	0.013924050632911392	GO:0007167	GO:BP	enzyme-linked receptor protein signaling pathway	16175	2731		0.9230769230769231	0.9259259259259259	790	15385	11	22	779	15363	16175	0.059680322151435795
M1	cpdb	0	network_modules	104	TRUE	3.8431848339585766e-4	617	33	10	0.30303030303030304	0.01620745542949757	GO:0051093	GO:BP	negative regulation of developmental process	16175	13488		0.9615384615384616	0.9629629629629629	617	15558	10	23	607	15535	16175	0.06252598122077158
M1	cpdb	0	network_modules	104	TRUE	4.0801765600043366e-4	7	33	3	0.09090909090909091	0.42857142857142855	GO:0006776	GO:BP	vitamin A metabolic process	16175	2462		1	1	7	16168	3	30	4	16138	16175	0.19668913305087454
M1	cpdb	0	network_modules	104	TRUE	0.007751467575665787	24	7	2	0.2857142857142857	0.08333333333333333	KEGG:04977	KEGG	Vitamin digestion and absorption	8484	408		NA	1	24	8460	2	5	22	8455	8484	0.15305529817397903
M1	cpdb	0	network_modules	105	TRUE	4.012852895567513e-38	55	25	19	0.76	0.34545454545454546	REAC:R-HSA-9639288	REAC	Amino acids regulate mTORC1	10916	142		0	0.07692307692307693	55	10861	19	6	36	10855	10916	0.5108674349843418
M1	cpdb	0	network_modules	105	TRUE	5.79125871295195e-36	92	30	20	0.6666666666666666	0.21739130434782608	GO:1903432	GO:BP	regulation of TORC1 signaling	16175	23003		0	0.037037037037037035	92	16083	20	10	72	16073	16175	0.3788750687534524
M1	cpdb	0	network_modules	105	TRUE	1.883406934930016e-35	97	30	20	0.6666666666666666	0.20618556701030927	GO:0038202	GO:BP	TORC1 signaling	16175	9766		0.038461538461538464	0.07407407407407407	97	16078	20	10	77	16068	16175	0.36886584196233557
M1	cpdb	0	network_modules	105	TRUE	6.494334622372804e-32	141	30	20	0.6666666666666666	0.14184397163120568	GO:0032006	GO:BP	regulation of TOR signaling	16175	7313		0.07692307692307693	0.1111111111111111	141	16034	20	10	121	16024	16175	0.30510404415865927
M1	cpdb	0	network_modules	105	TRUE	7.344636658858499e-31	158	30	20	0.6666666666666666	0.12658227848101267	GO:0031929	GO:BP	TOR signaling	16175	7288		0.11538461538461539	0.14814814814814814	158	16017	20	10	138	16007	16175	0.2879154927047317
M1	cpdb	0	network_modules	105	TRUE	1.8891700193707833e-28	157	25	19	0.76	0.12101910828025478	REAC:R-HSA-9711097	REAC	Cellular response to starvation	10916	337		0.08333333333333333	0.15384615384615385	157	10759	19	6	138	10753	10916	0.3000405350841213
M1	cpdb	0	network_modules	105	TRUE	1.5327303092230124e-27	155	21	18	0.8571428571428571	0.11612903225806452	KEGG:04150	KEGG	mTOR signaling pathway	8484	284		NA	1	155	8329	18	3	137	8326	8484	0.3120198060988725
M1	cpdb	0	network_modules	105	TRUE	3.8159553397006e-25	52	30	14	0.4666666666666667	0.2692307692307692	GO:1904263	GO:BP	positive regulation of TORC1 signaling	16175	23657		0.15384615384615385	0.18518518518518517	52	16123	14	16	38	16107	16175	0.35291156749411134
M1	cpdb	0	network_modules	105	TRUE	2.093093725595409e-23	46	30	13	0.43333333333333335	0.2826086956521739	GO:0034198	GO:BP	cellular response to amino acid starvation	16175	8499		0.19230769230769232	0.2222222222222222	46	16129	13	17	33	16112	16175	0.3484702895547968
M1	cpdb	0	network_modules	105	TRUE	3.960322257163892e-23	48	30	13	0.43333333333333335	0.2708333333333333	GO:1990928	GO:BP	response to amino acid starvation	16175	25341		0.23076923076923078	0.25925925925925924	48	16127	13	17	35	16110	16175	0.34105641520204016
M1	cpdb	0	network_modules	105	TRUE	4.0998380737584645e-23	70	30	14	0.4666666666666667	0.2	GO:0032008	GO:BP	positive regulation of TOR signaling	16175	7315		0.2692307692307692	0.2962962962962963	70	16105	14	16	56	16089	16175	0.3036106749246347
M1	cpdb	0	network_modules	105	TRUE	1.0353871038401559e-21	40	30	12	0.4	0.3	GO:0071230	GO:BP	cellular response to amino acid stimulus	16175	16492		0.3076923076923077	0.3333333333333333	40	16135	12	18	28	16117	16175	0.34501509377564715
M1	cpdb	0	network_modules	105	TRUE	3.89257221299618e-21	44	30	12	0.4	0.2727272727272727	GO:0071229	GO:BP	cellular response to acid chemical	16175	16491		0.34615384615384615	0.37037037037037035	44	16131	12	18	32	16113	16175	0.32879510256467626
M1	cpdb	0	network_modules	105	TRUE	7.166701480660087e-21	46	30	12	0.4	0.2608695652173913	GO:0043200	GO:BP	response to amino acid	16175	10574		0.38461538461538464	0.4074074074074074	46	16129	12	18	34	16111	16175	0.32148780106273694
M1	cpdb	0	network_modules	105	TRUE	2.908952742687988e-20	51	30	12	0.4	0.23529411764705882	GO:0001101	GO:BP	response to acid chemical	16175	287		0.4230769230769231	0.4444444444444444	51	16124	12	18	39	16106	16175	0.3051318172811205
M1	cpdb	0	network_modules	105	TRUE	9.776415177238619e-19	187	30	15	0.5	0.08021390374331551	GO:0031669	GO:BP	cellular response to nutrient levels	16175	7272		0.46153846153846156	0.48148148148148145	187	15988	15	15	172	15973	16175	0.19696012310585606
M1	cpdb	0	network_modules	105	TRUE	1.0492964022995927e-18	138	30	14	0.4666666666666667	0.10144927536231885	GO:0009267	GO:BP	cellular response to starvation	16175	3432		0.5	0.5185185185185185	138	16037	14	16	124	16021	16175	0.21472283810925463
M1	cpdb	0	network_modules	105	TRUE	1.5878373086859158e-18	45	30	11	0.36666666666666664	0.24444444444444444	GO:1904262	GO:BP	negative regulation of TORC1 signaling	16175	23656		0.5384615384615384	0.5555555555555556	45	16130	11	19	34	16111	16175	0.29780097980449943
M1	cpdb	0	network_modules	105	TRUE	8.202695871025226e-18	159	30	14	0.4666666666666667	0.0880503144654088	GO:0042594	GO:BP	response to starvation	16175	10254		0.5769230769230769	0.5925925925925926	159	16016	14	16	145	16000	16175	0.19960493224215797
M1	cpdb	0	network_modules	105	TRUE	1.7039305138489303e-16	262	30	15	0.5	0.05725190839694656	GO:0031667	GO:BP	response to nutrient levels	16175	7271		0.6153846153846154	0.6296296296296297	262	15913	15	15	247	15898	16175	0.1652064585004853
M1	cpdb	0	network_modules	105	TRUE	1.9629794910591238e-16	67	30	11	0.36666666666666664	0.16417910447761194	GO:0032007	GO:BP	negative regulation of TOR signaling	16175	7314		0.6538461538461539	0.6666666666666666	67	16108	11	19	56	16089	16175	0.243312829279352
M1	cpdb	0	network_modules	105	TRUE	5.49278751328248e-14	24	25	8	0.32	0.3333333333333333	REAC:R-HSA-166208	REAC	mTORC1-mediated signalling	10916	2711		0.16666666666666666	0.23076923076923078	24	10892	8	17	16	10875	10916	0.32508431136812477
M1	cpdb	0	network_modules	105	TRUE	3.183375129901354e-13	29	25	8	0.32	0.27586206896551724	REAC:R-HSA-380972	REAC	Energy dependent regulation of mTOR by LKB1-AMPK	10916	843		0.25	0.3076923076923077	29	10887	8	17	21	10870	10916	0.29537650185340414
M1	cpdb	0	network_modules	105	TRUE	6.969457794863948e-12	41	25	8	0.32	0.1951219512195122	REAC:R-HSA-165159	REAC	MTOR signalling	10916	1387		0.3333333333333333	0.38461538461538464	41	10875	8	17	33	10858	10916	0.24769397801759174
M1	cpdb	0	network_modules	105	TRUE	1.5774948869200915e-10	59	25	8	0.32	0.13559322033898305	REAC:R-HSA-8943724	REAC	Regulation of PTEN gene transcription	10916	1999		0.4166666666666667	0.46153846153846156	59	10857	8	17	51	10840	10916	0.20557517442438816
M1	cpdb	0	network_modules	105	TRUE	2.9952617822827926e-9	84	25	8	0.32	0.09523809523809523	REAC:R-HSA-5628897	REAC	TP53 Regulates Metabolic Genes	10916	2452		0.5	0.5384615384615384	84	10832	8	17	76	10815	10916	0.17123180911219185
M1	cpdb	0	network_modules	105	TRUE	1.3351319768228405e-7	134	25	8	0.32	0.05970149253731343	REAC:R-HSA-1632852	REAC	Macroautophagy	10916	1388		0.5833333333333334	0.6153846153846154	134	10782	8	17	126	10765	10916	0.13389352677333508
M1	cpdb	0	network_modules	105	TRUE	1.6905245942238256e-7	138	25	8	0.32	0.057971014492753624	REAC:R-HSA-6807070	REAC	PTEN Regulation	10916	1703		0.6666666666666666	0.6923076923076923	138	10778	8	17	130	10761	10916	0.13180611226945402
M1	cpdb	0	network_modules	105	TRUE	3.122766579895739e-7	149	25	8	0.32	0.053691275167785234	REAC:R-HSA-9612973	REAC	Autophagy	10916	193		0.75	0.7692307692307693	149	10767	8	17	141	10750	10916	0.1264962024711435
M1	cpdb	0	network_modules	105	TRUE	8.713535148327521e-7	253	25	9	0.36	0.03557312252964427	REAC:R-HSA-1257604	REAC	PIP3 activates AKT signaling	10916	1679		0.8333333333333334	0.8461538461538461	253	10663	9	16	244	10647	10916	0.10725102276955943
M1	cpdb	0	network_modules	105	TRUE	2.896568482541044e-6	551	30	11	0.36666666666666664	0.019963702359346643	GO:1902532	GO:BP	negative regulation of intracellular signal transduction	16175	22341		0.6923076923076923	0.7037037037037037	551	15624	11	19	540	15605	16175	0.079038467244652
M1	cpdb	0	network_modules	105	TRUE	3.156146263441344e-6	293	25	9	0.36	0.030716723549488054	REAC:R-HSA-9006925	REAC	Intracellular signaling by second messengers	10916	1266		0.9166666666666666	0.9230769230769231	293	10623	9	16	284	10607	10916	0.09876279364985552
M1	cpdb	0	network_modules	105	TRUE	6.752812079790973e-6	324	30	9	0.3	0.027777777777777776	GO:0010506	GO:BP	regulation of autophagy	16175	4181		0.7307692307692307	0.7407407407407407	324	15851	9	21	315	15830	16175	0.08613806997833964
M1	cpdb	0	network_modules	105	TRUE	6.130577244170153e-5	53	30	5	0.16666666666666666	0.09433962264150944	GO:0061462	GO:BP	protein localization to lysosome	16175	15493		0.7692307692307693	0.7777777777777778	53	16122	5	25	48	16097	16175	0.12324348918973815
M1	cpdb	0	network_modules	105	TRUE	2.4244981937400088e-4	491	30	9	0.3	0.018329938900203666	GO:0061919	GO:BP	process utilizing autophagic mechanism	16175	15723		0.8076923076923077	0.8518518518518519	491	15684	9	21	482	15663	16175	0.0677498466634358
M1	cpdb	0	network_modules	105	TRUE	2.4244981937400088e-4	491	30	9	0.3	0.018329938900203666	GO:0006914	GO:BP	autophagy	16175	2563		0.8076923076923077	0.8518518518518519	491	15684	9	21	482	15663	16175	0.0677498466634358
M1	cpdb	0	network_modules	105	TRUE	2.9528993704501803e-4	359	25	8	0.32	0.022284122562674095	REAC:R-HSA-3700989	REAC	Transcriptional Regulation by TP53	10916	2546		1	1	359	10557	8	17	351	10540	10916	0.07713194112443969
M1	cpdb	0	network_modules	105	TRUE	4.366837306142062e-4	78	30	5	0.16666666666666666	0.0641025641025641	GO:0072665	GO:BP	protein localization to vacuole	16175	17485		0.8846153846153846	0.8888888888888888	78	16097	5	25	73	16072	16175	0.10070796555004742
M1	cpdb	0	network_modules	105	TRUE	0.0010071372341564253	10	30	3	0.1	0.3	GO:1990253	GO:BP	cellular response to leucine starvation	16175	25122		0.9230769230769231	0.9259259259259259	10	16165	3	27	7	16138	16175	0.17234739749830705
M1	cpdb	0	network_modules	105	TRUE	0.0048904476213216894	2	30	2	0.06666666666666667	1	GO:1903577	GO:BP	cellular response to L-arginine	16175	23120		0.9615384615384616	0.9629629629629629	2	16173	2	28	0	16145	16175	0.2579752855695965
M1	cpdb	0	network_modules	105	TRUE	0.009450928211875787	145	30	5	0.16666666666666666	0.034482758620689655	GO:0010508	GO:BP	positive regulation of autophagy	16175	4183		1	1	145	16030	5	25	140	16005	16175	0.07212285730829492
M1	cpdb	0	network_modules	106	TRUE	0.005964179414387429	129	31	5	0.16129032258064516	0.03875968992248062	GO:1902904	GO:BP	negative regulation of supramolecular fiber organization	16175	22603		NA	1	129	16046	5	26	124	16020	16175	0.07553115183631061
M1	cpdb	0	network_modules	107	TRUE	5.215676280779893e-17	7	30	7	0.23333333333333334	1	GO:0035654	GO:BP	clathrin-coated vesicle cargo loading, AP-3-mediated	16175	9140		0	0.047619047619047616	7	16168	7	23	0	16145	16175	0.4827021876335669
M1	cpdb	0	network_modules	107	TRUE	5.215676280779893e-17	7	30	7	0.23333333333333334	1	GO:0035652	GO:BP	clathrin-coated vesicle cargo loading	16175	9138		0	0.047619047619047616	7	16168	7	23	0	16145	16175	0.4827021876335669
M1	cpdb	0	network_modules	107	TRUE	1.63724702230397e-12	18	30	7	0.23333333333333334	0.3888888888888889	GO:0099517	GO:BP	synaptic vesicle transport along microtubule	16175	19106		0.04878048780487805	0.11904761904761904	18	16157	7	23	11	16134	16175	0.3002408921928207
M1	cpdb	0	network_modules	107	TRUE	1.63724702230397e-12	18	30	7	0.23333333333333334	0.3888888888888889	GO:0099514	GO:BP	synaptic vesicle cytoskeletal transport	16175	19104		0.04878048780487805	0.11904761904761904	18	16157	7	23	11	16134	16175	0.3002408921928207
M1	cpdb	0	network_modules	107	TRUE	1.63724702230397e-12	18	30	7	0.23333333333333334	0.3888888888888889	GO:0048490	GO:BP	anterograde synaptic vesicle transport	16175	12783		0.04878048780487805	0.11904761904761904	18	16157	7	23	11	16134	16175	0.3002408921928207
M1	cpdb	0	network_modules	107	TRUE	2.5890797808021974e-12	19	30	7	0.23333333333333334	0.3684210526315789	GO:1903232	GO:BP	melanosome assembly	16175	22844		0.12195121951219512	0.14285714285714285	19	16156	7	23	12	16133	16175	0.292164265965324
M1	cpdb	0	network_modules	107	TRUE	1.7673354576591305e-11	24	30	7	0.23333333333333334	0.2916666666666667	GO:0060155	GO:BP	platelet dense granule organization	16175	14393		0.14634146341463414	0.16666666666666666	24	16151	7	23	17	16128	16175	0.2596491125320313
M1	cpdb	0	network_modules	107	TRUE	2.2727546706769224e-11	5	30	5	0.16666666666666666	1	GO:0016183	GO:BP	synaptic vesicle coating	16175	5163		0.17073170731707318	0.19047619047619047	5	16170	5	25	0	16145	16175	0.4079325775634489
M1	cpdb	0	network_modules	107	TRUE	2.157131425254999e-10	33	30	7	0.23333333333333334	0.21212121212121213	GO:0048489	GO:BP	synaptic vesicle transport	16175	12782		0.1951219512195122	0.21428571428571427	33	16142	7	23	26	16119	16175	0.22095967245005277
M1	cpdb	0	network_modules	107	TRUE	2.7130034277647727e-10	34	30	7	0.23333333333333334	0.20588235294117646	GO:0035459	GO:BP	vesicle cargo loading	16175	9047		0.21951219512195122	0.23809523809523808	34	16141	7	23	27	16118	16175	0.21763456953625698
M1	cpdb	0	network_modules	107	TRUE	4.760494175925826e-10	7	30	5	0.16666666666666666	0.7142857142857143	GO:0016185	GO:BP	synaptic vesicle budding from presynaptic endocytic zone membrane	16175	5164		0.24390243902439024	0.2857142857142857	7	16168	5	25	2	16143	16175	0.344531008852468
M1	cpdb	0	network_modules	107	TRUE	4.760494175925826e-10	7	30	5	0.16666666666666666	0.7142857142857143	GO:0070142	GO:BP	synaptic vesicle budding	16175	15937		0.24390243902439024	0.2857142857142857	7	16168	5	25	2	16143	16175	0.344531008852468
M1	cpdb	0	network_modules	107	TRUE	7.708581950906336e-10	39	30	7	0.23333333333333334	0.1794871794871795	GO:0048753	GO:BP	pigment granule organization	16175	13004		0.2926829268292683	0.3333333333333333	39	16136	7	23	32	16113	16175	0.2029650881799893
M1	cpdb	0	network_modules	107	TRUE	7.708581950906336e-10	39	30	7	0.23333333333333334	0.1794871794871795	GO:0032438	GO:BP	melanosome organization	16175	7566		0.2926829268292683	0.3333333333333333	39	16136	7	23	32	16113	16175	0.2029650881799893
M1	cpdb	0	network_modules	107	TRUE	9.332092077746676e-10	40	30	7	0.23333333333333334	0.175	GO:0097479	GO:BP	synaptic vesicle localization	16175	18670		0.34146341463414637	0.35714285714285715	40	16135	7	23	33	16112	16175	0.20036451985597137
M1	cpdb	0	network_modules	107	TRUE	1.3470449372917644e-9	42	30	7	0.23333333333333334	0.16666666666666666	GO:0008089	GO:BP	anterograde axonal transport	16175	3120		0.36585365853658536	0.40476190476190477	42	16133	7	23	35	16110	16175	0.19544313499405871
M1	cpdb	0	network_modules	107	TRUE	1.3470449372917644e-9	42	30	7	0.23333333333333334	0.16666666666666666	GO:0047496	GO:BP	vesicle transport along microtubule	16175	12458		0.36585365853658536	0.40476190476190477	42	16133	7	23	35	16110	16175	0.19544313499405871
M1	cpdb	0	network_modules	107	TRUE	2.1843790347314233e-9	81	30	8	0.26666666666666666	0.09876543209876543	GO:0043473	GO:BP	pigmentation	16175	10719		0.4146341463414634	0.42857142857142855	81	16094	8	22	73	16072	16175	0.15978902972261697
M1	cpdb	0	network_modules	107	TRUE	6.5971494918361525e-9	52	30	7	0.23333333333333334	0.1346153846153846	GO:0033363	GO:BP	secretory granule organization	16175	8173		0.43902439024390244	0.4523809523809524	52	16123	7	23	45	16100	16175	0.17523175856743273
M1	cpdb	0	network_modules	107	TRUE	8.71137467543232e-9	54	30	7	0.23333333333333334	0.12962962962962962	GO:0098930	GO:BP	axonal transport	16175	18959		0.4634146341463415	0.47619047619047616	54	16121	7	23	47	16098	16175	0.1718743745835931
M1	cpdb	0	network_modules	107	TRUE	1.4716190110678179e-8	58	30	7	0.23333333333333334	0.1206896551724138	GO:0033059	GO:BP	cellular pigmentation	16175	8013		0.4878048780487805	0.5	58	16117	7	23	51	16094	16175	0.16568404406909318
M1	cpdb	0	network_modules	107	TRUE	2.127305124207942e-8	61	30	7	0.23333333333333334	0.11475409836065574	GO:0008088	GO:BP	axo-dendritic transport	16175	3119		0.5121951219512195	0.5238095238095238	61	16114	7	23	54	16091	16175	0.16144308528655335
M1	cpdb	0	network_modules	107	TRUE	4.208867951736555e-8	67	30	7	0.23333333333333334	0.1044776119402985	GO:0099518	GO:BP	vesicle cytoskeletal trafficking	16175	19107		0.5365853658536586	0.5476190476190477	67	16108	7	23	60	16085	16175	0.1538244965369817
M1	cpdb	0	network_modules	107	TRUE	7.826778842210448e-8	73	30	7	0.23333333333333334	0.0958904109589041	GO:0072384	GO:BP	organelle transport along microtubule	16175	17378		0.5609756097560976	0.5714285714285714	73	16102	7	23	66	16079	16175	0.14715631489816397
M1	cpdb	0	network_modules	107	TRUE	2.1296683650362056e-7	315	30	10	0.3333333333333333	0.031746031746031744	GO:0016050	GO:BP	vesicle organization	16175	5082		0.5853658536585366	0.5952380952380952	315	15860	10	20	305	15840	16175	0.0979069187292307
M1	cpdb	0	network_modules	107	TRUE	7.032442387095993e-7	165	30	8	0.26666666666666666	0.048484848484848485	GO:0099111	GO:BP	microtubule-based transport	16175	19044		0.6097560975609756	0.6190476190476191	165	16010	8	22	157	15988	16175	0.1100215124506739
M1	cpdb	0	network_modules	107	TRUE	7.387415491030624e-7	131	20	7	0.35	0.05343511450381679	KEGG:04142	KEGG	Lysosome	8484	279		NA	1	131	8353	7	13	124	8340	8484	0.1318997219713899
M1	cpdb	0	network_modules	107	TRUE	1.2860600424728614e-6	178	30	8	0.26666666666666666	0.0449438202247191	GO:0051650	GO:BP	establishment of vesicle localization	16175	13863		0.6341463414634146	0.6428571428571429	178	15997	8	22	170	15975	16175	0.10563865211469009
M1	cpdb	0	network_modules	107	TRUE	1.5442812074492956e-6	519	30	11	0.36666666666666664	0.02119460500963391	GO:0051640	GO:BP	organelle localization	16175	13853		0.6585365853658537	0.6666666666666666	519	15656	11	19	508	15637	16175	0.08183930464994496
M1	cpdb	0	network_modules	107	TRUE	1.8230216436245655e-6	186	30	8	0.26666666666666666	0.043010752688172046	GO:0051648	GO:BP	vesicle localization	16175	13861		0.6829268292682927	0.6904761904761905	186	15989	8	22	178	15967	16175	0.10316776549266313
M1	cpdb	0	network_modules	107	TRUE	8.23234426902858e-6	36	30	5	0.16666666666666666	0.1388888888888889	GO:0006901	GO:BP	vesicle coating	16175	2554		0.7073170731707317	0.7142857142857143	36	16139	5	25	31	16114	16175	0.15042030531439257
M1	cpdb	0	network_modules	107	TRUE	9.656622106764334e-6	144	30	7	0.23333333333333334	0.04861111111111111	GO:0010970	GO:BP	transport along microtubule	16175	4546		0.7317073170731707	0.7380952380952381	144	16031	7	23	137	16008	16175	0.1029927404802382
M1	cpdb	0	network_modules	107	TRUE	1.2583684630744376e-5	348	30	9	0.3	0.02586206896551724	GO:0007018	GO:BP	microtubule-based movement	16175	2626		0.7560975609756098	0.7619047619047619	348	15827	9	21	339	15806	16175	0.08273690497965527
M1	cpdb	0	network_modules	107	TRUE	4.0947995075054086e-5	49	30	5	0.16666666666666666	0.10204081632653061	GO:0048488	GO:BP	synaptic vesicle endocytosis	16175	12781		0.7804878048780488	0.8095238095238095	49	16126	5	25	44	16101	16175	0.12835323832478615
M1	cpdb	0	network_modules	107	TRUE	4.0947995075054086e-5	49	30	5	0.16666666666666666	0.10204081632653061	GO:0140238	GO:BP	presynaptic endocytosis	16175	19709		0.7804878048780488	0.8095238095238095	49	16126	5	25	44	16101	16175	0.12835323832478615
M1	cpdb	0	network_modules	107	TRUE	5.194343004753344e-5	410	30	9	0.3	0.02195121951219512	GO:0051656	GO:BP	establishment of organelle localization	16175	13869		0.8292682926829268	0.8333333333333334	410	15765	9	21	401	15744	16175	0.07532343607269097
M1	cpdb	0	network_modules	107	TRUE	5.477901578758066e-5	185	30	7	0.23333333333333334	0.03783783783783784	GO:0030705	GO:BP	cytoskeleton-dependent intracellular transport	16175	6886		0.8536585365853658	0.8571428571428571	185	15990	7	23	178	15967	16175	0.08995496363438867
M1	cpdb	0	network_modules	107	TRUE	1.0612785167645604e-4	59	30	5	0.16666666666666666	0.0847457627118644	GO:0036465	GO:BP	synaptic vesicle recycling	16175	9613		0.8780487804878049	0.8809523809523809	59	16116	5	25	54	16091	16175	0.11656539713765972
M1	cpdb	0	network_modules	107	TRUE	3.349350967620561e-4	74	30	5	0.16666666666666666	0.06756756756756757	GO:0006900	GO:BP	vesicle budding from membrane	16175	2553		0.9024390243902439	0.9047619047619048	74	16101	5	25	69	16076	16175	0.10353910306929026
M1	cpdb	0	network_modules	107	TRUE	0.003295586794058457	117	30	5	0.16666666666666666	0.042735042735042736	GO:0099504	GO:BP	synaptic vesicle cycle	16175	19100		0.926829268292683	0.9285714285714286	117	16058	5	25	112	16033	16175	0.08110100204422188
M1	cpdb	0	network_modules	107	TRUE	0.003889965073877022	121	30	5	0.16666666666666666	0.04132231404958678	GO:0099003	GO:BP	vesicle-mediated transport in synapse	16175	18999		0.9512195121951219	0.9523809523809523	121	16054	5	25	116	16029	16175	0.07963544495807434
M1	cpdb	0	network_modules	107	TRUE	0.005126820044681056	522	30	8	0.26666666666666666	0.01532567049808429	GO:0010256	GO:BP	endomembrane system organization	16175	4029		0.975609756097561	0.9761904761904762	522	15653	8	22	514	15631	16175	0.057174125121783936
M1	cpdb	0	network_modules	107	TRUE	0.005982527902153439	533	30	8	0.26666666666666666	0.0150093808630394	GO:0006897	GO:BP	endocytosis	16175	2551		1	1	533	15642	8	22	525	15620	16175	0.0564367443929069
M1	cpdb	0	network_modules	108	TRUE	6.736734124680168e-11	59	23	8	0.34782608695652173	0.13559322033898305	REAC:R-HSA-6790901	REAC	rRNA modification in the nucleus and cytosol	10916	2731		0	0.125	59	10857	8	15	51	10842	10916	0.2146018116128692
M1	cpdb	0	network_modules	108	TRUE	3.2281082606309924e-10	169	29	10	0.3448275862068966	0.05917159763313609	GO:0006364	GO:BP	rRNA processing	16175	2140		0	0.07142857142857142	169	16006	10	19	159	15987	16175	0.13936878776995382
M1	cpdb	0	network_modules	108	TRUE	2.247981582271298e-9	205	29	10	0.3448275862068966	0.04878048780487805	GO:0016072	GO:BP	rRNA metabolic process	16175	5099		0.07692307692307693	0.14285714285714285	205	15970	10	19	195	15951	16175	0.1258405271974259
M1	cpdb	0	network_modules	108	TRUE	1.68805983355205e-8	251	29	10	0.3448275862068966	0.0398406374501992	GO:0042254	GO:BP	ribosome biogenesis	16175	10060		0.15384615384615385	0.21428571428571427	251	15924	10	19	241	15905	16175	0.11291523424833248
M1	cpdb	0	network_modules	108	TRUE	2.750276454849779e-7	46	29	6	0.20689655172413793	0.13043478260869565	GO:0030490	GO:BP	maturation of SSU-rRNA	16175	6815		0.23076923076923078	0.2857142857142857	46	16129	6	23	40	16106	16175	0.1623941689995014
M1	cpdb	0	network_modules	108	TRUE	4.046472647904944e-7	94	29	7	0.2413793103448276	0.07446808510638298	GO:0042274	GO:BP	ribosomal small subunit biogenesis	16175	10071		0.3076923076923077	0.35714285714285715	94	16081	7	22	87	16059	16175	0.13134284581556468
M1	cpdb	0	network_modules	108	TRUE	6.669006982075265e-7	182	23	8	0.34782608695652173	0.04395604395604396	REAC:R-HSA-6791226	REAC	Major pathway of rRNA processing in the nucleolus and cytosol	10916	1389		0.14285714285714285	0.25	182	10734	8	15	174	10719	10916	0.11884100287145143
M1	cpdb	0	network_modules	108	TRUE	1.0188257727786969e-6	192	23	8	0.34782608695652173	0.041666666666666664	REAC:R-HSA-8868773	REAC	rRNA processing in the nucleus and cytosol	10916	2734		0.2857142857142857	0.375	192	10724	8	15	184	10709	10916	0.1154385078530688
M1	cpdb	0	network_modules	108	TRUE	1.2709685926708736e-6	390	29	10	0.3448275862068966	0.02564102564102564	GO:0022613	GO:BP	ribonucleoprotein complex biogenesis	16175	6620		0.38461538461538464	0.42857142857142855	390	15785	10	19	380	15766	16175	0.08860888161404568
M1	cpdb	0	network_modules	108	TRUE	1.521734507800504e-6	202	23	8	0.34782608695652173	0.039603960396039604	REAC:R-HSA-72312	REAC	rRNA processing	10916	2732		0.42857142857142855	0.5	202	10714	8	15	194	10699	10916	0.11228501405524773
M1	cpdb	0	network_modules	108	TRUE	3.054234019983057e-5	56	23	5	0.21739130434782608	0.08928571428571429	REAC:R-HSA-72187	REAC	mRNA 3'-end processing	10916	2701		0.5714285714285714	0.625	56	10860	5	18	51	10842	10916	0.13652601792145516
M1	cpdb	0	network_modules	108	TRUE	6.522970105327371e-5	65	23	5	0.21739130434782608	0.07692307692307693	REAC:R-HSA-73856	REAC	RNA Polymerase II Transcription Termination	10916	1895		0.7142857142857143	0.75	65	10851	5	18	60	10833	10916	0.12628233158931165
M1	cpdb	0	network_modules	108	TRUE	1.0197312344045399e-4	71	23	5	0.21739130434782608	0.07042253521126761	REAC:R-HSA-159236	REAC	Transport of Mature mRNA derived from an Intron-Containing Transcript	10916	2586		0.8571428571428571	0.875	71	10845	5	18	66	10827	10916	0.1205479239538385
M1	cpdb	0	network_modules	108	TRUE	1.859605397953879e-4	80	23	5	0.21739130434782608	0.0625	REAC:R-HSA-72202	REAC	Transport of Mature Transcript to Cytoplasm	10916	2584		1	1	80	10836	5	18	75	10818	10916	0.11316782364484677
M1	cpdb	0	network_modules	108	TRUE	2.1566467357206096e-4	69	29	5	0.1724137931034483	0.07246376811594203	GO:0006406	GO:BP	mRNA export from nucleus	16175	2167		0.46153846153846156	0.5	69	16106	5	24	64	16082	16175	0.10934124140342835
M1	cpdb	0	network_modules	108	TRUE	2.606710076101857e-4	139	16	5	0.3125	0.03597122302158273	KEGG:03008	KEGG	Ribosome biogenesis in eukaryotes	8484	207		0	0.5	139	8345	5	11	134	8334	8484	0.10139390534688587
M1	cpdb	0	network_modules	108	TRUE	2.670609015227551e-4	28	29	4	0.13793103448275862	0.14285714285714285	GO:0000462	GO:BP	maturation of SSU-rRNA from tricistronic rRNA transcript (SSU-rRNA, 5.8S rRNA, LSU-rRNA)	16175	152		0.5384615384615384	0.5714285714285714	28	16147	4	25	24	16122	16175	0.1388554344222556
M1	cpdb	0	network_modules	108	TRUE	3.5146659880015463e-4	76	29	5	0.1724137931034483	0.06578947368421052	GO:0051028	GO:BP	mRNA transport	16175	13445		0.6153846153846154	0.6428571428571429	76	16099	5	24	71	16075	16175	0.10393862116554221
M1	cpdb	0	network_modules	108	TRUE	8.217129411632892e-4	90	29	5	0.1724137931034483	0.05555555555555555	GO:0006405	GO:BP	RNA export from nucleus	16175	2166		0.6923076923076923	0.7142857142857143	90	16085	5	24	85	16061	16175	0.09506142697026641
M1	cpdb	0	network_modules	108	TRUE	0.002523721728488376	108	16	4	0.25	0.037037037037037035	KEGG:03013	KEGG	Nucleocytoplasmic transport	8484	209		1	1	108	8376	4	12	104	8364	8484	0.09199900481636822
M1	cpdb	0	network_modules	108	TRUE	0.002664300592324621	114	29	5	0.1724137931034483	0.043859649122807015	GO:0050658	GO:BP	RNA transport	16175	13198		0.7692307692307693	0.8571428571428571	114	16061	5	24	109	16037	16175	0.08377568796139666
M1	cpdb	0	network_modules	108	TRUE	0.002664300592324621	114	29	5	0.1724137931034483	0.043859649122807015	GO:0050657	GO:BP	nucleic acid transport	16175	13197		0.7692307692307693	0.8571428571428571	114	16061	5	24	109	16037	16175	0.08377568796139666
M1	cpdb	0	network_modules	108	TRUE	0.003029533416397141	117	29	5	0.1724137931034483	0.042735042735042736	GO:0051236	GO:BP	establishment of RNA localization	16175	13586		0.9230769230769231	0.9285714285714286	117	16058	5	24	112	16034	16175	0.0826096327966114
M1	cpdb	0	network_modules	108	TRUE	0.00993803092054075	149	29	5	0.1724137931034483	0.03355704697986577	GO:0006403	GO:BP	RNA localization	16175	2164		1	1	149	16026	5	24	144	16002	16175	0.07239869055849499
M1	cpdb	0	network_modules	109	TRUE	2.6776290172382387e-21	301	29	20	0.6896551724137931	0.0664451827242525	KEGG:04010	KEGG	MAPK signaling pathway	8484	243		0	0.045454545454545456	301	8183	20	9	281	8174	8484	0.2071087039953534
M1	cpdb	0	network_modules	109	TRUE	3.377711502603718e-13	595	33	17	0.5151515151515151	0.02857142857142857	GO:0000165	GO:BP	MAPK cascade	16175	55		0	0.045454545454545456	595	15580	17	16	578	15564	16175	0.11490554926870304
M1	cpdb	0	network_modules	109	TRUE	2.739864901788189e-10	63	25	8	0.32	0.12698412698412698	REAC:R-HSA-450294	REAC	MAP kinase activation	10916	1345		0	0.02857142857142857	63	10853	8	17	55	10836	10916	0.1987468539904653
M1	cpdb	0	network_modules	109	TRUE	7.443283558842103e-10	71	25	8	0.32	0.11267605633802817	REAC:R-HSA-448424	REAC	Interleukin-17 signaling	10916	1238		0.029411764705882353	0.05714285714285714	71	10845	8	17	63	10828	10916	0.18684754982309254
M1	cpdb	0	network_modules	109	TRUE	4.8504884975498205e-9	45	33	7	0.21212121212121213	0.15555555555555556	GO:0051403	GO:BP	stress-activated MAPK cascade	16175	13696		0.047619047619047616	0.09090909090909091	45	16130	7	26	38	16104	16175	0.17970062393486144
M1	cpdb	0	network_modules	109	TRUE	6.6365327560523615e-9	11	25	5	0.2	0.45454545454545453	REAC:R-HSA-171007	REAC	p38MAPK events	10916	2716		0.058823529411764705	0.08571428571428572	11	10905	5	20	6	10885	10916	0.30048773985972965
M1	cpdb	0	network_modules	109	TRUE	8.224269093507457e-9	95	25	8	0.32	0.08421052631578947	REAC:R-HSA-975871	REAC	MyD88 cascade initiated on plasma membrane	10916	1497		0.08823529411764706	0.17142857142857143	95	10821	8	17	87	10804	10916	0.16057551940442286
M1	cpdb	0	network_modules	109	TRUE	8.224269093507457e-9	95	25	8	0.32	0.08421052631578947	REAC:R-HSA-168142	REAC	Toll Like Receptor 10 (TLR10) Cascade	10916	2513		0.08823529411764706	0.17142857142857143	95	10821	8	17	87	10804	10916	0.16057551940442286
M1	cpdb	0	network_modules	109	TRUE	8.224269093507457e-9	95	25	8	0.32	0.08421052631578947	REAC:R-HSA-168176	REAC	Toll Like Receptor 5 (TLR5) Cascade	10916	2517		0.08823529411764706	0.17142857142857143	95	10821	8	17	87	10804	10916	0.16057551940442286
M1	cpdb	0	network_modules	109	TRUE	1.0601338011098336e-8	50	33	7	0.21212121212121213	0.14	GO:0031098	GO:BP	stress-activated protein kinase signaling cascade	16175	7024		0.09523809523809523	0.13636363636363635	50	16125	7	26	43	16099	16175	0.17025363389368797
M1	cpdb	0	network_modules	109	TRUE	1.35600759919371e-8	101	25	8	0.32	0.07920792079207921	REAC:R-HSA-975138	REAC	TRAF6 mediated induction of NFkB and MAP kinases upon TLR7/8 or 9 activation	10916	2468		0.17647058823529413	0.2	101	10815	8	17	93	10798	10916	0.1555010708216912
M1	cpdb	0	network_modules	109	TRUE	1.4693617487992237e-8	102	25	8	0.32	0.0784313725490196	REAC:R-HSA-975155	REAC	MyD88 dependent cascade initiated on endosome	10916	1500		0.20588235294117646	0.22857142857142856	102	10814	8	17	94	10797	10916	0.15469846878341692
M1	cpdb	0	network_modules	109	TRUE	1.5908769823032116e-8	103	25	8	0.32	0.07766990291262135	REAC:R-HSA-168181	REAC	Toll Like Receptor 7/8 (TLR7/8) Cascade	10916	2518		0.23529411764705882	0.2857142857142857	103	10813	8	17	95	10796	10916	0.15390739329104183
M1	cpdb	0	network_modules	109	TRUE	1.5908769823032116e-8	103	25	8	0.32	0.07766990291262135	REAC:R-HSA-168164	REAC	Toll Like Receptor 3 (TLR3) Cascade	10916	2515		0.23529411764705882	0.2857142857142857	103	10813	8	17	95	10796	10916	0.15390739329104183
M1	cpdb	0	network_modules	109	TRUE	2.00945631707058e-8	106	25	8	0.32	0.07547169811320754	REAC:R-HSA-168138	REAC	Toll Like Receptor 9 (TLR9) Cascade	10916	2519		0.29411764705882354	0.3142857142857143	106	10810	8	17	98	10793	10916	0.15160060307681222
M1	cpdb	0	network_modules	109	TRUE	2.1688086876391876e-08	107	25	8	0.32	0.07476635514018691	REAC:R-HSA-937061	REAC	TRIF (TICAM1)-mediated TLR4 signaling 	10916	2471		0.3235294117647059	0.37142857142857144	107	10809	8	17	99	10792	10916	0.15085295539867277
M1	cpdb	0	network_modules	109	TRUE	2.1688086876391876e-08	107	25	8	0.32	0.07476635514018691	REAC:R-HSA-166166	REAC	MyD88-independent TLR4 cascade 	10916	1501		0.3235294117647059	0.37142857142857144	107	10809	8	17	99	10792	10916	0.15085295539867277
M1	cpdb	0	network_modules	109	TRUE	3.141831876744247e-8	112	25	8	0.32	0.07142857142857142	REAC:R-HSA-168188	REAC	Toll Like Receptor TLR6:TLR2 Cascade	10916	2521		0.38235294117647056	0.42857142857142855	112	10804	8	17	104	10787	10916	0.14726359928011978
M1	cpdb	0	network_modules	109	TRUE	3.141831876744247e-8	112	25	8	0.32	0.07142857142857142	REAC:R-HSA-166058	REAC	MyD88:MAL(TIRAP) cascade initiated on plasma membrane	10916	1502		0.38235294117647056	0.42857142857142855	112	10804	8	17	104	10787	10916	0.14726359928011978
M1	cpdb	0	network_modules	109	TRUE	3.639155045794003e-8	93	29	8	0.27586206896551724	0.08602150537634409	KEGG:04912	KEGG	GnRH signaling pathway	8484	369		0.047619047619047616	0.09090909090909091	93	8391	8	21	85	8370	8484	0.14899678590607016
M1	cpdb	0	network_modules	109	TRUE	3.8919439984261295e-8	115	25	8	0.32	0.06956521739130435	REAC:R-HSA-181438	REAC	Toll Like Receptor 2 (TLR2) Cascade	10916	2514		0.4411764705882353	0.4857142857142857	115	10801	8	17	107	10784	10916	0.1452212915562492
M1	cpdb	0	network_modules	109	TRUE	3.8919439984261295e-8	115	25	8	0.32	0.06956521739130435	REAC:R-HSA-168179	REAC	Toll Like Receptor TLR1:TLR2 Cascade	10916	2520		0.4411764705882353	0.4857142857142857	115	10801	8	17	107	10784	10916	0.1452212915562492
M1	cpdb	0	network_modules	109	TRUE	8.807750723163265e-8	17	25	5	0.2	0.29411764705882354	REAC:R-HSA-167044	REAC	Signalling to RAS	10916	2332		0.5	0.5142857142857142	17	10899	5	20	12	10879	10916	0.24111092536134815
M1	cpdb	0	network_modules	109	TRUE	2.2482062506044667e-7	143	25	8	0.32	0.055944055944055944	REAC:R-HSA-166016	REAC	Toll Like Receptor 4 (TLR4) Cascade	10916	2516		0.5294117647058824	0.5428571428571428	143	10773	8	17	135	10756	10916	0.12931834568670486
M1	cpdb	0	network_modules	109	TRUE	4.778166797077943e-7	141	33	8	0.24242424242424243	0.05673758865248227	GO:0007254	GO:BP	JNK cascade	16175	2787		0.14285714285714285	0.18181818181818182	141	16034	8	25	133	16009	16175	0.11367474085921098
M1	cpdb	0	network_modules	109	TRUE	5.20138520284341e-7	45	33	6	0.18181818181818182	0.13333333333333333	GO:0038066	GO:BP	p38MAPK cascade	16175	9683		0.19047619047619047	0.22727272727272727	45	16130	6	27	39	16103	16175	0.15368793741126754
M1	cpdb	0	network_modules	109	TRUE	6.704933711468837e-7	164	25	8	0.32	0.04878048780487805	REAC:R-HSA-168898	REAC	Toll-like Receptor Cascades	10916	2522		0.5588235294117647	0.5714285714285714	164	10752	8	17	156	10735	10916	0.1201154916513932
M1	cpdb	0	network_modules	109	TRUE	2.3672040224997998e-6	31	25	5	0.2	0.16129032258064516	REAC:R-HSA-187687	REAC	Signalling to ERKs	10916	2331		0.5882352941176471	0.6	31	10885	5	20	26	10865	10916	0.17751035346023009
M1	cpdb	0	network_modules	109	TRUE	2.6238944891658095e-6	122	25	7	0.28	0.05737704918032787	REAC:R-HSA-2559580	REAC	Oxidative Stress Induced Senescence	10916	1654		0.6176470588235294	0.6285714285714286	122	10794	7	18	115	10776	10916	0.1225169444458993
M1	cpdb	0	network_modules	109	TRUE	3.230980164142984e-6	106	29	7	0.2413793103448276	0.0660377358490566	KEGG:04620	KEGG	Toll-like receptor signaling pathway	8484	325		0.09523809523809523	0.13636363636363635	106	8378	7	22	99	8356	8484	0.12068060005721143
M1	cpdb	0	network_modules	109	TRUE	5.038877267560186e-6	113	29	7	0.2413793103448276	0.061946902654867256	KEGG:04668	KEGG	TNF signaling pathway	8484	342		0.14285714285714285	0.18181818181818182	113	8371	7	22	106	8349	8484	0.11651029746506768
M1	cpdb	0	network_modules	109	TRUE	5.3021750509900135e-6	67	29	6	0.20689655172413793	0.08955223880597014	KEGG:04664	KEGG	Fc epsilon RI signaling pathway	8484	340		0.19047619047619047	0.22727272727272727	67	8417	6	23	61	8394	8484	0.13166744542496567
M1	cpdb	0	network_modules	109	TRUE	1.99622164634328e-5	138	29	7	0.2413793103448276	0.050724637681159424	KEGG:05418	KEGG	Fluid shear stress and atherosclerosis	8484	495		0.23809523809523808	0.2727272727272727	138	8346	7	22	131	8324	8484	0.10422345431505962
M1	cpdb	0	network_modules	109	TRUE	2.439635667250665e-5	40	33	5	0.15151515151515152	0.125	GO:0043506	GO:BP	regulation of JUN kinase activity	16175	10743		0.23809523809523808	0.2727272727272727	40	16135	5	28	35	16107	16175	0.13568047587199084
M1	cpdb	0	network_modules	109	TRUE	5.424228682573606e-5	112	25	6	0.24	0.05357142857142857	REAC:R-HSA-187037	REAC	Signaling by NTRK1 (TRKA)	10916	2284		0.6470588235294118	0.6571428571428571	112	10804	6	19	106	10785	10916	0.10922816842308336
M1	cpdb	0	network_modules	109	TRUE	6.478006803031416e-5	23	25	4	0.16	0.17391304347826086	REAC:R-HSA-450302	REAC	activated TAK1 mediates p38 MAPK activation	10916	2685		0.6764705882352942	0.6857142857142857	23	10893	4	21	19	10872	10916	0.16497755463040714
M1	cpdb	0	network_modules	109	TRUE	6.486931264231471e-5	194	25	7	0.28	0.03608247422680412	REAC:R-HSA-2559583	REAC	Cellular Senescence	10916	331		0.7058823529411765	0.7142857142857143	194	10722	7	18	187	10704	10916	0.09509108874300651
M1	cpdb	0	network_modules	109	TRUE	9.535510386700405e-5	59	29	5	0.1724137931034483	0.0847457627118644	KEGG:04370	KEGG	VEGF signaling pathway	8484	307		0.2857142857142857	0.3181818181818182	59	8425	5	24	54	8401	8484	0.11660674399495652
M1	cpdb	0	network_modules	109	TRUE	1.1472484602085435e-4	701	33	11	0.3333333333333333	0.015691868758915834	GO:0009628	GO:BP	response to abiotic stimulus	16175	3549		0.2857142857142857	0.3181818181818182	701	15474	11	22	690	15452	16175	0.06439506189044251
M1	cpdb	0	network_modules	109	TRUE	1.3770934726245059e-4	131	25	6	0.24	0.04580152671755725	REAC:R-HSA-166520	REAC	Signaling by NTRKs	10916	2287		0.7352941176470589	0.7428571428571429	131	10785	6	19	125	10766	10916	0.1003199670387082
M1	cpdb	0	network_modules	109	TRUE	1.8965488739361541e-4	472	25	9	0.36	0.019067796610169493	REAC:R-HSA-449147	REAC	Signaling by Interleukins	10916	2261		0.7647058823529411	0.7714285714285715	472	10444	9	16	463	10428	10916	0.07461506822406185
M1	cpdb	0	network_modules	109	TRUE	1.9924557029100726e-4	194	29	7	0.2413793103448276	0.03608247422680412	KEGG:05167	KEGG	Kaposi sarcoma-associated herpesvirus infection	8484	448		0.3333333333333333	0.36363636363636365	194	8290	7	22	187	8268	8484	0.0856133480891761
M1	cpdb	0	network_modules	109	TRUE	2.546002321961018e-4	124	33	6	0.18181818181818182	0.04838709677419355	GO:0043405	GO:BP	regulation of MAP kinase activity	16175	10673		0.3333333333333333	0.36363636363636365	124	16051	6	27	118	16024	16175	0.09027951969566403
M1	cpdb	0	network_modules	109	TRUE	3.552772241938763e-4	136	29	6	0.20689655172413793	0.04411764705882353	KEGG:05135	KEGG	Yersinia infection	8484	432		0.38095238095238093	0.4090909090909091	136	8348	6	23	130	8325	8484	0.08900442707030135
M1	cpdb	0	network_modules	109	TRUE	3.69253398833742e-4	27	33	4	0.12121212121212122	0.14814814814814814	GO:0043507	GO:BP	positive regulation of JUN kinase activity	16175	10744		0.38095238095238093	0.4090909090909091	27	16148	4	29	23	16119	16175	0.13240520091052038
M1	cpdb	0	network_modules	109	TRUE	4.223801485728913e-4	36	25	4	0.16	0.1111111111111111	REAC:R-HSA-168638	REAC	NOD1/2 Signaling Pathway	10916	1529		0.7941176470588235	0.8	36	10880	4	21	32	10859	10916	0.13095097594214508
M1	cpdb	0	network_modules	109	TRUE	4.5607274221142445e-4	142	29	6	0.20689655172413793	0.04225352112676056	KEGG:04936	KEGG	Alcoholic liver disease	8484	393		0.42857142857142855	0.45454545454545453	142	8342	6	23	136	8319	8484	0.0868122168599854
M1	cpdb	0	network_modules	109	TRUE	6.091397345837422e-4	11	25	3	0.12	0.2727272727272727	REAC:R-HSA-376172	REAC	DSCAM interactions	10916	450		0.8235294117647058	0.8285714285714286	11	10905	3	22	8	10883	10916	0.17968397710091152
M1	cpdb	0	network_modules	109	TRUE	6.943977591204432e-4	94	25	5	0.2	0.05319148936170213	REAC:R-HSA-4420097	REAC	VEGFA-VEGFR2 Pathway	10916	2634		0.8529411764705882	0.8571428571428571	94	10822	5	20	89	10802	10916	0.09924267250771461
M1	cpdb	0	network_modules	109	TRUE	7.550881069454034e-4	155	29	6	0.20689655172413793	0.03870967741935484	KEGG:04218	KEGG	Cellular senescence	8484	295		0.47619047619047616	0.5	155	8329	6	23	149	8306	8484	0.08248673725055859
M1	cpdb	0	network_modules	109	TRUE	7.834512577328835e-4	156	29	6	0.20689655172413793	0.038461538461538464	KEGG:04148	KEGG	Efferocytosis	8484	283		0.5238095238095238	0.5454545454545454	156	8328	6	23	150	8305	8484	0.08217548613309414
M1	cpdb	0	network_modules	109	TRUE	7.952091038031065e-4	42	25	4	0.16	0.09523809523809523	REAC:R-HSA-5675221	REAC	Negative regulation of MAPK pathway	10916	1573		0.8823529411764706	0.8857142857142857	42	10874	4	21	38	10853	10916	0.12084511759323284
M1	cpdb	0	network_modules	109	TRUE	8.412549128420091e-4	80	33	5	0.15151515151515152	0.0625	GO:0090398	GO:BP	cellular senescence	16175	18269		0.42857142857142855	0.45454545454545453	80	16095	5	28	75	16067	16175	0.09446587714128
M1	cpdb	0	network_modules	109	TRUE	9.141431522336898e-4	251	33	7	0.21212121212121213	0.027888446215139442	GO:0104004	GO:BP	cellular response to environmental stimulus	16175	19202		0.47619047619047616	0.5454545454545454	251	15924	7	26	244	15898	16175	0.07192017743305074
M1	cpdb	0	network_modules	109	TRUE	9.141431522336898e-4	251	33	7	0.21212121212121213	0.027888446215139442	GO:0071214	GO:BP	cellular response to abiotic stimulus	16175	16476		0.47619047619047616	0.5454545454545454	251	15924	7	26	244	15898	16175	0.07192017743305074
M1	cpdb	0	network_modules	109	TRUE	9.723502821399735e-4	162	29	6	0.20689655172413793	0.037037037037037035	KEGG:05161	KEGG	Hepatitis B	8484	442		0.5714285714285714	0.5909090909090909	162	8322	6	23	156	8299	8484	0.08036578771596407
M1	cpdb	0	network_modules	109	TRUE	0.001145665519984112	104	25	5	0.2	0.04807692307692308	REAC:R-HSA-194138	REAC	Signaling by VEGF	10916	2313		0.9117647058823529	0.9142857142857143	104	10812	5	20	99	10792	10916	0.09394262766423839
M1	cpdb	0	network_modules	109	TRUE	0.0011775739127269438	530	33	9	0.2727272727272727	0.016981132075471698	GO:0043408	GO:BP	regulation of MAPK cascade	16175	10676		0.5714285714285714	0.5909090909090909	530	15645	9	24	521	15621	16175	0.060944835990167014
M1	cpdb	0	network_modules	109	TRUE	0.0014536523630947205	308	25	7	0.28	0.022727272727272728	REAC:R-HSA-5683057	REAC	MAPK family signaling cascades	10916	1348		0.9411764705882353	0.9428571428571428	308	10608	7	18	301	10590	10916	0.07285118033367108
M1	cpdb	0	network_modules	109	TRUE	0.0015745879806982677	104	29	5	0.1724137931034483	0.04807692307692308	KEGG:04625	KEGG	C-type lectin receptor signaling pathway	8484	330		0.6190476190476191	0.6363636363636364	104	8380	5	24	99	8356	8484	0.08524046820405981
M1	cpdb	0	network_modules	109	TRUE	0.001991900604539116	412	33	8	0.24242424242424243	0.019417475728155338	GO:0045859	GO:BP	regulation of protein kinase activity	16175	11671		0.6190476190476191	0.6363636363636364	412	15763	8	25	404	15738	16175	0.06226154214600647
M1	cpdb	0	network_modules	109	TRUE	0.0022844102940123303	180	33	6	0.18181818181818182	0.03333333333333333	GO:0046777	GO:BP	protein autophosphorylation	16175	12365		0.6666666666666666	0.6818181818181818	180	15995	6	27	174	15968	16175	0.07357021588659338
M1	cpdb	0	network_modules	109	TRUE	0.002374958143012984	55	25	4	0.16	0.07272727272727272	REAC:R-HSA-168643	REAC	Nucleotide-binding domain, leucine rich repeat containing receptor (NLR) signaling pathways	10916	1628		0.9705882352941176	0.9714285714285714	55	10861	4	21	51	10840	10916	0.10485937881586006
M1	cpdb	0	network_modules	109	TRUE	0.002679443894932736	185	33	6	0.18181818181818182	0.032432432432432434	GO:0018105	GO:BP	peptidyl-serine phosphorylation	16175	5324		0.7142857142857143	0.7272727272727273	185	15990	6	27	179	15963	16175	0.07244911584449179
M1	cpdb	0	network_modules	109	TRUE	0.0028979968035602716	118	29	5	0.1724137931034483	0.0423728813559322	KEGG:04722	KEGG	Neurotrophin signaling pathway	8484	352		0.6666666666666666	0.6818181818181818	118	8366	5	24	113	8342	8484	0.0792659367227634
M1	cpdb	0	network_modules	109	TRUE	0.003017941613566051	119	29	5	0.1724137931034483	0.04201680672268908	KEGG:04660	KEGG	T cell receptor signaling pathway	8484	338		0.7142857142857143	0.7272727272727273	119	8365	5	24	114	8341	8484	0.07887820210871078
M1	cpdb	0	network_modules	109	TRUE	0.003030128889170896	198	29	6	0.20689655172413793	0.030303030303030304	KEGG:05169	KEGG	Epstein-Barr virus infection	8484	450		0.7619047619047619	0.7727272727272727	198	8286	6	23	192	8263	8484	0.0712052969431148
M1	cpdb	0	network_modules	109	TRUE	0.0031417023137617164	120	29	5	0.1724137931034483	0.041666666666666664	KEGG:04935	KEGG	Growth hormone synthesis, secretion and action	8484	392		0.8095238095238095	0.8181818181818182	120	8364	5	24	115	8340	8484	0.07849509278830236
M1	cpdb	0	network_modules	109	TRUE	0.0034245063438618716	443	33	8	0.24242424242424243	0.01805869074492099	GO:0043549	GO:BP	regulation of kinase activity	16175	10763		0.7619047619047619	0.7727272727272727	443	15732	8	25	435	15707	16175	0.05957177365234589
M1	cpdb	0	network_modules	109	TRUE	0.0038592423912613303	197	33	6	0.18181818181818182	0.030456852791878174	GO:0018209	GO:BP	peptidyl-serine modification	16175	5368		0.8095238095238095	0.8181818181818182	197	15978	6	27	191	15951	16175	0.06992841675581701
M1	cpdb	0	network_modules	109	TRUE	0.004441511414723029	129	29	5	0.1724137931034483	0.03875968992248062	KEGG:04926	KEGG	Relaxin signaling pathway	8484	383		0.8571428571428571	0.8636363636363636	129	8355	5	24	124	8331	8484	0.07524044408833817
M1	cpdb	0	network_modules	109	TRUE	0.0046785682506525796	214	29	6	0.20689655172413793	0.028037383177570093	KEGG:05417	KEGG	Lipid and atherosclerosis	8484	494		0.9047619047619048	0.9090909090909091	214	8270	6	23	208	8247	8484	0.06785356102382707
M1	cpdb	0	network_modules	109	TRUE	0.004956173812542528	132	29	5	0.1724137931034483	0.03787878787878788	KEGG:04380	KEGG	Osteoclast differentiation	8484	309		0.9523809523809523	0.9545454545454546	132	8352	5	24	127	8328	8484	0.07422654956735046
M1	cpdb	0	network_modules	109	TRUE	0.005495316338931295	52	33	4	0.12121212121212122	0.07692307692307693	GO:0006970	GO:BP	response to osmotic stress	16175	2597		0.8571428571428571	0.8636363636363636	52	16123	4	29	48	16094	16175	0.09424753455312618
M1	cpdb	0	network_modules	109	TRUE	0.005591494378376005	22	25	3	0.12	0.13636363636363635	REAC:R-HSA-112409	REAC	RAF-independent MAPK1/3 activation	10916	1840		1	1	22	10894	3	22	19	10872	10916	0.12604336433891292
M1	cpdb	0	network_modules	109	TRUE	0.005759014398597355	70	29	4	0.13793103448275862	0.05714285714285714	KEGG:05120	KEGG	Epithelial cell signaling in Helicobacter pylori infection	8484	426		1	1	70	8414	4	25	66	8389	8484	0.08395881148166426
M1	cpdb	0	network_modules	109	TRUE	0.007817637893812455	17	33	3	0.09090909090909091	0.17647058823529413	GO:1904355	GO:BP	positive regulation of telomere capping	16175	23742		0.9047619047619048	0.9090909090909091	17	16158	3	30	14	16128	16175	0.12538959230205957
M1	cpdb	0	network_modules	109	TRUE	0.008972899700155421	129	33	5	0.15151515151515152	0.03875968992248062	GO:0009411	GO:BP	response to UV	16175	3476		0.9523809523809523	0.9545454545454546	129	16046	5	28	124	16018	16175	0.07296539210899045
M1	cpdb	0	network_modules	109	TRUE	0.009984340967553164	512	33	8	0.24242424242424243	0.015625	GO:0051338	GO:BP	regulation of transferase activity	16175	13665		1	1	512	15663	8	25	504	15638	16175	0.054432698861522195
M1	cpdb	0	network_modules	110	TRUE	2.3950624352821357e-8	62	30	7	0.23333333333333334	0.11290322580645161	GO:0006303	GO:BP	double-strand break repair via nonhomologous end joining	16175	2110		0	0.1111111111111111	62	16113	7	23	55	16090	16175	0.1600976735603291
M1	cpdb	0	network_modules	110	TRUE	4.497562198999803e-8	14	30	5	0.16666666666666666	0.35714285714285715	GO:0006266	GO:BP	DNA ligation	16175	2081		0.125	0.2222222222222222	14	16161	5	25	9	16136	16175	0.24303859963640526
M1	cpdb	0	network_modules	110	TRUE	7.058738938916647e-8	5	30	4	0.13333333333333333	0.8	GO:0051103	GO:BP	DNA ligation involved in DNA repair	16175	13498		0.25	0.3333333333333333	5	16170	4	26	1	16144	16175	0.3261944612167312
M1	cpdb	0	network_modules	110	TRUE	1.2364621169755222e-7	298	30	10	0.3333333333333333	0.03355704697986577	GO:0006302	GO:BP	double-strand break repair	16175	2109		0.375	0.4444444444444444	298	15877	10	20	288	15857	16175	0.10094382781333029
M1	cpdb	0	network_modules	110	TRUE	1.8972160663205054e-7	13	14	4	0.2857142857142857	0.3076923076923077	KEGG:03450	KEGG	Non-homologous end-joining	8484	241		0	0.5	13	8471	4	10	9	8461	8484	0.29537960543259867
M1	cpdb	0	network_modules	110	TRUE	3.310761174363402e-7	44	14	5	0.35714285714285715	0.11363636363636363	KEGG:03410	KEGG	Base excision repair	8484	237		1	1	44	8440	5	9	39	8431	8484	0.19921156831041062
M1	cpdb	0	network_modules	110	TRUE	6.614664523351282e-7	329	10	7	0.7	0.02127659574468085	REAC:R-HSA-73894	REAC	DNA Repair	10916	444		0	0.125	329	10587	7	3	322	10584	10916	0.11863993752533326
M1	cpdb	0	network_modules	110	TRUE	1.8506796879895776e-6	528	30	11	0.36666666666666664	0.020833333333333332	GO:0006281	GO:BP	DNA repair	16175	2095		0.5	0.5555555555555556	528	15647	11	19	517	15628	16175	0.08102716999954973
M1	cpdb	0	network_modules	110	TRUE	4.622929261514327e-6	11	30	4	0.13333333333333333	0.36363636363636365	GO:0000012	GO:BP	single strand break repair	16175	4		0.625	0.6666666666666666	11	16164	4	26	7	16138	16175	0.21934770440260062
M1	cpdb	0	network_modules	110	TRUE	1.0709032746260055e-5	798	30	12	0.4	0.015037593984962405	GO:0006974	GO:BP	DNA damage response	16175	2601		0.75	0.7777777777777778	798	15377	12	18	786	15359	16175	0.06979761324222591
M1	cpdb	0	network_modules	110	TRUE	5.411343907826591e-5	168	10	5	0.5	0.02976190476190476	REAC:R-HSA-5693532	REAC	DNA Double-Strand Break Repair	10916	443		0.14285714285714285	0.25	168	10748	5	5	163	10743	10916	0.11920774031114105
M1	cpdb	0	network_modules	110	TRUE	7.898477528620515e-5	68	10	4	0.4	0.058823529411764705	REAC:R-HSA-5693571	REAC	Nonhomologous End-Joining (NHEJ)	10916	1605		0.2857142857142857	0.375	68	10848	4	6	64	10842	10916	0.1515461076350598
M1	cpdb	0	network_modules	110	TRUE	1.68699448068997e-4	6	30	3	0.1	0.5	GO:0033152	GO:BP	immunoglobulin V(D)J recombination	16175	8064		0.875	0.8888888888888888	6	16169	3	27	3	16142	16175	0.2230255950735871
M1	cpdb	0	network_modules	110	TRUE	0.0010929709573566963	36	10	3	0.3	0.08333333333333333	REAC:R-HSA-73933	REAC	Resolution of Abasic Sites (AP sites)	10916	2075		0.42857142857142855	0.5	36	10880	3	7	33	10873	10916	0.15670602190132005
M1	cpdb	0	network_modules	110	TRUE	0.001383080098492013	11	30	3	0.1	0.2727272727272727	GO:0033151	GO:BP	V(D)J recombination	16175	8063		1	1	11	16164	3	27	8	16137	16175	0.16422965067086123
M1	cpdb	0	network_modules	110	TRUE	0.004444911644031575	7	10	2	0.2	0.2857142857142857	REAC:R-HSA-5649702	REAC	APEX1-Independent Resolution of AP Sites via the Single Nucleotide Replacement Pathway	10916	30		0.5714285714285714	0.75	7	10909	2	8	5	10901	10916	0.23846495752727878
M1	cpdb	0	network_modules	110	TRUE	0.004444911644031575	7	10	2	0.2	0.2857142857142857	REAC:R-HSA-164843	REAC	2-LTR circle formation	10916	1		0.5714285714285714	0.75	7	10909	2	8	5	10901	10916	0.23846495752727878
M1	cpdb	0	network_modules	110	TRUE	0.005923652628560625	8	10	2	0.2	0.25	REAC:R-HSA-110362	REAC	POLB-Dependent Long Patch Base Excision Repair	10916	1696		0.8571428571428571	0.875	8	10908	2	8	6	10900	10916	0.22297126089211025
M1	cpdb	0	network_modules	110	TRUE	0.007612402875442795	9	10	2	0.2	0.2222222222222222	REAC:R-HSA-162592	REAC	Integration of provirus	10916	1214		1	1	9	10907	2	8	7	10899	10916	0.21013230935567795
M1	cpdb	0	network_modules	111	TRUE	7.804002951451874e-40	183	33	25	0.7575757575757576	0.1366120218579235	GO:0071805	GO:BP	potassium ion transmembrane transport	16175	16918		0	0.011904761904761904	183	15992	25	8	158	15984	16175	0.3190340088807697
M1	cpdb	0	network_modules	111	TRUE	6.362135885245652e-39	198	33	25	0.7575757575757576	0.12626262626262627	GO:0006813	GO:BP	potassium ion transport	16175	2493		0.012048192771084338	0.023809523809523808	198	15977	25	8	173	15969	16175	0.3064740332026564
M1	cpdb	0	network_modules	111	TRUE	5.45051901470397e-35	43	31	18	0.5806451612903226	0.4186046511627907	REAC:R-HSA-1296072	REAC	Voltage gated Potassium channels	10916	2663		0	0.14285714285714285	43	10873	18	13	25	10860	10916	0.49133273197898775
M1	cpdb	0	network_modules	111	TRUE	5.630057948270802e-31	575	33	27	0.8181818181818182	0.04695652173913043	GO:0098662	GO:BP	inorganic cation transmembrane transport	16175	18818		0.024096385542168676	0.03571428571428571	575	15600	27	6	548	15594	16175	0.19111052063136202
M1	cpdb	0	network_modules	111	TRUE	6.192334277019365e-31	577	33	27	0.8181818181818182	0.04679376083188908	GO:0098655	GO:BP	monoatomic cation transmembrane transport	16175	18811		0.03614457831325301	0.047619047619047616	577	15598	27	6	550	15592	16175	0.19076110668313154
M1	cpdb	0	network_modules	111	TRUE	6.865331917818584e-30	630	33	27	0.8181818181818182	0.04285714285714286	GO:0098660	GO:BP	inorganic ion transmembrane transport	16175	18816		0.04819277108433735	0.05952380952380952	630	15545	27	6	603	15539	16175	0.18210597164294778
M1	cpdb	0	network_modules	111	TRUE	3.8419193390432017e-29	671	33	27	0.8181818181818182	0.040238450074515646	GO:0034220	GO:BP	monoatomic ion transmembrane transport	16175	8508		0.060240963855421686	0.07142857142857142	671	15504	27	6	644	15498	16175	0.1761130996777295
M1	cpdb	0	network_modules	111	TRUE	4.898137836826585e-29	677	33	27	0.8181818181818182	0.03988183161004431	GO:0030001	GO:BP	metal ion transport	16175	6646		0.07228915662650602	0.08333333333333333	677	15498	27	6	650	15492	16175	0.17528113398549042
M1	cpdb	0	network_modules	111	TRUE	7.411078014889635e-28	748	33	27	0.8181818181818182	0.03609625668449198	GO:0006812	GO:BP	monoatomic cation transport	16175	2492		0.08433734939759036	0.09523809523809523	748	15427	27	6	721	15421	16175	0.16619320086977216
M1	cpdb	0	network_modules	111	TRUE	4.5951153292629215e-27	103	31	18	0.5806451612903226	0.17475728155339806	REAC:R-HSA-1296071	REAC	Potassium Channels	10916	1780		0.16666666666666666	0.2857142857142857	103	10813	18	13	85	10800	10916	0.3153071671972272
M1	cpdb	0	network_modules	111	TRUE	2.328152638269164e-19	400	31	20	0.6451612903225806	0.05	REAC:R-HSA-112316	REAC	Neuronal System	10916	1590		0.3333333333333333	0.42857142857142855	400	10516	20	11	380	10505	10916	0.17284156164974115
M1	cpdb	0	network_modules	111	TRUE	6.939764817960644e-14	65	33	10	0.30303030303030304	0.15384615384615385	GO:1901379	GO:BP	regulation of potassium ion transmembrane transport	16175	21429		0.0963855421686747	0.10714285714285714	65	16110	10	23	55	16087	16175	0.2137009252751842
M1	cpdb	0	network_modules	111	TRUE	8.709737116236063e-14	23	33	8	0.24242424242424243	0.34782608695652173	GO:0099623	GO:BP	regulation of cardiac muscle cell membrane repolarization	16175	19168		0.10843373493975904	0.11904761904761904	23	16152	8	25	15	16127	16175	0.28917896235469537
M1	cpdb	0	network_modules	111	TRUE	2.752681860565962e-13	74	33	10	0.30303030303030304	0.13513513513513514	GO:0043266	GO:BP	regulation of potassium ion transport	16175	10590		0.12048192771084337	0.13095238095238096	74	16101	10	23	64	16078	16175	0.19996761143934158
M1	cpdb	0	network_modules	111	TRUE	1.3859744880706524e-12	31	33	8	0.24242424242424243	0.25806451612903225	GO:0060306	GO:BP	regulation of membrane repolarization	16175	14519		0.13253012048192772	0.14285714285714285	31	16144	8	25	23	16119	16175	0.24863665806590488
M1	cpdb	0	network_modules	111	TRUE	1.885427865511525e-12	8	33	6	0.18181818181818182	0.75	GO:0098915	GO:BP	membrane repolarization during ventricular cardiac muscle cell action potential	16175	18948		0.14457831325301204	0.15476190476190477	8	16167	6	27	2	16140	16175	0.3687373986331443
M1	cpdb	0	network_modules	111	TRUE	2.4326077779330617e-12	33	33	8	0.24242424242424243	0.24242424242424243	GO:0099622	GO:BP	cardiac muscle cell membrane repolarization	16175	19167		0.1566265060240964	0.16666666666666666	33	16142	8	25	25	16117	16175	0.24087548762310254
M1	cpdb	0	network_modules	111	TRUE	5.586812655549784e-12	19	33	7	0.21212121212121213	0.3684210526315789	GO:0060307	GO:BP	regulation of ventricular cardiac muscle cell membrane repolarization	16175	14520		0.1686746987951807	0.17857142857142858	19	16156	7	26	12	16130	16175	0.2784526224229358
M1	cpdb	0	network_modules	111	TRUE	8.733497445139779e-12	9	31	6	0.1935483870967742	0.6666666666666666	REAC:R-HSA-5576890	REAC	Phase 3 - rapid repolarisation	10916	1735		0.5	0.5714285714285714	9	10907	6	25	3	10882	10916	0.3583371558761297
M1	cpdb	0	network_modules	111	TRUE	1.419612514032453e-11	108	33	10	0.30303030303030304	0.09259259259259259	GO:0001508	GO:BP	action potential	16175	323		0.18072289156626506	0.19047619047619047	108	16067	10	23	98	16044	16175	0.1645330423768581
M1	cpdb	0	network_modules	111	TRUE	1.9220295039649182e-11	71	33	9	0.2727272727272727	0.1267605633802817	GO:0086001	GO:BP	cardiac muscle cell action potential	16175	17878		0.1927710843373494	0.20238095238095238	71	16104	9	24	62	16080	16175	0.18353054719320344
M1	cpdb	0	network_modules	111	TRUE	2.702925679818914e-11	23	33	7	0.21212121212121213	0.30434782608695654	GO:0099625	GO:BP	ventricular cardiac muscle cell membrane repolarization	16175	19170		0.20481927710843373	0.21428571428571427	23	16152	7	26	16	16126	16175	0.25281831748962746
M1	cpdb	0	network_modules	111	TRUE	4.490619774030209e-11	46	33	8	0.24242424242424243	0.17391304347826086	GO:0086009	GO:BP	membrane repolarization	16175	17883		0.21686746987951808	0.2261904761904762	46	16129	8	25	38	16104	16175	0.2034188250738453
M1	cpdb	0	network_modules	111	TRUE	6.476260064425557e-11	48	33	8	0.24242424242424243	0.16666666666666666	GO:1901016	GO:BP	regulation of potassium ion transmembrane transporter activity	16175	21138		0.2289156626506024	0.25	48	16127	8	25	40	16102	16175	0.19904541088023292
M1	cpdb	0	network_modules	111	TRUE	6.476260064425557e-11	48	33	8	0.24242424242424243	0.16666666666666666	GO:0086002	GO:BP	cardiac muscle cell action potential involved in contraction	16175	17879		0.2289156626506024	0.25	48	16127	8	25	40	16102	16175	0.19904541088023292
M1	cpdb	0	network_modules	111	TRUE	9.735761898495558e-11	27	33	7	0.21212121212121213	0.25925925925925924	GO:0086011	GO:BP	membrane repolarization during action potential	16175	17885		0.25301204819277107	0.2619047619047619	27	16148	7	26	20	16122	16175	0.23309573632375363
M1	cpdb	0	network_modules	111	TRUE	1.706318614455021e-10	29	33	7	0.21212121212121213	0.2413793103448276	GO:0086005	GO:BP	ventricular cardiac muscle cell action potential	16175	17882		0.26506024096385544	0.27380952380952384	29	16146	7	26	22	16120	16175	0.2247961513249252
M1	cpdb	0	network_modules	111	TRUE	1.7768467911815447e-10	90	33	9	0.2727272727272727	0.1	GO:0061337	GO:BP	cardiac conduction	16175	15419		0.27710843373493976	0.2857142857142857	90	16085	9	24	81	16061	16175	0.16239300721284136
M1	cpdb	0	network_modules	111	TRUE	2.936374073609606e-10	95	33	9	0.2727272727272727	0.09473684210526316	GO:2001257	GO:BP	regulation of cation channel activity	16175	26443		0.2891566265060241	0.2976190476190476	95	16080	9	24	86	16056	16175	0.1579034062981905
M1	cpdb	0	network_modules	111	TRUE	5.330879275474035e-10	16	33	6	0.18181818181818182	0.375	GO:0097623	GO:BP	potassium ion export across plasma membrane	16175	18713		0.30120481927710846	0.30952380952380953	16	16159	6	27	10	16132	16175	0.2600898708275886
M1	cpdb	0	network_modules	111	TRUE	5.691946872464982e-10	62	33	8	0.24242424242424243	0.12903225806451613	GO:0086003	GO:BP	cardiac muscle cell contraction	16175	17880		0.3132530120481928	0.32142857142857145	62	16113	8	25	54	16088	16175	0.1745793613187286
M1	cpdb	0	network_modules	111	TRUE	8.032377445962881e-10	229	33	11	0.3333333333333333	0.048034934497816595	GO:1904062	GO:BP	regulation of monoatomic cation transmembrane transport	16175	23501		0.3253012048192771	0.3333333333333333	229	15946	11	22	218	15924	16175	0.12215430092950201
M1	cpdb	0	network_modules	111	TRUE	8.226836715516755e-10	17	33	6	0.18181818181818182	0.35294117647058826	GO:1902259	GO:BP	regulation of delayed rectifier potassium channel activity	16175	22156		0.3373493975903614	0.34523809523809523	17	16158	6	27	11	16131	16175	0.25224577540725185
M1	cpdb	0	network_modules	111	TRUE	9.395612104324106e-10	163	33	10	0.30303030303030304	0.06134969325153374	GO:0008016	GO:BP	regulation of heart contraction	16175	3097		0.3493975903614458	0.35714285714285715	163	16012	10	23	153	15989	16175	0.13261845960272445
M1	cpdb	0	network_modules	111	TRUE	1.2359502368917407e-9	111	33	9	0.2727272727272727	0.08108108108108109	GO:0060048	GO:BP	cardiac muscle contraction	16175	14311		0.3614457831325301	0.36904761904761907	111	16064	9	24	102	16040	16175	0.14561132110379887
M1	cpdb	0	network_modules	111	TRUE	1.7984150489773514e-9	19	33	6	0.18181818181818182	0.3157894736842105	GO:1901380	GO:BP	negative regulation of potassium ion transmembrane transport	16175	21430		0.37349397590361444	0.39285714285714285	19	16156	6	27	13	16129	16175	0.23845216799487323
M1	cpdb	0	network_modules	111	TRUE	1.7984150489773514e-9	19	33	6	0.18181818181818182	0.3157894736842105	GO:0086013	GO:BP	membrane repolarization during cardiac muscle cell action potential	16175	17887		0.37349397590361444	0.39285714285714285	19	16156	6	27	13	16129	16175	0.23845216799487323
M1	cpdb	0	network_modules	111	TRUE	2.0068484675825113e-9	40	33	7	0.21212121212121213	0.175	GO:0086091	GO:BP	regulation of heart rate by cardiac conduction	16175	17929		0.39759036144578314	0.40476190476190477	40	16135	7	26	33	16109	16175	0.19085316639375446
M1	cpdb	0	network_modules	111	TRUE	2.8444659989177704e-9	182	33	10	0.30303030303030304	0.054945054945054944	GO:0032412	GO:BP	regulation of monoatomic ion transmembrane transporter activity	16175	7550		0.40963855421686746	0.4166666666666667	182	15993	10	23	172	15970	16175	0.12507629857063934
M1	cpdb	0	network_modules	111	TRUE	2.9555881646555865e-9	258	33	11	0.3333333333333333	0.04263565891472868	GO:0006936	GO:BP	muscle contraction	16175	2575		0.42168674698795183	0.42857142857142855	258	15917	11	22	247	15895	16175	0.11454219556065898
M1	cpdb	0	network_modules	111	TRUE	3.3504891462358483e-9	185	33	10	0.30303030303030304	0.05405405405405406	GO:0060047	GO:BP	heart contraction	16175	14310		0.43373493975903615	0.44047619047619047	185	15990	10	23	175	15967	16175	0.12399079262868684
M1	cpdb	0	network_modules	111	TRUE	3.4946133348614583e-9	262	33	11	0.3333333333333333	0.04198473282442748	GO:0034765	GO:BP	regulation of monoatomic ion transmembrane transport	16175	8734		0.4457831325301205	0.4523809523809524	262	15913	11	22	251	15891	16175	0.11359017439940332
M1	cpdb	0	network_modules	111	TRUE	4.374929665393395e-9	190	33	10	0.30303030303030304	0.05263157894736842	GO:0022898	GO:BP	regulation of transmembrane transporter activity	16175	6629		0.4578313253012048	0.47619047619047616	190	15985	10	23	180	15962	16175	0.12223786888977523
M1	cpdb	0	network_modules	111	TRUE	4.374929665393395e-9	190	33	10	0.30303030303030304	0.05263157894736842	GO:1903522	GO:BP	regulation of blood circulation	16175	23072		0.4578313253012048	0.47619047619047616	190	15985	10	23	180	15962	16175	0.12223786888977523
M1	cpdb	0	network_modules	111	TRUE	4.610617511845514e-9	191	33	10	0.30303030303030304	0.05235602094240838	GO:0003015	GO:BP	heart process	16175	1466		0.4819277108433735	0.4880952380952381	191	15984	10	23	181	15961	16175	0.12189539090707527
M1	cpdb	0	network_modules	111	TRUE	4.924428355738e-9	22	33	6	0.18181818181818182	0.2727272727272727	GO:0043267	GO:BP	negative regulation of potassium ion transport	16175	10591		0.4939759036144578	0.5	22	16153	6	27	16	16126	16175	0.22139149382391282
M1	cpdb	0	network_modules	111	TRUE	5.836898696332106e-9	82	33	8	0.24242424242424243	0.0975609756097561	GO:0002027	GO:BP	regulation of heart rate	16175	629		0.5060240963855421	0.5119047619047619	82	16093	8	25	74	16068	16175	0.15111061555821076
M1	cpdb	0	network_modules	111	TRUE	7.771082192437144e-9	282	33	11	0.3333333333333333	0.03900709219858156	GO:0042391	GO:BP	regulation of membrane potential	16175	10141		0.5180722891566265	0.5238095238095238	282	15893	11	22	271	15871	16175	0.10912980322009902
M1	cpdb	0	network_modules	111	TRUE	8.389885511258412e-9	284	33	11	0.3333333333333333	0.03873239436619718	GO:0010959	GO:BP	regulation of metal ion transport	16175	4536		0.5301204819277109	0.5357142857142857	284	15891	11	22	273	15869	16175	0.10870914035520715
M1	cpdb	0	network_modules	111	TRUE	8.454615989629247e-9	381	33	12	0.36363636363636365	0.031496062992125984	GO:0044057	GO:BP	regulation of system process	16175	10893		0.54216867469879515	0.5476190476190477	381	15794	12	21	369	15773	16175	0.10139044618836401
M1	cpdb	0	network_modules	111	TRUE	8.469016324889734e-9	203	33	10	0.30303030303030304	0.04926108374384237	GO:0032409	GO:BP	regulation of transporter activity	16175	7547		0.5542168674698795	0.5595238095238095	203	15972	10	23	193	15949	16175	0.11798077927929912
M1	cpdb	0	network_modules	111	TRUE	8.641722917393727e-9	86	33	8	0.24242424242424243	0.09302325581395349	GO:0070252	GO:BP	actin-mediated cell contraction	16175	16020		0.5662650602409639	0.5714285714285714	86	16089	8	25	78	16064	16175	0.14741916136704197
M1	cpdb	0	network_modules	111	TRUE	1.3301922800713203e-8	144	33	9	0.2727272727272727	0.0625	GO:0006941	GO:BP	striated muscle contraction	16175	2579		0.5783132530120482	0.5833333333333334	144	16031	9	24	135	16007	16175	0.12699201009124925
M1	cpdb	0	network_modules	111	TRUE	1.6907668085042682e-8	303	33	11	0.3333333333333333	0.036303630363036306	GO:0003012	GO:BP	muscle system process	16175	1463		0.5903614457831325	0.5952380952380952	303	15872	11	22	292	15850	16175	0.10491682998953702
M1	cpdb	0	network_modules	111	TRUE	3.1038221560322635e-8	29	33	6	0.18181818181818182	0.20689655172413793	GO:1901381	GO:BP	positive regulation of potassium ion transmembrane transport	16175	21431		0.6024096385542169	0.6071428571428571	29	16146	6	27	23	16119	16175	0.19240867005082515
M1	cpdb	0	network_modules	111	TRUE	4.014306406938853e-8	113	16	7	0.4375	0.061946902654867256	KEGG:04725	KEGG	Cholinergic synapse	8484	355		0	0.5	113	8371	7	9	106	8362	8484	0.16083973609165472
M1	cpdb	0	network_modules	111	TRUE	6.03364428989458e-8	341	33	11	0.3333333333333333	0.03225806451612903	GO:0043269	GO:BP	regulation of monoatomic ion transport	16175	10593		0.6144578313253012	0.6190476190476191	341	15834	11	22	330	15812	16175	0.09827758945413946
M1	cpdb	0	network_modules	111	TRUE	6.455294471324378e-8	110	33	8	0.24242424242424243	0.07272727272727272	GO:0030048	GO:BP	actin filament-based movement	16175	6667		0.6265060240963856	0.6309523809523809	110	16065	8	25	102	16040	16175	0.129629758507935
M1	cpdb	0	network_modules	111	TRUE	7.234413962933099e-8	65	33	7	0.21212121212121213	0.1076923076923077	GO:1904063	GO:BP	negative regulation of cation transmembrane transport	16175	23502		0.6385542168674698	0.6428571428571429	65	16110	7	26	58	16084	16175	0.14872904219521607
M1	cpdb	0	network_modules	111	TRUE	8.724972463096675e-8	34	33	6	0.18181818181818182	0.17647058823529413	GO:0043268	GO:BP	positive regulation of potassium ion transport	16175	10592		0.6506024096385542	0.6547619047619048	34	16141	6	27	28	16114	16175	0.17742101982707986
M1	cpdb	0	network_modules	111	TRUE	9.011124905814636e-8	354	33	11	0.3333333333333333	0.031073446327683617	GO:0034762	GO:BP	regulation of transmembrane transport	16175	8731		0.6626506024096386	0.6666666666666666	354	15821	11	22	343	15799	16175	0.09624742734078978
M1	cpdb	0	network_modules	111	TRUE	1.2369416614073012e-7	70	33	7	0.21212121212121213	0.1	GO:0034766	GO:BP	negative regulation of monoatomic ion transmembrane transport	16175	8735		0.6746987951807228	0.6785714285714286	70	16105	7	26	63	16079	16175	0.14312821580744783
M1	cpdb	0	network_modules	111	TRUE	1.2920627764896816e-7	15	31	5	0.16129032258064516	0.3333333333333333	REAC:R-HSA-5576893	REAC	Phase 2 - plateau phase	10916	1734		0.6666666666666666	0.7142857142857143	15	10901	5	26	10	10875	10916	0.23037948326304114
M1	cpdb	0	network_modules	111	TRUE	6.38614322242733e-7	88	33	7	0.21212121212121213	0.07954545454545454	GO:0043271	GO:BP	negative regulation of monoatomic ion transport	16175	10595		0.6867469879518072	0.6904761904761905	88	16087	7	26	81	16061	16175	0.12704093499742253
M1	cpdb	0	network_modules	111	TRUE	6.921523186933101e-7	89	33	7	0.21212121212121213	0.07865168539325842	GO:0034763	GO:BP	negative regulation of transmembrane transport	16175	8732		0.6987951807228916	0.7023809523809523	89	16086	7	26	82	16060	16175	0.12629134375497786
M1	cpdb	0	network_modules	111	TRUE	7.578519944187247e-7	7	33	4	0.12121212121212122	0.5714285714285714	GO:1902260	GO:BP	negative regulation of delayed rectifier potassium channel activity	16175	22157		0.7108433734939759	0.7142857142857143	7	16168	4	29	3	16139	16175	0.2625657787438777
M1	cpdb	0	network_modules	111	TRUE	1.5199696508829273e-6	163	33	8	0.24242424242424243	0.049079754601226995	GO:0043270	GO:BP	positive regulation of monoatomic ion transport	16175	10594		0.7228915662650602	0.7261904761904762	163	16012	8	25	155	15987	16175	0.10518238022644537
M1	cpdb	0	network_modules	111	TRUE	2.2193290826164087e-6	358	33	10	0.30303030303030304	0.027932960893854747	GO:0008015	GO:BP	blood circulation	16175	3096		0.7349397590361446	0.7380952380952381	358	15817	10	23	348	15794	16175	0.08633098746897719
M1	cpdb	0	network_modules	111	TRUE	3.9899512592991765e-6	114	33	7	0.21212121212121213	0.06140350877192982	GO:1904064	GO:BP	positive regulation of cation transmembrane transport	16175	23503		0.7469879518072289	0.75	114	16061	7	26	107	16035	16175	0.11083909939293111
M1	cpdb	0	network_modules	111	TRUE	4.228397379146559e-6	63	33	6	0.18181818181818182	0.09523809523809523	GO:0140115	GO:BP	export across plasma membrane	16175	19670		0.7590361445783133	0.7619047619047619	63	16112	6	27	57	16085	16175	0.1291547455634779
M1	cpdb	0	network_modules	111	TRUE	4.527569911302502e-6	10	33	4	0.12121212121212122	0.4	GO:1903817	GO:BP	negative regulation of voltage-gated potassium channel activity	16175	23304		0.7710843373493976	0.7738095238095238	10	16165	4	29	6	16136	16175	0.21936130101981535
M1	cpdb	0	network_modules	111	TRUE	6.382069032263345e-6	31	33	5	0.15151515151515152	0.16129032258064516	GO:2001258	GO:BP	negative regulation of cation channel activity	16175	26444		0.7831325301204819	0.7857142857142857	31	16144	5	28	26	16116	16175	0.1546549180918594
M1	cpdb	0	network_modules	111	TRUE	8.986456876105269e-6	128	33	7	0.21212121212121213	0.0546875	GO:0034767	GO:BP	positive regulation of monoatomic ion transmembrane transport	16175	8736		0.7951807228915663	0.7976190476190477	128	16047	7	26	121	16021	16175	0.10420604897609848
M1	cpdb	0	network_modules	111	TRUE	1.1722746181335134e-5	3	33	3	0.09090909090909091	1	GO:1903765	GO:BP	negative regulation of potassium ion export across plasma membrane	16175	23259		0.8072289156626506	0.8095238095238095	3	16172	3	30	0	16142	16175	0.3012315542258971
M1	cpdb	0	network_modules	111	TRUE	1.5701014787315382e-5	439	33	10	0.30303030303030304	0.022779043280182234	GO:0003013	GO:BP	circulatory system process	16175	1464		0.8192771084337349	0.8214285714285714	439	15736	10	23	429	15713	16175	0.07676770697123393
M1	cpdb	0	network_modules	111	TRUE	1.9959852293739534e-5	130	31	7	0.22580645161290322	0.05384615384615385	REAC:R-HSA-5576891	REAC	Cardiac conduction	10916	306		0.8333333333333334	0.8571428571428571	130	10786	7	24	123	10762	10916	0.10522856095324812
M1	cpdb	0	network_modules	111	TRUE	3.8902403628716714e-5	16	33	4	0.12121212121212122	0.25	GO:1901017	GO:BP	negative regulation of potassium ion transmembrane transporter activity	16175	21139		0.8313253012048193	0.8333333333333334	16	16159	4	29	12	16130	16175	0.17291899453749424
M1	cpdb	0	network_modules	111	TRUE	6.975431462610769e-5	172	33	7	0.21212121212121213	0.040697674418604654	GO:0034764	GO:BP	positive regulation of transmembrane transport	16175	8733		0.8433734939759037	0.8452380952380952	172	16003	7	26	165	15977	16175	0.08881898566938165
M1	cpdb	0	network_modules	111	TRUE	7.742858938652322e-5	50	33	5	0.15151515151515152	0.1	GO:0032413	GO:BP	negative regulation of ion transmembrane transporter activity	16175	7551		0.8554216867469879	0.8571428571428571	50	16125	5	28	45	16097	16175	0.12089037997066931
M1	cpdb	0	network_modules	111	TRUE	1.2621378987228378e-4	55	33	5	0.15151515151515152	0.09090909090909091	GO:0086065	GO:BP	cell communication involved in cardiac conduction	16175	17919		0.8674698795180723	0.8690476190476191	55	16120	5	28	50	16092	16175	0.11504223358518988
M1	cpdb	0	network_modules	111	TRUE	1.5147507500476695e-4	57	33	5	0.15151515151515152	0.08771929824561403	GO:0032410	GO:BP	negative regulation of transporter activity	16175	7548		0.8795180722891566	0.8809523809523809	57	16118	5	28	52	16090	16175	0.1129185936759446
M1	cpdb	0	network_modules	111	TRUE	2.1404978468248122e-4	307	33	8	0.24242424242424243	0.026058631921824105	GO:0051051	GO:BP	negative regulation of transport	16175	13461		0.891566265060241	0.8928571428571429	307	15868	8	25	299	15843	16175	0.07403918898436737
M1	cpdb	0	network_modules	111	TRUE	4.0801765600043366e-4	7	33	3	0.09090909090909091	0.42857142857142855	GO:1903764	GO:BP	regulation of potassium ion export across plasma membrane	16175	23258		0.9036144578313253	0.9166666666666666	7	16168	3	30	4	16138	16175	0.19668913305087454
M1	cpdb	0	network_modules	111	TRUE	4.0801765600043366e-4	7	33	3	0.09090909090909091	0.42857142857142855	GO:0060372	GO:BP	regulation of atrial cardiac muscle cell membrane repolarization	16175	14580		0.9036144578313253	0.9166666666666666	7	16168	3	30	4	16138	16175	0.19668913305087454
M1	cpdb	0	network_modules	111	TRUE	4.1628607187882205e-4	203	31	7	0.22580645161290322	0.034482758620689655	REAC:R-HSA-397014	REAC	Muscle contraction	10916	1496		1	1	203	10713	7	24	196	10689	10916	0.08185346692045273
M1	cpdb	0	network_modules	111	TRUE	4.175933887546484e-4	153	16	5	0.3125	0.032679738562091505	KEGG:04261	KEGG	Adrenergic signaling in cardiomyocytes	8484	297		1	1	153	8331	5	11	148	8320	8484	0.09618584842034086
M1	cpdb	0	network_modules	111	TRUE	6.582359329961394e-4	31	33	4	0.12121212121212122	0.12903225806451613	GO:0086019	GO:BP	cell-cell signaling involved in cardiac conduction	16175	17893		0.927710843373494	0.9285714285714286	31	16144	4	29	27	16115	16175	0.12332767143384427
M1	cpdb	0	network_modules	111	TRUE	0.0013930881492977857	10	33	3	0.09090909090909091	0.3	GO:0099624	GO:BP	atrial cardiac muscle cell membrane repolarization	16175	19169		0.9397590361445783	0.9404761904761905	10	16165	3	30	7	16135	16175	0.1642398307076278
M1	cpdb	0	network_modules	111	TRUE	0.0026889565567294236	101	33	5	0.15151515151515152	0.04950495049504951	GO:0007605	GO:BP	sensory perception of sound	16175	3064		0.9518072289156626	0.9523809523809523	101	16074	5	28	96	16046	16175	0.08338322495716534
M1	cpdb	0	network_modules	111	TRUE	0.003341059171379381	46	33	4	0.12121212121212122	0.08695652173913043	GO:0098900	GO:BP	regulation of action potential	16175	18933		0.963855421686747	0.9642857142857143	46	16129	4	29	42	16100	16175	0.10050208947166679
M1	cpdb	0	network_modules	111	TRUE	0.003577767020307057	107	33	5	0.15151515151515152	0.04672897196261682	GO:0050954	GO:BP	sensory perception of mechanical stimulus	16175	13396		0.9759036144578314	0.9761904761904762	107	16068	5	28	102	16040	16175	0.08081987733061459
M1	cpdb	0	network_modules	111	TRUE	0.005328058627066485	116	33	5	0.15151515151515152	0.04310344827586207	GO:0006937	GO:BP	regulation of muscle contraction	16175	2576		0.9879518072289156	0.9880952380952381	116	16059	5	28	111	16031	16175	0.07734492952082594
M1	cpdb	0	network_modules	111	TRUE	0.006593990875879223	653	33	9	0.2727272727272727	0.013782542113323124	GO:0051050	GO:BP	positive regulation of transport	16175	13460		1	1	653	15522	9	24	644	15498	16175	0.053376078796511066
M1	cpdb	0	network_modules	112	TRUE	1.784362109698982e-30	25	25	14	0.56	0.56	REAC:R-HSA-8982491	REAC	Glycogen metabolism	10916	1064		0	0.07142857142857142	25	10891	14	11	11	10880	10916	0.5589899917362959
M1	cpdb	0	network_modules	112	TRUE	1.2316398265964405e-24	52	32	14	0.4375	0.2692307692307692	GO:0005977	GO:BP	glycogen metabolic process	16175	1852		0	0.047619047619047616	52	16123	14	18	38	16105	16175	0.3415682918705678
M1	cpdb	0	network_modules	112	TRUE	1.6720234627043638e-24	53	32	14	0.4375	0.2641509433962264	GO:0044042	GO:BP	glucan metabolic process	16175	10891		0.05	0.09523809523809523	53	16122	14	18	39	16104	16175	0.3382929318864636
M1	cpdb	0	network_modules	112	TRUE	2.0036234559932012e-23	62	32	14	0.4375	0.22580645161290322	GO:0006112	GO:BP	energy reserve metabolic process	16175	1971		0.1	0.14285714285714285	62	16113	14	18	48	16095	16175	0.3124635816695314
M1	cpdb	0	network_modules	112	TRUE	1.6431291089789432e-22	71	32	14	0.4375	0.19718309859154928	GO:0005976	GO:BP	polysaccharide metabolic process	16175	1851		0.15	0.19047619047619047	71	16104	14	18	57	16086	16175	0.2916955625714821
M1	cpdb	0	network_modules	112	TRUE	1.7387762460958133e-22	14	25	10	0.4	0.7142857142857143	REAC:R-HSA-70221	REAC	Glycogen breakdown (glycogenolysis)	10916	1063		0.07692307692307693	0.14285714285714285	14	10902	10	15	4	10887	10916	0.533762206891424
M1	cpdb	0	network_modules	112	TRUE	2.265865878898403e-15	367	32	16	0.5	0.043596730245231606	GO:0005975	GO:BP	carbohydrate metabolic process	16175	1850		0.2	0.23809523809523808	367	15808	16	16	351	15792	16175	0.1427107857535398
M1	cpdb	0	network_modules	112	TRUE	3.226054048721514e-15	137	21	12	0.5714285714285714	0.08759124087591241	KEGG:04910	KEGG	Insulin signaling pathway	8484	367		0	0.2	137	8347	12	9	125	8338	8484	0.21944975020792368
M1	cpdb	0	network_modules	112	TRUE	1.867448917849538e-14	252	32	14	0.4375	0.05555555555555555	GO:0015980	GO:BP	energy derivation by oxidation of organic compounds	16175	5060		0.25	0.2857142857142857	252	15923	14	18	238	15905	16175	0.15168581287531036
M1	cpdb	0	network_modules	112	TRUE	7.001409778067836e-14	288	25	14	0.56	0.04861111111111111	REAC:R-HSA-71387	REAC	Metabolism of carbohydrates	10916	1422		0.15384615384615385	0.21428571428571427	288	10628	14	11	274	10617	10916	0.15951703034183923
M1	cpdb	0	network_modules	112	TRUE	1.1741001378532582e-13	372	32	15	0.46875	0.04032258064516129	GO:0006091	GO:BP	generation of precursor metabolites and energy	16175	1954		0.3	0.3333333333333333	372	15803	15	17	357	15786	16175	0.13239719155923607
M1	cpdb	0	network_modules	112	TRUE	5.747846450880002e-13	36	21	8	0.38095238095238093	0.2222222222222222	KEGG:00500	KEGG	Starch and sucrose metabolism	8484	62		0.25	0.4	36	8448	8	13	28	8435	8484	0.28868621375659265
M1	cpdb	0	network_modules	112	TRUE	1.3422272794965882e-12	107	21	10	0.47619047619047616	0.09345794392523364	KEGG:04922	KEGG	Glucagon signaling pathway	8484	379		0.5	0.6	107	8377	10	11	97	8366	8484	0.2069356315335922
M1	cpdb	0	network_modules	112	TRUE	7.885200018388951e-11	14	25	6	0.24	0.42857142857142855	REAC:R-HSA-3322077	REAC	Glycogen synthesis	10916	1073		0.23076923076923078	0.2857142857142857	14	10902	6	19	8	10883	10916	0.31957056088731467
M1	cpdb	0	network_modules	112	TRUE	1.312237484476769e-10	15	25	6	0.24	0.4	REAC:R-HSA-3229121	REAC	Glycogen storage diseases	10916	1072		0.3076923076923077	0.35714285714285715	15	10901	6	19	9	10882	10916	0.3086301701457973
M1	cpdb	0	network_modules	112	TRUE	8.524502749681747e-10	37	32	7	0.21875	0.1891891891891892	GO:0005978	GO:BP	glycogen biosynthetic process	16175	1853		0.35	0.42857142857142855	37	16138	7	25	30	16113	16175	0.2017363441146625
M1	cpdb	0	network_modules	112	TRUE	8.524502749681747e-10	37	32	7	0.21875	0.1891891891891892	GO:0009250	GO:BP	glucan biosynthetic process	16175	3415		0.35	0.42857142857142855	37	16138	7	25	30	16113	16175	0.2017363441146625
M1	cpdb	0	network_modules	112	TRUE	8.03718465887326e-9	10	32	5	0.15625	0.5	GO:0005980	GO:BP	glycogen catabolic process	16175	1855		0.45	0.47619047619047616	10	16165	5	27	5	16138	16175	0.2787645439035011
M1	cpdb	0	network_modules	112	TRUE	1.2488986728355742e-8	53	32	7	0.21875	0.1320754716981132	GO:0000271	GO:BP	polysaccharide biosynthetic process	16175	74		0.5	0.5238095238095238	53	16122	7	25	46	16097	16175	0.16787008195789796
M1	cpdb	0	network_modules	112	TRUE	1.4714334170874257e-8	11	32	5	0.15625	0.45454545454545453	GO:0000272	GO:BP	polysaccharide catabolic process	16175	75		0.55	0.6190476190476191	11	16164	5	27	6	16137	16175	0.26569419800518035
M1	cpdb	0	network_modules	112	TRUE	1.4714334170874257e-8	11	32	5	0.15625	0.45454545454545453	GO:0009251	GO:BP	glucan catabolic process	16175	3416		0.55	0.6190476190476191	11	16164	5	27	6	16137	16175	0.26569419800518035
M1	cpdb	0	network_modules	112	TRUE	2.8267726749326854e-8	33	25	6	0.24	0.18181818181818182	REAC:R-HSA-5663084	REAC	Diseases of carbohydrate metabolism	10916	763		0.38461538461538464	0.42857142857142855	33	10883	6	19	27	10864	10916	0.20681136857091945
M1	cpdb	0	network_modules	112	TRUE	2.8774322034316115e-7	108	21	7	0.3333333333333333	0.06481481481481481	KEGG:04931	KEGG	Insulin resistance	8484	388		0.75	0.8	108	8376	7	14	101	8362	8484	0.14245777891082337
M1	cpdb	0	network_modules	112	TRUE	3.736711166686402e-6	3	25	3	0.12	1	REAC:R-HSA-3878781	REAC	Glycogen storage disease type IV (GBE1)	10916	1068		0.46153846153846156	0.5	3	10913	3	22	0	10891	10916	0.34606081356548346
M1	cpdb	0	network_modules	112	TRUE	1.034359957176631e-5	3	32	3	0.09375	1	GO:1902267	GO:BP	regulation of polyamine transmembrane transport	16175	22163		0.65	0.6666666666666666	3	16172	3	29	0	16143	16175	0.3059115646022684
M1	cpdb	0	network_modules	112	TRUE	1.815414966303312e-5	147	32	7	0.21875	0.047619047619047616	GO:0016051	GO:BP	carbohydrate biosynthetic process	16175	5083		0.7	0.7142857142857143	147	16028	7	25	140	16003	16175	0.09836675397469777
M1	cpdb	0	network_modules	112	TRUE	4.335680017160987e-5	17	32	4	0.125	0.23529411764705882	GO:0006595	GO:BP	polyamine metabolic process	16175	2312		0.75	0.7619047619047619	17	16158	4	28	13	16130	16175	0.17031460968341863
M1	cpdb	0	network_modules	112	TRUE	6.125350748858789e-5	58	25	5	0.2	0.08620689655172414	REAC:R-HSA-351202	REAC	Metabolism of polyamines	10916	1433		0.5384615384615384	0.5714285714285714	58	10858	5	20	53	10838	10916	0.1283060151436427
M1	cpdb	0	network_modules	112	TRUE	3.110472009820973e-4	9	25	3	0.12	0.3333333333333333	REAC:R-HSA-3785653	REAC	Myoclonic epilepsy of Lafora	10916	1503		0.6153846153846154	0.6428571428571429	9	10907	3	22	6	10885	10916	0.19893573576338952
M1	cpdb	0	network_modules	112	TRUE	5.753571925095902e-4	8	32	3	0.09375	0.375	GO:1902047	GO:BP	polyamine transmembrane transport	16175	21970		0.8	0.8095238095238095	8	16167	3	29	5	16138	16175	0.18674177234759662
M1	cpdb	0	network_modules	112	TRUE	0.001688419813370325	11	32	3	0.09375	0.2727272727272727	GO:0006596	GO:BP	polyamine biosynthetic process	16175	2313		0.85	0.8571428571428571	11	16164	3	29	8	16135	16175	0.15895193423622508
M1	cpdb	0	network_modules	112	TRUE	0.0017509585324191309	51	25	4	0.16	0.0784313725490196	REAC:R-HSA-350562	REAC	Regulation of ornithine decarboxylase (ODC)	10916	2046		0.6923076923076923	0.7142857142857143	51	10865	4	21	47	10844	10916	0.10913130146777614
M1	cpdb	0	network_modules	112	TRUE	0.0017731506814441475	2	25	2	0.08	1	REAC:R-HSA-3828062	REAC	Glycogen storage disease type 0 (muscle GYS1)	10916	1066		0.7692307692307693	0.9285714285714286	2	10914	2	23	0	10891	10916	0.28254452604712355
M1	cpdb	0	network_modules	112	TRUE	0.0017731506814441475	2	25	2	0.08	1	REAC:R-HSA-3858516	REAC	Glycogen storage disease type 0 (liver GYS2)	10916	1065		0.7692307692307693	0.9285714285714286	2	10914	2	23	0	10891	10916	0.28254452604712355
M1	cpdb	0	network_modules	112	TRUE	0.0017731506814441475	2	25	2	0.08	1	REAC:R-HSA-3814836	REAC	Glycogen storage disease type XV (GYG1)	10916	1071		0.7692307692307693	0.9285714285714286	2	10914	2	23	0	10891	10916	0.28254452604712355
M1	cpdb	0	network_modules	112	TRUE	0.0037097536379917273	14	32	3	0.09375	0.21428571428571427	GO:0015846	GO:BP	polyamine transport	16175	4955		0.9	0.9047619047619048	14	16161	3	29	11	16132	16175	0.14062810170400844
M1	cpdb	0	network_modules	112	TRUE	0.0052405168701410935	245	25	6	0.24	0.024489795918367346	REAC:R-HSA-5668914	REAC	Diseases of metabolism	10916	767		1	1	245	10671	6	19	239	10652	10916	0.07036956695122239
M1	cpdb	0	network_modules	112	TRUE	0.005576234529139214	2	32	2	0.0625	1	GO:1902269	GO:BP	positive regulation of polyamine transmembrane transport	16175	22165		0.95	0.9523809523809523	2	16173	2	30	0	16143	16175	0.2497680244466571
M1	cpdb	0	network_modules	112	TRUE	0.005599427479046993	6	21	2	0.09523809523809523	0.3333333333333333	KEGG:00440	KEGG	Phosphonate and phosphinate metabolism	8484	57		1	1	6	8478	2	19	4	8459	8484	0.1771330146082941
M1	cpdb	0	network_modules	112	TRUE	0.0058872742662239115	123	32	5	0.15625	0.04065040650406504	GO:0016052	GO:BP	carbohydrate catabolic process	16175	5084		1	1	123	16052	5	27	118	16025	16175	0.07618374077016095
M1	cpdb	0	network_modules	113	TRUE	7.99111191907807e-5	5	28	3	0.10714285714285714	0.6	GO:0046391	GO:BP	5-phosphoribose 1-diphosphate metabolic process	16175	12118		0	0.5	5	16170	3	25	2	16145	16175	0.2530729892717718
M1	cpdb	0	network_modules	113	TRUE	7.99111191907807e-5	5	28	3	0.10714285714285714	0.6	GO:0006015	GO:BP	5-phosphoribose 1-diphosphate biosynthetic process	16175	1888		0	0.5	5	16170	3	25	2	16145	16175	0.2530729892717718
M1	cpdb	0	network_modules	113	TRUE	0.0013093888251545815	11	28	3	0.10714285714285714	0.2727272727272727	GO:0097354	GO:BP	prenylation	16175	18621		0.6666666666666666	1	11	16164	3	25	8	16139	16175	0.17006090420272324
M1	cpdb	0	network_modules	113	TRUE	0.0013093888251545815	11	28	3	0.10714285714285714	0.2727272727272727	GO:0018342	GO:BP	protein prenylation	16175	5409		0.6666666666666666	1	11	16164	3	25	8	16139	16175	0.17006090420272324
M1	cpdb	0	network_modules	113	TRUE	0.009947148201801329	22	8	2	0.25	0.09090909090909091	KEGG:00900	KEGG	Terpenoid backbone biosynthesis	8484	129		NA	1	22	8462	2	6	20	8456	8484	0.14945625893258527
M1	cpdb	0	network_modules	114	TRUE	5.02638390126151e-5	35	16	4	0.25	0.11428571428571428	REAC:R-HSA-432720	REAC	Lysosome Vesicle Biogenesis	10916	1341		0	0.5	35	10881	4	12	31	10869	10916	0.16725376638448985
M1	cpdb	0	network_modules	114	TRUE	9.558997176631463e-4	72	16	4	0.25	0.05555555555555555	REAC:R-HSA-199992	REAC	trans-Golgi Network Vesicle Budding	10916	2749		1	1	72	10844	4	12	68	10832	10916	0.11520658256331713
M1	cpdb	0	network_modules	114	TRUE	0.0014363410327922212	131	12	4	0.3333333333333333	0.030534351145038167	KEGG:04142	KEGG	Lysosome	8484	279		NA	1	131	8353	4	8	127	8345	8484	0.0970335023959429
M1	cpdb	0	network_modules	115	TRUE	8.87459385282765e-45	244	33	30	0.9090909090909091	0.12295081967213115	REAC:R-HSA-8951664	REAC	Neddylation	10916	1559		0	0.043478260869565216	244	10672	30	3	214	10669	10916	0.33031163851423295
M1	cpdb	0	network_modules	115	TRUE	5.988000045368223e-30	667	32	27	0.84375	0.04047976011994003	GO:0032446	GO:BP	protein modification by small protein conjugation	16175	7568		0	0.03125	667	15508	27	5	640	15503	16175	0.17969612080265182
M1	cpdb	0	network_modules	115	TRUE	7.110486405870333e-30	798	32	28	0.875	0.03508771929824561	GO:0043687	GO:BP	post-translational protein modification	16175	10838		0.03225806451612903	0.0625	798	15377	28	4	770	15373	16175	0.169743663125402
M1	cpdb	0	network_modules	115	TRUE	1.4173463540507593e-28	749	32	27	0.84375	0.036048064085447265	GO:0070647	GO:BP	protein modification by small protein conjugation or removal	16175	16231		0.06451612903225806	0.09375	749	15426	27	5	722	15421	16175	0.16895060930148792
M1	cpdb	0	network_modules	115	TRUE	1.2910703534453953e-26	140	17	16	0.9411764705882353	0.11428571428571428	KEGG:04120	KEGG	Ubiquitin mediated proteolysis	8484	270		0	0.2	140	8344	16	1	124	8343	8484	0.32523569714371053
M1	cpdb	0	network_modules	115	TRUE	4.1089766514443663e-26	29	32	13	0.40625	0.4482758620689655	GO:0045116	GO:BP	protein neddylation	16175	11286		0.0967741935483871	0.125	29	16146	13	19	16	16127	16175	0.4256652098010336
M1	cpdb	0	network_modules	115	TRUE	6.909207703183072e-25	38	33	14	0.42424242424242425	0.3684210526315789	REAC:R-HSA-5696394	REAC	DNA Damage Recognition in GG-NER	10916	439		0.045454545454545456	0.08695652173913043	38	10878	14	19	24	10859	10916	0.39338304758574133
M1	cpdb	0	network_modules	115	TRUE	1.235433814723788e-22	52	33	14	0.42424242424242425	0.2692307692307692	REAC:R-HSA-6781823	REAC	Formation of TC-NER Pre-Incision Complex	10916	951		0.09090909090909091	0.13043478260869565	52	10864	14	19	38	10845	10916	0.3354745837270012
M1	cpdb	0	network_modules	115	TRUE	1.085891207187708e-20	11	32	9	0.28125	0.8181818181818182	GO:0000338	GO:BP	protein deneddylation	16175	95		0.12903225806451613	0.15625	11	16164	9	23	2	16141	16175	0.4791787255430908
M1	cpdb	0	network_modules	115	TRUE	5.1390477797008395e-20	20	32	10	0.3125	0.5	GO:2000434	GO:BP	regulation of protein neddylation	16175	25749		0.16129032258064516	0.1875	20	16155	10	22	10	16133	16175	0.39435459548127866
M1	cpdb	0	network_modules	115	TRUE	5.631521286449841e-20	77	33	14	0.42424242424242425	0.18181818181818182	REAC:R-HSA-6781827	REAC	Transcription-Coupled Nucleotide Excision Repair (TC-NER)	10916	2541		0.13636363636363635	0.17391304347826086	77	10839	14	19	63	10820	10916	0.27449763103169816
M1	cpdb	0	network_modules	115	TRUE	1.1361091889457387e-19	109	33	15	0.45454545454545453	0.13761467889908258	REAC:R-HSA-5696398	REAC	Nucleotide Excision Repair	10916	1622		0.18181818181818182	0.21739130434782608	109	10807	15	18	94	10789	10916	0.24621292681026663
M1	cpdb	0	network_modules	115	TRUE	2.1035395386716042e-19	84	33	14	0.42424242424242425	0.16666666666666666	REAC:R-HSA-5696399	REAC	Global Genome Nucleotide Excision Repair (GG-NER)	10916	1047		0.22727272727272727	0.2608695652173913	84	10832	14	19	70	10813	10916	0.2624922799994317
M1	cpdb	0	network_modules	115	TRUE	1.1357041562000404e-15	547	32	18	0.5625	0.03290676416819013	GO:0006511	GO:BP	ubiquitin-dependent protein catabolic process	16175	2235		0.1935483870967742	0.21875	547	15628	18	14	529	15614	16175	0.13021968104600587
M1	cpdb	0	network_modules	115	TRUE	1.394464704760109e-15	673	32	19	0.59375	0.02823179791976226	GO:0051603	GO:BP	proteolysis involved in protein catabolic process	16175	13820		0.22580645161290322	0.25	673	15502	19	13	654	15489	16175	0.12310537002887238
M1	cpdb	0	network_modules	115	TRUE	1.4710057975708503e-15	555	32	18	0.5625	0.032432432432432434	GO:0019941	GO:BP	modification-dependent protein catabolic process	16175	6072		0.25806451612903225	0.28125	555	15620	18	14	537	15606	16175	0.1291898833569242
M1	cpdb	0	network_modules	115	TRUE	1.6716947689063472e-15	559	32	18	0.5625	0.03220035778175313	GO:0043632	GO:BP	modification-dependent macromolecule catabolic process	16175	10812		0.2903225806451613	0.3125	559	15616	18	14	541	15602	16175	0.1286830441069694
M1	cpdb	0	network_modules	115	TRUE	6.54333155213374e-14	206	32	13	0.40625	0.06310679611650485	GO:1903320	GO:BP	regulation of protein modification by small protein conjugation or removal	16175	22904		0.3225806451612903	0.34375	206	15969	13	19	193	15950	16175	0.1562482636410827
M1	cpdb	0	network_modules	115	TRUE	7.914963713343662e-14	209	32	13	0.40625	0.06220095693779904	GO:1901873	GO:BP	regulation of post-translational protein modification	16175	21817		0.3548387096774194	0.375	209	15966	13	19	196	15947	16175	0.1550642649156882
M1	cpdb	0	network_modules	115	TRUE	8.146491126170764e-14	363	32	15	0.46875	0.04132231404958678	GO:0043161	GO:BP	proteasome-mediated ubiquitin-dependent protein catabolic process	16175	10561		0.3870967741935484	0.40625	363	15812	15	17	348	15795	16175	0.1341575356955195
M1	cpdb	0	network_modules	115	TRUE	8.343666237539252e-14	329	33	16	0.48484848484848486	0.0486322188449848	REAC:R-HSA-73894	REAC	DNA Repair	10916	444		0.2727272727272727	0.30434782608695654	329	10587	16	17	313	10570	10916	0.14645208399087514
M1	cpdb	0	network_modules	115	TRUE	1.1572169321746066e-13	470	32	16	0.5	0.03404255319148936	GO:0010498	GO:BP	proteasomal protein catabolic process	16175	4177		0.41935483870967744	0.4375	470	15705	16	16	454	15689	16175	0.12483243135777472
M1	cpdb	0	network_modules	115	TRUE	4.1350965185644925e-12	590	32	16	0.5	0.02711864406779661	GO:0016567	GO:BP	protein ubiquitination	16175	5254		0.45161290322580644	0.46875	590	15585	16	16	574	15569	16175	0.1100829175099009
M1	cpdb	0	network_modules	115	TRUE	1.0766991585433082e-10	104	33	10	0.30303030303030304	0.09615384615384616	REAC:R-HSA-8856825	REAC	Cargo recognition for clathrin-mediated endocytosis	10916	309		0.3181818181818182	0.34782608695652173	104	10812	10	23	94	10789	10916	0.16637537382130826
M1	cpdb	0	network_modules	115	TRUE	7.422155156390982e-10	109	32	9	0.28125	0.08256880733944955	GO:0070646	GO:BP	protein modification by small protein removal	16175	16230		0.4838709677419355	0.5	109	16066	9	23	100	16043	16175	0.14938950970255843
M1	cpdb	0	network_modules	115	TRUE	2.9302190001514555e-9	144	33	10	0.30303030303030304	0.06944444444444445	REAC:R-HSA-8856828	REAC	Clathrin-mediated endocytosis	10916	372		0.36363636363636365	0.391304347826087	144	10772	10	23	134	10749	10916	0.139885620533184
M1	cpdb	0	network_modules	115	TRUE	3.6858300067802596e-9	210	17	9	0.5294117647058824	0.04285714285714286	KEGG:05170	KEGG	Human immunodeficiency virus 1 infection	8484	451		0.25	0.4	210	8274	9	8	201	8266	8484	0.14554296123695976
M1	cpdb	0	network_modules	115	TRUE	7.650320463162727e-8	61	17	6	0.35294117647058826	0.09836065573770492	KEGG:03420	KEGG	Nucleotide excision repair	8484	238		0.5	0.6	61	8423	6	11	55	8412	8484	0.18336890155308952
M1	cpdb	0	network_modules	115	TRUE	2.9596270666794083e-7	308	33	11	0.3333333333333333	0.03571428571428571	REAC:R-HSA-983168	REAC	Antigen processing: Ubiquitination & Proteasome degradation	10916	154		0.4090909090909091	0.43478260869565216	308	10608	11	22	297	10586	10916	0.10146627388850114
M1	cpdb	0	network_modules	115	TRUE	2.6947979102992142e-6	380	33	11	0.3333333333333333	0.02894736842105263	REAC:R-HSA-983169	REAC	Class I MHC mediated antigen processing & presentation	10916	368		0.45454545454545453	0.4782608695652174	380	10536	11	22	369	10514	10916	0.08967944549009045
M1	cpdb	0	network_modules	115	TRUE	6.5359006529849475e-6	300	32	9	0.28125	0.03	GO:0009314	GO:BP	response to radiation	16175	3460		0.5161290322580645	0.53125	300	15875	9	23	291	15852	16175	0.08669108941455145
M1	cpdb	0	network_modules	115	TRUE	7.304190200605364e-6	129	32	7	0.21875	0.05426356589147287	GO:0009411	GO:BP	response to UV	16175	3476		0.5483870967741935	0.5625	129	16046	7	25	122	16021	16175	0.1055036407606649
M1	cpdb	0	network_modules	115	TRUE	8.747656258796601e-6	30	33	5	0.15151515151515152	0.16666666666666666	REAC:R-HSA-110314	REAC	Recognition of DNA damage by PCNA-containing replication complex	10916	1948		0.5	0.5217391304347826	30	10886	5	28	25	10858	10916	0.1564795830244039
M1	cpdb	0	network_modules	115	TRUE	1.0015506927166473e-5	68	17	5	0.29411764705882354	0.07352941176470588	KEGG:05211	KEGG	Renal cell carcinoma	8484	462		0.75	0.8	68	8416	5	12	63	8404	8484	0.14377214905303204
M1	cpdb	0	network_modules	115	TRUE	1.2045639254827542e-5	220	32	8	0.25	0.03636363636363636	GO:0009416	GO:BP	response to light stimulus	16175	3480		0.5806451612903226	0.59375	220	15955	8	24	212	15931	16175	0.09086834350304523
M1	cpdb	0	network_modules	115	TRUE	2.932155071479204e-5	43	32	5	0.15625	0.11627906976744186	GO:0031146	GO:BP	SCF-dependent proteasomal ubiquitin-dependent protein catabolic process	16175	7064		0.6129032258064516	0.625	43	16132	5	27	38	16105	16175	0.1328055481764893
M1	cpdb	0	network_modules	115	TRUE	4.4930248075238024e-5	41	33	5	0.15151515151515152	0.12195121951219512	REAC:R-HSA-5696400	REAC	Dual Incision in GG-NER	10916	807		0.5454545454545454	0.5652173913043478	41	10875	5	28	36	10847	10916	0.13301301671267274
M1	cpdb	0	network_modules	115	TRUE	5.7465955819266e-5	43	33	5	0.15151515151515152	0.11627906976744186	REAC:R-HSA-5696395	REAC	Formation of Incision Complex in GG-NER	10916	948		0.5909090909090909	0.6086956521739131	43	10873	5	28	38	10845	10916	0.12973373916551117
M1	cpdb	0	network_modules	115	TRUE	7.940113460773995e-5	182	32	7	0.21875	0.038461538461538464	GO:0045732	GO:BP	positive regulation of protein catabolic process	16175	11573		0.6451612903225806	0.65625	182	15993	7	25	175	15968	16175	0.08758718122793588
M1	cpdb	0	network_modules	115	TRUE	1.0113343904345148e-4	48	33	5	0.15151515151515152	0.10416666666666667	REAC:R-HSA-73893	REAC	DNA Damage Bypass	10916	438		0.6363636363636364	0.6521739130434783	48	10868	5	28	43	10840	10916	0.12243804129212602
M1	cpdb	0	network_modules	115	TRUE	1.0691814787517739e-4	109	17	5	0.29411764705882354	0.045871559633027525	KEGG:04066	KEGG	HIF-1 signaling pathway	8484	257		1	1	109	8375	5	12	104	8363	8484	0.11191234465571287
M1	cpdb	0	network_modules	115	TRUE	2.0722462186394846e-4	23	33	4	0.12121212121212122	0.17391304347826086	REAC:R-HSA-9013422	REAC	RHOBTB1 GTPase cycle	10916	1862		0.6818181818181818	0.6956521739130435	23	10893	4	29	19	10864	10916	0.14303389063618555
M1	cpdb	0	network_modules	115	TRUE	4.0201337768255987e-4	63	33	5	0.15151515151515152	0.07936507936507936	REAC:R-HSA-6782210	REAC	Gap-filling DNA repair synthesis and ligation in TC-NER	10916	1038		0.7272727272727273	0.7391304347826086	63	10853	5	28	58	10825	10916	0.10594759795904023
M1	cpdb	0	network_modules	115	TRUE	4.3514886491033135e-4	64	33	5	0.15151515151515152	0.078125	REAC:R-HSA-6782135	REAC	Dual incision in TC-NER	10916	808		0.7727272727272727	0.782608695652174	64	10852	5	28	59	10824	10916	0.10505539156441962
M1	cpdb	0	network_modules	115	TRUE	5.07870275006683e-4	66	33	5	0.15151515151515152	0.07575757575757576	REAC:R-HSA-1234176	REAC	Oxygen-dependent proline hydroxylation of Hypoxia-inducible Factor Alpha	10916	1655		0.8181818181818182	0.8260869565217391	66	10850	5	28	61	10822	10916	0.10333078801791751
M1	cpdb	0	network_modules	115	TRUE	6.531820658311361e-4	248	32	7	0.21875	0.028225806451612902	GO:0000209	GO:BP	protein polyubiquitination	16175	59		0.6774193548387096	0.6875	248	15927	7	25	241	15902	16175	0.07370943087413104
M1	cpdb	0	network_modules	115	TRUE	6.651361982652469e-4	370	32	8	0.25	0.021621621621621623	GO:0044772	GO:BP	mitotic cell cycle phase transition	16175	11148		0.7096774193548387	0.71875	370	15805	8	24	362	15781	16175	0.06763855995039442
M1	cpdb	0	network_modules	115	TRUE	7.402050384186505e-4	81	32	5	0.15625	0.06172839506172839	GO:0034644	GO:BP	cellular response to UV	16175	8706		0.7419354838709677	0.75	81	16094	5	27	76	16067	16175	0.09539505002285187
M1	cpdb	0	network_modules	115	TRUE	8.741099893505283e-4	701	32	10	0.3125	0.014265335235378032	GO:0009628	GO:BP	response to abiotic stimulus	16175	3549		0.7741935483870968	0.78125	701	15474	10	22	691	15452	16175	0.05885451883310598
M1	cpdb	0	network_modules	115	TRUE	9.620853354986707e-4	75	33	5	0.15151515151515152	0.06666666666666667	REAC:R-HSA-1234174	REAC	Cellular response to hypoxia	10916	335		0.8636363636363636	0.8695652173913043	75	10841	5	28	70	10813	10916	0.09642348229539427
M1	cpdb	0	network_modules	115	TRUE	0.0011944390267822045	35	33	4	0.12121212121212122	0.11428571428571428	REAC:R-HSA-9706574	REAC	RHOBTB GTPase Cycle	10916	1861		0.9090909090909091	0.9130434782608695	35	10881	4	29	31	10852	10916	0.11494264236309804
M1	cpdb	0	network_modules	115	TRUE	0.0014386360466176868	11	33	3	0.09090909090909091	0.2727272727272727	REAC:R-HSA-9708530	REAC	Regulation of BACH1 activity	10916	1965		0.9545454545454546	0.9565217391304348	11	10905	3	30	8	10875	10916	0.1560283225067308
M1	cpdb	0	network_modules	115	TRUE	0.002248199685490826	12	32	3	0.09375	0.25	GO:0070914	GO:BP	UV-damage excision repair	16175	16369		0.8064516129032258	0.84375	12	16163	3	29	9	16134	16175	0.152088503044477
M1	cpdb	0	network_modules	115	TRUE	0.002248199685490826	12	32	3	0.09375	0.25	GO:0140627	GO:BP	ubiquitin-dependent protein catabolic process via the C-end degron rule pathway	16175	19838		0.8064516129032258	0.84375	12	16163	3	29	9	16134	16175	0.152088503044477
M1	cpdb	0	network_modules	115	TRUE	0.0022869367043063782	187	32	6	0.1875	0.03208556149732621	GO:0000082	GO:BP	G1/S transition of mitotic cell cycle	16175	31		0.8709677419354839	0.875	187	15988	6	26	181	15962	16175	0.07327760650429704
M1	cpdb	0	network_modules	115	TRUE	0.0026978434822544453	105	32	5	0.15625	0.047619047619047616	GO:0071482	GO:BP	cellular response to light stimulus	16175	16715		0.9032258064516129	0.90625	105	16070	5	27	100	16043	16175	0.08302637007296873
M1	cpdb	0	network_modules	115	TRUE	0.002849526066340021	309	32	7	0.21875	0.022653721682847898	GO:0042176	GO:BP	regulation of protein catabolic process	16175	10004		0.9354838709677419	0.9375	309	15866	7	25	302	15841	16175	0.06493454056028337
M1	cpdb	0	network_modules	115	TRUE	0.003701507447728602	465	32	8	0.25	0.017204301075268817	GO:0044770	GO:BP	cell cycle phase transition	16175	11146		0.967741935483871	0.96875	465	15710	8	24	457	15686	16175	0.05895215126114279
M1	cpdb	0	network_modules	115	TRUE	0.0049993703613318875	214	32	6	0.1875	0.028037383177570093	GO:0044843	GO:BP	cell cycle G1/S phase transition	16175	11189		1	1	214	15961	6	26	208	15935	16175	0.06790662073168684
M1	cpdb	0	network_modules	115	TRUE	0.006429000447641405	53	33	4	0.12121212121212122	0.07547169811320754	REAC:R-HSA-180585	REAC	Vif-mediated degradation of APOBEC3G	10916	2646		1	1	53	10863	4	29	49	10834	10916	0.09217759258366323
M1	cpdb	0	network_modules	116	TRUE	2.0887727040912384e-28	140	27	19	0.7037037037037037	0.1357142857142857	REAC:R-HSA-1474228	REAC	Degradation of the extracellular matrix	10916	726		0	0.1	140	10776	19	8	121	10768	10916	0.30574564119604253
M1	cpdb	0	network_modules	116	TRUE	5.853001077964868e-26	298	27	21	0.7777777777777778	0.07046979865771812	REAC:R-HSA-1474244	REAC	Extracellular matrix organization	10916	889		0.1111111111111111	0.2	298	10618	21	6	277	10612	10916	0.2293296008189994
M1	cpdb	0	network_modules	116	TRUE	7.221188646187207e-25	33	27	13	0.48148148148148145	0.3939393939393939	REAC:R-HSA-1592389	REAC	Activation of Matrix Metalloproteinases	10916	86		0.2222222222222222	0.3	33	10883	13	14	20	10869	10916	0.43397459420734746
M1	cpdb	0	network_modules	116	TRUE	1.449292207424569e-21	37	33	12	0.36363636363636365	0.32432432432432434	GO:0030574	GO:BP	collagen catabolic process	16175	6846		0	0.03225806451612903	37	16138	12	21	25	16117	16175	0.3419980160598864
M1	cpdb	0	network_modules	116	TRUE	4.947732647035758e-20	236	33	17	0.5151515151515151	0.07203389830508475	GO:0030198	GO:BP	extracellular matrix organization	16175	6707		0.03333333333333333	0.06451612903225806	236	15939	17	16	219	15923	16175	0.18875268817242727
M1	cpdb	0	network_modules	116	TRUE	5.325011200665261e-20	237	33	17	0.5151515151515151	0.07172995780590717	GO:0043062	GO:BP	extracellular structure organization	16175	10509		0.06666666666666667	0.0967741935483871	237	15938	17	16	220	15922	16175	0.18833669952371324
M1	cpdb	0	network_modules	116	TRUE	5.729197871986308e-20	238	33	17	0.5151515151515151	0.07142857142857142	GO:0045229	GO:BP	external encapsulating structure organization	16175	11340		0.1	0.12903225806451613	238	15937	17	16	221	15921	16175	0.1879232980130773
M1	cpdb	0	network_modules	116	TRUE	8.52971543876541e-19	59	33	12	0.36363636363636365	0.2033898305084746	GO:0022617	GO:BP	extracellular matrix disassembly	16175	6624		0.13333333333333333	0.16129032258064516	59	16116	12	21	47	16095	16175	0.26999572805963906
M1	cpdb	0	network_modules	116	TRUE	9.614964315353682e-18	71	33	12	0.36363636363636365	0.16901408450704225	GO:0032963	GO:BP	collagen metabolic process	16175	7947		0.16666666666666666	0.1935483870967742	71	16104	12	21	59	16083	16175	0.24570813182897058
M1	cpdb	0	network_modules	116	TRUE	4.425848281121351e-16	64	27	11	0.4074074074074074	0.171875	REAC:R-HSA-1442490	REAC	Collagen degradation	10916	386		0.3333333333333333	0.4	64	10852	11	16	53	10836	10916	0.2619028126888603
M1	cpdb	0	network_modules	116	TRUE	6.803494669304461e-9	374	33	12	0.36363636363636365	0.03208556149732621	GO:0022411	GO:BP	cellular component disassembly	16175	6602		0.2	0.22580645161290322	374	15801	12	21	362	15780	16175	0.10244241455212771
M1	cpdb	0	network_modules	116	TRUE	1.7861874321972484e-8	11	33	5	0.15151515151515152	0.45454545454545453	GO:0071492	GO:BP	cellular response to UV-A	16175	16725		0.23333333333333334	0.25806451612903225	11	16164	5	28	6	16136	16175	0.2616099213276839
M1	cpdb	0	network_modules	116	TRUE	7.706684017985176e-8	14	33	5	0.15151515151515152	0.35714285714285715	GO:0070141	GO:BP	response to UV-A	16175	15936		0.26666666666666666	0.2903225806451613	14	16161	5	28	9	16133	16175	0.2316287643671845
M1	cpdb	0	network_modules	116	TRUE	3.3643651686221736e-7	42	33	6	0.18181818181818182	0.14285714285714285	GO:0010466	GO:BP	negative regulation of peptidase activity	16175	4159		0.3	0.3225806451612903	42	16133	6	27	36	16106	16175	0.1592321219265468
M1	cpdb	0	network_modules	116	TRUE	7.578519944187247e-7	7	33	4	0.12121212121212122	0.5714285714285714	GO:0051045	GO:BP	negative regulation of membrane protein ectodomain proteolysis	16175	13455		0.3333333333333333	0.3548387096774194	7	16168	4	29	3	16139	16175	0.2625657787438777
M1	cpdb	0	network_modules	116	TRUE	5.360440405365388e-6	30	33	5	0.15151515151515152	0.16666666666666666	GO:0010951	GO:BP	negative regulation of endopeptidase activity	16175	4529		0.36666666666666664	0.3870967741935484	30	16145	5	28	25	16117	16175	0.1572714699841624
M1	cpdb	0	network_modules	116	TRUE	1.001448842807424e-5	130	33	7	0.21212121212121213	0.05384615384615385	GO:0045861	GO:BP	negative regulation of proteolysis	16175	11673		0.4	0.41935483870967744	130	16045	7	26	123	16019	16175	0.1033451879540948
M1	cpdb	0	network_modules	116	TRUE	3.553501985515396e-5	43	33	5	0.15151515151515152	0.11627906976744186	GO:0035987	GO:BP	endodermal cell differentiation	16175	9378		0.43333333333333335	0.45161290322580644	43	16132	5	28	38	16104	16175	0.13071117599973042
M1	cpdb	0	network_modules	116	TRUE	3.9848306666202586e-5	91	33	6	0.18181818181818182	0.06593406593406594	GO:0051346	GO:BP	negative regulation of hydrolase activity	16175	13673		0.4666666666666667	0.4838709677419355	91	16084	6	27	85	16057	16175	0.10651029235740479
M1	cpdb	0	network_modules	116	TRUE	4.003291554820188e-5	44	33	5	0.15151515151515152	0.11363636363636363	GO:0006509	GO:BP	membrane protein ectodomain proteolysis	16175	2234		0.5	0.5161290322580645	44	16131	5	28	39	16103	16175	0.12916762138181118
M1	cpdb	0	network_modules	116	TRUE	4.592347465549151e-5	92	17	5	0.29411764705882354	0.05434782608695652	KEGG:04657	KEGG	IL-17 signaling pathway	8484	335		0	0.25	92	8392	5	12	87	8380	8484	0.12255751682541437
M1	cpdb	0	network_modules	116	TRUE	7.742858938652322e-5	50	33	5	0.15151515151515152	0.1	GO:0001706	GO:BP	endoderm formation	16175	398		0.5333333333333333	0.5483870967741935	50	16125	5	28	45	16097	16175	0.12089037997066931
M1	cpdb	0	network_modules	116	TRUE	8.40184952889125e-5	103	33	6	0.18181818181818182	0.05825242718446602	GO:0052547	GO:BP	regulation of peptidase activity	16175	14133		0.5666666666666667	0.5806451612903226	103	16072	6	27	97	16045	16175	0.09972939936816766
M1	cpdb	0	network_modules	116	TRUE	9.982822674380671e-5	60	27	5	0.18518518518518517	0.08333333333333333	REAC:R-HSA-2022090	REAC	Assembly of collagen fibrils and other multimeric structures	10916	177		0.4444444444444444	0.5	60	10856	5	22	55	10834	10916	0.12102122731303608
M1	cpdb	0	network_modules	116	TRUE	1.1690150017111401e-4	5	33	3	0.09090909090909091	0.6	GO:1905049	GO:BP	negative regulation of metallopeptidase activity	16175	24324		0.6	0.6129032258064516	5	16170	3	30	2	16140	16175	0.23302935797773947
M1	cpdb	0	network_modules	116	TRUE	1.5147507500476695e-4	57	33	5	0.15151515151515152	0.08771929824561403	GO:0007492	GO:BP	endoderm development	16175	2978		0.6333333333333333	0.6451612903225806	57	16118	5	28	52	16090	16175	0.1129185936759446
M1	cpdb	0	network_modules	116	TRUE	1.8059117782857347e-4	59	33	5	0.15151515151515152	0.0847457627118644	GO:0033619	GO:BP	membrane protein proteolysis	16175	8321		0.6666666666666666	0.6774193548387096	59	16116	5	28	54	16088	16175	0.11090236855157709
M1	cpdb	0	network_modules	116	TRUE	2.6692220571640995e-4	25	33	4	0.12121212121212122	0.16	GO:0051043	GO:BP	regulation of membrane protein ectodomain proteolysis	16175	13453		0.7	0.7096774193548387	25	16150	4	29	21	16121	16175	0.13773331618221063
M1	cpdb	0	network_modules	116	TRUE	3.0380841135820003e-4	140	27	6	0.2222222222222222	0.04285714285714286	REAC:R-HSA-3781865	REAC	Diseases of glycosylation	10916	765		0.5555555555555556	0.6	140	10776	6	21	134	10755	10916	0.09266784854464583
M1	cpdb	0	network_modules	116	TRUE	6.944080015862472e-4	77	33	5	0.15151515151515152	0.06493506493506493	GO:0052548	GO:BP	regulation of endopeptidase activity	16175	14134		0.7333333333333333	0.7419354838709677	77	16098	5	28	72	16070	16175	0.09640139935225046
M1	cpdb	0	network_modules	116	TRUE	7.225123547925591e-4	89	27	5	0.18518518518518517	0.056179775280898875	REAC:R-HSA-1474290	REAC	Collagen formation	10916	387		0.6666666666666666	0.7	89	10827	5	22	84	10805	10916	0.09802890518327738
M1	cpdb	0	network_modules	116	TRUE	8.412549128420091e-4	80	33	5	0.15151515151515152	0.0625	GO:0001704	GO:BP	formation of primary germ layer	16175	396		0.7666666666666667	0.7741935483870968	80	16095	5	28	75	16067	16175	0.09446587714128
M1	cpdb	0	network_modules	116	TRUE	8.953057632076832e-4	81	33	5	0.15151515151515152	0.06172839506172839	GO:0034644	GO:BP	cellular response to UV	16175	8706		0.8	0.8064516129032258	81	16094	5	28	76	16066	16175	0.09384425929965297
M1	cpdb	0	network_modules	116	TRUE	0.0019128320005597909	11	33	3	0.09090909090909091	0.2727272727272727	GO:1905048	GO:BP	regulation of metallopeptidase activity	16175	24323		0.8333333333333334	0.8387096774193549	11	16164	3	30	8	16134	16175	0.1564941503252175
M1	cpdb	0	network_modules	116	TRUE	0.0020429119592704687	283	33	7	0.21212121212121213	0.024734982332155476	GO:0001501	GO:BP	skeletal system development	16175	318		0.8666666666666667	0.8709677419354839	283	15892	7	26	276	15866	16175	0.06711798152523903
M1	cpdb	0	network_modules	116	TRUE	0.002088340136146152	41	33	4	0.12121212121212122	0.0975609756097561	GO:1904645	GO:BP	response to amyloid-beta	16175	23985		0.9	0.9032258064516129	41	16134	4	29	37	16105	16175	0.10671548836946554
M1	cpdb	0	network_modules	116	TRUE	0.0021496788656507233	111	27	5	0.18518518518518517	0.04504504504504504	REAC:R-HSA-6785807	REAC	Interleukin-4 and Interleukin-13 signaling	10916	1252		0.7777777777777778	0.8	111	10805	5	22	106	10783	10916	0.08686740351455095
M1	cpdb	0	network_modules	116	TRUE	0.0028505999669847485	105	17	4	0.23529411764705882	0.0380952380952381	KEGG:04928	KEGG	Parathyroid hormone synthesis, secretion and action	8484	385		0.3333333333333333	0.5	105	8379	4	13	101	8366	8484	0.09034715890673416
M1	cpdb	0	network_modules	116	TRUE	0.00325911438328717	105	33	5	0.15151515151515152	0.047619047619047616	GO:0071482	GO:BP	cellular response to light stimulus	16175	16715		0.9333333333333333	0.9354838709677419	105	16070	5	28	100	16042	16175	0.0816504980374909
M1	cpdb	0	network_modules	116	TRUE	0.004159758148776459	41	17	3	0.17647058823529413	0.07317073170731707	KEGG:05219	KEGG	Bladder cancer	8484	470		0.6666666666666666	0.75	41	8443	3	14	38	8429	8484	0.11090046499194224
M1	cpdb	0	network_modules	116	TRUE	0.005105777260930713	115	33	5	0.15151515151515152	0.043478260869565216	GO:0007369	GO:BP	gastrulation	16175	2871		0.9666666666666667	0.967741935483871	115	16060	5	28	110	16032	16175	0.07771133574394938
M1	cpdb	0	network_modules	116	TRUE	0.006373722734502875	129	17	4	0.23529411764705882	0.031007751937984496	KEGG:04926	KEGG	Relaxin signaling pathway	8484	383		1	1	129	8355	4	13	125	8342	8484	0.08059176112617245
M1	cpdb	0	network_modules	116	TRUE	0.007678373363788295	245	27	6	0.2222222222222222	0.024489795918367346	REAC:R-HSA-5668914	REAC	Diseases of metabolism	10916	767		0.8888888888888888	0.9	245	10671	6	21	239	10650	10916	0.06716046494835148
M1	cpdb	0	network_modules	116	TRUE	0.008972899700155421	129	33	5	0.15151515151515152	0.03875968992248062	GO:0009411	GO:BP	response to UV	16175	3476		1	1	129	16046	5	28	124	16018	16175	0.07296539210899045
M1	cpdb	0	network_modules	116	TRUE	0.009215902420066657	73	27	4	0.14814814814814814	0.0547945205479452	REAC:R-HSA-9009391	REAC	Extra-nuclear estrogen signaling	10916	888		1	1	73	10843	4	23	69	10820	10916	0.08642733183650152
M1	cpdb	0	network_modules	117	TRUE	9.565792799048712e-9	193	14	8	0.5714285714285714	0.04145077720207254	KEGG:04814	KEGG	Motor proteins	8484	366		0	0.16666666666666666	193	8291	8	6	185	8285	8484	0.14960974610324698
M1	cpdb	0	network_modules	117	TRUE	2.8640603061786617e-6	249	14	7	0.5	0.028112449799196786	KEGG:05132	KEGG	Salmonella infection	8484	429		0.2	0.3333333333333333	249	8235	7	7	242	8228	8484	0.11336791190960016
M1	cpdb	0	network_modules	117	TRUE	7.822475537034733e-6	53	19	5	0.2631578947368421	0.09433962264150944	REAC:R-HSA-6811436	REAC	COPI-independent Golgi-to-ER retrograde traffic	10916	278		0	0.1	53	10863	5	14	48	10849	10916	0.1551682514957146
M1	cpdb	0	network_modules	117	TRUE	1.1364780642864182e-5	57	19	5	0.2631578947368421	0.08771929824561403	REAC:R-HSA-3371497	REAC	HSP90 chaperone cycle for steroid hormone receptors (SHR) in the presence of ligand	10916	1111		0.1111111111111111	0.2	57	10859	5	14	52	10845	10916	0.14943998250800575
M1	cpdb	0	network_modules	117	TRUE	1.3878019086200336e-5	123	19	6	0.3157894736842105	0.04878048780487805	REAC:R-HSA-2132295	REAC	MHC class II antigen presentation	10916	1371		0.2222222222222222	0.3	123	10793	6	13	117	10780	10916	0.12047066981162814
M1	cpdb	0	network_modules	117	TRUE	5.1099048710213685e-5	5	26	3	0.11538461538461539	0.6	GO:0008655	GO:BP	pyrimidine-containing compound salvage	16175	3226		0	0.14285714285714285	5	16170	3	23	2	16147	16175	0.26266426439336954
M1	cpdb	0	network_modules	117	TRUE	2.1541050112620786e-4	102	19	5	0.2631578947368421	0.049019607843137254	REAC:R-HSA-6807878	REAC	COPI-mediated anterograde transport	10916	279		0.3333333333333333	0.4	102	10814	5	14	97	10800	10916	0.11015617223512818
M1	cpdb	0	network_modules	117	TRUE	2.3288181911626814e-4	11	19	3	0.15789473684210525	0.2727272727272727	REAC:R-HSA-73614	REAC	Pyrimidine salvage	10916	1829		0.4444444444444444	0.5	11	10905	3	16	8	10889	10916	0.2064737038345342
M1	cpdb	0	network_modules	117	TRUE	2.7896076220608766e-4	305	14	6	0.42857142857142855	0.019672131147540985	KEGG:05016	KEGG	Huntington disease	8484	414		0.4	0.5	305	8179	6	8	299	8171	8484	0.08574265389293483
M1	cpdb	0	network_modules	117	TRUE	7.614931983982054e-4	363	14	6	0.42857142857142855	0.01652892561983471	KEGG:05014	KEGG	Amyotrophic lateral sclerosis	8484	413		0.6	0.6666666666666666	363	8121	6	8	357	8113	8484	0.07750152535722063
M1	cpdb	0	network_modules	117	TRUE	8.039590671303582e-4	133	19	5	0.2631578947368421	0.03759398496240601	REAC:R-HSA-8856688	REAC	Golgi-to-ER retrograde transport	10916	1084		0.5555555555555556	0.6	133	10783	5	14	128	10769	10916	0.0955256200830036
M1	cpdb	0	network_modules	117	TRUE	0.0017063945987085781	155	19	5	0.2631578947368421	0.03225806451612903	REAC:R-HSA-199977	REAC	ER to Golgi Anterograde Transport	10916	823		0.6666666666666666	0.7	155	10761	5	14	150	10747	10916	0.087866178963728
M1	cpdb	0	network_modules	117	TRUE	0.0024668142038995512	23	19	3	0.15789473684210525	0.13043478260869565	REAC:R-HSA-8956321	REAC	Nucleotide salvage	10916	1626		0.7777777777777778	0.8	23	10893	3	16	20	10877	10916	0.14186734905480192
M1	cpdb	0	network_modules	117	TRUE	0.0026256372808698084	44	14	3	0.21428571428571427	0.06818181818181818	KEGG:04962	KEGG	Vasopressin-regulated water reabsorption	8484	398		0.8	0.8333333333333334	44	8440	3	11	41	8429	8484	0.11835275357758487
M1	cpdb	0	network_modules	117	TRUE	0.003430526248101933	17	26	3	0.11538461538461539	0.17647058823529413	GO:0051014	GO:BP	actin filament severing	16175	13440		0.16666666666666666	0.2857142857142857	17	16158	3	23	14	16135	16175	0.14158387767899894
M1	cpdb	0	network_modules	117	TRUE	0.003450794777497106	2	26	2	0.07692307692307693	1	GO:0044206	GO:BP	UMP salvage	16175	10931		0.3333333333333333	0.8571428571428571	2	16173	2	24	0	16149	16175	0.27714423421480233
M1	cpdb	0	network_modules	117	TRUE	0.003450794777497106	2	26	2	0.07692307692307693	1	GO:0044211	GO:BP	CTP salvage	16175	10935		0.3333333333333333	0.8571428571428571	2	16173	2	24	0	16149	16175	0.27714423421480233
M1	cpdb	0	network_modules	117	TRUE	0.003450794777497106	2	26	2	0.07692307692307693	1	GO:0032262	GO:BP	pyrimidine nucleotide salvage	16175	7448		0.3333333333333333	0.8571428571428571	2	16173	2	24	0	16149	16175	0.27714423421480233
M1	cpdb	0	network_modules	117	TRUE	0.003450794777497106	2	26	2	0.07692307692307693	1	GO:0010138	GO:BP	pyrimidine ribonucleotide salvage	16175	3943		0.3333333333333333	0.8571428571428571	2	16173	2	24	0	16149	16175	0.27714423421480233
M1	cpdb	0	network_modules	117	TRUE	0.004151682438697194	186	19	5	0.2631578947368421	0.026881720430107527	REAC:R-HSA-948021	REAC	Transport to the Golgi and subsequent modification	10916	2604		0.8888888888888888	0.9	186	10730	5	14	181	10716	10916	0.07940998374500942
M1	cpdb	0	network_modules	117	TRUE	0.005727798340945601	57	14	3	0.21428571428571427	0.05263157894736842	KEGG:00240	KEGG	Pyrimidine metabolism	8484	24		1	1	57	8427	3	11	54	8416	8484	0.10330176546723593
M1	cpdb	0	network_modules	117	TRUE	0.006191481649199753	202	19	5	0.2631578947368421	0.024752475247524754	REAC:R-HSA-6811442	REAC	Intra-Golgi and retrograde Golgi-to-ER traffic	10916	1262		1	1	202	10714	5	14	197	10700	10916	0.07580289624836392
M1	cpdb	0	network_modules	117	TRUE	0.0066811333727300375	21	26	3	0.11538461538461539	0.14285714285714285	GO:0072528	GO:BP	pyrimidine-containing compound biosynthetic process	16175	17430		1	1	21	16154	3	23	18	16131	16175	0.12712823401015022
M1	cpdb	0	network_modules	118	TRUE	7.243756563825568e-17	100	23	12	0.5217391304347826	0.12	REAC:R-HSA-5668541	REAC	TNFR2 non-canonical NF-kB pathway	10916	2450		0	0.3333333333333333	100	10816	12	11	88	10805	10916	0.2472182575924814
M1	cpdb	0	network_modules	118	TRUE	4.3518887811391353e-16	29	23	9	0.391304347826087	0.3103448275862069	REAC:R-HSA-5669034	REAC	TNFs bind their physiological receptors	10916	2451		0.5	0.6666666666666666	29	10887	9	14	20	10873	10916	0.34694184315887844
M1	cpdb	0	network_modules	118	TRUE	6.891902637531469e-13	291	17	12	0.7058823529411765	0.041237113402061855	KEGG:04060	KEGG	Cytokine-cytokine receptor interaction	8484	253		0	0.5	291	8193	12	5	279	8188	8484	0.16534525487554602
M1	cpdb	0	network_modules	118	TRUE	1.0735148448900847e-6	44	17	5	0.29411764705882354	0.11363636363636363	KEGG:04672	KEGG	Intestinal immune network for IgA production	8484	344		1	1	44	8440	5	12	39	8428	8484	0.18024264101835552
M1	cpdb	0	network_modules	118	TRUE	8.816921745393555e-6	16	23	4	0.17391304347826086	0.25	REAC:R-HSA-5676594	REAC	TNF receptor superfamily (TNFSF) members mediating non-canonical NF-kB pathway	10916	2445		1	1	16	10900	4	19	12	10881	10916	0.20712707146160486
M1	cpdb	0	network_modules	118	TRUE	4.1976246373575353e-4	91	26	5	0.19230769230769232	0.054945054945054944	GO:0050864	GO:BP	regulation of B cell activation	16175	13312		0	0.2	91	16084	5	21	86	16063	16175	0.10014798739163004
M1	cpdb	0	network_modules	118	TRUE	7.894518711760492e-4	197	26	6	0.23076923076923078	0.030456852791878174	GO:0042113	GO:BP	B cell activation	16175	9971		0.25	0.4	197	15978	6	20	191	15958	16175	0.07996390580333093
M1	cpdb	0	network_modules	118	TRUE	0.0027154568619690614	57	26	4	0.15384615384615385	0.07017543859649122	GO:0050871	GO:BP	positive regulation of B cell activation	16175	13319		0.5	0.6	57	16118	4	22	53	16096	16175	0.10178604912265703
M1	cpdb	0	network_modules	118	TRUE	0.004334650326503141	64	26	4	0.15384615384615385	0.0625	GO:0019731	GO:BP	antibacterial humoral response	16175	6022		0.75	0.8	64	16111	4	22	60	16089	16175	0.09580273768665881
M1	cpdb	0	network_modules	118	TRUE	0.008639015077545349	76	26	4	0.15384615384615385	0.05263157894736842	GO:0042100	GO:BP	B cell proliferation	16175	9966		1	1	76	16099	4	22	72	16077	16175	0.08751208044771674
M1	cpdb	0	network_modules	119	TRUE	6.630597231817445e-17	365	24	17	0.7083333333333334	0.04657534246575343	KEGG:04080	KEGG	Neuroactive ligand-receptor interaction	8484	263		NA	1	365	8119	17	7	348	8112	8484	0.17464180597789267
M1	cpdb	0	network_modules	119	TRUE	4.0670033056148765e-16	460	21	16	0.7619047619047619	0.034782608695652174	REAC:R-HSA-500792	REAC	GPCR ligand binding	10916	1019		0	0.09090909090909091	460	10456	16	5	444	10451	10916	0.1572854133252493
M1	cpdb	0	network_modules	119	TRUE	1.0568677564369385e-13	774	30	18	0.6	0.023255813953488372	GO:0007186	GO:BP	G protein-coupled receptor signaling pathway	16175	2744		0	0.043478260869565216	774	15401	18	12	756	15389	16175	0.11150561857377818
M1	cpdb	0	network_modules	119	TRUE	7.850665375723509e-9	33	21	6	0.2857142857142857	0.18181818181818182	REAC:R-HSA-420092	REAC	Glucagon-type ligand receptors	10916	1050		0.1	0.18181818181818182	33	10883	6	15	27	10868	10916	0.2260687653417545
M1	cpdb	0	network_modules	119	TRUE	7.993791892543718e-8	156	21	8	0.38095238095238093	0.05128205128205128	REAC:R-HSA-418555	REAC	G alpha (s) signalling events	10916	989		0.2	0.2727272727272727	156	10760	8	13	148	10747	10916	0.1356301844416463
M1	cpdb	0	network_modules	119	TRUE	8.651228141675552e-8	93	21	7	0.3333333333333333	0.07526881720430108	REAC:R-HSA-373080	REAC	Class B/2 (Secretin family receptors)	10916	366		0.3	0.36363636363636365	93	10823	7	14	86	10809	10916	0.15515959277412691
M1	cpdb	0	network_modules	119	TRUE	9.543117894992522e-7	213	21	8	0.38095238095238093	0.03755868544600939	REAC:R-HSA-416476	REAC	G alpha (q) signalling events	10916	988		0.4	0.45454545454545453	213	10703	8	13	205	10690	10916	0.11472363327397618
M1	cpdb	0	network_modules	119	TRUE	9.84415054023916e-7	8	30	4	0.13333333333333333	0.5	GO:0007217	GO:BP	tachykinin receptor signaling pathway	16175	2771		0.045454545454545456	0.08695652173913043	8	16167	4	26	4	16141	16175	0.257543703435845
M1	cpdb	0	network_modules	119	TRUE	1.211519505912732e-6	328	21	9	0.42857142857142855	0.027439024390243903	REAC:R-HSA-373076	REAC	Class A/1 (Rhodopsin-like receptors)	10916	365		0.5	0.5454545454545454	328	10588	9	12	319	10576	10916	0.10248726958144729
M1	cpdb	0	network_modules	119	TRUE	1.2247975146030247e-5	149	30	7	0.23333333333333334	0.04697986577181208	GO:0030072	GO:BP	peptide hormone secretion	16175	6672		0.09090909090909091	0.13043478260869565	149	16026	7	23	142	16003	16175	0.1011262440413338
M1	cpdb	0	network_modules	119	TRUE	1.283145527053753e-5	150	30	7	0.23333333333333334	0.04666666666666667	GO:0002790	GO:BP	peptide secretion	16175	1301		0.13636363636363635	0.17391304347826086	150	16025	7	23	143	16002	16175	0.10076393421006935
M1	cpdb	0	network_modules	119	TRUE	1.7302056135470056e-5	361	30	9	0.3	0.024930747922437674	GO:0010817	GO:BP	regulation of hormone levels	16175	4429		0.18181818181818182	0.21739130434782608	361	15814	9	21	352	15793	16175	0.08103236950837628
M1	cpdb	0	network_modules	119	TRUE	1.9371775986899965e-5	5	21	3	0.14285714285714285	0.6	REAC:R-HSA-380095	REAC	Tachykinin receptors bind tachykinins	10916	2480		0.6	0.6363636363636364	5	10911	3	18	2	10893	10916	0.29217935115695076
M1	cpdb	0	network_modules	119	TRUE	2.9345391394829854e-5	169	30	7	0.23333333333333334	0.04142011834319527	GO:0015833	GO:BP	peptide transport	16175	4943		0.22727272727272727	0.2608695652173913	169	16006	7	23	162	15983	16175	0.09448920413608902
M1	cpdb	0	network_modules	119	TRUE	3.319769920387954e-5	24	21	4	0.19047619047619047	0.16666666666666666	REAC:R-HSA-400508	REAC	Incretin synthesis, secretion, and inactivation	10916	1180		0.7	0.7272727272727273	24	10892	4	17	20	10875	10916	0.1764813162328351
M1	cpdb	0	network_modules	119	TRUE	5.082839991051009e-5	183	30	7	0.23333333333333334	0.03825136612021858	GO:0046879	GO:BP	hormone secretion	16175	12414		0.2727272727272727	0.30434782608695654	183	15992	7	23	176	15969	16175	0.09048992505796263
M1	cpdb	0	network_modules	119	TRUE	7.072128831828364e-5	192	30	7	0.23333333333333334	0.036458333333333336	GO:0009914	GO:BP	hormone transport	16175	3770		0.3181818181818182	0.34782608695652173	192	15983	7	23	185	15960	16175	0.08814701843433846
M1	cpdb	0	network_modules	119	TRUE	1.0019841449537438e-4	202	30	7	0.23333333333333334	0.034653465346534656	GO:0042886	GO:BP	amide transport	16175	10431		0.36363636363636365	0.391304347826087	202	15973	7	23	195	15950	16175	0.08572438650107779
M1	cpdb	0	network_modules	119	TRUE	1.6354439587875995e-4	217	30	7	0.23333333333333334	0.03225806451612903	GO:0007188	GO:BP	adenylate cyclase-modulating G protein-coupled receptor signaling pathway	16175	2746		0.4090909090909091	0.43478260869565216	217	15958	7	23	210	15935	16175	0.08239990659246528
M1	cpdb	0	network_modules	119	TRUE	2.3518504708248955e-4	69	30	5	0.16666666666666666	0.07246376811594203	GO:0007218	GO:BP	neuropeptide signaling pathway	16175	2772		0.45454545454545453	0.4782608695652174	69	16106	5	25	64	16081	16175	0.10741272353088648
M1	cpdb	0	network_modules	119	TRUE	4.1326604074294024e-4	195	21	6	0.2857142857142857	0.03076923076923077	REAC:R-HSA-375276	REAC	Peptide ligand-binding receptors	10916	1726		0.8	0.8181818181818182	195	10721	6	15	189	10706	10916	0.0887804262748856
M1	cpdb	0	network_modules	119	TRUE	0.001383080098492013	11	30	3	0.1	0.2727272727272727	GO:0003353	GO:BP	positive regulation of cilium movement	16175	1773		0.5	0.6086956521739131	11	16164	3	27	8	16137	16175	0.16422965067086123
M1	cpdb	0	network_modules	119	TRUE	0.001383080098492013	11	30	3	0.1	0.2727272727272727	GO:1902093	GO:BP	positive regulation of flagellated sperm motility	16175	22012		0.5	0.6086956521739131	11	16164	3	27	8	16137	16175	0.16422965067086123
M1	cpdb	0	network_modules	119	TRUE	0.001383080098492013	11	30	3	0.1	0.2727272727272727	GO:2000155	GO:BP	positive regulation of cilium-dependent cell motility	16175	25497		0.5	0.6086956521739131	11	16164	3	27	8	16137	16175	0.16422965067086123
M1	cpdb	0	network_modules	119	TRUE	0.0018593639239656789	311	30	7	0.23333333333333334	0.022508038585209004	GO:0023061	GO:BP	signal release	16175	6645		0.6363636363636364	0.6521739130434783	311	15864	7	23	304	15841	16175	0.06720915733420281
M1	cpdb	0	network_modules	119	TRUE	0.0025259257797974324	21	21	3	0.14285714285714285	0.14285714285714285	REAC:R-HSA-381771	REAC	Synthesis, secretion, and inactivation of Glucagon-like Peptide-1 (GLP-1)	10916	2415		0.9	0.9090909090909091	21	10895	3	18	18	10877	10916	0.14120500885071788
M1	cpdb	0	network_modules	119	TRUE	0.0048904476213216894	2	30	2	0.06666666666666667	1	GO:0038192	GO:BP	gastric inhibitory peptide signaling pathway	16175	9761		0.6818181818181818	0.6956521739130435	2	16173	2	28	0	16145	16175	0.2579752855695965
M1	cpdb	0	network_modules	119	TRUE	0.004936394037694048	127	30	5	0.16666666666666666	0.03937007874015748	GO:0090276	GO:BP	regulation of peptide hormone secretion	16175	18165		0.7272727272727273	0.7391304347826086	127	16048	5	25	122	16023	16175	0.0775648956200154
M1	cpdb	0	network_modules	119	TRUE	0.005130429574547129	128	30	5	0.16666666666666666	0.0390625	GO:0002791	GO:BP	regulation of peptide secretion	16175	1302		0.7727272727272727	0.782608695652174	128	16047	5	25	123	16022	16175	0.07723364359887268
M1	cpdb	0	network_modules	119	TRUE	0.005536472881018492	130	30	5	0.16666666666666666	0.038461538461538464	GO:0090087	GO:BP	regulation of peptide transport	16175	18008		0.8181818181818182	0.8260869565217391	130	16045	5	25	125	16020	16175	0.07658231821113841
M1	cpdb	0	network_modules	119	TRUE	0.005594689096600543	58	30	4	0.13333333333333333	0.06896551724137931	GO:2000243	GO:BP	positive regulation of reproductive process	16175	25571		0.8636363636363636	0.8695652173913043	58	16117	4	26	54	16091	16175	0.09356834923613137
M1	cpdb	0	network_modules	119	TRUE	0.006725748260190292	88	21	4	0.19047619047619047	0.045454545454545456	REAC:R-HSA-2980736	REAC	Peptide hormone metabolism	10916	1725		1	1	88	10828	4	17	84	10811	10916	0.08955787140683777
M1	cpdb	0	network_modules	119	TRUE	0.007961358977745478	140	30	5	0.16666666666666666	0.03571428571428571	GO:0007189	GO:BP	adenylate cyclase-activating G protein-coupled receptor signaling pathway	16175	2747		0.9090909090909091	0.9130434782608695	140	16035	5	25	135	16010	16175	0.07353187371245878
M1	cpdb	0	network_modules	119	TRUE	0.008041474614635868	19	30	3	0.1	0.15789473684210525	GO:1901317	GO:BP	regulation of flagellated sperm motility	16175	21377		0.9545454545454546	0.9565217391304348	19	16156	3	27	16	16129	16175	0.12436853556759232
M1	cpdb	0	network_modules	119	TRUE	0.009200870311952946	255	30	6	0.2	0.023529411764705882	GO:0007610	GO:BP	behavior	16175	3067		1	1	255	15920	6	24	249	15896	16175	0.06375529283392697
M1	cpdb	0	network_modules	120	TRUE	3.477034020284719e-9	39	16	6	0.375	0.15384615384615385	REAC:R-HSA-6783310	REAC	Fanconi Anemia Pathway	10916	932		0	0.1111111111111111	39	10877	6	10	33	10867	10916	0.2385048304938508
M1	cpdb	0	network_modules	120	TRUE	3.893355029119124e-7	54	12	5	0.4166666666666667	0.09259259259259259	KEGG:03460	KEGG	Fanconi anemia pathway	8484	242		0	0.5	54	8430	5	7	49	8423	8484	0.1941739679550752
M1	cpdb	0	network_modules	120	TRUE	1.8949445338249552e-6	30	27	5	0.18518518518518517	0.16666666666666666	GO:1904357	GO:BP	negative regulation of telomere maintenance via telomere lengthening	16175	23744		0	0.038461538461538464	30	16145	5	22	25	16123	16175	0.17422954541501878
M1	cpdb	0	network_modules	120	TRUE	5.7503796976806236e-6	37	27	5	0.18518518518518517	0.13513513513513514	GO:0032205	GO:BP	negative regulation of telomere maintenance	16175	7397		0.04	0.07692307692307693	37	16138	5	22	32	16116	16175	0.15654865412321875
M1	cpdb	0	network_modules	120	TRUE	6.935217340988814e-6	84	27	6	0.2222222222222222	0.07142857142857142	GO:0010833	GO:BP	telomere maintenance via telomere lengthening	16175	4443		0.08	0.11538461538461539	84	16091	6	21	78	16070	16175	0.12346772774815025
M1	cpdb	0	network_modules	120	TRUE	1.2965404124992802e-5	15	27	4	0.14814814814814814	0.26666666666666666	GO:0000712	GO:BP	resolution of meiotic recombination intermediates	16175	192		0.12	0.15384615384615385	15	16160	4	23	11	16137	16175	0.1977742018216588
M1	cpdb	0	network_modules	120	TRUE	2.589531327467998e-5	4	27	3	0.1111111111111111	0.75	GO:0072429	GO:BP	response to intra-S DNA damage checkpoint signaling	16175	17397		0.16	0.19230769230769232	4	16171	3	24	1	16147	16175	0.2883089932851915
M1	cpdb	0	network_modules	120	TRUE	3.7175575410769416e-5	53	27	5	0.18518518518518517	0.09433962264150944	GO:0140527	GO:BP	reciprocal homologous recombination	16175	19808		0.2	0.2692307692307692	53	16122	5	22	48	16100	16175	0.13015847665579391
M1	cpdb	0	network_modules	120	TRUE	3.7175575410769416e-5	53	27	5	0.18518518518518517	0.09433962264150944	GO:0007131	GO:BP	reciprocal meiotic recombination	16175	2702		0.2	0.2692307692307692	53	16122	5	22	48	16100	16175	0.13015847665579391
M1	cpdb	0	network_modules	120	TRUE	4.455864791690292e-5	34	16	4	0.25	0.11764705882352941	REAC:R-HSA-5693568	REAC	Resolution of D-loop Structures through Holliday Junction Intermediates	10916	2077		0.125	0.2222222222222222	34	10882	4	12	30	10870	10916	0.169750746403711
M1	cpdb	0	network_modules	120	TRUE	5.02638390126151e-5	35	16	4	0.25	0.11428571428571428	REAC:R-HSA-5693537	REAC	Resolution of D-Loop Structures	10916	2076		0.25	0.3333333333333333	35	10881	4	12	31	10869	10916	0.16725376638448985
M1	cpdb	0	network_modules	120	TRUE	7.637173131794986e-5	61	27	5	0.18518518518518517	0.08196721311475409	GO:0035825	GO:BP	homologous recombination	16175	9273		0.28	0.3076923076923077	61	16114	5	22	56	16092	16175	0.12102381621061131
M1	cpdb	0	network_modules	120	TRUE	9.002757315808802e-5	63	27	5	0.18518518518518517	0.07936507936507936	GO:1904356	GO:BP	regulation of telomere maintenance via telomere lengthening	16175	23743		0.32	0.34615384615384615	63	16112	5	22	58	16090	16175	0.11901352896086873
M1	cpdb	0	network_modules	120	TRUE	2.2582828282020372e-4	7	27	3	0.1111111111111111	0.42857142857142855	GO:0072423	GO:BP	response to DNA damage checkpoint signaling	16175	17395		0.36	0.46153846153846156	7	16168	3	24	4	16144	16175	0.21759669023535055
M1	cpdb	0	network_modules	120	TRUE	2.2582828282020372e-4	7	27	3	0.1111111111111111	0.42857142857142855	GO:0072402	GO:BP	response to DNA integrity checkpoint signaling	16175	17391		0.36	0.46153846153846156	7	16168	3	24	4	16144	16175	0.21759669023535055
M1	cpdb	0	network_modules	120	TRUE	2.2582828282020372e-4	7	27	3	0.1111111111111111	0.42857142857142855	GO:0072396	GO:BP	response to cell cycle checkpoint signaling	16175	17388		0.36	0.46153846153846156	7	16168	3	24	4	16144	16175	0.21759669023535055
M1	cpdb	0	network_modules	120	TRUE	2.4510778686522787e-4	152	27	6	0.2222222222222222	0.039473684210526314	GO:0000723	GO:BP	telomere maintenance	16175	202		0.48	0.5	152	16023	6	21	146	16002	16175	0.09019775777604461
M1	cpdb	0	network_modules	120	TRUE	3.0149506628521694e-4	132	16	5	0.3125	0.03787878787878788	REAC:R-HSA-5693567	REAC	HDR through Homologous Recombination (HRR) or Single Strand Annealing (SSA)	10916	1098		0.375	0.4444444444444444	132	10784	5	11	127	10773	10916	0.10530387781545313
M1	cpdb	0	network_modules	120	TRUE	3.758923879199089e-4	138	16	5	0.3125	0.036231884057971016	REAC:R-HSA-5693538	REAC	Homology Directed Repair	10916	1130		0.5	0.5555555555555556	138	10778	5	11	133	10767	10916	0.10282939629042584
M1	cpdb	0	network_modules	120	TRUE	5.459108832111493e-4	90	27	5	0.18518518518518517	0.05555555555555555	GO:2001251	GO:BP	negative regulation of chromosome organization	16175	26440		0.52	0.5384615384615384	90	16085	5	22	85	16063	16175	0.09873979644061029
M1	cpdb	0	network_modules	120	TRUE	6.118075043057567e-4	37	27	4	0.14814814814814814	0.10810810810810811	GO:0016233	GO:BP	telomere capping	16175	5178		0.56	0.5769230769230769	37	16138	4	23	33	16115	16175	0.12484733607470526
M1	cpdb	0	network_modules	120	TRUE	6.456087096540229e-4	2	16	2	0.125	1	REAC:R-HSA-5545619	REAC	XAV939 stabilizes AXIN	10916	2675		0.625	0.6666666666666666	2	10914	2	14	0	10900	10916	0.35332655644370065
M1	cpdb	0	network_modules	120	TRUE	6.79164176946532e-4	298	27	7	0.25925925925925924	0.02348993288590604	GO:0006302	GO:BP	double-strand break repair	16175	2109		0.6	0.6153846153846154	298	15877	7	20	291	15857	16175	0.07323107855522408
M1	cpdb	0	network_modules	120	TRUE	7.101752502960089e-4	182	27	6	0.2222222222222222	0.03296703296703297	GO:0032200	GO:BP	telomere organization	16175	7392		0.64	0.6538461538461539	182	15993	6	21	176	15972	16175	0.0817875951894686
M1	cpdb	0	network_modules	120	TRUE	7.593610036227843e-4	68	16	4	0.25	0.058823529411764705	REAC:R-HSA-5685942	REAC	HDR through Homologous Recombination (HRR)	10916	1097		0.75	0.7777777777777778	68	10848	4	12	64	10836	10916	0.11870317143066614
M1	cpdb	0	network_modules	120	TRUE	8.79376143802433e-4	99	27	5	0.18518518518518517	0.050505050505050504	GO:0007127	GO:BP	meiosis I	16175	2698		0.68	0.6923076923076923	99	16076	5	22	94	16054	16175	0.09387933653481195
M1	cpdb	0	network_modules	120	TRUE	9.92909321586653e-4	168	16	5	0.3125	0.02976190476190476	REAC:R-HSA-5693532	REAC	DNA Double-Strand Break Repair	10916	443		0.875	0.8888888888888888	168	10748	5	11	163	10737	10916	0.09247166967980945
M1	cpdb	0	network_modules	120	TRUE	0.0011242705068795057	104	27	5	0.18518518518518517	0.04807692307692308	GO:0032204	GO:BP	regulation of telomere maintenance	16175	7396		0.72	0.7307692307692307	104	16071	5	22	99	16049	16175	0.09145092818881413
M1	cpdb	0	network_modules	120	TRUE	0.0012952309753519549	107	27	5	0.18518518518518517	0.04672897196261682	GO:0061982	GO:BP	meiosis I cell cycle process	16175	15766		0.76	0.7692307692307693	107	16068	5	22	102	16046	16175	0.0900746519302769
M1	cpdb	0	network_modules	120	TRUE	0.001315478575447418	41	12	3	0.25	0.07317073170731707	KEGG:03440	KEGG	Homologous recombination	8484	240		1	1	41	8443	3	9	38	8434	8484	0.13305177154863182
M1	cpdb	0	network_modules	120	TRUE	0.0014238258446532621	329	16	6	0.375	0.0182370820668693	REAC:R-HSA-73894	REAC	DNA Repair	10916	444		1	1	329	10587	6	10	323	10577	10916	0.07728044929369811
M1	cpdb	0	network_modules	120	TRUE	0.002287879528247179	120	27	5	0.18518518518518517	0.041666666666666664	GO:0051053	GO:BP	negative regulation of DNA metabolic process	16175	13463		0.8	0.8076923076923077	120	16055	5	22	115	16033	16175	0.08470723911843756
M1	cpdb	0	network_modules	120	TRUE	0.004192715654658986	2	27	2	0.07407407407407407	1	GO:1904743	GO:BP	negative regulation of telomeric DNA binding	16175	24070		0.84	0.8461538461538461	2	16173	2	25	0	16148	16175	0.27195509076604235
M1	cpdb	0	network_modules	120	TRUE	0.005619001061362678	144	27	5	0.18518518518518517	0.034722222222222224	GO:0140013	GO:BP	meiotic nuclear division	16175	19632		0.88	0.8846153846153846	144	16031	5	22	139	16009	16175	0.07673872708237835
M1	cpdb	0	network_modules	120	TRUE	0.007721746830703984	69	27	4	0.14814814814814814	0.057971014492753624	GO:0032206	GO:BP	positive regulation of telomere maintenance	16175	7398		0.92	0.9230769230769231	69	16106	4	23	65	16083	16175	0.09027256805051075
M1	cpdb	0	network_modules	120	TRUE	0.008867118403915323	281	27	6	0.2222222222222222	0.021352313167259787	GO:0006310	GO:BP	DNA recombination	16175	2115		0.96	0.9615384615384616	281	15894	6	21	275	15873	16175	0.06411098371411823
M1	cpdb	0	network_modules	120	TRUE	0.009701188872905664	161	27	5	0.18518518518518517	0.031055900621118012	GO:1903046	GO:BP	meiotic cell cycle process	16175	22726		1	1	161	16014	5	22	156	15992	16175	0.072179897496567
M1	cpdb	0	network_modules	121	TRUE	2.7462758917364013e-6	44	20	5	0.25	0.11363636363636363	KEGG:00970	KEGG	Aminoacyl-tRNA biosynthesis	8484	153		0	0.3333333333333333	44	8440	5	15	39	8425	8484	0.16567848150746786
M1	cpdb	0	network_modules	121	TRUE	1.228994730391733e-5	38	31	5	0.16129032258064516	0.13157894736842105	GO:0006418	GO:BP	tRNA aminoacylation for protein translation	16175	2175		0	0.14285714285714285	38	16137	5	26	33	16111	16175	0.1438640739693686
M1	cpdb	0	network_modules	121	TRUE	1.8275161101375533e-5	41	31	5	0.16129032258064516	0.12195121951219512	GO:0043039	GO:BP	tRNA aminoacylation	16175	10489		0.16666666666666666	0.42857142857142855	41	16134	5	26	36	16108	16175	0.13835202337462554
M1	cpdb	0	network_modules	121	TRUE	1.8275161101375533e-5	41	31	5	0.16129032258064516	0.12195121951219512	GO:0043038	GO:BP	amino acid activation	16175	10488		0.16666666666666666	0.42857142857142855	41	16134	5	26	36	16108	16175	0.13835202337462554
M1	cpdb	0	network_modules	121	TRUE	1.1109194939993542e-4	292	19	7	0.3684210526315789	0.023972602739726026	REAC:R-HSA-72766	REAC	Translation	10916	2565		0	0.3333333333333333	292	10624	7	12	285	10612	10916	0.0884219178225788
M1	cpdb	0	network_modules	121	TRUE	2.2409267481883128e-4	42	19	4	0.21052631578947367	0.09523809523809523	REAC:R-HSA-379724	REAC	tRNA Aminoacylation	10916	2740		0.5	0.6666666666666666	42	10874	4	15	38	10859	10916	0.13940019271875287
M1	cpdb	0	network_modules	121	TRUE	0.001445659935609165	11	31	3	0.0967741935483871	0.2727272727272727	GO:0006614	GO:BP	SRP-dependent cotranslational protein targeting to membrane	16175	2329		0.5	0.5714285714285714	11	16164	3	28	8	16136	16175	0.1615272001831636
M1	cpdb	0	network_modules	121	TRUE	0.0028161162321667828	24	19	3	0.15789473684210525	0.125	REAC:R-HSA-379716	REAC	Cytosolic tRNA aminoacylation	10916	430		1	1	24	10892	3	16	21	10876	10916	0.13880503843176983
M1	cpdb	0	network_modules	121	TRUE	0.0030523727925125784	31	20	3	0.15	0.0967741935483871	KEGG:03060	KEGG	Protein export	8484	217		0.5	0.6666666666666666	31	8453	3	17	28	8436	8484	0.11790238571751319
M1	cpdb	0	network_modules	121	TRUE	0.005228888500744766	37	20	3	0.15	0.08108108108108109	KEGG:01250	KEGG	Biosynthesis of nucleotide sugars	8484	191		1	1	37	8447	3	17	34	8430	8484	0.10743677441529953
M1	cpdb	0	network_modules	121	TRUE	0.007084737757149372	18	31	3	0.0967741935483871	0.16666666666666666	GO:0006613	GO:BP	cotranslational protein targeting to membrane	16175	2328		0.6666666666666666	0.7142857142857143	18	16157	3	28	15	16129	16175	0.12573017523062804
M1	cpdb	0	network_modules	121	TRUE	0.007912984557869233	62	31	4	0.12903225806451613	0.06451612903225806	GO:0006112	GO:BP	energy reserve metabolic process	16175	1971		0.8333333333333334	0.8571428571428571	62	16113	4	27	58	16086	16175	0.08878446990468865
M1	cpdb	0	network_modules	121	TRUE	0.008859838847230326	247	31	6	0.1935483870967742	0.024291497975708502	GO:0006520	GO:BP	amino acid metabolic process	16175	2241		1	1	247	15928	6	25	241	15903	16175	0.06370712269508991
M1	cpdb	0	network_modules	122	TRUE	9.457035072247293e-16	16	30	8	0.26666666666666666	0.5	GO:0006744	GO:BP	ubiquinone biosynthetic process	16175	2443		0	0.05555555555555555	16	16159	8	22	8	16137	16175	0.36431194663613187
M1	cpdb	0	network_modules	122	TRUE	9.457035072247293e-16	16	30	8	0.26666666666666666	0.5	GO:1901663	GO:BP	quinone biosynthetic process	16175	21630		0	0.05555555555555555	16	16159	8	22	8	16137	16175	0.36431194663613187
M1	cpdb	0	network_modules	122	TRUE	3.207615295946211e-15	18	30	8	0.26666666666666666	0.4444444444444444	GO:0006743	GO:BP	ubiquinone metabolic process	16175	2442		0.05714285714285714	0.08333333333333333	18	16157	8	22	10	16135	16175	0.3433379896877745
M1	cpdb	0	network_modules	122	TRUE	2.3327005474363226e-14	22	30	8	0.26666666666666666	0.36363636363636365	GO:1901661	GO:BP	quinone metabolic process	16175	21628		0.08571428571428572	0.1111111111111111	22	16153	8	22	14	16131	16175	0.31031010324423974
M1	cpdb	0	network_modules	122	TRUE	8.404106786186898e-12	42	30	8	0.26666666666666666	0.19047619047619047	GO:0042181	GO:BP	ketone biosynthetic process	16175	10009		0.11428571428571428	0.1388888888888889	42	16133	8	22	34	16111	16175	0.22367778607724453
M1	cpdb	0	network_modules	122	TRUE	1.9380092913792612e-10	18	22	6	0.2727272727272727	0.3333333333333333	REAC:R-HSA-163210	REAC	Formation of ATP by chemiosmotic coupling	10916	944		0	0.1111111111111111	18	10898	6	16	12	10882	10916	0.3002384493188861
M1	cpdb	0	network_modules	122	TRUE	3.794480352306226e-10	8	22	5	0.22727272727272727	0.625	REAC:R-HSA-2142789	REAC	Ubiquinol biosynthesis	10916	2618		0.125	0.2222222222222222	8	10908	5	17	3	10891	10916	0.37619086717652606
M1	cpdb	0	network_modules	122	TRUE	2.01845791703092e-9	232	15	9	0.6	0.03879310344827586	KEGG:04714	KEGG	Thermogenesis	8484	349		0	0.09090909090909091	232	8252	9	6	223	8246	8484	0.14777440831254482
M1	cpdb	0	network_modules	122	TRUE	7.561701067126627e-9	31	22	6	0.2727272727272727	0.1935483870967742	REAC:R-HSA-8949613	REAC	Cristae formation	10916	414		0.25	0.3333333333333333	31	10885	6	16	25	10869	10916	0.227912809796367
M1	cpdb	0	network_modules	122	TRUE	7.701556743165456e-8	134	15	7	0.4666666666666667	0.05223880597014925	KEGG:00190	KEGG	Oxidative phosphorylation	8484	18		0.1	0.18181818181818182	134	8350	7	8	127	8342	8484	0.1521906855266693
M1	cpdb	0	network_modules	122	TRUE	7.767129198517244e-8	19	22	5	0.22727272727272727	0.2631578947368421	REAC:R-HSA-8978934	REAC	Metabolism of cofactors	10916	1423		0.375	0.4444444444444444	19	10897	5	17	14	10880	10916	0.24314166761984146
M1	cpdb	0	network_modules	122	TRUE	8.607928037904449e-8	127	30	8	0.26666666666666666	0.06299212598425197	GO:0006119	GO:BP	oxidative phosphorylation	16175	1977		0.14285714285714285	0.16666666666666666	127	16048	8	22	119	16026	16175	0.1264046615314051
M1	cpdb	0	network_modules	122	TRUE	1.31537390623359e-7	11	15	4	0.26666666666666666	0.36363636363636365	KEGG:00130	KEGG	Ubiquinone and other terpenoid-quinone biosynthesis	8484	16		0.2	0.2727272727272727	11	8473	4	11	7	8462	8484	0.3103610975804535
M1	cpdb	0	network_modules	122	TRUE	3.5822123741583074e-7	177	22	8	0.36363636363636365	0.04519774011299435	REAC:R-HSA-1428517	REAC	Aerobic respiration and respiratory electron transport	10916	127		0.5	0.5555555555555556	177	10739	8	14	169	10725	10916	0.12361451943068993
M1	cpdb	0	network_modules	122	TRUE	6.07482173678094e-7	162	30	8	0.26666666666666666	0.04938271604938271	GO:0009060	GO:BP	aerobic respiration	16175	3236		0.17142857142857143	0.19444444444444445	162	16013	8	22	154	15991	16175	0.1111054468174913
M1	cpdb	0	network_modules	122	TRUE	8.511588602058044e-7	169	30	8	0.26666666666666666	0.047337278106508875	GO:0042180	GO:BP	ketone metabolic process	16175	10008		0.2	0.2222222222222222	169	16006	8	22	161	15984	16175	0.10862043132763116
M1	cpdb	0	network_modules	122	TRUE	1.3586004542315595e-6	202	15	7	0.4666666666666667	0.034653465346534656	KEGG:05415	KEGG	Diabetic cardiomyopathy	8484	492		0.3	0.36363636363636365	202	8282	7	8	195	8274	8484	0.1222504816762745
M1	cpdb	0	network_modules	122	TRUE	1.98429793340889e-6	188	30	8	0.26666666666666666	0.0425531914893617	GO:0045333	GO:BP	cellular respiration	16175	11360		0.22857142857142856	0.25	188	15987	8	22	180	15965	16175	0.10257422315899017
M1	cpdb	0	network_modules	122	TRUE	2.6922166030472365e-6	65	30	6	0.2	0.09230769230769231	GO:0042776	GO:BP	proton motive force-driven mitochondrial ATP synthesis	16175	10361		0.2571428571428571	0.2777777777777778	65	16110	6	24	59	16086	16175	0.13353540144570206
M1	cpdb	0	network_modules	122	TRUE	5.047173280566254e-6	72	30	6	0.2	0.08333333333333333	GO:0015986	GO:BP	proton motive force-driven ATP synthesis	16175	5062		0.2857142857142857	0.3055555555555556	72	16103	6	24	66	16079	16175	0.12662549319733313
M1	cpdb	0	network_modules	122	TRUE	6.780878857526349e-6	92	22	6	0.2727272727272727	0.06521739130434782	REAC:R-HSA-1592230	REAC	Mitochondrial biogenesis	10916	1464		0.625	0.6666666666666666	92	10824	6	16	86	10808	10916	0.1299239907128622
M1	cpdb	0	network_modules	122	TRUE	1.0300269012537935e-5	271	15	7	0.4666666666666667	0.025830258302583026	KEGG:05020	KEGG	Prion disease	8484	416		0.4	0.45454545454545453	271	8213	7	8	264	8205	8484	0.1040419467442646
M1	cpdb	0	network_modules	122	TRUE	1.9656492095526606e-5	90	30	6	0.2	0.06666666666666667	GO:0006754	GO:BP	ATP biosynthetic process	16175	2451		0.3142857142857143	0.3333333333333333	90	16085	6	24	84	16061	16175	0.11267575196990004
M1	cpdb	0	network_modules	122	TRUE	1.988103450477712e-5	252	30	8	0.26666666666666666	0.031746031746031744	GO:0015980	GO:BP	energy derivation by oxidation of organic compounds	16175	5060		0.34285714285714286	0.3611111111111111	252	15923	8	22	244	15901	16175	0.08739720025388503
M1	cpdb	0	network_modules	122	TRUE	2.2454817235371598e-5	92	30	6	0.2	0.06521739130434782	GO:0009206	GO:BP	purine ribonucleoside triphosphate biosynthetic process	16175	3372		0.37142857142857144	0.4166666666666667	92	16083	6	24	86	16059	16175	0.11138033994127028
M1	cpdb	0	network_modules	122	TRUE	2.2454817235371598e-5	92	30	6	0.2	0.06521739130434782	GO:0009145	GO:BP	purine nucleoside triphosphate biosynthetic process	16175	3312		0.37142857142857144	0.4166666666666667	92	16083	6	24	86	16059	16175	0.11138033994127028
M1	cpdb	0	network_modules	122	TRUE	3.092003456007433e-5	97	30	6	0.2	0.061855670103092786	GO:0009201	GO:BP	ribonucleoside triphosphate biosynthetic process	16175	3367		0.42857142857142855	0.4444444444444444	97	16078	6	24	91	16054	16175	0.10831601223473679
M1	cpdb	0	network_modules	122	TRUE	4.439857228122729e-5	103	30	6	0.2	0.05825242718446602	GO:0009142	GO:BP	nucleoside triphosphate biosynthetic process	16175	3309		0.45714285714285713	0.4722222222222222	103	16072	6	24	97	16048	16175	0.10493244246259882
M1	cpdb	0	network_modules	122	TRUE	5.277238913885648e-5	184	30	7	0.23333333333333334	0.03804347826086957	GO:0046034	GO:BP	ATP metabolic process	16175	11811		0.4857142857142857	0.5	184	15991	7	23	177	15968	16175	0.0902213850331207
M1	cpdb	0	network_modules	122	TRUE	7.618486789821156e-5	221	15	6	0.4	0.027149321266968326	KEGG:05208	KEGG	Chemical carcinogenesis - reactive oxygen species	8484	460		0.5	0.5454545454545454	221	8263	6	9	215	8254	8484	0.09880521551138532
M1	cpdb	0	network_modules	122	TRUE	8.735814683686008e-5	198	30	7	0.23333333333333334	0.03535353535353535	GO:0009205	GO:BP	purine ribonucleoside triphosphate metabolic process	16175	3371		0.5142857142857142	0.5277777777777778	198	15977	7	23	191	15954	16175	0.08667206436763097
M1	cpdb	0	network_modules	122	TRUE	9.68475558869303e-5	201	30	7	0.23333333333333334	0.03482587064676617	GO:0009144	GO:BP	purine nucleoside triphosphate metabolic process	16175	3311		0.5428571428571428	0.5555555555555556	201	15974	7	23	194	15951	16175	0.08595873345340617
M1	cpdb	0	network_modules	122	TRUE	1.0719525314561622e-4	204	30	7	0.23333333333333334	0.03431372549019608	GO:0009199	GO:BP	ribonucleoside triphosphate metabolic process	16175	3365		0.5714285714285714	0.5833333333333334	204	15971	7	23	197	15948	16175	0.08526071197977209
M1	cpdb	0	network_modules	122	TRUE	0.00015352441406741161	215	30	7	0.23333333333333334	0.03255813953488372	GO:0009141	GO:BP	nucleoside triphosphate metabolic process	16175	3308		0.6	0.6111111111111112	215	15960	7	23	208	15937	16175	0.08282362880312709
M1	cpdb	0	network_modules	122	TRUE	1.631198311085786e-4	128	30	6	0.2	0.046875	GO:0009152	GO:BP	purine ribonucleotide biosynthetic process	16175	3319		0.6285714285714286	0.6388888888888888	128	16047	6	24	122	16023	16175	0.09345035269489092
M1	cpdb	0	network_modules	122	TRUE	2.198945176268193e-4	265	15	6	0.4	0.022641509433962263	KEGG:05012	KEGG	Parkinson disease	8484	412		0.6	0.6363636363636364	265	8219	6	9	259	8210	8484	0.08921690986819403
M1	cpdb	0	network_modules	122	TRUE	2.4435223264898144e-4	137	30	6	0.2	0.043795620437956206	GO:0009260	GO:BP	ribonucleotide biosynthetic process	16175	3425		0.6571428571428571	0.6666666666666666	137	16038	6	24	131	16014	16175	0.09009229038114279
M1	cpdb	0	network_modules	122	TRUE	3.1508575833283576e-4	143	30	6	0.2	0.04195804195804196	GO:0046390	GO:BP	ribose phosphate biosynthetic process	16175	12117		0.6857142857142857	0.6944444444444444	143	16032	6	24	137	16008	16175	0.08802767211081783
M1	cpdb	0	network_modules	122	TRUE	3.400674019000137e-4	364	30	8	0.26666666666666666	0.02197802197802198	GO:0007005	GO:BP	mitochondrion organization	16175	2617		0.7142857142857143	0.7222222222222222	364	15811	8	22	356	15789	16175	0.07096350082854014
M1	cpdb	0	network_modules	122	TRUE	4.0138377756409433e-4	372	30	8	0.26666666666666666	0.021505376344086023	GO:0006091	GO:BP	generation of precursor metabolites and energy	16175	1954		0.7428571428571429	0.75	372	15803	8	22	364	15781	16175	0.07007184118444361
M1	cpdb	0	network_modules	122	TRUE	4.961517024020437e-4	305	15	6	0.4	0.019672131147540985	KEGG:05016	KEGG	Huntington disease	8484	414		0.7	0.7272727272727273	305	8179	6	9	299	8170	8484	0.08229836483928063
M1	cpdb	0	network_modules	122	TRUE	6.512592965392771e-4	266	30	7	0.23333333333333334	0.02631578947368421	GO:0009150	GO:BP	purine ribonucleotide metabolic process	16175	3317		0.7714285714285715	0.7777777777777778	266	15909	7	23	259	15886	16175	0.07351222388413335
M1	cpdb	0	network_modules	122	TRUE	7.076132863006383e-4	164	30	6	0.2	0.036585365853658534	GO:0006164	GO:BP	purine nucleotide biosynthetic process	16175	1999		0.8	0.8055555555555556	164	16011	6	24	158	15987	16175	0.08169401980982166
M1	cpdb	0	network_modules	122	TRUE	8.351220618644187e-4	276	30	7	0.23333333333333334	0.025362318840579712	GO:0009259	GO:BP	ribonucleotide metabolic process	16175	3424		0.8285714285714286	0.8333333333333334	276	15899	7	23	269	15876	16175	0.07198510693547706
M1	cpdb	0	network_modules	122	TRUE	9.883245132260503e-4	283	30	7	0.23333333333333334	0.024734982332155476	GO:0019693	GO:BP	ribose phosphate metabolic process	16175	6010		0.8571428571428571	0.8611111111111112	283	15892	7	23	276	15869	16175	0.07096262774744828
M1	cpdb	0	network_modules	122	TRUE	0.0013040405928422382	16	22	3	0.13636363636363635	0.1875	REAC:R-HSA-8949664	REAC	Processing of SMDT1	10916	1800		0.75	0.7777777777777778	16	10900	3	19	13	10881	10916	0.15845761835371047
M1	cpdb	0	network_modules	122	TRUE	0.0013462738450124691	363	15	6	0.4	0.01652892561983471	KEGG:05014	KEGG	Amyotrophic lateral sclerosis	8484	413		0.8	0.8181818181818182	363	8121	6	9	357	8112	8484	0.0742848266495848
M1	cpdb	0	network_modules	122	TRUE	0.0014804416519879765	186	30	6	0.2	0.03225806451612903	GO:0009165	GO:BP	nucleotide biosynthetic process	16175	3331		0.8857142857142857	0.8888888888888888	186	15989	6	24	180	15965	16175	0.07621349951230735
M1	cpdb	0	network_modules	122	TRUE	0.0017998160728272448	382	15	6	0.4	0.015706806282722512	KEGG:05010	KEGG	Alzheimer disease	8484	411		0.9	0.9090909090909091	382	8102	6	9	376	8093	8484	0.07204420456123103
M1	cpdb	0	network_modules	122	TRUE	0.0028336718511781105	482	30	8	0.26666666666666666	0.016597510373443983	GO:0044283	GO:BP	small molecule biosynthetic process	16175	10950		0.9142857142857143	0.9166666666666666	482	15693	8	22	474	15671	16175	0.06005027965626054
M1	cpdb	0	network_modules	122	TRUE	0.003930662110450979	220	30	6	0.2	0.02727272727272727	GO:0072522	GO:BP	purine-containing compound biosynthetic process	16175	17424		0.9428571428571428	0.9444444444444444	220	15955	6	24	214	15931	16175	0.06936959747818763
M1	cpdb	0	network_modules	122	TRUE	0.004001950109968724	349	30	7	0.23333333333333334	0.02005730659025788	GO:0006163	GO:BP	purine nucleotide metabolic process	16175	1998		0.9714285714285714	0.9722222222222222	349	15826	7	23	342	15803	16175	0.06282391796896852
M1	cpdb	0	network_modules	122	TRUE	0.004086488663090117	23	22	3	0.13636363636363635	0.13043478260869565	REAC:R-HSA-8949215	REAC	Mitochondrial calcium ion transport	10916	1465		0.875	0.8888888888888888	23	10893	3	19	20	10874	10916	0.13157678726397642
M1	cpdb	0	network_modules	122	TRUE	0.006030179237031277	292	22	6	0.2727272727272727	0.02054794520547945	REAC:R-HSA-1852241	REAC	Organelle biogenesis and maintenance	10916	1646		1	1	292	10624	6	16	286	10608	10916	0.06850798475226674
M1	cpdb	0	network_modules	122	TRUE	0.0075444415689372235	153	15	4	0.26666666666666666	0.026143790849673203	KEGG:01240	KEGG	Biosynthesis of cofactors	8484	190		1	1	153	8331	4	11	149	8320	8484	0.07863107662724728
M1	cpdb	0	network_modules	122	TRUE	0.00804666475726919	388	30	7	0.23333333333333334	0.01804123711340206	GO:0009117	GO:BP	nucleotide metabolic process	16175	3286		1	1	388	15787	7	23	381	15764	16175	0.0589772156801977
M1	cpdb	0	network_modules	123	TRUE	1.2107720336764969e-17	24	20	9	0.45	0.375	REAC:R-HSA-6783589	REAC	Interleukin-6 family signaling	10916	1253		0	0.3333333333333333	24	10892	9	11	15	10881	10916	0.40961040491957545
M1	cpdb	0	network_modules	123	TRUE	1.3781178265206802e-13	17	20	7	0.35	0.4117647058823529	REAC:R-HSA-6788467	REAC	IL-6-type cytokine receptor ligand interactions	10916	1146		0.5	0.6666666666666666	17	10899	7	13	10	10886	10916	0.3785807282292146
M1	cpdb	0	network_modules	123	TRUE	4.068435130703768e-9	54	27	7	0.25925925925925924	0.12962962962962962	GO:0042531	GO:BP	positive regulation of tyrosine phosphorylation of STAT protein	16175	10227		0	0.045454545454545456	54	16121	7	20	47	16101	16175	0.18141762310011378
M1	cpdb	0	network_modules	123	TRUE	1.0558094212918559e-8	162	16	8	0.5	0.04938271604938271	KEGG:04630	KEGG	JAK-STAT signaling pathway	8484	332		0	0.5	162	8322	8	8	154	8314	8484	0.15274196264905557
M1	cpdb	0	network_modules	123	TRUE	1.2586471811765178e-8	63	27	7	0.25925925925925924	0.1111111111111111	GO:0042509	GO:BP	regulation of tyrosine phosphorylation of STAT protein	16175	10226		0.047619047619047616	0.09090909090909091	63	16112	7	20	56	16092	16175	0.16764171071099002
M1	cpdb	0	network_modules	123	TRUE	1.580344708980084e-8	65	27	7	0.25925925925925924	0.1076923076923077	GO:0007260	GO:BP	tyrosine phosphorylation of STAT protein	16175	2790		0.09523809523809523	0.13636363636363635	65	16110	7	20	58	16090	16175	0.1649727827631759
M1	cpdb	0	network_modules	123	TRUE	4.8036118426015603e-8	5	27	4	0.14814814814814814	0.8	GO:0070120	GO:BP	ciliary neurotrophic factor-mediated signaling pathway	16175	15922		0.14285714285714285	0.18181818181818182	5	16170	4	23	1	16147	16175	0.34388710479424905
M1	cpdb	0	network_modules	123	TRUE	1.1083725692155787e-6	291	16	8	0.5	0.027491408934707903	KEGG:04060	KEGG	Cytokine-cytokine receptor interaction	8484	253		1	1	291	8193	8	8	283	8185	8484	0.11122659042179234
M1	cpdb	0	network_modules	123	TRUE	2.3580022623766227e-6	131	27	7	0.25925925925925924	0.05343511450381679	GO:0050731	GO:BP	positive regulation of peptidyl-tyrosine phosphorylation	16175	13230		0.19047619047619047	0.22727272727272727	131	16044	7	20	124	16024	16175	0.11458450445796522
M1	cpdb	0	network_modules	123	TRUE	4.149881807799006e-6	142	27	7	0.25925925925925924	0.04929577464788732	GO:0007259	GO:BP	cell surface receptor signaling pathway via JAK-STAT	16175	2789		0.23809523809523808	0.2727272727272727	142	16033	7	20	135	16013	16175	0.10979656959399069
M1	cpdb	0	network_modules	123	TRUE	5.809278281948473e-6	149	27	7	0.25925925925925924	0.04697986577181208	GO:0097696	GO:BP	cell surface receptor signaling pathway via STAT	16175	18727		0.2857142857142857	0.3181818181818182	149	16026	7	20	142	16006	16175	0.10702460571681066
M1	cpdb	0	network_modules	123	TRUE	1.7788177476636997e-5	175	27	7	0.25925925925925924	0.04	GO:0050730	GO:BP	regulation of peptidyl-tyrosine phosphorylation	16175	13229		0.3333333333333333	0.36363636363636365	175	16000	7	20	168	15980	16175	0.09819954376612548
M1	cpdb	0	network_modules	123	TRUE	1.816126162655004e-5	472	20	9	0.45	0.019067796610169493	REAC:R-HSA-449147	REAC	Signaling by Interleukins	10916	2261		1	1	472	10444	9	11	463	10433	10916	0.08568001860794354
M1	cpdb	0	network_modules	123	TRUE	7.128641766495966e-5	214	27	7	0.25925925925925924	0.03271028037383177	GO:0018108	GO:BP	peptidyl-tyrosine phosphorylation	16175	5327		0.38095238095238093	0.4090909090909091	214	15961	7	20	207	15941	16175	0.08804731287979267
M1	cpdb	0	network_modules	123	TRUE	7.360510417096084e-5	215	27	7	0.25925925925925924	0.03255813953488372	GO:0018212	GO:BP	peptidyl-tyrosine modification	16175	5371		0.42857142857142855	0.45454545454545453	215	15960	7	20	208	15940	16175	0.0878229906515715
M1	cpdb	0	network_modules	123	TRUE	3.020226543490657e-4	80	27	5	0.18518518518518517	0.0625	GO:0043524	GO:BP	negative regulation of neuron apoptotic process	16175	10753		0.47619047619047616	0.5	80	16095	5	22	75	16073	16175	0.10505718587038596
M1	cpdb	0	network_modules	123	TRUE	0.0015512598306263402	686	27	9	0.3333333333333333	0.013119533527696793	GO:0008284	GO:BP	positive regulation of cell population proliferation	16175	3151		0.5238095238095238	0.5454545454545454	686	15489	9	18	677	15471	16175	0.05902961136691785
M1	cpdb	0	network_modules	123	TRUE	0.002287879528247179	120	27	5	0.18518518518518517	0.041666666666666664	GO:0043523	GO:BP	regulation of neuron apoptotic process	16175	10752		0.5714285714285714	0.5909090909090909	120	16055	5	22	115	16033	16175	0.08470723911843756
M1	cpdb	0	network_modules	123	TRUE	0.003559067221583319	555	27	8	0.2962962962962963	0.014414414414414415	GO:0071345	GO:BP	cellular response to cytokine stimulus	16175	16597		0.6190476190476191	0.6363636363636364	555	15620	8	19	547	15601	16175	0.05885111644986992
M1	cpdb	0	network_modules	123	TRUE	0.004012331919264063	564	27	8	0.2962962962962963	0.014184397163120567	GO:0045937	GO:BP	positive regulation of phosphate metabolic process	16175	11731		0.6666666666666666	0.7272727272727273	564	15611	8	19	556	15592	16175	0.058272472091042776
M1	cpdb	0	network_modules	123	TRUE	0.004012331919264063	564	27	8	0.2962962962962963	0.014184397163120567	GO:0010562	GO:BP	positive regulation of phosphorus metabolic process	16175	4215		0.6666666666666666	0.7272727272727273	564	15611	8	19	556	15592	16175	0.058272472091042776
M1	cpdb	0	network_modules	123	TRUE	0.004192715654658986	2	27	2	0.07407407407407407	1	GO:0002384	GO:BP	hepatic immune response	16175	911		0.7619047619047619	0.7727272727272727	2	16173	2	25	0	16148	16175	0.27195509076604235
M1	cpdb	0	network_modules	123	TRUE	0.004398785169219106	137	27	5	0.18518518518518517	0.0364963503649635	GO:0051402	GO:BP	neuron apoptotic process	16175	13695		0.8095238095238095	0.8181818181818182	137	16038	5	22	132	16016	16175	0.07885071303094891
M1	cpdb	0	network_modules	123	TRUE	0.00659557987132567	419	27	7	0.25925925925925924	0.016706443914081145	GO:0019221	GO:BP	cytokine-mediated signaling pathway	16175	5598		0.8571428571428571	0.8636363636363636	419	15756	7	20	412	15736	16175	0.06006950796351773
M1	cpdb	0	network_modules	123	TRUE	0.008589083466843363	625	27	8	0.2962962962962963	0.0128	GO:1901652	GO:BP	response to peptide	16175	21619		0.9047619047619048	0.9545454545454546	625	15550	8	19	617	15531	16175	0.054664145515997964
M1	cpdb	0	network_modules	123	TRUE	0.008589083466843363	625	27	8	0.2962962962962963	0.0128	GO:0034097	GO:BP	response to cytokine	16175	8408		0.9047619047619048	0.9545454545454546	625	15550	8	19	617	15531	16175	0.054664145515997964
M1	cpdb	0	network_modules	123	TRUE	0.009323936198562005	632	27	8	0.2962962962962963	0.012658227848101266	GO:0031401	GO:BP	positive regulation of protein modification process	16175	7157		1	1	632	15543	8	19	624	15524	16175	0.054281487534961995
M1	cpdb	0	network_modules	124	TRUE	1.0426586134058328e-8	5	19	4	0.21052631578947367	0.8	REAC:R-HSA-5624138	REAC	Trafficking of myristoylated proteins to the cilium	10916	2534		0	0.25	5	10911	4	15	1	10896	10916	0.4099491932600253
M1	cpdb	0	network_modules	124	TRUE	6.417049728353829e-6	51	19	5	0.2631578947368421	0.09803921568627451	REAC:R-HSA-5620920	REAC	Cargo trafficking to the periciliary membrane	10916	310		0.3333333333333333	0.5	51	10865	5	14	46	10851	10916	0.15827913889104606
M1	cpdb	0	network_modules	124	TRUE	2.9825862176254106e-4	126	9	4	0.4444444444444444	0.031746031746031744	KEGG:00230	KEGG	Purine metabolism	8484	22		NA	1	126	8358	4	5	122	8353	8484	0.11573714370947408
M1	cpdb	0	network_modules	124	TRUE	0.0028161162321667828	24	19	3	0.15789473684210525	0.125	REAC:R-HSA-9648002	REAC	RAS processing	10916	1843		0.6666666666666666	0.75	24	10892	3	16	21	10876	10916	0.13880503843176983
M1	cpdb	0	network_modules	124	TRUE	0.005900751091194866	200	19	5	0.2631578947368421	0.025	REAC:R-HSA-5617833	REAC	Cilium Assembly	10916	361		1	1	200	10716	5	14	195	10702	10916	0.07623090405982495
M1	cpdb	0	network_modules	125	TRUE	2.699215831826512e-23	20	30	11	0.36666666666666664	0.55	GO:0033141	GO:BP	positive regulation of peptidyl-serine phosphorylation of STAT protein	16175	8056		0	0.017857142857142856	20	16155	11	19	9	16136	16175	0.4482515887055365
M1	cpdb	0	network_modules	125	TRUE	5.662242886376679e-23	21	30	11	0.36666666666666664	0.5238095238095238	GO:0033139	GO:BP	regulation of peptidyl-serine phosphorylation of STAT protein	16175	8054		0.01818181818181818	0.03571428571428571	21	16154	11	19	10	16135	16175	0.43738828760150833
M1	cpdb	0	network_modules	125	TRUE	1.1312277620405253e-22	22	30	11	0.36666666666666664	0.5	GO:0042501	GO:BP	serine phosphorylation of STAT protein	16175	10225		0.03636363636363636	0.05357142857142857	22	16153	11	19	11	16134	16175	0.42727295674685534
M1	cpdb	0	network_modules	125	TRUE	1.6762664848112244e-22	24	23	11	0.4782608695652174	0.4583333333333333	REAC:R-HSA-912694	REAC	Regulation of IFNA/IFNB signaling	10916	1979		0	0.1	24	10892	11	12	13	10880	10916	0.46704423084508906
M1	cpdb	0	network_modules	125	TRUE	3.646281556514795e-21	30	23	11	0.4782608695652174	0.36666666666666664	REAC:R-HSA-933541	REAC	TRAF6 mediated IRF7 activation	10916	2465		0.1111111111111111	0.2	30	10886	11	12	19	10874	10916	0.4173697212910087
M1	cpdb	0	network_modules	125	TRUE	5.506267171282225e-21	29	30	11	0.36666666666666664	0.3793103448275862	GO:0002323	GO:BP	natural killer cell activation involved in immune response	16175	855		0.05454545454545454	0.07142857142857142	29	16146	11	19	18	16127	16175	0.37178945740655656
M1	cpdb	0	network_modules	125	TRUE	1.349048933976229e-19	37	30	11	0.36666666666666664	0.2972972972972973	GO:0043330	GO:BP	response to exogenous dsRNA	16175	10636		0.07272727272727272	0.08928571428571429	37	16138	11	19	26	16119	16175	0.3287863172931889
M1	cpdb	0	network_modules	125	TRUE	4.963674987100835e-19	41	30	11	0.36666666666666664	0.2682926829268293	GO:0043331	GO:BP	response to dsRNA	16175	10637		0.09090909090909091	0.10714285714285714	41	16134	11	19	30	16115	16175	0.3121631637386118
M1	cpdb	0	network_modules	125	TRUE	5.937791239656293e-19	64	30	12	0.4	0.1875	GO:0098586	GO:BP	cellular response to virus	16175	18801		0.10909090909090909	0.125	64	16111	12	18	52	16093	16175	0.27194263490285814
M1	cpdb	0	network_modules	125	TRUE	3.926727140027701e-18	74	30	12	0.4	0.16216216216216217	GO:0060337	GO:BP	type I interferon-mediated signaling pathway	16175	14549		0.12727272727272726	0.14285714285714285	74	16101	12	18	62	16083	16175	0.2525851261450056
M1	cpdb	0	network_modules	125	TRUE	4.669854325649457e-18	75	30	12	0.4	0.16	GO:0071357	GO:BP	cellular response to type I interferon	16175	16609		0.14545454545454545	0.17857142857142858	75	16100	12	18	63	16082	16175	0.2508641380649076
M1	cpdb	0	network_modules	125	TRUE	4.669854325649457e-18	75	30	12	0.4	0.16	GO:0030101	GO:BP	natural killer cell activation	16175	6679		0.14545454545454545	0.17857142857142858	75	16100	12	18	63	16082	16175	0.2508641380649076
M1	cpdb	0	network_modules	125	TRUE	8.199917514190648e-18	106	18	12	0.6666666666666666	0.11320754716981132	KEGG:04620	KEGG	Toll-like receptor signaling pathway	8484	325		0	0.043478260869565216	106	8378	12	6	94	8372	8484	0.2715607459457384
M1	cpdb	0	network_modules	125	TRUE	1.1736276889236549e-17	71	18	11	0.6111111111111112	0.15492957746478872	KEGG:04622	KEGG	RIG-I-like receptor signaling pathway	8484	327		0.045454545454545456	0.08695652173913043	71	8413	11	7	60	8406	8484	0.3050878531575271
M1	cpdb	0	network_modules	125	TRUE	1.2564498665698945e-17	81	30	12	0.4	0.14814814814814814	GO:0034340	GO:BP	response to type I interferon	16175	8578		0.18181818181818182	0.19642857142857142	81	16094	12	18	69	16076	16175	0.2412125961009214
M1	cpdb	0	network_modules	125	TRUE	4.038163127071234e-17	49	18	10	0.5555555555555556	0.20408163265306123	KEGG:05320	KEGG	Autoimmune thyroid disease	8484	482		0.09090909090909091	0.13043478260869565	49	8435	10	8	39	8427	8484	0.3345385085732141
M1	cpdb	0	network_modules	125	TRUE	5.863182905963513e-17	124	18	12	0.6666666666666666	0.0967741935483871	KEGG:04650	KEGG	Natural killer cell mediated cytotoxicity	8484	334		0.13636363636363635	0.17391304347826086	124	8360	12	6	112	8354	8484	0.25053321444560955
M1	cpdb	0	network_modules	125	TRUE	6.364455673902963e-17	82	18	11	0.6111111111111112	0.13414634146341464	KEGG:04623	KEGG	Cytosolic DNA-sensing pathway	8484	328		0.18181818181818182	0.21739130434782608	82	8402	11	7	71	8395	8484	0.28346278813526304
M1	cpdb	0	network_modules	125	TRUE	1.0926968241835999e-16	96	30	12	0.4	0.125	GO:0140888	GO:BP	interferon-mediated signaling pathway	16175	19923		0.2	0.21428571428571427	96	16079	12	18	84	16061	16175	0.22115080659608263
M1	cpdb	0	network_modules	125	TRUE	1.9556890664743181e-16	198	18	13	0.7222222222222222	0.06565656565656566	KEGG:05169	KEGG	Epstein-Barr virus infection	8484	450		0.22727272727272727	0.2608695652173913	198	8286	13	5	185	8281	8484	0.21345086884622594
M1	cpdb	0	network_modules	125	TRUE	2.2208563220735467e-16	138	18	12	0.6666666666666666	0.08695652173913043	KEGG:05162	KEGG	Measles	8484	443		0.2727272727272727	0.30434782608695654	138	8346	12	6	126	8340	8484	0.23708281939417922
M1	cpdb	0	network_modules	125	TRUE	3.648823999126309e-16	76	23	11	0.4782608695652174	0.14473684210526316	REAC:R-HSA-909733	REAC	Interferon alpha/beta signaling	10916	1228		0.2222222222222222	0.3	76	10840	11	12	65	10828	10916	0.26045243196228135
M1	cpdb	0	network_modules	125	TRUE	8.6637154308856945e-16	76	30	11	0.36666666666666664	0.14473684210526316	GO:0042100	GO:BP	B cell proliferation	16175	9966		0.21818181818181817	0.23214285714285715	76	16099	11	19	65	16080	16175	0.22816545586242679
M1	cpdb	0	network_modules	125	TRUE	8.867014716750739e-16	82	23	11	0.4782608695652174	0.13414634146341464	REAC:R-HSA-168928	REAC	DDX58/IFIH1-mediated induction of interferon-alpha/beta	10916	436		0.3333333333333333	0.4	82	10834	11	12	71	10822	10916	0.250519606579784
M1	cpdb	0	network_modules	125	TRUE	1.1853301915681822e-15	158	18	12	0.6666666666666666	0.0759493670886076	KEGG:04217	KEGG	Necroptosis	8484	294		0.3181818181818182	0.391304347826087	158	8326	12	6	146	8320	8484	0.2210319775228532
M1	cpdb	0	network_modules	125	TRUE	1.1853301915681822e-15	158	18	12	0.6666666666666666	0.0759493670886076	KEGG:05160	KEGG	Hepatitis C	8484	441		0.3181818181818182	0.391304347826087	158	8326	12	6	146	8320	8484	0.2210319775228532
M1	cpdb	0	network_modules	125	TRUE	1.6131945631511848e-15	162	18	12	0.6666666666666666	0.07407407407407407	KEGG:04630	KEGG	JAK-STAT signaling pathway	8484	332		0.4090909090909091	0.43478260869565216	162	8322	12	6	150	8316	8484	0.2181797363269584
M1	cpdb	0	network_modules	125	TRUE	1.8241813498286485e-15	81	30	11	0.36666666666666664	0.13580246913580246	GO:0033138	GO:BP	positive regulation of peptidyl-serine phosphorylation	16175	8053		0.23636363636363636	0.25	81	16094	11	19	70	16075	16175	0.2208567045063453
M1	cpdb	0	network_modules	125	TRUE	2.345411783917918e-15	167	18	12	0.6666666666666666	0.0718562874251497	KEGG:05164	KEGG	Influenza A	8484	445		0.45454545454545453	0.4782608695652174	167	8317	12	6	155	8311	8484	0.21475771029318355
M1	cpdb	0	network_modules	125	TRUE	2.423424104248958e-15	83	30	11	0.36666666666666664	0.13253012048192772	GO:0046425	GO:BP	regulation of receptor signaling pathway via JAK-STAT	16175	12135		0.2545454545454545	0.26785714285714285	83	16092	11	19	72	16073	16175	0.21811851438483468
M1	cpdb	0	network_modules	125	TRUE	6.199105550635868e-15	90	30	11	0.36666666666666664	0.12222222222222222	GO:1904892	GO:BP	regulation of receptor signaling pathway via STAT	16175	24199		0.2727272727272727	0.2857142857142857	90	16085	11	19	79	16066	16175	0.20925923305697652
M1	cpdb	0	network_modules	125	TRUE	6.744424530097782e-15	182	18	12	0.6666666666666666	0.06593406593406594	KEGG:04621	KEGG	NOD-like receptor signaling pathway	8484	326		0.5	0.5217391304347826	182	8302	12	6	170	8296	8484	0.2053406134079033
M1	cpdb	0	network_modules	125	TRUE	1.4513668804343722e-14	142	30	12	0.4	0.08450704225352113	GO:0007259	GO:BP	cell surface receptor signaling pathway via JAK-STAT	16175	2789		0.2909090909090909	0.30357142857142855	142	16033	12	18	130	16015	16175	0.18078254863618307
M1	cpdb	0	network_modules	125	TRUE	1.4736525770255393e-14	194	18	12	0.6666666666666666	0.061855670103092786	KEGG:05167	KEGG	Kaposi sarcoma-associated herpesvirus infection	8484	448		0.5454545454545454	0.5652173913043478	194	8290	12	6	182	8284	8484	0.19859608646986301
M1	cpdb	0	network_modules	125	TRUE	2.0875643890835967e-14	100	30	11	0.36666666666666664	0.11	GO:0002286	GO:BP	T cell activation involved in immune response	16175	818		0.3090909090909091	0.32142857142857145	100	16075	11	19	89	16056	16175	0.19824248807454528
M1	cpdb	0	network_modules	125	TRUE	2.6202151253832688e-14	102	30	11	0.36666666666666664	0.10784313725490197	GO:0033135	GO:BP	regulation of peptidyl-serine phosphorylation	16175	8051		0.32727272727272727	0.3392857142857143	102	16073	11	19	91	16054	16175	0.19623419222734861
M1	cpdb	0	network_modules	125	TRUE	2.6267502744063848e-14	149	30	12	0.4	0.08053691275167785	GO:0097696	GO:BP	cell surface receptor signaling pathway via STAT	16175	18727		0.34545454545454546	0.35714285714285715	149	16026	12	18	137	16008	16175	0.1763281656710784
M1	cpdb	0	network_modules	125	TRUE	3.4602073333828976e-14	142	18	11	0.6111111111111112	0.07746478873239436	KEGG:04936	KEGG	Alcoholic liver disease	8484	393		0.5909090909090909	0.6086956521739131	142	8342	11	7	131	8335	8484	0.21363780964775628
M1	cpdb	0	network_modules	125	TRUE	5.600833799651083e-14	109	30	11	0.36666666666666664	0.10091743119266056	GO:0030183	GO:BP	B cell differentiation	16175	6700		0.36363636363636365	0.375	109	16066	11	19	98	16047	16175	0.18964187508437175
M1	cpdb	0	network_modules	125	TRUE	6.949900250494834e-14	224	30	13	0.43333333333333335	0.05803571428571429	GO:0006959	GO:BP	humoral immune response	16175	2590		0.38181818181818183	0.39285714285714285	224	15951	13	17	211	15934	16175	0.154733431122901
M1	cpdb	0	network_modules	125	TRUE	7.071496823356576e-14	120	23	11	0.4782608695652174	0.09166666666666666	REAC:R-HSA-9705671	REAC	SARS-CoV-2 activates/modulates innate and adaptive immune responses	10916	2123		0.4444444444444444	0.5	120	10796	11	12	109	10784	10916	0.2059195194646605
M1	cpdb	0	network_modules	125	TRUE	1.2357928627561692e-13	231	18	12	0.6666666666666666	0.05194805194805195	KEGG:05171	KEGG	Coronavirus disease - COVID-19	8484	452		0.6363636363636364	0.6521739130434783	231	8253	12	6	219	8247	8484	0.18116944358308745
M1	cpdb	0	network_modules	125	TRUE	1.5265053738966483e-13	162	18	11	0.6111111111111112	0.06790123456790123	KEGG:05161	KEGG	Hepatitis B	8484	442		0.6818181818181818	0.6956521739130435	162	8322	11	7	151	8315	8484	0.19946197469813184
M1	cpdb	0	network_modules	125	TRUE	1.6363163646375044e-13	330	18	13	0.7222222222222222	0.03939393939393939	KEGG:05165	KEGG	Human papillomavirus infection	8484	446		0.7272727272727273	0.7391304347826086	330	8154	13	5	317	8149	8484	0.1629607703535443
M1	cpdb	0	network_modules	125	TRUE	3.6268950154475914e-13	175	18	11	0.6111111111111112	0.06285714285714286	KEGG:05152	KEGG	Tuberculosis	8484	440		0.7727272727272727	0.782608695652174	175	8309	11	7	164	8302	8484	0.19156340431716506
M1	cpdb	0	network_modules	125	TRUE	2.0146073983483127e-12	291	18	12	0.6666666666666666	0.041237113402061855	KEGG:04060	KEGG	Cytokine-cytokine receptor interaction	8484	253		0.8181818181818182	0.8260869565217391	291	8193	12	6	279	8187	8484	0.1602134139735827
M1	cpdb	0	network_modules	125	TRUE	2.769567437876301e-12	210	18	11	0.6111111111111112	0.05238095238095238	KEGG:05170	KEGG	Human immunodeficiency virus 1 infection	8484	451		0.8636363636363636	0.8695652173913043	210	8274	11	7	199	8267	8484	0.17401781067779828
M1	cpdb	0	network_modules	125	TRUE	3.3445375488666616e-12	169	23	11	0.4782608695652174	0.0650887573964497	REAC:R-HSA-983231	REAC	Factors involved in megakaryocyte development and platelet production	10916	931		0.5555555555555556	0.6	169	10747	11	12	158	10735	10916	0.17224251861251308
M1	cpdb	0	network_modules	125	TRUE	3.4151218233592133e-12	214	18	11	0.6111111111111112	0.0514018691588785	KEGG:05417	KEGG	Lipid and atherosclerosis	8484	494		0.9090909090909091	0.9130434782608695	214	8270	11	7	203	8263	8484	0.17228684549941312
M1	cpdb	0	network_modules	125	TRUE	3.720487581028032e-12	158	30	11	0.36666666666666664	0.06962025316455696	GO:0002285	GO:BP	lymphocyte activation involved in immune response	16175	817		0.4	0.4107142857142857	158	16017	11	19	147	15998	16175	0.15642691869766895
M1	cpdb	0	network_modules	125	TRUE	5.393077916221597e-12	223	18	11	0.6111111111111112	0.04932735426008968	KEGG:05163	KEGG	Human cytomegalovirus infection	8484	444		0.9545454545454546	0.9565217391304348	223	8261	11	7	212	8254	8484	0.16856055872074147
M1	cpdb	0	network_modules	125	TRUE	1.841492484498904e-11	197	23	11	0.4782608695652174	0.05583756345177665	REAC:R-HSA-9705683	REAC	SARS-CoV-2-host interactions	10916	2128		0.6666666666666666	0.7	197	10719	11	12	186	10707	10916	0.1588558594493615
M1	cpdb	0	network_modules	125	TRUE	2.1603928422615513e-11	185	30	11	0.36666666666666664	0.05945945945945946	GO:0018105	GO:BP	peptidyl-serine phosphorylation	16175	5324		0.41818181818181815	0.42857142857142855	185	15990	11	19	174	15971	16175	0.1440073076988878
M1	cpdb	0	network_modules	125	TRUE	2.2605503494999072e-11	356	18	12	0.6666666666666666	0.033707865168539325	KEGG:04151	KEGG	PI3K-Akt signaling pathway	8484	285		1	1	356	8128	12	6	344	8122	8484	0.1436667090712132
M1	cpdb	0	network_modules	125	TRUE	3.668975443401219e-11	292	23	12	0.5217391304347826	0.0410958904109589	REAC:R-HSA-9694516	REAC	SARS-CoV-2 Infection	10916	2122		0.7777777777777778	0.8	292	10624	12	11	280	10613	10916	0.14096592317870235
M1	cpdb	0	network_modules	125	TRUE	4.33779756086938e-11	197	30	11	0.36666666666666664	0.05583756345177665	GO:0042113	GO:BP	B cell activation	16175	9971		0.43636363636363634	0.4642857142857143	197	15978	11	19	186	15959	16175	0.13931322509756547
M1	cpdb	0	network_modules	125	TRUE	4.33779756086938e-11	197	30	11	0.36666666666666664	0.05583756345177665	GO:0018209	GO:BP	peptidyl-serine modification	16175	5368		0.43636363636363634	0.4642857142857143	197	15978	11	19	186	15959	16175	0.13931322509756547
M1	cpdb	0	network_modules	125	TRUE	7.911907961613517e-11	208	30	11	0.36666666666666664	0.052884615384615384	GO:0046651	GO:BP	lymphocyte proliferation	16175	12287		0.4727272727272727	0.48214285714285715	208	15967	11	19	197	15948	16175	0.13536592978698192
M1	cpdb	0	network_modules	125	TRUE	9.267498289818839e-11	211	30	11	0.36666666666666664	0.052132701421800945	GO:0032943	GO:BP	mononuclear cell proliferation	16175	7928		0.4909090909090909	0.5	211	15964	11	19	200	15945	16175	0.1343423341745758
M1	cpdb	0	network_modules	125	TRUE	1.2000293196896898e-10	216	30	11	0.36666666666666664	0.05092592592592592	GO:0002366	GO:BP	leukocyte activation involved in immune response	16175	898		0.509090909090909	0.5178571428571429	216	15959	11	19	205	15940	16175	0.13268305391463445
M1	cpdb	0	network_modules	125	TRUE	1.5443135125375925e-10	221	30	11	0.36666666666666664	0.049773755656108594	GO:0002263	GO:BP	cell activation involved in immune response	16175	795		0.5272727272727272	0.5357142857142857	221	15954	11	19	210	15935	16175	0.13107929702744445
M1	cpdb	0	network_modules	125	TRUE	3.180103174074301e-10	236	30	11	0.36666666666666664	0.046610169491525424	GO:0070661	GO:BP	leukocyte proliferation	16175	16242		0.5454545454545454	0.5535714285714286	236	15939	11	19	225	15920	16175	0.1265715458538914
M1	cpdb	0	network_modules	125	TRUE	4.4415743715268553e-10	263	23	11	0.4782608695652174	0.04182509505703422	REAC:R-HSA-913531	REAC	Interferon Signaling	10916	1227		0.8888888888888888	0.9	263	10653	11	12	252	10641	10916	0.13609939379339553
M1	cpdb	0	network_modules	125	TRUE	4.500130561752997e-10	334	30	12	0.4	0.03592814371257485	GO:0009615	GO:BP	response to virus	16175	3541		0.5636363636363636	0.5714285714285714	334	15841	12	18	322	15823	16175	0.11499062202522724
M1	cpdb	0	network_modules	125	TRUE	2.197075897478801e-9	500	30	13	0.43333333333333335	0.026	GO:0001934	GO:BP	positive regulation of protein phosphorylation	16175	548		0.5818181818181818	0.5892857142857143	500	15675	13	17	487	15658	16175	0.10022549677076759
M1	cpdb	0	network_modules	125	TRUE	3.786757268544155e-9	522	30	13	0.43333333333333335	0.02490421455938697	GO:0042327	GO:BP	positive regulation of phosphorylation	16175	10095		0.6	0.6071428571428571	522	15653	13	17	509	15636	16175	0.09782787375220661
M1	cpdb	0	network_modules	125	TRUE	3.9188976898726084e-9	297	30	11	0.36666666666666664	0.037037037037037035	GO:0030098	GO:BP	lymphocyte differentiation	16175	6676		0.6181818181818182	0.625	297	15878	11	19	286	15859	16175	0.11183287097394672
M1	cpdb	0	network_modules	125	TRUE	4.501587888509587e-9	406	30	12	0.4	0.029556650246305417	GO:0042110	GO:BP	T cell activation	16175	9970		0.6363636363636364	0.6428571428571429	406	15769	12	18	394	15751	16175	0.10330841582294992
M1	cpdb	0	network_modules	125	TRUE	5.2882107069031706e-9	536	30	13	0.43333333333333335	0.024253731343283583	GO:0002252	GO:BP	immune effector process	16175	784		0.6545454545454545	0.6607142857142857	536	15639	13	17	523	15622	16175	0.09637657914360775
M1	cpdb	0	network_modules	125	TRUE	6.5151696930016e-9	419	30	12	0.4	0.028639618138424822	GO:0019221	GO:BP	cytokine-mediated signaling pathway	16175	5598		0.6727272727272727	0.6785714285714286	419	15756	12	18	407	15738	16175	0.10151699600944869
M1	cpdb	0	network_modules	125	TRUE	7.738011362318675e-9	459	23	12	0.5217391304347826	0.026143790849673203	REAC:R-HSA-9679506	REAC	SARS-CoV Infections	10916	2112		1	1	459	10457	12	11	447	10446	10916	0.10982599596041645
M1	cpdb	0	network_modules	125	TRUE	1.0040463384110133e-8	564	30	13	0.43333333333333335	0.02304964539007092	GO:0045937	GO:BP	positive regulation of phosphate metabolic process	16175	11731		0.6909090909090909	0.7142857142857143	564	15611	13	17	551	15594	16175	0.0936312542681531
M1	cpdb	0	network_modules	125	TRUE	1.0040463384110133e-8	564	30	13	0.43333333333333335	0.02304964539007092	GO:0010562	GO:BP	positive regulation of phosphorus metabolic process	16175	4215		0.6909090909090909	0.7142857142857143	564	15611	13	17	551	15594	16175	0.0936312542681531
M1	cpdb	0	network_modules	125	TRUE	1.189346507500145e-8	721	30	14	0.4666666666666667	0.019417475728155338	GO:0045087	GO:BP	innate immune response	16175	11270		0.7272727272727273	0.7321428571428571	721	15454	14	16	707	15438	16175	0.08816670763462418
M1	cpdb	0	network_modules	125	TRUE	1.3982337981427885e-8	334	30	11	0.36666666666666664	0.03293413173652695	GO:0002250	GO:BP	adaptive immune response	16175	782		0.7454545454545455	0.75	334	15841	11	19	323	15822	16175	0.10488646453251728
M1	cpdb	0	network_modules	125	TRUE	2.8673007757871242e-8	357	30	11	0.36666666666666664	0.03081232492997199	GO:1903131	GO:BP	mononuclear cell differentiation	16175	22787		0.7636363636363637	0.7678571428571429	357	15818	11	19	346	15799	16175	0.10110803904612566
M1	cpdb	0	network_modules	125	TRUE	4.180523756587302e-8	632	30	13	0.43333333333333335	0.020569620253164556	GO:0031401	GO:BP	positive regulation of protein modification process	16175	7157		0.7818181818181819	0.7857142857142857	632	15543	13	17	619	15526	16175	0.08770884811248915
M1	cpdb	0	network_modules	125	TRUE	1.7125981045544703e-7	555	30	12	0.4	0.021621621621621623	GO:0071345	GO:BP	cellular response to cytokine stimulus	16175	16597		0.8	0.8035714285714286	555	15620	12	18	543	15602	16175	0.08659829577129581
M1	cpdb	0	network_modules	125	TRUE	2.2821362448379297e-7	569	30	12	0.4	0.0210896309314587	GO:0046649	GO:BP	lymphocyte activation	16175	12286		0.8181818181818182	0.8214285714285714	569	15606	12	18	557	15588	16175	0.08536213777229566
M1	cpdb	0	network_modules	125	TRUE	2.3219395717469533e-7	434	30	11	0.36666666666666664	0.02534562211981567	GO:0002521	GO:BP	leukocyte differentiation	16175	1043		0.8363636363636363	0.8392857142857143	434	15741	11	19	423	15722	16175	0.09065528918487131
M1	cpdb	0	network_modules	125	TRUE	2.498671625640123e-7	437	30	11	0.36666666666666664	0.02517162471395881	GO:0014070	GO:BP	response to organic cyclic compound	16175	4635		0.8545454545454545	0.8571428571428571	437	15738	11	19	426	15719	16175	0.09030287842787436
M1	cpdb	0	network_modules	125	TRUE	3.1714137932786964e-7	744	30	13	0.43333333333333335	0.01747311827956989	GO:0001932	GO:BP	regulation of protein phosphorylation	16175	546		0.8727272727272727	0.875	744	15431	13	17	731	15414	16175	0.07970594733745351
M1	cpdb	0	network_modules	125	TRUE	6.704181590287626e-7	625	30	12	0.4	0.0192	GO:1901652	GO:BP	response to peptide	16175	21619		0.8909090909090909	0.9107142857142857	625	15550	12	18	613	15532	16175	0.08082038460721012
M1	cpdb	0	network_modules	125	TRUE	6.704181590287626e-7	625	30	12	0.4	0.0192	GO:0034097	GO:BP	response to cytokine	16175	8408		0.8909090909090909	0.9107142857142857	625	15550	12	18	613	15532	16175	0.08082038460721012
M1	cpdb	0	network_modules	125	TRUE	6.851945209070361e-7	792	30	13	0.43333333333333335	0.016414141414141416	GO:0042325	GO:BP	regulation of phosphorylation	16175	10093		0.9272727272727272	0.9285714285714286	792	15383	13	17	779	15366	16175	0.07678051163163253
M1	cpdb	0	network_modules	125	TRUE	8.483674206132844e-7	638	30	12	0.4	0.018808777429467086	GO:0018193	GO:BP	peptidyl-amino acid modification	16175	5353		0.9454545454545454	0.9464285714285714	638	15537	12	18	626	15519	16175	0.07984821202090268
M1	cpdb	0	network_modules	125	TRUE	2.400160574745918e-6	699	30	12	0.4	0.017167381974248927	GO:0045321	GO:BP	leukocyte activation	16175	11356		0.9636363636363636	0.9642857142857143	699	15476	12	18	687	15458	16175	0.07563533392069448
M1	cpdb	0	network_modules	125	TRUE	9.76955031086169e-6	619	30	11	0.36666666666666664	0.017770597738287562	GO:1901698	GO:BP	response to nitrogen compound	16175	21651		0.9818181818181818	0.9821428571428571	619	15556	11	19	608	15537	16175	0.0737890214277617
M1	cpdb	0	network_modules	125	TRUE	1.3375004430235504e-5	638	30	11	0.36666666666666664	0.017241379310344827	GO:0030097	GO:BP	hemopoiesis	16175	6675		1	1	638	15537	11	19	627	15518	16175	0.07246626855132049
M1	cpdb	0	network_modules	126	TRUE	8.730339425476076e-12	15	17	6	0.35294117647058826	0.4	REAC:R-HSA-1362300	REAC	Transcription of E2F targets under negative control by p107 (RBL1) and p130 (RBL2) in complex with HDAC1	10916	2537		0	0.1	15	10901	6	11	9	10890	10916	0.37482109308828
M1	cpdb	0	network_modules	126	TRUE	3.977910632052967e-10	26	17	6	0.35294117647058826	0.23076923076923078	REAC:R-HSA-1538133	REAC	G0 and Early G1	10916	999		0.1111111111111111	0.2	26	10890	6	11	20	10879	10916	0.2840243695475539
M1	cpdb	0	network_modules	126	TRUE	1.078453319954379e-8	155	11	7	0.6363636363636364	0.04516129032258064	KEGG:04218	KEGG	Cellular senescence	8484	295		0	0.5	155	8329	7	4	148	8325	8484	0.166291715399717
M1	cpdb	0	network_modules	126	TRUE	1.3532922332122788e-8	18	17	5	0.29411764705882354	0.2777777777777778	REAC:R-HSA-1362277	REAC	Transcription of E2F targets under negative control by DREAM complex	10916	2536		0.2222222222222222	0.3	18	10898	5	12	13	10886	10916	0.28468487161291545
M1	cpdb	0	network_modules	126	TRUE	1.2646197204837348e-7	27	17	5	0.29411764705882354	0.18518518518518517	REAC:R-HSA-69205	REAC	G1/S-Specific Transcription	10916	1003		0.3333333333333333	0.4	27	10889	5	12	22	10877	10916	0.23188472679077077
M1	cpdb	0	network_modules	126	TRUE	4.03057582784641e-7	147	17	7	0.4117647058823529	0.047619047619047616	REAC:R-HSA-453279	REAC	Mitotic G1 phase and G1/S transition	10916	1480		0.4444444444444444	0.5	147	10769	7	10	140	10759	10916	0.1364761262849976
M1	cpdb	0	network_modules	126	TRUE	1.8122918271795783e-6	15	17	4	0.23529411764705882	0.26666666666666666	REAC:R-HSA-156711	REAC	Polo-like kinase mediated events	10916	1768		0.5555555555555556	0.6	15	10901	4	13	11	10888	10916	0.2493923886799581
M1	cpdb	0	network_modules	126	TRUE	4.0634629900204754e-5	82	17	5	0.29411764705882354	0.06097560975609756	REAC:R-HSA-69202	REAC	Cyclin E associated events during G1/S transition 	10916	421		0.6666666666666666	0.7	82	10834	5	12	77	10822	10916	0.13109260706014153
M1	cpdb	0	network_modules	126	TRUE	4.589150876320527e-5	84	17	5	0.29411764705882354	0.05952380952380952	REAC:R-HSA-69656	REAC	Cyclin A:Cdk2-associated events at S phase entry	10916	419		0.7777777777777778	0.8	84	10832	5	12	79	10820	10916	0.12945172891042667
M1	cpdb	0	network_modules	126	TRUE	4.0783867043833337e-4	130	17	5	0.29411764705882354	0.038461538461538464	REAC:R-HSA-69206	REAC	G1/S Transition	10916	1002		0.8888888888888888	0.9	130	10786	5	12	125	10774	10916	0.10274552196798475
M1	cpdb	0	network_modules	126	TRUE	0.0012085091235365694	162	17	5	0.29411764705882354	0.030864197530864196	REAC:R-HSA-69242	REAC	S Phase	10916	2111		1	1	162	10754	5	12	157	10742	10916	0.09121943550952148
M1	cpdb	0	network_modules	126	TRUE	0.001970953177264988	157	11	4	0.36363636363636365	0.025477707006369428	KEGG:04110	KEGG	Cell cycle	8484	264		1	1	157	8327	4	7	153	8320	8484	0.09227162882767366
M1	cpdb	0	network_modules	126	TRUE	0.004982325234183615	2	28	2	0.07142857142857142	1	GO:0032877	GO:BP	positive regulation of DNA endoreduplication	16175	7874		0	1	2	16173	2	26	0	16147	16175	0.2670463285603229
M1	cpdb	0	network_modules	126	TRUE	0.004982325234183615	2	28	2	0.07142857142857142	1	GO:0060718	GO:BP	chorionic trophoblast cell differentiation	16175	14891		0	1	2	16173	2	26	0	16147	16175	0.2670463285603229
M1	cpdb	0	network_modules	126	TRUE	0.004982325234183615	2	28	2	0.07142857142857142	1	GO:0060717	GO:BP	chorion development	16175	14890		0	1	2	16173	2	26	0	16147	16175	0.2670463285603229
M1	cpdb	0	network_modules	128	TRUE	1.39411711531636e-34	397	28	25	0.8928571428571429	0.06297229219143577	GO:0008380	GO:BP	RNA splicing	16175	3186		0	0.047619047619047616	397	15778	25	3	372	15775	16175	0.2336858967710521
M1	cpdb	0	network_modules	128	TRUE	8.049399647310052e-29	352	28	22	0.7857142857142857	0.0625	GO:0006397	GO:BP	mRNA processing	16175	2158		0.05	0.09523809523809523	352	15823	22	6	330	15817	16175	0.21803583808089524
M1	cpdb	0	network_modules	128	TRUE	1.484489454917184e-28	287	28	21	0.75	0.07317073170731707	GO:0000398	GO:BP	mRNA splicing, via spliceosome	16175	121		0.1	0.19047619047619047	287	15888	21	7	266	15881	16175	0.23097506323690375
M1	cpdb	0	network_modules	128	TRUE	1.484489454917184e-28	287	28	21	0.75	0.07317073170731707	GO:0000377	GO:BP	RNA splicing, via transesterification reactions with bulged adenosine as nucleophile	16175	109		0.1	0.19047619047619047	287	15888	21	7	266	15881	16175	0.23097506323690375
M1	cpdb	0	network_modules	128	TRUE	2.0029321451781132e-28	291	28	21	0.75	0.07216494845360824	GO:0000375	GO:BP	RNA splicing, via transesterification reactions	16175	107		0.2	0.23809523809523808	291	15884	21	7	270	15877	16175	0.22933351719735315
M1	cpdb	0	network_modules	128	TRUE	5.760484246366215e-24	175	28	17	0.6071428571428571	0.09714285714285714	GO:0043484	GO:BP	regulation of RNA splicing	16175	10730		0.25	0.2857142857142857	175	16000	17	11	158	15989	16175	0.24003823833967394
M1	cpdb	0	network_modules	128	TRUE	8.350192473893518e-24	590	28	22	0.7857142857142857	0.03728813559322034	GO:0016071	GO:BP	mRNA metabolic process	16175	5098		0.3	0.3333333333333333	590	15585	22	6	568	15579	16175	0.16642474863351617
M1	cpdb	0	network_modules	128	TRUE	1.6909611067702984e-22	202	24	17	0.7083333333333334	0.08415841584158416	REAC:R-HSA-72163	REAC	mRNA Splicing - Major Pathway	10916	2707		0	0.125	202	10714	17	7	185	10707	10916	0.24027295379445904
M1	cpdb	0	network_modules	128	TRUE	3.076974554033066e-22	209	24	17	0.7083333333333334	0.08133971291866028	REAC:R-HSA-72172	REAC	mRNA Splicing	10916	2706		0.14285714285714285	0.25	209	10707	17	7	192	10700	10916	0.2360725239747795
M1	cpdb	0	network_modules	128	TRUE	3.7211768089361966e-22	276	24	18	0.75	0.06521739130434782	REAC:R-HSA-72203	REAC	Processing of Capped Intron-Containing Pre-mRNA	10916	1796		0.2857142857142857	0.375	276	10640	18	6	258	10634	10916	0.2166994624615757
M1	cpdb	0	network_modules	128	TRUE	2.2025715229559573e-21	98	28	14	0.5	0.14285714285714285	GO:0048024	GO:BP	regulation of mRNA splicing, via spliceosome	16175	12475		0.35	0.38095238095238093	98	16077	14	14	84	16063	16175	0.2650557013816516
M1	cpdb	0	network_modules	128	TRUE	3.9242641233720676e-20	119	28	14	0.5	0.11764705882352941	GO:0050684	GO:BP	regulation of mRNA processing	16175	13215		0.4	0.42857142857142855	119	16056	14	14	105	16042	16175	0.24005873297568187
M1	cpdb	0	network_modules	128	TRUE	1.670580218601957e-17	56	24	11	0.4583333333333333	0.19642857142857142	REAC:R-HSA-72187	REAC	mRNA 3'-end processing	10916	2701		0.42857142857142855	0.5	56	10860	11	13	45	10847	10916	0.29778267033407235
M1	cpdb	0	network_modules	128	TRUE	9.943354284077217e-17	65	24	11	0.4583333333333333	0.16923076923076924	REAC:R-HSA-73856	REAC	RNA Polymerase II Transcription Termination	10916	1895		0.5714285714285714	0.625	65	10851	11	13	54	10838	10916	0.27601074419252664
M1	cpdb	0	network_modules	128	TRUE	2.825840912500752e-16	71	24	11	0.4583333333333333	0.15492957746478872	REAC:R-HSA-159236	REAC	Transport of Mature mRNA derived from an Intron-Containing Transcript	10916	2586		0.7142857142857143	0.75	71	10845	11	13	60	10832	10916	0.2638430117315614
M1	cpdb	0	network_modules	128	TRUE	4.03151727480584e-16	174	16	12	0.75	0.06896551724137931	KEGG:03040	KEGG	Spliceosome	8484	215		NA	1	174	8310	12	4	162	8306	8484	0.22372520428631665
M1	cpdb	0	network_modules	128	TRUE	1.1449463861696358e-15	80	24	11	0.4583333333333333	0.1375	REAC:R-HSA-72202	REAC	Transport of Mature Transcript to Cytoplasm	10916	2584		0.8571428571428571	0.875	80	10836	11	13	69	10823	10916	0.24820861503006977
M1	cpdb	0	network_modules	128	TRUE	6.108845660352816e-15	273	28	14	0.5	0.05128205128205128	GO:1903311	GO:BP	regulation of mRNA metabolic process	16175	22895		0.45	0.47619047619047616	273	15902	14	14	259	15888	16175	0.1561806012712698
M1	cpdb	0	network_modules	128	TRUE	4.0272023899322485e-13	16	28	7	0.25	0.4375	GO:0048025	GO:BP	negative regulation of mRNA splicing, via spliceosome	16175	12476		0.5	0.5238095238095238	16	16159	7	21	9	16138	16175	0.3298590224197775
M1	cpdb	0	network_modules	128	TRUE	6.83846069361859e-13	17	28	7	0.25	0.4117647058823529	GO:0050686	GO:BP	negative regulation of mRNA processing	16175	13217		0.55	0.5714285714285714	17	16158	7	21	10	16137	16175	0.3199407052567833
M1	cpdb	0	network_modules	128	TRUE	4.070166362610962e-12	21	28	7	0.25	0.3333333333333333	GO:0033119	GO:BP	negative regulation of RNA splicing	16175	8043		0.6	0.6190476190476191	21	16154	7	21	14	16133	16175	0.28761163430484965
M1	cpdb	0	network_modules	128	TRUE	5.184019907782154e-12	73	28	9	0.32142857142857145	0.1232876712328767	GO:0000245	GO:BP	spliceosomal complex assembly	16175	69		0.65	0.6666666666666666	73	16102	9	19	64	16083	16175	0.19688808328942078
M1	cpdb	0	network_modules	128	TRUE	7.053335970938472e-11	30	28	7	0.25	0.23333333333333334	GO:0006376	GO:BP	mRNA splice site recognition	16175	2146		0.7	0.7142857142857143	30	16145	7	21	23	16124	16175	0.2401617057953495
M1	cpdb	0	network_modules	128	TRUE	2.8233490574169525e-10	67	28	8	0.2857142857142857	0.11940298507462686	GO:0000380	GO:BP	alternative mRNA splicing, via spliceosome	16175	112		0.75	0.7619047619047619	67	16108	8	20	59	16088	16175	0.18256132389696805
M1	cpdb	0	network_modules	128	TRUE	1.8520467951868757e-9	84	28	8	0.2857142857142857	0.09523809523809523	GO:1903312	GO:BP	negative regulation of mRNA metabolic process	16175	22896		0.8	0.8095238095238095	84	16091	8	20	76	16071	16175	0.16252184127645528
M1	cpdb	0	network_modules	128	TRUE	1.922033911292448e-8	178	28	9	0.32142857142857145	0.05056179775280899	GO:0022618	GO:BP	protein-RNA complex assembly	16175	6625		0.85	0.8571428571428571	178	15997	9	19	169	15978	16175	0.12390913012865473
M1	cpdb	0	network_modules	128	TRUE	3.144785472701971e-8	188	28	9	0.32142857142857145	0.047872340425531915	GO:0071826	GO:BP	protein-RNA complex organization	16175	16929		0.9	0.9047619047619048	188	15987	9	19	179	15968	16175	0.12036614997934353
M1	cpdb	0	network_modules	128	TRUE	6.382884649592847e-7	54	28	6	0.21428571428571427	0.1111111111111111	GO:0000381	GO:BP	regulation of alternative mRNA splicing, via spliceosome	16175	113		0.95	0.9523809523809523	54	16121	6	22	48	16099	16175	0.15228542450875196
M1	cpdb	0	network_modules	128	TRUE	1.994259428020681e-5	390	28	9	0.32142857142857145	0.023076923076923078	GO:0022613	GO:BP	ribonucleoprotein complex biogenesis	16175	6620		1	1	390	15785	9	19	381	15766	16175	0.08071289955225089
M1	cpdb	0	network_modules	128	TRUE	0.0010117435128560806	48	24	4	0.16666666666666666	0.08333333333333333	REAC:R-HSA-72165	REAC	mRNA Splicing - Minor Pathway	10916	2708		1	1	48	10868	4	20	44	10848	10916	0.11512156007131033
M1	cpdb	0	network_modules	129	TRUE	4.866177028232621e-26	26	29	13	0.4482758620689655	0.5	REAC:R-HSA-389960	REAC	Formation of tubulin folding intermediates by CCT/TriC	10916	975		0	0.02127659574468085	26	10890	13	16	13	10874	10916	0.47210594068353573
M1	cpdb	0	network_modules	129	TRUE	2.6561930101540516e-24	33	29	13	0.4482758620689655	0.3939393939393939	REAC:R-HSA-389958	REAC	Cooperation of Prefoldin and TriC/CCT  in actin and tubulin folding	10916	411		0.021739130434782608	0.0425531914893617	33	10883	13	16	20	10867	10916	0.41858510132278026
M1	cpdb	0	network_modules	129	TRUE	9.08112962363931e-23	28	29	12	0.41379310344827586	0.42857142857142855	REAC:R-HSA-389957	REAC	Prefoldin mediated transfer of substrate  to CCT/TriC	10916	1788		0.043478260869565216	0.06382978723404255	28	10888	12	17	16	10871	10916	0.41960251735549475
M1	cpdb	0	network_modules	129	TRUE	5.783513431024104e-21	10	29	9	0.3103448275862069	0.9	REAC:R-HSA-390450	REAC	Folding of actin by CCT/TriC	10916	943		0.06521739130434782	0.0851063829787234	10	10906	9	20	1	10886	10916	0.5278813494532237
M1	cpdb	0	network_modules	129	TRUE	6.760143159224071e-20	91	29	14	0.4827586206896552	0.15384615384615385	REAC:R-HSA-390466	REAC	Chaperonin-mediated protein folding	10916	345		0.08695652173913043	0.10638297872340426	91	10825	14	15	77	10810	10916	0.26930151697599974
M1	cpdb	0	network_modules	129	TRUE	2.046197479937732e-19	98	29	14	0.4827586206896552	0.14285714285714285	REAC:R-HSA-391251	REAC	Protein folding	10916	1812		0.10869565217391304	0.1276595744680851	98	10818	14	15	84	10803	10916	0.25923850232705253
M1	cpdb	0	network_modules	129	TRUE	4.239414058174045e-18	10	31	8	0.25806451612903225	0.8	GO:1904851	GO:BP	positive regulation of establishment of protein localization to telomere	16175	24163		0	0.017543859649122806	10	16165	8	23	2	16142	16175	0.45385625472885616
M1	cpdb	0	network_modules	129	TRUE	1.552485937997944e-17	11	31	8	0.25806451612903225	0.7272727272727273	GO:1904871	GO:BP	positive regulation of protein localization to Cajal body	16175	24179		0.017857142857142856	0.07017543859649122	11	16164	8	23	3	16141	16175	0.4326444240502846
M1	cpdb	0	network_modules	129	TRUE	1.552485937997944e-17	11	31	8	0.25806451612903225	0.7272727272727273	GO:1904869	GO:BP	regulation of protein localization to Cajal body	16175	24177		0.017857142857142856	0.07017543859649122	11	16164	8	23	3	16141	16175	0.4326444240502846
M1	cpdb	0	network_modules	129	TRUE	1.552485937997944e-17	11	31	8	0.25806451612903225	0.7272727272727273	GO:0070203	GO:BP	regulation of establishment of protein localization to telomere	16175	15986		0.017857142857142856	0.07017543859649122	11	16164	8	23	3	16141	16175	0.4326444240502846
M1	cpdb	0	network_modules	129	TRUE	4.65156738802863e-17	12	31	8	0.25806451612903225	0.6666666666666666	GO:0070202	GO:BP	regulation of establishment of protein localization to chromosome	16175	15985		0.07142857142857142	0.12280701754385964	12	16163	8	23	4	16140	16175	0.4141388132779776
M1	cpdb	0	network_modules	129	TRUE	4.65156738802863e-17	12	31	8	0.25806451612903225	0.6666666666666666	GO:1903405	GO:BP	protein localization to nuclear body	16175	22981		0.07142857142857142	0.12280701754385964	12	16163	8	23	4	16140	16175	0.4141388132779776
M1	cpdb	0	network_modules	129	TRUE	4.65156738802863e-17	12	31	8	0.25806451612903225	0.6666666666666666	GO:1904867	GO:BP	protein localization to Cajal body	16175	24175		0.07142857142857142	0.12280701754385964	12	16163	8	23	4	16140	16175	0.4141388132779776
M1	cpdb	0	network_modules	129	TRUE	1.2078778861665218e-16	13	31	8	0.25806451612903225	0.6153846153846154	GO:1904816	GO:BP	positive regulation of protein localization to chromosome, telomeric region	16175	24131		0.125	0.14035087719298245	13	16162	8	23	5	16139	16175	0.39780841123376987
M1	cpdb	0	network_modules	129	TRUE	2.814816958939367e-16	14	31	8	0.25806451612903225	0.5714285714285714	GO:1990173	GO:BP	protein localization to nucleoplasm	16175	25107		0.14285714285714285	0.15789473684210525	14	16161	8	23	6	16138	16175	0.38325751174362016
M1	cpdb	0	network_modules	129	TRUE	4.803496284536554e-16	38	29	10	0.3448275862068966	0.2631578947368421	REAC:R-HSA-390471	REAC	Association of TriC/CCT with target proteins during biosynthesis	10916	182		0.13043478260869565	0.14893617021276595	38	10878	10	19	28	10859	10916	0.2991145155401321
M1	cpdb	0	network_modules	129	TRUE	6.02412117976829e-16	15	31	8	0.25806451612903225	0.5333333333333333	GO:1904814	GO:BP	regulation of protein localization to chromosome, telomeric region	16175	24129		0.16071428571428573	0.19298245614035087	15	16160	8	23	7	16137	16175	0.3701843849607003
M1	cpdb	0	network_modules	129	TRUE	6.02412117976829e-16	15	31	8	0.25806451612903225	0.5333333333333333	GO:1904874	GO:BP	positive regulation of telomerase RNA localization to Cajal body	16175	24182		0.16071428571428573	0.19298245614035087	15	16160	8	23	7	16137	16175	0.3701843849607003
M1	cpdb	0	network_modules	129	TRUE	2.270025230682825e-15	17	31	8	0.25806451612903225	0.47058823529411764	GO:0070200	GO:BP	establishment of protein localization to telomere	16175	15983		0.19642857142857142	0.21052631578947367	17	16158	8	23	9	16135	16175	0.34758198133104484
M1	cpdb	0	network_modules	129	TRUE	4.0808764368479296e-15	18	31	8	0.25806451612903225	0.4444444444444444	GO:1904872	GO:BP	regulation of telomerase RNA localization to Cajal body	16175	24180		0.21428571428571427	0.22807017543859648	18	16157	8	23	10	16134	16175	0.3377181653441862
M1	cpdb	0	network_modules	129	TRUE	7.0398692769050295e-15	19	31	8	0.25806451612903225	0.42105263157894735	GO:0090685	GO:BP	RNA localization to nucleus	16175	18411		0.23214285714285715	0.2982456140350877	19	16156	8	23	11	16133	16175	0.32864180539215476
M1	cpdb	0	network_modules	129	TRUE	7.0398692769050295e-15	19	31	8	0.25806451612903225	0.42105263157894735	GO:0090672	GO:BP	telomerase RNA localization	16175	18402		0.23214285714285715	0.2982456140350877	19	16156	8	23	11	16133	16175	0.32864180539215476
M1	cpdb	0	network_modules	129	TRUE	7.0398692769050295e-15	19	31	8	0.25806451612903225	0.42105263157894735	GO:0090671	GO:BP	telomerase RNA localization to Cajal body	16175	18401		0.23214285714285715	0.2982456140350877	19	16156	8	23	11	16133	16175	0.32864180539215476
M1	cpdb	0	network_modules	129	TRUE	7.0398692769050295e-15	19	31	8	0.25806451612903225	0.42105263157894735	GO:0090670	GO:BP	RNA localization to Cajal body	16175	18400		0.23214285714285715	0.2982456140350877	19	16156	8	23	11	16133	16175	0.32864180539215476
M1	cpdb	0	network_modules	129	TRUE	9.001318010501594e-14	38	29	9	0.3103448275862069	0.23684210526315788	REAC:R-HSA-6814122	REAC	Cooperation of PDCL (PhLP1) and TRiC/CCT in G-protein beta folding	10916	410		0.15217391304347827	0.1702127659574468	38	10878	9	20	29	10858	10916	0.26889802021691606
M1	cpdb	0	network_modules	129	TRUE	2.0469863383700226e-13	27	31	8	0.25806451612903225	0.2962962962962963	GO:0070199	GO:BP	establishment of protein localization to chromosome	16175	15982		0.30357142857142855	0.3157894736842105	27	16148	8	23	19	16125	16175	0.2752252812923527
M1	cpdb	0	network_modules	129	TRUE	7.236925982354574e-13	31	31	8	0.25806451612903225	0.25806451612903225	GO:0070198	GO:BP	protein localization to chromosome, telomeric region	16175	15981		0.32142857142857145	0.3333333333333333	31	16144	8	23	23	16121	16175	0.2566398382301225
M1	cpdb	0	network_modules	129	TRUE	1.2704766140647696e-12	33	31	8	0.25806451612903225	0.24242424242424243	GO:0032212	GO:BP	positive regulation of telomere maintenance via telomerase	16175	7404		0.3392857142857143	0.3508771929824561	33	16142	8	23	25	16119	16175	0.24863665806590488
M1	cpdb	0	network_modules	129	TRUE	2.7584851158520944e-12	36	31	8	0.25806451612903225	0.2222222222222222	GO:1904358	GO:BP	positive regulation of telomere maintenance via telomere lengthening	16175	23745		0.35714285714285715	0.3684210526315789	36	16139	8	23	28	16116	16175	0.237901133120107
M1	cpdb	0	network_modules	129	TRUE	1.5680129352553558e-11	118	31	10	0.3225806451612903	0.0847457627118644	GO:0034502	GO:BP	protein localization to chromosome	16175	8668		0.375	0.38596491228070173	118	16057	10	21	108	16036	16175	0.16234924189515165
M1	cpdb	0	network_modules	129	TRUE	6.722335389198421e-11	52	31	8	0.25806451612903225	0.15384615384615385	GO:2000573	GO:BP	positive regulation of DNA biosynthetic process	16175	25874		0.39285714285714285	0.40350877192982454	52	16123	8	23	44	16100	16175	0.19727818011176446
M1	cpdb	0	network_modules	129	TRUE	9.270825751017148e-11	54	31	8	0.25806451612903225	0.14814814814814814	GO:0032210	GO:BP	regulation of telomere maintenance via telomerase	16175	7402		0.4107142857142857	0.42105263157894735	54	16121	8	23	46	16098	16175	0.19350848878778196
M1	cpdb	0	network_modules	129	TRUE	3.4116976081667287e-10	63	31	8	0.25806451612903225	0.12698412698412698	GO:1904356	GO:BP	regulation of telomere maintenance via telomere lengthening	16175	23743		0.42857142857142855	0.43859649122807015	63	16112	8	23	55	16089	16175	0.17881263139902276
M1	cpdb	0	network_modules	129	TRUE	5.040395370171966e-10	66	31	8	0.25806451612903225	0.12121212121212122	GO:0061077	GO:BP	chaperone-mediated protein folding	16175	15193		0.44642857142857145	0.45614035087719296	66	16109	8	23	58	16086	16175	0.1745902191716416
M1	cpdb	0	network_modules	129	TRUE	5.379703636306126e-10	200	29	11	0.3793103448275862	0.055	REAC:R-HSA-5617833	REAC	Cilium Assembly	10916	361		0.17391304347826086	0.19148936170212766	200	10716	11	18	189	10698	10916	0.13892185369808546
M1	cpdb	0	network_modules	129	TRUE	7.309906120984198e-10	69	31	8	0.25806451612903225	0.11594202898550725	GO:0032206	GO:BP	positive regulation of telomere maintenance	16175	7398		0.4642857142857143	0.47368421052631576	69	16106	8	23	61	16083	16175	0.17064380147288874
M1	cpdb	0	network_modules	129	TRUE	9.277568386462122e-10	71	31	8	0.25806451612903225	0.11267605633802817	GO:0006278	GO:BP	RNA-templated DNA biosynthetic process	16175	2093		0.48214285714285715	0.5087719298245614	71	16104	8	23	63	16081	16175	0.1681516837445146
M1	cpdb	0	network_modules	129	TRUE	9.277568386462122e-10	71	31	8	0.25806451612903225	0.11267605633802817	GO:0007004	GO:BP	telomere maintenance via telomerase	16175	2616		0.48214285714285715	0.5087719298245614	71	16104	8	23	63	16081	16175	0.1681516837445146
M1	cpdb	0	network_modules	129	TRUE	1.8210038751407514e-9	77	31	8	0.25806451612903225	0.1038961038961039	GO:1900182	GO:BP	positive regulation of protein localization to nucleus	16175	20458		0.5178571428571429	0.5263157894736842	77	16098	8	23	69	16075	16175	0.1612614010070209
M1	cpdb	0	network_modules	129	TRUE	3.7394060592745285e-9	84	31	8	0.25806451612903225	0.09523809523809523	GO:0010833	GO:BP	telomere maintenance via telomere lengthening	16175	4443		0.5357142857142857	0.543859649122807	84	16091	8	23	76	16068	16175	0.1541657753166776
M1	cpdb	0	network_modules	129	TRUE	4.122679928038137e-9	85	31	8	0.25806451612903225	0.09411764705882353	GO:2000278	GO:BP	regulation of DNA biosynthetic process	16175	25603		0.5535714285714286	0.5614035087719298	85	16090	8	23	77	16067	16175	0.15322352682216198
M1	cpdb	0	network_modules	129	TRUE	5.00898976036645e-9	140	31	9	0.2903225806451613	0.06428571428571428	GO:0071897	GO:BP	DNA biosynthetic process	16175	16970		0.5714285714285714	0.5789473684210527	140	16035	9	22	131	16013	16175	0.13324699174304896
M1	cpdb	0	network_modules	129	TRUE	6.928350573821924e-9	23	29	6	0.20689655172413793	0.2608695652173913	REAC:R-HSA-5620922	REAC	BBSome-mediated cargo-targeting to cilium	10916	199		0.1956521739130435	0.2127659574468085	23	10893	6	23	17	10870	10916	0.23050404040037029
M1	cpdb	0	network_modules	129	TRUE	1.2623736762181355e-8	229	31	10	0.3225806451612903	0.043668122270742356	GO:0033044	GO:BP	regulation of chromosome organization	16175	7999		0.5892857142857143	0.5964912280701754	229	15946	10	21	219	15925	16175	0.11439912169681933
M1	cpdb	0	network_modules	129	TRUE	1.3260433685525885e-8	98	31	8	0.25806451612903225	0.08163265306122448	GO:2001252	GO:BP	positive regulation of chromosome organization	16175	26441		0.6071428571428571	0.6140350877192983	98	16077	8	23	90	16054	16175	0.14230315404539068
M1	cpdb	0	network_modules	129	TRUE	2.153975489609653e-8	104	31	8	0.25806451612903225	0.07692307692307693	GO:0032204	GO:BP	regulation of telomere maintenance	16175	7396		0.625	0.631578947368421	104	16071	8	23	96	16048	16175	0.13795969127433502
M1	cpdb	0	network_modules	129	TRUE	3.279840905607288e-8	292	29	11	0.3793103448275862	0.03767123287671233	REAC:R-HSA-1852241	REAC	Organelle biogenesis and maintenance	10916	1646		0.21739130434782608	0.23404255319148937	292	10624	11	18	281	10606	10916	0.11277342191771035
M1	cpdb	0	network_modules	129	TRUE	3.400148519806783e-8	110	31	8	0.25806451612903225	0.07272727272727272	GO:1900180	GO:BP	regulation of protein localization to nucleus	16175	20456		0.6428571428571429	0.6491228070175439	110	16065	8	23	102	16042	16175	0.13397166260313093
M1	cpdb	0	network_modules	129	TRUE	5.363772494129456e-8	182	31	9	0.2903225806451613	0.04945054945054945	GO:0006457	GO:BP	protein folding	16175	2203		0.6607142857142857	0.6666666666666666	182	15993	9	22	173	15971	16175	0.11593993726006727
M1	cpdb	0	network_modules	129	TRUE	1.4809191055036224e-7	115	29	8	0.27586206896551724	0.06956521739130435	REAC:R-HSA-9648025	REAC	EML4 and NUDC in mitotic spindle formation	10916	817		0.2391304347826087	0.2553191489361702	115	10801	8	21	107	10780	10916	0.1341247976358785
M1	cpdb	0	network_modules	129	TRUE	2.543195953229257e-7	123	29	8	0.27586206896551724	0.06504065040650407	REAC:R-HSA-2500257	REAC	Resolution of Sister Chromatid Cohesion	10916	2079		0.2608695652173913	0.2765957446808511	123	10793	8	21	115	10772	10916	0.1293793899332992
M1	cpdb	0	network_modules	129	TRUE	3.930457223481257e-7	149	31	8	0.25806451612903225	0.053691275167785234	GO:0006403	GO:BP	RNA localization	16175	2164		0.6785714285714286	0.6842105263157895	149	16026	8	23	141	16003	16175	0.11414485401286685
M1	cpdb	0	network_modules	129	TRUE	4.6100968809420637e-7	152	31	8	0.25806451612903225	0.05263157894736842	GO:0000723	GO:BP	telomere maintenance	16175	202		0.6964285714285714	0.7017543859649122	152	16023	8	23	144	16000	16175	0.11293915321908515
M1	cpdb	0	network_modules	129	TRUE	4.7420293291096e-7	199	29	9	0.3103448275862069	0.04522613065326633	REAC:R-HSA-68877	REAC	Mitotic Prometaphase	10916	1484		0.2826086956521739	0.2978723404255319	199	10717	9	20	190	10697	10916	0.11269345223949294
M1	cpdb	0	network_modules	129	TRUE	5.682528159064167e-7	136	29	8	0.27586206896551724	0.058823529411764705	REAC:R-HSA-5663220	REAC	RHO GTPases Activate Formins	10916	1848		0.30434782608695654	0.3191489361702128	136	10780	8	21	128	10759	10916	0.12256057215745728
M1	cpdb	0	network_modules	129	TRUE	1.1749393154932044e-6	51	29	6	0.20689655172413793	0.11764705882352941	REAC:R-HSA-5620920	REAC	Cargo trafficking to the periciliary membrane	10916	310		0.32608695652173914	0.3404255319148936	51	10865	6	23	45	10842	10916	0.1530531436822234
M1	cpdb	0	network_modules	129	TRUE	1.5735547915145897e-6	228	29	9	0.3103448275862069	0.039473684210526314	REAC:R-HSA-68882	REAC	Mitotic Anaphase	10916	1479		0.34782608695652173	0.3617021276595745	228	10688	9	20	219	10668	10916	0.10446682828327548
M1	cpdb	0	network_modules	129	TRUE	1.6351848143857947e-6	229	29	9	0.3103448275862069	0.039301310043668124	REAC:R-HSA-2555396	REAC	Mitotic Metaphase and Anaphase	10916	1482		0.3695652173913043	0.3829787234042553	229	10687	9	20	220	10667	10916	0.10421037069876657
M1	cpdb	0	network_modules	129	TRUE	1.934378162524553e-6	182	31	8	0.25806451612903225	0.04395604395604396	GO:0032200	GO:BP	telomere organization	16175	7392		0.7142857142857143	0.7192982456140351	182	15993	8	23	174	15970	16175	0.1025383201634454
M1	cpdb	0	network_modules	129	TRUE	3.66586360981823e-6	545	31	11	0.3548387096774194	0.02018348623853211	GO:0051276	GO:BP	chromosome organization	16175	13613		0.7321428571428571	0.7368421052631579	545	15630	11	20	534	15610	16175	0.07799066643310004
M1	cpdb	0	network_modules	129	TRUE	4.9541057526421054e-6	205	31	8	0.25806451612903225	0.03902439024390244	GO:0050821	GO:BP	protein stabilization	16175	13283		0.75	0.7543859649122807	205	15970	8	23	197	15947	16175	0.09612761353473309
M1	cpdb	0	network_modules	129	TRUE	7.345066679759235e-6	188	29	8	0.27586206896551724	0.0425531914893617	REAC:R-HSA-2467813	REAC	Separation of Sister Chromatids	10916	2204		0.391304347826087	0.40425531914893614	188	10728	8	21	180	10707	10916	0.10260421448614011
M1	cpdb	0	network_modules	129	TRUE	8.264420735821151e-6	70	29	6	0.20689655172413793	0.08571428571428572	REAC:R-HSA-2995410	REAC	Nuclear Envelope (NE) Reassembly	10916	1612		0.41304347826086957	0.425531914893617	70	10846	6	23	64	10823	10916	0.12962960477501637
M1	cpdb	0	network_modules	129	TRUE	9.775282811353218e-6	195	29	8	0.27586206896551724	0.041025641025641026	REAC:R-HSA-69275	REAC	G2/M Transition	10916	1008		0.43478260869565216	0.44680851063829785	195	10721	8	21	187	10700	10916	0.10052878744393075
M1	cpdb	0	network_modules	129	TRUE	1.0585888354498396e-5	197	29	8	0.27586206896551724	0.04060913705583756	REAC:R-HSA-453274	REAC	Mitotic G2-G2/M phases	10916	1481		0.45652173913043476	0.46808510638297873	197	10719	8	21	189	10698	10916	0.09995548390471524
M1	cpdb	0	network_modules	129	TRUE	1.2577396220835001e-5	75	29	6	0.20689655172413793	0.08	REAC:R-HSA-9833482	REAC	PKR-mediated signaling	10916	1692		0.4782608695652174	0.48936170212765956	75	10841	6	23	69	10818	10916	0.1249767856328862
M1	cpdb	0	network_modules	129	TRUE	1.6856543362138997e-5	406	29	10	0.3448275862068966	0.024630541871921183	REAC:R-HSA-68886	REAC	M Phase	10916	1343		0.5	0.5106382978723404	406	10510	10	19	396	10491	10916	0.08390330010124425
M1	cpdb	0	network_modules	129	TRUE	1.7627258016975945e-5	241	31	8	0.25806451612903225	0.03319502074688797	GO:0034504	GO:BP	protein localization to nucleus	16175	8670		0.7678571428571429	0.7719298245614035	241	15934	8	23	233	15911	16175	0.08795279858163832
M1	cpdb	0	network_modules	129	TRUE	1.880240555622428e-5	243	31	8	0.25806451612903225	0.03292181069958848	GO:1904951	GO:BP	positive regulation of establishment of protein localization	16175	24241		0.7857142857142857	0.7894736842105263	243	15932	8	23	235	15909	16175	0.08755106093820435
M1	cpdb	0	network_modules	129	TRUE	2.069202846564632e-5	246	31	8	0.25806451612903225	0.032520325203252036	GO:0051054	GO:BP	positive regulation of DNA metabolic process	16175	13464		0.8035714285714286	0.8070175438596491	246	15929	8	23	238	15906	16175	0.08695735891631821
M1	cpdb	0	network_modules	129	TRUE	3.253045244346215e-5	44	29	5	0.1724137931034483	0.11363636363636363	REAC:R-HSA-9646399	REAC	Aggrephagy	10916	129		0.5217391304347826	0.5319148936170213	44	10872	5	24	39	10848	10916	0.1371594167724154
M1	cpdb	0	network_modules	129	TRUE	5.541854452023102e-5	170	18	6	0.3333333333333333	0.03529411764705882	KEGG:04530	KEGG	Tight junction	8484	317		0	0.25	170	8314	6	12	164	8302	8484	0.10309144482918157
M1	cpdb	0	network_modules	129	TRUE	6.607816305803691e-5	20	29	4	0.13793103448275862	0.2	REAC:R-HSA-190840	REAC	Microtubule-dependent trafficking of connexons from Golgi to the plasma membrane	10916	1451		0.5434782608695652	0.5531914893617021	20	10896	4	25	16	10871	10916	0.16425339757638308
M1	cpdb	0	network_modules	129	TRUE	8.147635969219425e-5	21	29	4	0.13793103448275862	0.19047619047619047	REAC:R-HSA-190872	REAC	Transport of connexons to the plasma membrane	10916	2592		0.5652173913043478	0.574468085106383	21	10895	4	25	17	10870	10916	0.1601943588154428
M1	cpdb	0	network_modules	129	TRUE	8.309428344401244e-5	420	31	9	0.2903225806451613	0.02142857142857143	GO:0010638	GO:BP	positive regulation of organelle organization	16175	4284		0.8214285714285714	0.8245614035087719	420	15755	9	22	411	15733	16175	0.07284099066491921
M1	cpdb	0	network_modules	129	TRUE	8.830138699706557e-5	5	31	3	0.0967741935483871	0.6	GO:0090666	GO:BP	scaRNA localization to Cajal body	16175	18396		0.8392857142857143	0.8421052631578947	5	16170	3	28	2	16142	16175	0.2404637712143711
M1	cpdb	0	network_modules	129	TRUE	8.926976754022754e-5	297	31	8	0.25806451612903225	0.026936026936026935	GO:0031647	GO:BP	regulation of protein stability	16175	7257		0.8571428571428571	0.8596491228070176	297	15878	8	23	289	15855	16175	0.07823780010106278
M1	cpdb	0	network_modules	129	TRUE	1.1217643524077474e-4	435	31	9	0.2903225806451613	0.020689655172413793	GO:0051052	GO:BP	regulation of DNA metabolic process	16175	13462		0.875	0.8771929824561403	435	15740	9	22	426	15718	16175	0.07135699067374418
M1	cpdb	0	network_modules	129	TRUE	1.4386234152777283e-4	24	29	4	0.13793103448275862	0.16666666666666666	REAC:R-HSA-389977	REAC	Post-chaperonin tubulin folding pathway	10916	1773		0.5869565217391305	0.5957446808510638	24	10892	4	25	20	10867	10916	0.14956590107409845
M1	cpdb	0	network_modules	129	TRUE	1.7292892033565912e-4	792	31	11	0.3548387096774194	0.013888888888888888	GO:0000278	GO:BP	mitotic cell cycle	16175	76		0.8928571428571429	0.8947368421052632	792	15383	11	20	781	15363	16175	0.06211255300203087
M1	cpdb	0	network_modules	129	TRUE	2.732672269900796e-4	483	31	9	0.2903225806451613	0.018633540372670808	GO:0051604	GO:BP	protein maturation	16175	13821		0.9107142857142857	0.9122807017543859	483	15692	9	22	474	15670	16175	0.06705801462130048
M1	cpdb	0	network_modules	129	TRUE	2.751784186720123e-4	28	29	4	0.13793103448275862	0.14285714285714285	REAC:R-HSA-9619483	REAC	Activation of AMPK downstream of NMDARs	10916	73		0.6086956521739131	0.6170212765957447	28	10888	4	25	24	10863	10916	0.13812265381562192
M1	cpdb	0	network_modules	129	TRUE	4.1785818806283176e-4	318	29	8	0.27586206896551724	0.025157232704402517	REAC:R-HSA-195258	REAC	RHO GTPase Effectors	10916	1846		0.6304347826086957	0.6382978723404256	318	10598	8	21	310	10577	10916	0.07571915680582086
M1	cpdb	0	network_modules	129	TRUE	4.79759194602646e-4	32	29	4	0.13793103448275862	0.125	REAC:R-HSA-9668328	REAC	Sealing of the nuclear envelope (NE) by ESCRT-III	10916	2185		0.6521739130434783	0.6808510638297872	32	10884	4	25	28	10859	10916	0.1288758386837903
M1	cpdb	0	network_modules	129	TRUE	4.79759194602646e-4	32	29	4	0.13793103448275862	0.125	REAC:R-HSA-5626467	REAC	RHO GTPases activate IQGAPs	10916	1854		0.6521739130434783	0.6808510638297872	32	10884	4	25	28	10859	10916	0.1288758386837903
M1	cpdb	0	network_modules	129	TRUE	5.110808906486181e-4	373	31	8	0.25806451612903225	0.021447721179624665	GO:0072594	GO:BP	establishment of protein localization to organelle	16175	17458		0.9285714285714286	0.9298245614035088	373	15802	8	23	365	15779	16175	0.06860958798726405
M1	cpdb	0	network_modules	129	TRUE	5.431414256540788e-4	376	31	8	0.25806451612903225	0.02127659574468085	GO:1903829	GO:BP	positive regulation of protein localization	16175	23311		0.9464285714285714	0.9473684210526315	376	15799	8	23	368	15776	16175	0.06828788188225221
M1	cpdb	0	network_modules	129	TRUE	6.740097347800961e-4	80	29	5	0.1724137931034483	0.0625	REAC:R-HSA-9663891	REAC	Selective autophagy	10916	2186		0.6956521739130435	0.7021276595744681	80	10836	5	24	75	10812	10916	0.09989340187574801
M1	cpdb	0	network_modules	129	TRUE	6.92645072738134e-4	147	29	6	0.20689655172413793	0.04081632653061224	REAC:R-HSA-1169410	REAC	Antiviral mechanism by IFN-stimulated genes	10916	157		0.717391304347826	0.723404255319149	147	10769	6	23	141	10746	10916	0.08661359625296199
M1	cpdb	0	network_modules	129	TRUE	8.678992748618609e-4	400	31	8	0.25806451612903225	0.02	GO:0070201	GO:BP	regulation of establishment of protein localization	16175	15984		0.9642857142857143	0.9649122807017544	400	15775	8	23	392	15752	16175	0.06583923267846259
M1	cpdb	0	network_modules	129	TRUE	9.740203470415506e-4	38	29	4	0.13793103448275862	0.10526315789473684	REAC:R-HSA-190861	REAC	Gap junction assembly	10916	1033		0.7391304347826086	0.7446808510638298	38	10878	4	25	34	10853	10916	0.11781554360083568
M1	cpdb	0	network_modules	129	TRUE	0.0014998743501481674	94	29	5	0.1724137931034483	0.05319148936170213	REAC:R-HSA-380320	REAC	Recruitment of NuMA to mitotic centrosomes	10916	1950		0.7608695652173914	0.7659574468085106	94	10822	5	24	89	10798	10916	0.09149797053648893
M1	cpdb	0	network_modules	129	TRUE	0.0016135791768632415	43	29	4	0.13793103448275862	0.09302325581395349	REAC:R-HSA-9609736	REAC	Assembly and cell surface presentation of NMDA receptors	10916	173		0.782608695652174	0.7872340425531915	43	10873	4	25	39	10848	10916	0.11040224811129408
M1	cpdb	0	network_modules	129	TRUE	0.0018202276707486452	88	18	4	0.2222222222222222	0.045454545454545456	KEGG:04540	KEGG	Gap junction	8484	318		0.3333333333333333	0.5	88	8396	4	14	84	8382	8484	0.0964157975899156
M1	cpdb	0	network_modules	129	TRUE	0.001940967409246709	45	29	4	0.13793103448275862	0.08888888888888889	REAC:R-HSA-8955332	REAC	Carboxyterminal post-translational modifications of tubulin	10916	305		0.8043478260869565	0.8085106382978723	45	10871	4	25	41	10846	10916	0.10778332666119655
M1	cpdb	0	network_modules	129	TRUE	0.0021623417463727513	808	31	10	0.3225806451612903	0.012376237623762377	GO:0033365	GO:BP	protein localization to organelle	16175	8175		0.9821428571428571	0.9824561403508771	808	15367	10	21	798	15346	16175	0.054838835136379264
M1	cpdb	0	network_modules	129	TRUE	0.0023541559510743765	32	18	3	0.16666666666666666	0.09375	KEGG:04136	KEGG	Autophagy - other	8484	273		0.6666666666666666	0.75	32	8452	3	15	29	8437	8484	0.12253225616421644
M1	cpdb	0	network_modules	129	TRUE	0.0023953289982696383	193	18	5	0.2777777777777778	0.025906735751295335	KEGG:04814	KEGG	Motor proteins	8484	366		1	1	193	8291	5	13	188	8278	8484	0.07886882357081611
M1	cpdb	0	network_modules	129	TRUE	0.0025208946176748528	48	29	4	0.13793103448275862	0.08333333333333333	REAC:R-HSA-437239	REAC	Recycling pathway of L1	10916	1954		0.8260869565217391	0.8297872340425532	48	10868	4	25	44	10843	10916	0.10416078684667725
M1	cpdb	0	network_modules	129	TRUE	0.002739943297283656	49	29	4	0.13793103448275862	0.08163265306122448	REAC:R-HSA-190828	REAC	Gap junction trafficking	10916	1035		0.8478260869565217	0.851063829787234	49	10867	4	25	45	10842	10916	0.10302645800178968
M1	cpdb	0	network_modules	129	TRUE	0.002972740964396337	50	29	4	0.13793103448275862	0.08	REAC:R-HSA-157858	REAC	Gap junction trafficking and regulation	10916	1036		0.8695652173913043	0.8723404255319149	50	10866	4	25	46	10841	10916	0.10192566247732278
M1	cpdb	0	network_modules	129	TRUE	0.0037590772684001268	53	29	4	0.13793103448275862	0.07547169811320754	REAC:R-HSA-6811436	REAC	COPI-independent Golgi-to-ER retrograde traffic	10916	278		0.8913043478260869	0.8936170212765957	53	10863	4	25	49	10838	10916	0.09880856628925157
M1	cpdb	0	network_modules	129	TRUE	0.003990123479598662	305	29	7	0.2413793103448276	0.022950819672131147	REAC:R-HSA-446203	REAC	Asparagine N-linked glycosylation	10916	169		0.9130434782608695	0.9148936170212766	305	10611	7	22	298	10589	10916	0.06684261765534719
M1	cpdb	0	network_modules	129	TRUE	0.004052362949116836	54	29	4	0.13793103448275862	0.07407407407407407	REAC:R-HSA-5620924	REAC	Intraflagellar transport	10916	1267		0.9347826086956522	0.9361702127659575	54	10862	4	25	50	10837	10916	0.0978265131664637
M1	cpdb	0	network_modules	129	TRUE	0.004971678878575304	684	31	9	0.2903225806451613	0.013157894736842105	GO:0032880	GO:BP	regulation of protein localization	16175	7877		1	1	684	15491	9	22	675	15469	16175	0.05400884963237632
M1	cpdb	0	network_modules	129	TRUE	0.0050337832835408765	57	29	4	0.13793103448275862	0.07017543859649122	REAC:R-HSA-3371497	REAC	HSP90 chaperone cycle for steroid hormone receptors (SHR) in the presence of ligand	10916	1111		0.9565217391304348	0.9574468085106383	57	10859	4	25	53	10834	10916	0.09503368386522935
M1	cpdb	0	network_modules	129	TRUE	0.006180040318356137	60	29	4	0.13793103448275862	0.06666666666666667	REAC:R-HSA-983189	REAC	Kinesins	10916	1292		0.9782608695652174	0.9787234042553191	60	10856	4	25	56	10831	10916	0.09244832765350186
M1	cpdb	0	network_modules	129	TRUE	0.008475410424277807	134	29	5	0.1724137931034483	0.03731343283582089	REAC:R-HSA-1632852	REAC	Macroautophagy	10916	1388		1	1	134	10782	5	24	129	10758	10916	0.07505876029984253
M1	cpdb	0	network_modules	131	TRUE	6.16191612924479e-9	131	18	8	0.4444444444444444	0.061068702290076333	KEGG:04142	KEGG	Lysosome	8484	279		0	0.5	131	8353	8	10	123	8343	8484	0.16043600651445547
M1	cpdb	0	network_modules	131	TRUE	3.2355682673134153e-7	11	16	4	0.25	0.36363636363636365	REAC:R-HSA-2206281	REAC	Mucopolysaccharidoses	10916	1493		0	0.25	11	10905	4	12	7	10893	10916	0.30066786740934015
M1	cpdb	0	network_modules	131	TRUE	3.315035680730174e-6	19	18	4	0.2222222222222222	0.21052631578947367	KEGG:00531	KEGG	Glycosaminoglycan degradation	8484	75		1	1	19	8465	4	14	15	8451	8484	0.2145833650689005
M1	cpdb	0	network_modules	131	TRUE	3.935111348698331e-5	33	16	4	0.25	0.12121212121212122	REAC:R-HSA-5663084	REAC	Diseases of carbohydrate metabolism	10916	763		0.3333333333333333	0.5	33	10883	4	12	29	10871	10916	0.17235954767567666
M1	cpdb	0	network_modules	131	TRUE	0.00293052110335139	2	23	2	0.08695652173913043	1	GO:0051412	GO:BP	response to corticosterone	16175	13699		NA	1	2	16173	2	21	0	16152	16175	0.29469240258173435
M1	cpdb	0	network_modules	131	TRUE	0.008592851117641161	125	16	4	0.25	0.032	REAC:R-HSA-1630316	REAC	Glycosaminoglycan metabolism	10916	1076		0.6666666666666666	0.75	125	10791	4	12	121	10779	10916	0.08590172192559181
M1	cpdb	0	network_modules	131	TRUE	0.009651048672627758	6	16	2	0.125	0.3333333333333333	REAC:R-HSA-193993	REAC	Mineralocorticoid biosynthesis	10916	1452		1	1	6	10910	2	14	4	10896	10916	0.20343158583831095
M1	cpdb	0	network_modules	132	TRUE	5.574920031443589e-12	49	21	8	0.38095238095238093	0.16326530612244897	REAC:R-HSA-373752	REAC	Netrin-1 signaling	10916	1586		0	0.06666666666666667	49	10867	8	13	41	10854	10916	0.24724619976218243
M1	cpdb	0	network_modules	132	TRUE	2.784276460342519e-10	8	21	5	0.23809523809523808	0.625	REAC:R-HSA-72731	REAC	Recycling of eIF2:GDP	10916	1953		0.07142857142857142	0.2	8	10908	5	16	3	10892	10916	0.3850825744424474
M1	cpdb	0	network_modules	132	TRUE	2.784276460342519e-10	8	21	5	0.23809523809523808	0.625	REAC:R-HSA-418886	REAC	Netrin mediated repulsion signals	10916	1585		0.07142857142857142	0.2	8	10908	5	16	3	10892	10916	0.3850825744424474
M1	cpdb	0	network_modules	132	TRUE	9.687188450880025e-9	165	28	9	0.32142857142857145	0.05454545454545454	GO:0007411	GO:BP	axon guidance	16175	2906		0	0.06451612903225806	165	16010	9	19	156	15991	16175	0.12897867453237402
M1	cpdb	0	network_modules	132	TRUE	9.687188450880025e-9	165	28	9	0.32142857142857145	0.05454545454545454	GO:0097485	GO:BP	neuron projection guidance	16175	18673		0	0.06451612903225806	165	16010	9	19	156	15991	16175	0.12897867453237402
M1	cpdb	0	network_modules	132	TRUE	4.6444105866692475e-8	181	17	8	0.47058823529411764	0.04419889502762431	KEGG:04360	KEGG	Axon guidance	8484	305		NA	1	181	8303	8	9	173	8294	8484	0.13931421983629924
M1	cpdb	0	network_modules	132	TRUE	6.328627417956625e-8	297	28	10	0.35714285714285715	0.03367003367003367	GO:0007409	GO:BP	axonogenesis	16175	2905		0.06666666666666667	0.0967741935483871	297	15878	10	18	287	15860	16175	0.1050801164510536
M1	cpdb	0	network_modules	132	TRUE	1.3329478918320008e-7	441	28	11	0.39285714285714285	0.024943310657596373	GO:0048812	GO:BP	neuron projection morphogenesis	16175	13058		0.1	0.12903225806451613	441	15734	11	17	430	15717	16175	0.09348376685375447
M1	cpdb	0	network_modules	132	TRUE	1.5261570500596998e-7	43	28	6	0.21428571428571427	0.13953488372093023	GO:0002183	GO:BP	cytoplasmic translational initiation	16175	731		0.13333333333333333	0.16129032258064516	43	16132	6	22	37	16110	16175	0.1711475632460128
M1	cpdb	0	network_modules	132	TRUE	1.9054084474757847e-7	456	28	11	0.39285714285714285	0.02412280701754386	GO:0120039	GO:BP	plasma membrane bounded cell projection morphogenesis	16175	19473		0.16666666666666666	0.1935483870967742	456	15719	11	17	445	15702	16175	0.09174389387629955
M1	cpdb	0	network_modules	132	TRUE	2.0915087326391882e-7	460	28	11	0.39285714285714285	0.02391304347826087	GO:0048858	GO:BP	cell projection morphogenesis	16175	13102		0.2	0.22580645161290322	460	15715	11	17	449	15698	16175	0.09129380856052795
M1	cpdb	0	network_modules	132	TRUE	2.3190544154656913e-7	339	28	10	0.35714285714285715	0.029498525073746312	GO:0061564	GO:BP	axon development	16175	15561		0.23333333333333334	0.25806451612903225	339	15836	10	18	329	15818	16175	0.09773105496658761
M1	cpdb	0	network_modules	132	TRUE	3.6691546731040377e-07	21	28	5	0.17857142857142858	0.23809523809523808	GO:0014003	GO:BP	oligodendrocyte development	16175	4576		0.26666666666666666	0.2903225806451613	21	16154	5	23	16	16131	16175	0.20500790400519778
M1	cpdb	0	network_modules	132	TRUE	6.886639850075191e-7	379	28	10	0.35714285714285715	0.026385224274406333	GO:0048667	GO:BP	cell morphogenesis involved in neuron differentiation	16175	12925		0.3	0.3225806451612903	379	15796	10	18	369	15778	16175	0.09186616038724954
M1	cpdb	0	network_modules	132	TRUE	2.8240908250541985e-6	761	28	12	0.42857142857142855	0.01576872536136662	GO:0048666	GO:BP	neuron development	16175	12924		0.3333333333333333	0.3548387096774194	761	15414	12	16	749	15398	16175	0.07503237397027648
M1	cpdb	0	network_modules	132	TRUE	8.179113777934359e-6	651	28	11	0.39285714285714285	0.016897081413210446	GO:0000902	GO:BP	cell morphogenesis	16175	240		0.36666666666666664	0.3870967741935484	651	15524	11	17	640	15507	16175	0.07471013275393809
M1	cpdb	0	network_modules	132	TRUE	1.3690857277142997e-5	684	28	11	0.39285714285714285	0.01608187134502924	GO:0031175	GO:BP	neuron projection development	16175	7086		0.4	0.41935483870967744	684	15491	11	17	673	15474	16175	0.07254106622867262
M1	cpdb	0	network_modules	132	TRUE	2.399377231730025e-5	46	28	5	0.17857142857142858	0.10869565217391304	GO:0048709	GO:BP	oligodendrocyte differentiation	16175	12966		0.43333333333333335	0.45161290322580644	46	16129	5	23	41	16106	16175	0.13741513199091665
M1	cpdb	0	network_modules	132	TRUE	5.234934684523738e-5	111	28	6	0.21428571428571427	0.05405405405405406	GO:0006413	GO:BP	translational initiation	16175	2171		0.4666666666666667	0.4838709677419355	111	16064	6	22	105	16042	16175	0.10462766339737994
M1	cpdb	0	network_modules	132	TRUE	1.0229642706922932e-4	61	28	5	0.17857142857142858	0.08196721311475409	GO:0021782	GO:BP	glial cell development	16175	6360		0.5	0.5161290322580645	61	16114	5	23	56	16091	16175	0.11875520464035587
M1	cpdb	0	network_modules	132	TRUE	2.2123662634952504e-4	71	28	5	0.17857142857142858	0.07042253521126761	GO:0009408	GO:BP	response to heat	16175	3473		0.5333333333333333	0.5483870967741935	71	16104	5	23	66	16081	16175	0.10971965843520481
M1	cpdb	0	network_modules	132	TRUE	2.3102707926059242e-4	10	21	3	0.14285714285714285	0.3	REAC:R-HSA-418889	REAC	Caspase activation via Dependence Receptors in the absence of ligand	10916	314		0.21428571428571427	0.26666666666666666	10	10906	3	18	7	10888	10916	0.20598464316337545
M1	cpdb	0	network_modules	132	TRUE	3.1726929367907207e-4	11	21	3	0.14285714285714285	0.2727272727272727	REAC:R-HSA-376172	REAC	DSCAM interactions	10916	450		0.2857142857142857	0.3333333333333333	11	10905	3	18	8	10887	10916	0.19628089464160198
M1	cpdb	0	network_modules	132	TRUE	4.295087923258644e-4	158	28	6	0.21428571428571427	0.0379746835443038	GO:0002181	GO:BP	cytoplasmic translation	16175	729		0.5666666666666667	0.5806451612903226	158	16017	6	22	152	15995	16175	0.08659420713431258
M1	cpdb	0	network_modules	132	TRUE	6.903871996798191e-4	89	28	5	0.17857142857142858	0.056179775280898875	GO:0001764	GO:BP	neuron migration	16175	430		0.6	0.6129032258064516	89	16086	5	23	84	16063	16175	0.0974266809583863
M1	cpdb	0	network_modules	132	TRUE	7.716626270546826e-4	91	28	5	0.17857142857142858	0.054945054945054944	GO:0009749	GO:BP	response to glucose	16175	3646		0.6333333333333333	0.6451612903225806	91	16084	5	23	86	16061	16175	0.0962872595351105
M1	cpdb	0	network_modules	132	TRUE	8.259823449684065e-4	120	21	5	0.23809523809523808	0.041666666666666664	REAC:R-HSA-72613	REAC	Eukaryotic Translation Initiation	10916	871		0.35714285714285715	0.4666666666666667	120	10796	5	16	115	10780	10916	0.09562222350847223
M1	cpdb	0	network_modules	132	TRUE	8.259823449684065e-4	120	21	5	0.23809523809523808	0.041666666666666664	REAC:R-HSA-72737	REAC	Cap-dependent Translation Initiation	10916	304		0.35714285714285715	0.4666666666666667	120	10796	5	16	115	10780	10916	0.09562222350847223
M1	cpdb	0	network_modules	132	TRUE	8.603288620515021e-4	93	28	5	0.17857142857142858	0.053763440860215055	GO:0009746	GO:BP	response to hexose	16175	3643		0.6666666666666666	0.7096774193548387	93	16082	5	23	88	16059	16175	0.09518410726119465
M1	cpdb	0	network_modules	132	TRUE	8.603288620515021e-4	93	28	5	0.17857142857142858	0.053763440860215055	GO:0034284	GO:BP	response to monosaccharide	16175	8541		0.6666666666666666	0.7096774193548387	93	16082	5	23	88	16059	16175	0.09518410726119465
M1	cpdb	0	network_modules	132	TRUE	0.0012359826204824678	100	28	5	0.17857142857142858	0.05	GO:0009266	GO:BP	response to temperature stimulus	16175	3431		0.7333333333333333	0.7419354838709677	100	16075	5	23	95	16052	16175	0.09158230370822343
M1	cpdb	0	network_modules	132	TRUE	0.0012988126598825825	101	28	5	0.17857142857142858	0.04950495049504951	GO:0009743	GO:BP	response to carbohydrate	16175	3640		0.7666666666666667	0.7741935483870968	101	16074	5	23	96	16051	16175	0.09109795060887284
M1	cpdb	0	network_modules	132	TRUE	0.0023702840048648146	114	28	5	0.17857142857142858	0.043859649122807015	GO:0050852	GO:BP	T cell receptor signaling pathway	16175	13300		0.8	0.8064516129032258	114	16061	5	23	109	16038	16175	0.08538121565712763
M1	cpdb	0	network_modules	132	TRUE	0.0029211387049777457	22	21	3	0.14285714285714285	0.13636363636363635	REAC:R-HSA-167242	REAC	Abortive elongation of HIV-1 transcript in the absence of Tat	10916	51		0.5	0.5333333333333333	22	10894	3	18	19	10876	10916	0.13787513538282495
M1	cpdb	0	network_modules	132	TRUE	0.0029313884363441	119	28	5	0.17857142857142858	0.04201680672268908	GO:0010001	GO:BP	glial cell differentiation	16175	3822		0.8333333333333334	0.8387096774193549	119	16056	5	23	114	16033	16175	0.08343062563815246
M1	cpdb	0	network_modules	132	TRUE	0.003594027106055537	15	28	3	0.10714285714285714	0.2	GO:0034244	GO:BP	negative regulation of transcription elongation by RNA polymerase II	16175	8520		0.8666666666666667	0.8709677419354839	15	16160	3	25	12	16135	16175	0.14531116107917666
M1	cpdb	0	network_modules	132	TRUE	0.004346571905437383	25	21	3	0.14285714285714285	0.12	REAC:R-HSA-5357769	REAC	Caspase activation via extrinsic apoptotic signalling pathway	10916	315		0.5714285714285714	0.6	25	10891	3	18	22	10873	10916	0.1291037399356338
M1	cpdb	0	network_modules	132	TRUE	0.0043654055585514865	129	28	5	0.17857142857142858	0.03875968992248062	GO:0048588	GO:BP	developmental cell growth	16175	12859		0.9	0.9032258064516129	129	16046	5	23	124	16023	16175	0.07986718539709937
M1	cpdb	0	network_modules	132	TRUE	0.005263859393940492	134	28	5	0.17857142857142858	0.03731343283582089	GO:0060560	GO:BP	developmental growth involved in morphogenesis	16175	14744		0.9333333333333333	0.9354838709677419	134	16041	5	23	129	16018	16175	0.07823315734168215
M1	cpdb	0	network_modules	132	TRUE	0.00761867105046191	19	28	3	0.10714285714285714	0.15789473684210525	GO:0032785	GO:BP	negative regulation of DNA-templated transcription, elongation	16175	7820		0.9666666666666667	0.967741935483871	19	16156	3	25	16	16131	16175	0.1288276952064913
M1	cpdb	0	network_modules	132	TRUE	0.007625315185891984	30	21	3	0.14285714285714285	0.1	REAC:R-HSA-167238	REAC	Pausing and recovery of Tat-mediated HIV elongation	10916	1720		0.6428571428571429	0.7333333333333333	30	10886	3	18	27	10868	10916	0.11749798984366094
M1	cpdb	0	network_modules	132	TRUE	0.007625315185891984	30	21	3	0.14285714285714285	0.1	REAC:R-HSA-167243	REAC	Tat-mediated HIV elongation arrest and recovery	10916	2484		0.6428571428571429	0.7333333333333333	30	10886	3	18	27	10868	10916	0.11749798984366094
M1	cpdb	0	network_modules	132	TRUE	0.007797063322564959	65	28	4	0.14285714285714285	0.06153846153846154	GO:0061387	GO:BP	regulation of extent of cell growth	16175	15458		1	1	65	16110	4	24	61	16086	16175	0.09138673179113517
M1	cpdb	0	network_modules	132	TRUE	0.009292628489540771	32	21	3	0.14285714285714285	0.09375	REAC:R-HSA-167290	REAC	Pausing and recovery of HIV elongation	10916	1719		0.7857142857142857	1	32	10884	3	18	29	10866	10916	0.11362860748159069
M1	cpdb	0	network_modules	132	TRUE	0.009292628489540771	32	21	3	0.14285714285714285	0.09375	REAC:R-HSA-167158	REAC	Formation of the HIV-1 Early Elongation Complex	10916	965		0.7857142857142857	1	32	10884	3	18	29	10866	10916	0.11362860748159069
M1	cpdb	0	network_modules	132	TRUE	0.009292628489540771	32	21	3	0.14285714285714285	0.09375	REAC:R-HSA-113418	REAC	Formation of the Early Elongation Complex	10916	963		0.7857142857142857	1	32	10884	3	18	29	10866	10916	0.11362860748159069
M1	cpdb	0	network_modules	132	TRUE	0.009292628489540771	32	21	3	0.14285714285714285	0.09375	REAC:R-HSA-167287	REAC	HIV elongation arrest and recovery	10916	1106		0.7857142857142857	1	32	10884	3	18	29	10866	10916	0.11362860748159069
M1	cpdb	0	network_modules	133	TRUE	3.297215910018765e-4	2	12	2	0.16666666666666666	1	REAC:R-HSA-3359473	REAC	Defective MMADHC causes MMAHCD	10916	583		0	0.5	2	10914	2	10	0	10904	10916	0.40806121796608574
M1	cpdb	0	network_modules	133	TRUE	8.547141890285448e-4	69	7	3	0.42857142857142855	0.043478260869565216	KEGG:04924	KEGG	Renin secretion	8484	381		0	0.5	69	8415	3	4	66	8411	8484	0.1345176997386078
M1	cpdb	0	network_modules	133	TRUE	0.002381377134528591	97	7	3	0.42857142857142855	0.030927835051546393	KEGG:04713	KEGG	Circadian entrainment	8484	348		1	1	97	8387	3	4	94	8383	8484	0.11275071443411114
M1	cpdb	0	network_modules	133	TRUE	0.006903031937510064	7	12	2	0.16666666666666666	0.2857142857142857	REAC:R-HSA-9759218	REAC	Cobalamin (Cbl) metabolism	10916	380		1	1	7	10909	2	10	5	10899	10916	0.21756763404988302
M1	cpdb	0	network_modules	134	TRUE	1.7646929825596404e-10	407	24	12	0.5	0.029484029484029485	GO:0007015	GO:BP	actin filament organization	16175	2624		0	0.029411764705882353	407	15768	12	12	395	15756	16175	0.11687184377242436
M1	cpdb	0	network_modules	134	TRUE	1.150005107699546e-9	632	24	13	0.5416666666666666	0.020569620253164556	GO:0030036	GO:BP	actin cytoskeleton organization	16175	6660		0.030303030303030304	0.058823529411764705	632	15543	13	11	619	15532	16175	0.09998654439433738
M1	cpdb	0	network_modules	134	TRUE	4.852865225099169e-9	708	24	13	0.5416666666666666	0.018361581920903956	GO:0030029	GO:BP	actin filament-based process	16175	6653		0.06060606060606061	0.08823529411764706	708	15467	13	11	695	15456	16175	0.09381421669632997
M1	cpdb	0	network_modules	134	TRUE	9.715142700118906e-9	748	24	13	0.5416666666666666	0.017379679144385027	GO:0097435	GO:BP	supramolecular fiber organization	16175	18657		0.09090909090909091	0.11764705882352941	748	15427	13	11	735	15416	16175	0.09093568795549471
M1	cpdb	0	network_modules	134	TRUE	1.8349264775825127e-8	19	17	5	0.29411764705882354	0.2631578947368421	REAC:R-HSA-5627117	REAC	RHO GTPases Activate ROCKs	10916	1850		0	0.09090909090909091	19	10897	5	12	14	10885	10916	0.2770178243011048
M1	cpdb	0	network_modules	134	TRUE	1.8826562850784678e-8	215	24	9	0.375	0.04186046511627907	GO:0110053	GO:BP	regulation of actin filament organization	16175	19377		0.12121212121212122	0.14705882352941177	215	15960	9	15	206	15945	16175	0.12175099003051737
M1	cpdb	0	network_modules	134	TRUE	2.4443246988019922e-8	20	17	5	0.29411764705882354	0.25	REAC:R-HSA-416572	REAC	Sema4D induced cell migration and growth-cone collapse	10916	2191		0.1	0.18181818181818182	20	10896	5	12	15	10884	10916	0.2699313636969266
M1	cpdb	0	network_modules	134	TRUE	3.222328131505837e-8	181	11	7	0.6363636363636364	0.03867403314917127	KEGG:04360	KEGG	Axon guidance	8484	305		0	0.5	181	8303	7	4	174	8299	8484	0.15336188620400532
M1	cpdb	0	network_modules	134	TRUE	6.676528376557999e-8	24	17	5	0.29411764705882354	0.20833333333333334	REAC:R-HSA-400685	REAC	Sema4D in semaphorin signaling	10916	2190		0.2	0.2727272727272727	24	10892	5	12	19	10880	10916	0.24614875620956228
M1	cpdb	0	network_modules	134	TRUE	1.579880380312606e-7	227	11	7	0.6363636363636364	0.030837004405286344	KEGG:04810	KEGG	Regulation of actin cytoskeleton	8484	365		1	1	227	8257	7	4	220	8253	8484	0.1361145497654237
M1	cpdb	0	network_modules	134	TRUE	1.6480409647881902e-7	274	24	9	0.375	0.032846715328467155	GO:0032956	GO:BP	regulation of actin cytoskeleton organization	16175	7940		0.15151515151515152	0.17647058823529413	274	15901	9	15	265	15886	16175	0.10695937245546996
M1	cpdb	0	network_modules	134	TRUE	4.3546890904800944e-7	793	24	12	0.5	0.015132408575031526	GO:0044087	GO:BP	regulation of cellular component biogenesis	16175	10909		0.18181818181818182	0.20588235294117646	793	15382	12	12	781	15370	16175	0.08051159746394891
M1	cpdb	0	network_modules	134	TRUE	4.3673474214212743e-7	440	24	10	0.4166666666666667	0.022727272727272728	GO:0051493	GO:BP	regulation of cytoskeleton organization	16175	13748		0.21212121212121213	0.23529411764705882	440	15735	10	14	430	15721	16175	0.09229071822021104
M1	cpdb	0	network_modules	134	TRUE	4.6568339410123113e-7	308	24	9	0.375	0.02922077922077922	GO:0032970	GO:BP	regulation of actin filament-based process	16175	7953		0.24242424242424243	0.2647058823529412	308	15867	9	15	299	15852	16175	0.10039833685730795
M1	cpdb	0	network_modules	134	TRUE	6.179065931447698e-7	318	24	9	0.375	0.02830188679245283	GO:1902903	GO:BP	regulation of supramolecular fiber organization	16175	22602		0.2727272727272727	0.29411764705882354	318	15857	9	15	309	15842	16175	0.09866662304448655
M1	cpdb	0	network_modules	134	TRUE	8.345714582319172e-7	329	24	9	0.375	0.02735562310030395	GO:0090066	GO:BP	regulation of anatomical structure size	16175	17992		0.30303030303030304	0.3235294117647059	329	15846	9	15	320	15831	16175	0.09685110916457065
M1	cpdb	0	network_modules	134	TRUE	1.8808194244426944e-6	449	17	9	0.5294117647058824	0.0200445434298441	REAC:R-HSA-9012999	REAC	RHO GTPase cycle	10916	1847		0.3	0.36363636363636365	449	10467	9	8	440	10459	10916	0.097102151748013385
M1	cpdb	0	network_modules	134	TRUE	6.6564506341394e-6	583	24	10	0.4166666666666667	0.017152658662092625	GO:0051129	GO:BP	negative regulation of cellular component organization	16175	13513		0.3333333333333333	0.35294117647058826	583	15592	10	14	573	15578	16175	0.07871554091338948
M1	cpdb	0	network_modules	134	TRUE	8.461298283318944e-6	45	24	5	0.20833333333333334	0.1111111111111111	GO:0030837	GO:BP	negative regulation of actin filament polymerization	16175	6922		0.36363636363636365	0.38235294117647056	45	16130	5	19	40	16111	16175	0.15043431369740745
M1	cpdb	0	network_modules	134	TRUE	1.1544422953781587e-5	64	17	5	0.29411764705882354	0.078125	REAC:R-HSA-373755	REAC	Semaphorin interactions	10916	2193		0.4	0.45454545454545453	64	10852	5	12	59	10840	10916	0.14911666064344467
M1	cpdb	0	network_modules	134	TRUE	2.8658543627238297e-5	57	24	5	0.20833333333333334	0.08771929824561403	GO:0032272	GO:BP	negative regulation of protein polymerization	16175	7453		0.3939393939393939	0.4117647058823529	57	16118	5	19	52	16099	16175	0.1332315356761813
M1	cpdb	0	network_modules	134	TRUE	3.8966406667739433e-05	127	24	6	0.25	0.047244094488188976	GO:0051494	GO:BP	negative regulation of cytoskeleton organization	16175	13749		0.42424242424242425	0.4411764705882353	127	16048	6	18	121	16030	16175	0.10575951391514006
M1	cpdb	0	network_modules	134	TRUE	5.619107691737333e-5	135	24	6	0.25	0.044444444444444446	GO:0051017	GO:BP	actin filament bundle assembly	16175	13442		0.45454545454545453	0.47058823529411764	135	16040	6	18	129	16022	16175	0.10239405454946682
M1	cpdb	0	network_modules	134	TRUE	6.408671721082042e-5	138	24	6	0.25	0.043478260869565216	GO:0061572	GO:BP	actin filament bundle organization	16175	15565		0.48484848484848486	0.5	138	16037	6	18	132	16019	16175	0.10120669572911649
M1	cpdb	0	network_modules	134	TRUE	1.0115420669918593e-4	257	24	7	0.2916666666666667	0.027237354085603113	GO:0032535	GO:BP	regulation of cellular component size	16175	7629		0.5151515151515151	0.5294117647058824	257	15918	7	17	250	15901	16175	0.0850156594582692
M1	cpdb	0	network_modules	134	TRUE	1.1847660778340613e-4	40	17	4	0.23529411764705882	0.1	REAC:R-HSA-3928662	REAC	EPHB-mediated forward signaling	10916	821		0.5	0.5454545454545454	40	10876	4	13	36	10863	10916	0.15139950158922458
M1	cpdb	0	network_modules	134	TRUE	3.1779411058468744e-4	304	24	7	0.2916666666666667	0.023026315789473683	GO:0010639	GO:BP	negative regulation of organelle organization	16175	4285		0.5454545454545454	0.5588235294117647	304	15871	7	17	297	15854	16175	0.0774587716099459
M1	cpdb	0	network_modules	134	TRUE	4.2411904158483896e-4	97	24	5	0.20833333333333334	0.05154639175257732	GO:0030833	GO:BP	regulation of actin filament polymerization	16175	6918		0.5757575757575758	0.5882352941176471	97	16078	5	19	92	16059	16175	0.10102349602665321
M1	cpdb	0	network_modules	134	TRUE	9.093372315990072e-4	113	24	5	0.20833333333333334	0.04424778761061947	GO:0008064	GO:BP	regulation of actin polymerization or depolymerization	16175	3113		0.6060606060606061	0.6176470588235294	113	16062	5	19	108	16043	16175	0.0931873277168
M1	cpdb	0	network_modules	134	TRUE	9.501162274641238e-4	114	24	5	0.20833333333333334	0.043859649122807015	GO:0031333	GO:BP	negative regulation of protein-containing complex assembly	16175	7124		0.6363636363636364	0.6470588235294118	114	16061	5	19	109	16042	16175	0.09275211101003188
M1	cpdb	0	network_modules	134	TRUE	0.0010360093832625565	116	24	5	0.20833333333333334	0.04310344827586207	GO:0030832	GO:BP	regulation of actin filament length	16175	6917		0.6666666666666666	0.6764705882352942	116	16059	5	19	111	16040	16175	0.09189828594819269
M1	cpdb	0	network_modules	134	TRUE	0.0016245168312150153	127	24	5	0.20833333333333334	0.03937007874015748	GO:0030041	GO:BP	actin filament polymerization	16175	6662		0.696969696969697	0.7058823529411765	127	16048	5	19	122	16029	16175	0.0875613890073999
M1	cpdb	0	network_modules	134	TRUE	0.0017552687447024715	129	24	5	0.20833333333333334	0.03875968992248062	GO:1902904	GO:BP	negative regulation of supramolecular fiber organization	16175	22603		0.7272727272727273	0.7647058823529411	129	16046	5	19	124	16027	16175	0.08683179454546669
M1	cpdb	0	network_modules	134	TRUE	0.0017552687447024715	129	24	5	0.20833333333333334	0.03875968992248062	GO:0007266	GO:BP	Rho protein signal transduction	16175	2794		0.7272727272727273	0.7647058823529411	129	16046	5	19	124	16027	16175	0.08683179454546669
M1	cpdb	0	network_modules	134	TRUE	0.001816872060287757	23	17	3	0.17647058823529413	0.13043478260869565	REAC:R-HSA-9013422	REAC	RHOBTB1 GTPase cycle	10916	1862		0.6	0.6363636363636364	23	10893	3	14	20	10879	10916	0.15018023933619465
M1	cpdb	0	network_modules	134	TRUE	0.0024798009978851004	16	24	3	0.125	0.1875	GO:1901550	GO:BP	regulation of endothelial cell development	16175	21558		0.7878787878787878	0.8235294117647058	16	16159	3	21	13	16138	16175	0.15206964990454408
M1	cpdb	0	network_modules	134	TRUE	0.0024798009978851004	16	24	3	0.125	0.1875	GO:1903140	GO:BP	regulation of establishment of endothelial barrier	16175	22793		0.7878787878787878	0.8235294117647058	16	16159	3	21	13	16138	16175	0.15206964990454408
M1	cpdb	0	network_modules	134	TRUE	0.0026596514225807407	26	17	3	0.17647058823529413	0.11538461538461539	REAC:R-HSA-5223345	REAC	Miscellaneous transport and binding events	10916	1456		0.7	0.7272727272727273	26	10890	3	14	23	10876	10916	0.14104730351097974
M1	cpdb	0	network_modules	134	TRUE	0.00315795548890815	90	17	4	0.23529411764705882	0.044444444444444446	REAC:R-HSA-2682334	REAC	EPH-Ephrin signaling	10916	818		0.8	0.8181818181818182	90	10826	4	13	86	10813	10916	0.09916527894147638
M1	cpdb	0	network_modules	134	TRUE	0.0032968362412703106	2	24	2	0.08333333333333333	1	GO:1905205	GO:BP	positive regulation of connective tissue replacement	16175	24441		0.8484848484848485	0.8529411764705882	2	16173	2	22	0	16151	16175	0.28847872656338225
M1	cpdb	0	network_modules	134	TRUE	0.0040738423797992826	153	24	5	0.20833333333333334	0.032679738562091505	GO:0008154	GO:BP	actin polymerization or depolymerization	16175	3127		0.8787878787878788	0.8823529411764706	153	16022	5	19	148	16003	16175	0.079199924613218
M1	cpdb	0	network_modules	134	TRUE	0.0052323666896009	161	24	5	0.20833333333333334	0.031055900621118012	GO:0032271	GO:BP	regulation of protein polymerization	16175	7452		0.9090909090909091	0.9117647058823529	161	16014	5	19	156	15995	16175	0.07703437853205924
M1	cpdb	0	network_modules	134	TRUE	0.006637393977929351	35	17	3	0.17647058823529413	0.08571428571428572	REAC:R-HSA-9706574	REAC	RHOBTB GTPase Cycle	10916	1861		0.9	0.9090909090909091	35	10881	3	14	32	10867	10916	0.12104177569629349
M1	cpdb	0	network_modules	134	TRUE	0.007331217501827521	77	24	4	0.16666666666666666	0.05194805194805195	GO:0051492	GO:BP	regulation of stress fiber assembly	16175	13747		0.9393939393939394	0.9411764705882353	77	16098	4	20	73	16078	16175	0.09067393186170822
M1	cpdb	0	network_modules	134	TRUE	0.007864527029876016	37	17	3	0.17647058823529413	0.08108108108108109	REAC:R-HSA-9013407	REAC	RHOH GTPase cycle	10916	1869		1	1	37	10879	3	14	34	10865	10916	0.11761125331052884
M1	cpdb	0	network_modules	134	TRUE	0.008893134236368538	24	24	3	0.125	0.125	GO:0051016	GO:BP	barbed-end actin filament capping	16175	13441		0.9696969696969697	1	24	16151	3	21	21	16130	16175	0.12369977091201784
M1	cpdb	0	network_modules	134	TRUE	0.008893134236368538	24	24	3	0.125	0.125	GO:0051693	GO:BP	actin filament capping	16175	13896		0.9696969696969697	1	24	16151	3	21	21	16130	16175	0.12369977091201784
M1	cpdb	0	network_modules	136	TRUE	5.241761706206191e-16	28	29	9	0.3103448275862069	0.32142857142857145	GO:0034063	GO:BP	stress granule assembly	16175	8390		0	0.022727272727272728	28	16147	9	20	19	16127	16175	0.3146307483920139
M1	cpdb	0	network_modules	136	TRUE	1.4786579650336883e-14	279	29	14	0.4827586206896552	0.05017921146953405	GO:0006401	GO:BP	RNA catabolic process	16175	2162		0.023255813953488372	0.045454545454545456	279	15896	14	15	265	15881	16175	0.15152824561532022
M1	cpdb	0	network_modules	136	TRUE	3.9169284555093804e-14	299	29	14	0.4827586206896552	0.046822742474916385	GO:0141188	GO:BP	nucleic acid catabolic process	16175	20075		0.046511627906976744	0.06818181818181818	299	15876	14	15	285	15861	16175	0.14607583818422076
M1	cpdb	0	network_modules	136	TRUE	4.914593469617558e-14	226	29	13	0.4482758620689655	0.05752212389380531	GO:0006402	GO:BP	mRNA catabolic process	16175	2163		0.06976744186046512	0.09090909090909091	226	15949	13	16	213	15933	16175	0.1568134745569571
M1	cpdb	0	network_modules	136	TRUE	1.0149815784432958e-13	172	29	12	0.41379310344827586	0.06976744186046512	GO:0061013	GO:BP	regulation of mRNA catabolic process	16175	15136		0.09302325581395349	0.11363636363636363	172	16003	12	17	160	15986	16175	0.1665799350996485
M1	cpdb	0	network_modules	136	TRUE	1.2810324357704116e-12	290	29	13	0.4482758620689655	0.04482758620689655	GO:0006417	GO:BP	regulation of translation	16175	2174		0.11627906976744186	0.13636363636363635	290	15885	13	16	277	15869	16175	0.13744753151452715
M1	cpdb	0	network_modules	136	TRUE	2.2593938532594603e-12	156	29	11	0.3793103448275862	0.07051282051282051	GO:0043488	GO:BP	regulation of mRNA stability	16175	10733		0.13953488372093023	0.1590909090909091	156	16019	11	18	145	16001	16175	0.16030243701855437
M1	cpdb	0	network_modules	136	TRUE	4.843200200003762e-12	167	29	11	0.3793103448275862	0.0658682634730539	GO:0043487	GO:BP	regulation of RNA stability	16175	10732		0.16279069767441862	0.18181818181818182	167	16008	11	18	156	15990	16175	0.15470119145980932
M1	cpdb	0	network_modules	136	TRUE	7.059908959544748e-12	434	29	14	0.4827586206896552	0.03225806451612903	GO:0010608	GO:BP	post-transcriptional regulation of gene expression	16175	4255		0.18604651162790697	0.20454545454545456	434	15741	14	15	420	15726	16175	0.11957632121277181
M1	cpdb	0	network_modules	136	TRUE	9.570724091417801e-12	566	29	15	0.5172413793103449	0.026501766784452298	GO:0006412	GO:BP	translation	16175	2170		0.20930232558139536	0.22727272727272727	566	15609	15	14	551	15595	16175	0.11122092192690682
M1	cpdb	0	network_modules	136	TRUE	1.0948298231028152e-11	448	29	14	0.4827586206896552	0.03125	GO:0034655	GO:BP	nucleobase-containing compound catabolic process	16175	8711		0.23255813953488372	0.25	448	15727	14	15	434	15712	16175	0.11752195639289047
M1	cpdb	0	network_modules	136	TRUE	2.722612458066627e-11	273	29	12	0.41379310344827586	0.04395604395604396	GO:1903311	GO:BP	regulation of mRNA metabolic process	16175	22895		0.2558139534883721	0.2727272727272727	273	15902	12	17	261	15885	16175	0.1305874233456651
M1	cpdb	0	network_modules	136	TRUE	1.004167096689068e-10	97	29	9	0.3103448275862069	0.09278350515463918	GO:0061014	GO:BP	positive regulation of mRNA catabolic process	16175	15137		0.27906976744186046	0.29545454545454547	97	16078	9	20	88	16058	16175	0.16706261351050042
M1	cpdb	0	network_modules	136	TRUE	1.244807777912804e-10	6	29	5	0.1724137931034483	0.8333333333333334	GO:0062028	GO:BP	regulation of stress granule assembly	16175	15789		0.3023255813953488	0.3181818181818182	6	16169	5	24	1	16145	16175	0.37864326604326026
M1	cpdb	0	network_modules	136	TRUE	3.2154593447810655e-10	110	29	9	0.3103448275862069	0.08181818181818182	GO:0017148	GO:BP	negative regulation of translation	16175	5285		0.32558139534883723	0.3409090909090909	110	16065	9	20	101	16045	16175	0.15652944991903328
M1	cpdb	0	network_modules	136	TRUE	4.786900601022506e-10	590	29	14	0.4827586206896552	0.023728813559322035	GO:0016071	GO:BP	mRNA metabolic process	16175	5098		0.3488372093023256	0.36363636363636365	590	15585	14	15	576	15570	16175	0.10088842395407067
M1	cpdb	0	network_modules	136	TRUE	1.041203639278344e-9	125	29	9	0.3103448275862069	0.072	GO:1903313	GO:BP	positive regulation of mRNA metabolic process	16175	22897		0.37209302325581395	0.38636363636363635	125	16050	9	20	116	16030	16175	0.14645742662511843
M1	cpdb	0	network_modules	136	TRUE	5.040152581899758e-9	92	29	8	0.27586206896551724	0.08695652173913043	GO:0061157	GO:BP	mRNA destabilization	16175	15262		0.3953488372093023	0.4090909090909091	92	16083	8	21	84	16062	16175	0.15225703596751705
M1	cpdb	0	network_modules	136	TRUE	6.5588997365127975e-9	95	29	8	0.27586206896551724	0.08421052631578947	GO:0050779	GO:BP	RNA destabilization	16175	13253		0.4186046511627907	0.4318181818181818	95	16080	8	21	87	16059	16175	0.14974480011449998
M1	cpdb	0	network_modules	136	TRUE	9.525886667144987e-9	11	29	5	0.1724137931034483	0.45454545454545453	GO:0070934	GO:BP	CRD-mediated mRNA stabilization	16175	16378		0.4418604651162791	0.45454545454545453	11	16164	5	24	6	16140	16175	0.27918729874147213
M1	cpdb	0	network_modules	136	TRUE	1.3436476736597458e-8	4	29	4	0.13793103448275862	1	GO:0062029	GO:BP	positive regulation of stress granule assembly	16175	15790		0.46511627906976744	0.4772727272727273	4	16171	4	25	0	16146	16175	0.37110348452319386
M1	cpdb	0	network_modules	136	TRUE	3.6445067428432415e-7	343	29	10	0.3448275862068966	0.029154518950437316	GO:0140694	GO:BP	membraneless organelle assembly	16175	19860		0.4883720930232558	0.5	343	15832	10	19	333	15813	16175	0.09519933851311048
M1	cpdb	0	network_modules	136	TRUE	1.7770235125240744e-6	3	20	3	0.15	1	REAC:R-HSA-428359	REAC	Insulin-like Growth Factor-2 mRNA Binding Proteins (IGF2BPs/IMPs/VICKZs) bind RNA	10916	1212		NA	1	3	10913	3	17	0	10896	10916	0.3869965551919206
M1	cpdb	0	network_modules	136	TRUE	2.855968879974201e-6	67	29	6	0.20689655172413793	0.08955223880597014	GO:1902373	GO:BP	negative regulation of mRNA catabolic process	16175	22245		0.5116279069767442	0.5227272727272727	67	16108	6	23	61	16085	16175	0.13378973635356986
M1	cpdb	0	network_modules	136	TRUE	6.702757619277329e-6	77	29	6	0.20689655172413793	0.07792207792207792	GO:1902369	GO:BP	negative regulation of RNA catabolic process	16175	22241		0.5348837209302325	0.5454545454545454	77	16098	6	23	71	16075	16175	0.12445817059799763
M1	cpdb	0	network_modules	136	TRUE	8.845653803260243e-6	477	29	10	0.3448275862068966	0.020964360587002098	GO:0009896	GO:BP	positive regulation of catabolic process	16175	3756		0.5581395348837209	0.5681818181818182	477	15698	10	19	467	15679	16175	0.07899602982671258
M1	cpdb	0	network_modules	136	TRUE	1.1393508577829228e-5	84	29	6	0.20689655172413793	0.07142857142857142	GO:1903312	GO:BP	negative regulation of mRNA metabolic process	16175	22896		0.5813953488372093	0.5909090909090909	84	16091	6	23	78	16068	16175	0.11893037002209418
M1	cpdb	0	network_modules	136	TRUE	6.835039189153667e-5	113	29	6	0.20689655172413793	0.05309734513274336	GO:0000956	GO:BP	nuclear-transcribed mRNA catabolic process	16175	264		0.6046511627906976	0.6136363636363636	113	16062	6	23	107	16039	16175	0.10172022325568918
M1	cpdb	0	network_modules	136	TRUE	7.223680665649504e-5	595	29	10	0.3448275862068966	0.01680672268907563	GO:0051248	GO:BP	negative regulation of protein metabolic process	16175	13595		0.627906976744186	0.6363636363636364	595	15580	10	19	585	15561	16175	0.06935521730140233
M1	cpdb	0	network_modules	136	TRUE	8.859888032114452e-5	118	29	6	0.20689655172413793	0.05084745762711865	GO:0045727	GO:BP	positive regulation of translation	16175	11569		0.6511627906976745	0.6590909090909091	118	16057	6	23	112	16034	16175	0.09940336036037818
M1	cpdb	0	network_modules	136	TRUE	8.913629572890242e-5	58	29	5	0.1724137931034483	0.08620689655172414	GO:0048255	GO:BP	mRNA stabilization	16175	12610		0.6744186046511628	0.6818181818181818	58	16117	5	24	53	16093	16175	0.11970139798098922
M1	cpdb	0	network_modules	136	TRUE	1.8578800708957254e-4	67	29	5	0.1724137931034483	0.07462686567164178	GO:0043489	GO:BP	RNA stabilization	16175	10734		0.6976744186046512	0.7045454545454546	67	16108	5	24	62	16084	16175	0.11103590135174042
M1	cpdb	0	network_modules	136	TRUE	3.5529238581825777e-4	149	29	6	0.20689655172413793	0.040268456375838924	GO:0006403	GO:BP	RNA localization	16175	2164		0.7209302325581395	0.7272727272727273	149	16026	6	23	143	16003	16175	0.08769572036469266
M1	cpdb	0	network_modules	136	TRUE	5.304381480002108e-4	33	29	4	0.13793103448275862	0.12121212121212122	GO:2000765	GO:BP	regulation of cytoplasmic translation	16175	26025		0.7441860465116279	0.75	33	16142	4	25	29	16117	16175	0.12763370750262504
M1	cpdb	0	network_modules	136	TRUE	0.0018187927351900701	12	29	3	0.10344827586206896	0.25	GO:0006388	GO:BP	tRNA splicing, via endonucleolytic cleavage and ligation	16175	2152		0.7674418604651163	0.7954545454545454	12	16163	3	26	9	16137	16175	0.15986620675600594
M1	cpdb	0	network_modules	136	TRUE	0.0018187927351900701	12	29	3	0.10344827586206896	0.25	GO:1900152	GO:BP	negative regulation of nuclear-transcribed mRNA catabolic process, deadenylation-dependent decay	16175	20436		0.7674418604651163	0.7954545454545454	12	16163	3	26	9	16137	16175	0.15986620675600594
M1	cpdb	0	network_modules	136	TRUE	0.0023615803542509635	13	29	3	0.10344827586206896	0.23076923076923078	GO:0000394	GO:BP	RNA splicing, via endonucleolytic cleavage and ligation	16175	119		0.813953488372093	0.8181818181818182	13	16162	3	26	10	16136	16175	0.1535067763082632
M1	cpdb	0	network_modules	136	TRUE	0.002664300592324621	114	29	5	0.1724137931034483	0.043859649122807015	GO:0050658	GO:BP	RNA transport	16175	13198		0.8372093023255814	0.8636363636363636	114	16061	5	24	109	16037	16175	0.08377568796139666
M1	cpdb	0	network_modules	136	TRUE	0.002664300592324621	114	29	5	0.1724137931034483	0.043859649122807015	GO:0050657	GO:BP	nucleic acid transport	16175	13197		0.8372093023255814	0.8636363636363636	114	16061	5	24	109	16037	16175	0.08377568796139666
M1	cpdb	0	network_modules	136	TRUE	0.0029231857026973773	50	29	4	0.13793103448275862	0.08	GO:0035195	GO:BP	miRNA-mediated post-transcriptional gene silencing	16175	8884		0.8837209302325582	0.8863636363636364	50	16125	4	25	46	16100	16175	0.10294237720342161
M1	cpdb	0	network_modules	136	TRUE	0.003029533416397141	117	29	5	0.1724137931034483	0.042735042735042736	GO:0051236	GO:BP	establishment of RNA localization	16175	13586		0.9069767441860465	0.9090909090909091	117	16058	5	24	112	16034	16175	0.0826096327966114
M1	cpdb	0	network_modules	136	TRUE	0.003748007648819565	15	29	3	0.10344827586206896	0.2	GO:2000767	GO:BP	positive regulation of cytoplasmic translation	16175	26027		0.9302325581395349	0.9318181818181818	15	16160	3	26	12	16134	16175	0.14274371530670452
M1	cpdb	0	network_modules	136	TRUE	0.00497059582156992	57	29	4	0.13793103448275862	0.07017543859649122	GO:0000288	GO:BP	nuclear-transcribed mRNA catabolic process, deadenylation-dependent decay	16175	81		0.9534883720930233	0.9545454545454546	57	16118	4	25	53	16093	16175	0.09612579609155743
M1	cpdb	0	network_modules	136	TRUE	0.005458569555599512	79	10	3	0.3	0.0379746835443038	KEGG:03018	KEGG	RNA degradation	8484	211		NA	1	79	8405	3	7	76	8398	8484	0.10396847146276021
M1	cpdb	0	network_modules	136	TRUE	0.006976325003396741	62	29	4	0.13793103448275862	0.06451612903225806	GO:0035194	GO:BP	regulatory ncRNA-mediated post-transcriptional gene silencing	16175	8883		0.9767441860465116	0.9772727272727273	62	16113	4	25	58	16088	16175	0.09197058161762683
M1	cpdb	0	network_modules	136	TRUE	0.0095263559517346	67	29	4	0.13793103448275862	0.05970149253731343	GO:0016441	GO:BP	post-transcriptional gene silencing	16175	5222		1	1	67	16108	4	25	63	16083	16175	0.08828206634991098
M1	cpdb	0	network_modules	137	TRUE	6.553494266520432e-20	791	30	22	0.7333333333333333	0.02781289506953224	GO:0000122	GO:BP	negative regulation of transcription by RNA polymerase II	16175	48		0	0.034482758620689655	791	15384	22	8	769	15376	16175	0.13680201675114356
M1	cpdb	0	network_modules	137	TRUE	9.890762724661887e-19	59	27	12	0.4444444444444444	0.2033898305084746	REAC:R-HSA-8943724	REAC	Regulation of PTEN gene transcription	10916	1999		0	0.037037037037037035	59	10857	12	15	47	10842	10916	0.2981769817722256
M1	cpdb	0	network_modules	137	TRUE	1.2191495168411414e-16	529	30	18	0.6	0.034026465028355386	GO:0006325	GO:BP	chromatin organization	16175	2122		0.03571428571428571	0.06896551724137931	529	15646	18	12	511	15634	16175	0.1374882260859623
M1	cpdb	0	network_modules	137	TRUE	5.533722021277945e-15	19	30	8	0.26666666666666666	0.42105263157894735	GO:0042659	GO:BP	regulation of cell fate specification	16175	10274		0.07142857142857142	0.10344827586206896	19	16156	8	22	11	16134	16175	0.33411319856475696
M1	cpdb	0	network_modules	137	TRUE	2.20679900474528e-14	65	30	10	0.3333333333333333	0.15384615384615385	GO:0001708	GO:BP	cell fate specification	16175	400		0.10714285714285714	0.13793103448275862	65	16110	10	20	55	16090	16175	0.2243844074765845
M1	cpdb	0	network_modules	137	TRUE	3.254948221994548e-14	185	27	13	0.48148148148148145	0.07027027027027027	REAC:R-HSA-212165	REAC	Epigenetic regulation of gene expression	10916	852		0.038461538461538464	0.07407407407407407	185	10731	13	14	172	10717	10916	0.1792102493425284
M1	cpdb	0	network_modules	137	TRUE	4.8619147735648445e-14	138	27	12	0.4444444444444444	0.08695652173913043	REAC:R-HSA-6807070	REAC	PTEN Regulation	10916	1703		0.07692307692307693	0.1111111111111111	138	10778	12	15	126	10763	10916	0.19245441591197096
M1	cpdb	0	network_modules	137	TRUE	3.1046571570449167e-13	29	30	8	0.26666666666666666	0.27586206896551724	GO:0010453	GO:BP	regulation of cell fate commitment	16175	4149		0.14285714285714285	0.1724137931034483	29	16146	8	22	21	16124	16175	0.269894094831915
M1	cpdb	0	network_modules	137	TRUE	6.525478235169145e-13	454	30	15	0.5	0.03303964757709251	GO:0006338	GO:BP	chromatin remodeling	16175	2126		0.17857142857142858	0.20689655172413793	454	15721	15	15	439	15706	16175	0.12316783350114918
M1	cpdb	0	network_modules	137	TRUE	3.2904566950347403e-12	94	27	10	0.37037037037037035	0.10638297872340426	REAC:R-HSA-3214815	REAC	HDACs deacetylate histones	10916	1092		0.11538461538461539	0.14814814814814814	94	10822	10	17	84	10805	10916	0.19496347278735407
M1	cpdb	0	network_modules	137	TRUE	4.819379806524806e-12	271	27	13	0.48148148148148145	0.04797047970479705	REAC:R-HSA-3247509	REAC	Chromatin modifying enzymes	10916	355		0.15384615384615385	0.2222222222222222	271	10645	13	14	258	10631	10916	0.1461445621985448
M1	cpdb	0	network_modules	137	TRUE	4.819379806524806e-12	271	27	13	0.48148148148148145	0.04797047970479705	REAC:R-HSA-4839726	REAC	Chromatin organization	10916	356		0.15384615384615385	0.2222222222222222	271	10645	13	14	258	10631	10916	0.1461445621985448
M1	cpdb	0	network_modules	137	TRUE	4.223041701718982e-11	47	27	8	0.2962962962962963	0.1702127659574468	REAC:R-HSA-73762	REAC	RNA Polymerase I Transcription Initiation	10916	1885		0.23076923076923078	0.25925925925925924	47	10869	8	19	39	10850	10916	0.2220632496651712
M1	cpdb	0	network_modules	137	TRUE	6.788187089514945e-11	116	27	10	0.37037037037037035	0.08620689655172414	KEGG:03082	KEGG	ATP-dependent chromatin remodeling	8484	219		0	0.25	116	8368	10	17	106	8351	8484	0.17355402993792293
M1	cpdb	0	network_modules	137	TRUE	7.585940759065014e-11	253	27	12	0.4444444444444444	0.04743083003952569	REAC:R-HSA-1257604	REAC	PIP3 activates AKT signaling	10916	1679		0.2692307692307692	0.2962962962962963	253	10663	12	15	241	10648	10916	0.1394149526529553
M1	cpdb	0	network_modules	137	TRUE	1.5268034177142788e-10	30	27	7	0.25925925925925924	0.23333333333333334	REAC:R-HSA-6804758	REAC	Regulation of TP53 Activity through Acetylation	10916	2013		0.3076923076923077	0.3333333333333333	30	10886	7	20	23	10866	10916	0.24398471022632842
M1	cpdb	0	network_modules	137	TRUE	2.0490559848791016e-10	61	30	8	0.26666666666666666	0.13114754098360656	GO:2000736	GO:BP	regulation of stem cell differentiation	16175	25999		0.21428571428571427	0.2413793103448276	61	16114	8	22	53	16092	16175	0.18488526765120167
M1	cpdb	0	network_modules	137	TRUE	3.928983717014553e-10	150	27	10	0.37037037037037035	0.06666666666666667	REAC:R-HSA-9679191	REAC	Potential therapeutics for SARS	10916	1782		0.34615384615384615	0.37037037037037035	150	10766	10	17	140	10749	10916	0.15254407291503466
M1	cpdb	0	network_modules	137	TRUE	4.3487613042562364e-10	293	27	12	0.4444444444444444	0.040955631399317405	REAC:R-HSA-9006925	REAC	Intracellular signaling by second messengers	10916	1266		0.38461538461538464	0.4074074074074074	293	10623	12	15	281	10608	10916	0.12866420302100384
M1	cpdb	0	network_modules	137	TRUE	5.925958401577725e-10	104	27	9	0.3333333333333333	0.08653846153846154	REAC:R-HSA-5250913	REAC	Positive epigenetic regulation of rRNA expression	10916	1771		0.4230769230769231	0.4444444444444444	104	10812	9	18	95	10794	10916	0.16598416550509126
M1	cpdb	0	network_modules	137	TRUE	6.218681178806218e-10	175	30	10	0.3333333333333333	0.05714285714285714	GO:0045165	GO:BP	cell fate commitment	16175	11307		0.25	0.27586206896551724	175	16000	10	20	165	15980	16175	0.13438650958566883
M1	cpdb	0	network_modules	137	TRUE	2.1692060411608747e-9	75	27	8	0.2962962962962963	0.10666666666666667	REAC:R-HSA-427389	REAC	ERCC6 (CSB) and EHMT2 (G9a) positively regulate rRNA expression	10916	827		0.46153846153846156	0.48148148148148145	75	10841	8	19	67	10822	10916	0.17447094771766947
M1	cpdb	0	network_modules	137	TRUE	8.00375590898534e-9	152	30	9	0.3	0.05921052631578947	GO:0048863	GO:BP	stem cell differentiation	16175	13106		0.2857142857142857	0.3103448275862069	152	16023	9	21	143	16002	16175	0.1298350499576326
M1	cpdb	0	network_modules	137	TRUE	4.6327337896221355e-8	109	27	8	0.2962962962962963	0.07339449541284404	REAC:R-HSA-73854	REAC	RNA Polymerase I Promoter Clearance	10916	1881		0.5	0.5185185185185185	109	10807	8	19	101	10788	10916	0.14339154661064743
M1	cpdb	0	network_modules	137	TRUE	4.988300692473235e-8	110	27	8	0.2962962962962963	0.07272727272727272	REAC:R-HSA-73864	REAC	RNA Polymerase I Transcription	10916	1884		0.5384615384615384	0.5555555555555556	110	10806	8	19	102	10787	10916	0.14269921024604046
M1	cpdb	0	network_modules	137	TRUE	1.326819615451782e-7	134	30	8	0.26666666666666666	0.05970149253731343	GO:0045814	GO:BP	negative regulation of gene expression, epigenetic	16175	11636		0.32142857142857145	0.3448275862068966	134	16041	8	22	126	16019	16175	0.12287979973028917
M1	cpdb	0	network_modules	137	TRUE	4.5820445780990775e-6	209	30	8	0.26666666666666666	0.03827751196172249	GO:0040029	GO:BP	epigenetic regulation of gene expression	16175	9916		0.35714285714285715	0.3793103448275862	209	15966	8	22	201	15944	16175	0.09685298761710946
M1	cpdb	0	network_modules	137	TRUE	1.2023240758627407e-5	83	30	6	0.2	0.07228915662650602	GO:0030512	GO:BP	negative regulation of transforming growth factor beta receptor signaling pathway	16175	6828		0.39285714285714285	0.41379310344827586	83	16092	6	24	77	16068	16175	0.11756654441947141
M1	cpdb	0	network_modules	137	TRUE	1.25062716486915e-5	84	27	6	0.2222222222222222	0.07142857142857142	KEGG:03083	KEGG	Polycomb repressive complex	8484	220		0.3333333333333333	0.5	84	8400	6	21	78	8379	8484	0.12116816094711831
M1	cpdb	0	network_modules	137	TRUE	2.2250955261925513e-5	459	27	10	0.37037037037037035	0.02178649237472767	REAC:R-HSA-9679506	REAC	SARS-CoV Infections	10916	2112		0.5769230769230769	0.5925925925925926	459	10457	10	17	449	10440	10916	0.0814594548558763
M1	cpdb	0	network_modules	137	TRUE	2.835203486571138e-5	160	27	7	0.25925925925925924	0.04375	REAC:R-HSA-5633007	REAC	Regulation of TP53 Activity	10916	2012		0.6153846153846154	0.6296296296296297	160	10756	7	20	153	10736	10916	0.10135047885052394
M1	cpdb	0	network_modules	137	TRUE	4.474513438262143e-5	171	27	7	0.25925925925925924	0.04093567251461988	REAC:R-HSA-3108232	REAC	SUMO E3 ligases SUMOylate target proteins	10916	2163		0.6538461538461539	0.6666666666666666	171	10745	7	20	164	10725	10916	0.09768256471421428
M1	cpdb	0	network_modules	137	TRUE	5.66523597367948e-5	177	27	7	0.25925925925925924	0.03954802259887006	REAC:R-HSA-2990846	REAC	SUMOylation	10916	2167		0.6923076923076923	0.7037037037037037	177	10739	7	20	170	10719	10916	0.09582276634038076
M1	cpdb	0	network_modules	137	TRUE	6.787738029930203e-5	60	27	5	0.18518518518518517	0.08333333333333333	KEGG:04330	KEGG	Notch signaling pathway	8484	301		0.6666666666666666	0.75	60	8424	5	22	55	8402	8484	0.12009787177206101
M1	cpdb	0	network_modules	137	TRUE	1.2214744841612833e-4	23	30	4	0.13333333333333333	0.17391304347826086	GO:1902455	GO:BP	negative regulation of stem cell population maintenance	16175	22293		0.42857142857142855	0.4482758620689655	23	16152	4	26	19	16126	16175	0.15090064780848197
M1	cpdb	0	network_modules	137	TRUE	1.2862329512954886e-4	123	30	6	0.2	0.04878048780487805	GO:0017015	GO:BP	regulation of transforming growth factor beta receptor signaling pathway	16175	5276		0.4642857142857143	0.4827586206896552	123	16052	6	24	117	16028	16175	0.09546937067584005
M1	cpdb	0	network_modules	137	TRUE	1.4161623705402827e-4	125	30	6	0.2	0.048	GO:1903844	GO:BP	regulation of cellular response to transforming growth factor beta stimulus	16175	23323		0.5	0.5172413793103449	125	16050	6	24	119	16026	16175	0.09464756968467093
M1	cpdb	0	network_modules	137	TRUE	1.485072555059107e-4	126	30	6	0.2	0.047619047619047616	GO:0090101	GO:BP	negative regulation of transmembrane receptor protein serine/threonine kinase signaling pathway	16175	18019		0.5357142857142857	0.5517241379310345	126	16049	6	24	120	16025	16175	0.09424385960625135
M1	cpdb	0	network_modules	137	TRUE	1.6354439587875995e-4	217	30	7	0.23333333333333334	0.03225806451612903	GO:0090092	GO:BP	regulation of transmembrane receptor protein serine/threonine kinase signaling pathway	16175	18013		0.5714285714285714	0.5862068965517241	217	15958	7	23	210	15935	16175	0.08239990659246528
M1	cpdb	0	network_modules	137	TRUE	2.175292389991132e-4	70	27	5	0.18518518518518517	0.07142857142857142	REAC:R-HSA-3214841	REAC	PKMTs methylate histone lysines	10916	1691		0.7307692307692307	0.7407407407407407	70	10846	5	22	65	10824	10916	0.11152404103084475
M1	cpdb	0	network_modules	137	TRUE	2.506260568751861e-4	72	27	5	0.18518518518518517	0.06944444444444445	REAC:R-HSA-9710421	REAC	Defective pyroptosis	10916	702		0.7692307692307693	0.8148148148148148	72	10844	5	22	67	10822	10916	0.10986161894681157
M1	cpdb	0	network_modules	137	TRUE	2.506260568751861e-4	72	27	5	0.18518518518518517	0.06944444444444445	REAC:R-HSA-212300	REAC	PRC2 methylates histones and DNA	10916	1701		0.7692307692307693	0.8148148148148148	72	10844	5	22	67	10822	10916	0.10986161894681157
M1	cpdb	0	network_modules	137	TRUE	5.027557048828947e-4	256	30	7	0.23333333333333334	0.02734375	GO:0090287	GO:BP	regulation of cellular response to growth factor stimulus	16175	18171		0.6071428571428571	0.6206896551724138	256	15919	7	23	249	15896	16175	0.07512424807931489
M1	cpdb	0	network_modules	137	TRUE	6.72397841119651e-4	85	30	5	0.16666666666666666	0.058823529411764705	GO:0031507	GO:BP	heterochromatin formation	16175	7192		0.6428571428571429	0.6551724137931034	85	16090	5	25	80	16065	16175	0.09623504785477151
M1	cpdb	0	network_modules	137	TRUE	8.149652608770732e-4	275	30	7	0.23333333333333334	0.025454545454545455	GO:0141091	GO:BP	transforming growth factor beta receptor superfamily signaling pathway	16175	20020		0.6785714285714286	0.6896551724137931	275	15900	7	23	268	15877	16175	0.07213421703451846
M1	cpdb	0	network_modules	137	TRUE	0.0010713052463195525	176	30	6	0.2	0.03409090909090909	GO:0007179	GO:BP	transforming growth factor beta receptor signaling pathway	16175	2741		0.7142857142857143	0.7241379310344828	176	15999	6	24	170	15975	16175	0.07858114028926864
M1	cpdb	0	network_modules	137	TRUE	0.0011645210787397645	290	30	7	0.23333333333333334	0.02413793103448276	GO:0007178	GO:BP	cell surface receptor protein serine/threonine kinase signaling pathway	16175	2740		0.75	0.7586206896551724	290	15885	7	23	283	15862	16175	0.06997580699386358
M1	cpdb	0	network_modules	137	TRUE	0.0013649471227356635	41	30	4	0.13333333333333333	0.0975609756097561	GO:1902459	GO:BP	positive regulation of stem cell population maintenance	16175	22297		0.7857142857142857	0.7931034482758621	41	16134	4	26	37	16108	16175	0.11213105069464156
M1	cpdb	0	network_modules	137	TRUE	0.001439891598814063	99	30	5	0.16666666666666666	0.050505050505050504	GO:0019827	GO:BP	stem cell population maintenance	16175	6046		0.8214285714285714	0.8275862068965517	99	16076	5	25	94	16051	16175	0.0887317575375235
M1	cpdb	0	network_modules	137	TRUE	0.0014882570385560286	103	27	5	0.18518518518518517	0.04854368932038835	REAC:R-HSA-9645723	REAC	Diseases of programmed cell death	10916	771		0.8461538461538461	0.8518518518518519	103	10813	5	22	98	10791	10916	0.09052192497316054
M1	cpdb	0	network_modules	137	TRUE	0.0015137197394953226	100	30	5	0.16666666666666666	0.05	GO:0098727	GO:BP	maintenance of cell number	16175	18856		0.8571428571428571	0.8620689655172413	100	16075	5	25	95	16050	16175	0.08825573107792033
M1	cpdb	0	network_modules	137	TRUE	0.0016360647573008605	105	27	5	0.18518518518518517	0.047619047619047616	REAC:R-HSA-427413	REAC	NoRC negatively regulates rRNA expression	10916	1602		0.8846153846153846	0.8888888888888888	105	10811	5	22	100	10789	10916	0.08957048526443159
M1	cpdb	0	network_modules	137	TRUE	0.0018791334138776512	108	27	5	0.18518518518518517	0.046296296296296294	REAC:R-HSA-5250941	REAC	Negative epigenetic regulation of rRNA expression	10916	1566		0.9230769230769231	0.9259259259259259	108	10808	5	22	103	10786	10916	0.08819167699489855
M1	cpdb	0	network_modules	137	TRUE	0.002395294364866713	202	30	6	0.2	0.0297029702970297	GO:0071560	GO:BP	cellular response to transforming growth factor beta stimulus	16175	16762		0.8928571428571429	0.896551724137931	202	15973	6	24	196	15949	16175	0.07278553564814134
M1	cpdb	0	network_modules	137	TRUE	0.0028395071015788562	208	30	6	0.2	0.028846153846153848	GO:0071559	GO:BP	response to transforming growth factor beta	16175	16761		0.9285714285714286	0.9310344827586207	208	15967	6	24	202	15943	16175	0.07159961606404652
M1	cpdb	0	network_modules	137	TRUE	0.00491242857104793	519	30	8	0.26666666666666666	0.015414258188824663	GO:0070848	GO:BP	response to growth factor	16175	16340		0.9642857142857143	0.9655172413793104	519	15656	8	22	511	15634	16175	0.05737900310001685
M1	cpdb	0	network_modules	137	TRUE	0.005656565128534658	3	27	2	0.07407407407407407	0.6666666666666666	REAC:R-HSA-5339700	REAC	Signaling by TCF7L2 mutants	10916	2307		0.9615384615384616	0.9629629629629629	3	10913	2	25	1	10888	10916	0.22170252656645592
M1	cpdb	0	network_modules	137	TRUE	0.005663936857428923	76	27	4	0.14814814814814814	0.05263157894736842	KEGG:05220	KEGG	Chronic myeloid leukemia	8484	471		1	1	76	8408	4	23	72	8385	8484	0.08346984469189521
M1	cpdb	0	network_modules	137	TRUE	0.005993857187140468	59	30	4	0.13333333333333333	0.06779661016949153	GO:2000036	GO:BP	regulation of stem cell population maintenance	16175	25399		1	1	59	16116	4	26	55	16090	16175	0.09273068000597846
M1	cpdb	0	network_modules	137	TRUE	0.006323410332860527	359	27	7	0.25925925925925924	0.019498607242339833	REAC:R-HSA-3700989	REAC	Transcriptional Regulation by TP53	10916	2546		1	1	359	10557	7	20	352	10537	10916	0.06320568789732964
M1	cpdb	0	network_modules	138	TRUE	3.425944522806128e-23	153	27	16	0.5925925925925926	0.10457516339869281	GO:0008154	GO:BP	actin polymerization or depolymerization	16175	3127		0	0.017857142857142856	153	16022	16	11	137	16011	16175	0.2463376258206906
M1	cpdb	0	network_modules	138	TRUE	2.507866059270023e-22	35	25	12	0.48	0.34285714285714286	REAC:R-HSA-5663213	REAC	RHO GTPases Activate WASPs and WAVEs	10916	1852		0	0.05555555555555555	35	10881	12	13	23	10868	10916	0.4040747667173321
M1	cpdb	0	network_modules	138	TRUE	5.510345172729682e-20	632	27	20	0.7407407407407407	0.03164556962025317	GO:0030036	GO:BP	actin cytoskeleton organization	16175	6660		0.01818181818181818	0.03571428571428571	632	15543	20	7	612	15536	16175	0.14807187290150634
M1	cpdb	0	network_modules	138	TRUE	6.706183995461738e-20	407	27	18	0.6666666666666666	0.044226044226044224	GO:0007015	GO:BP	actin filament organization	16175	2624		0.03636363636363636	0.05357142857142857	407	15768	18	9	389	15759	16175	0.16748692772022197
M1	cpdb	0	network_modules	138	TRUE	5.341196991516514e-19	708	27	20	0.7407407407407407	0.02824858757062147	GO:0030029	GO:BP	actin filament-based process	16175	6653		0.05454545454545454	0.07142857142857142	708	15467	20	7	688	15460	16175	0.1393031367944181
M1	cpdb	0	network_modules	138	TRUE	7.933892591901822e-16	127	27	12	0.4444444444444444	0.09448818897637795	GO:0030041	GO:BP	actin filament polymerization	16175	6662		0.07272727272727272	0.08928571428571429	127	16048	12	15	115	16033	16175	0.2022698132657755
M1	cpdb	0	network_modules	138	TRUE	1.3623746140912155e-15	113	25	12	0.48	0.10619469026548672	REAC:R-HSA-9664417	REAC	Leishmania phagocytosis	10916	1312		0.058823529411764705	0.2222222222222222	113	10803	12	13	101	10790	10916	0.22231098646239955
M1	cpdb	0	network_modules	138	TRUE	1.3623746140912155e-15	113	25	12	0.48	0.10619469026548672	REAC:R-HSA-9664407	REAC	Parasite infection	10916	1716		0.058823529411764705	0.2222222222222222	113	10803	12	13	101	10790	10916	0.22231098646239955
M1	cpdb	0	network_modules	138	TRUE	1.3623746140912155e-15	113	25	12	0.48	0.10619469026548672	REAC:R-HSA-9664422	REAC	FCGR3A-mediated phagocytosis	10916	899		0.058823529411764705	0.2222222222222222	113	10803	12	13	101	10790	10916	0.22231098646239955
M1	cpdb	0	network_modules	138	TRUE	1.8899062905086286e-15	116	25	12	0.48	0.10344827586206896	REAC:R-HSA-2029482	REAC	Regulation of actin dynamics for phagocytic cup formation	10916	2020		0.23529411764705882	0.2777777777777778	116	10800	12	13	104	10787	10916	0.21931950194451488
M1	cpdb	0	network_modules	138	TRUE	3.7963110502768635e-15	748	27	18	0.6666666666666666	0.02406417112299465	GO:0097435	GO:BP	supramolecular fiber organization	16175	18657		0.09090909090909091	0.10714285714285714	748	15427	18	9	730	15418	16175	0.12079884325569971
M1	cpdb	0	network_modules	138	TRUE	1.949871786460607e-14	140	25	12	0.48	0.08571428571428572	REAC:R-HSA-2029480	REAC	Fcgamma receptor (FCGR) dependent phagocytosis	10916	939		0.29411764705882354	0.3333333333333333	140	10776	12	13	128	10763	10916	0.19892356852311943
M1	cpdb	0	network_modules	138	TRUE	6.943049057247858e-14	215	25	13	0.52	0.06046511627906977	REAC:R-HSA-9658195	REAC	Leishmania infection	10916	1310		0.35294117647058826	0.4444444444444444	215	10701	13	12	202	10689	10916	0.1725052582409317
M1	cpdb	0	network_modules	138	TRUE	6.943049057247858e-14	215	25	13	0.52	0.06046511627906977	REAC:R-HSA-9824443	REAC	Parasitic Infection Pathways	10916	1717		0.35294117647058826	0.4444444444444444	215	10701	13	12	202	10689	10916	0.1725052582409317
M1	cpdb	0	network_modules	138	TRUE	5.551991199912232e-13	184	25	12	0.48	0.06521739130434782	REAC:R-HSA-9013149	REAC	RAC1 GTPase cycle	10916	1836		0.47058823529411764	0.5	184	10732	12	13	172	10719	10916	0.17237189622165758
M1	cpdb	0	network_modules	138	TRUE	6.154414797669845e-13	197	22	12	0.5454545454545454	0.06091370558375635	KEGG:05130	KEGG	Pathogenic Escherichia coli infection	8484	427		0	0.14285714285714285	197	8287	12	10	185	8277	8484	0.17681094893065144
M1	cpdb	0	network_modules	138	TRUE	1.7437813720999555e-12	238	27	12	0.4444444444444444	0.05042016806722689	GO:0051258	GO:BP	protein polymerization	16175	13605		0.10909090909090909	0.125	238	15937	12	15	226	15922	16175	0.1459389082936873
M1	cpdb	0	network_modules	138	TRUE	1.1414835563591628e-11	318	25	13	0.52	0.040880503144654086	REAC:R-HSA-195258	REAC	RHO GTPase Effectors	10916	1846		0.5294117647058824	0.5555555555555556	318	10598	13	12	305	10586	10916	0.13984252401639177
M1	cpdb	0	network_modules	138	TRUE	1.7435788462395247e-11	651	27	15	0.5555555555555556	0.02304147465437788	GO:0000902	GO:BP	cell morphogenesis	16175	240		0.12727272727272726	0.14285714285714285	651	15524	15	12	636	15512	16175	0.1072115547218369
M1	cpdb	0	network_modules	138	TRUE	2.993958024182695e-11	215	27	11	0.4074074074074074	0.05116279069767442	GO:0110053	GO:BP	regulation of actin filament organization	16175	19377		0.14545454545454545	0.16071428571428573	215	15960	11	16	204	15944	16175	0.14071954152809985
M1	cpdb	0	network_modules	138	TRUE	3.371366792780579e-11	449	25	14	0.56	0.031180400890868598	REAC:R-HSA-9012999	REAC	RHO GTPase cycle	10916	1847		0.5882352941176471	0.6111111111111112	449	10467	14	11	435	10456	10916	0.12517627404583792
M1	cpdb	0	network_modules	138	TRUE	1.1310072302180881e-10	94	25	9	0.36	0.09574468085106383	REAC:R-HSA-4420097	REAC	VEGFA-VEGFR2 Pathway	10916	2634		0.6470588235294118	0.6666666666666666	94	10822	9	16	85	10806	10916	0.18220901469375428
M1	cpdb	0	network_modules	138	TRUE	2.882804267456295e-10	104	25	9	0.36	0.08653846153846154	REAC:R-HSA-194138	REAC	Signaling by VEGF	10916	2313		0.7058823529411765	0.7222222222222222	104	10812	9	16	95	10796	10916	0.17285588072948088
M1	cpdb	0	network_modules	138	TRUE	4.3229700174189593e-10	274	27	11	0.4074074074074074	0.040145985401459854	GO:0032956	GO:BP	regulation of actin cytoskeleton organization	16175	7940		0.16363636363636364	0.17857142857142858	274	15901	11	16	263	15885	16175	0.12372697618180385
M1	cpdb	0	network_modules	138	TRUE	7.634722679408244e-10	8	27	5	0.18518518518518517	0.625	GO:2000601	GO:BP	positive regulation of Arp2/3 complex-mediated actin nucleation	16175	25890		0.18181818181818182	0.19642857142857142	8	16167	5	22	3	16145	16175	0.3396658368382056
M1	cpdb	0	network_modules	138	TRUE	1.5518492072724157e-9	308	27	11	0.4074074074074074	0.03571428571428571	GO:0032970	GO:BP	regulation of actin filament-based process	16175	7953		0.2	0.21428571428571427	308	15867	11	16	297	15851	16175	0.1161943128686443
M1	cpdb	0	network_modules	138	TRUE	2.1977648201281047e-9	318	27	11	0.4074074074074074	0.03459119496855346	GO:1902903	GO:BP	regulation of supramolecular fiber organization	16175	22602		0.21818181818181817	0.23214285714285715	318	15857	11	16	307	15841	16175	0.1142067216884819
M1	cpdb	0	network_modules	138	TRUE	2.5295169410872352e-9	150	27	9	0.3333333333333333	0.06	GO:1902905	GO:BP	positive regulation of supramolecular fiber organization	16175	22604		0.23636363636363636	0.25	150	16025	9	18	141	16007	16175	0.13824430913239044
M1	cpdb	0	network_modules	138	TRUE	3.828874810241052e-9	157	27	9	0.3333333333333333	0.05732484076433121	GO:0051495	GO:BP	positive regulation of cytoskeleton organization	16175	13750		0.2545454545454545	0.26785714285714285	157	16018	9	18	148	16000	16175	0.13497631669642246
M1	cpdb	0	network_modules	138	TRUE	4.4785869561817314e-9	460	27	12	0.4444444444444444	0.02608695652173913	GO:0048858	GO:BP	cell projection morphogenesis	16175	13102		0.2727272727272727	0.2857142857142857	460	15715	12	15	448	15700	16175	0.10233631163448163
M1	cpdb	0	network_modules	138	TRUE	6.277244767619935e-9	11	27	5	0.18518518518518517	0.45454545454545453	GO:0051127	GO:BP	positive regulation of actin nucleation	16175	13511		0.2909090909090909	0.30357142857142855	11	16164	5	22	6	16142	16175	0.28940395892662013
M1	cpdb	0	network_modules	138	TRUE	1.3707860470689768e-8	113	27	8	0.2962962962962963	0.07079646017699115	GO:0008064	GO:BP	regulation of actin polymerization or depolymerization	16175	3113		0.3090909090909091	0.32142857142857145	113	16062	8	19	105	16043	16175	0.14203374035703553
M1	cpdb	0	network_modules	138	TRUE	1.6964811349160784e-8	116	27	8	0.2962962962962963	0.06896551724137931	GO:0030832	GO:BP	regulation of actin filament length	16175	6917		0.32727272727272727	0.3392857142857143	116	16059	8	19	108	16040	16175	0.1401082812473745
M1	cpdb	0	network_modules	138	TRUE	7.33644008107084e-8	440	27	11	0.4074074074074074	0.025	GO:0051493	GO:BP	regulation of cytoskeleton organization	16175	13748		0.34545454545454546	0.35714285714285715	440	15735	11	16	429	15719	16175	0.09557071567378606
M1	cpdb	0	network_modules	138	TRUE	1.0754849607294226e-7	456	27	11	0.4074074074074074	0.02412280701754386	GO:0120039	GO:BP	plasma membrane bounded cell projection morphogenesis	16175	19473		0.36363636363636365	0.375	456	15719	11	16	445	15703	16175	0.09368246155400363
M1	cpdb	0	network_modules	138	TRUE	4.054722838106418e-7	172	27	8	0.2962962962962963	0.046511627906976744	GO:0120032	GO:BP	regulation of plasma membrane bounded cell projection assembly	16175	19468		0.38181818181818183	0.39285714285714285	172	16003	8	19	164	15984	16175	0.11388204655627508
M1	cpdb	0	network_modules	138	TRUE	4.2468432917054606e-7	173	27	8	0.2962962962962963	0.046242774566473986	GO:0060491	GO:BP	regulation of cell projection assembly	16175	14685		0.4	0.4107142857142857	173	16002	8	19	165	15983	16175	0.11353140263019447
M1	cpdb	0	network_modules	138	TRUE	1.0771520954498838e-6	27	27	5	0.18518518518518517	0.18518518518518517	GO:0034315	GO:BP	regulation of Arp2/3 complex-mediated actin nucleation	16175	8569		0.41818181818181815	0.42857142857142855	27	16148	5	22	22	16126	16175	0.18382278736502172
M1	cpdb	0	network_modules	138	TRUE	1.784649603218882e-6	441	27	10	0.37037037037037035	0.022675736961451247	GO:0048812	GO:BP	neuron projection morphogenesis	16175	13058		0.43636363636363634	0.44642857142857145	441	15734	10	17	431	15717	16175	0.08615020978629657
M1	cpdb	0	network_modules	138	TRUE	2.1560926615437527e-6	136	22	7	0.3181818181818182	0.051470588235294115	KEGG:05135	KEGG	Yersinia infection	8484	432		0.16666666666666666	0.2857142857142857	136	8348	7	15	129	8333	8484	0.12267039863361753
M1	cpdb	0	network_modules	138	TRUE	2.9402851068750265e-6	73	27	6	0.2222222222222222	0.0821917808219178	GO:0097581	GO:BP	lamellipodium organization	16175	18706		0.45454545454545453	0.4642857142857143	73	16102	6	21	67	16081	16175	0.13281343577766017
M1	cpdb	0	network_modules	138	TRUE	3.0396607461806522e-6	466	27	10	0.37037037037037035	0.02145922746781116	GO:0120035	GO:BP	regulation of plasma membrane bounded cell projection organization	16175	19471		0.4727272727272727	0.48214285714285715	466	15709	10	17	456	15692	16175	0.08349629141820504
M1	cpdb	0	network_modules	138	TRUE	3.1451991896465596e-6	33	27	5	0.18518518518518517	0.15151515151515152	GO:0051125	GO:BP	regulation of actin nucleation	16175	13509		0.4909090909090909	0.5	33	16142	5	22	28	16120	16175	0.16596871271493147
M1	cpdb	0	network_modules	138	TRUE	3.5646114476910513e-6	227	22	8	0.36363636363636365	0.03524229074889868	KEGG:04810	KEGG	Regulation of actin cytoskeleton	8484	365		0.3333333333333333	0.42857142857142855	227	8257	8	14	219	8243	8484	0.1064453753116092
M1	cpdb	0	network_modules	138	TRUE	3.6832917105377877e-6	34	27	5	0.18518518518518517	0.14705882352941177	GO:0010591	GO:BP	regulation of lamellipodium assembly	16175	4239		0.509090909090909	0.5178571428571429	34	16141	5	22	29	16119	16175	0.16345964870227397
M1	cpdb	0	network_modules	138	TRUE	4.042681975568157e-6	480	27	10	0.37037037037037035	0.020833333333333332	GO:0031344	GO:BP	regulation of cell projection organization	16175	7135		0.5272727272727272	0.5357142857142857	480	15695	10	17	470	15678	16175	0.08209774201569747
M1	cpdb	0	network_modules	138	TRUE	4.495183326517852e-6	35	25	5	0.2	0.14285714285714285	REAC:R-HSA-202433	REAC	Generation of second messenger molecules	10916	1044		0.7647058823529411	0.7777777777777778	35	10881	5	20	30	10861	10916	0.16677940120471824
M1	cpdb	0	network_modules	138	TRUE	6.333632344228321e-6	93	22	6	0.2727272727272727	0.06451612903225806	KEGG:04520	KEGG	Adherens junction	8484	316		0.5	0.5714285714285714	93	8391	6	16	87	8375	8484	0.12818567641937756
M1	cpdb	0	network_modules	138	TRUE	7.801048052410657e-6	514	27	10	0.37037037037037035	0.019455252918287938	GO:0030031	GO:BP	cell projection assembly	16175	6655		0.5454545454545454	0.5535714285714286	514	15661	10	17	504	15644	16175	0.07893205141597195
M1	cpdb	0	network_modules	138	TRUE	9.732911133926437e-6	257	27	8	0.2962962962962963	0.0311284046692607	GO:0032535	GO:BP	regulation of cellular component size	16175	7629		0.5636363636363636	0.5714285714285714	257	15918	8	19	249	15899	16175	0.09169501738946219
M1	cpdb	0	network_modules	138	TRUE	1.1158546964395035e-5	42	27	5	0.18518518518518517	0.11904761904761904	GO:0030838	GO:BP	positive regulation of actin filament polymerization	16175	6923		0.5818181818181818	0.6071428571428571	42	16133	5	22	37	16111	16175	0.14670949194142402
M1	cpdb	0	network_modules	138	TRUE	1.1158546964395035e-5	42	27	5	0.18518518518518517	0.11904761904761904	GO:0034314	GO:BP	Arp2/3 complex-mediated actin nucleation	16175	8568		0.5818181818181818	0.6071428571428571	42	16133	5	22	37	16111	16175	0.14670949194142402
M1	cpdb	0	network_modules	138	TRUE	1.661678790942042e-5	97	27	6	0.2222222222222222	0.061855670103092786	GO:0030833	GO:BP	regulation of actin filament polymerization	16175	6918		0.6181818181818182	0.625	97	16078	6	21	91	16057	16175	0.114517394141244
M1	cpdb	0	network_modules	138	TRUE	1.7899249361227236e-5	46	27	5	0.18518518518518517	0.10869565217391304	GO:1902743	GO:BP	regulation of lamellipodium organization	16175	22469		0.6363636363636364	0.6428571428571429	46	16129	5	22	41	16107	16175	0.1400132665338203
M1	cpdb	0	network_modules	138	TRUE	1.896598835171677e-5	94	25	6	0.24	0.06382978723404255	REAC:R-HSA-9013423	REAC	RAC3 GTPase cycle	10916	1838		0.8235294117647058	0.8333333333333334	94	10822	6	19	88	10803	10916	0.11998425805422452
M1	cpdb	0	network_modules	138	TRUE	2.017525015524175e-5	412	27	9	0.3333333333333333	0.021844660194174758	GO:0044089	GO:BP	positive regulation of cellular component biogenesis	16175	10911		0.6545454545454545	0.6607142857142857	412	15763	9	18	403	15745	16175	0.07990146430970312
M1	cpdb	0	network_modules	138	TRUE	2.383259001752918e-5	420	27	9	0.3333333333333333	0.02142857142857143	GO:0010638	GO:BP	positive regulation of organelle organization	16175	4284		0.6727272727272727	0.6785714285714286	420	15755	9	18	411	15737	16175	0.07902976048630315
M1	cpdb	0	network_modules	138	TRUE	2.7541313573759897e-5	50	27	5	0.18518518518518517	0.1	GO:0045010	GO:BP	actin nucleation	16175	11227		0.6909090909090909	0.6964285714285714	50	16125	5	22	45	16103	16175	0.13413050555715533
M1	cpdb	0	network_modules	138	TRUE	3.634444609902855e-5	793	27	11	0.4074074074074074	0.013871374527112233	GO:0044087	GO:BP	regulation of cellular component biogenesis	16175	10909		0.7090909090909091	0.7142857142857143	793	15382	11	16	782	15366	16175	0.06786860789757039
M1	cpdb	0	network_modules	138	TRUE	5.3996391586593286e-5	57	27	5	0.18518518518518517	0.08771929824561403	GO:0030032	GO:BP	lamellipodium assembly	16175	6656		0.7272727272727273	0.7321428571428571	57	16118	5	22	52	16096	16175	0.1253533787163621
M1	cpdb	0	network_modules	138	TRUE	6.665061549450269e-5	329	27	8	0.2962962962962963	0.0243161094224924	GO:0090066	GO:BP	regulation of anatomical structure size	16175	17992		0.7454545454545455	0.75	329	15846	8	19	321	15827	16175	0.07993726500884032
M1	cpdb	0	network_modules	138	TRUE	1.125536365185628e-4	503	27	9	0.3333333333333333	0.017892644135188866	GO:0120031	GO:BP	plasma membrane bounded cell projection assembly	16175	19467		0.7636363636363637	0.7678571428571429	503	15672	9	18	494	15654	16175	0.07119782613367828
M1	cpdb	0	network_modules	138	TRUE	1.1747791029392317e-4	684	27	10	0.37037037037037035	0.014619883040935672	GO:0031175	GO:BP	neuron projection development	16175	7086		0.7818181818181819	0.7857142857142857	684	15491	10	17	674	15474	16175	0.06666265472529875
M1	cpdb	0	network_modules	138	TRUE	2.179916366703436e-4	252	27	7	0.25925925925925924	0.027777777777777776	GO:0031346	GO:BP	positive regulation of cell projection organization	16175	7137		0.8	0.8035714285714286	252	15923	7	20	245	15903	16175	0.08045876556190788
M1	cpdb	0	network_modules	138	TRUE	2.504809270250176e-4	96	22	5	0.22727272727272727	0.052083333333333336	KEGG:04666	KEGG	Fc gamma R-mediated phagocytosis	8484	341		0.6666666666666666	0.7142857142857143	96	8388	5	17	91	8371	8484	0.10410667392933792
M1	cpdb	0	network_modules	138	TRUE	2.8346811066618156e-4	79	27	5	0.18518518518518517	0.06329113924050633	GO:0032273	GO:BP	positive regulation of protein polymerization	16175	7454		0.8181818181818182	0.8214285714285714	79	16096	5	22	74	16074	16175	0.10575299156280804
M1	cpdb	0	network_modules	138	TRUE	3.1844855906513385e-4	761	27	10	0.37037037037037035	0.013140604467805518	GO:0048666	GO:BP	neuron development	16175	12924		0.8363636363636363	0.8392857142857143	761	15414	10	17	751	15397	16175	0.06243852940053025
M1	cpdb	0	network_modules	138	TRUE	3.446122550205087e-4	161	27	6	0.2222222222222222	0.037267080745341616	GO:0032271	GO:BP	regulation of protein polymerization	16175	7452		0.8545454545454545	0.8571428571428571	161	16014	6	21	155	15993	16175	0.08743588016966668
M1	cpdb	0	network_modules	138	TRUE	3.4602168589109816e-4	507	25	9	0.36	0.01775147928994083	REAC:R-HSA-9006934	REAC	Signaling by Receptor Tyrosine Kinases	10916	2302		0.8823529411764706	0.8888888888888888	507	10409	9	16	498	10393	10916	0.0713845275200125
M1	cpdb	0	network_modules	138	TRUE	3.711564716675957e-4	155	25	6	0.24	0.03870967741935484	REAC:R-HSA-9013148	REAC	CDC42 GTPase cycle	10916	269		0.9411764705882353	0.9444444444444444	155	10761	6	19	149	10742	10916	0.09143925810274438
M1	cpdb	0	network_modules	138	TRUE	5.268520470114019e-4	173	27	6	0.2222222222222222	0.03468208092485549	GO:0031334	GO:BP	positive regulation of protein-containing complex assembly	16175	7125		0.8727272727272727	0.875	173	16002	6	21	167	15981	16175	0.08408563721006931
M1	cpdb	0	network_modules	138	TRUE	5.462878151589395e-4	36	27	4	0.14814814814814814	0.1111111111111111	GO:0016601	GO:BP	Rac protein signal transduction	16175	5257		0.8909090909090909	0.8928571428571429	36	16139	4	23	32	16116	16175	0.12661917381391077
M1	cpdb	0	network_modules	138	TRUE	6.78730328217653e-4	94	27	5	0.18518518518518517	0.05319148936170213	GO:0120034	GO:BP	positive regulation of plasma membrane bounded cell projection assembly	16175	19470		0.9090909090909091	0.9107142857142857	94	16081	5	22	89	16059	16175	0.0964950933371314
M1	cpdb	0	network_modules	138	TRUE	0.0018512128816373487	346	27	7	0.25925925925925924	0.02023121387283237	GO:0043254	GO:BP	regulation of protein-containing complex assembly	16175	10588		0.9272727272727272	0.9285714285714286	346	15829	7	20	339	15809	16175	0.06722618117398899
M1	cpdb	0	network_modules	138	TRUE	0.002005119871031656	249	22	6	0.2727272727272727	0.024096385542168676	KEGG:05132	KEGG	Salmonella infection	8484	429		0.8333333333333334	0.8571428571428571	249	8235	6	16	243	8219	8484	0.07352333026739005
M1	cpdb	0	network_modules	138	TRUE	0.0023166433769196727	120	25	5	0.2	0.041666666666666664	REAC:R-HSA-202403	REAC	TCR signaling	10916	2422		1	1	120	10796	5	20	115	10776	10916	0.0868471144826054
M1	cpdb	0	network_modules	138	TRUE	0.003396209775935267	379	27	7	0.25925925925925924	0.018469656992084433	GO:0048667	GO:BP	cell morphogenesis involved in neuron differentiation	16175	12925		0.9454545454545454	0.9464285714285714	379	15796	7	20	372	15776	16175	0.0637483681166991
M1	cpdb	0	network_modules	138	TRUE	0.004091724760236707	135	27	5	0.18518518518518517	0.037037037037037035	GO:0051017	GO:BP	actin filament bundle assembly	16175	13442		0.9636363636363636	0.9642857142857143	135	16040	5	22	130	16018	16175	0.07948326820084388
M1	cpdb	0	network_modules	138	TRUE	0.004558964695890622	138	27	5	0.18518518518518517	0.036231884057971016	GO:0061572	GO:BP	actin filament bundle organization	16175	15565		0.9818181818181818	0.9821428571428571	138	16037	5	22	133	16015	16175	0.0785394654157899
M1	cpdb	0	network_modules	138	TRUE	0.006169238979555305	19	27	3	0.1111111111111111	0.15789473684210525	GO:0097320	GO:BP	plasma membrane tubulation	16175	18595		1	1	19	16156	3	24	16	16132	16175	0.13123957709566395
M1	cpdb	0	network_modules	138	TRUE	0.006922195987537854	98	22	4	0.18181818181818182	0.04081632653061224	KEGG:05231	KEGG	Choline metabolism in cancer	8484	479		1	1	98	8386	4	18	94	8368	8484	0.0812485417659704
M1	cpdb	0	network_modules	139	TRUE	3.0770668324765135e-18	11	26	8	0.3076923076923077	0.7272727272727273	GO:0001867	GO:BP	complement activation, lectin pathway	16175	504		0	0.023809523809523808	11	16164	8	18	3	16146	16175	0.47254490094839663
M1	cpdb	0	network_modules	139	TRUE	1.0060960444928797e-17	7	21	7	0.3333333333333333	1	REAC:R-HSA-166662	REAC	Lectin pathway of complement activation	10916	1309		0	0.01694915254237288	7	10909	7	14	0	10895	10916	0.5769796807433613
M1	cpdb	0	network_modules	139	TRUE	1.5089540557811244e-13	56	26	9	0.34615384615384615	0.16071428571428573	GO:0006956	GO:BP	complement activation	16175	2587		0.024390243902439025	0.047619047619047616	56	16119	9	17	47	16102	16175	0.23409853055181595
M1	cpdb	0	network_modules	139	TRUE	1.0774475109112153e-12	9	26	6	0.23076923076923078	0.6666666666666666	GO:1903028	GO:BP	positive regulation of opsonization	16175	22710		0.04878048780487805	0.07142857142857142	9	16166	6	20	3	16146	16175	0.39171040005985697
M1	cpdb	0	network_modules	139	TRUE	5.913400803137035e-12	11	26	6	0.23076923076923078	0.5454545454545454	GO:1903027	GO:BP	regulation of opsonization	16175	22709		0.07317073170731707	0.09523809523809523	11	16164	6	20	5	16144	16175	0.35414699254434573
M1	cpdb	0	network_modules	139	TRUE	6.379053637281364e-11	15	26	6	0.23076923076923078	0.4	GO:0008228	GO:BP	opsonization	16175	3147		0.0975609756097561	0.11904761904761904	15	16160	6	20	9	16140	16175	0.30298490481237667
M1	cpdb	0	network_modules	139	TRUE	8.955076689273158e-11	68	21	8	0.38095238095238093	0.11764705882352941	REAC:R-HSA-166786	REAC	Creation of C4 and C2 activators	10916	413		0.017241379310344827	0.03389830508474576	68	10848	8	13	60	10835	10916	0.20909353478873344
M1	cpdb	0	network_modules	139	TRUE	2.2649303971015564e-10	76	21	8	0.38095238095238093	0.10526315789473684	REAC:R-HSA-166663	REAC	Initial triggering of complement	10916	1200		0.034482758620689655	0.05084745762711865	76	10840	8	13	68	10827	10916	0.1974686937755949
M1	cpdb	0	network_modules	139	TRUE	4.441903425615012e-10	72	14	7	0.5	0.09722222222222222	KEGG:05218	KEGG	Melanoma	8484	469		0	0.08333333333333333	72	8412	7	7	65	8405	8484	0.21784243731097147
M1	cpdb	0	network_modules	139	TRUE	4.913960357348722e-10	20	26	6	0.23076923076923078	0.3	GO:0006910	GO:BP	phagocytosis, recognition	16175	2560		0.12195121951219512	0.14285714285714285	20	16155	6	20	14	16135	16175	0.26208027508678794
M1	cpdb	0	network_modules	139	TRUE	3.2031180307105722e-9	4	21	4	0.19047619047619047	1	REAC:R-HSA-2855086	REAC	Ficolins bind to repetitive carbohydrate structures on the target cell surface	10916	942		0.05172413793103448	0.06779661016949153	4	10912	4	17	0	10895	10916	0.43609568240433466
M1	cpdb	0	network_modules	139	TRUE	5.109274447607802e-9	111	21	8	0.38095238095238093	0.07207207207207207	REAC:R-HSA-166658	REAC	Complement cascade	10916	390		0.06896551724137931	0.0847457627118644	111	10805	8	13	103	10792	10916	0.16225812673038084
M1	cpdb	0	network_modules	139	TRUE	6.568255529522739e-9	61	26	7	0.2692307692307692	0.11475409836065574	GO:0008543	GO:BP	fibroblast growth factor receptor signaling pathway	16175	3191		0.14634146341463414	0.16666666666666666	61	16114	7	19	54	16095	16175	0.1737760211678548
M1	cpdb	0	network_modules	139	TRUE	9.88101188798817e-9	14	21	5	0.23809523809523808	0.35714285714285715	REAC:R-HSA-2033519	REAC	Activated point mutants of FGFR2	10916	69		0.08620689655172414	0.11864406779661017	14	10902	5	16	9	10886	10916	0.2905008925076168
M1	cpdb	0	network_modules	139	TRUE	9.88101188798817e-9	14	21	5	0.23809523809523808	0.35714285714285715	REAC:R-HSA-5654221	REAC	Phospholipase C-mediated cascade; FGFR2	10916	1745		0.08620689655172414	0.11864406779661017	14	10902	5	16	9	10886	10916	0.2905008925076168
M1	cpdb	0	network_modules	139	TRUE	2.150589230674638e-8	16	21	5	0.23809523809523808	0.3125	REAC:R-HSA-190241	REAC	FGFR2 ligand binding and activation	10916	906		0.1206896551724138	0.15254237288135594	16	10900	5	16	11	10884	10916	0.27155337346747044
M1	cpdb	0	network_modules	139	TRUE	2.150589230674638e-8	16	21	5	0.23809523809523808	0.3125	REAC:R-HSA-5654699	REAC	SHC-mediated cascade:FGFR2	10916	2134		0.1206896551724138	0.15254237288135594	16	10900	5	16	11	10884	10916	0.27155337346747044
M1	cpdb	0	network_modules	139	TRUE	4.208154639744775e-8	18	21	5	0.23809523809523808	0.2777777777777778	REAC:R-HSA-5654695	REAC	PI-3K cascade:FGFR2	10916	1668		0.15517241379310345	0.1694915254237288	18	10898	5	16	13	10882	10916	0.25584821590693674
M1	cpdb	0	network_modules	139	TRUE	4.283940499987918e-8	79	26	7	0.2692307692307692	0.08860759493670886	GO:0044344	GO:BP	cellular response to fibroblast growth factor stimulus	16175	10963		0.17073170731707318	0.19047619047619047	79	16096	7	19	72	16077	16175	0.1521456337761183
M1	cpdb	0	network_modules	139	TRUE	5.128233083495294e-8	81	26	7	0.2692307692307692	0.08641975308641975	GO:0071774	GO:BP	response to fibroblast growth factor	16175	16903		0.1951219512195122	0.21428571428571427	81	16094	7	19	74	16075	16175	0.15019460227626671
M1	cpdb	0	network_modules	139	TRUE	5.6428928080893955e-8	224	26	9	0.34615384615384615	0.04017857142857143	GO:0006959	GO:BP	humoral immune response	16175	2590		0.21951219512195122	0.23809523809523808	224	15951	9	17	215	15934	16175	0.11409785141475623
M1	cpdb	0	network_modules	139	TRUE	5.704084090434231e-8	19	21	5	0.23809523809523808	0.2631578947368421	REAC:R-HSA-5654700	REAC	FRS-mediated FGFR2 signaling	10916	928		0.1724137931034483	0.1864406779661017	19	10897	5	16	14	10881	10916	0.24893930676543213
M1	cpdb	0	network_modules	139	TRUE	7.267386422926671e-8	147	14	7	0.5	0.047619047619047616	KEGG:05224	KEGG	Breast cancer	8484	475		0.09090909090909091	0.16666666666666666	147	8337	7	7	140	8330	8484	0.15038781540796958
M1	cpdb	0	network_modules	139	TRUE	7.622594135567265e-8	148	14	7	0.5	0.0472972972972973	KEGG:05226	KEGG	Gastric cancer	8484	477		0.18181818181818182	0.25	148	8336	7	7	141	8329	8484	0.14985127426188297
M1	cpdb	0	network_modules	139	TRUE	1.6425835938996668e-7	23	21	5	0.23809523809523808	0.21739130434782608	REAC:R-HSA-5654696	REAC	Downstream signaling of activated FGFR2	10916	793		0.1896551724137931	0.2033898305084746	23	10893	5	16	18	10877	10916	0.22594994870933782
M1	cpdb	0	network_modules	139	TRUE	4.0108395325497193e-7	9	21	4	0.19047619047619047	0.4444444444444444	REAC:R-HSA-190239	REAC	FGFR3 ligand binding and activation	10916	910		0.20689655172413793	0.3050847457627119	9	10907	4	17	5	10890	10916	0.2900964503272823
M1	cpdb	0	network_modules	139	TRUE	4.0108395325497193e-7	9	21	4	0.19047619047619047	0.4444444444444444	REAC:R-HSA-1839130	REAC	Signaling by activated point mutants of FGFR3	10916	2317		0.20689655172413793	0.3050847457627119	9	10907	4	17	5	10890	10916	0.2900964503272823
M1	cpdb	0	network_modules	139	TRUE	4.0108395325497193e-7	9	21	4	0.19047619047619047	0.4444444444444444	REAC:R-HSA-5654227	REAC	Phospholipase C-mediated cascade; FGFR3	10916	1746		0.20689655172413793	0.3050847457627119	9	10907	4	17	5	10890	10916	0.2900964503272823
M1	cpdb	0	network_modules	139	TRUE	4.0108395325497193e-7	9	21	4	0.19047619047619047	0.4444444444444444	REAC:R-HSA-190375	REAC	FGFR2c ligand binding and activation	10916	909		0.20689655172413793	0.3050847457627119	9	10907	4	17	5	10890	10916	0.2900964503272823
M1	cpdb	0	network_modules	139	TRUE	4.0108395325497193e-7	9	21	4	0.19047619047619047	0.4444444444444444	REAC:R-HSA-2033514	REAC	FGFR3 mutant receptor activation	10916	911		0.20689655172413793	0.3050847457627119	9	10907	4	17	5	10890	10916	0.2900964503272823
M1	cpdb	0	network_modules	139	TRUE	4.0108395325497193e-7	9	21	4	0.19047619047619047	0.4444444444444444	REAC:R-HSA-190372	REAC	FGFR3c ligand binding and activation	10916	913		0.20689655172413793	0.3050847457627119	9	10907	4	17	5	10890	10916	0.2900964503272823
M1	cpdb	0	network_modules	139	TRUE	4.768293457044268e-7	28	21	5	0.23809523809523808	0.17857142857142858	REAC:R-HSA-5654727	REAC	Negative regulation of FGFR2 signaling	10916	1569		0.3103448275862069	0.3220338983050847	28	10888	5	16	23	10872	10916	0.2044339776340523
M1	cpdb	0	network_modules	139	TRUE	4.856244814884853e-7	111	26	7	0.2692307692307692	0.06306306306306306	GO:0008037	GO:BP	cell recognition	16175	3099		0.24390243902439024	0.2619047619047619	111	16064	7	19	104	16045	16175	0.12752085480792516
M1	cpdb	0	network_modules	139	TRUE	5.48060668385465e-7	59	26	6	0.23076923076923078	0.1016949152542373	GO:0050766	GO:BP	positive regulation of phagocytosis	16175	13240		0.2682926829268293	0.2857142857142857	59	16116	6	20	53	16096	16175	0.1511687425112614
M1	cpdb	0	network_modules	139	TRUE	5.754640056353284e-7	29	21	5	0.23809523809523808	0.1724137931034483	REAC:R-HSA-1839126	REAC	FGFR2 mutant receptor activation	10916	907		0.3275862068965517	0.3389830508474576	29	10887	5	16	24	10871	10916	0.2008094237516726
M1	cpdb	0	network_modules	139	TRUE	8.804164291682519e-7	210	14	7	0.5	0.03333333333333333	KEGG:04015	KEGG	Rap1 signaling pathway	8484	248		0.2727272727272727	0.3333333333333333	210	8274	7	7	203	8267	8484	0.1243584872516241
M1	cpdb	0	network_modules	139	TRUE	9.099561615046763e-7	211	14	7	0.5	0.03317535545023697	KEGG:05207	KEGG	Chemical carcinogenesis - receptor activation	8484	459		0.36363636363636365	0.4166666666666667	211	8273	7	7	204	8266	8484	0.12404017520891963
M1	cpdb	0	network_modules	139	TRUE	1.0478408113140293e-6	11	21	4	0.19047619047619047	0.36363636363636365	REAC:R-HSA-5654704	REAC	SHC-mediated cascade:FGFR3	10916	2135		0.3448275862068966	0.3559322033898305	11	10905	4	17	7	10888	10916	0.2621726511353661
M1	cpdb	0	network_modules	139	TRUE	1.2035978354601236e-6	67	26	6	0.23076923076923078	0.08955223880597014	GO:0002752	GO:BP	cell surface pattern recognition receptor signaling pathway	16175	1263		0.2926829268292683	0.30952380952380953	67	16108	6	20	61	16088	16175	0.14158317693286882
M1	cpdb	0	network_modules	139	TRUE	1.5108077451254198e-6	227	14	7	0.5	0.030837004405286344	KEGG:04810	KEGG	Regulation of actin cytoskeleton	8484	365		0.45454545454545453	0.5	227	8257	7	7	220	8250	8484	0.11922951885785878
M1	cpdb	0	network_modules	139	TRUE	1.569801943970576e-6	12	21	4	0.19047619047619047	0.3333333333333333	REAC:R-HSA-190322	REAC	FGFR4 ligand binding and activation	10916	914		0.3620689655172414	0.3728813559322034	12	10904	4	17	8	10887	10916	0.25090134258013275
M1	cpdb	0	network_modules	139	TRUE	1.8112432451447183e-6	36	21	5	0.23809523809523808	0.1388888888888889	REAC:R-HSA-109704	REAC	PI3K Cascade	10916	1671		0.3793103448275862	0.3898305084745763	36	10880	5	16	31	10864	10916	0.1797988903305315
M1	cpdb	0	network_modules	139	TRUE	1.920138545053778e-6	235	14	7	0.5	0.029787234042553193	KEGG:04014	KEGG	Ras signaling pathway	8484	247		0.5454545454545454	0.5833333333333334	235	8249	7	7	228	8242	8484	0.11700571427944931
M1	cpdb	0	network_modules	139	TRUE	2.091687365567537e-6	37	21	5	0.23809523809523808	0.13513513513513514	REAC:R-HSA-5655253	REAC	Signaling by FGFR2 in disease	10916	2248		0.39655172413793105	0.4067796610169492	37	10879	5	16	32	10863	10916	0.17729148475059908
M1	cpdb	0	network_modules	139	TRUE	2.2646650952583986e-6	13	21	4	0.19047619047619047	0.3076923076923077	REAC:R-HSA-5654228	REAC	Phospholipase C-mediated cascade; FGFR4	10916	1747		0.41379310344827586	0.4406779661016949	13	10903	4	17	9	10886	10916	0.24095265289158788
M1	cpdb	0	network_modules	139	TRUE	2.2646650952583986e-6	13	21	4	0.19047619047619047	0.3076923076923077	REAC:R-HSA-5654710	REAC	PI-3K cascade:FGFR3	10916	1669		0.41379310344827586	0.4406779661016949	13	10903	4	17	9	10886	10916	0.24095265289158788
M1	cpdb	0	network_modules	139	TRUE	2.756059238677477e-6	39	21	5	0.23809523809523808	0.1282051282051282	REAC:R-HSA-112399	REAC	IRS-mediated signalling	10916	1164		0.4482758620689655	0.4576271186440678	39	10877	5	16	34	10861	10916	0.17256678414907148
M1	cpdb	0	network_modules	139	TRUE	3.026617087778749e-6	251	14	7	0.5	0.027888446215139442	KEGG:04020	KEGG	Calcium signaling pathway	8484	250		0.6363636363636364	0.6666666666666666	251	8233	7	7	244	8226	8484	0.11287249420994752
M1	cpdb	0	network_modules	139	TRUE	3.16657872860657e-6	14	21	4	0.19047619047619047	0.2857142857142857	REAC:R-HSA-5654706	REAC	FRS-mediated FGFR3 signaling	10916	929		0.46551724137931033	0.4745762711864407	14	10902	4	17	10	10885	10916	0.23208605732703347
M1	cpdb	0	network_modules	139	TRUE	3.856332679112677e-6	81	26	6	0.23076923076923078	0.07407407407407407	GO:0050764	GO:BP	regulation of phagocytosis	16175	13238		0.3170731707317073	0.3333333333333333	81	16094	6	20	75	16074	16175	0.12833157532481274
M1	cpdb	0	network_modules	139	TRUE	4.3126788485672585e-6	15	21	4	0.19047619047619047	0.26666666666666666	REAC:R-HSA-5654719	REAC	SHC-mediated cascade:FGFR4	10916	2136		0.4827586206896552	0.4915254237288136	15	10901	4	17	11	10884	10916	0.22411814508086372
M1	cpdb	0	network_modules	139	TRUE	4.585290515633626e-6	43	21	5	0.23809523809523808	0.11627906976744186	REAC:R-HSA-2428924	REAC	IGF1R signaling cascade	10916	1142		0.5	0.5254237288135594	43	10873	5	16	38	10857	10916	0.16411793683731565
M1	cpdb	0	network_modules	139	TRUE	4.585290515633626e-6	43	21	5	0.23809523809523808	0.11627906976744186	REAC:R-HSA-2428928	REAC	IRS-related events triggered by IGF1R	10916	1165		0.5	0.5254237288135594	43	10873	5	16	38	10857	10916	0.16411793683731565
M1	cpdb	0	network_modules	139	TRUE	5.166816219400867e-6	44	21	5	0.23809523809523808	0.11363636363636363	REAC:R-HSA-2404192	REAC	Signaling by Type 1 Insulin-like Growth Factor 1 Receptor (IGF1R)	10916	2312		0.5344827586206896	0.5423728813559322	44	10872	5	16	39	10856	10916	0.16218622618045406
M1	cpdb	0	network_modules	139	TRUE	5.174773738506289e-6	85	26	6	0.23076923076923078	0.07058823529411765	GO:0002220	GO:BP	innate immune response activating cell surface receptor signaling pathway	16175	754		0.34146341463414637	0.35714285714285715	85	16090	6	20	79	16070	16175	0.1251539523519772
M1	cpdb	0	network_modules	139	TRUE	5.805553097997886e-6	45	21	5	0.23809523809523808	0.1111111111111111	REAC:R-HSA-74751	REAC	Insulin receptor signalling cascade	10916	1211		0.5517241379310345	0.559322033898305	45	10871	5	16	40	10855	10916	0.16031863834051743
M1	cpdb	0	network_modules	139	TRUE	6.14134327329577e-6	531	26	10	0.38461538461538464	0.018832391713747645	GO:0032103	GO:BP	positive regulation of response to external stimulus	16175	7367		0.36585365853658536	0.38095238095238093	531	15644	10	16	521	15628	16175	0.0792166917126829
M1	cpdb	0	network_modules	139	TRUE	7.500805342168413e-6	17	21	4	0.19047619047619047	0.23529411764705882	REAC:R-HSA-5655332	REAC	Signaling by FGFR3 in disease	10916	2251		0.5689655172413793	0.5932203389830508	17	10899	4	17	13	10882	10916	0.2103376649462788
M1	cpdb	0	network_modules	139	TRUE	7.500805342168413e-6	17	21	4	0.19047619047619047	0.23529411764705882	REAC:R-HSA-5654720	REAC	PI-3K cascade:FGFR4	10916	1670		0.5689655172413793	0.5932203389830508	17	10899	4	17	13	10882	10916	0.2103376649462788
M1	cpdb	0	network_modules	139	TRUE	7.75830777238441e-6	4	21	3	0.14285714285714285	0.75	REAC:R-HSA-190371	REAC	FGFR3b ligand binding and activation	10916	912		0.603448275862069	0.6101694915254238	4	10912	3	18	1	10894	10916	0.3268616193220557
M1	cpdb	0	network_modules	139	TRUE	9.631869283817229e-6	18	21	4	0.19047619047619047	0.2222222222222222	REAC:R-HSA-5654708	REAC	Downstream signaling of activated FGFR3	10916	794		0.6206896551724138	0.6440677966101694	18	10898	4	17	14	10881	10916	0.20432172011637328
M1	cpdb	0	network_modules	139	TRUE	9.631869283817229e-6	18	21	4	0.19047619047619047	0.2222222222222222	REAC:R-HSA-5654712	REAC	FRS-mediated FGFR4 signaling	10916	930		0.6206896551724138	0.6440677966101694	18	10898	4	17	14	10881	10916	0.20432172011637328
M1	cpdb	0	network_modules	139	TRUE	1.0549759832687987e-5	301	14	7	0.5	0.023255813953488372	KEGG:04010	KEGG	MAPK signaling pathway	8484	243		0.7272727272727273	0.75	301	8183	7	7	294	8176	8484	0.102091415216372
M1	cpdb	0	network_modules	139	TRUE	1.7908025262945627e-5	56	21	5	0.23809523809523808	0.08928571428571429	REAC:R-HSA-1226099	REAC	Signaling by FGFR in disease	10916	2240		0.6551724137931034	0.6610169491525424	56	10860	5	16	51	10844	10916	0.14316656216553408
M1	cpdb	0	network_modules	139	TRUE	2.0461444381733738e-05	4	26	3	0.11538461538461539	0.75	GO:0043654	GO:BP	recognition of apoptotic cell	16175	10834		0.3902439024390244	0.40476190476190477	4	16171	3	23	1	16148	16175	0.2938162617423233
M1	cpdb	0	network_modules	139	TRUE	2.2910586988732763e-5	22	21	4	0.19047619047619047	0.18181818181818182	REAC:R-HSA-5654716	REAC	Downstream signaling of activated FGFR4	10916	795		0.6724137931034483	0.6779661016949152	22	10894	4	17	18	10877	10916	0.18449116021832385
M1	cpdb	0	network_modules	139	TRUE	2.7699287752804952e-5	23	21	4	0.19047619047619047	0.17391304347826086	REAC:R-HSA-5654732	REAC	Negative regulation of FGFR3 signaling	10916	1570		0.6896551724137931	0.6949152542372882	23	10893	4	17	19	10876	10916	0.18035648437469576
M1	cpdb	0	network_modules	139	TRUE	3.3141765530908365e-5	356	14	7	0.5	0.019662921348314606	KEGG:04151	KEGG	PI3K-Akt signaling pathway	8484	285		0.8181818181818182	0.8333333333333334	356	8128	7	7	349	8121	8484	0.09287701787349018
M1	cpdb	0	network_modules	139	TRUE	3.539639120645687e-5	64	21	5	0.23809523809523808	0.078125	REAC:R-HSA-5654738	REAC	Signaling by FGFR2	10916	2244		0.7068965517241379	0.711864406779661	64	10852	5	16	59	10836	10916	0.13354796424773305
M1	cpdb	0	network_modules	139	TRUE	3.829911157088939e-5	65	21	5	0.23809523809523808	0.07692307692307693	REAC:R-HSA-2219530	REAC	Constitutive Signaling by Aberrant PI3K in Cancer	10916	401		0.7241379310344828	0.7288135593220338	65	10851	5	16	60	10835	10916	0.13247052020436842
M1	cpdb	0	network_modules	139	TRUE	4.190138918116709e-5	475	26	9	0.34615384615384615	0.018947368421052633	GO:0002253	GO:BP	activation of immune response	16175	785		0.4146341463414634	0.42857142857142855	475	15700	9	17	466	15683	16175	0.07528866677454905
M1	cpdb	0	network_modules	139	TRUE	5.068778435154295e-5	124	26	6	0.23076923076923078	0.04838709677419355	GO:0045807	GO:BP	positive regulation of endocytosis	16175	11631		0.43902439024390244	0.4523809523809524	124	16051	6	20	118	16031	16175	0.10263649689263035
M1	cpdb	0	network_modules	139	TRUE	5.352129889208409e-5	339	26	8	0.3076923076923077	0.02359882005899705	GO:0002833	GO:BP	positive regulation of response to biotic stimulus	16175	1343		0.4634146341463415	0.47619047619047616	339	15836	8	18	331	15818	16175	0.08031835449390048
M1	cpdb	0	network_modules	139	TRUE	5.462477105970423e-5	27	21	4	0.19047619047619047	0.14814814814814814	REAC:R-HSA-5654733	REAC	Negative regulation of FGFR4 signaling	10916	1571		0.7413793103448276	0.7457627118644068	27	10889	4	17	23	10872	10916	0.16616819185483825
M1	cpdb	0	network_modules	139	TRUE	6.89658616648413e-5	73	21	5	0.23809523809523808	0.0684931506849315	REAC:R-HSA-74752	REAC	Signaling by Insulin receptor	10916	2260		0.7586206896551724	0.7627118644067796	73	10843	5	16	68	10827	10916	0.12465261807265644
M1	cpdb	0	network_modules	139	TRUE	8.451570137942398e-5	76	21	5	0.23809523809523808	0.06578947368421052	REAC:R-HSA-190236	REAC	Signaling by FGFR	10916	2239		0.7758620689655172	0.7796610169491526	76	10840	5	16	71	10824	10916	0.12203939335377828
M1	cpdb	0	network_modules	139	TRUE	1.1123014206002465e-4	32	21	4	0.19047619047619047	0.125	REAC:R-HSA-5654741	REAC	Signaling by FGFR3	10916	2249		0.7931034482758621	0.7966101694915254	32	10884	4	17	28	10867	10916	0.15229832562815024
M1	cpdb	0	network_modules	139	TRUE	1.1217462402284907e-4	721	26	10	0.38461538461538464	0.013869625520110958	GO:0045087	GO:BP	innate immune response	16175	11270		0.4878048780487805	0.5	721	15454	10	16	711	15438	16175	0.06611509218669759
M1	cpdb	0	network_modules	139	TRUE	1.1819147772650552e-4	536	26	9	0.34615384615384615	0.016791044776119403	GO:0002252	GO:BP	immune effector process	16175	784		0.5121951219512195	0.5238095238095238	536	15639	9	17	527	15622	16175	0.07016785468274597
M1	cpdb	0	network_modules	139	TRUE	1.6135278730790086e-4	35	21	4	0.19047619047619047	0.11428571428571428	REAC:R-HSA-5654743	REAC	Signaling by FGFR4	10916	2252		0.8103448275862069	0.8135593220338984	35	10881	4	17	31	10864	10916	0.14543169975716894
M1	cpdb	0	network_modules	139	TRUE	2.205944013397169e-4	92	21	5	0.23809523809523808	0.05434782608695652	REAC:R-HSA-6811558	REAC	PI5P, PP2A and IER3 Regulate PI3K/AKT Signaling	10916	1677		0.8275862068965517	0.847457627118644	92	10824	5	16	87	10808	10916	0.11029880511088
M1	cpdb	0	network_modules	139	TRUE	2.205944013397169e-4	92	21	5	0.23809523809523808	0.05434782608695652	REAC:R-HSA-2219528	REAC	PI3K/AKT Signaling in Cancer	10916	1674		0.8275862068965517	0.847457627118644	92	10824	5	16	87	10808	10916	0.11029880511088
M1	cpdb	0	network_modules	139	TRUE	2.701861335114806e-4	276	26	7	0.2692307692307692	0.025362318840579712	GO:0002697	GO:BP	regulation of immune effector process	16175	1215		0.5365853658536586	0.5476190476190477	276	15899	7	19	269	15880	16175	0.0781281679783978
M1	cpdb	0	network_modules	139	TRUE	2.9387730804838596e-4	423	26	8	0.3076923076923077	0.018912529550827423	GO:0031349	GO:BP	positive regulation of defense response	16175	7140		0.5609756097560976	0.5714285714285714	423	15752	8	18	415	15734	16175	0.07078830474629272
M1	cpdb	0	network_modules	139	TRUE	3.1726929367907207e-4	11	21	3	0.14285714285714285	0.2727272727272727	REAC:R-HSA-5654219	REAC	Phospholipase C-mediated cascade: FGFR1	10916	1744		0.8620689655172413	0.864406779661017	11	10905	3	18	8	10887	10916	0.19628089464160198
M1	cpdb	0	network_modules	139	TRUE	3.1808723190321695e-4	99	21	5	0.23809523809523808	0.050505050505050504	REAC:R-HSA-199418	REAC	Negative regulation of the PI3K/AKT network	10916	1580		0.8793103448275862	0.8813559322033898	99	10817	5	16	94	10801	10916	0.10606529367759841
M1	cpdb	0	network_modules	139	TRUE	3.4192349859413825e-4	42	21	4	0.19047619047619047	0.09523809523809523	REAC:R-HSA-5654736	REAC	Signaling by FGFR1	10916	2241		0.896551724137931	0.8983050847457628	42	10874	4	17	38	10857	10916	0.13234834326962486
M1	cpdb	0	network_modules	139	TRUE	4.48078395309985e-4	627	26	9	0.34615384615384615	0.014354066985645933	GO:0050778	GO:BP	positive regulation of immune response	16175	13252		0.5853658536585366	0.5952380952380952	627	15548	9	17	618	15531	16175	0.06389653383341447
M1	cpdb	0	network_modules	139	TRUE	4.7906734414360436e-4	451	26	8	0.3076923076923077	0.017738359201773836	GO:0002831	GO:BP	regulation of response to biotic stimulus	16175	1341		0.6097560975609756	0.6190476190476191	451	15724	8	18	443	15706	16175	0.06819479631597704
M1	cpdb	0	network_modules	139	TRUE	5.258624023472347e-4	86	14	4	0.2857142857142857	0.046511627906976744	KEGG:04610	KEGG	Complement and coagulation cascades	8484	320		0.9090909090909091	1	86	8398	4	10	82	8388	8484	0.1118483698332246
M1	cpdb	0	network_modules	139	TRUE	5.258624023472347e-4	86	14	4	0.2857142857142857	0.046511627906976744	KEGG:05150	KEGG	Staphylococcus aureus infection	8484	439		0.9090909090909091	1	86	8398	4	10	82	8388	8484	0.1118483698332246
M1	cpdb	0	network_modules	139	TRUE	5.45672578679351e-4	185	26	6	0.23076923076923078	0.032432432432432434	GO:0006909	GO:BP	phagocytosis	16175	2559		0.6341463414634146	0.6428571428571429	185	15990	6	20	179	15970	16175	0.08276556935352623
M1	cpdb	0	network_modules	139	TRUE	5.485737953394275e-4	13	21	3	0.14285714285714285	0.23076923076923078	REAC:R-HSA-5654688	REAC	SHC-mediated cascade:FGFR1	10916	2133		0.9137931034482759	0.9322033898305084	13	10903	3	18	10	10885	10916	0.18033549359669784
M1	cpdb	0	network_modules	139	TRUE	5.485737953394275e-4	13	21	3	0.14285714285714285	0.23076923076923078	REAC:R-HSA-190242	REAC	FGFR1 ligand binding and activation	10916	900		0.9137931034482759	0.9322033898305084	13	10903	3	18	10	10885	10916	0.18033549359669784
M1	cpdb	0	network_modules	139	TRUE	6.788519666460457e-4	192	26	6	0.23076923076923078	0.03125	GO:0002699	GO:BP	positive regulation of immune effector process	16175	1217		0.6585365853658537	0.6666666666666666	192	15983	6	20	186	15963	16175	0.08110026626881178
M1	cpdb	0	network_modules	139	TRUE	8.705733528521941e-4	15	21	3	0.14285714285714285	0.2	REAC:R-HSA-5654689	REAC	PI-3K cascade:FGFR1	10916	1667		0.9482758620689655	0.9491525423728814	15	10901	3	18	12	10883	10916	0.1676814643799777
M1	cpdb	0	network_modules	139	TRUE	0.0010701495720102417	16	21	3	0.14285714285714285	0.1875	REAC:R-HSA-5654693	REAC	FRS-mediated FGFR1 signaling	10916	927		0.9655172413793104	0.9661016949152542	16	10900	3	18	13	10882	10916	0.16225919808324704
M1	cpdb	0	network_modules	139	TRUE	0.0010789620050681928	502	26	8	0.3076923076923077	0.01593625498007968	GO:0071363	GO:BP	cellular response to growth factor stimulus	16175	16615		0.6829268292682927	0.6904761904761905	502	15673	8	18	494	15655	16175	0.06401349002265046
M1	cpdb	0	network_modules	139	TRUE	0.001215646201967063	510	26	8	0.3076923076923077	0.01568627450980392	GO:0007169	GO:BP	cell surface receptor protein tyrosine kinase signaling pathway	16175	2733		0.7073170731707317	0.7142857142857143	510	15665	8	18	502	15647	16175	0.0634120864147359
M1	cpdb	0	network_modules	139	TRUE	0.001386906105957553	519	26	8	0.3076923076923077	0.015414258188824663	GO:0070848	GO:BP	response to growth factor	16175	16340		0.7317073170731707	0.7380952380952381	519	15656	8	18	511	15638	16175	0.06275124428071424
M1	cpdb	0	network_modules	139	TRUE	0.0015467149387951536	221	26	6	0.23076923076923078	0.027149321266968326	GO:0030100	GO:BP	regulation of endocytosis	16175	6678		0.7560975609756098	0.7619047619047619	221	15954	6	20	215	15934	16175	0.07504113295481218
M1	cpdb	0	network_modules	139	TRUE	0.0018080931777246674	227	26	6	0.23076923076923078	0.02643171806167401	GO:0002221	GO:BP	pattern recognition receptor signaling pathway	16175	755		0.7804878048780488	0.7857142857142857	227	15948	6	20	221	15928	16175	0.07393015390826456
M1	cpdb	0	network_modules	139	TRUE	0.0021486848670878643	756	26	9	0.34615384615384615	0.011904761904761904	GO:0050776	GO:BP	regulation of immune response	16175	13250		0.8048780487804879	0.8095238095238095	756	15419	9	17	747	15402	16175	0.0569171011398863
M1	cpdb	0	network_modules	139	TRUE	0.002686574149202369	243	26	6	0.23076923076923078	0.024691358024691357	GO:0002758	GO:BP	innate immune response-activating signaling pathway	16175	1269		0.8292682926829268	0.8333333333333334	243	15932	6	20	237	15912	16175	0.071164386087777
M1	cpdb	0	network_modules	139	TRUE	0.002814183851497351	781	26	9	0.34615384615384615	0.011523687580025609	GO:0030334	GO:BP	regulation of cell migration	16175	6780		0.8536585365853658	0.8571428571428571	781	15394	9	17	772	15377	16175	0.05575487689430545
M1	cpdb	0	network_modules	139	TRUE	0.0029211387049777457	22	21	3	0.14285714285714285	0.13636363636363635	REAC:R-HSA-5654687	REAC	Downstream signaling of activated FGFR1	10916	792		0.9827586206896551	0.9830508474576272	22	10894	3	18	19	10876	10916	0.13787513538282495
M1	cpdb	0	network_modules	139	TRUE	0.003784983763611242	409	26	7	0.2692307692307692	0.017114914425427872	GO:0060627	GO:BP	regulation of vesicle-mediated transport	16175	14803		0.8780487804878049	0.8809523809523809	409	15766	7	19	402	15747	16175	0.06234869340537516
M1	cpdb	0	network_modules	139	TRUE	0.004246970096869142	263	26	6	0.23076923076923078	0.022813688212927757	GO:0002218	GO:BP	activation of innate immune response	16175	753		0.9024390243902439	0.9047619047619048	263	15912	6	20	257	15892	16175	0.06805570866809754
M1	cpdb	0	network_modules	139	TRUE	0.004436910840072295	265	26	6	0.23076923076923078	0.022641509433962263	GO:0002429	GO:BP	immune response-activating cell surface receptor signaling pathway	16175	952		0.926829268292683	0.9285714285714286	265	15910	6	20	259	15890	16175	0.06776358670407016
M1	cpdb	0	network_modules	139	TRUE	0.00487808005922128	19	26	3	0.11538461538461539	0.15789473684210525	GO:0046597	GO:BP	negative regulation of viral entry into host cell	16175	12247		0.9512195121951219	0.9523809523809523	19	16156	3	23	16	16133	16175	0.13378838606206206
M1	cpdb	0	network_modules	139	TRUE	0.004907439070020555	26	21	3	0.14285714285714285	0.11538461538461539	REAC:R-HSA-5654726	REAC	Negative regulation of FGFR1 signaling	10916	1568		1	1	26	10890	3	18	23	10872	10916	0.12651993704673264
M1	cpdb	0	network_modules	139	TRUE	0.007024021019869835	287	26	6	0.23076923076923078	0.020905923344947737	GO:0002768	GO:BP	immune response-regulating cell surface receptor signaling pathway	16175	1279		0.975609756097561	0.9761904761904762	287	15888	6	20	281	15868	16175	0.06474627479214323
M1	cpdb	0	network_modules	139	TRUE	0.007775007092139323	654	26	8	0.3076923076923077	0.012232415902140673	GO:0031347	GO:BP	regulation of defense response	16175	7138		1	1	654	15521	8	18	646	15503	16175	0.05444307426674232
M1	cpdb	0	network_modules	140	TRUE	7.678425897554828e-18	24	23	9	0.391304347826087	0.375	GO:0042744	GO:BP	hydrogen peroxide catabolic process	16175	10337		0	0.14285714285714285	24	16151	9	14	15	16137	16175	0.3821681451239193
M1	cpdb	0	network_modules	140	TRUE	3.2629229381696605e-15	43	23	9	0.391304347826087	0.20930232558139536	GO:0042743	GO:BP	hydrogen peroxide metabolic process	16175	10336		0.16666666666666666	0.2857142857142857	43	16132	9	14	34	16118	16175	0.28482023315248833
M1	cpdb	0	network_modules	140	TRUE	1.104700403856956e-14	13	23	7	0.30434782608695654	0.5384615384615384	GO:0015671	GO:BP	oxygen transport	16175	4800		0.3333333333333333	0.42857142857142855	13	16162	7	16	6	16146	16175	0.4042012448744006
M1	cpdb	0	network_modules	140	TRUE	2.0398595434447792e-13	18	23	7	0.30434782608695654	0.3888888888888889	GO:0015669	GO:BP	gas transport	16175	4798		0.5	0.5714285714285714	18	16157	7	16	11	16141	16175	0.3432082848941042
M1	cpdb	0	network_modules	140	TRUE	1.0495305914503937e-11	13	23	6	0.2608695652173913	0.46153846153846156	GO:0015670	GO:BP	carbon dioxide transport	16175	4799		0.6666666666666666	0.7142857142857143	13	16162	6	17	7	16145	16175	0.34630532067763964
M1	cpdb	0	network_modules	140	TRUE	2.604192713835036e-11	175	23	10	0.43478260869565216	0.05714285714285714	GO:0072593	GO:BP	reactive oxygen species metabolic process	16175	17457		0.8333333333333334	0.8571428571428571	175	16000	10	13	165	15987	16175	0.15464805042579222
M1	cpdb	0	network_modules	140	TRUE	1.1302927770882121e-10	18	23	6	0.2608695652173913	0.3333333333333333	GO:0019755	GO:BP	one-carbon compound transport	16175	6037		1	1	18	16157	6	17	12	16140	16175	0.2939985978231436
M1	cpdb	0	network_modules	140	TRUE	8.734510314481114e-5	9	17	3	0.17647058823529413	0.3333333333333333	REAC:R-HSA-1247673	REAC	Erythrocytes take up oxygen and release carbon dioxide	10916	856		0	0.3333333333333333	9	10907	3	14	6	10893	10916	0.24169033691262573
M1	cpdb	0	network_modules	140	TRUE	2.9624631491657015e-4	13	17	3	0.17647058823529413	0.23076923076923078	REAC:R-HSA-1237044	REAC	Erythrocytes take up carbon dioxide and release oxygen	10916	855		0.5	1	13	10903	3	14	10	10889	10916	0.20071579064829034
M1	cpdb	0	network_modules	140	TRUE	2.9624631491657015e-4	13	17	3	0.17647058823529413	0.23076923076923078	REAC:R-HSA-1480926	REAC	O2/CO2 exchange in erythrocytes	10916	1633		0.5	1	13	10903	3	14	10	10889	10916	0.20071579064829034
M1	cpdb	0	network_modules	141	TRUE	3.214122202850684e-16	10	18	7	0.3888888888888889	0.7	REAC:R-HSA-9754560	REAC	SARS-CoV-2 modulates autophagy	10916	2124		0	0.25	10	10906	7	11	3	10895	10916	0.5211886061712577
M1	cpdb	0	network_modules	141	TRUE	2.328352604694952e-15	20	26	8	0.3076923076923077	0.4	GO:0035493	GO:BP	SNARE complex assembly	16175	9063		0	0.058823529411764705	20	16155	8	18	12	16137	16175	0.34991096916176556
M1	cpdb	0	network_modules	141	TRUE	2.5346894979767093e-15	99	26	11	0.4230769230769231	0.1111111111111111	GO:0006906	GO:BP	vesicle fusion	16175	2557		0.0625	0.11764705882352941	99	16076	11	15	88	16061	16175	0.21450734108116176
M1	cpdb	0	network_modules	141	TRUE	3.190590584629078e-15	101	26	11	0.4230769230769231	0.10891089108910891	GO:0090174	GO:BP	organelle membrane fusion	16175	18081		0.125	0.17647058823529413	101	16074	11	15	90	16059	16175	0.21232311568138273
M1	cpdb	0	network_modules	141	TRUE	5.230852097615499e-15	11	26	7	0.2692307692307692	0.6363636363636364	GO:0034058	GO:BP	endosomal vesicle fusion	16175	8388		0.1875	0.23529411764705882	11	16164	7	19	4	16145	16175	0.4133459467463712
M1	cpdb	0	network_modules	141	TRUE	1.2541134145424833e-14	12	26	7	0.2692307692307692	0.5833333333333334	GO:0035542	GO:BP	regulation of SNARE complex assembly	16175	9085		0.25	0.29411764705882354	12	16163	7	19	5	16144	16175	0.3956697473283969
M1	cpdb	0	network_modules	141	TRUE	9.485639650841498e-14	136	26	11	0.4230769230769231	0.08088235294117647	GO:0048284	GO:BP	organelle fusion	16175	12626		0.3125	0.35294117647058826	136	16039	11	15	125	16024	16175	0.18222228917276242
M1	cpdb	0	network_modules	141	TRUE	4.785252436830525e-13	157	26	11	0.4230769230769231	0.07006369426751592	GO:0061025	GO:BP	membrane fusion	16175	15142		0.375	0.4117647058823529	157	16018	11	15	146	16003	16175	0.16917794521893595
M1	cpdb	0	network_modules	141	TRUE	2.5391319951242584e-11	315	26	12	0.46153846153846156	0.0380952380952381	GO:0016050	GO:BP	vesicle organization	16175	5082		0.4375	0.47058823529411764	315	15860	12	14	303	15846	16175	0.12836197518450623
M1	cpdb	0	network_modules	141	TRUE	1.1506542752759585e-10	67	26	8	0.3076923076923077	0.11940298507462686	GO:0008333	GO:BP	endosome to lysosome transport	16175	3164		0.5	0.5294117647058824	67	16108	8	18	59	16090	16175	0.1896401687255652
M1	cpdb	0	network_modules	141	TRUE	2.0361122355294974e-9	155	26	9	0.34615384615384615	0.05806451612903226	GO:0007034	GO:BP	vacuolar transport	16175	2639		0.5625	0.5882352941176471	155	16020	9	17	146	16003	16175	0.1386238436816235
M1	cpdb	0	network_modules	141	TRUE	1.9587360011042875e-8	125	26	8	0.3076923076923077	0.064	GO:0007041	GO:BP	lysosomal transport	16175	2645		0.625	0.6470588235294118	125	16050	8	18	117	16032	16175	0.13744699164890772
M1	cpdb	0	network_modules	141	TRUE	4.291455136188635e-8	156	19	8	0.42105263157894735	0.05128205128205128	KEGG:04148	KEGG	Efferocytosis	8484	283		0	0.3333333333333333	156	8328	8	11	148	8317	8484	0.14199573117515013
M1	cpdb	0	network_modules	141	TRUE	6.718826571761048e-8	165	19	8	0.42105263157894735	0.048484848484848485	KEGG:04140	KEGG	Autophagy - animal	8484	277		0.5	0.6666666666666666	165	8319	8	11	157	8308	8484	0.13777954740192933
M1	cpdb	0	network_modules	141	TRUE	2.810121428596658e-6	657	26	11	0.4230769230769231	0.0167427701674277	GO:0061024	GO:BP	membrane organization	16175	15141		0.6875	0.7058823529411765	657	15518	11	15	646	15503	16175	0.07773956659117671
M1	cpdb	0	network_modules	141	TRUE	4.653167043329486e-6	197	18	7	0.3888888888888889	0.03553299492385787	REAC:R-HSA-9705683	REAC	SARS-CoV-2-host interactions	10916	2128		0.3333333333333333	0.5	197	10719	7	11	190	10708	10916	0.1132152752041573
M1	cpdb	0	network_modules	141	TRUE	3.189932856002029e-5	202	26	7	0.2692307692307692	0.034653465346534656	GO:0007033	GO:BP	vacuole organization	16175	2638		0.75	0.7647058823529411	202	15973	7	19	195	15954	16175	0.0927655548415166
M1	cpdb	0	network_modules	141	TRUE	3.967533169500533e-5	249	19	7	0.3684210526315789	0.028112449799196786	KEGG:05132	KEGG	Salmonella infection	8484	429		1	1	249	8235	7	12	242	8223	8484	0.09517525159947177
M1	cpdb	0	network_modules	141	TRUE	6.958322230155008e-5	292	18	7	0.3888888888888889	0.023972602739726026	REAC:R-HSA-9694516	REAC	SARS-CoV-2 Infection	10916	2122		0.6666666666666666	0.75	292	10624	7	11	285	10613	10916	0.09121503211455069
M1	cpdb	0	network_modules	141	TRUE	5.487384697908569e-4	96	26	5	0.19230769230769232	0.052083333333333336	GO:0080171	GO:BP	lytic vacuole organization	16175	17845		0.8125	0.8823529411764706	96	16079	5	21	91	16058	16175	0.09735877321204527
M1	cpdb	0	network_modules	141	TRUE	5.487384697908569e-4	96	26	5	0.19230769230769232	0.052083333333333336	GO:0007040	GO:BP	lysosome organization	16175	2644		0.8125	0.8823529411764706	96	16079	5	21	91	16058	16175	0.09735877321204527
M1	cpdb	0	network_modules	141	TRUE	0.0012415753158373803	346	26	7	0.2692307692307692	0.02023121387283237	GO:0043254	GO:BP	regulation of protein-containing complex assembly	16175	10588		0.9375	0.9411764705882353	346	15829	7	19	339	15810	16175	0.06873284028278835
M1	cpdb	0	network_modules	141	TRUE	0.001456754477998213	459	18	7	0.3888888888888889	0.015250544662309368	REAC:R-HSA-9679506	REAC	SARS-CoV Infections	10916	2112		1	1	459	10457	7	11	452	10446	10916	0.07023382304507703
M1	cpdb	0	network_modules	141	TRUE	0.0023496619006924766	55	26	4	0.15384615384615385	0.07272727272727272	GO:0097352	GO:BP	autophagosome maturation	16175	18619		1	1	55	16120	4	22	51	16098	16175	0.10369897883128286
M1	cpdb	0	network_modules	142	TRUE	1.7030843727105754e-9	10	22	5	0.22727272727272727	0.5	REAC:R-HSA-193697	REAC	p75NTR regulates axonogenesis	10916	2724		0	0.1	10	10906	5	17	5	10889	10916	0.3362340373944124
M1	cpdb	0	network_modules	142	TRUE	5.16168974760276e-7	9	22	4	0.18181818181818182	0.4444444444444444	REAC:R-HSA-193634	REAC	Axonal growth inhibition (RHOA activation)	10916	195		0.1111111111111111	0.2	9	10907	4	18	5	10889	10916	0.2833810065188784
M1	cpdb	0	network_modules	142	TRUE	1.3228128017679184e-6	10	25	4	0.16	0.4	GO:0038180	GO:BP	nerve growth factor signaling pathway	16175	9754		0	0.06666666666666667	10	16165	4	21	6	16144	16175	0.2522776631961113
M1	cpdb	0	network_modules	142	TRUE	1.620538564266181e-6	137	25	7	0.28	0.051094890510948905	GO:0051402	GO:BP	neuron apoptotic process	16175	13695		0.07142857142857142	0.13333333333333333	137	16038	7	18	130	16020	16175	0.11657641196358323
M1	cpdb	0	network_modules	142	TRUE	4.259254416214865e-6	118	17	6	0.35294117647058826	0.05084745762711865	KEGG:04722	KEGG	Neurotrophin signaling pathway	8484	352		0	0.25	118	8366	6	11	112	8355	8484	0.1297185011317966
M1	cpdb	0	network_modules	142	TRUE	9.337771731670797e-6	97	22	6	0.2727272727272727	0.061855670103092786	REAC:R-HSA-193704	REAC	p75 NTR receptor-mediated signalling	10916	2721		0.2222222222222222	0.3	97	10819	6	16	91	10803	10916	0.12634103307526368
M1	cpdb	0	network_modules	142	TRUE	9.490038631996982e-6	356	17	8	0.47058823529411764	0.02247191011235955	KEGG:04151	KEGG	PI3K-Akt signaling pathway	8484	285		0.3333333333333333	0.5	356	8128	8	9	348	8119	8484	0.09579060444533719
M1	cpdb	0	network_modules	142	TRUE	4.5506754176941995e-5	22	25	4	0.16	0.18181818181818182	GO:1990090	GO:BP	cellular response to nerve growth factor stimulus	16175	25079		0.14285714285714285	0.3333333333333333	22	16153	4	21	18	16132	16175	0.1693567286406019
M1	cpdb	0	network_modules	142	TRUE	4.5506754176941995e-5	22	25	4	0.16	0.18181818181818182	GO:1990089	GO:BP	response to nerve growth factor	16175	25078		0.14285714285714285	0.3333333333333333	22	16153	4	21	18	16132	16175	0.1693567286406019
M1	cpdb	0	network_modules	142	TRUE	4.5506754176941995e-5	22	25	4	0.16	0.18181818181818182	GO:0038179	GO:BP	neurotrophin signaling pathway	16175	9753		0.14285714285714285	0.3333333333333333	22	16153	4	21	18	16132	16175	0.1693567286406019
M1	cpdb	0	network_modules	142	TRUE	1.4201802559328378e-4	153	22	6	0.2727272727272727	0.0392156862745098	REAC:R-HSA-73887	REAC	Death Receptor Signaling	10916	455		0.3333333333333333	0.4	153	10763	6	16	147	10747	10916	0.09889718776229647
M1	cpdb	0	network_modules	142	TRUE	1.8314117748525514e-4	80	25	5	0.2	0.0625	GO:0043524	GO:BP	negative regulation of neuron apoptotic process	16175	10753		0.35714285714285715	0.4	80	16095	5	20	75	16075	16175	0.10939377781946275
M1	cpdb	0	network_modules	142	TRUE	2.484736538966447e-4	235	17	6	0.35294117647058826	0.02553191489361702	KEGG:04014	KEGG	Ras signaling pathway	8484	247		0.6666666666666666	0.75	235	8249	6	11	229	8238	8484	0.08880396383730717
M1	cpdb	0	network_modules	142	TRUE	4.5162911789245073e-4	38	25	4	0.16	0.10526315789473684	GO:0021675	GO:BP	nerve development	16175	6258		0.42857142857142855	0.4666666666666667	38	16137	4	21	34	16116	16175	0.12812111915467386
M1	cpdb	0	network_modules	142	TRUE	7.511556027579543e-4	43	25	4	0.16	0.09302325581395349	GO:0007422	GO:BP	peripheral nervous system development	16175	2917		0.5	0.5333333333333333	43	16132	4	21	39	16111	16175	0.12022455914394735
M1	cpdb	0	network_modules	142	TRUE	0.001032451748709447	301	17	6	0.35294117647058826	0.019933554817275746	KEGG:04010	KEGG	MAPK signaling pathway	8484	243		1	1	301	8183	6	11	295	8172	8484	0.0768977132586767
M1	cpdb	0	network_modules	142	TRUE	0.0012925086367273537	2	22	2	0.09090909090909091	1	REAC:R-HSA-205017	REAC	NFG and proNGF binds to p75NTR	10916	1524		0.4444444444444444	0.5	2	10914	2	20	0	10894	10916	0.3012349568172482
M1	cpdb	0	network_modules	142	TRUE	0.0013040405928422382	16	22	3	0.13636363636363635	0.1875	REAC:R-HSA-205043	REAC	NRIF signals cell death from the nucleus	10916	1549		0.5555555555555556	0.6	16	10900	3	19	13	10881	10916	0.15845761835371047
M1	cpdb	0	network_modules	142	TRUE	0.0013930616540286588	120	25	5	0.2	0.041666666666666664	GO:0043523	GO:BP	regulation of neuron apoptotic process	16175	10752		0.5714285714285714	0.6	120	16055	5	20	115	16035	16175	0.08829701339569333
M1	cpdb	0	network_modules	142	TRUE	0.002724493825054791	59	25	4	0.16	0.06779661016949153	GO:0007613	GO:BP	memory	16175	3070		0.6428571428571429	0.6666666666666666	59	16116	4	21	55	16095	16175	0.10204175871319976
M1	cpdb	0	network_modules	142	TRUE	0.0030769327692432304	21	22	3	0.13636363636363635	0.14285714285714285	REAC:R-HSA-9006115	REAC	Signaling by NTRK2 (TRKB)	10916	2285		0.6666666666666666	0.7	21	10895	3	19	18	10876	10916	0.13787513538282495
M1	cpdb	0	network_modules	142	TRUE	0.003637600018084523	266	25	6	0.24	0.022556390977443608	GO:0051960	GO:BP	regulation of nervous system development	16175	14029		0.7142857142857143	0.7333333333333333	266	15909	6	19	260	15890	16175	0.06915919086692207
M1	cpdb	0	network_modules	142	TRUE	0.0038727888435273945	3	22	2	0.09090909090909091	0.6666666666666666	REAC:R-HSA-193681	REAC	Ceramide signalling	10916	342		0.7777777777777778	0.8	3	10913	2	20	1	10893	10916	0.24572021915797454
M1	cpdb	0	network_modules	142	TRUE	0.004027715377862427	65	25	4	0.16	0.06153846153846154	GO:0061387	GO:BP	regulation of extent of cell growth	16175	15458		0.7857142857142857	0.8	65	16110	4	21	61	16089	16175	0.09700554120519962
M1	cpdb	0	network_modules	142	TRUE	0.007736115924899079	4	22	2	0.09090909090909091	0.5	REAC:R-HSA-209563	REAC	Axonal growth stimulation	10916	196		0.8888888888888888	1	4	10912	2	20	2	10892	10916	0.21259460496347032
M1	cpdb	0	network_modules	142	TRUE	0.007736115924899079	4	22	2	0.09090909090909091	0.5	REAC:R-HSA-9026527	REAC	Activated NTRK2 signals through PLCG1	10916	63		0.8888888888888888	1	4	10912	2	20	2	10892	10916	0.21259460496347032
M1	cpdb	0	network_modules	142	TRUE	0.007997110195736816	684	25	8	0.32	0.011695906432748537	GO:0031175	GO:BP	neuron projection development	16175	7086		0.8571428571428571	0.8666666666666667	684	15491	8	17	676	15474	16175	0.05429448408679217
M1	cpdb	0	network_modules	142	TRUE	0.00923062445209091	24	25	3	0.12	0.125	GO:0031102	GO:BP	neuron projection regeneration	16175	7028		0.9285714285714286	0.9333333333333333	24	16151	3	22	21	16129	16175	0.12114361369528363
M1	cpdb	0	network_modules	142	TRUE	0.009734269564140235	81	25	4	0.16	0.04938271604938271	GO:0033138	GO:BP	positive regulation of peptidyl-serine phosphorylation	16175	8053		1	1	81	16094	4	21	77	16073	16175	0.08639001850379645
M1	cpdb	0	network_modules	144	TRUE	1.861853022027406e-5	4	25	3	0.12	0.75	GO:0051459	GO:BP	regulation of corticotropin secretion	16175	13720		0	0.14285714285714285	4	16171	3	22	1	16149	16175	0.29965044535356145
M1	cpdb	0	network_modules	144	TRUE	2.0041966590808417e-5	365	18	8	0.4444444444444444	0.021917808219178082	KEGG:04080	KEGG	Neuroactive ligand-receptor interaction	8484	263		NA	1	365	8119	8	10	357	8109	8484	0.09122241305697736
M1	cpdb	0	network_modules	144	TRUE	2.2947850053969057e-5	460	21	9	0.42857142857142855	0.01956521739130435	REAC:R-HSA-500792	REAC	GPCR ligand binding	10916	1019		0	0.5	460	10456	9	12	451	10444	10916	0.08444429594659195
M1	cpdb	0	network_modules	144	TRUE	4.649883605893815e-5	5	25	3	0.12	0.6	GO:0051458	GO:BP	corticotropin secretion	16175	13719		0.16666666666666666	0.2857142857142857	5	16170	3	22	2	16148	16175	0.26788542285229483
M1	cpdb	0	network_modules	144	TRUE	1.6907497778632536e-4	30	25	4	0.16	0.13333333333333333	GO:0060986	GO:BP	endocrine hormone secretion	16175	15113		0.3333333333333333	0.42857142857142855	30	16145	4	21	26	16124	16175	0.14461209876556172
M1	cpdb	0	network_modules	144	TRUE	2.3284222062820454e-4	93	21	5	0.23809523809523808	0.053763440860215055	REAC:R-HSA-373080	REAC	Class B/2 (Secretin family receptors)	10916	366		1	1	93	10823	5	16	88	10807	10916	0.1096655057001031
M1	cpdb	0	network_modules	144	TRUE	0.0018341952887982375	774	25	9	0.36	0.011627906976744186	GO:0007186	GO:BP	G protein-coupled receptor signaling pathway	16175	2744		0.5	0.5714285714285714	774	15401	9	16	765	15385	16175	0.05753659686007012
M1	cpdb	0	network_modules	144	TRUE	0.0023695478935030147	57	25	4	0.16	0.07017543859649122	GO:0050886	GO:BP	endocrine process	16175	13330		0.6666666666666666	0.7142857142857143	57	16118	4	21	53	16097	16175	0.10389218557707551
M1	cpdb	0	network_modules	144	TRUE	0.008085042301513865	23	25	3	0.12	0.13043478260869565	GO:0044060	GO:BP	regulation of endocrine process	16175	10895		0.8333333333333334	0.8571428571428571	23	16152	3	22	20	16130	16175	0.12380987150270771
M1	cpdb	0	network_modules	144	TRUE	0.009819758219721055	3	25	2	0.08	0.6666666666666666	GO:0051461	GO:BP	positive regulation of corticotropin secretion	16175	13722		1	1	3	16172	2	23	1	16149	16175	0.23060434694047444
M1	cpdb	0	network_modules	145	TRUE	0.001816872060287757	23	17	3	0.17647058823529413	0.13043478260869565	REAC:R-HSA-73980	REAC	RNA Polymerase III Transcription Termination	10916	1903		NA	1	23	10893	3	14	20	10879	10916	0.15018023933619465
M1	cpdb	0	network_modules	145	TRUE	0.004815206589211492	63	12	3	0.25	0.047619047619047616	KEGG:00310	KEGG	Lysine degradation	8484	34		NA	1	63	8421	3	9	60	8412	8484	0.10633859343337987
M1	cpdb	0	network_modules	146	TRUE	5.230852097615499e-15	11	26	7	0.2692307692307692	0.6363636363636364	GO:0140588	GO:BP	chromatin looping	16175	19829		0	0.047619047619047616	11	16164	7	19	4	16145	16175	0.4133459467463712
M1	cpdb	0	network_modules	146	TRUE	9.248935842576912e-11	72	12	7	0.5833333333333334	0.09722222222222222	REAC:R-HSA-3108214	REAC	SUMOylation of DNA damage response and repair proteins	10916	2168		0	0.3333333333333333	72	10844	7	5	65	10839	10916	0.23636241819283638
M1	cpdb	0	network_modules	146	TRUE	5.8205185697327625e-9	60	26	7	0.2692307692307692	0.11666666666666667	GO:0016925	GO:BP	protein sumoylation	16175	5258		0.05	0.09523809523809523	60	16115	7	19	53	16096	16175	0.1752535398861267
M1	cpdb	0	network_modules	146	TRUE	2.3738499650647823e-8	128	26	8	0.3076923076923077	0.0625	GO:0018205	GO:BP	peptidyl-lysine modification	16175	5364		0.1	0.14285714285714285	128	16047	8	18	120	16029	16175	0.13575543951444885
M1	cpdb	0	network_modules	146	TRUE	4.5183542802930836e-8	171	12	7	0.5833333333333334	0.04093567251461988	REAC:R-HSA-3108232	REAC	SUMO E3 ligases SUMOylate target proteins	10916	2163		0.5	0.6666666666666666	171	10745	7	5	164	10740	10916	0.15165424509339417
M1	cpdb	0	network_modules	146	TRUE	5.762569648464053e-8	177	12	7	0.5833333333333334	0.03954802259887006	REAC:R-HSA-2990846	REAC	SUMOylation	10916	2167		1	1	177	10739	7	5	170	10734	10916	0.14895893805526525
M1	cpdb	0	network_modules	146	TRUE	2.5593402634525014e-7	172	26	8	0.3076923076923077	0.046511627906976744	GO:0000724	GO:BP	double-strand break repair via homologous recombination	16175	203		0.15	0.19047619047619047	172	16003	8	18	164	15985	16175	0.11620782424669332
M1	cpdb	0	network_modules	146	TRUE	3.0594880091929703e-7	104	26	7	0.2692307692307692	0.0673076923076923	GO:0032204	GO:BP	regulation of telomere maintenance	16175	7396		0.2	0.23809523809523808	104	16071	7	19	97	16052	16175	0.13193110330201746
M1	cpdb	0	network_modules	146	TRUE	3.0755577681730925e-7	176	26	8	0.3076923076923077	0.045454545454545456	GO:0000725	GO:BP	recombinational repair	16175	204		0.25	0.2857142857142857	176	15999	8	18	168	15981	16175	0.11479840422668633
M1	cpdb	0	network_modules	146	TRUE	1.2263161990965757e-6	791	26	12	0.46153846153846156	0.015170670037926675	GO:0000122	GO:BP	negative regulation of transcription by RNA polymerase II	16175	48		0.3	0.3333333333333333	791	15384	12	14	779	15370	16175	0.07677188584651598
M1	cpdb	0	network_modules	146	TRUE	1.3561413399039372e-6	798	26	12	0.46153846153846156	0.015037593984962405	GO:0043687	GO:BP	post-translational protein modification	16175	10838		0.35	0.38095238095238093	798	15377	12	14	786	15363	16175	0.07637163925172902
M1	cpdb	0	network_modules	146	TRUE	3.2932068731013745e-6	667	26	11	0.4230769230769231	0.01649175412293853	GO:0032446	GO:BP	protein modification by small protein conjugation	16175	7568		0.4	0.42857142857142855	667	15508	11	15	656	15493	16175	0.07705472285348275
M1	cpdb	0	network_modules	146	TRUE	4.43077119339704e-6	152	26	7	0.2692307692307692	0.046052631578947366	GO:0000723	GO:BP	telomere maintenance	16175	202		0.45	0.47619047619047616	152	16023	7	19	145	16004	16175	0.10805868169008248
M1	cpdb	0	network_modules	146	TRUE	1.1068238454002117e-5	749	26	11	0.4230769230769231	0.014686248331108143	GO:0070647	GO:BP	protein modification by small protein conjugation or removal	16175	16231		0.5	0.5238095238095238	749	15426	11	15	738	15411	16175	0.07193958377953702
M1	cpdb	0	network_modules	146	TRUE	1.242568209534502e-5	281	26	8	0.3076923076923077	0.028469750889679714	GO:0006310	GO:BP	DNA recombination	16175	2115		0.55	0.5714285714285714	281	15894	8	18	273	15876	16175	0.08915897491237598
M1	cpdb	0	network_modules	146	TRUE	1.5514738133193942e-5	182	26	7	0.2692307692307692	0.038461538461538464	GO:0032200	GO:BP	telomere organization	16175	7392		0.6	0.6190476190476191	182	15993	7	19	175	15974	16175	0.09813898554812236
M1	cpdb	0	network_modules	146	TRUE	1.9593793722674168e-5	435	26	9	0.34615384615384615	0.020689655172413793	GO:0051052	GO:BP	regulation of DNA metabolic process	16175	13462		0.65	0.6666666666666666	435	15740	9	17	426	15723	16175	0.07918744533836167
M1	cpdb	0	network_modules	146	TRUE	1.9656789243986537e-5	298	26	8	0.3076923076923077	0.026845637583892617	GO:0006302	GO:BP	double-strand break repair	16175	2109		0.7	0.7142857142857143	298	15877	8	18	290	15859	16175	0.08631125025417119
M1	cpdb	0	network_modules	146	TRUE	7.558636425406031e-5	229	26	7	0.2692307692307692	0.03056768558951965	GO:0033044	GO:BP	regulation of chromosome organization	16175	7999		0.75	0.7619047619047619	229	15946	7	19	222	15927	16175	0.08663217478382046
M1	cpdb	0	network_modules	146	TRUE	8.377531810881064e-4	11	26	3	0.11538461538461539	0.2727272727272727	GO:0000722	GO:BP	telomere maintenance via recombination	16175	201		0.8	0.8095238095238095	11	16164	3	23	8	16141	16175	0.17655012993826932
M1	cpdb	0	network_modules	146	TRUE	0.001578433077823648	528	26	8	0.3076923076923077	0.015151515151515152	GO:0006281	GO:BP	DNA repair	16175	2095		0.85	0.8571428571428571	528	15647	8	18	520	15629	16175	0.06210638496094859
M1	cpdb	0	network_modules	146	TRUE	0.0020025077255279963	545	26	8	0.3076923076923077	0.014678899082568808	GO:0051276	GO:BP	chromosome organization	16175	13613		0.9	0.9047619047619048	545	15630	8	18	537	15612	16175	0.06092960048726856
M1	cpdb	0	network_modules	146	TRUE	0.005732798402039871	20	26	3	0.11538461538461539	0.15	GO:0006312	GO:BP	mitotic recombination	16175	2117		0.95	0.9523809523809523	20	16155	3	23	17	16132	16175	0.1303342339743215
M1	cpdb	0	network_modules	146	TRUE	0.0064750755986038005	638	26	8	0.3076923076923077	0.012539184952978056	GO:0018193	GO:BP	peptidyl-amino acid modification	16175	5353		1	1	638	15537	8	18	630	15519	16175	0.05529704009012993
M1	cpdb	0	network_modules	148	TRUE	7.20482802559603e-27	83	22	16	0.7272727272727273	0.1927710843373494	KEGG:04146	KEGG	Peroxisome	8484	282		NA	1	83	8401	16	6	67	8395	8484	0.37169486838302546
M1	cpdb	0	network_modules	148	TRUE	2.7170089522389944e-25	37	28	13	0.4642857142857143	0.35135135135135137	GO:0007031	GO:BP	peroxisome organization	16175	2636		0	0.04	37	16138	13	15	24	16123	16175	0.4027095973985626
M1	cpdb	0	network_modules	148	TRUE	2.6125790861485618e-23	21	28	11	0.39285714285714285	0.5238095238095238	GO:0043574	GO:BP	peroxisomal transport	16175	10779		0.041666666666666664	0.12	21	16154	11	17	10	16137	16175	0.45281909490415334
M1	cpdb	0	network_modules	148	TRUE	2.6125790861485618e-23	21	28	11	0.39285714285714285	0.5238095238095238	GO:0015919	GO:BP	peroxisomal membrane transport	16175	5014		0.041666666666666664	0.12	21	16154	11	17	10	16137	16175	0.45281909490415334
M1	cpdb	0	network_modules	148	TRUE	5.221863606190636e-21	19	23	10	0.43478260869565216	0.5263157894736842	REAC:R-HSA-9603798	REAC	Class I peroxisomal membrane protein import	10916	369		0	0.16666666666666666	19	10897	10	13	9	10884	10916	0.4773681963196815
M1	cpdb	0	network_modules	148	TRUE	9.487136646073148e-18	20	28	9	0.32142857142857145	0.45	GO:0072662	GO:BP	protein localization to peroxisome	16175	17482		0.125	0.2	20	16155	9	19	11	16136	16175	0.3794193796302915
M1	cpdb	0	network_modules	148	TRUE	9.487136646073148e-18	20	28	9	0.32142857142857145	0.45	GO:0072663	GO:BP	establishment of protein localization to peroxisome	16175	17483		0.125	0.2	20	16155	9	19	11	16136	16175	0.3794193796302915
M1	cpdb	0	network_modules	148	TRUE	2.4668370032095503e-16	158	23	13	0.5652173913043478	0.08227848101265822	REAC:R-HSA-9609507	REAC	Protein localization	10916	1815		0.2	0.3333333333333333	158	10758	13	10	145	10748	10916	0.21188906425954274
M1	cpdb	0	network_modules	148	TRUE	1.2109123277564649e-13	14	28	7	0.25	0.5	GO:0016558	GO:BP	protein import into peroxisome matrix	16175	5249		0.20833333333333334	0.24	14	16161	7	21	7	16140	16175	0.3527873986646525
M1	cpdb	0	network_modules	148	TRUE	1.6749609902466405e-11	25	28	7	0.25	0.28	GO:0065002	GO:BP	intracellular protein transmembrane transport	16175	15886		0.25	0.28	25	16150	7	21	18	16129	16175	0.26337091685817904
M1	cpdb	0	network_modules	148	TRUE	2.872495230213848e-10	36	28	7	0.25	0.19444444444444445	GO:0044743	GO:BP	protein transmembrane import into intracellular organelle	16175	11137		0.2916666666666667	0.32	36	16139	7	21	29	16118	16175	0.21894959925735044
M1	cpdb	0	network_modules	148	TRUE	2.912468221074656e-9	49	28	7	0.25	0.14285714285714285	GO:0071806	GO:BP	protein transmembrane transport	16175	16919		0.3333333333333333	0.36	49	16126	7	21	42	16105	16175	0.18713771861315856
M1	cpdb	0	network_modules	148	TRUE	7.95438885994871e-9	60	23	7	0.30434782608695654	0.11666666666666667	REAC:R-HSA-9033241	REAC	Peroxisomal protein import	10916	1728		0.4	0.5	60	10856	7	16	53	10840	10916	0.18573695035047538
M1	cpdb	0	network_modules	148	TRUE	1.3541655270361902e-5	373	28	9	0.32142857142857145	0.024128686327077747	GO:0072594	GO:BP	establishment of protein localization to organelle	16175	17458		0.375	0.4	373	15802	9	19	364	15783	16175	0.0827788917451241
M1	cpdb	0	network_modules	148	TRUE	1.4782776005678847e-5	18	23	4	0.17391304347826086	0.2222222222222222	REAC:R-HSA-1369062	REAC	ABC transporters in lipid homeostasis	10916	8		0.6	0.6666666666666666	18	10898	4	19	14	10879	10916	0.19509169753767955
M1	cpdb	0	network_modules	148	TRUE	3.2001549599090184e-5	4	28	3	0.10714285714285714	0.75	GO:0016560	GO:BP	protein import into peroxisome matrix, docking	16175	5251		0.4166666666666667	0.44	4	16171	3	25	1	16146	16175	0.2830991874101228
M1	cpdb	0	network_modules	148	TRUE	7.99111191907807e-5	5	28	3	0.10714285714285714	0.6	GO:0044721	GO:BP	protein import into peroxisome matrix, substrate release	16175	11123		0.4583333333333333	0.48	5	16170	3	25	2	16145	16175	0.2530729892717718
M1	cpdb	0	network_modules	148	TRUE	2.521806990115163e-4	524	28	9	0.32142857142857145	0.01717557251908397	GO:0006886	GO:BP	intracellular protein transport	16175	2542		0.5	0.52	524	15651	9	19	515	15632	16175	0.06798106627966337
M1	cpdb	0	network_modules	148	TRUE	4.895125629886689e-4	33	28	4	0.14285714285714285	0.12121212121212122	GO:0000038	GO:BP	very long-chain fatty acid metabolic process	16175	15		0.5416666666666666	0.56	33	16142	4	24	29	16118	16175	0.12995610827480467
M1	cpdb	0	network_modules	148	TRUE	7.716626270546826e-4	91	28	5	0.17857142857142858	0.054945054945054944	GO:0019395	GO:BP	fatty acid oxidation	16175	5752		0.5833333333333334	0.6	91	16084	5	23	86	16061	16175	0.0962872595351105
M1	cpdb	0	network_modules	148	TRUE	9.07583126368538e-4	94	28	5	0.17857142857142858	0.05319148936170213	GO:0009062	GO:BP	fatty acid catabolic process	16175	3238		0.625	0.64	94	16081	5	23	89	16058	16175	0.09464552895964518
M1	cpdb	0	network_modules	148	TRUE	9.533879337877791e-4	10	28	3	0.10714285714285714	0.3	GO:0016559	GO:BP	peroxisome fission	16175	5250		0.6666666666666666	0.68	10	16165	3	25	7	16140	16175	0.1784594367560398
M1	cpdb	0	network_modules	148	TRUE	0.001008243586731957	96	28	5	0.17857142857142858	0.052083333333333336	GO:0034440	GO:BP	lipid oxidation	16175	8634		0.7083333333333334	0.72	96	16079	5	23	91	16056	16175	0.09359323901719177
M1	cpdb	0	network_modules	148	TRUE	0.0015537450829935923	319	28	7	0.25	0.0219435736677116	GO:0006631	GO:BP	fatty acid metabolic process	16175	2343		0.75	0.76	319	15856	7	21	312	15835	16175	0.06896648020420297
M1	cpdb	0	network_modules	148	TRUE	0.0018126584154033864	108	28	5	0.17857142857142858	0.046296296296296294	GO:0072329	GO:BP	monocarboxylic acid catabolic process	16175	17352		0.7916666666666666	0.8	108	16067	5	23	103	16044	16175	0.087894152433735
M1	cpdb	0	network_modules	148	TRUE	0.0019384179527215171	58	23	4	0.17391304347826086	0.06896551724137931	REAC:R-HSA-8866654	REAC	E3 ubiquitin ligases ubiquitinate target proteins	10916	811		0.8	0.8333333333333334	58	10858	4	19	54	10839	10916	0.10656674068658986
M1	cpdb	0	network_modules	148	TRUE	0.005721003630456214	761	28	9	0.32142857142857145	0.011826544021024968	GO:0043436	GO:BP	oxoacid metabolic process	16175	10693		0.8333333333333334	0.84	761	15414	9	19	752	15395	16175	0.053961109404164244
M1	cpdb	0	network_modules	148	TRUE	0.0059857738388337705	248	28	6	0.21428571428571427	0.024193548387096774	GO:0016042	GO:BP	lipid catabolic process	16175	5076		0.875	0.88	248	15927	6	22	242	15905	16175	0.06742732679420652
M1	cpdb	0	network_modules	148	TRUE	0.0061020689869304215	767	28	9	0.32142857142857145	0.011734028683181226	GO:0006082	GO:BP	organic acid metabolic process	16175	1947		0.9166666666666666	0.92	767	15408	9	19	758	15389	16175	0.05368741910100723
M1	cpdb	0	network_modules	148	TRUE	0.0063377216963188075	78	23	4	0.17391304347826086	0.05128205128205128	REAC:R-HSA-8852135	REAC	Protein ubiquitination	10916	1818		1	1	78	10838	4	19	74	10819	10916	0.09097947290342397
M1	cpdb	0	network_modules	148	TRUE	0.008768336781953927	265	28	6	0.21428571428571427	0.022641509433962263	GO:0006979	GO:BP	response to oxidative stress	16175	2604		0.9583333333333334	0.96	265	15910	6	22	259	15888	16175	0.06491879220707666
M1	cpdb	0	network_modules	148	TRUE	0.00934424664794594	808	28	9	0.32142857142857145	0.011138613861386138	GO:0033365	GO:BP	protein localization to organelle	16175	8175		1	1	808	15367	9	19	799	15348	16175	0.05189277565916115
M1	cpdb	0	network_modules	149	TRUE	4.0779747530075936e-14	14	25	7	0.28	0.5	GO:0035721	GO:BP	intraciliary retrograde transport	16175	9191		0	0.07692307692307693	14	16161	7	18	7	16143	16175	0.3734593720906664
M1	cpdb	0	network_modules	149	TRUE	1.6830936573960958e-13	59	25	9	0.36	0.15254237288135594	GO:0061512	GO:BP	protein localization to cilium	16175	15514		0.08333333333333333	0.15384615384615385	59	16116	9	16	50	16100	16175	0.23256967070892978
M1	cpdb	0	network_modules	149	TRUE	2.7732743993791465e-12	45	25	8	0.32	0.17777777777777778	GO:0042073	GO:BP	intraciliary transport	16175	9956		0.16666666666666666	0.23076923076923078	45	16130	8	17	37	16113	16175	0.23695305647909096
M1	cpdb	0	network_modules	149	TRUE	2.4370583663765012e-9	165	25	9	0.36	0.05454545454545454	GO:0099111	GO:BP	microtubule-based transport	16175	19044		0.25	0.3076923076923077	165	16010	9	16	156	15994	16175	0.13696482472192897
M1	cpdb	0	network_modules	149	TRUE	1.674302840495909e-8	54	15	6	0.4	0.1111111111111111	REAC:R-HSA-5620924	REAC	Intraflagellar transport	10916	1267		0	0.2	54	10862	6	9	48	10853	10916	0.20887175601658614
M1	cpdb	0	network_modules	149	TRUE	2.9495607877405006e-8	137	25	8	0.32	0.058394160583941604	GO:0031503	GO:BP	protein-containing complex localization	16175	7188		0.3333333333333333	0.38461538461538464	137	16038	8	17	129	16021	16175	0.13374966755111473
M1	cpdb	0	network_modules	149	TRUE	4.410706852864915e-8	144	25	8	0.32	0.05555555555555555	GO:0010970	GO:BP	transport along microtubule	16175	4546		0.4166666666666667	0.46153846153846156	144	16031	8	17	136	16014	16175	0.13030552199743947
M1	cpdb	0	network_modules	149	TRUE	6.549968251413879e-8	348	25	10	0.4	0.028735632183908046	GO:0007018	GO:BP	microtubule-based movement	16175	2626		0.5	0.5384615384615384	348	15827	10	15	338	15812	16175	0.10263326454644066
M1	cpdb	0	network_modules	149	TRUE	1.1338975540524637e-7	368	25	10	0.4	0.02717391304347826	GO:0044782	GO:BP	cilium organization	16175	11155		0.5833333333333334	0.6153846153846154	368	15807	10	15	358	15792	16175	0.09954221682168227
M1	cpdb	0	network_modules	149	TRUE	3.292535679732966e-7	185	25	8	0.32	0.043243243243243246	GO:0030705	GO:BP	cytoskeleton-dependent intracellular transport	16175	6886		0.6666666666666666	0.6923076923076923	185	15990	8	17	177	15973	16175	0.11417242219008641
M1	cpdb	0	network_modules	149	TRUE	1.570620379558577e-6	113	15	6	0.4	0.05309734513274336	REAC:R-HSA-5610787	REAC	Hedgehog 'off' state	10916	1112		0.25	0.4	113	10803	6	9	107	10794	10916	0.1428029820718349
M1	cpdb	0	network_modules	149	TRUE	8.315877091093033e-6	149	15	6	0.4	0.040268456375838924	REAC:R-HSA-5358351	REAC	Signaling by Hedgehog	10916	2258		0.5	0.6	149	10767	6	9	143	10758	10916	0.12351416384529157
M1	cpdb	0	network_modules	149	TRUE	4.251512277870428e-5	343	25	8	0.32	0.023323615160349854	GO:0060271	GO:BP	cilium assembly	16175	14488		0.75	0.7692307692307693	343	15832	8	17	335	15815	16175	0.08159914073544589
M1	cpdb	0	network_modules	149	TRUE	4.814203093614196e-5	200	15	6	0.4	0.03	REAC:R-HSA-5617833	REAC	Cilium Assembly	10916	361		0.75	0.8	200	10716	6	9	194	10707	10916	0.1055703768787515
M1	cpdb	0	network_modules	149	TRUE	4.470505398735096e-4	292	15	6	0.4	0.02054794520547945	REAC:R-HSA-1852241	REAC	Organelle biogenesis and maintenance	10916	1646		1	1	292	10624	6	9	286	10615	10916	0.08581054615906318
M1	cpdb	0	network_modules	149	TRUE	8.016472267250518e-4	503	25	8	0.32	0.015904572564612324	GO:0120031	GO:BP	plasma membrane bounded cell projection assembly	16175	19467		0.8333333333333334	0.8461538461538461	503	15672	8	17	495	15655	16175	0.06548371625432439
M1	cpdb	0	network_modules	149	TRUE	9.442802155927371e-4	514	25	8	0.32	0.01556420233463035	GO:0030031	GO:BP	cell projection assembly	16175	6655		0.9166666666666666	0.9230769230769231	514	15661	8	17	506	15644	16175	0.06464943085673919
M1	cpdb	0	network_modules	149	TRUE	0.0026222962571703706	808	25	9	0.36	0.011138613861386138	GO:0033365	GO:BP	protein localization to organelle	16175	8175		1	1	808	15367	9	16	799	15351	16175	0.055995670889297265
M1	cpdb	0	network_modules	150	TRUE	4.832650464164258e-6	54	17	5	0.29411764705882354	0.09259259259259259	REAC:R-HSA-5620924	REAC	Intraflagellar transport	10916	1267		0	0.2	54	10862	5	12	49	10850	10916	0.16277859245178136
M1	cpdb	0	network_modules	150	TRUE	7.99111191907807e-5	5	28	3	0.10714285714285714	0.6	GO:0072383	GO:BP	plus-end-directed vesicle transport along microtubule	16175	17377		0	0.25	5	16170	3	25	2	16145	16175	0.2530729892717718
M1	cpdb	0	network_modules	150	TRUE	1.2977591037375554e-4	202	17	6	0.35294117647058826	0.0297029702970297	REAC:R-HSA-6811442	REAC	Intra-Golgi and retrograde Golgi-to-ER traffic	10916	1262		0.25	0.4	202	10714	6	11	196	10703	10916	0.09800685977732293
M1	cpdb	0	network_modules	150	TRUE	1.596369490256435e-4	6	28	3	0.10714285714285714	0.5	GO:0072386	GO:BP	plus-end-directed organelle transport along microtubule	16175	17380		0.3333333333333333	0.5	6	16169	3	25	3	16144	16175	0.23089642354241308
M1	cpdb	0	network_modules	150	TRUE	2.1144682490595993e-4	27	28	4	0.14285714285714285	0.14814814814814814	GO:0043507	GO:BP	positive regulation of JUN kinase activity	16175	10744		0.6666666666666666	0.75	27	16148	4	24	23	16124	16175	0.14402358239087304
M1	cpdb	0	network_modules	150	TRUE	6.202015033653883e-4	60	17	4	0.23529411764705882	0.06666666666666667	REAC:R-HSA-983189	REAC	Kinesins	10916	1292		0.5	0.6	60	10856	4	13	56	10843	10916	0.12275229066362867
M1	cpdb	0	network_modules	150	TRUE	0.0010842141210036784	40	28	4	0.14285714285714285	0.1	GO:0043506	GO:BP	regulation of JUN kinase activity	16175	10743		1	1	40	16135	4	24	36	16111	16175	0.11770125802578738
M1	cpdb	0	network_modules	150	TRUE	0.0033863739483335088	200	17	5	0.29411764705882354	0.025	REAC:R-HSA-5617833	REAC	Cilium Assembly	10916	361		0.75	0.8	200	10716	5	12	195	10704	10916	0.08121778559602393
M1	cpdb	0	network_modules	150	TRUE	0.0042928346642317605	193	20	5	0.25	0.025906735751295335	KEGG:04814	KEGG	Motor proteins	8484	366		NA	1	193	8291	5	15	188	8276	8484	0.07408871936108118
M1	cpdb	0	network_modules	150	TRUE	0.004612503048373036	99	17	4	0.23529411764705882	0.04040404040404041	REAC:R-HSA-6811434	REAC	COPI-dependent Golgi-to-ER retrograde traffic	10916	277		1	1	99	10817	4	13	95	10804	10916	0.09424622859166218
M1	cpdb	0	network_modules	151	TRUE	1.1773449890221703e-4	70	12	4	0.3333333333333333	0.05714285714285714	KEGG:04920	KEGG	Adipocytokine signaling pathway	8484	377		0	0.1	70	8414	4	8	66	8406	8484	0.13525135896667287
M1	cpdb	0	network_modules	151	TRUE	6.685676521254419e-4	108	12	4	0.3333333333333333	0.037037037037037035	KEGG:04931	KEGG	Insulin resistance	8484	388		0.1111111111111111	0.2	108	8376	4	8	104	8368	8484	0.10763074377021946
M1	cpdb	0	network_modules	151	TRUE	7.425779836529669e-4	34	12	3	0.25	0.08823529411764706	KEGG:04710	KEGG	Circadian rhythm	8484	345		0.2222222222222222	0.3	34	8450	3	9	31	8441	8484	0.14653868350479857
M1	cpdb	0	network_modules	151	TRUE	0.0014363410327922212	131	12	4	0.3333333333333333	0.030534351145038167	KEGG:04068	KEGG	FoxO signaling pathway	8484	258		0.3333333333333333	0.4	131	8353	4	8	127	8345	8484	0.0970335023959429
M1	cpdb	0	network_modules	151	TRUE	0.0017137873111863697	137	12	4	0.3333333333333333	0.029197080291970802	KEGG:04910	KEGG	Insulin signaling pathway	8484	367		0.4444444444444444	0.5	137	8347	4	8	133	8339	8484	0.09470782367302169
M1	cpdb	0	network_modules	151	TRUE	0.001973580932471055	142	12	4	0.3333333333333333	0.028169014084507043	KEGG:04936	KEGG	Alcoholic liver disease	8484	393		0.5555555555555556	0.6	142	8342	4	8	138	8334	8484	0.09288046753587555
M1	cpdb	0	network_modules	151	TRUE	0.002714344384756515	154	12	4	0.3333333333333333	0.025974025974025976	KEGG:04932	KEGG	Non-alcoholic fatty liver disease	8484	389		0.6666666666666666	0.7	154	8330	4	8	150	8322	8484	0.08885383791505559
M1	cpdb	0	network_modules	151	TRUE	0.0033447138902351014	28	17	3	0.17647058823529413	0.10714285714285714	REAC:R-HSA-9619483	REAC	Activation of AMPK downstream of NMDARs	10916	73		0	0.5	28	10888	3	14	25	10874	10916	0.1357860084762307
M1	cpdb	0	network_modules	151	TRUE	0.0035564651501499354	165	12	4	0.3333333333333333	0.024242424242424242	KEGG:04140	KEGG	Autophagy - animal	8484	277		0.7777777777777778	0.8	165	8319	4	8	161	8311	8484	0.08554434033772555
M1	cpdb	0	network_modules	151	TRUE	0.003727052171909284	29	17	3	0.17647058823529413	0.10344827586206896	REAC:R-HSA-380972	REAC	Energy dependent regulation of mTOR by LKB1-AMPK	10916	843		1	1	29	10887	3	14	26	10873	10916	0.13336017258120095
M1	cpdb	0	network_modules	151	TRUE	0.003996614284022135	170	12	4	0.3333333333333333	0.023529411764705882	KEGG:04530	KEGG	Tight junction	8484	317		0.8888888888888888	0.9	170	8314	4	8	166	8306	8484	0.08414400035595401
M1	cpdb	0	network_modules	151	TRUE	0.004370983622239227	61	12	3	0.25	0.04918032786885246	KEGG:04213	KEGG	Longevity regulating pathway - multiple species	8484	290		1	1	61	8423	3	9	58	8414	8484	0.10815996846921777
M1	cpdb	0	network_modules	151	TRUE	0.009881539404908083	3	24	2	0.08333333333333333	0.6666666666666666	GO:1903944	GO:BP	negative regulation of hepatocyte apoptotic process	16175	23407		0	1	3	16172	2	22	1	16150	16175	0.23537416597204877
M1	cpdb	0	network_modules	151	TRUE	0.009881539404908083	3	24	2	0.08333333333333333	0.6666666666666666	GO:1990044	GO:BP	protein localization to lipid droplet	16175	25059		0	1	3	16172	2	22	1	16150	16175	0.23537416597204877
M1	cpdb	0	network_modules	151	TRUE	0.009881539404908083	3	24	2	0.08333333333333333	0.6666666666666666	GO:1903943	GO:BP	regulation of hepatocyte apoptotic process	16175	23406		0	1	3	16172	2	22	1	16150	16175	0.23537416597204877
M1	cpdb	0	network_modules	153	TRUE	6.219283348879069e-16	510	28	17	0.6071428571428571	0.03333333333333333	GO:0007169	GO:BP	cell surface receptor protein tyrosine kinase signaling pathway	16175	2733		0	0.019230769230769232	510	15665	17	11	493	15654	16175	0.13716947477922156
M1	cpdb	0	network_modules	153	TRUE	2.957753351944955e-14	790	28	18	0.6428571428571429	0.02278481012658228	GO:0007167	GO:BP	enzyme-linked receptor protein signaling pathway	16175	2731		0.0196078431372549	0.038461538461538464	790	15385	18	10	772	15375	16175	0.11476606135419645
M1	cpdb	0	network_modules	153	TRUE	3.3950982952373176e-14	227	17	12	0.7058823529411765	0.05286343612334802	KEGG:04810	KEGG	Regulation of actin cytoskeleton	8484	365		0	0.07142857142857142	227	8257	12	5	215	8252	8484	0.1885761196624642
M1	cpdb	0	network_modules	153	TRUE	7.523277345127201e-13	94	24	10	0.4166666666666667	0.10638297872340426	REAC:R-HSA-4420097	REAC	VEGFA-VEGFR2 Pathway	10916	2634		0	0.029411764705882353	94	10822	10	14	84	10808	10916	0.20730836507497066
M1	cpdb	0	network_modules	153	TRUE	2.146498008589283e-12	104	24	10	0.4166666666666667	0.09615384615384616	REAC:R-HSA-194138	REAC	Signaling by VEGF	10916	2313		0.030303030303030304	0.058823529411764705	104	10812	10	14	94	10798	10916	0.196738221351182
M1	cpdb	0	network_modules	153	TRUE	2.2620734171426362e-12	507	24	15	0.625	0.029585798816568046	REAC:R-HSA-9006934	REAC	Signaling by Receptor Tyrosine Kinases	10916	2302		0.06060606060606061	0.08823529411764706	507	10409	15	9	492	10400	10916	0.1290479351849488
M1	cpdb	0	network_modules	153	TRUE	2.689102008028031e-12	39	24	8	0.3333333333333333	0.20512820512820512	REAC:R-HSA-9013420	REAC	RHOU GTPase cycle	10916	1874		0.09090909090909091	0.11764705882352941	39	10877	8	16	31	10861	10916	0.2594341980040104
M1	cpdb	0	network_modules	153	TRUE	2.157015878157978e-10	17	24	6	0.25	0.35294117647058826	REAC:R-HSA-3928664	REAC	Ephrin signaling	10916	849		0.12121212121212122	0.14705882352941177	17	10899	6	18	11	10881	10916	0.29574928457815824
M1	cpdb	0	network_modules	153	TRUE	2.5983813817540814e-9	202	17	9	0.5294117647058824	0.04455445544554455	KEGG:04510	KEGG	Focal adhesion	8484	313		0.07692307692307693	0.14285714285714285	202	8282	9	8	193	8274	8484	0.14860247165908713
M1	cpdb	0	network_modules	153	TRUE	1.080503825765776e-8	449	24	12	0.5	0.026726057906458798	REAC:R-HSA-9012999	REAC	RHO GTPase cycle	10916	1847		0.15151515151515152	0.17647058823529413	449	10467	12	12	437	10455	10916	0.10845973865568649
M1	cpdb	0	network_modules	153	TRUE	1.2932389674336658e-8	13	24	5	0.20833333333333334	0.38461538461538464	REAC:R-HSA-8849471	REAC	PTK6 Regulates RHO GTPases, RAS GTPase and MAP kinases	10916	1709		0.18181818181818182	0.23529411764705882	13	10903	5	19	8	10884	10916	0.2819289649687074
M1	cpdb	0	network_modules	153	TRUE	1.2932389674336658e-8	13	24	5	0.20833333333333334	0.38461538461538464	REAC:R-HSA-428540	REAC	Activation of RAC1	10916	94		0.18181818181818182	0.23529411764705882	13	10903	5	19	8	10884	10916	0.2819289649687074
M1	cpdb	0	network_modules	153	TRUE	2.9315539899787722e-8	184	24	9	0.375	0.04891304347826087	REAC:R-HSA-9013149	REAC	RAC1 GTPase cycle	10916	1836		0.24242424242424243	0.2647058823529412	184	10732	9	15	175	10717	10916	0.1305941666728764
M1	cpdb	0	network_modules	153	TRUE	3.415624993452155e-8	279	28	10	0.35714285714285715	0.035842293906810034	GO:0031589	GO:BP	cell-substrate adhesion	16175	7233		0.0392156862745098	0.057692307692307696	279	15896	10	18	269	15878	16175	0.10871134596210326
M1	cpdb	0	network_modules	153	TRUE	3.9386817259632504e-8	37	24	6	0.25	0.16216216216216217	REAC:R-HSA-9013424	REAC	RHOV GTPase cycle	10916	1875		0.2727272727272727	0.29411764705882354	37	10879	6	18	31	10861	10916	0.19917347915028494
M1	cpdb	0	network_modules	153	TRUE	1.3009815069834748e-7	440	28	11	0.39285714285714285	0.025	GO:0051493	GO:BP	regulation of cytoskeleton organization	16175	13748		0.058823529411764705	0.07692307692307693	440	15735	11	17	429	15718	16175	0.09360279020881927
M1	cpdb	0	network_modules	153	TRUE	1.947952206496847e-7	90	24	7	0.2916666666666667	0.07777777777777778	REAC:R-HSA-2682334	REAC	EPH-Ephrin signaling	10916	818		0.30303030303030304	0.3235294117647059	90	10826	7	17	83	10809	10916	0.14712736355510048
M1	cpdb	0	network_modules	153	TRUE	2.0211369502593248e-7	21	24	5	0.20833333333333334	0.23809523809523808	REAC:R-HSA-5627123	REAC	RHO GTPases activate PAKs	10916	1856		0.3333333333333333	0.35294117647058826	21	10895	5	19	16	10876	10916	0.22111685951359575
M1	cpdb	0	network_modules	153	TRUE	2.426184678086735e-7	136	17	7	0.4117647058823529	0.051470588235294115	KEGG:05135	KEGG	Yersinia infection	8484	432		0.15384615384615385	0.21428571428571427	136	8348	7	10	129	8338	8484	0.14118989469988083
M1	cpdb	0	network_modules	153	TRUE	5.458272901421209e-7	84	17	6	0.35294117647058826	0.07142857142857142	KEGG:04012	KEGG	ErbB signaling pathway	8484	245		0.23076923076923078	0.2857142857142857	84	8400	6	11	78	8389	8484	0.1552480143616031
M1	cpdb	0	network_modules	153	TRUE	1.3760033403186295e-6	407	28	10	0.35714285714285715	0.02457002457002457	GO:0007015	GO:BP	actin filament organization	16175	2624		0.0784313725490196	0.09615384615384616	407	15768	10	18	397	15750	16175	0.08826825438409841
M1	cpdb	0	network_modules	153	TRUE	1.8116469604736113e-6	11	24	4	0.16666666666666666	0.36363636363636365	REAC:R-HSA-389359	REAC	CD28 dependent Vav1 pathway	10916	268		0.36363636363636365	0.38235294117647056	11	10905	4	20	7	10885	10916	0.24508747344262508
M1	cpdb	0	network_modules	153	TRUE	2.321599516256634e-6	748	28	12	0.42857142857142855	0.016042780748663103	GO:0097435	GO:BP	supramolecular fiber organization	16175	18657		0.09803921568627451	0.11538461538461539	748	15427	12	16	736	15411	16175	0.0758090523550195
M1	cpdb	0	network_modules	153	TRUE	3.360726732681923e-6	318	28	9	0.32142857142857145	0.02830188679245283	GO:1902903	GO:BP	regulation of supramolecular fiber organization	16175	22602		0.11764705882352941	0.1346153846153846	318	15857	9	19	309	15838	16175	0.09051641828772586
M1	cpdb	0	network_modules	153	TRUE	3.91373126852191e-6	13	24	4	0.16666666666666666	0.3076923076923077	REAC:R-HSA-418885	REAC	DCC mediated attractive signaling	10916	435		0.3939393939393939	0.4117647058823529	13	10903	4	20	9	10883	10916	0.225218996265265
M1	cpdb	0	network_modules	153	TRUE	4.9690806741262515e-6	210	17	7	0.4117647058823529	0.03333333333333333	KEGG:05170	KEGG	Human immunodeficiency virus 1 infection	8484	451		0.3076923076923077	0.35714285714285715	210	8274	7	10	203	8264	8484	0.111613730804339
M1	cpdb	0	network_modules	153	TRUE	9.25996145991272e-6	43	24	5	0.20833333333333334	0.11627906976744186	REAC:R-HSA-445355	REAC	Smooth Muscle Contraction	10916	2336		0.42424242424242425	0.4411764705882353	43	10873	5	19	38	10854	10916	0.15317041735742012
M1	cpdb	0	network_modules	153	TRUE	9.918460603596112e-6	16	24	4	0.16666666666666666	0.25	REAC:R-HSA-399954	REAC	Sema3A PAK dependent Axon repulsion	10916	2189		0.45454545454545453	0.47058823529411764	16	10900	4	20	12	10880	10916	0.20270038548412667
M1	cpdb	0	network_modules	153	TRUE	1.1192665977174098e-5	86	28	6	0.21428571428571427	0.06976744186046512	GO:0034446	GO:BP	substrate adhesion-dependent cell spreading	16175	8640		0.13725490196078433	0.15384615384615385	86	16089	6	22	80	16067	16175	0.11965895880481606
M1	cpdb	0	network_modules	153	TRUE	1.454387390027393e-5	161	28	7	0.25	0.043478260869565216	GO:0032271	GO:BP	regulation of protein polymerization	16175	7452		0.1568627450980392	0.17307692307692307	161	16014	7	21	154	15993	16175	0.10069540924662908
M1	cpdb	0	network_modules	153	TRUE	1.6534102067419432e-5	164	28	7	0.25	0.042682926829268296	GO:0010810	GO:BP	regulation of cell-substrate adhesion	16175	4422		0.17647058823529413	0.19230769230769232	164	16011	7	21	157	15990	16175	0.09970241593970561
M1	cpdb	0	network_modules	153	TRUE	1.8184392906798172e-5	49	24	5	0.20833333333333334	0.10204081632653061	REAC:R-HSA-373752	REAC	Netrin-1 signaling	10916	1586		0.48484848484848486	0.5	49	10867	5	19	44	10848	10916	0.14314015280548614
M1	cpdb	0	network_modules	153	TRUE	1.878186972090873e-5	77	17	5	0.29411764705882354	0.06493506493506493	KEGG:05100	KEGG	Bacterial invasion of epithelial cells	8484	423		0.38461538461538464	0.42857142857142855	77	8407	5	12	72	8395	8484	0.1346799399224114
M1	cpdb	0	network_modules	153	TRUE	2.233599107316646e-5	51	24	5	0.20833333333333334	0.09803921568627451	REAC:R-HSA-9006927	REAC	Signaling by Non-Receptor Tyrosine Kinases	10916	2288		0.5151515151515151	0.5588235294117647	51	10865	5	19	46	10846	10916	0.1401922071805672
M1	cpdb	0	network_modules	153	TRUE	2.233599107316646e-5	51	24	5	0.20833333333333334	0.09803921568627451	REAC:R-HSA-8848021	REAC	Signaling by PTK6	10916	2295		0.5151515151515151	0.5588235294117647	51	10865	5	19	46	10846	10916	0.1401922071805672
M1	cpdb	0	network_modules	153	TRUE	2.446083275667394e-5	274	28	8	0.2857142857142857	0.029197080291970802	GO:0032956	GO:BP	regulation of actin cytoskeleton organization	16175	7940		0.19607843137254902	0.21153846153846154	274	15901	8	20	266	15881	16175	0.08673173777196444
M1	cpdb	0	network_modules	153	TRUE	2.9645864000447598e-5	101	28	6	0.21428571428571427	0.0594059405940594	GO:0007229	GO:BP	integrin-mediated signaling pathway	16175	2779		0.21568627450980393	0.23076923076923078	101	16074	6	22	95	16052	16175	0.10997771986455875
M1	cpdb	0	network_modules	153	TRUE	3.2885814857697635e-5	55	24	5	0.20833333333333334	0.09090909090909091	REAC:R-HSA-9013409	REAC	RHOJ GTPase cycle	10916	1870		0.5757575757575758	0.5882352941176471	55	10861	5	19	50	10842	10916	0.1347800066048857
M1	cpdb	0	network_modules	153	TRUE	4.920191010490983e-5	192	28	7	0.25	0.036458333333333336	GO:0007160	GO:BP	cell-matrix adhesion	16175	2724		0.23529411764705882	0.25	192	15983	7	21	185	15962	16175	0.09156118825583194
M1	cpdb	0	network_modules	153	TRUE	4.981551886866084e-5	53	28	5	0.17857142857142858	0.09433962264150944	GO:1900024	GO:BP	regulation of substrate adhesion-dependent cell spreading	16175	20331		0.2549019607843137	0.2692307692307692	53	16122	5	23	48	16099	16175	0.1277317730817244
M1	cpdb	0	network_modules	153	TRUE	5.40806276212877e-5	181	17	6	0.35294117647058826	0.03314917127071823	KEGG:04360	KEGG	Axon guidance	8484	305		0.46153846153846156	0.5	181	8303	6	11	175	8292	8484	0.10283171837503949
M1	cpdb	0	network_modules	153	TRUE	6.073227069001825e-5	308	28	8	0.2857142857142857	0.025974025974025976	GO:0032970	GO:BP	regulation of actin filament-based process	16175	7953		0.27450980392156865	0.28846153846153844	308	15867	8	20	300	15847	16175	0.08125178948088724
M1	cpdb	0	network_modules	153	TRUE	6.86175562054945e-5	450	28	9	0.32142857142857145	0.02	GO:0030335	GO:BP	positive regulation of cell migration	16175	6781		0.29411764705882354	0.3076923076923077	450	15725	9	19	441	15706	16175	0.07434358104617747
M1	cpdb	0	network_modules	153	TRUE	7.191497172100851e-5	190	17	6	0.35294117647058826	0.031578947368421054	KEGG:04062	KEGG	Chemokine signaling pathway	8484	255		0.5384615384615384	0.5714285714285714	190	8294	6	11	184	8283	8484	0.10009987509759861
M1	cpdb	0	network_modules	153	TRUE	9.241252928127279e-5	632	28	10	0.35714285714285715	0.015822784810126583	GO:0030036	GO:BP	actin cytoskeleton organization	16175	6660		0.3137254901960784	0.3269230769230769	632	15543	10	18	622	15525	16175	0.06835565057304578
M1	cpdb	0	network_modules	153	TRUE	9.411055575701623e-5	27	24	4	0.16666666666666666	0.14814814814814814	REAC:R-HSA-5218920	REAC	VEGFR2 mediated vascular permeability	10916	2636		0.6060606060606061	0.6176470588235294	27	10889	4	20	23	10869	10916	0.15516533568011806
M1	cpdb	0	network_modules	153	TRUE	9.965931497260501e-5	470	28	9	0.32142857142857145	0.019148936170212766	GO:2000147	GO:BP	positive regulation of cell motility	16175	25495		0.3333333333333333	0.34615384615384615	470	15705	9	19	461	15686	16175	0.07248436643542495
M1	cpdb	0	network_modules	153	TRUE	1.070767004223202e-4	215	28	7	0.25	0.03255813953488372	GO:0110053	GO:BP	regulation of actin filament organization	16175	19377		0.35294117647058826	0.36538461538461536	215	15960	7	21	208	15939	16175	0.08607052051409905
M1	cpdb	0	network_modules	153	TRUE	1.1723696203264217e-4	479	28	9	0.32142857142857145	0.018789144050104383	GO:0040017	GO:BP	positive regulation of locomotion	16175	9905		0.37254901960784315	0.38461538461538464	479	15696	9	19	470	15677	16175	0.07168407709041942
M1	cpdb	0	network_modules	153	TRUE	1.3355448474631736e-4	114	17	5	0.29411764705882354	0.043859649122807015	KEGG:04670	KEGG	Leukocyte transendothelial migration	8484	343		0.6153846153846154	0.6428571428571429	114	8370	5	12	109	8358	8484	0.10923393160732599
M1	cpdb	0	network_modules	153	TRUE	1.6516976943681936e-4	119	17	5	0.29411764705882354	0.04201680672268908	KEGG:04660	KEGG	T cell receptor signaling pathway	8484	338		0.6923076923076923	0.7142857142857143	119	8365	5	12	114	8353	8484	0.1067218685198094
M1	cpdb	0	network_modules	153	TRUE	1.6774090349915837e-4	31	24	4	0.16666666666666666	0.12903225806451613	REAC:R-HSA-389356	REAC	Co-stimulation by CD28	10916	378		0.6363636363636364	0.6470588235294118	31	10885	4	20	27	10865	10916	0.14451243288517882
M1	cpdb	0	network_modules	153	TRUE	1.6886116306793117e-4	135	28	6	0.21428571428571427	0.044444444444444446	GO:0051017	GO:BP	actin filament bundle assembly	16175	13442		0.39215686274509803	0.40384615384615385	135	16040	6	22	129	16018	16175	0.09426445744866607
M1	cpdb	0	network_modules	153	TRUE	1.9246580216193847e-4	138	28	6	0.21428571428571427	0.043478260869565216	GO:0061572	GO:BP	actin filament bundle organization	16175	15565		0.4117647058823529	0.4230769230769231	138	16037	6	22	132	16015	16175	0.09315895837479354
M1	cpdb	0	network_modules	153	TRUE	2.1448374358067125e-4	238	28	7	0.25	0.029411764705882353	GO:0051258	GO:BP	protein polymerization	16175	13605		0.43137254901960786	0.4423076923076923	238	15937	7	21	231	15916	16175	0.08137323546524096
M1	cpdb	0	network_modules	153	TRUE	2.5017386181563374e-4	155	24	6	0.25	0.03870967741935484	REAC:R-HSA-9013148	REAC	CDC42 GTPase cycle	10916	269		0.6666666666666666	0.6764705882352942	155	10761	6	18	149	10743	10916	0.09355525402175481
M1	cpdb	0	network_modules	153	TRUE	2.6775182317826236e-4	708	28	10	0.35714285714285715	0.014124293785310734	GO:0030029	GO:BP	actin filament-based process	16175	6653		0.45098039215686275	0.46153846153846156	708	15467	10	18	698	15449	16175	0.06378482274725714
M1	cpdb	0	network_modules	153	TRUE	2.7749857540370227e-4	35	24	4	0.16666666666666666	0.11428571428571428	REAC:R-HSA-202433	REAC	Generation of second messenger molecules	10916	1044		0.696969696969697	0.7058823529411765	35	10881	4	20	31	10861	10916	0.13572484859515913
M1	cpdb	0	network_modules	153	TRUE	2.7904078941657794e-4	7	28	3	0.10714285714285714	0.42857142857142855	GO:0007172	GO:BP	signal complex assembly	16175	2735		0.47058823529411764	0.4807692307692308	7	16168	3	25	4	16143	16175	0.2136513790804247
M1	cpdb	0	network_modules	153	TRUE	3.1578840656125315e-4	150	28	6	0.21428571428571427	0.04	GO:1902905	GO:BP	positive regulation of supramolecular fiber organization	16175	22604		0.49019607843137253	0.5	150	16025	6	22	144	16003	16175	0.08906607645033135
M1	cpdb	0	network_modules	153	TRUE	3.52970881964925e-4	88	24	5	0.20833333333333334	0.056818181818181816	REAC:R-HSA-9013404	REAC	RAC2 GTPase cycle	10916	1837		0.7272727272727273	0.7352941176470589	88	10828	5	19	83	10809	10916	0.10512829308663774
M1	cpdb	0	network_modules	153	TRUE	3.7934038274251166e-4	79	28	5	0.17857142857142858	0.06329113924050633	GO:0032273	GO:BP	positive regulation of protein polymerization	16175	7454		0.5098039215686274	0.5192307692307693	79	16096	5	23	74	16073	16175	0.10374640094831777
M1	cpdb	0	network_modules	153	TRUE	4.136829245522412e-4	157	28	6	0.21428571428571427	0.03821656050955414	GO:0051495	GO:BP	positive regulation of cytoskeleton organization	16175	13750		0.5294117647058824	0.5384615384615384	157	16018	6	22	151	15996	16175	0.08689309451218796
M1	cpdb	0	network_modules	153	TRUE	5.082897241961621e-4	68	17	4	0.23529411764705882	0.058823529411764705	KEGG:05211	KEGG	Renal cell carcinoma	8484	462		0.7692307692307693	0.7857142857142857	68	8416	4	13	64	8403	8484	0.11421217152865427
M1	cpdb	0	network_modules	153	TRUE	6.160403816708705e-4	87	28	5	0.17857142857142858	0.05747126436781609	GO:0010811	GO:BP	positive regulation of cell-substrate adhesion	16175	4423		0.5490196078431373	0.5576923076923077	87	16088	5	23	82	16065	16175	0.09860443635270454
M1	cpdb	0	network_modules	153	TRUE	6.656468876651072e-4	781	28	10	0.35714285714285715	0.012804097311139564	GO:0030334	GO:BP	regulation of cell migration	16175	6780		0.5686274509803921	0.5769230769230769	781	15394	10	18	771	15376	16175	0.05999784293734135
M1	cpdb	0	network_modules	153	TRUE	7.021541261267597e-4	36	28	4	0.14285714285714285	0.1111111111111111	GO:1900026	GO:BP	positive regulation of substrate adhesion-dependent cell spreading	16175	20333		0.5882352941176471	0.5961538461538461	36	16139	4	24	32	16115	16175	0.12427116992879121
M1	cpdb	0	network_modules	153	TRUE	7.301303892142018e-4	90	28	5	0.17857142857142858	0.05555555555555555	GO:0043149	GO:BP	stress fiber assembly	16175	10553		0.6078431372549019	0.6346153846153846	90	16085	5	23	85	16062	16175	0.09685231130986062
M1	cpdb	0	network_modules	153	TRUE	7.301303892142018e-4	90	28	5	0.17857142857142858	0.05555555555555555	GO:0030038	GO:BP	contractile actin filament bundle assembly	16175	6661		0.6078431372549019	0.6346153846153846	90	16085	5	23	85	16062	16175	0.09685231130986062
M1	cpdb	0	network_modules	153	TRUE	7.662440965654847e-4	793	28	10	0.35714285714285715	0.012610340479192938	GO:0044087	GO:BP	regulation of cellular component biogenesis	16175	10909		0.6470588235294118	0.6538461538461539	793	15382	10	18	783	15364	16175	0.059422299882865466
M1	cpdb	0	network_modules	153	TRUE	0.0010617772617161237	97	28	5	0.17857142857142858	0.05154639175257732	GO:0007173	GO:BP	epidermal growth factor receptor signaling pathway	16175	2736		0.6666666666666666	0.6730769230769231	97	16078	5	23	92	16055	16175	0.09307910026427317
M1	cpdb	0	network_modules	153	TRUE	0.0011618924424725851	318	24	7	0.2916666666666667	0.0220125786163522	REAC:R-HSA-195258	REAC	RHO GTPase Effectors	10916	1846		0.7575757575757576	0.7647058823529411	318	10598	7	17	311	10581	10916	0.07327860898405011
M1	cpdb	0	network_modules	153	TRUE	0.0013093888251545815	11	28	3	0.10714285714285714	0.2727272727272727	GO:0048012	GO:BP	hepatocyte growth factor receptor signaling pathway	16175	12468		0.6862745098039216	0.6923076923076923	11	16164	3	25	8	16139	16175	0.17006090420272324
M1	cpdb	0	network_modules	153	TRUE	0.001326566651643673	638	28	9	0.32142857142857145	0.014106583072100314	GO:0018193	GO:BP	peptidyl-amino acid modification	16175	5353		0.7058823529411765	0.7115384615384616	638	15537	9	19	629	15518	16175	0.06032668275461392
M1	cpdb	0	network_modules	153	TRUE	0.0013873202890084442	116	24	5	0.20833333333333334	0.04310344827586207	REAC:R-HSA-2029482	REAC	Regulation of actin dynamics for phagocytic cup formation	10916	2020		0.7878787878787878	0.7941176470588235	116	10800	5	19	111	10781	10916	0.09050986406780816
M1	cpdb	0	network_modules	153	TRUE	0.0014420464297733616	466	28	8	0.2857142857142857	0.017167381974248927	GO:0120035	GO:BP	regulation of plasma membrane bounded cell projection organization	16175	19471		0.7254901960784313	0.7307692307692307	466	15709	8	20	458	15689	16175	0.06395605780440891
M1	cpdb	0	network_modules	153	TRUE	0.0016028596601759685	44	28	4	0.14285714285714285	0.09090909090909091	GO:0048013	GO:BP	ephrin receptor signaling pathway	16175	12469		0.7450980392156863	0.75	44	16131	4	24	40	16107	16175	0.11203994602113224
M1	cpdb	0	network_modules	153	TRUE	0.0018020700450499692	480	28	8	0.2857142857142857	0.016666666666666666	GO:0031344	GO:BP	regulation of cell projection organization	16175	7135		0.7647058823529411	0.7692307692307693	480	15695	8	20	472	15675	16175	0.06283215997453882
M1	cpdb	0	network_modules	153	TRUE	0.0019359430284191998	197	17	5	0.29411764705882354	0.025380710659898477	KEGG:05130	KEGG	Pathogenic Escherichia coli infection	8484	427		0.8461538461538461	0.8571428571428571	197	8287	5	12	192	8275	8484	0.08059971456641415
M1	cpdb	0	network_modules	153	TRUE	0.002171198638408434	112	28	5	0.17857142857142858	0.044642857142857144	GO:0038127	GO:BP	ERBB signaling pathway	16175	9716		0.7843137254901961	0.7884615384615384	112	16063	5	23	107	16040	16175	0.08619690463860415
M1	cpdb	0	network_modules	153	TRUE	0.0023285685940436247	59	24	4	0.16666666666666666	0.06779661016949153	REAC:R-HSA-9013406	REAC	RHOQ GTPase cycle	10916	1871		0.8181818181818182	0.8235294117647058	59	10857	4	20	55	10837	10916	0.1032442306945215
M1	cpdb	0	network_modules	153	TRUE	0.002448369119557518	500	28	8	0.2857142857142857	0.016	GO:0001934	GO:BP	positive regulation of protein phosphorylation	16175	548		0.803921568627451	0.8076923076923077	500	15675	8	20	492	15655	16175	0.06130446314611922
M1	cpdb	0	network_modules	153	TRUE	0.0026739064598206713	346	28	7	0.25	0.02023121387283237	GO:0043254	GO:BP	regulation of protein-containing complex assembly	16175	10588		0.8235294117647058	0.8269230769230769	346	15829	7	21	339	15808	16175	0.065796963234091
M1	cpdb	0	network_modules	153	TRUE	0.002926219051497722	51	28	4	0.14285714285714285	0.0784313725490196	GO:0048010	GO:BP	vascular endothelial growth factor receptor signaling pathway	16175	12466		0.8431372549019608	0.8461538461538461	51	16124	4	24	47	16100	16175	0.10376840502119047
M1	cpdb	0	network_modules	153	TRUE	0.003206190206104885	20	24	3	0.125	0.15	REAC:R-HSA-5621575	REAC	CD209 (DC-SIGN) signaling	10916	265		0.8484848484848485	0.8529411764705882	20	10896	3	21	17	10875	10916	0.13519606957514896
M1	cpdb	0	network_modules	153	TRUE	0.003227002395259175	64	24	4	0.16666666666666666	0.0625	REAC:R-HSA-373755	REAC	Semaphorin interactions	10916	2193		0.8787878787878788	0.8823529411764706	64	10852	4	20	60	10832	10916	0.09887045323784183
M1	cpdb	0	network_modules	153	TRUE	0.0033789616936474583	522	28	8	0.2857142857142857	0.01532567049808429	GO:0042327	GO:BP	positive regulation of phosphorylation	16175	10095		0.8627450980392157	0.8653846153846154	522	15653	8	20	514	15633	16175	0.059720353885603095
M1	cpdb	0	network_modules	153	TRUE	0.003482555000681608	140	24	5	0.20833333333333334	0.03571428571428571	REAC:R-HSA-2029480	REAC	Fcgamma receptor (FCGR) dependent phagocytosis	10916	939		0.9090909090909091	0.9117647058823529	140	10776	5	19	135	10757	10916	0.08156189878856011
M1	cpdb	0	network_modules	153	TRUE	0.003509025219466342	223	17	5	0.29411764705882354	0.02242152466367713	KEGG:05163	KEGG	Human cytomegalovirus infection	8484	444		0.9230769230769231	0.9285714285714286	223	8261	5	12	218	8249	8484	0.07501627281215081
M1	cpdb	0	network_modules	153	TRUE	0.003875750949508512	67	24	4	0.16666666666666666	0.05970149253731343	REAC:R-HSA-388841	REAC	Regulation of T cell activation by CD28 family	10916	2007		0.9393939393939394	0.9411764705882353	67	10849	4	20	63	10829	10916	0.09647977253178794
M1	cpdb	0	network_modules	153	TRUE	0.0047508814057126945	744	28	9	0.32142857142857145	0.012096774193548387	GO:0001932	GO:BP	regulation of protein phosphorylation	16175	546		0.8823529411764706	0.8846153846153846	744	15431	9	19	735	15412	16175	0.05475297766628594
M1	cpdb	0	network_modules	153	TRUE	0.004869537416898183	150	24	5	0.20833333333333334	0.03333333333333333	REAC:R-HSA-1500931	REAC	Cell-Cell communication	10916	328		0.9696969696969697	0.9705882352941176	150	10766	5	19	145	10747	10916	0.0784634819321006
M1	cpdb	0	network_modules	153	TRUE	0.0049268687254813235	58	28	4	0.14285714285714285	0.06896551724137931	GO:0031113	GO:BP	regulation of microtubule polymerization	16175	7038		0.9019607843137255	0.9038461538461539	58	16117	4	24	54	16093	16175	0.09702487825210347
M1	cpdb	0	network_modules	153	TRUE	0.005600343215789051	246	17	5	0.29411764705882354	0.02032520325203252	KEGG:05131	KEGG	Shigellosis	8484	428		1	1	246	8238	5	12	241	8226	8484	0.07079905826086834
M1	cpdb	0	network_modules	153	TRUE	0.006010167492960805	564	28	8	0.2857142857142857	0.014184397163120567	GO:0010562	GO:BP	positive regulation of phosphorus metabolic process	16175	4215		0.9215686274509803	0.9423076923076923	564	15611	8	20	556	15591	16175	0.0569415208137625
M1	cpdb	0	network_modules	153	TRUE	0.006010167492960805	564	28	8	0.2857142857142857	0.014184397163120567	GO:0045937	GO:BP	positive regulation of phosphate metabolic process	16175	11731		0.9215686274509803	0.9423076923076923	564	15611	8	20	556	15591	16175	0.0569415208137625
M1	cpdb	0	network_modules	153	TRUE	0.00761867105046191	19	28	3	0.10714285714285714	0.15789473684210525	GO:0010968	GO:BP	regulation of microtubule nucleation	16175	4544		0.9607843137254902	0.9615384615384616	19	16156	3	25	16	16131	16175	0.1288276952064913
M1	cpdb	0	network_modules	153	TRUE	0.007854327265953432	791	28	9	0.32142857142857145	0.011378002528445006	GO:1901701	GO:BP	cellular response to oxygen-containing compound	16175	21654		0.9803921568627451	0.9807692307692307	791	15384	9	19	782	15365	16175	0.05262139505319064
M1	cpdb	0	network_modules	153	TRUE	0.00793590139902407	792	28	9	0.32142857142857145	0.011363636363636364	GO:0042325	GO:BP	regulation of phosphorylation	16175	10093		1	1	792	15383	9	19	783	15364	16175	0.052577942987588826
M1	cpdb	0	network_modules	153	TRUE	0.0085563803106996	4	24	2	0.08333333333333333	0.5	REAC:R-HSA-9032759	REAC	NTRK2 activates RAC1	10916	1554		1	1	4	10912	2	22	2	10890	10916	0.20348763012649823
M1	cpdb	0	network_modules	156	TRUE	4.051109841675854e-6	18	17	4	0.23529411764705882	0.2222222222222222	REAC:R-HSA-1369062	REAC	ABC transporters in lipid homeostasis	10916	8		0	0.2	18	10898	4	13	14	10885	10916	0.2274268832846812
M1	cpdb	0	network_modules	156	TRUE	1.949764569551933e-5	45	12	4	0.3333333333333333	0.08888888888888889	KEGG:02010	KEGG	ABC transporters	8484	199		0	0.5	45	8439	4	8	41	8431	8484	0.16996484614717783
M1	cpdb	0	network_modules	156	TRUE	7.609574657788746e-4	2	17	2	0.11764705882352941	1	REAC:R-HSA-5679096	REAC	Defective ABCG5 causes sitosterolemia	10916	471		0.25	0.6	2	10914	2	15	0	10899	10916	0.3427613847547913
M1	cpdb	0	network_modules	156	TRUE	7.609574657788746e-4	2	17	2	0.11764705882352941	1	REAC:R-HSA-5679090	REAC	Defective ABCG8 causes GBD4 and sitosterolemia	10916	472		0.25	0.6	2	10914	2	15	0	10899	10916	0.3427613847547913
M1	cpdb	0	network_modules	156	TRUE	0.0015204924041175743	43	12	3	0.25	0.06976744186046512	KEGG:04975	KEGG	Fat digestion and absorption	8484	406		1	1	43	8441	3	9	40	8432	8484	0.1298111552039502
M1	cpdb	0	network_modules	156	TRUE	0.0018712357345051357	52	26	4	0.15384615384615385	0.07692307692307693	GO:0033344	GO:BP	cholesterol efflux	16175	8154		0	0.125	52	16123	4	22	48	16101	16175	0.106769895579598
M1	cpdb	0	network_modules	156	TRUE	0.003450794777497106	2	26	2	0.07692307692307693	1	GO:0010949	GO:BP	negative regulation of intestinal phytosterol absorption	16175	4527		0.14285714285714285	0.625	2	16173	2	24	0	16149	16175	0.27714423421480233
M1	cpdb	0	network_modules	156	TRUE	0.003450794777497106	2	26	2	0.07692307692307693	1	GO:0060752	GO:BP	intestinal phytosterol absorption	16175	14920		0.14285714285714285	0.625	2	16173	2	24	0	16149	16175	0.27714423421480233
M1	cpdb	0	network_modules	156	TRUE	0.003450794777497106	2	26	2	0.07692307692307693	1	GO:0045796	GO:BP	negative regulation of intestinal cholesterol absorption	16175	11624		0.14285714285714285	0.625	2	16173	2	24	0	16149	16175	0.27714423421480233
M1	cpdb	0	network_modules	156	TRUE	0.003450794777497106	2	26	2	0.07692307692307693	1	GO:1904730	GO:BP	negative regulation of intestinal lipid absorption	16175	24060		0.14285714285714285	0.625	2	16173	2	24	0	16149	16175	0.27714423421480233
M1	cpdb	0	network_modules	156	TRUE	0.00411224180584779	18	26	3	0.11538461538461539	0.16666666666666666	GO:0098856	GO:BP	intestinal lipid absorption	16175	18913		0.7142857142857143	0.75	18	16157	3	23	15	16134	16175	0.13752465046393864
M1	cpdb	0	network_modules	156	TRUE	0.005396708728085686	103	17	4	0.23529411764705882	0.038834951456310676	REAC:R-HSA-382556	REAC	ABC-family proteins mediated transport	10916	9		0.75	0.8	103	10813	4	13	99	10800	10916	0.09226548023245013
M1	cpdb	0	network_modules	156	TRUE	0.0072338247285523025	36	17	3	0.17647058823529413	0.08333333333333333	REAC:R-HSA-9029569	REAC	NR1H3 & NR1H2 regulate gene expression linked to cholesterol transport and efflux	10916	1547		1	1	36	10880	3	14	33	10866	10916	0.11929117976265428
M1	cpdb	0	network_modules	156	TRUE	0.007764731613962329	74	26	4	0.15384615384615385	0.05405405405405406	GO:0042632	GO:BP	cholesterol homeostasis	16175	10265		0.8571428571428571	0.875	74	16101	4	22	70	16079	16175	0.08875480281703874
M1	cpdb	0	network_modules	156	TRUE	0.008193250838074054	75	26	4	0.15384615384615385	0.05333333333333334	GO:0055092	GO:BP	sterol homeostasis	16175	14242		1	1	75	16100	4	22	71	16078	16175	0.08812734150918672
M1	cpdb	0	network_modules	157	TRUE	1.1030733651538385e-6	8	6	3	0.5	0.375	REAC:R-HSA-75158	REAC	TRAIL  signaling	10916	2470		0	0.14285714285714285	8	10908	3	3	5	10905	10916	0.4326554652539553
M1	cpdb	0	network_modules	157	TRUE	1.1638436604252137e-4	153	6	4	0.6666666666666666	0.026143790849673203	REAC:R-HSA-73887	REAC	Death Receptor Signaling	10916	455		0.16666666666666666	0.2857142857142857	153	10763	4	2	149	10761	10916	0.1301952366664236
M1	cpdb	0	network_modules	157	TRUE	7.205502237488851e-4	98	5	3	0.6	0.030612244897959183	KEGG:04061	KEGG	Viral protein interaction with cytokine and cytokine receptor	8484	254		NA	1	98	8386	3	2	95	8384	8484	0.13373084604634228
M1	cpdb	0	network_modules	157	TRUE	0.0024163037408110387	10	6	2	0.3333333333333333	0.2	REAC:R-HSA-3371378	REAC	Regulation by c-FLIP	10916	1962		0.3333333333333333	0.7142857142857143	10	10906	2	4	8	10902	10916	0.2576781409088113
M1	cpdb	0	network_modules	157	TRUE	0.0024163037408110387	10	6	2	0.3333333333333333	0.2	REAC:R-HSA-69416	REAC	Dimerization of procaspase-8	10916	745		0.3333333333333333	0.7142857142857143	10	10906	2	4	8	10902	10916	0.2576781409088113
M1	cpdb	0	network_modules	157	TRUE	0.0024163037408110387	10	6	2	0.3333333333333333	0.2	REAC:R-HSA-5218900	REAC	CASP8 activity is inhibited	10916	263		0.3333333333333333	0.7142857142857143	10	10906	2	4	8	10902	10916	0.2576781409088113
M1	cpdb	0	network_modules	157	TRUE	0.0035421800031743915	12	6	2	0.3333333333333333	0.16666666666666666	REAC:R-HSA-6803211	REAC	TP53 Regulates Transcription of Death Receptors and Ligands	10916	2457		0.8333333333333334	0.8571428571428571	12	10904	2	4	10	10900	10916	0.23511879436218117
M1	cpdb	0	network_modules	157	TRUE	0.005631154960289099	15	6	2	0.3333333333333333	0.13333333333333333	REAC:R-HSA-140534	REAC	Caspase activation via Death Receptors in the presence of ligand	10916	313		1	1	15	10901	2	4	13	10897	10916	0.21015159549681772
M1	cpdb	0	network_modules	158	TRUE	2.451438090567583e-14	210	22	13	0.5909090909090909	0.06190476190476191	KEGG:04015	KEGG	Rap1 signaling pathway	8484	248		0	0.2	210	8274	13	9	197	8265	8484	0.18579955547728721
M1	cpdb	0	network_modules	158	TRUE	2.8016962166092633e-14	15	19	7	0.3684210526315789	0.4666666666666667	REAC:R-HSA-392517	REAC	Rap1 signalling	10916	1940		0	0.25	15	10901	7	12	8	10889	10916	0.41374202932742243
M1	cpdb	0	network_modules	158	TRUE	1.7053395858723162e-11	389	27	13	0.48148148148148145	0.033419023136246784	GO:0007264	GO:BP	small GTPase-mediated signal transduction	16175	2792		0	0.14285714285714285	389	15786	13	14	376	15772	16175	0.12209068072754868
M1	cpdb	0	network_modules	158	TRUE	6.436342445784822e-9	103	27	8	0.2962962962962963	0.07766990291262135	GO:0007265	GO:BP	Ras protein signal transduction	16175	2793		0.16666666666666666	0.2857142857142857	103	16072	8	19	95	16053	16175	0.1490404154880986
M1	cpdb	0	network_modules	158	TRUE	1.8457337001704022e-7	26	19	5	0.2631578947368421	0.19230769230769232	REAC:R-HSA-354192	REAC	Integrin signaling	10916	1217		0.3333333333333333	0.5	26	10890	5	14	21	10876	10916	0.22338498279929966
M1	cpdb	0	network_modules	158	TRUE	1.3904205554221862e-6	38	19	5	0.2631578947368421	0.13157894736842105	REAC:R-HSA-76009	REAC	Platelet Aggregation (Plug Formation)	10916	1761		0.6666666666666666	0.75	38	10878	5	14	33	10864	10916	0.1840999287872525
M1	cpdb	0	network_modules	158	TRUE	9.073563983375348e-5	235	22	7	0.3181818181818182	0.029787234042553193	KEGG:04014	KEGG	Ras signaling pathway	8484	247		0.25	0.4	235	8249	7	15	228	8234	8484	0.09025287794349993
M1	cpdb	0	network_modules	158	TRUE	9.615806960482273e-5	147	22	6	0.2727272727272727	0.04081632653061224	KEGG:04072	KEGG	Phospholipase D signaling pathway	8484	261		0.5	0.6	147	8337	6	16	141	8321	8484	0.09980073342788011
M1	cpdb	0	network_modules	158	TRUE	2.1404973844530375e-4	93	22	5	0.22727272727272727	0.053763440860215055	KEGG:04520	KEGG	Adherens junction	8484	316		0.75	0.8	93	8391	5	17	88	8374	8484	0.10592673666044353
M1	cpdb	0	network_modules	158	TRUE	5.836576829057289e-4	114	22	5	0.22727272727272727	0.043859649122807015	KEGG:04670	KEGG	Leukocyte transendothelial migration	8484	343		1	1	114	8370	5	17	109	8353	8484	0.09469792988752099
M1	cpdb	0	network_modules	158	TRUE	7.334272203511683e-4	183	27	6	0.2222222222222222	0.03278688524590164	GO:0043087	GO:BP	regulation of GTPase activity	16175	10520		0.3333333333333333	0.42857142857142855	183	15992	6	21	177	15971	16175	0.08154247318080507
M1	cpdb	0	network_modules	158	TRUE	0.001122334074880342	259	19	6	0.3157894736842105	0.023166023166023165	REAC:R-HSA-76002	REAC	Platelet activation, signaling and aggregation	10916	1762		1	1	259	10657	6	13	253	10644	10916	0.08013011793902458
M1	cpdb	0	network_modules	158	TRUE	0.0014116110841080967	12	27	3	0.1111111111111111	0.25	GO:0032486	GO:BP	Rap protein signal transduction	16175	7597		0.5	0.5714285714285714	12	16163	3	24	9	16139	16175	0.16575368276393845
M1	cpdb	0	network_modules	158	TRUE	0.0030278427052398537	127	27	5	0.18518518518518517	0.03937007874015748	GO:0043547	GO:BP	positive regulation of GTPase activity	16175	10762		0.6666666666666666	0.7142857142857143	127	16048	5	22	122	16026	16175	0.08215716054450467
M1	cpdb	0	network_modules	158	TRUE	0.004192715654658986	2	27	2	0.07407407407407407	1	GO:2000299	GO:BP	negative regulation of Rho-dependent protein serine/threonine kinase activity	16175	25621		0.8333333333333334	0.8571428571428571	2	16173	2	25	0	16148	16175	0.27195509076604235
M1	cpdb	0	network_modules	158	TRUE	0.006169238979555305	19	27	3	0.1111111111111111	0.15789473684210525	GO:2000300	GO:BP	regulation of synaptic vesicle exocytosis	16175	25622		1	1	19	16156	3	24	16	16132	16175	0.13123957709566395
M1	cpdb	0	network_modules	159	TRUE	7.344173587895144e-10	11	17	5	0.29411764705882354	0.45454545454545453	REAC:R-HSA-5625970	REAC	RHO GTPases activate KTN1	10916	1855		0	0.1	11	10905	5	12	6	10893	10916	0.3648514260827194
M1	cpdb	0	network_modules	159	TRUE	1.7794435521187464e-7	348	27	10	0.37037037037037035	0.028735632183908046	GO:0007018	GO:BP	microtubule-based movement	16175	2626		0	0.07142857142857142	348	15827	10	17	338	15810	16175	0.09831588328858572
M1	cpdb	0	network_modules	159	TRUE	8.299857555132584e-6	60	17	5	0.29411764705882354	0.08333333333333333	REAC:R-HSA-983189	REAC	Kinesins	10916	1292		0.1111111111111111	0.2	60	10856	5	12	55	10844	10916	0.15417439001838362
M1	cpdb	0	network_modules	159	TRUE	1.043834311678177e-5	5	17	3	0.17647058823529413	0.6	REAC:R-HSA-9013425	REAC	RHOT1 GTPase cycle	10916	1872		0.2222222222222222	0.3	5	10911	3	14	2	10897	10916	0.3248785243572749
M1	cpdb	0	network_modules	159	TRUE	1.1158546964395035e-5	42	27	5	0.18518518518518517	0.11904761904761904	GO:0008089	GO:BP	anterograde axonal transport	16175	3120		0.07692307692307693	0.14285714285714285	42	16133	5	22	37	16111	16175	0.14670949194142402
M1	cpdb	0	network_modules	159	TRUE	1.596727798732918e-5	249	17	7	0.4117647058823529	0.028112449799196786	KEGG:05132	KEGG	Salmonella infection	8484	429		0	0.14285714285714285	249	8235	7	10	242	8225	8484	0.101522936974664
M1	cpdb	0	network_modules	159	TRUE	3.664876317291361e-5	19	27	4	0.14814814814814814	0.21052631578947367	GO:0047497	GO:BP	mitochondrion transport along microtubule	16175	12459		0.15384615384615385	0.2857142857142857	19	16156	4	23	15	16133	16175	0.17545352693158756
M1	cpdb	0	network_modules	159	TRUE	3.664876317291361e-5	19	27	4	0.14814814814814814	0.21052631578947367	GO:0034643	GO:BP	establishment of mitochondrion localization, microtubule-mediated	16175	8705		0.15384615384615385	0.2857142857142857	19	16156	4	23	15	16133	16175	0.17545352693158756
M1	cpdb	0	network_modules	159	TRUE	4.0922506061505464e-5	54	27	5	0.18518518518518517	0.09259259259259259	GO:0098930	GO:BP	axonal transport	16175	18959		0.3076923076923077	0.35714285714285715	54	16121	5	22	49	16099	16175	0.12890784734082275
M1	cpdb	0	network_modules	159	TRUE	5.828615162144252e-5	8	17	3	0.17647058823529413	0.375	REAC:R-HSA-9715370	REAC	Miro GTPase Cycle	10916	1454		0.3333333333333333	0.4	8	10908	3	14	5	10894	10916	0.2564732578983867
M1	cpdb	0	network_modules	159	TRUE	7.637173131794986e-5	61	27	5	0.18518518518518517	0.08196721311475409	GO:0008088	GO:BP	axo-dendritic transport	16175	3119		0.38461538461538464	0.42857142857142855	61	16114	5	22	56	16092	16175	0.12102381621061131
M1	cpdb	0	network_modules	159	TRUE	7.883400784122777e-5	193	17	6	0.35294117647058826	0.031088082901554404	KEGG:04814	KEGG	Motor proteins	8484	366		0.16666666666666666	0.2857142857142857	193	8291	6	11	187	8280	8484	0.09923054978461661
M1	cpdb	0	network_modules	159	TRUE	9.990172978933918e-5	24	27	4	0.14814814814814814	0.16666666666666666	GO:0051654	GO:BP	establishment of mitochondrion localization	16175	13867		0.46153846153846156	0.5	24	16151	4	23	20	16128	16175	0.1558066942008116
M1	cpdb	0	network_modules	159	TRUE	1.0486096994172088e-4	99	17	5	0.29411764705882354	0.050505050505050504	REAC:R-HSA-6811434	REAC	COPI-dependent Golgi-to-ER retrograde traffic	10916	277		0.4444444444444444	0.5	99	10817	5	12	94	10805	10916	0.11875235830049677
M1	cpdb	0	network_modules	159	TRUE	1.7779333366168466e-4	144	27	6	0.2222222222222222	0.041666666666666664	GO:0010970	GO:BP	transport along microtubule	16175	4546		0.5384615384615384	0.5714285714285714	144	16031	6	21	138	16010	16175	0.09286156484144767
M1	cpdb	0	network_modules	159	TRUE	1.9021205661192244e-4	73	27	5	0.18518518518518517	0.0684931506849315	GO:0072384	GO:BP	organelle transport along microtubule	16175	17378		0.6153846153846154	0.6428571428571429	73	16102	5	22	68	16080	16175	0.11021898985686113
M1	cpdb	0	network_modules	159	TRUE	3.098523061586201e-4	123	17	5	0.29411764705882354	0.04065040650406504	REAC:R-HSA-2132295	REAC	MHC class II antigen presentation	10916	1371		0.5555555555555556	0.6	123	10793	5	12	118	10781	10916	0.10583440379665028
M1	cpdb	0	network_modules	159	TRUE	3.984175565570283e-4	165	27	6	0.2222222222222222	0.03636363636363636	GO:0099111	GO:BP	microtubule-based transport	16175	19044		0.6923076923076923	0.7142857142857143	165	16010	6	21	159	15989	16175	0.08627970380325602
M1	cpdb	0	network_modules	159	TRUE	4.566658487109233e-4	133	17	5	0.29411764705882354	0.03759398496240601	REAC:R-HSA-8856688	REAC	Golgi-to-ER retrograde transport	10916	1084		0.6666666666666666	0.7	133	10783	5	12	128	10771	10916	0.10149532169614928
M1	cpdb	0	network_modules	159	TRUE	4.974526565610225e-4	265	17	6	0.35294117647058826	0.022641509433962263	KEGG:05012	KEGG	Parkinson disease	8484	412		0.3333333333333333	0.42857142857142855	265	8219	6	11	259	8208	8484	0.0828680182259778
M1	cpdb	0	network_modules	159	TRUE	5.658267764033796e-4	271	17	6	0.35294117647058826	0.02214022140221402	KEGG:05020	KEGG	Prion disease	8484	416		0.5	0.5714285714285714	271	8213	6	11	265	8202	8484	0.08179524407136388
M1	cpdb	0	network_modules	159	TRUE	7.81809304747836e-4	185	27	6	0.2222222222222222	0.032432432432432434	GO:0030705	GO:BP	cytoskeleton-dependent intracellular transport	16175	6886		0.7692307692307693	0.7857142857142857	185	15990	6	21	179	15969	16175	0.08105802798265244
M1	cpdb	0	network_modules	159	TRUE	8.4370384305119e-4	40	27	4	0.14814814814814814	0.1	GO:0051646	GO:BP	mitochondrion localization	16175	13859		0.8461538461538461	0.8571428571428571	40	16135	4	23	36	16112	16175	0.11993278861516482
M1	cpdb	0	network_modules	159	TRUE	0.0011132121644566778	305	17	6	0.35294117647058826	0.019672131147540985	KEGG:05016	KEGG	Huntington disease	8484	414		0.6666666666666666	0.7142857142857143	305	8179	6	11	299	8168	8484	0.07629699937646599
M1	cpdb	0	network_modules	159	TRUE	0.001487402781396774	169	17	5	0.29411764705882354	0.029585798816568046	REAC:R-HSA-983231	REAC	Factors involved in megakaryocyte development and platelet production	10916	931		0.7777777777777778	0.8	169	10747	5	12	164	10735	10916	0.08913424236223119
M1	cpdb	0	network_modules	159	TRUE	0.0018330523440763533	13	27	3	0.1111111111111111	0.23076923076923078	GO:0019896	GO:BP	axonal transport of mitochondrion	16175	6066		0.9230769230769231	0.9285714285714286	13	16162	3	24	10	16138	16175	0.15916670598500132
M1	cpdb	0	network_modules	159	TRUE	0.002155290776589313	519	27	8	0.2962962962962963	0.015414258188824663	GO:0051640	GO:BP	organelle localization	16175	13853		1	1	519	15656	8	19	511	15637	16175	0.061304385619837184
M1	cpdb	0	network_modules	159	TRUE	0.002984700421777064	363	17	6	0.35294117647058826	0.01652892561983471	KEGG:05014	KEGG	Amyotrophic lateral sclerosis	8484	413		0.8333333333333334	0.8571428571428571	363	8121	6	11	357	8110	8484	0.06867216138694654
M1	cpdb	0	network_modules	159	TRUE	0.0035543116885967713	202	17	5	0.29411764705882354	0.024752475247524754	REAC:R-HSA-6811442	REAC	Intra-Golgi and retrograde Golgi-to-ER traffic	10916	1262		0.8888888888888888	0.9	202	10714	5	12	197	10702	10916	0.08076856772535462
M1	cpdb	0	network_modules	159	TRUE	0.0039745662876088965	382	17	6	0.35294117647058826	0.015706806282722512	KEGG:05010	KEGG	Alzheimer disease	8484	411		1	1	382	8102	6	11	376	8091	8484	0.06653707906751109
M1	cpdb	0	network_modules	159	TRUE	0.007588677859020828	5	17	2	0.11764705882352941	0.4	REAC:R-HSA-9667769	REAC	Acetylcholine inhibits contraction of outer hair cells	10916	55		1	1	5	10911	2	15	3	10896	10916	0.21630386887908817
M1	cpdb	0	network_modules	160	TRUE	3.778162146722575e-29	23	22	13	0.5909090909090909	0.5652173913043478	REAC:R-HSA-5620922	REAC	BBSome-mediated cargo-targeting to cilium	10916	199		0	0.25	23	10893	13	9	10	10884	10916	0.5770492175640715
M1	cpdb	0	network_modules	160	TRUE	1.539328970970643e-23	51	22	13	0.5909090909090909	0.2549019607843137	REAC:R-HSA-5620920	REAC	Cargo trafficking to the periciliary membrane	10916	310		0.3333333333333333	0.5	51	10865	13	9	38	10856	10916	0.3863264921631861
M1	cpdb	0	network_modules	160	TRUE	2.5439074168063077e-15	200	22	13	0.5909090909090909	0.065	REAC:R-HSA-5617833	REAC	Cilium Assembly	10916	361		0.6666666666666666	0.75	200	10716	13	9	187	10707	10916	0.19186315833889184
M1	cpdb	0	network_modules	160	TRUE	3.6827695733316906e-13	292	22	13	0.5909090909090909	0.04452054794520548	REAC:R-HSA-1852241	REAC	Organelle biogenesis and maintenance	10916	1646		1	1	292	10624	13	9	279	10615	10916	0.15712580928656736
M1	cpdb	0	network_modules	160	TRUE	3.961632993168109e-11	343	25	12	0.48	0.03498542274052478	GO:0060271	GO:BP	cilium assembly	16175	14488		0	0.0196078431372549	343	15832	12	13	331	15819	16175	0.12529427341149263
M1	cpdb	0	network_modules	160	TRUE	9.164492846988328e-11	368	25	12	0.48	0.03260869565217391	GO:0044782	GO:BP	cilium organization	16175	11155		0.02	0.0392156862745098	368	15807	12	13	356	15794	16175	0.12065130049379909
M1	cpdb	0	network_modules	160	TRUE	1.8672775623934348e-10	18	25	6	0.24	0.3333333333333333	GO:0051904	GO:BP	pigment granule transport	16175	13987		0.04	0.0784313725490196	18	16157	6	19	12	16138	16175	0.28190595089194276
M1	cpdb	0	network_modules	160	TRUE	1.8672775623934348e-10	18	25	6	0.24	0.3333333333333333	GO:0032402	GO:BP	melanosome transport	16175	7546		0.04	0.0784313725490196	18	16157	6	19	12	16138	16175	0.28190595089194276
M1	cpdb	0	network_modules	160	TRUE	2.72634808685148e-10	19	25	6	0.24	0.3157894736842105	GO:0032401	GO:BP	establishment of melanosome localization	16175	7545		0.08	0.11764705882352941	19	16156	6	19	13	16137	16175	0.2743245821911035
M1	cpdb	0	network_modules	160	TRUE	2.72634808685148e-10	19	25	6	0.24	0.3157894736842105	GO:0051905	GO:BP	establishment of pigment granule localization	16175	13988		0.08	0.11764705882352941	19	16156	6	19	13	16137	16175	0.2743245821911035
M1	cpdb	0	network_modules	160	TRUE	5.441712693257252e-10	21	25	6	0.24	0.2857142857142857	GO:0032400	GO:BP	melanosome localization	16175	7544		0.12	0.1568627450980392	21	16154	6	19	15	16135	16175	0.26081577534057704
M1	cpdb	0	network_modules	160	TRUE	5.441712693257252e-10	21	25	6	0.24	0.2857142857142857	GO:0051875	GO:BP	pigment granule localization	16175	13962		0.12	0.1568627450980392	21	16154	6	19	15	16135	16175	0.26081577534057704
M1	cpdb	0	network_modules	160	TRUE	3.6940175190989982e-9	503	25	12	0.48	0.02385685884691849	GO:0120031	GO:BP	plasma membrane bounded cell projection assembly	16175	19467		0.16	0.17647058823529413	503	15672	12	13	491	15659	16175	0.10174989593893632
M1	cpdb	0	network_modules	160	TRUE	4.762502218826608e-9	514	25	12	0.48	0.023346303501945526	GO:0030031	GO:BP	cell projection assembly	16175	6655		0.18	0.19607843137254902	514	15661	12	13	502	15648	16175	0.10053804669913323
M1	cpdb	0	network_modules	160	TRUE	1.0973340222331317e-8	33	25	6	0.24	0.18181818181818182	GO:0045494	GO:BP	photoreceptor cell maintenance	16175	11413		0.2	0.21568627450980393	33	16142	6	19	27	16123	16175	0.20748944578682144
M1	cpdb	0	network_modules	160	TRUE	5.150342719802007e-8	42	25	6	0.24	0.14285714285714285	GO:0001895	GO:BP	retina homeostasis	16175	520		0.22	0.23529411764705882	42	16133	6	19	36	16114	16175	0.18354085618067106
M1	cpdb	0	network_modules	160	TRUE	3.9102434629143053e-7	58	25	6	0.24	0.10344827586206896	GO:0033059	GO:BP	cellular pigmentation	16175	8013		0.24	0.2549019607843137	58	16117	6	19	52	16098	16175	0.155612874407184
M1	cpdb	0	network_modules	160	TRUE	4.348520676901652e-7	59	25	6	0.24	0.1016949152542373	GO:0061512	GO:BP	protein localization to cilium	16175	15514		0.26	0.27450980392156865	59	16116	6	19	53	16097	16175	0.15425292351149178
M1	cpdb	0	network_modules	160	TRUE	3.0633368268367838e-6	81	25	6	0.24	0.07407407407407407	GO:0043473	GO:BP	pigmentation	16175	10719		0.28	0.29411764705882354	81	16094	6	19	75	16075	16175	0.13098063834580387
M1	cpdb	0	network_modules	160	TRUE	1.1393096219626072e-5	16	25	4	0.16	0.25	GO:0048854	GO:BP	brain morphogenesis	16175	13098		0.3	0.3137254901960784	16	16159	4	21	12	16138	16175	0.19901576184562753
M1	cpdb	0	network_modules	160	TRUE	1.861853022027406e-5	4	25	3	0.12	0.75	GO:0038108	GO:BP	negative regulation of appetite by leptin-mediated signaling pathway	16175	9702		0.32	0.3333333333333333	4	16171	3	22	1	16149	16175	0.29965044535356145
M1	cpdb	0	network_modules	160	TRUE	1.0284615091834897e-4	145	25	6	0.24	0.041379310344827586	GO:0045444	GO:BP	fat cell differentiation	16175	11377		0.34	0.35294117647058826	145	16030	6	19	139	16011	16175	0.09643975014851545
M1	cpdb	0	network_modules	160	TRUE	1.0492117467407622e-4	250	25	7	0.28	0.028	GO:0007389	GO:BP	pattern specification process	16175	2889		0.36	0.37254901960784315	250	15925	7	18	243	15907	16175	0.084375488968350107
M1	cpdb	0	network_modules	160	TRUE	1.3617121179492823e-4	152	25	6	0.24	0.039473684210526314	GO:0060249	GO:BP	anatomical structure homeostasis	16175	14466		0.38	0.4117647058823529	152	16023	6	19	146	16004	16175	0.09403702096622818
M1	cpdb	0	network_modules	160	TRUE	1.3617121179492823e-4	152	25	6	0.24	0.039473684210526314	GO:0001894	GO:BP	tissue homeostasis	16175	519		0.38	0.4117647058823529	152	16023	6	19	146	16004	16175	0.09403702096622818
M1	cpdb	0	network_modules	160	TRUE	1.624140176254548e-4	7	25	3	0.12	0.42857142857142855	GO:0021544	GO:BP	subpallium development	16175	6128		0.42	0.47058823529411764	7	16168	3	22	4	16146	16175	0.22618460430073142
M1	cpdb	0	network_modules	160	TRUE	1.624140176254548e-4	7	25	3	0.12	0.42857142857142855	GO:0021756	GO:BP	striatum development	16175	6337		0.42	0.47058823529411764	7	16168	3	22	4	16146	16175	0.22618460430073142
M1	cpdb	0	network_modules	160	TRUE	1.624140176254548e-4	7	25	3	0.12	0.42857142857142855	GO:0060296	GO:BP	regulation of cilium beat frequency involved in ciliary motility	16175	14510		0.42	0.47058823529411764	7	16168	3	22	4	16146	16175	0.22618460430073142
M1	cpdb	0	network_modules	160	TRUE	2.0743558318860123e-4	82	25	5	0.2	0.06097560975609756	GO:0007368	GO:BP	determination of left/right symmetry	16175	2870		0.48	0.49019607843137253	82	16093	5	20	77	16073	16175	0.10798968638128117
M1	cpdb	0	network_modules	160	TRUE	2.2050481707688185e-4	83	25	5	0.2	0.060240963855421686	GO:0060972	GO:BP	left/right pattern formation	16175	15099		0.5	0.5098039215686274	83	16092	5	20	78	16072	16175	0.10730646587808129
M1	cpdb	0	network_modules	160	TRUE	2.595973150559093e-4	8	25	3	0.12	0.375	GO:0032096	GO:BP	negative regulation of response to food	16175	7360		0.52	0.5686274509803921	8	16167	3	22	5	16145	16175	0.2114734655362776
M1	cpdb	0	network_modules	160	TRUE	2.595973150559093e-4	8	25	3	0.12	0.375	GO:0032108	GO:BP	negative regulation of response to nutrient levels	16175	7369		0.52	0.5686274509803921	8	16167	3	22	5	16145	16175	0.2114734655362776
M1	cpdb	0	network_modules	160	TRUE	2.595973150559093e-4	8	25	3	0.12	0.375	GO:0032099	GO:BP	negative regulation of appetite	16175	7363		0.52	0.5686274509803921	8	16167	3	22	5	16145	16175	0.2114734655362776
M1	cpdb	0	network_modules	160	TRUE	3.132861120311294e-4	89	25	5	0.2	0.056179775280898875	GO:0009855	GO:BP	determination of bilateral symmetry	16175	3727		0.58	0.6078431372549019	89	16086	5	20	84	16066	16175	0.10344831563247758
M1	cpdb	0	network_modules	160	TRUE	3.132861120311294e-4	89	25	5	0.2	0.056179775280898875	GO:0009799	GO:BP	specification of symmetry	16175	3683		0.58	0.6078431372549019	89	16086	5	20	84	16066	16175	0.10344831563247758
M1	cpdb	0	network_modules	160	TRUE	3.471438653196131e-4	178	25	6	0.24	0.033707865168539325	GO:0051650	GO:BP	establishment of vesicle localization	16175	13863		0.62	0.6274509803921569	178	15997	6	19	172	15978	16175	0.08636254767860349
M1	cpdb	0	network_modules	160	TRUE	3.8899871601792674e-4	9	25	3	0.12	0.3333333333333333	GO:0033210	GO:BP	leptin-mediated signaling pathway	16175	8076		0.64	0.6470588235294118	9	16166	3	22	6	16144	16175	0.19928211379297658
M1	cpdb	0	network_modules	160	TRUE	4.4993769947974824e-4	186	25	6	0.24	0.03225806451612903	GO:0051648	GO:BP	vesicle localization	16175	13861		0.66	0.6666666666666666	186	15989	6	19	180	15970	16175	0.08432349141018507
M1	cpdb	0	network_modules	160	TRUE	5.027209148184389e-4	39	25	4	0.16	0.10256410256410256	GO:1905515	GO:BP	non-motile cilium assembly	16175	24691		0.68	0.6862745098039216	39	16136	4	21	35	16115	16175	0.12642219612928213
M1	cpdb	0	network_modules	160	TRUE	6.819893922019735e-4	42	25	4	0.16	0.09523809523809523	GO:0001947	GO:BP	heart looping	16175	558		0.7	0.7058823529411765	42	16133	4	21	38	16112	16175	0.12169141141562201
M1	cpdb	0	network_modules	160	TRUE	7.62546401250899e-4	11	25	3	0.12	0.2727272727272727	GO:0044320	GO:BP	cellular response to leptin stimulus	16175	10955		0.72	0.7254901960784313	11	16164	3	22	8	16142	16175	0.18008199221677743
M1	cpdb	0	network_modules	160	TRUE	8.531363639271898e-4	50	9	3	0.3333333333333333	0.06	KEGG:00270	KEGG	Cysteine and methionine metabolism	8484	30		NA	1	50	8434	3	6	47	8428	8484	0.13940612072088585
M1	cpdb	0	network_modules	160	TRUE	9.90159371366646e-4	46	25	4	0.16	0.08695652173913043	GO:0061371	GO:BP	determination of heart left/right asymmetry	16175	15443		0.74	0.7647058823529411	46	16129	4	21	42	16108	16175	0.11611187826839577
M1	cpdb	0	network_modules	160	TRUE	9.90159371366646e-4	46	25	4	0.16	0.08695652173913043	GO:0003143	GO:BP	embryonic heart tube morphogenesis	16175	1575		0.74	0.7647058823529411	46	16129	4	21	42	16108	16175	0.11611187826839577
M1	cpdb	0	network_modules	160	TRUE	0.0013190517910497343	13	25	3	0.12	0.23076923076923078	GO:0032095	GO:BP	regulation of response to food	16175	7359		0.78	0.7843137254901961	13	16162	3	22	10	16140	16175	0.16548991892696704
M1	cpdb	0	network_modules	160	TRUE	0.0013745886740726874	225	25	6	0.24	0.02666666666666667	GO:0003002	GO:BP	regionalization	16175	1453		0.8	0.803921568627451	225	15950	6	19	219	15931	16175	0.07595162997966043
M1	cpdb	0	network_modules	160	TRUE	0.001632464525617017	52	25	4	0.16	0.07692307692307693	GO:0035050	GO:BP	embryonic heart tube development	16175	8784		0.82	0.8235294117647058	52	16123	4	21	48	16102	16175	0.10897036144172943
M1	cpdb	0	network_modules	160	TRUE	0.0016770806674558068	14	25	3	0.12	0.21428571428571427	GO:0044321	GO:BP	response to leptin	16175	10956		0.84	0.8431372549019608	14	16161	3	22	11	16139	16175	0.15939229457778828
M1	cpdb	0	network_modules	160	TRUE	0.002094212406975043	15	25	3	0.12	0.2	GO:0003356	GO:BP	regulation of cilium beat frequency	16175	1776		0.86	0.8627450980392157	15	16160	3	22	12	16138	16175	0.15391243747171574
M1	cpdb	0	network_modules	160	TRUE	0.0025748630171493763	16	25	3	0.12	0.1875	GO:0032098	GO:BP	regulation of appetite	16175	7362		0.88	0.8823529411764706	16	16159	3	22	13	16137	16175	0.14895231009052606
M1	cpdb	0	network_modules	160	TRUE	0.0025878154018713338	136	25	5	0.2	0.03676470588235294	GO:0048562	GO:BP	embryonic organ morphogenesis	16175	12835		0.9	0.9019607843137255	136	16039	5	20	131	16019	16175	0.08255572949701934
M1	cpdb	0	network_modules	160	TRUE	0.003276358997535711	2	25	2	0.08	1	GO:0051877	GO:BP	pigment granule aggregation in cell center	16175	13964		0.92	0.9215686274509803	2	16173	2	23	0	16150	16175	0.282641522315189
M1	cpdb	0	network_modules	160	TRUE	0.00444181271442159	19	25	3	0.12	0.15789473684210525	GO:0032094	GO:BP	response to food	16175	7358		0.94	0.9411764705882353	19	16156	3	22	16	16134	16175	0.13648766424315323
M1	cpdb	0	network_modules	160	TRUE	0.005244001373935766	157	25	5	0.2	0.03184713375796178	GO:0060562	GO:BP	epithelial tube morphogenesis	16175	14746		0.96	0.9607843137254902	157	16018	5	20	152	15998	16175	0.07636570854458284
M1	cpdb	0	network_modules	160	TRUE	0.007037649377665408	22	25	3	0.12	0.13636363636363635	GO:0032107	GO:BP	regulation of response to nutrient levels	16175	7368		0.98	0.9803921568627451	22	16153	3	22	19	16131	16175	0.12665454491867303
M1	cpdb	0	network_modules	160	TRUE	0.008085042301513865	23	25	3	0.12	0.13043478260869565	GO:0051131	GO:BP	chaperone-mediated protein complex assembly	16175	13515		1	1	23	16152	3	22	20	16130	16175	0.12380987150270771
M1	cpdb	0	network_modules	161	TRUE	5.221501144053336e-22	125	28	15	0.5357142857142857	0.12	GO:0046631	GO:BP	alpha-beta T cell activation	16175	12268		0	0.005	125	16050	15	13	110	16037	16175	0.25107734052870584
M1	cpdb	0	network_modules	161	TRUE	2.244889395973981e-20	62	19	12	0.631578947368421	0.1935483870967742	KEGG:05321	KEGG	Inflammatory bowel disease	8484	483		0	0.09090909090909091	62	8422	12	7	50	8415	8484	0.3472431823426442
M1	cpdb	0	network_modules	161	TRUE	4.58286978422801e-20	84	28	13	0.4642857142857143	0.15476190476190477	GO:0046634	GO:BP	regulation of alpha-beta T cell activation	16175	12271		0.005025125628140704	0.01	84	16091	13	15	71	16076	16175	0.2659784396741736
M1	cpdb	0	network_modules	161	TRUE	9.679305201099591e-18	85	28	12	0.42857142857142855	0.1411764705882353	GO:0046632	GO:BP	alpha-beta T cell differentiation	16175	12269		0.010050251256281407	0.015	85	16090	12	16	73	16074	16175	0.24381195513380846
M1	cpdb	0	network_modules	161	TRUE	1.962252877541138e-17	105	19	12	0.631578947368421	0.11428571428571428	KEGG:04659	KEGG	Th17 cell differentiation	8484	337		0.1	0.18181818181818182	105	8379	12	7	93	8372	8484	0.2653420515049847
M1	cpdb	0	network_modules	161	TRUE	2.9794605772503834e-17	61	28	11	0.39285714285714285	0.18032786885245902	GO:0002294	GO:BP	CD4-positive, alpha-beta T cell differentiation involved in immune response	16175	826		0.01507537688442211	0.02	61	16114	11	17	50	16097	16175	0.2643359720099232
M1	cpdb	0	network_modules	161	TRUE	3.618588550290918e-17	62	28	11	0.39285714285714285	0.1774193548387097	GO:0002293	GO:BP	alpha-beta T cell differentiation involved in immune response	16175	825		0.020100502512562814	0.03	62	16113	11	17	51	16096	16175	0.2621620377071799
M1	cpdb	0	network_modules	161	TRUE	3.618588550290918e-17	62	28	11	0.39285714285714285	0.1774193548387097	GO:0002287	GO:BP	alpha-beta T cell activation involved in immune response	16175	819		0.020100502512562814	0.03	62	16113	11	17	51	16096	16175	0.2621620377071799
M1	cpdb	0	network_modules	161	TRUE	4.190190965533589e-17	162	19	13	0.6842105263157895	0.08024691358024691	KEGG:04630	KEGG	JAK-STAT signaling pathway	8484	332		0.2	0.2727272727272727	162	8322	13	6	149	8316	8484	0.23024481268686992
M1	cpdb	0	network_modules	161	TRUE	7.617304861850092e-17	66	28	11	0.39285714285714285	0.16666666666666666	GO:0002292	GO:BP	T cell differentiation involved in immune response	16175	824		0.03015075376884422	0.035	66	16109	11	17	55	16092	16175	0.2539635757779984
M1	cpdb	0	network_modules	161	TRUE	1.6271019887376148e-16	472	20	16	0.8	0.03389830508474576	REAC:R-HSA-449147	REAC	Signaling by Interleukins	10916	2261		0	0.14285714285714285	472	10444	16	4	456	10440	10916	0.15940396777543803
M1	cpdb	0	network_modules	161	TRUE	2.130975169606758e-16	72	28	11	0.39285714285714285	0.1527777777777778	GO:0043367	GO:BP	CD4-positive, alpha-beta T cell differentiation	16175	10644		0.035175879396984924	0.04	72	16103	11	17	61	16086	16175	0.24296486594248207
M1	cpdb	0	network_modules	161	TRUE	3.902539042438054e-16	89	19	11	0.5789473684210527	0.12359550561797752	KEGG:04658	KEGG	Th1 and Th2 cell differentiation	8484	336		0.3	0.36363636363636365	89	8395	11	8	78	8387	8484	0.2643359733277991
M1	cpdb	0	network_modules	161	TRUE	3.9308495588276465e-16	57	20	10	0.5	0.17543859649122806	REAC:R-HSA-447115	REAC	Interleukin-12 family signaling	10916	1235		0.16666666666666666	0.2857142857142857	57	10859	10	10	47	10849	10916	0.2941191372895489
M1	cpdb	0	network_modules	161	TRUE	1.5371610029278286e-15	54	28	10	0.35714285714285715	0.18518518518518517	GO:0046637	GO:BP	regulation of alpha-beta T cell differentiation	16175	12274		0.04020100502512563	0.045	54	16121	10	18	44	16103	16175	0.25541577019022166
M1	cpdb	0	network_modules	161	TRUE	1.8482930717642406e-15	129	28	12	0.42857142857142855	0.09302325581395349	GO:0045580	GO:BP	regulation of T cell differentiation	16175	11431		0.04522613065326633	0.05	129	16046	12	16	117	16030	16175	0.1969084867520374
M1	cpdb	0	network_modules	161	TRUE	2.2220248821963296e-15	88	28	11	0.39285714285714285	0.125	GO:0035710	GO:BP	CD4-positive, alpha-beta T cell activation	16175	9184		0.05025125628140704	0.055	88	16087	11	17	77	16070	16175	0.21931927162949688
M1	cpdb	0	network_modules	161	TRUE	4.015274631682246e-15	59	28	10	0.35714285714285715	0.1694915254237288	GO:0042093	GO:BP	T-helper cell differentiation	16175	9964		0.05527638190954774	0.06	59	16116	10	18	49	16098	16175	0.24417788805210078
M1	cpdb	0	network_modules	161	TRUE	8.645981052768194e-15	206	28	13	0.4642857142857143	0.06310679611650485	GO:0030217	GO:BP	T cell differentiation	16175	6725		0.06030150753768844	0.065	206	15969	13	15	193	15954	16175	0.1676913916797576
M1	cpdb	0	network_modules	161	TRUE	9.719062272161844e-15	100	28	11	0.39285714285714285	0.11	GO:0002286	GO:BP	T cell activation involved in immune response	16175	818		0.06532663316582915	0.07	100	16075	11	17	89	16058	16175	0.20542236230422836
M1	cpdb	0	network_modules	161	TRUE	1.066629837393285e-14	284	28	14	0.5	0.04929577464788732	GO:0050863	GO:BP	regulation of T cell activation	16175	13311		0.07035175879396985	0.075	284	15891	14	14	270	15877	16175	0.15296347592112186
M1	cpdb	0	network_modules	161	TRUE	1.4067466697378447e-14	152	28	12	0.42857142857142855	0.07894736842105263	GO:0045619	GO:BP	regulation of lymphocyte differentiation	16175	11470		0.07537688442211055	0.08	152	16023	12	16	140	16007	16175	0.18091652079344986
M1	cpdb	0	network_modules	161	TRUE	3.671010914643586e-14	406	28	15	0.5357142857142857	0.03694581280788178	GO:0042110	GO:BP	T cell activation	16175	9970		0.08040201005025126	0.085	406	15769	15	13	391	15756	16175	0.13592672579697512
M1	cpdb	0	network_modules	161	TRUE	3.903826811659839e-14	44	28	9	0.32142857142857145	0.20454545454545456	GO:0043370	GO:BP	regulation of CD4-positive, alpha-beta T cell differentiation	16175	10647		0.08542713567839195	0.09	44	16131	9	19	35	16112	16175	0.2548084377722362
M1	cpdb	0	network_modules	161	TRUE	2.639015433497629e-13	30	28	8	0.2857142857142857	0.26666666666666666	GO:0042088	GO:BP	T-helper 1 type immune response	16175	9962		0.09045226130653267	0.095	30	16145	8	20	22	16125	16175	0.274726955528319
M1	cpdb	0	network_modules	161	TRUE	4.193107298652065e-13	369	28	14	0.5	0.037940379403794036	GO:0051249	GO:BP	regulation of lymphocyte activation	16175	13596		0.09547738693467336	0.1	369	15806	14	14	355	15792	16175	0.13308889818567485
M1	cpdb	0	network_modules	161	TRUE	4.886211944782488e-13	57	28	9	0.32142857142857145	0.15789473684210525	GO:2000514	GO:BP	regulation of CD4-positive, alpha-beta T cell activation	16175	25817		0.10050251256281408	0.105	57	16118	9	19	48	16099	16175	0.2233989929260636
M1	cpdb	0	network_modules	161	TRUE	6.239554617857865e-13	33	28	8	0.2857142857142857	0.24242424242424243	GO:0045622	GO:BP	regulation of T-helper cell differentiation	16175	11473		0.10552763819095477	0.11	33	16142	8	20	25	16122	16175	0.26179504777210555
M1	cpdb	0	network_modules	161	TRUE	1.0472329413006567e-12	297	28	13	0.4642857142857143	0.04377104377104377	GO:0030098	GO:BP	lymphocyte differentiation	16175	6676		0.11055276381909548	0.115	297	15878	13	15	284	15863	16175	0.13831272884978774
M1	cpdb	0	network_modules	161	TRUE	1.4305425440342217e-12	403	28	14	0.5	0.034739454094292806	GO:0001819	GO:BP	positive regulation of cytokine production	16175	476		0.11557788944723618	0.12	403	15772	14	14	389	15758	16175	0.12692664500571565
M1	cpdb	0	network_modules	161	TRUE	1.7436471706177176e-12	158	28	11	0.39285714285714285	0.06962025316455696	GO:0002285	GO:BP	lymphocyte activation involved in immune response	16175	817		0.12060301507537688	0.125	158	16017	11	17	147	16000	16175	0.16220263783398145
M1	cpdb	0	network_modules	161	TRUE	1.9792017818916776e-12	228	28	12	0.42857142857142855	0.05263157894736842	GO:1902105	GO:BP	regulation of leukocyte differentiation	16175	22019		0.12562814070351758	0.13	228	15947	12	16	216	15931	16175	0.14640955897668756
M1	cpdb	0	network_modules	161	TRUE	2.456468486334448e-12	419	28	14	0.5	0.03341288782816229	GO:0019221	GO:BP	cytokine-mediated signaling pathway	16175	5598		0.1306532663316583	0.135	419	15756	14	14	405	15742	16175	0.12428351210156481
M1	cpdb	0	network_modules	161	TRUE	2.6242412901359403e-12	421	28	14	0.5	0.0332541567695962	GO:0002694	GO:BP	regulation of leukocyte activation	16175	1212		0.135678391959799	0.14	421	15754	14	14	407	15740	16175	0.12396348141751432
M1	cpdb	0	network_modules	161	TRUE	3.819206575498825e-12	555	28	15	0.5357142857142857	0.02702702702702703	GO:0071345	GO:BP	cellular response to cytokine stimulus	16175	16597		0.1407035175879397	0.145	555	15620	15	13	540	15607	16175	0.11470345601610644
M1	cpdb	0	network_modules	161	TRUE	4.8063258167487855e-12	334	28	13	0.4642857142857143	0.038922155688622756	GO:0002250	GO:BP	adaptive immune response	16175	782		0.1457286432160804	0.15	334	15841	13	15	321	15826	16175	0.12990928285743739
M1	cpdb	0	network_modules	161	TRUE	5.515560974822484e-12	569	28	15	0.5357142857142857	0.026362038664323375	GO:0046649	GO:BP	lymphocyte activation	16175	12286		0.1507537688442211	0.155	569	15606	15	13	554	15593	16175	0.11313871375757167
M1	cpdb	0	network_modules	161	TRUE	1.1355727934829164e-11	468	28	14	0.5	0.029914529914529916	GO:0050865	GO:BP	regulation of cell activation	16175	13313		0.15577889447236182	0.16	468	15707	14	14	454	15693	16175	0.11702806332070763
M1	cpdb	0	network_modules	161	TRUE	1.1369080880062897e-11	357	28	13	0.4642857142857143	0.036414565826330535	GO:1903131	GO:BP	mononuclear cell differentiation	16175	22787		0.16080402010050251	0.165	357	15818	13	15	344	15803	16175	0.12534314352266532
M1	cpdb	0	network_modules	161	TRUE	2.1950713916332996e-11	625	28	15	0.5357142857142857	0.024	GO:0034097	GO:BP	response to cytokine	16175	8408		0.1658291457286432	0.175	625	15550	15	13	610	15537	16175	0.1073973541460956
M1	cpdb	0	network_modules	161	TRUE	2.1950713916332996e-11	625	28	15	0.5357142857142857	0.024	GO:1901652	GO:BP	response to peptide	16175	21619		0.1658291457286432	0.175	625	15550	15	13	610	15537	16175	0.1073973541460956
M1	cpdb	0	network_modules	161	TRUE	5.413715280397677e-11	29	28	7	0.25	0.2413793103448276	GO:0072539	GO:BP	T-helper 17 cell differentiation	16175	17437		0.17587939698492464	0.18	29	16146	7	21	22	16125	16175	0.24432062280411057
M1	cpdb	0	network_modules	161	TRUE	5.661505784513991e-11	216	28	11	0.39285714285714285	0.05092592592592592	GO:0002366	GO:BP	leukocyte activation involved in immune response	16175	898		0.18090452261306533	0.185	216	15959	11	17	205	15942	16175	0.13767754507839894
M1	cpdb	0	network_modules	161	TRUE	7.289945694088822e-11	221	28	11	0.39285714285714285	0.049773755656108594	GO:0002263	GO:BP	cell activation involved in immune response	16175	795		0.18592964824120603	0.19	221	15954	11	17	210	15937	16175	0.13602163884952767
M1	cpdb	0	network_modules	161	TRUE	7.623115208312539e-11	309	28	12	0.42857142857142855	0.038834951456310676	GO:1903706	GO:BP	regulation of hemopoiesis	16175	23220		0.19095477386934673	0.195	309	15866	12	16	297	15850	16175	0.12456162088860914
M1	cpdb	0	network_modules	161	TRUE	1.1161386385410471e-10	60	28	8	0.2857142857142857	0.13333333333333333	GO:0032729	GO:BP	positive regulation of type II interferon production	16175	7774		0.19597989949748743	0.2	60	16115	8	20	52	16095	16175	0.19317156194579102
M1	cpdb	0	network_modules	161	TRUE	1.1300622924697237e-10	699	28	15	0.5357142857142857	0.02145922746781116	GO:0045321	GO:BP	leukocyte activation	16175	11356		0.20100502512562815	0.205	699	15476	15	13	684	15463	16175	0.10085912172937962
M1	cpdb	0	network_modules	161	TRUE	1.4001583137789387e-10	434	28	13	0.4642857142857143	0.029953917050691243	GO:0002521	GO:BP	leukocyte differentiation	16175	1043		0.20603015075376885	0.21	434	15741	13	15	421	15726	16175	0.11273244672920138
M1	cpdb	0	network_modules	161	TRUE	1.9258158052212662e-10	334	28	12	0.42857142857142855	0.03592814371257485	GO:0009615	GO:BP	response to virus	16175	3541		0.21105527638190955	0.215	334	15841	12	16	322	15825	16175	0.11945113396348772
M1	cpdb	0	network_modules	161	TRUE	2.344316489017692e-10	291	19	11	0.5789473684210527	0.037800687285223365	KEGG:04060	KEGG	Cytokine-cytokine receptor interaction	8484	253		0.4	0.45454545454545453	291	8193	11	8	280	8185	8484	0.1417788761746796
M1	cpdb	0	network_modules	161	TRUE	3.5387134682009817e-10	37	28	7	0.25	0.1891891891891892	GO:0072538	GO:BP	T-helper 17 type immune response	16175	17436		0.21608040201005024	0.22	37	16138	7	21	30	16117	16175	0.21592335569634408
M1	cpdb	0	network_modules	161	TRUE	4.784894232290282e-10	18	28	6	0.21428571428571427	0.3333333333333333	GO:0072540	GO:BP	T-helper 17 cell lineage commitment	16175	17438		0.22110552763819097	0.225	18	16157	6	22	12	16135	16175	0.2662519099594253
M1	cpdb	0	network_modules	161	TRUE	5.090877712828097e-10	9	20	5	0.25	0.5555555555555556	REAC:R-HSA-9020933	REAC	Interleukin-23 signaling	10916	1244		0.3333333333333333	0.42857142857142855	9	10907	5	15	4	10892	10916	0.3719430459333364
M1	cpdb	0	network_modules	161	TRUE	6.985148078961842e-10	19	28	6	0.21428571428571427	0.3157894736842105	GO:2000319	GO:BP	regulation of T-helper 17 cell differentiation	16175	25641		0.22613065326633167	0.23	19	16156	6	22	13	16134	16175	0.25908343895860075
M1	cpdb	0	network_modules	161	TRUE	7.302123286372715e-10	634	28	14	0.5	0.022082018927444796	GO:0001817	GO:BP	regulation of cytokine production	16175	474		0.23115577889447236	0.235	634	15541	14	14	620	15527	16175	0.09888017802901361
M1	cpdb	0	network_modules	161	TRUE	7.954838772022196e-10	638	28	14	0.5	0.0219435736677116	GO:0001816	GO:BP	cytokine production	16175	473		0.23618090452261306	0.24	638	15537	14	14	624	15523	16175	0.09852950371584202
M1	cpdb	0	network_modules	161	TRUE	8.380412215834008e-10	276	28	11	0.39285714285714285	0.03985507246376811	GO:0002460	GO:BP	adaptive immune response based on somatic recombination of immune receptors built from immunoglobulin superfamily domains	16175	983		0.24120603015075376	0.245	276	15899	11	17	265	15882	16175	0.12083354491730912
M1	cpdb	0	network_modules	161	TRUE	9.967140685343415e-10	20	28	6	0.21428571428571427	0.3	GO:0002825	GO:BP	regulation of T-helper 1 type immune response	16175	1335		0.24623115577889448	0.255	20	16155	6	22	14	16133	16175	0.252457855673736
M1	cpdb	0	network_modules	161	TRUE	9.967140685343415e-10	20	28	6	0.21428571428571427	0.3	GO:0002295	GO:BP	T-helper cell lineage commitment	16175	827		0.24623115577889448	0.255	20	16155	6	22	14	16133	16175	0.252457855673736
M1	cpdb	0	network_modules	161	TRUE	1.025435197172252e-9	8	28	5	0.17857142857142858	0.625	GO:2000328	GO:BP	regulation of T-helper 17 cell lineage commitment	16175	25647		0.2562814070351759	0.26	8	16167	5	23	3	16144	16175	0.3335224755523794
M1	cpdb	0	network_modules	161	TRUE	1.2843906541723478e-9	287	28	11	0.39285714285714285	0.03832752613240418	GO:1903037	GO:BP	regulation of leukocyte cell-cell adhesion	16175	22717		0.2613065326633166	0.265	287	15888	11	17	276	15871	16175	0.11832179725018571
M1	cpdb	0	network_modules	161	TRUE	2.3044942261533486e-09	9	28	5	0.17857142857142858	0.5555555555555556	GO:0035722	GO:BP	interleukin-12-mediated signaling pathway	16175	9192		0.2663316582914573	0.27	9	16166	5	23	4	16143	16175	0.3143485591481688
M1	cpdb	0	network_modules	161	TRUE	2.4781980424047625e-9	142	28	9	0.32142857142857145	0.06338028169014084	GO:0007259	GO:BP	cell surface receptor signaling pathway via JAK-STAT	16175	2789		0.271356783919598	0.275	142	16033	9	19	133	16014	16175	0.1395673008271657
M1	cpdb	0	network_modules	161	TRUE	2.586778126164176e-9	23	28	6	0.21428571428571427	0.2608695652173913	GO:0002363	GO:BP	alpha-beta T cell lineage commitment	16175	895		0.27638190954773867	0.285	23	16152	6	22	17	16130	16175	0.23523506218231935
M1	cpdb	0	network_modules	161	TRUE	2.586778126164176e-9	23	28	6	0.21428571428571427	0.2608695652173913	GO:0043373	GO:BP	CD4-positive, alpha-beta T cell lineage commitment	16175	10650		0.27638190954773867	0.285	23	16152	6	22	17	16130	16175	0.23523506218231935
M1	cpdb	0	network_modules	161	TRUE	3.2713431169635865e-9	90	28	8	0.2857142857142857	0.08888888888888889	GO:0032649	GO:BP	regulation of type II interferon production	16175	7696		0.2864321608040201	0.295	90	16085	8	20	82	16065	16175	0.15683263683230317
M1	cpdb	0	network_modules	161	TRUE	3.2713431169635865e-9	90	28	8	0.2857142857142857	0.08888888888888889	GO:0032609	GO:BP	type II interferon production	16175	7657		0.2864321608040201	0.295	90	16085	8	20	82	16065	16175	0.15683263683230317
M1	cpdb	0	network_modules	161	TRUE	3.405165242338725e-9	111	20	8	0.4	0.07207207207207207	REAC:R-HSA-6785807	REAC	Interleukin-4 and Interleukin-13 signaling	10916	1252		0.5	0.5714285714285714	111	10805	8	12	103	10793	10916	0.1664745941478887
M1	cpdb	0	network_modules	161	TRUE	3.445013018465276e-9	24	28	6	0.21428571428571427	0.25	GO:0043369	GO:BP	CD4-positive or CD8-positive, alpha-beta T cell lineage commitment	16175	10646		0.2964824120603015	0.305	24	16151	6	22	18	16129	16175	0.23022243446491467
M1	cpdb	0	network_modules	161	TRUE	3.445013018465276e-9	24	28	6	0.21428571428571427	0.25	GO:0002360	GO:BP	T cell lineage commitment	16175	892		0.2964824120603015	0.305	24	16151	6	22	18	16129	16175	0.23022243446491467
M1	cpdb	0	network_modules	161	TRUE	3.840284252570393e-9	149	28	9	0.32142857142857145	0.06040268456375839	GO:0097696	GO:BP	cell surface receptor signaling pathway via STAT	16175	18727		0.3065326633165829	0.31	149	16026	9	19	140	16007	16175	0.1360905539373262
M1	cpdb	0	network_modules	161	TRUE	4.808272160072912e-9	324	28	11	0.39285714285714285	0.033950617283950615	GO:0007159	GO:BP	leukocyte cell-cell adhesion	16175	2723		0.31155778894472363	0.315	324	15851	11	17	313	15834	16175	0.11081103332084376
M1	cpdb	0	network_modules	161	TRUE	5.183227652158558e-9	154	28	9	0.32142857142857145	0.05844155844155844	GO:0002819	GO:BP	regulation of adaptive immune response	16175	1329		0.3165829145728643	0.32	154	16021	9	19	145	16002	16175	0.1337513937249755
M1	cpdb	0	network_modules	161	TRUE	5.202481087400729e-9	53	28	7	0.25	0.1320754716981132	GO:0046635	GO:BP	positive regulation of alpha-beta T cell activation	16175	12272		0.32160804020100503	0.325	53	16122	7	21	46	16101	16175	0.17977952231266725
M1	cpdb	0	network_modules	161	TRUE	5.8790409350026165e-9	26	28	6	0.21428571428571427	0.23076923076923078	GO:2000316	GO:BP	regulation of T-helper 17 type immune response	16175	25638		0.32663316582914576	0.33	26	16149	6	22	20	16127	16175	0.22107572707560239
M1	cpdb	0	network_modules	161	TRUE	7.92866968465116e-9	756	28	14	0.5	0.018518518518518517	GO:0050776	GO:BP	regulation of immune response	16175	13250		0.3316582914572864	0.335	756	15419	14	14	742	15405	16175	0.08942046624288859
M1	cpdb	0	network_modules	161	TRUE	8.429790810485311e-9	11	28	5	0.17857142857142858	0.45454545454545453	GO:0071349	GO:BP	cellular response to interleukin-12	16175	16601		0.33668341708542715	0.345	11	16164	5	23	6	16141	16175	0.28415904906777284
M1	cpdb	0	network_modules	161	TRUE	8.429790810485311e-9	11	28	5	0.17857142857142858	0.45454545454545453	GO:0070671	GO:BP	response to interleukin-12	16175	16252		0.33668341708542715	0.345	11	16164	5	23	6	16141	16175	0.28415904906777284
M1	cpdb	0	network_modules	161	TRUE	8.882715861478442e-9	57	28	7	0.25	0.12280701754385964	GO:0002711	GO:BP	positive regulation of T cell mediated immunity	16175	1229		0.34673366834170855	0.35	57	16118	7	21	50	16097	16175	0.17320446857766447
M1	cpdb	0	network_modules	161	TRUE	1.203075016097219e-8	169	28	9	0.32142857142857145	0.05325443786982249	GO:0050670	GO:BP	regulation of lymphocyte proliferation	16175	13204		0.35175879396984927	0.355	169	16006	9	19	160	15987	16175	0.12735780640101835
M1	cpdb	0	network_modules	161	TRUE	1.3380454119736978e-8	171	28	9	0.32142857142857145	0.05263157894736842	GO:0032944	GO:BP	regulation of mononuclear cell proliferation	16175	7929		0.35678391959798994	0.36	171	16004	9	19	162	15985	16175	0.12656839995108946
M1	cpdb	0	network_modules	161	TRUE	1.8547284458372556e-8	638	28	13	0.4642857142857143	0.02037617554858934	GO:0030097	GO:BP	hemopoiesis	16175	6675		0.36180904522613067	0.365	638	15537	13	15	625	15522	16175	0.09088893952359639
M1	cpdb	0	network_modules	161	TRUE	1.8691860996632238e-8	31	28	6	0.21428571428571427	0.1935483870967742	GO:0043368	GO:BP	positive T cell selection	16175	10645		0.36683417085427134	0.37	31	16144	6	22	25	16122	16175	0.20220060180622362
M1	cpdb	0	network_modules	161	TRUE	2.3427344955964454e-8	13	28	5	0.17857142857142858	0.38461538461538464	GO:0002827	GO:BP	positive regulation of T-helper 1 type immune response	16175	1337		0.37185929648241206	0.375	13	16162	5	23	8	16139	16175	0.2612227849363993
M1	cpdb	0	network_modules	161	TRUE	3.0695622427035715e-8	276	28	10	0.35714285714285715	0.036231884057971016	GO:0002697	GO:BP	regulation of immune effector process	16175	1215		0.3768844221105528	0.38	276	15899	10	18	266	15881	16175	0.10934989603373611
M1	cpdb	0	network_modules	161	TRUE	3.192346757822921e-8	386	28	11	0.39285714285714285	0.02849740932642487	GO:0022407	GO:BP	regulation of cell-cell adhesion	16175	6598		0.38190954773869346	0.385	386	15789	11	17	375	15772	16175	0.10067571619134527
M1	cpdb	0	network_modules	161	TRUE	3.4588247201105885e-8	190	28	9	0.32142857142857145	0.04736842105263158	GO:0070663	GO:BP	regulation of leukocyte proliferation	16175	16244		0.3869346733668342	0.39	190	15985	9	19	181	15966	16175	0.11969066872361359
M1	cpdb	0	network_modules	161	TRUE	4.368320250852699e-8	195	28	9	0.32142857142857145	0.046153846153846156	GO:0050870	GO:BP	positive regulation of T cell activation	16175	13318		0.39195979899497485	0.395	195	15980	9	19	186	15961	16175	0.11804674044311958
M1	cpdb	0	network_modules	161	TRUE	5.018788922276639e-8	536	28	12	0.42857142857142855	0.022388059701492536	GO:0002252	GO:BP	immune effector process	16175	784		0.3969849246231156	0.4	536	15639	12	16	524	15623	16175	0.091995029596817
M1	cpdb	0	network_modules	161	TRUE	5.7270124450362577e-8	47	20	6	0.3	0.1276595744680851	REAC:R-HSA-9020591	REAC	Interleukin-12 signaling	10916	1236		0.6666666666666666	0.7142857142857143	47	10869	6	14	41	10855	10916	0.19348368245761602
M1	cpdb	0	network_modules	161	TRUE	5.785610939450979e-8	128	28	8	0.2857142857142857	0.0625	GO:0042129	GO:BP	regulation of T cell proliferation	16175	9983		0.4020100502512563	0.405	128	16047	8	20	120	16027	16175	0.1305596641803974
M1	cpdb	0	network_modules	161	TRUE	5.860684138210535e-8	37	28	6	0.21428571428571427	0.16216216216216217	GO:0045058	GO:BP	T cell selection	16175	11256		0.40703517587939697	0.41	37	16138	6	22	31	16116	16175	0.184792315412641
M1	cpdb	0	network_modules	161	TRUE	7.79295486380426e-8	208	28	9	0.32142857142857145	0.04326923076923077	GO:0046651	GO:BP	lymphocyte proliferation	16175	12287		0.4120603015075377	0.415	208	15967	9	19	199	15948	16175	0.11404773268910602
M1	cpdb	0	network_modules	161	TRUE	8.85893033486281e-8	211	28	9	0.32142857142857145	0.04265402843601896	GO:0032943	GO:BP	mononuclear cell proliferation	16175	7928		0.41708542713567837	0.42	211	15964	9	19	202	15945	16175	0.11317663552383328
M1	cpdb	0	network_modules	161	TRUE	1.0396849586719263e-7	80	28	7	0.25	0.0875	GO:0002709	GO:BP	regulation of T cell mediated immunity	16175	1227		0.4221105527638191	0.425	80	16095	7	21	73	16074	16175	0.14546176873914318
M1	cpdb	0	network_modules	161	TRUE	1.0454013394877086e-7	571	28	12	0.42857142857142855	0.021015761821366025	GO:0060284	GO:BP	regulation of cell development	16175	14500		0.4271356783919598	0.43	571	15604	12	16	559	15588	16175	0.08874261398587945
M1	cpdb	0	network_modules	161	TRUE	1.0479633276287252e-7	215	28	9	0.32142857142857145	0.04186046511627907	GO:1903039	GO:BP	positive regulation of leukocyte cell-cell adhesion	16175	22719		0.4321608040201005	0.435	215	15960	9	19	206	15941	16175	0.11204301562749025
M1	cpdb	0	network_modules	161	TRUE	1.1254257482194064e-7	139	28	8	0.2857142857142857	0.05755395683453238	GO:0002822	GO:BP	regulation of adaptive immune response based on somatic recombination of immune receptors built from immunoglobulin superfamily domains	16175	1332		0.4371859296482412	0.44	139	16036	8	20	131	16016	16175	0.1250233255819538
M1	cpdb	0	network_modules	161	TRUE	1.1923136093372597e-07	140	28	8	0.2857142857142857	0.05714285714285714	GO:0042098	GO:BP	T cell proliferation	16175	9965		0.44221105527638194	0.445	140	16035	8	20	132	16015	16175	0.12455210499771475
M1	cpdb	0	network_modules	161	TRUE	1.746566013705674e-7	86	28	7	0.25	0.08139534883720931	GO:0045582	GO:BP	positive regulation of T cell differentiation	16175	11433		0.4472361809045226	0.45	86	16089	7	21	79	16068	16175	0.1401095373922075
M1	cpdb	0	network_modules	161	TRUE	1.85289355917726e-7	6	28	4	0.14285714285714285	0.6666666666666666	GO:2000330	GO:BP	positive regulation of T-helper 17 cell lineage commitment	16175	25649		0.45226130653266333	0.455	6	16169	4	24	2	16145	16175	0.30812928850092025
M1	cpdb	0	network_modules	161	TRUE	2.232040853713943e-7	89	28	7	0.25	0.07865168539325842	GO:0002824	GO:BP	positive regulation of adaptive immune response based on somatic recombination of immune receptors built from immunoglobulin superfamily domains	16175	1334		0.457286432160804	0.46	89	16086	7	21	82	16065	16175	0.13763633265586914
M1	cpdb	0	network_modules	161	TRUE	2.407126712491754e-7	236	28	9	0.32142857142857145	0.038135593220338986	GO:0070661	GO:BP	leukocyte proliferation	16175	16242		0.4623115577889447	0.465	236	15939	9	19	227	15920	16175	0.10656147101170245
M1	cpdb	0	network_modules	161	TRUE	2.616001244116964e-7	91	28	7	0.25	0.07692307692307693	GO:0031341	GO:BP	regulation of cell killing	16175	7132		0.46733668341708545	0.47	91	16084	7	21	84	16063	16175	0.13605506432733827
M1	cpdb	0	network_modules	161	TRUE	2.8282087553938326e-7	92	28	7	0.25	0.07608695652173914	GO:0002708	GO:BP	positive regulation of lymphocyte mediated immunity	16175	1226		0.4723618090452261	0.475	92	16083	7	21	85	16062	16175	0.13528358713525293
M1	cpdb	0	network_modules	161	TRUE	3.8304076609971827e-7	96	28	7	0.25	0.07291666666666667	GO:0002821	GO:BP	positive regulation of adaptive immune response	16175	1331		0.47738693467336685	0.48	96	16079	7	21	89	16058	16175	0.13231759577990365
M1	cpdb	0	network_modules	161	TRUE	3.8778235292834727e-7	249	28	9	0.32142857142857145	0.03614457831325301	GO:0051251	GO:BP	positive regulation of lymphocyte activation	16175	13598		0.4824120603015075	0.485	249	15926	9	19	240	15907	16175	0.10351294458488483
M1	cpdb	0	network_modules	161	TRUE	4.435758928676239e-7	98	28	7	0.25	0.07142857142857142	GO:0002456	GO:BP	T cell mediated immunity	16175	979		0.48743718592964824	0.49	98	16077	7	21	91	16056	16175	0.13090225092016416
M1	cpdb	0	network_modules	161	TRUE	4.7678193341515243e-7	99	28	7	0.25	0.0707070707070707	GO:0045621	GO:BP	positive regulation of lymphocyte differentiation	16175	11472		0.49246231155778897	0.495	99	16076	7	21	92	16055	16175	0.13021049257914144
M1	cpdb	0	network_modules	161	TRUE	5.134208708406404e-7	257	28	9	0.32142857142857145	0.03501945525291829	GO:0022409	GO:BP	positive regulation of cell-cell adhesion	16175	6600		0.49748743718592964	0.5	257	15918	9	19	248	15899	16175	0.10175000463465046
M1	cpdb	0	network_modules	161	TRUE	6.382884649592847e-7	54	28	6	0.21428571428571427	0.1111111111111111	GO:0042531	GO:BP	positive regulation of tyrosine phosphorylation of STAT protein	16175	10227		0.5025125628140703	0.505	54	16121	6	22	48	16099	16175	0.15228542450875196
M1	cpdb	0	network_modules	161	TRUE	6.764826965759606e-7	104	28	7	0.25	0.0673076923076923	GO:0050671	GO:BP	positive regulation of lymphocyte proliferation	16175	13205		0.507537688442211	0.51	104	16071	7	21	97	16050	16175	0.12690058876223356
M1	cpdb	0	network_modules	161	TRUE	7.125139918586065e-7	175	28	8	0.2857142857142857	0.045714285714285714	GO:0045165	GO:BP	cell fate commitment	16175	11307		0.5125628140703518	0.515	175	16000	8	20	167	15980	16175	0.11065356168949146
M1	cpdb	0	network_modules	161	TRUE	7.239762092543252e-7	105	28	7	0.25	0.06666666666666667	GO:0032946	GO:BP	positive regulation of mononuclear cell proliferation	16175	7931		0.5175879396984925	0.52	105	16070	7	21	98	16049	16175	0.12626672646809675
M1	cpdb	0	network_modules	161	TRUE	8.626315735945718e-7	8	28	4	0.14285714285714285	0.5	GO:0010455	GO:BP	positive regulation of cell fate commitment	16175	4151		0.5226130653266332	0.525	8	16167	4	24	4	16143	16175	0.26663271544947015
M1	cpdb	0	network_modules	161	TRUE	9.349066199933741e-7	275	28	9	0.32142857142857145	0.03272727272727273	GO:0002696	GO:BP	positive regulation of leukocyte activation	16175	1214		0.5276381909547738	0.53	275	15900	9	19	266	15881	16175	0.09806085556242466
M1	cpdb	0	network_modules	161	TRUE	9.534583820119199e-7	25	28	5	0.17857142857142858	0.2	GO:0032814	GO:BP	regulation of natural killer cell activation	16175	7838		0.5326633165829145	0.535	25	16150	5	23	20	16127	16175	0.18765397253147748
M1	cpdb	0	network_modules	161	TRUE	1.0064322293494256e-6	110	28	7	0.25	0.06363636363636363	GO:0002705	GO:BP	positive regulation of leukocyte mediated immunity	16175	1223		0.5376884422110553	0.54	110	16065	7	21	103	16044	16175	0.1232262242150234
M1	cpdb	0	network_modules	161	TRUE	1.3574531990275234e-6	12	20	4	0.2	0.3333333333333333	REAC:R-HSA-8984722	REAC	Interleukin-35 Signalling	10916	1248		0.8333333333333334	0.8571428571428571	12	10904	4	16	8	10888	10916	0.25715663631504615
M1	cpdb	0	network_modules	161	TRUE	1.4453276391573562e-6	27	28	5	0.17857142857142858	0.18518518518518517	GO:0043372	GO:BP	positive regulation of CD4-positive, alpha-beta T cell differentiation	16175	10649		0.542713567839196	0.545	27	16148	5	23	22	16125	16175	0.18045517011094642
M1	cpdb	0	network_modules	161	TRUE	1.4895052791388589e-6	192	28	8	0.2857142857142857	0.041666666666666664	GO:0002699	GO:BP	positive regulation of immune effector process	16175	1217		0.5477386934673367	0.55	192	15983	8	20	184	15963	16175	0.10529337140113772
M1	cpdb	0	network_modules	161	TRUE	1.494089183880036e-6	290	28	9	0.32142857142857145	0.03103448275862069	GO:0050867	GO:BP	positive regulation of cell activation	16175	13315		0.5527638190954773	0.555	290	15885	9	19	281	15866	16175	0.09524517746227601
M1	cpdb	0	network_modules	161	TRUE	1.5508932370893082e-6	9	28	4	0.14285714285714285	0.4444444444444444	GO:0043382	GO:BP	positive regulation of memory T cell differentiation	16175	10659		0.5577889447236181	0.57	9	16166	4	24	5	16142	16175	0.25128233804226063
M1	cpdb	0	network_modules	161	TRUE	1.5508932370893082e-6	9	28	4	0.14285714285714285	0.4444444444444444	GO:0051135	GO:BP	positive regulation of NK T cell activation	16175	13519		0.5577889447236181	0.57	9	16166	4	24	5	16142	16175	0.25128233804226063
M1	cpdb	0	network_modules	161	TRUE	1.5508932370893082e-6	9	28	4	0.14285714285714285	0.4444444444444444	GO:2000321	GO:BP	positive regulation of T-helper 17 cell differentiation	16175	25643		0.5577889447236181	0.57	9	16166	4	24	5	16142	16175	0.25128233804226063
M1	cpdb	0	network_modules	161	TRUE	1.661624656151956e-6	63	28	6	0.21428571428571427	0.09523809523809523	GO:0042509	GO:BP	regulation of tyrosine phosphorylation of STAT protein	16175	10226		0.5728643216080402	0.58	63	16112	6	22	57	16090	16175	0.14065628947156467
M1	cpdb	0	network_modules	161	TRUE	1.661624656151956e-6	63	28	6	0.21428571428571427	0.09523809523809523	GO:0031343	GO:BP	positive regulation of cell killing	16175	7134		0.5728643216080402	0.58	63	16112	6	22	57	16090	16175	0.14065628947156467
M1	cpdb	0	network_modules	161	TRUE	1.7535617137170345e-6	119	28	7	0.25	0.058823529411764705	GO:0070665	GO:BP	positive regulation of leukocyte proliferation	16175	16246		0.5829145728643216	0.585	119	16056	7	21	112	16035	16175	0.11823687171315898
M1	cpdb	0	network_modules	161	TRUE	2.015259334890052e-6	65	28	6	0.21428571428571427	0.09230769230769231	GO:0007260	GO:BP	tyrosine phosphorylation of STAT protein	16175	2790		0.5879396984924623	0.59	65	16110	6	22	59	16088	16175	0.1384026473993289
M1	cpdb	0	network_modules	161	TRUE	2.121058519050823e-6	29	28	5	0.17857142857142858	0.1724137931034483	GO:0010453	GO:BP	regulation of cell fate commitment	16175	4149		0.592964824120603	0.595	29	16146	5	23	24	16123	16175	0.17401049721620723
M1	cpdb	0	network_modules	161	TRUE	2.5817530452173434e-6	10	28	4	0.14285714285714285	0.4	GO:0043380	GO:BP	regulation of memory T cell differentiation	16175	10657		0.5979899497487438	0.61	10	16165	4	24	6	16141	16175	0.23829115796090963
M1	cpdb	0	network_modules	161	TRUE	2.5817530452173434e-6	10	28	4	0.14285714285714285	0.4	GO:0090715	GO:BP	immunological memory formation process	16175	18426		0.5979899497487438	0.61	10	16165	4	24	6	16141	16175	0.23829115796090963
M1	cpdb	0	network_modules	161	TRUE	2.5817530452173434e-6	10	28	4	0.14285714285714285	0.4	GO:0043379	GO:BP	memory T cell differentiation	16175	10656		0.5979899497487438	0.61	10	16165	4	24	6	16141	16175	0.23829115796090963
M1	cpdb	0	network_modules	161	TRUE	3.027551888322003e-6	31	28	5	0.17857142857142858	0.16129032258064516	GO:0002230	GO:BP	positive regulation of defense response to virus by host	16175	763		0.6130653266331658	0.615	31	16144	5	23	26	16121	16175	0.16819637300857265
M1	cpdb	0	network_modules	161	TRUE	4.052223476306975e-6	11	28	4	0.14285714285714285	0.36363636363636365	GO:0051133	GO:BP	regulation of NK T cell activation	16175	13517		0.6180904522613065	0.62	11	16164	4	24	7	16140	16175	0.22710997663524804
M1	cpdb	0	network_modules	161	TRUE	4.2189369160632675e-6	33	28	5	0.17857142857142858	0.15151515151515152	GO:2000516	GO:BP	positive regulation of CD4-positive, alpha-beta T cell activation	16175	25819		0.6231155778894473	0.625	33	16142	5	23	28	16119	16175	0.16291584314912988
M1	cpdb	0	network_modules	161	TRUE	4.480765033233622e-6	136	28	7	0.25	0.051470588235294115	GO:0002706	GO:BP	regulation of lymphocyte mediated immunity	16175	1224		0.628140703517588	0.63	136	16039	7	21	129	16018	16175	0.1101797460159155
M1	cpdb	0	network_modules	161	TRUE	4.9404737160721e-6	34	28	5	0.17857142857142858	0.14705882352941177	GO:0001916	GO:BP	positive regulation of T cell mediated cytotoxicity	16175	533		0.6331658291457286	0.635	34	16141	5	23	29	16118	16175	0.16045090154839442
M1	cpdb	0	network_modules	161	TRUE	5.079473105594212e-6	622	28	11	0.39285714285714285	0.017684887459807074	GO:0030155	GO:BP	regulation of cell adhesion	16175	6688		0.6381909547738693	0.64	622	15553	11	17	611	15536	16175	0.07674890224039596
M1	cpdb	0	network_modules	161	TRUE	5.220227055231477e-6	139	28	7	0.25	0.050359712230215826	GO:1902107	GO:BP	positive regulation of leukocyte differentiation	16175	22021		0.6432160804020101	0.65	139	16036	7	21	132	16015	16175	0.10891078860193579
M1	cpdb	0	network_modules	161	TRUE	5.220227055231477e-6	139	28	7	0.25	0.050359712230215826	GO:1903708	GO:BP	positive regulation of hemopoiesis	16175	23222		0.6432160804020101	0.65	139	16036	7	21	132	16015	16175	0.10891078860193579
M1	cpdb	0	network_modules	161	TRUE	5.704056534533207e-6	77	28	6	0.21428571428571427	0.07792207792207792	GO:0042102	GO:BP	positive regulation of T cell proliferation	16175	9967		0.6532663316582915	0.655	77	16098	6	22	71	16076	16175	0.1267600760598011
M1	cpdb	0	network_modules	161	TRUE	5.757050187679452e-6	35	28	5	0.17857142857142858	0.14285714285714285	GO:0032660	GO:BP	regulation of interleukin-17 production	16175	7706		0.6582914572864321	0.665	35	16140	5	23	30	16117	16175	0.15809162932542528
M1	cpdb	0	network_modules	161	TRUE	5.757050187679452e-6	35	28	5	0.17857142857142858	0.14285714285714285	GO:0032620	GO:BP	interleukin-17 production	16175	7667		0.6582914572864321	0.665	35	16140	5	23	30	16117	16175	0.15809162932542528
M1	cpdb	0	network_modules	161	TRUE	5.7944304105253476e-6	228	28	8	0.2857142857142857	0.03508771929824561	GO:0051607	GO:BP	defense response to virus	16175	13823		0.6683417085427136	0.67	228	15947	8	20	220	15927	16175	0.09594663378228918
M1	cpdb	0	network_modules	161	TRUE	6.071118245049677e-6	12	28	4	0.14285714285714285	0.3333333333333333	GO:0051132	GO:BP	NK T cell activation	16175	13516		0.6733668341708543	0.675	12	16163	4	24	8	16139	16175	0.2173534201376294
M1	cpdb	0	network_modules	161	TRUE	7.711907371996202e-6	37	28	5	0.17857142857142858	0.13513513513513514	GO:0046638	GO:BP	positive regulation of alpha-beta T cell differentiation	16175	12275		0.678391959798995	0.68	37	16138	5	23	32	16115	16175	0.1536612751289379
M1	cpdb	0	network_modules	161	TRUE	8.581092199986418e-6	654	28	11	0.39285714285714285	0.016819571865443424	GO:0031347	GO:BP	regulation of defense response	16175	7138		0.6834170854271356	0.685	654	15521	11	17	643	15504	16175	0.07450657479059719
M1	cpdb	0	network_modules	161	TRUE	8.758980867313558e-6	13	28	4	0.14285714285714285	0.3076923076923077	GO:0090713	GO:BP	immunological memory process	16175	18424		0.6884422110552764	0.69	13	16162	4	24	9	16138	16175	0.20874202396775826
M1	cpdb	0	network_modules	161	TRUE	1.1600130649173941e-5	40	28	5	0.17857142857142858	0.125	GO:0050691	GO:BP	regulation of defense response to virus by host	16175	13221		0.6934673366834171	0.695	40	16135	5	23	35	16112	16175	0.14764491717280076
M1	cpdb	0	network_modules	161	TRUE	1.3541655270361902e-5	373	28	9	0.32142857142857145	0.024128686327077747	GO:0045785	GO:BP	positive regulation of cell adhesion	16175	11617		0.6984924623115578	0.7	373	15802	9	19	364	15783	16175	0.0827788917451241
M1	cpdb	0	network_modules	161	TRUE	1.4961011022668793e-5	42	28	5	0.17857142857142858	0.11904761904761904	GO:0001914	GO:BP	regulation of T cell mediated cytotoxicity	16175	531		0.7035175879396985	0.705	42	16133	5	23	37	16110	16175	0.1439944395547196
M1	cpdb	0	network_modules	161	TRUE	1.6682005920132264e-5	15	28	4	0.14285714285714285	0.26666666666666666	GO:0032816	GO:BP	positive regulation of natural killer cell activation	16175	7840		0.7085427135678392	0.71	15	16160	4	24	11	16136	16175	0.19417111390020736
M1	cpdb	0	network_modules	161	TRUE	1.9543907794748046e-5	168	28	7	0.25	0.041666666666666664	GO:0001906	GO:BP	cell killing	16175	524		0.7135678391959799	0.715	168	16007	7	21	161	15986	16175	0.09841906512886217
M1	cpdb	0	network_modules	161	TRUE	2.1411151857039234e-5	45	28	5	0.17857142857142858	0.1111111111111111	GO:0001913	GO:BP	T cell mediated cytotoxicity	16175	530		0.7185929648241206	0.73	45	16130	5	23	40	16107	16175	0.13897814816127552
M1	cpdb	0	network_modules	161	TRUE	2.1411151857039234e-5	45	28	5	0.17857142857142858	0.1111111111111111	GO:0032653	GO:BP	regulation of interleukin-10 production	16175	7700		0.7185929648241206	0.73	45	16130	5	23	40	16107	16175	0.13897814816127552
M1	cpdb	0	network_modules	161	TRUE	2.1411151857039234e-5	45	28	5	0.17857142857142858	0.1111111111111111	GO:0032613	GO:BP	interleukin-10 production	16175	7661		0.7185929648241206	0.73	45	16130	5	23	40	16107	16175	0.13897814816127552
M1	cpdb	0	network_modules	161	TRUE	2.2216265047816887e-5	16	28	4	0.14285714285714285	0.25	GO:2000318	GO:BP	positive regulation of T-helper 17 type immune response	16175	25640		0.7336683417085427	0.735	16	16159	4	24	12	16135	16175	0.18792929328245603
M1	cpdb	0	network_modules	161	TRUE	2.805559035682466e-5	177	28	7	0.25	0.03954802259887006	GO:0002703	GO:BP	regulation of leukocyte mediated immunity	16175	1221		0.7386934673366834	0.74	177	15998	7	21	170	15977	16175	0.09568849143652637
M1	cpdb	0	network_modules	161	TRUE	3.318489547138883e-5	745	28	11	0.39285714285714285	0.01476510067114094	GO:0098609	GO:BP	cell-cell adhesion	16175	18805		0.7437185929648241	0.745	745	15430	11	17	734	15413	16175	0.06889590049999059
M1	cpdb	0	network_modules	161	TRUE	3.325958370285357e-5	49	28	5	0.17857142857142858	0.10204081632653061	GO:0045670	GO:BP	regulation of osteoclast differentiation	16175	11521		0.7487437185929648	0.75	49	16126	5	23	44	16103	16175	0.13301395620056633
M1	cpdb	0	network_modules	161	TRUE	3.726397370762878e-5	18	28	4	0.14285714285714285	0.2222222222222222	GO:0045624	GO:BP	positive regulation of T-helper cell differentiation	16175	11475		0.7537688442211056	0.755	18	16157	4	24	14	16133	16175	0.17703796751553944
M1	cpdb	0	network_modules	161	TRUE	4.929663927327982e-5	34	19	4	0.21052631578947367	0.11764705882352941	KEGG:05330	KEGG	Allograft rejection	8484	486		0.5	0.5454545454545454	34	8450	4	15	30	8435	8484	0.1548658642321423
M1	cpdb	0	network_modules	161	TRUE	5.483360360373255e-5	54	28	5	0.17857142857142858	0.09259259259259259	GO:0050688	GO:BP	regulation of defense response to virus	16175	13219		0.7587939698492462	0.76	54	16121	5	23	49	16098	16175	0.12650283808838453
M1	cpdb	0	network_modules	161	TRUE	5.8861265398165824e-5	20	28	4	0.14285714285714285	0.2	GO:0042104	GO:BP	positive regulation of activated T cell proliferation	16175	9969		0.7638190954773869	0.77	20	16155	4	24	16	16131	16175	0.167816839702699
M1	cpdb	0	network_modules	161	TRUE	5.8861265398165824e-5	20	28	4	0.14285714285714285	0.2	GO:0045672	GO:BP	positive regulation of osteoclast differentiation	16175	11523		0.7638190954773869	0.77	20	16155	4	24	16	16131	16175	0.167816839702699
M1	cpdb	0	network_modules	161	TRUE	6.993919055620823e-5	451	28	9	0.32142857142857145	0.019955654101995565	GO:0002831	GO:BP	regulation of response to biotic stimulus	16175	1341		0.7738693467336684	0.775	451	15724	9	19	442	15705	16175	0.07424783848708913
M1	cpdb	0	network_modules	161	TRUE	7.234060383767734e-5	57	28	5	0.17857142857142858	0.08771929824561403	GO:0001912	GO:BP	positive regulation of leukocyte mediated cytotoxicity	16175	529		0.7788944723618091	0.78	57	16118	5	23	52	16095	16175	0.12300994422926535
M1	cpdb	0	network_modules	161	TRUE	8.575361357232772e-5	627	28	10	0.35714285714285715	0.01594896331738437	GO:0050778	GO:BP	positive regulation of immune response	16175	13252		0.7839195979899497	0.785	627	15548	10	18	617	15530	16175	0.06868330971487283
M1	cpdb	0	network_modules	161	TRUE	1.411478577300218e-4	131	28	6	0.21428571428571427	0.04580152671755725	GO:0050731	GO:BP	positive regulation of peptidyl-tyrosine phosphorylation	16175	13230		0.7889447236180904	0.79	131	16044	6	22	125	16022	16175	0.09579575362398124
M1	cpdb	0	network_modules	161	TRUE	1.573667210583068e-4	104	19	5	0.2631578947368421	0.04807692307692308	KEGG:04625	KEGG	C-type lectin receptor signaling pathway	8484	330		0.6	0.6363636363636364	104	8380	5	14	99	8366	8484	0.10802521542365263
M1	cpdb	0	network_modules	161	TRUE	1.6001706589343126e-4	228	28	7	0.25	0.03070175438596491	GO:0001818	GO:BP	negative regulation of cytokine production	16175	475		0.7939698492462312	0.795	228	15947	7	21	221	15926	16175	0.08333090248368959
M1	cpdb	0	network_modules	161	TRUE	2.727495904136324e-4	74	28	5	0.17857142857142858	0.06756756756756757	GO:0030316	GO:BP	osteoclast differentiation	16175	6767		0.7989949748743719	0.8	74	16101	5	23	69	16078	16175	0.10736816432909817
M1	cpdb	0	network_modules	161	TRUE	2.8547889473122025e-4	29	28	4	0.14285714285714285	0.13793103448275862	GO:0046640	GO:BP	regulation of alpha-beta T cell proliferation	16175	12277		0.8040201005025126	0.805	29	16146	4	24	25	16122	16175	0.1388554344222556
M1	cpdb	0	network_modules	161	TRUE	2.918848685279396e-4	75	28	5	0.17857142857142858	0.06666666666666667	GO:0030101	GO:BP	natural killer cell activation	16175	6679		0.8090452261306532	0.81	75	16100	5	23	70	16077	16175	0.10661539096288693
M1	cpdb	0	network_modules	161	TRUE	3.290076090154222e-4	30	28	4	0.14285714285714285	0.13333333333333333	GO:0046633	GO:BP	alpha-beta T cell proliferation	16175	12270		0.8140703517587939	0.815	30	16145	4	24	26	16121	16175	0.13646595659644098
M1	cpdb	0	network_modules	161	TRUE	3.5575375523050026e-4	78	28	5	0.17857142857142858	0.0641025641025641	GO:0001910	GO:BP	regulation of leukocyte mediated cytotoxicity	16175	527		0.8190954773869347	0.82	78	16097	5	23	73	16074	16175	0.10444324403179206
M1	cpdb	0	network_modules	161	TRUE	3.773009508120296e-4	31	28	4	0.14285714285714285	0.12903225806451613	GO:0032733	GO:BP	positive regulation of interleukin-10 production	16175	7778		0.8241206030150754	0.825	31	16144	4	24	27	16120	16175	0.13419214421092165
M1	cpdb	0	network_modules	161	TRUE	4.4594768412236935e-4	8	28	3	0.10714285714285714	0.375	GO:0032819	GO:BP	positive regulation of natural killer cell proliferation	16175	7843		0.8291457286432161	0.83	8	16167	3	25	5	16142	16175	0.19974295534656084
M1	cpdb	0	network_modules	161	TRUE	4.895125629886689e-4	33	28	4	0.14285714285714285	0.12121212121212122	GO:0046006	GO:BP	regulation of activated T cell proliferation	16175	11797		0.8341708542713567	0.835	33	16142	4	24	29	16118	16175	0.12995610827480467
M1	cpdb	0	network_modules	161	TRUE	4.927965663207078e-4	269	28	7	0.25	0.026022304832713755	GO:0002449	GO:BP	lymphocyte mediated immunity	16175	972		0.8391959798994975	0.84	269	15906	7	21	262	15885	16175	0.07599143711461089
M1	cpdb	0	network_modules	161	TRUE	5.541221748916824e-4	34	28	4	0.14285714285714285	0.11764705882352941	GO:0050798	GO:BP	activated T cell proliferation	16175	13265		0.8442211055276382	0.85	34	16141	4	24	30	16117	16175	0.12797848018601712
M1	cpdb	0	network_modules	161	TRUE	5.541221748916824e-4	34	28	4	0.14285714285714285	0.11764705882352941	GO:0032735	GO:BP	positive regulation of interleukin-12 production	16175	7780		0.8442211055276382	0.85	34	16141	4	24	30	16117	16175	0.12797848018601712
M1	cpdb	0	network_modules	161	TRUE	5.548294231896031e-4	165	28	6	0.21428571428571427	0.03636363636363636	GO:0002573	GO:BP	myeloid leukocyte differentiation	16175	1094		0.8542713567839196	0.855	165	16010	6	22	159	15988	16175	0.08457663003814928
M1	cpdb	0	network_modules	161	TRUE	6.903871996798191e-4	89	28	5	0.17857142857142858	0.056179775280898875	GO:0002761	GO:BP	regulation of myeloid leukocyte differentiation	16175	1272		0.8592964824120602	0.86	89	16086	5	23	84	16063	16175	0.0974266809583863
M1	cpdb	0	network_modules	161	TRUE	6.944308363289526e-4	283	28	7	0.25	0.024734982332155476	GO:0010720	GO:BP	positive regulation of cell development	16175	4346		0.864321608040201	0.865	283	15892	7	21	276	15871	16175	0.07384567443239826
M1	cpdb	0	network_modules	161	TRUE	7.846896369146674e-4	175	28	6	0.21428571428571427	0.03428571428571429	GO:0050730	GO:BP	regulation of peptidyl-tyrosine phosphorylation	16175	13229		0.8693467336683417	0.87	175	16000	6	22	169	15978	16175	0.08190141132278424
M1	cpdb	0	network_modules	161	TRUE	9.533879337877791e-4	10	28	3	0.10714285714285714	0.3	GO:0032817	GO:BP	regulation of natural killer cell proliferation	16175	7841		0.8743718592964824	0.875	10	16165	3	25	7	16140	16175	0.1784594367560398
M1	cpdb	0	network_modules	161	TRUE	0.0010361842585209233	72	19	4	0.21052631578947367	0.05555555555555555	KEGG:05140	KEGG	Leishmaniasis	8484	433		0.7	0.7272727272727273	72	8412	4	15	68	8397	8484	0.10434819171944792
M1	cpdb	0	network_modules	161	TRUE	0.0012848780166313494	76	19	4	0.21052631578947367	0.05263157894736842	KEGG:05133	KEGG	Pertussis	8484	430		0.8	0.8181818181818182	76	8408	4	15	72	8393	8484	0.10135216151111155
M1	cpdb	0	network_modules	161	TRUE	0.0013093888251545815	11	28	3	0.10714285714285714	0.2727272727272727	GO:0032736	GO:BP	positive regulation of interleukin-13 production	16175	7781		0.8793969849246231	0.885	11	16164	3	25	8	16139	16175	0.17006090420272324
M1	cpdb	0	network_modules	161	TRUE	0.0013093888251545815	11	28	3	0.10714285714285714	0.2727272727272727	GO:0032700	GO:BP	negative regulation of interleukin-17 production	16175	7745		0.8793969849246231	0.885	11	16164	3	25	8	16139	16175	0.17006090420272324
M1	cpdb	0	network_modules	161	TRUE	0.001651877881949041	106	28	5	0.17857142857142858	0.04716981132075472	GO:0001909	GO:BP	leukocyte mediated cytotoxicity	16175	526		0.8894472361809045	0.89	106	16069	5	23	101	16046	16175	0.08877776038282718
M1	cpdb	0	network_modules	161	TRUE	0.001743828060791088	12	28	3	0.10714285714285714	0.25	GO:0001787	GO:BP	natural killer cell proliferation	16175	449		0.8944723618090452	0.9	12	16163	3	25	9	16138	16175	0.16273140207277706
M1	cpdb	0	network_modules	161	TRUE	0.001743828060791088	12	28	3	0.10714285714285714	0.25	GO:0034393	GO:BP	positive regulation of smooth muscle cell apoptotic process	16175	8614		0.8944723618090452	0.9	12	16163	3	25	9	16138	16175	0.16273140207277706
M1	cpdb	0	network_modules	161	TRUE	0.0017571473195241592	45	28	4	0.14285714285714285	0.08888888888888889	GO:0002763	GO:BP	positive regulation of myeloid leukocyte differentiation	16175	1274		0.9045226130653267	0.905	45	16130	4	24	41	16106	16175	0.11074262035233712
M1	cpdb	0	network_modules	161	TRUE	0.002112893279721258	334	28	7	0.25	0.020958083832335328	GO:0002443	GO:BP	leukocyte mediated immunity	16175	966		0.9095477386934674	0.91	334	15841	7	21	327	15820	16175	0.06716038949373937
M1	cpdb	0	network_modules	161	TRUE	0.0024280986051554757	686	28	9	0.32142857142857145	0.013119533527696793	GO:0008284	GO:BP	positive regulation of cell population proliferation	16175	3151		0.914572864321608	0.915	686	15489	9	19	677	15470	16175	0.057654736185915566
M1	cpdb	0	network_modules	161	TRUE	0.0025468008087559915	214	28	6	0.21428571428571427	0.028037383177570093	GO:0018108	GO:BP	peptidyl-tyrosine phosphorylation	16175	5327		0.9195979899497487	0.92	214	15961	6	22	208	15939	16175	0.07327506855697292
M1	cpdb	0	network_modules	161	TRUE	0.002616840735311016	215	28	6	0.21428571428571427	0.027906976744186046	GO:0018212	GO:BP	peptidyl-tyrosine modification	16175	5371		0.9246231155778895	0.925	215	15960	6	22	209	15938	16175	0.07308427295740344
M1	cpdb	0	network_modules	161	TRUE	0.00269991754135925	50	28	4	0.14285714285714285	0.08	GO:0032655	GO:BP	regulation of interleukin-12 production	16175	7702		0.9296482412060302	0.935	50	16125	4	24	46	16101	16175	0.10484407873116088
M1	cpdb	0	network_modules	161	TRUE	0.00269991754135925	50	28	4	0.14285714285714285	0.08	GO:0032615	GO:BP	interleukin-12 production	16175	7663		0.9296482412060302	0.935	50	16125	4	24	46	16101	16175	0.10484407873116088
M1	cpdb	0	network_modules	161	TRUE	0.0028785580860284476	14	28	3	0.10714285714285714	0.21428571428571427	GO:0045063	GO:BP	T-helper 1 cell differentiation	16175	11261		0.9396984924623115	0.945	14	16161	3	25	11	16136	16175	0.15049423360121347
M1	cpdb	0	network_modules	161	TRUE	0.0028785580860284476	14	28	3	0.10714285714285714	0.21428571428571427	GO:0032725	GO:BP	positive regulation of granulocyte macrophage colony-stimulating factor production	16175	7770		0.9396984924623115	0.945	14	16161	3	25	11	16136	16175	0.15049423360121347
M1	cpdb	0	network_modules	161	TRUE	0.003263473154710179	76	20	4	0.2	0.05263157894736842	REAC:R-HSA-909733	REAC	Interferon alpha/beta signaling	10916	1228		1	1	76	10840	4	16	72	10824	10916	0.09946396571107319
M1	cpdb	0	network_modules	161	TRUE	0.003594027106055537	15	28	3	0.10714285714285714	0.2	GO:0010661	GO:BP	positive regulation of muscle cell apoptotic process	16175	4306		0.949748743718593	0.955	15	16160	3	25	12	16135	16175	0.14531116107917666
M1	cpdb	0	network_modules	161	TRUE	0.003594027106055537	15	28	3	0.10714285714285714	0.2	GO:0032693	GO:BP	negative regulation of interleukin-10 production	16175	7739		0.949748743718593	0.955	15	16160	3	25	12	16135	16175	0.14531116107917666
M1	cpdb	0	network_modules	161	TRUE	0.003666757452010573	721	28	9	0.32142857142857145	0.012482662968099861	GO:0045087	GO:BP	innate immune response	16175	11270		0.9597989949748744	0.96	721	15454	9	19	712	15435	16175	0.05586495933647643
M1	cpdb	0	network_modules	161	TRUE	0.004006059275109083	36	19	3	0.15789473684210525	0.08333333333333333	KEGG:05143	KEGG	African trypanosomiasis	8484	435		0.9	0.9090909090909091	36	8448	3	16	33	8432	8484	0.1119882490174578
M1	cpdb	0	network_modules	161	TRUE	0.004418291146288086	16	28	3	0.10714285714285714	0.1875	GO:0032656	GO:BP	regulation of interleukin-13 production	16175	7703		0.964824120603015	0.98	16	16159	3	25	13	16134	16175	0.14061938357001555
M1	cpdb	0	network_modules	161	TRUE	0.004418291146288086	16	28	3	0.10714285714285714	0.1875	GO:0032645	GO:BP	regulation of granulocyte macrophage colony-stimulating factor production	16175	7692		0.964824120603015	0.98	16	16159	3	25	13	16134	16175	0.14061938357001555
M1	cpdb	0	network_modules	161	TRUE	0.004418291146288086	16	28	3	0.10714285714285714	0.1875	GO:0032616	GO:BP	interleukin-13 production	16175	7664		0.964824120603015	0.98	16	16159	3	25	13	16134	16175	0.14061938357001555
M1	cpdb	0	network_modules	161	TRUE	0.004418291146288086	16	28	3	0.10714285714285714	0.1875	GO:0032604	GO:BP	granulocyte macrophage colony-stimulating factor production	16175	7652		0.964824120603015	0.98	16	16159	3	25	13	16134	16175	0.14061938357001555
M1	cpdb	0	network_modules	161	TRUE	0.005358849775277653	17	28	3	0.10714285714285714	0.17647058823529413	GO:0071353	GO:BP	cellular response to interleukin-4	16175	16605		0.9849246231155779	0.985	17	16158	3	25	14	16133	16175	0.13634560791566383
M1	cpdb	0	network_modules	161	TRUE	0.005512092242167408	40	19	3	0.15789473684210525	0.075	KEGG:04940	KEGG	Type I diabetes mellitus	8484	394		1	1	40	8444	3	16	37	8428	8484	0.10594046592213915
M1	cpdb	0	network_modules	161	TRUE	0.006423166935591639	18	28	3	0.10714285714285714	0.16666666666666666	GO:0046641	GO:BP	positive regulation of alpha-beta T cell proliferation	16175	12278		0.9899497487437185	0.995	18	16157	3	25	15	16132	16175	0.13243099629359648
M1	cpdb	0	network_modules	161	TRUE	0.006423166935591639	18	28	3	0.10714285714285714	0.16666666666666666	GO:0070670	GO:BP	response to interleukin-4	16175	16251		0.9899497487437185	0.995	18	16157	3	25	15	16132	16175	0.13243099629359648
M1	cpdb	0	network_modules	161	TRUE	0.00818502934232914	795	28	9	0.32142857142857145	0.011320754716981131	GO:0051241	GO:BP	negative regulation of multicellular organismal process	16175	13591		1	1	795	15380	9	19	786	15361	16175	0.05244803683370131
M1	cpdb	0	network_modules	162	TRUE	4.370248231574883e-10	74	22	8	0.36363636363636365	0.10810810810810811	KEGG:01230	KEGG	Biosynthesis of amino acids	8484	188		0	0.25	74	8410	8	14	66	8396	8484	0.19461882214248621
M1	cpdb	0	network_modules	162	TRUE	2.499246028125046e-9	48	28	7	0.25	0.14583333333333334	GO:0097237	GO:BP	cellular response to toxic substance	16175	18553		0	0.013333333333333334	48	16127	7	21	41	16106	16175	0.1891184890725991
M1	cpdb	0	network_modules	162	TRUE	1.4308946759215192e-8	67	22	7	0.3181818181818182	0.1044776119402985	KEGG:00010	KEGG	Glycolysis / Gluconeogenesis	8484	2		0.3333333333333333	0.5	67	8417	7	15	60	8402	8484	0.1787391325664997
M1	cpdb	0	network_modules	162	TRUE	1.614114842986474e-8	115	22	8	0.36363636363636365	0.06956521739130435	KEGG:01200	KEGG	Carbon metabolism	8484	184		0.6666666666666666	0.75	115	8369	8	14	107	8355	8484	0.15436856545849564
M1	cpdb	0	network_modules	162	TRUE	4.948961608947163e-8	36	25	6	0.24	0.16666666666666666	REAC:R-HSA-3299685	REAC	Detoxification of Reactive Oxygen Species	10916	735		0	0.125	36	10880	6	19	30	10861	10916	0.1978044439706015
M1	cpdb	0	network_modules	162	TRUE	1.76506603398782e-7	44	28	6	0.21428571428571427	0.13636363636363635	GO:1990748	GO:BP	cellular detoxification	16175	25271		0.013513513513513514	0.02666666666666667	44	16131	6	22	38	16109	16175	0.16914734272157383
M1	cpdb	0	network_modules	162	TRUE	3.8304076609971827e-7	96	28	7	0.25	0.07291666666666667	GO:0006090	GO:BP	pyruvate metabolic process	16175	1953		0.02702702702702703	0.04	96	16079	7	21	89	16058	16175	0.13231759577990365
M1	cpdb	0	network_modules	162	TRUE	4.123621033266818e-7	97	28	7	0.25	0.07216494845360824	GO:0009636	GO:BP	response to toxic substance	16175	3554		0.04054054054054054	0.05333333333333334	97	16078	7	21	90	16057	16175	0.13160452783562435
M1	cpdb	0	network_modules	162	TRUE	5.743695872968219e-7	372	28	10	0.35714285714285715	0.026881720430107527	GO:0006091	GO:BP	generation of precursor metabolites and energy	16175	1954		0.05405405405405406	0.06666666666666667	372	15803	10	18	362	15785	16175	0.09282614887256718
M1	cpdb	0	network_modules	162	TRUE	6.052915598847443e-7	23	28	5	0.17857142857142858	0.21739130434782608	GO:0098869	GO:BP	cellular oxidant detoxification	16175	18920		0.06756756756756757	0.08	23	16152	5	23	18	16129	16175	0.19576732022850926
M1	cpdb	0	network_modules	162	TRUE	6.736686974995016e-7	265	28	9	0.32142857142857145	0.033962264150943396	GO:0006979	GO:BP	response to oxidative stress	16175	2604		0.08108108108108109	0.09333333333333334	265	15910	9	19	256	15891	16175	0.10006533233703756
M1	cpdb	0	network_modules	162	TRUE	2.429143789328149e-6	67	28	6	0.21428571428571427	0.08955223880597014	GO:0098754	GO:BP	detoxification	16175	18873		0.0945945945945946	0.10666666666666667	67	16108	6	22	61	16086	16175	0.13624958000509738
M1	cpdb	0	network_modules	162	TRUE	2.771760701367929e-6	127	28	7	0.25	0.05511811023622047	GO:0000302	GO:BP	response to reactive oxygen species	16175	88		0.10810810810810811	0.12	127	16048	7	21	120	16027	16175	0.11424747930698538
M1	cpdb	0	network_modules	162	TRUE	3.296467525490415e-6	33	25	5	0.2	0.15151515151515152	REAC:R-HSA-70263	REAC	Gluconeogenesis	10916	1052		0.14285714285714285	0.25	33	10883	5	20	28	10863	10916	0.17190309593990777
M1	cpdb	0	network_modules	162	TRUE	3.7808714978608183e-6	72	28	6	0.21428571428571427	0.08333333333333333	GO:0046032	GO:BP	ADP catabolic process	16175	11809		0.12162162162162163	0.14666666666666667	72	16103	6	22	66	16081	16175	0.13126061241879516
M1	cpdb	0	network_modules	162	TRUE	3.7808714978608183e-6	72	28	6	0.21428571428571427	0.08333333333333333	GO:0006096	GO:BP	glycolytic process	16175	1956		0.12162162162162163	0.14666666666666667	72	16103	6	22	66	16081	16175	0.13126061241879516
M1	cpdb	0	network_modules	162	TRUE	4.4724675837779225e-6	74	28	6	0.21428571428571427	0.08108108108108109	GO:0009137	GO:BP	purine nucleoside diphosphate catabolic process	16175	3304		0.14864864864864866	0.18666666666666668	74	16101	6	22	68	16079	16175	0.12940641234025463
M1	cpdb	0	network_modules	162	TRUE	4.4724675837779225e-6	74	28	6	0.21428571428571427	0.08108108108108109	GO:0009181	GO:BP	purine ribonucleoside diphosphate catabolic process	16175	3347		0.14864864864864866	0.18666666666666668	74	16101	6	22	68	16079	16175	0.12940641234025463
M1	cpdb	0	network_modules	162	TRUE	4.4724675837779225e-6	74	28	6	0.21428571428571427	0.08108108108108109	GO:0046031	GO:BP	ADP metabolic process	16175	11808		0.14864864864864866	0.18666666666666668	74	16101	6	22	68	16079	16175	0.12940641234025463
M1	cpdb	0	network_modules	162	TRUE	4.963005534635298e-6	138	28	7	0.25	0.050724637681159424	GO:0019362	GO:BP	pyridine nucleotide metabolic process	16175	5724		0.1891891891891892	0.21333333333333335	138	16037	7	21	131	16016	16175	0.10932926455503827
M1	cpdb	0	network_modules	162	TRUE	4.963005534635298e-6	138	28	7	0.25	0.050724637681159424	GO:0046496	GO:BP	nicotinamide nucleotide metabolic process	16175	12199		0.1891891891891892	0.21333333333333335	138	16037	7	21	131	16016	16175	0.10932926455503827
M1	cpdb	0	network_modules	162	TRUE	5.265738487212237e-6	76	28	6	0.21428571428571427	0.07894736842105263	GO:0009179	GO:BP	purine ribonucleoside diphosphate metabolic process	16175	3345		0.21621621621621623	0.24	76	16099	6	22	70	16077	16175	0.1276249825035527
M1	cpdb	0	network_modules	162	TRUE	5.265738487212237e-6	76	28	6	0.21428571428571427	0.07894736842105263	GO:0019364	GO:BP	pyridine nucleotide catabolic process	16175	5726		0.21621621621621623	0.24	76	16099	6	22	70	16077	16175	0.1276249825035527
M1	cpdb	0	network_modules	162	TRUE	5.704056534533207e-6	77	28	6	0.21428571428571427	0.07792207792207792	GO:0009191	GO:BP	ribonucleoside diphosphate catabolic process	16175	3357		0.24324324324324326	0.26666666666666666	77	16098	6	22	71	16076	16175	0.1267600760598011
M1	cpdb	0	network_modules	162	TRUE	5.704056534533207e-6	77	28	6	0.21428571428571427	0.07792207792207792	GO:0009135	GO:BP	purine nucleoside diphosphate metabolic process	16175	3302		0.24324324324324326	0.26666666666666666	77	16098	6	22	71	16076	16175	0.1267600760598011
M1	cpdb	0	network_modules	162	TRUE	6.3657075871400675e-6	143	28	7	0.25	0.04895104895104895	GO:0072524	GO:BP	pyridine-containing compound metabolic process	16175	17426		0.2702702702702703	0.28	143	16032	7	21	136	16011	16175	0.10728014192129373
M1	cpdb	0	network_modules	162	TRUE	6.671668052713996e-6	79	28	6	0.21428571428571427	0.0759493670886076	GO:0072526	GO:BP	pyridine-containing compound catabolic process	16175	17428		0.28378378378378377	0.29333333333333333	79	16096	6	22	73	16074	16175	0.12507914995787806
M1	cpdb	0	network_modules	162	TRUE	8.375157986163013e-6	82	28	6	0.21428571428571427	0.07317073170731707	GO:0009134	GO:BP	nucleoside diphosphate catabolic process	16175	3301		0.2972972972972973	0.30666666666666664	82	16093	6	22	76	16071	16175	0.12267249050598326
M1	cpdb	0	network_modules	162	TRUE	1.0423967648629735e-5	85	28	6	0.21428571428571427	0.07058823529411765	GO:0009185	GO:BP	ribonucleoside diphosphate metabolic process	16175	3351		0.3108108108108108	0.32	85	16090	6	22	79	16068	16175	0.12039264444250808
M1	cpdb	0	network_modules	162	TRUE	1.4752977595295185e-5	90	28	6	0.21428571428571427	0.06666666666666667	GO:0009154	GO:BP	purine ribonucleotide catabolic process	16175	3321		0.32432432432432434	0.3333333333333333	90	16085	6	22	84	16063	16175	0.1168457531506748
M1	cpdb	0	network_modules	162	TRUE	1.6856810740439226e-5	92	28	6	0.21428571428571427	0.06521739130434782	GO:0009261	GO:BP	ribonucleotide catabolic process	16175	3426		0.33783783783783783	0.3466666666666667	92	16083	6	22	86	16061	16175	0.11550742990009748
M1	cpdb	0	network_modules	162	TRUE	1.6909484090782204e-5	43	28	5	0.17857142857142858	0.11627906976744186	GO:0042743	GO:BP	hydrogen peroxide metabolic process	16175	10336		0.35135135135135137	0.36	43	16132	5	23	38	16109	16175	0.1422646486172932
M1	cpdb	0	network_modules	162	TRUE	1.7998280963742692e-5	93	28	6	0.21428571428571427	0.06451612903225806	GO:0009132	GO:BP	nucleoside diphosphate metabolic process	16175	3299		0.36486486486486486	0.37333333333333335	93	16082	6	22	87	16060	16175	0.11485426523732659
M1	cpdb	0	network_modules	162	TRUE	1.9072659318926694e-5	388	28	9	0.32142857142857145	0.023195876288659795	GO:0009117	GO:BP	nucleotide metabolic process	16175	3286		0.3783783783783784	0.38666666666666666	388	15787	9	19	379	15768	16175	0.08094918012405587
M1	cpdb	0	network_modules	162	TRUE	2.593360702581176e-5	175	28	7	0.25	0.04	GO:0072593	GO:BP	reactive oxygen species metabolic process	16175	17457		0.3918918918918919	0.4	175	16000	7	21	168	15979	16175	0.09627748650613785
M1	cpdb	0	network_modules	162	TRUE	2.627305520715233e-5	99	28	6	0.21428571428571427	0.06060606060606061	GO:0006195	GO:BP	purine nucleotide catabolic process	16175	2024		0.40540540540540543	0.41333333333333333	99	16076	6	22	93	16054	16175	0.11114215837846231
M1	cpdb	0	network_modules	162	TRUE	3.532754673250782e-5	183	28	7	0.25	0.03825136612021858	GO:0034599	GO:BP	cellular response to oxidative stress	16175	8684		0.4189189189189189	0.4266666666666667	183	15992	7	21	176	15971	16175	0.09397835475790511
M1	cpdb	0	network_modules	162	TRUE	3.6682674342623054e-5	184	28	7	0.25	0.03804347826086957	GO:0046034	GO:BP	ATP metabolic process	16175	11811		0.43243243243243246	0.44	184	15991	7	21	177	15970	16175	0.09370128478782469
M1	cpdb	0	network_modules	162	TRUE	3.808164081876958e-5	185	28	7	0.25	0.03783783783783784	GO:0046434	GO:BP	organophosphate catabolic process	16175	12142		0.44594594594594594	0.4533333333333333	185	15990	7	21	178	15969	16175	0.09342640536739857
M1	cpdb	0	network_modules	162	TRUE	4.1979637061950446e-5	107	28	6	0.21428571428571427	0.056074766355140186	GO:0034614	GO:BP	cellular response to reactive oxygen species	16175	8691		0.4594594594594595	0.4666666666666667	107	16068	6	22	101	16046	16175	0.10667914630343617
M1	cpdb	0	network_modules	162	TRUE	6.081607863251409e-5	198	28	7	0.25	0.03535353535353535	GO:0009205	GO:BP	purine ribonucleoside triphosphate metabolic process	16175	3371		0.47297297297297297	0.48	198	15977	7	21	191	15956	16175	0.09003967713201384
M1	cpdb	0	network_modules	162	TRUE	6.617564665765636e-5	610	28	10	0.35714285714285715	0.01639344262295082	GO:0043066	GO:BP	negative regulation of apoptotic process	16175	10512		0.4864864864864865	0.49333333333333335	610	15565	10	18	600	15547	16175	0.06982550143080725
M1	cpdb	0	network_modules	162	TRUE	6.744430376196838e-5	201	28	7	0.25	0.03482587064676617	GO:0009144	GO:BP	purine nucleoside triphosphate metabolic process	16175	3311		0.5	0.5066666666666667	201	15974	7	21	194	15953	16175	0.08930388562427298
M1	cpdb	0	network_modules	162	TRUE	6.82014931207385e-5	116	28	6	0.21428571428571427	0.05172413793103448	GO:0072523	GO:BP	purine-containing compound catabolic process	16175	17425		0.5135135135135135	0.52	116	16059	6	22	110	16037	16175	0.10221130101457791
M1	cpdb	0	network_modules	162	TRUE	7.180394925972226e-5	117	28	6	0.21428571428571427	0.05128205128205128	GO:0009166	GO:BP	nucleotide catabolic process	16175	3332		0.527027027027027	0.5333333333333333	117	16058	6	22	111	16036	16175	0.10174635165941912
M1	cpdb	0	network_modules	162	TRUE	7.262464185248455e-5	21	28	4	0.14285714285714285	0.19047619047619047	GO:0032148	GO:BP	activation of protein kinase B activity	16175	7382		0.5405405405405406	0.5466666666666666	21	16154	4	24	17	16130	16175	0.16370603885537185
M1	cpdb	0	network_modules	162	TRUE	7.467475050074294e-5	204	28	7	0.25	0.03431372549019608	GO:0009199	GO:BP	ribonucleoside triphosphate metabolic process	16175	3365		0.5540540540540541	0.56	204	15971	7	21	197	15950	16175	0.08858392180504165
M1	cpdb	0	network_modules	162	TRUE	8.969596159372262e-5	630	28	10	0.35714285714285715	0.015873015873015872	GO:0043069	GO:BP	negative regulation of programmed cell death	16175	10515		0.5675675675675675	0.5733333333333334	630	15545	10	18	620	15527	16175	0.06848627446018984
M1	cpdb	0	network_modules	162	TRUE	9.687571808630755e-5	123	28	6	0.21428571428571427	0.04878048780487805	GO:0016052	GO:BP	carbohydrate catabolic process	16175	5084		0.581081081081081	0.5866666666666667	123	16052	6	22	117	16030	16175	0.09907443804551054
M1	cpdb	0	network_modules	162	TRUE	1.070767004223202e-4	215	28	7	0.25	0.03255813953488372	GO:0009141	GO:BP	nucleoside triphosphate metabolic process	16175	3308		0.5945945945945946	0.6	215	15960	7	21	208	15939	16175	0.08607052051409905
M1	cpdb	0	network_modules	162	TRUE	1.1494417065387602e-4	211	25	7	0.28	0.03317535545023697	REAC:R-HSA-9711123	REAC	Cellular response to chemical stress	10916	333		0.2857142857142857	0.375	211	10705	7	18	204	10687	10916	0.09071040360401066
M1	cpdb	0	network_modules	162	TRUE	1.3723110281274776e-4	68	25	5	0.2	0.07352941176470588	REAC:R-HSA-70171	REAC	Glycolysis	10916	1074		0.42857142857142855	0.5	68	10848	5	20	63	10828	10916	0.11799355022452658
M1	cpdb	0	network_modules	162	TRUE	1.506663285964267e-4	226	28	7	0.25	0.030973451327433628	GO:0062197	GO:BP	cellular response to chemical stress	16175	15861		0.6081081081081081	0.6133333333333333	226	15949	7	21	219	15928	16175	0.08373743048369471
M1	cpdb	0	network_modules	162	TRUE	1.5939485466165383e-4	349	28	8	0.2857142857142857	0.022922636103151862	GO:0006163	GO:BP	purine nucleotide metabolic process	16175	1998		0.6216216216216216	0.6266666666666667	349	15826	8	20	341	15806	16175	0.07570239326571879
M1	cpdb	0	network_modules	162	TRUE	1.8105607459419545e-4	504	28	9	0.32142857142857145	0.017857142857142856	GO:0032787	GO:BP	monocarboxylic acid metabolic process	16175	7822		0.6351351351351351	0.64	504	15671	9	19	495	15652	16175	0.06956887442966883
M1	cpdb	0	network_modules	162	TRUE	2.009129709637446e-4	139	28	6	0.21428571428571427	0.04316546762589928	GO:1901292	GO:BP	nucleoside phosphate catabolic process	16175	21367		0.6486486486486487	0.6533333333333333	139	16036	6	22	133	16014	16175	0.09279825162191775
M1	cpdb	0	network_modules	162	TRUE	2.4016372168067854e-4	521	28	9	0.32142857142857145	0.01727447216890595	GO:0006753	GO:BP	nucleoside phosphate metabolic process	16175	2450		0.6621621621621622	0.6666666666666666	521	15654	9	19	512	15635	16175	0.06821371947987515
M1	cpdb	0	network_modules	162	TRUE	4.142233212554796e-4	742	28	10	0.35714285714285715	0.013477088948787063	GO:0019752	GO:BP	carboxylic acid metabolic process	16175	6036		0.6756756756756757	0.68	742	15433	10	18	732	15415	16175	0.06195651107269378
M1	cpdb	0	network_modules	162	TRUE	4.298005880507487e-4	558	28	9	0.32142857142857145	0.016129032258064516	GO:0055086	GO:BP	nucleobase-containing small molecule metabolic process	16175	14237		0.6891891891891891	0.6933333333333334	558	15617	9	19	549	15598	16175	0.06546946363094572
M1	cpdb	0	network_modules	162	TRUE	4.460061436745348e-4	86	25	5	0.2	0.05813953488372093	REAC:R-HSA-70326	REAC	Glucose metabolism	10916	1053		0.5714285714285714	0.625	86	10830	5	20	81	10810	10916	0.10411481228007909
M1	cpdb	0	network_modules	162	TRUE	4.567516592637693e-4	266	28	7	0.25	0.02631578947368421	GO:0009150	GO:BP	purine ribonucleotide metabolic process	16175	3317		0.7027027027027027	0.7066666666666667	266	15909	7	21	259	15888	16175	0.07647228163679015
M1	cpdb	0	network_modules	162	TRUE	4.684051032435227e-4	109	22	5	0.22727272727272727	0.045871559633027525	KEGG:04066	KEGG	HIF-1 signaling pathway	8484	257		1	1	109	8375	5	17	104	8358	8484	0.09708346758914024
M1	cpdb	0	network_modules	162	TRUE	4.895125629886689e-4	33	28	4	0.14285714285714285	0.12121212121212122	GO:1902175	GO:BP	regulation of oxidative stress-induced intrinsic apoptotic signaling pathway	16175	22078		0.7162162162162162	0.72	33	16142	4	24	29	16118	16175	0.12995610827480467
M1	cpdb	0	network_modules	162	TRUE	5.236527442489073e-4	761	28	10	0.35714285714285715	0.013140604467805518	GO:0043436	GO:BP	oxoacid metabolic process	16175	10693		0.7297297297297297	0.7333333333333333	761	15414	10	18	751	15396	16175	0.06098486425953499
M1	cpdb	0	network_modules	162	TRUE	5.631395791517995e-4	767	28	10	0.35714285714285715	0.01303780964797914	GO:0006082	GO:BP	organic acid metabolic process	16175	1947		0.7432432432432432	0.7466666666666667	767	15408	10	18	757	15390	16175	0.06068500976619222
M1	cpdb	0	network_modules	162	TRUE	5.721244587209203e-4	275	28	7	0.25	0.025454545454545455	GO:2001233	GO:BP	regulation of apoptotic signaling pathway	16175	26422		0.7567567567567568	0.76	275	15900	7	21	268	15879	16175	0.075052560531096
M1	cpdb	0	network_modules	162	TRUE	5.863387870363664e-4	276	28	7	0.25	0.025362318840579712	GO:0009259	GO:BP	ribonucleotide metabolic process	16175	3424		0.7702702702702703	0.7733333333333333	276	15899	7	21	269	15878	16175	0.0748989493830171
M1	cpdb	0	network_modules	162	TRUE	6.944308363289526e-4	283	28	7	0.25	0.024734982332155476	GO:0019693	GO:BP	ribose phosphate metabolic process	16175	6010		0.7837837837837838	0.7866666666666666	283	15892	7	21	276	15871	16175	0.07384567443239826
M1	cpdb	0	network_modules	162	TRUE	7.33373407180065e-4	173	28	6	0.21428571428571427	0.03468208092485549	GO:2001234	GO:BP	negative regulation of apoptotic signaling pathway	16175	26423		0.7972972972972973	0.8	173	16002	6	22	167	15980	16175	0.08241837724351639
M1	cpdb	0	network_modules	162	TRUE	9.769527219682338e-4	39	28	4	0.14285714285714285	0.10256410256410256	GO:0045454	GO:BP	cell redox homeostasis	16175	11384		0.8108108108108109	0.8133333333333334	39	16136	4	24	35	16112	16175	0.1192494970504416
M1	cpdb	0	network_modules	162	TRUE	0.0015134999378940838	469	28	8	0.2857142857142857	0.017057569296375266	GO:0072521	GO:BP	purine-containing compound metabolic process	16175	17423		0.8243243243243243	0.8266666666666667	469	15706	8	20	461	15686	16175	0.06371123823549153
M1	cpdb	0	network_modules	162	TRUE	0.0015253765382029338	196	28	6	0.21428571428571427	0.030612244897959183	GO:1901136	GO:BP	carbohydrate derivative catabolic process	16175	21244		0.8378378378378378	0.84	196	15979	6	22	190	15957	16175	0.07694625688996774
M1	cpdb	0	network_modules	162	TRUE	0.0017571473195241592	45	28	4	0.14285714285714285	0.08888888888888889	GO:0008631	GO:BP	intrinsic apoptotic signaling pathway in response to oxidative stress	16175	3219		0.8513513513513513	0.8533333333333334	45	16130	4	24	41	16106	16175	0.11074262035233712
M1	cpdb	0	network_modules	162	TRUE	0.0017731506814441475	2	25	2	0.08	1	REAC:R-HSA-9636667	REAC	Manipulation of host energy metabolism	10916	1391		0.7142857142857143	0.75	2	10914	2	23	0	10891	10916	0.28254452604712355
M1	cpdb	0	network_modules	162	TRUE	0.002941529049014102	126	25	5	0.2	0.03968253968253968	REAC:R-HSA-114608	REAC	Platelet degranulation 	10916	1764		0.8571428571428571	0.875	126	10790	5	20	121	10770	10916	0.08453112444552928
M1	cpdb	0	network_modules	162	TRUE	0.0035570566122058024	131	25	5	0.2	0.03816793893129771	REAC:R-HSA-76005	REAC	Response to elevated platelet cytosolic Ca2+	10916	2090		1	1	131	10785	5	20	126	10765	10916	0.08271991624886975
M1	cpdb	0	network_modules	162	TRUE	0.003974669775440618	55	28	4	0.14285714285714285	0.07272727272727272	GO:0006801	GO:BP	superoxide metabolic process	16175	2486		0.8648648648648649	0.8666666666666667	55	16120	4	24	51	16096	16175	0.09975928310776035
M1	cpdb	0	network_modules	162	TRUE	0.004982325234183615	2	28	2	0.07142857142857142	1	GO:0046166	GO:BP	glyceraldehyde-3-phosphate biosynthetic process	16175	11936		0.8783783783783784	0.92	2	16173	2	26	0	16147	16175	0.2670463285603229
M1	cpdb	0	network_modules	162	TRUE	0.004982325234183615	2	28	2	0.07142857142857142	1	GO:0036482	GO:BP	neuron intrinsic apoptotic signaling pathway in response to hydrogen peroxide	16175	9618		0.8783783783783784	0.92	2	16173	2	26	0	16147	16175	0.2670463285603229
M1	cpdb	0	network_modules	162	TRUE	0.004982325234183615	2	28	2	0.07142857142857142	1	GO:1903383	GO:BP	regulation of hydrogen peroxide-induced neuron intrinsic apoptotic signaling pathway	16175	22962		0.8783783783783784	0.92	2	16173	2	26	0	16147	16175	0.2670463285603229
M1	cpdb	0	network_modules	162	TRUE	0.004982325234183615	2	28	2	0.07142857142857142	1	GO:1903384	GO:BP	negative regulation of hydrogen peroxide-induced neuron intrinsic apoptotic signaling pathway	16175	22963		0.8783783783783784	0.92	2	16173	2	26	0	16147	16175	0.2670463285603229
M1	cpdb	0	network_modules	162	TRUE	0.005358849775277653	17	28	3	0.10714285714285714	0.17647058823529413	GO:0019430	GO:BP	removal of superoxide radicals	16175	5782		0.9324324324324325	0.9333333333333333	17	16158	3	25	14	16133	16175	0.13634560791566383
M1	cpdb	0	network_modules	162	TRUE	0.005868944607429005	137	28	5	0.17857142857142858	0.0364963503649635	GO:2001242	GO:BP	regulation of intrinsic apoptotic signaling pathway	16175	26431		0.9459459459459459	0.9466666666666667	137	16038	5	23	132	16015	16175	0.07729480579853915
M1	cpdb	0	network_modules	162	TRUE	0.006423166935591639	18	28	3	0.10714285714285714	0.16666666666666666	GO:0071451	GO:BP	cellular response to superoxide	16175	16685		0.9594594594594594	0.9866666666666667	18	16157	3	25	15	16132	16175	0.13243099629359648
M1	cpdb	0	network_modules	162	TRUE	0.006423166935591639	18	28	3	0.10714285714285714	0.16666666666666666	GO:0000303	GO:BP	response to superoxide	16175	89		0.9594594594594594	0.9866666666666667	18	16157	3	25	15	16132	16175	0.13243099629359648
M1	cpdb	0	network_modules	162	TRUE	0.006423166935591639	18	28	3	0.10714285714285714	0.16666666666666666	GO:0071450	GO:BP	cellular response to oxygen radical	16175	16684		0.9594594594594594	0.9866666666666667	18	16157	3	25	15	16132	16175	0.13243099629359648
M1	cpdb	0	network_modules	162	TRUE	0.00761867105046191	19	28	3	0.10714285714285714	0.15789473684210525	GO:0000305	GO:BP	response to oxygen radical	16175	91		1	1	19	16156	3	25	16	16131	16175	0.1288276952064913
M1	cpdb	0	network_modules	163	TRUE	2.3530556087524552e-11	30	21	7	0.3333333333333333	0.23333333333333334	KEGG:00020	KEGG	Citrate cycle (TCA cycle)	8484	3		0	0.07142857142857142	30	8454	7	14	23	8440	8484	0.27676007395281876
M1	cpdb	0	network_modules	163	TRUE	1.8581683680217517e-10	115	21	9	0.42857142857142855	0.0782608695652174	KEGG:01200	KEGG	Carbon metabolism	8484	184		0.07692307692307693	0.14285714285714285	115	8369	9	12	106	8357	8484	0.17878364934932658
M1	cpdb	0	network_modules	163	TRUE	3.655056052626538e-10	43	21	7	0.3333333333333333	0.16279069767441862	KEGG:00071	KEGG	Fatty acid degradation	8484	11		0.15384615384615385	0.21428571428571427	43	8441	7	14	36	8427	8484	0.2302721938070195
M1	cpdb	0	network_modules	163	TRUE	8.29110399303392e-10	48	21	7	0.3333333333333333	0.14583333333333334	KEGG:00280	KEGG	Valine, leucine and isoleucine degradation	8484	31		0.23076923076923078	0.2857142857142857	48	8436	7	14	41	8422	8484	0.21762228630974015
M1	cpdb	0	network_modules	163	TRUE	2.3481188705689957e-9	22	26	6	0.23076923076923078	0.2727272727272727	REAC:R-HSA-71403	REAC	Citric acid cycle (TCA cycle)	10916	364		0	0.25	22	10894	6	20	16	10874	10916	0.24922960509078307
M1	cpdb	0	network_modules	163	TRUE	2.900308248099402e-9	26	26	6	0.23076923076923078	0.23076923076923078	GO:0006099	GO:BP	tricarboxylic acid cycle	16175	1959		0	0.047619047619047616	26	16149	6	20	20	16129	16175	0.22953076399110212
M1	cpdb	0	network_modules	163	TRUE	3.0820670497790545e-7	271	26	9	0.34615384615384615	0.033210332103321034	GO:0044248	GO:BP	cellular catabolic process	16175	10939		0.05	0.09523809523809523	271	15904	9	17	262	15887	16175	0.10297774536240746
M1	cpdb	0	network_modules	163	TRUE	5.837418210374299e-7	31	21	5	0.23809523809523808	0.16129032258064516	KEGG:00410	KEGG	beta-Alanine metabolism	8484	55		0.3076923076923077	0.35714285714285715	31	8453	5	16	26	8437	8484	0.19355124920129413
M1	cpdb	0	network_modules	163	TRUE	5.89705327699855e-7	742	26	12	0.46153846153846156	0.016172506738544475	GO:0019752	GO:BP	carboxylic acid metabolic process	16175	6036		0.1	0.14285714285714285	742	15433	12	14	730	15419	16175	0.07972135690373397
M1	cpdb	0	network_modules	163	TRUE	6.90752647973022e-7	32	21	5	0.23809523809523808	0.15625	KEGG:00640	KEGG	Propanoate metabolism	8484	109		0.38461538461538464	0.42857142857142855	32	8452	5	16	27	8436	8484	0.1904184929459029
M1	cpdb	0	network_modules	163	TRUE	7.879755816297408e-7	761	26	12	0.46153846153846156	0.01576872536136662	GO:0043436	GO:BP	oxoacid metabolic process	16175	10693		0.15	0.19047619047619047	761	15414	12	14	749	15400	16175	0.0785457646293073
M1	cpdb	0	network_modules	163	TRUE	8.621231084475367e-7	767	26	12	0.46153846153846156	0.01564537157757497	GO:0006082	GO:BP	organic acid metabolic process	16175	1947		0.2	0.23809523809523808	767	15408	12	14	755	15394	16175	0.07818314215164777
M1	cpdb	0	network_modules	163	TRUE	2.2287889151050675e-6	40	21	5	0.23809523809523808	0.125	KEGG:00380	KEGG	Tryptophan metabolism	8484	48		0.46153846153846156	0.5	40	8444	5	16	35	8428	8484	0.16971043991148343
M1	cpdb	0	network_modules	163	TRUE	2.295946357643688e-5	63	21	5	0.23809523809523808	0.07936507936507936	KEGG:00310	KEGG	Lysine degradation	8484	34		0.5384615384615384	0.5714285714285714	63	8421	5	16	58	8405	8484	0.13384008204602516
M1	cpdb	0	network_modules	163	TRUE	6.973338870219454e-5	33	21	4	0.19047619047619047	0.12121212121212122	KEGG:01210	KEGG	2-Oxocarboxylic acid metabolism	8484	185		0.6153846153846154	0.6428571428571429	33	8451	4	17	29	8434	8484	0.14931979018134914
M1	cpdb	0	network_modules	163	TRUE	7.668835768553387e-5	65	26	5	0.19230769230769232	0.07692307692307693	GO:0006635	GO:BP	fatty acid beta-oxidation	16175	2346		0.25	0.2857142857142857	65	16110	5	21	60	16089	16175	0.11942052642010623
M1	cpdb	0	network_modules	163	TRUE	1.020890917005216e-4	6	26	3	0.11538461538461539	0.5	GO:1901289	GO:BP	succinyl-CoA catabolic process	16175	21364		0.3	0.3333333333333333	6	16169	3	23	3	16146	16175	0.23965716178343868
M1	cpdb	0	network_modules	163	TRUE	2.491929130861075e-4	162	26	6	0.23076923076923078	0.037037037037037035	GO:0009060	GO:BP	aerobic respiration	16175	3236		0.35	0.38095238095238093	162	16013	6	20	156	15993	16175	0.08895542226241872
M1	cpdb	0	network_modules	163	TRUE	2.971975234598398e-4	47	21	4	0.19047619047619047	0.0851063829787234	KEGG:00620	KEGG	Pyruvate metabolism	8484	99		0.6923076923076923	0.7142857142857143	47	8437	4	17	43	8420	8484	0.12411591319582183
M1	cpdb	0	network_modules	163	TRUE	3.2369482945789806e-4	48	21	4	0.19047619047619047	0.08333333333333333	KEGG:00330	KEGG	Arginine and proline metabolism	8484	36		0.7692307692307693	0.7857142857142857	48	8436	4	17	44	8419	8484	0.1227452319905297
M1	cpdb	0	network_modules	163	TRUE	4.1976246373575353e-4	91	26	5	0.19230769230769232	0.054945054945054944	GO:0019395	GO:BP	fatty acid oxidation	16175	5752		0.4	0.42857142857142855	91	16084	5	21	86	16063	16175	0.10014798739163004
M1	cpdb	0	network_modules	163	TRUE	4.2740370063761187e-4	9	26	3	0.11538461538461539	0.3333333333333333	GO:0006104	GO:BP	succinyl-CoA metabolic process	16175	1963		0.45	0.47619047619047616	9	16166	3	23	6	16143	16175	0.19538182665355472
M1	cpdb	0	network_modules	163	TRUE	4.938520171545708e-4	94	26	5	0.19230769230769232	0.05319148936170213	GO:0009062	GO:BP	fatty acid catabolic process	16175	3238		0.5	0.5238095238095238	94	16081	5	21	89	16060	16175	0.09844820641075007
M1	cpdb	0	network_modules	163	TRUE	4.983729744970121e-4	158	26	6	0.23076923076923078	0.0379746835443038	REAC:R-HSA-9609507	REAC	Protein localization	10916	1815		0.3333333333333333	0.5	158	10758	6	20	152	10738	10916	0.08848885123855414
M1	cpdb	0	network_modules	163	TRUE	5.487384697908569e-4	96	26	5	0.19230769230769232	0.052083333333333336	GO:0034440	GO:BP	lipid oxidation	16175	8634		0.55	0.5714285714285714	96	16079	5	21	91	16058	16175	0.09735877321204527
M1	cpdb	0	network_modules	163	TRUE	5.998354386660752e-4	188	26	6	0.23076923076923078	0.031914893617021274	GO:0045333	GO:BP	cellular respiration	16175	11360		0.6	0.6190476190476191	188	15987	6	20	182	15967	16175	0.08204081903717048
M1	cpdb	0	network_modules	163	TRUE	9.658372337410672e-4	177	26	6	0.23076923076923078	0.03389830508474576	REAC:R-HSA-1428517	REAC	Aerobic respiration and respiratory electron transport	10916	127		0.6666666666666666	0.75	177	10739	6	20	171	10719	10916	0.08300520656008405
M1	cpdb	0	network_modules	163	TRUE	9.877635083929569e-4	108	26	5	0.19230769230769232	0.046296296296296294	GO:0072329	GO:BP	monocarboxylic acid catabolic process	16175	17352		0.65	0.6666666666666666	108	16067	5	21	103	16046	16175	0.09145947930749498
M1	cpdb	0	network_modules	163	TRUE	0.001180232369702971	211	26	6	0.23076923076923078	0.02843601895734597	GO:0046395	GO:BP	carboxylic acid catabolic process	16175	12121		0.7	0.7619047619047619	211	15964	6	20	205	15944	16175	0.07699334325219885
M1	cpdb	0	network_modules	163	TRUE	0.001180232369702971	211	26	6	0.23076923076923078	0.02843601895734597	GO:0016054	GO:BP	organic acid catabolic process	16175	5086		0.7	0.7619047619047619	211	15964	6	20	205	15944	16175	0.07699334325219885
M1	cpdb	0	network_modules	163	TRUE	0.0012568410884362456	22	21	3	0.14285714285714285	0.13636363636363635	KEGG:00340	KEGG	Histidine metabolism	8484	40		0.8461538461538461	0.8571428571428571	22	8462	3	18	19	8444	8484	0.13738729960676443
M1	cpdb	0	network_modules	163	TRUE	0.00129164292245363	142	21	5	0.23809523809523808	0.035211267605633804	KEGG:04936	KEGG	Alcoholic liver disease	8484	393		0.9230769230769231	0.9285714285714286	142	8342	5	16	137	8326	8484	0.08595354635031185
M1	cpdb	0	network_modules	163	TRUE	0.002015266843652889	372	26	7	0.2692307692307692	0.01881720430107527	GO:0006091	GO:BP	generation of precursor metabolites and energy	16175	1954		0.8	0.8095238095238095	372	15803	7	19	365	15784	16175	0.06591161513554161
M1	cpdb	0	network_modules	163	TRUE	0.003271541317618007	30	21	3	0.14285714285714285	0.1	KEGG:00053	KEGG	Ascorbate and aldarate metabolism	8484	8		1	1	30	8454	3	18	27	8436	8484	0.11691579964697348
M1	cpdb	0	network_modules	163	TRUE	0.0033171007078701777	252	26	6	0.23076923076923078	0.023809523809523808	GO:0015980	GO:BP	energy derivation by oxidation of organic compounds	16175	5060		0.85	0.8571428571428571	252	15923	6	20	246	15903	16175	0.06972150806112451
M1	cpdb	0	network_modules	163	TRUE	0.005102743114943837	65	26	4	0.15384615384615385	0.06153846153846154	REAC:R-HSA-1268020	REAC	Mitochondrial protein import	10916	1468		1	1	65	10851	4	22	61	10829	10916	0.09392650969188586
M1	cpdb	0	network_modules	163	TRUE	0.00752359983325534	163	26	5	0.19230769230769232	0.03067484662576687	GO:0030258	GO:BP	lipid modification	16175	6747		0.9	0.9047619047619048	163	16012	5	21	158	15991	16175	0.07320865222122509
M1	cpdb	0	network_modules	163	TRUE	0.007764731613962329	74	26	4	0.15384615384615385	0.05405405405405406	GO:0043648	GO:BP	dicarboxylic acid metabolic process	16175	10828		0.95	0.9523809523809523	74	16101	4	22	70	16079	16175	0.08875480281703874
M1	cpdb	0	network_modules	163	TRUE	0.00905680887945808	300	26	6	0.23076923076923078	0.02	GO:0044282	GO:BP	small molecule catabolic process	16175	10949		1	1	300	15875	6	20	294	15855	16175	0.06311480419140478
M1	cpdb	0	network_modules	164	TRUE	0.0016977936561572006	28	14	3	0.21428571428571427	0.10714285714285714	REAC:R-HSA-525793	REAC	Myogenesis	10916	1504		NA	1	28	10888	3	11	25	10877	10916	0.14999771673998716
M1	cpdb	0	network_modules	165	TRUE	2.362254951499124e-36	43	25	18	0.72	0.4186046511627907	KEGG:03022	KEGG	Basal transcription factors	8484	213		0	0.3333333333333333	43	8441	18	7	25	8434	8484	0.547323995878655
M1	cpdb	0	network_modules	165	TRUE	2.3789444490509435e-29	64	28	16	0.5714285714285714	0.25	GO:0051123	GO:BP	RNA polymerase II preinitiation complex assembly	16175	13507		0	0.058823529411764705	64	16111	16	12	48	16099	16175	0.3764180736994908
M1	cpdb	0	network_modules	165	TRUE	5.460930837106723e-29	67	28	16	0.5714285714285714	0.23880597014925373	GO:0070897	GO:BP	transcription preinitiation complex assembly	16175	16360		0.0625	0.11764705882352941	67	16108	16	12	51	16096	16175	0.3678082994644508
M1	cpdb	0	network_modules	165	TRUE	4.47822860956742e-28	46	26	15	0.5769230769230769	0.32608695652173914	REAC:R-HSA-167161	REAC	HIV Transcription Initiation	10916	1105		0	0.3333333333333333	46	10870	15	11	31	10859	10916	0.43199293201636785
M1	cpdb	0	network_modules	165	TRUE	4.47822860956742e-28	46	26	15	0.5769230769230769	0.32608695652173914	REAC:R-HSA-167162	REAC	RNA Polymerase II HIV Promoter Escape	10916	1887		0	0.3333333333333333	46	10870	15	11	31	10859	10916	0.43199293201636785
M1	cpdb	0	network_modules	165	TRUE	4.47822860956742e-28	46	26	15	0.5769230769230769	0.32608695652173914	REAC:R-HSA-73776	REAC	RNA Polymerase II Promoter Escape	10916	1889		0	0.3333333333333333	46	10870	15	11	31	10859	10916	0.43199293201636785
M1	cpdb	0	network_modules	165	TRUE	4.47822860956742e-28	46	26	15	0.5769230769230769	0.32608695652173914	REAC:R-HSA-75953	REAC	RNA Polymerase II Transcription Initiation	10916	1892		0	0.3333333333333333	46	10870	15	11	31	10859	10916	0.43199293201636785
M1	cpdb	0	network_modules	165	TRUE	4.47822860956742e-28	46	26	15	0.5769230769230769	0.32608695652173914	REAC:R-HSA-73779	REAC	RNA Polymerase II Transcription Pre-Initiation And Promoter Opening	10916	1894		0	0.3333333333333333	46	10870	15	11	31	10859	10916	0.43199293201636785
M1	cpdb	0	network_modules	165	TRUE	4.47822860956742e-28	46	26	15	0.5769230769230769	0.32608695652173914	REAC:R-HSA-76042	REAC	RNA Polymerase II Transcription Initiation And Promoter Clearance	10916	1893		0	0.3333333333333333	46	10870	15	11	31	10859	10916	0.43199293201636785
M1	cpdb	0	network_modules	165	TRUE	7.227760913995324e-28	55	28	15	0.5357142857142857	0.2727272727272727	GO:0060261	GO:BP	positive regulation of transcription initiation by RNA polymerase II	16175	14478		0.125	0.17647058823529413	55	16120	15	13	40	16107	16175	0.38078636428173535
M1	cpdb	0	network_modules	165	TRUE	4.2651326773757576e-27	61	28	15	0.5357142857142857	0.2459016393442623	GO:2000144	GO:BP	positive regulation of DNA-templated transcription initiation	16175	25492		0.1875	0.23529411764705882	61	16114	15	13	46	16101	16175	0.3613898169229681
M1	cpdb	0	network_modules	165	TRUE	1.6165310214434432e-26	66	28	15	0.5357142857142857	0.22727272727272727	GO:0060260	GO:BP	regulation of transcription initiation by RNA polymerase II	16175	14477		0.25	0.29411764705882354	66	16109	15	13	51	16096	16175	0.34728322202842576
M1	cpdb	0	network_modules	165	TRUE	2.7987162025586575e-26	173	28	18	0.6428571428571429	0.10404624277456648	GO:0006352	GO:BP	DNA-templated transcription initiation	16175	2129		0.3125	0.35294117647058826	173	16002	18	10	155	15992	16175	0.255914755168668
M1	cpdb	0	network_modules	165	TRUE	6.928439137022552e-26	72	28	15	0.5357142857142857	0.20833333333333334	GO:2000142	GO:BP	regulation of DNA-templated transcription initiation	16175	25490		0.375	0.4117647058823529	72	16103	15	13	57	16090	16175	0.33232826876143157
M1	cpdb	0	network_modules	165	TRUE	4.8535598104080855e-25	69	26	15	0.5769230769230769	0.21739130434782608	REAC:R-HSA-167172	REAC	Transcription of the HIV genome	10916	2540		0.35294117647058826	0.3888888888888889	69	10847	15	11	54	10836	10916	0.3517954727849312
M1	cpdb	0	network_modules	165	TRUE	9.153713634155782e-25	40	28	13	0.4642857142857143	0.325	GO:0042789	GO:BP	mRNA transcription by RNA polymerase II	16175	10367		0.4375	0.47058823529411764	40	16135	13	15	27	16120	16175	0.3871941903489078
M1	cpdb	0	network_modules	165	TRUE	5.529680708054413e-24	45	28	13	0.4642857142857143	0.28888888888888886	GO:0009299	GO:BP	mRNA transcription	16175	3446		0.5	0.5294117647058824	45	16130	13	15	32	16115	16175	0.3648623706327828
M1	cpdb	0	network_modules	165	TRUE	5.6224454819135814e-24	80	26	15	0.5769230769230769	0.1875	REAC:R-HSA-674695	REAC	RNA Polymerase II Pre-transcription Events	10916	1888		0.4117647058823529	0.4444444444444444	80	10836	15	11	65	10825	10916	0.32630405357079373
M1	cpdb	0	network_modules	165	TRUE	2.8169143614447e-23	143	28	16	0.5714285714285714	0.11188811188811189	GO:0006367	GO:BP	transcription initiation at RNA polymerase II promoter	16175	2142		0.5625	0.5882352941176471	143	16032	16	12	127	16020	16175	0.2502682729601263
M1	cpdb	0	network_modules	165	TRUE	1.7240869684742043e-21	183	28	16	0.5714285714285714	0.08743169398907104	GO:0065004	GO:BP	protein-DNA complex assembly	16175	15888		0.625	0.6470588235294118	183	15992	16	12	167	15980	16175	0.22053499155018305
M1	cpdb	0	network_modules	165	TRUE	1.2183246179096635e-20	206	28	16	0.5714285714285714	0.07766990291262135	GO:0071824	GO:BP	protein-DNA complex organization	16175	16927		0.6875	0.7058823529411765	206	15969	16	12	190	15957	16175	0.20748085991928114
M1	cpdb	0	network_modules	165	TRUE	1.736789707051589e-20	132	26	15	0.5769230769230769	0.11363636363636363	REAC:R-HSA-162599	REAC	Late Phase of HIV Life Cycle	10916	1304		0.47058823529411764	0.5	132	10784	15	11	117	10773	10916	0.2525094737759911
M1	cpdb	0	network_modules	165	TRUE	7.578528623472637e-20	145	26	15	0.5769230769230769	0.10344827586206896	REAC:R-HSA-162587	REAC	HIV Life Cycle	10916	1103		0.5294117647058824	0.5555555555555556	145	10771	15	11	130	10760	10916	0.24056138576853603
M1	cpdb	0	network_modules	165	TRUE	1.4043152523640037e-18	92	26	13	0.5	0.14130434782608695	REAC:R-HSA-6804756	REAC	Regulation of TP53 Activity through Phosphorylation	10916	2016		0.5882352941176471	0.6111111111111112	92	10824	13	13	79	10811	10916	0.2627456877319526
M1	cpdb	0	network_modules	165	TRUE	6.711370878651057e-17	225	26	15	0.5769230769230769	0.06666666666666667	REAC:R-HSA-162906	REAC	HIV Infection	10916	1102		0.6470588235294118	0.6666666666666666	225	10691	15	11	210	10680	10916	0.19131701095499173
M1	cpdb	0	network_modules	165	TRUE	2.5552167757610626e-15	160	26	13	0.5	0.08125	REAC:R-HSA-5633007	REAC	Regulation of TP53 Activity	10916	2012		0.7058823529411765	0.7222222222222222	160	10756	13	13	147	10743	10916	0.19733280987464363
M1	cpdb	0	network_modules	165	TRUE	9.872388139649106e-11	359	26	13	0.5	0.036211699164345405	REAC:R-HSA-3700989	REAC	Transcriptional Regulation by TP53	10916	2546		0.7647058823529411	0.7777777777777778	359	10557	13	13	346	10544	10916	0.12797945635929336
M1	cpdb	0	network_modules	165	TRUE	1.2587978411645147e-9	73	26	8	0.3076923076923077	0.1095890410958904	REAC:R-HSA-6807505	REAC	RNA polymerase II transcribes snRNA genes	10916	1904		0.8235294117647058	0.8333333333333334	73	10843	8	18	65	10825	10916	0.18045695860276179
M1	cpdb	0	network_modules	165	TRUE	6.9322334159238046e-9	590	28	13	0.4642857142857143	0.022033898305084745	GO:0016071	GO:BP	mRNA metabolic process	16175	5098		0.75	0.7647058823529411	590	15585	13	15	577	15570	16175	0.09502733967373037
M1	cpdb	0	network_modules	165	TRUE	3.283501857467978e-4	9	26	3	0.11538461538461539	0.3333333333333333	REAC:R-HSA-381183	REAC	ATF6 (ATF6-alpha) activates chaperone genes	10916	36		0.8823529411764706	0.8888888888888888	9	10907	3	23	6	10884	10916	0.19502751012348568
M1	cpdb	0	network_modules	165	TRUE	6.429366217412311e-4	11	26	3	0.11538461538461539	0.2727272727272727	REAC:R-HSA-381033	REAC	ATF6 (ATF6-alpha) activates chaperones	10916	37		0.9411764705882353	0.9444444444444444	11	10905	3	23	8	10882	10916	0.17614303780331245
M1	cpdb	0	network_modules	165	TRUE	8.873720834135741e-4	437	28	8	0.2857142857142857	0.018306636155606407	GO:0080135	GO:BP	regulation of cellular response to stress	16175	17817		0.8125	0.8235294117647058	437	15738	8	20	429	15718	16175	0.06644369299180011
M1	cpdb	0	network_modules	165	TRUE	0.002098240824958057	207	28	6	0.21428571428571427	0.028985507246376812	GO:0006282	GO:BP	regulation of DNA repair	16175	2096		0.875	0.8823529411764706	207	15968	6	22	201	15946	16175	0.07464771825763934
M1	cpdb	0	network_modules	165	TRUE	0.002164901991439167	16	26	3	0.11538461538461539	0.1875	REAC:R-HSA-9614657	REAC	FOXO-mediated transcription of cell death genes	10916	925		1	1	16	10900	3	23	13	10877	10916	0.14549856698069571
M1	cpdb	0	network_modules	165	TRUE	0.0029201858845870616	69	25	4	0.16	0.057971014492753624	KEGG:04612	KEGG	Antigen processing and presentation	8484	322		0.5	0.6666666666666666	69	8415	4	21	65	8394	8484	0.09192276631397288
M1	cpdb	0	network_modules	165	TRUE	0.0031455914649420732	141	25	5	0.2	0.03546099290780142	KEGG:05017	KEGG	Spinocerebellar ataxia	8484	415		1	1	141	8343	5	20	136	8323	8484	0.0779818584292098
M1	cpdb	0	network_modules	165	TRUE	0.003594027106055537	15	28	3	0.10714285714285714	0.2	GO:0045346	GO:BP	regulation of MHC class II biosynthetic process	16175	11369		0.9375	0.9411764705882353	15	16160	3	25	12	16135	16175	0.14531116107917666
M1	cpdb	0	network_modules	165	TRUE	0.004418291146288086	16	28	3	0.10714285714285714	0.1875	GO:0045342	GO:BP	MHC class II biosynthetic process	16175	11365		1	1	16	16159	3	25	13	16134	16175	0.14061938357001555
M1	cpdb	0	network_modules	166	TRUE	1.8712806034278992e-10	449	15	11	0.7333333333333333	0.024498886414253896	REAC:R-HSA-9012999	REAC	RHO GTPase cycle	10916	1847		0	0.1	449	10467	11	4	438	10463	10916	0.12929268609189923
M1	cpdb	0	network_modules	166	TRUE	9.53657906376061e-10	74	15	7	0.4666666666666667	0.0945945945945946	REAC:R-HSA-9013408	REAC	RHOG GTPase cycle	10916	1868		0.1111111111111111	0.2	74	10842	7	8	67	10834	10916	0.2079012738801525
M1	cpdb	0	network_modules	166	TRUE	2.255998950419016e-6	389	23	9	0.391304347826087	0.02313624678663239	GO:0007264	GO:BP	small GTPase-mediated signal transduction	16175	2792		0	0.3333333333333333	389	15786	9	14	380	15772	16175	0.09045900161476307
M1	cpdb	0	network_modules	166	TRUE	8.315877091093033e-6	149	15	6	0.4	0.040268456375838924	REAC:R-HSA-8980692	REAC	RHOA GTPase cycle	10916	1859		0.2222222222222222	0.3	149	10767	6	9	143	10758	10916	0.12351416384529157
M1	cpdb	0	network_modules	166	TRUE	1.053547780572888e-5	155	15	6	0.4	0.03870967741935484	REAC:R-HSA-9013148	REAC	CDC42 GTPase cycle	10916	269		0.3333333333333333	0.4	155	10761	6	9	149	10752	10916	0.12096139527468609
M1	cpdb	0	network_modules	166	TRUE	2.3864115209817835e-5	77	8	4	0.5	0.05194805194805195	KEGG:05100	KEGG	Bacterial invasion of epithelial cells	8484	423		NA	1	77	8407	4	4	73	8403	8484	0.1590371699602506
M1	cpdb	0	network_modules	166	TRUE	3.1603853321639187e-4	59	15	4	0.26666666666666666	0.06779661016949153	REAC:R-HSA-193648	REAC	NRAGE signals death through JNK	10916	1548		0.4444444444444444	0.5	59	10857	4	11	55	10846	10916	0.13218156947628942
M1	cpdb	0	network_modules	166	TRUE	6.31050322043165e-4	70	15	4	0.26666666666666666	0.05714285714285714	REAC:R-HSA-9013026	REAC	RHOB GTPase cycle	10916	1860		0.5555555555555556	0.6	70	10846	4	11	66	10835	10916	0.12094549105001957
M1	cpdb	0	network_modules	166	TRUE	8.787274401004924e-4	76	15	4	0.26666666666666666	0.05263157894736842	REAC:R-HSA-204998	REAC	Cell death signalling via NRAGE, NRIF and NADE	10916	323		0.6666666666666666	0.7	76	10840	4	11	72	10829	10916	0.1158600930317808
M1	cpdb	0	network_modules	166	TRUE	0.0010612162231761078	184	15	5	0.3333333333333333	0.02717391304347826	REAC:R-HSA-9013149	REAC	RAC1 GTPase cycle	10916	1836		0.7777777777777778	0.8	184	10732	5	10	179	10722	10916	0.09119465103294525
M1	cpdb	0	network_modules	166	TRUE	0.001079745163057164	80	15	4	0.26666666666666666	0.05	REAC:R-HSA-416482	REAC	G alpha (12/13) signalling events	10916	986		0.8888888888888888	0.9	80	10836	4	11	76	10825	10916	0.11278792585693644
M1	cpdb	0	network_modules	166	TRUE	0.0013027580373003507	242	23	6	0.2608695652173913	0.024793388429752067	GO:0051056	GO:BP	regulation of small GTPase mediated signal transduction	16175	13466		0.5	0.6666666666666666	242	15933	6	17	236	15916	16175	0.07643840445478224
M1	cpdb	0	network_modules	166	TRUE	0.0023331121209682858	97	15	4	0.26666666666666666	0.041237113402061855	REAC:R-HSA-193704	REAC	p75 NTR receptor-mediated signalling	10916	2721		1	1	97	10819	4	11	93	10808	10916	0.10189358350503393
M1	cpdb	0	network_modules	166	TRUE	0.00293052110335139	2	23	2	0.08695652173913043	1	GO:1904694	GO:BP	negative regulation of vascular associated smooth muscle contraction	16175	24031		1	1	2	16173	2	21	0	16152	16175	0.29469240258173435
M1	cpdb	0	network_modules	167	TRUE	8.675379611292331e-23	365	21	19	0.9047619047619048	0.052054794520547946	KEGG:04080	KEGG	Neuroactive ligand-receptor interaction	8484	263		NA	1	365	8119	19	2	346	8117	8484	0.21155658986685125
M1	cpdb	0	network_modules	167	TRUE	1.3085186617966886e-21	195	22	16	0.7272727272727273	0.08205128205128205	REAC:R-HSA-375276	REAC	Peptide ligand-binding receptors	10916	1726		0	0.16666666666666666	195	10721	16	6	179	10715	10916	0.2406816317488018
M1	cpdb	0	network_modules	167	TRUE	6.4986361306810085e-18	328	22	16	0.7272727272727273	0.04878048780487805	REAC:R-HSA-373076	REAC	Class A/1 (Rhodopsin-like receptors)	10916	365		0.2	0.3333333333333333	328	10588	16	6	312	10582	10916	0.1835313678018996
M1	cpdb	0	network_modules	167	TRUE	2.257641977369256e-17	460	22	17	0.7727272727272727	0.036956521739130437	REAC:R-HSA-500792	REAC	GPCR ligand binding	10916	1019		0.4	0.5	460	10456	17	5	443	10451	10916	0.1634148780376779
M1	cpdb	0	network_modules	167	TRUE	3.0597145959230694e-12	774	26	16	0.6153846153846154	0.020671834625323	GO:0007186	GO:BP	G protein-coupled receptor signaling pathway	16175	2744		0	0.03571428571428571	774	15401	16	10	758	15391	16175	0.10668523515333245
M1	cpdb	0	network_modules	167	TRUE	4.700216967922126e-12	46	26	8	0.3076923076923077	0.17391304347826086	GO:0007631	GO:BP	feeding behavior	16175	3087		0.037037037037037035	0.07142857142857142	46	16129	8	18	38	16111	16175	0.22969918139399828
M1	cpdb	0	network_modules	167	TRUE	1.4721752575173786e-10	69	26	8	0.3076923076923077	0.11594202898550725	GO:0007218	GO:BP	neuropeptide signaling pathway	16175	2772		0.07407407407407407	0.10714285714285714	69	16106	8	18	61	16088	16175	0.18680702807435717
M1	cpdb	0	network_modules	167	TRUE	3.794480352306226e-10	8	22	5	0.22727272727272727	0.625	REAC:R-HSA-389397	REAC	Orexin and neuropeptides FF and QRFP bind to their respective receptors	10916	1645		0.6	0.6666666666666666	8	10908	5	17	3	10891	10916	0.37619086717652606
M1	cpdb	0	network_modules	167	TRUE	4.6098605215770153e-8	213	22	9	0.4090909090909091	0.04225352112676056	REAC:R-HSA-416476	REAC	G alpha (q) signalling events	10916	988		0.8	0.8333333333333334	213	10703	9	13	204	10690	10916	0.1265707457517323
M1	cpdb	0	network_modules	167	TRUE	1.3567037234152466e-6	312	22	9	0.4090909090909091	0.028846153846153848	REAC:R-HSA-418594	REAC	G alpha (i) signalling events	10916	987		1	1	312	10604	9	13	303	10591	10916	0.10262046336374007
M1	cpdb	0	network_modules	167	TRUE	5.804981526460092e-6	255	26	8	0.3076923076923077	0.03137254901960784	GO:0007610	GO:BP	behavior	16175	3067		0.1111111111111111	0.14285714285714285	255	15920	8	18	247	15902	16175	0.09403534942147909
M1	cpdb	0	network_modules	167	TRUE	1.5011985908223866e-5	583	26	10	0.38461538461538464	0.017152658662092625	GO:0032940	GO:BP	secretion by cell	16175	7926		0.14814814814814814	0.17857142857142858	583	15592	10	16	573	15576	16175	0.07503529398218586
M1	cpdb	0	network_modules	167	TRUE	2.0461444381733738e-05	4	26	3	0.11538461538461539	0.75	GO:2000851	GO:BP	positive regulation of glucocorticoid secretion	16175	26102		0.18518518518518517	0.32142857142857145	4	16171	3	23	1	16148	16175	0.2938162617423233
M1	cpdb	0	network_modules	167	TRUE	2.0461444381733738e-05	4	26	3	0.11538461538461539	0.75	GO:0051464	GO:BP	positive regulation of cortisol secretion	16175	13725		0.18518518518518517	0.32142857142857145	4	16171	3	23	1	16148	16175	0.2938162617423233
M1	cpdb	0	network_modules	167	TRUE	2.0461444381733738e-05	4	26	3	0.11538461538461539	0.75	GO:0051462	GO:BP	regulation of cortisol secretion	16175	13723		0.18518518518518517	0.32142857142857145	4	16171	3	23	1	16148	16175	0.2938162617423233
M1	cpdb	0	network_modules	167	TRUE	2.0461444381733738e-05	4	26	3	0.11538461538461539	0.75	GO:0043400	GO:BP	cortisol secretion	16175	10669		0.18518518518518517	0.32142857142857145	4	16171	3	23	1	16148	16175	0.2938162617423233
M1	cpdb	0	network_modules	167	TRUE	3.9811127135562266e-5	646	26	10	0.38461538461538464	0.015479876160990712	GO:0140352	GO:BP	export from cell	16175	19748		0.3333333333333333	0.35714285714285715	646	15529	10	16	636	15513	16175	0.07062894334438798
M1	cpdb	0	network_modules	167	TRUE	4.159652950365429e-5	649	26	10	0.38461538461538464	0.015408320493066256	GO:0046903	GO:BP	secretion	16175	12430		0.37037037037037035	0.39285714285714285	649	15526	10	16	639	15510	16175	0.07043439946882826
M1	cpdb	0	network_modules	167	TRUE	5.1099048710213685e-5	5	26	3	0.11538461538461539	0.6	GO:2000848	GO:BP	positive regulation of corticosteroid hormone secretion	16175	26099		0.4074074074074074	0.42857142857142855	5	16170	3	23	2	16147	16175	0.26266426439336954
M1	cpdb	0	network_modules	167	TRUE	7.572069088463398e-5	24	26	4	0.15384615384615385	0.16666666666666666	GO:0140353	GO:BP	lipid export from cell	16175	19749		0.4444444444444444	0.4642857142857143	24	16151	4	22	20	16129	16175	0.15882928177839048
M1	cpdb	0	network_modules	167	TRUE	1.020890917005216e-4	6	26	3	0.11538461538461539	0.5	GO:2000849	GO:BP	regulation of glucocorticoid secretion	16175	26100		0.48148148148148145	0.5357142857142857	6	16169	3	23	3	16146	16175	0.23965716178343868
M1	cpdb	0	network_modules	167	TRUE	1.020890917005216e-4	6	26	3	0.11538461538461539	0.5	GO:0035933	GO:BP	glucocorticoid secretion	16175	9353		0.48148148148148145	0.5357142857142857	6	16169	3	23	3	16146	16175	0.23965716178343868
M1	cpdb	0	network_modules	167	TRUE	1.7846535808571944e-4	7	26	3	0.11538461538461539	0.42857142857142855	GO:0008343	GO:BP	adult feeding behavior	16175	3168		0.5555555555555556	0.5714285714285714	7	16168	3	23	4	16145	16175	0.22176700751010106
M1	cpdb	0	network_modules	167	TRUE	2.8524002094473843e-4	8	26	3	0.11538461538461539	0.375	GO:2000833	GO:BP	positive regulation of steroid hormone secretion	16175	26084		0.5925925925925926	0.6071428571428571	8	16167	3	23	5	16144	16175	0.20733888428774644
M1	cpdb	0	network_modules	167	TRUE	4.2740370063761187e-4	9	26	3	0.11538461538461539	0.3333333333333333	GO:0035930	GO:BP	corticosteroid hormone secretion	16175	9350		0.6296296296296297	0.6785714285714286	9	16166	3	23	6	16143	16175	0.19538182665355472
M1	cpdb	0	network_modules	167	TRUE	4.2740370063761187e-4	9	26	3	0.11538461538461539	0.3333333333333333	GO:2000846	GO:BP	regulation of corticosteroid hormone secretion	16175	26097		0.6296296296296297	0.6785714285714286	9	16166	3	23	6	16143	16175	0.19538182665355472
M1	cpdb	0	network_modules	167	TRUE	0.0014490099394394822	13	26	3	0.11538461538461539	0.23076923076923078	GO:0032095	GO:BP	regulation of response to food	16175	7359		0.7037037037037037	0.75	13	16162	3	23	10	16139	16175	0.16223747198685623
M1	cpdb	0	network_modules	167	TRUE	0.0014490099394394822	13	26	3	0.11538461538461539	0.23076923076923078	GO:2000831	GO:BP	regulation of steroid hormone secretion	16175	26082		0.7037037037037037	0.75	13	16162	3	23	10	16139	16175	0.16223747198685623
M1	cpdb	0	network_modules	167	TRUE	0.0018422277729335168	14	26	3	0.11538461538461539	0.21428571428571427	GO:0035929	GO:BP	steroid hormone secretion	16175	9349		0.7777777777777778	0.7857142857142857	14	16161	3	23	11	16138	16175	0.15625642062334155
M1	cpdb	0	network_modules	167	TRUE	0.002828155079357112	16	26	3	0.11538461538461539	0.1875	GO:0032098	GO:BP	regulation of appetite	16175	7362		0.8148148148148148	0.8214285714285714	16	16159	3	23	13	16136	16175	0.14601571742775804
M1	cpdb	0	network_modules	167	TRUE	0.003450794777497106	2	26	2	0.07692307692307693	1	GO:1902606	GO:BP	regulation of large conductance calcium-activated potassium channel activity	16175	22378		0.8518518518518519	0.8928571428571429	2	16173	2	24	0	16149	16175	0.27714423421480233
M1	cpdb	0	network_modules	167	TRUE	0.003450794777497106	2	26	2	0.07692307692307693	1	GO:1902608	GO:BP	positive regulation of large conductance calcium-activated potassium channel activity	16175	22380		0.8518518518518519	0.8928571428571429	2	16173	2	24	0	16149	16175	0.27714423421480233
M1	cpdb	0	network_modules	167	TRUE	0.00487808005922128	19	26	3	0.11538461538461539	0.15789473684210525	GO:0032094	GO:BP	response to food	16175	7358		0.9259259259259259	0.9285714285714286	19	16156	3	23	16	16133	16175	0.13378838606206206
M1	cpdb	0	network_modules	167	TRUE	0.007727800711620386	22	26	3	0.11538461538461539	0.13636363636363635	GO:0032107	GO:BP	regulation of response to nutrient levels	16175	7368		0.9629629629629629	0.9642857142857143	22	16153	3	23	19	16130	16175	0.12414189032667687
M1	cpdb	0	network_modules	167	TRUE	0.008877495418110313	23	26	3	0.11538461538461539	0.13043478260869565	GO:0044060	GO:BP	regulation of endocrine process	16175	10895		1	1	23	16152	3	23	20	16129	16175	0.12135109035153473
M1	cpdb	0	network_modules	168	TRUE	3.846876600581902e-5	156	18	6	0.3333333333333333	0.038461538461538464	REAC:R-HSA-418555	REAC	G alpha (s) signalling events	10916	989		0	0.25	156	10760	6	12	150	10748	10916	0.10924619639073165
M1	cpdb	0	network_modules	168	TRUE	6.984277353408227e-5	140	24	6	0.25	0.04285714285714286	GO:0007189	GO:BP	adenylate cyclase-activating G protein-coupled receptor signaling pathway	16175	2747		0	0.16666666666666666	140	16035	6	18	134	16017	16175	0.10043600035559488
M1	cpdb	0	network_modules	168	TRUE	1.441987641762852e-4	195	18	6	0.3333333333333333	0.03076923076923077	REAC:R-HSA-375276	REAC	Peptide ligand-binding receptors	10916	1726		0.3333333333333333	0.5	195	10721	6	12	189	10709	10916	0.09679412626201264
M1	cpdb	0	network_modules	168	TRUE	4.806315084158163e-4	63	18	4	0.2222222222222222	0.06349206349206349	KEGG:00561	KEGG	Glycerolipid metabolism	8484	85		0	0.25	63	8421	4	14	59	8407	8484	0.11536467083283591
M1	cpdb	0	network_modules	168	TRUE	7.926640268529954e-4	2	18	2	0.1111111111111111	1	REAC:R-HSA-5579031	REAC	Defective ACTH causes obesity and POMCD	10916	473		0.6666666666666666	0.75	2	10914	2	16	0	10898	10916	0.3330889092246938
M1	cpdb	0	network_modules	168	TRUE	9.351400532308002e-4	217	24	6	0.25	0.027649769585253458	GO:0007188	GO:BP	adenylate cyclase-modulating G protein-coupled receptor signaling pathway	16175	2746		0.2	0.3333333333333333	217	15958	6	18	211	15940	16175	0.07927146892279852
M1	cpdb	0	network_modules	168	TRUE	0.0020315749782952633	56	24	4	0.16666666666666666	0.07142857142857142	GO:0007187	GO:BP	G protein-coupled receptor signaling pathway, coupled to cyclic nucleotide second messenger	16175	2745		0.4	0.5	56	16119	4	20	52	16099	16175	0.1071073710203819
M1	cpdb	0	network_modules	168	TRUE	0.0029677348084294827	328	18	6	0.3333333333333333	0.018292682926829267	REAC:R-HSA-373076	REAC	Class A/1 (Rhodopsin-like receptors)	10916	365		1	1	328	10588	6	12	322	10576	10916	0.07219953803369816
M1	cpdb	0	network_modules	168	TRUE	0.004473194848350138	365	18	6	0.3333333333333333	0.01643835616438356	KEGG:04080	KEGG	Neuroactive ligand-receptor interaction	8484	263		0.3333333333333333	0.5	365	8119	6	12	359	8107	8484	0.0659726348319473
M1	cpdb	0	network_modules	168	TRUE	0.00502853374470541	20	24	3	0.125	0.15	GO:0006670	GO:BP	sphingosine metabolic process	16175	2379		0.6	0.6666666666666666	20	16155	3	21	17	16134	16175	0.13576080024891163
M1	cpdb	0	network_modules	168	TRUE	0.005772469613863889	43	18	3	0.16666666666666666	0.06976744186046512	KEGG:04975	KEGG	Fat digestion and absorption	8484	406		0.6666666666666666	0.75	43	8441	3	15	40	8426	8484	0.10493089987762465
M1	cpdb	0	network_modules	168	TRUE	0.006779710287488683	22	24	3	0.125	0.13636363636363635	GO:0046519	GO:BP	sphingoid metabolic process	16175	12217		0.8	0.8333333333333334	22	16153	3	21	19	16132	16175	0.1293215278126346
M1	cpdb	0	network_modules	168	TRUE	0.009083040635140887	50	18	3	0.16666666666666666	0.06	KEGG:00565	KEGG	Ether lipid metabolism	8484	89		1	1	50	8434	3	15	47	8419	8484	0.09685224462866741
M1	cpdb	0	network_modules	168	TRUE	0.009881539404908083	3	24	2	0.08333333333333333	0.6666666666666666	GO:1990680	GO:BP	response to melanocyte-stimulating hormone	16175	25251		1	1	3	16172	2	22	1	16150	16175	0.23537416597204877
M1	cpdb	0	network_modules	169	TRUE	4.3679141594368673e-16	12	15	7	0.4666666666666667	0.5833333333333334	REAC:R-HSA-375281	REAC	Hormone ligand-binding receptors	10916	1131		0	0.1	12	10904	7	8	5	10896	10916	0.5211646737723516
M1	cpdb	0	network_modules	169	TRUE	2.7988939614210626e-8	8	15	4	0.26666666666666666	0.5	KEGG:04122	KEGG	Sulfur relay system	8484	271		0	0.25	8	8476	4	11	4	8465	8484	0.36435108852150005
M1	cpdb	0	network_modules	169	TRUE	3.165966116474535e-8	5	25	4	0.16	0.8	GO:0034227	GO:BP	tRNA thio-modification	16175	8510		0	0.08333333333333333	5	16170	4	21	1	16149	16175	0.35741118141915157
M1	cpdb	0	network_modules	169	TRUE	1.9558539352072588e-7	156	15	7	0.4666666666666667	0.04487179487179487	REAC:R-HSA-418555	REAC	G alpha (s) signalling events	10916	989		0.1111111111111111	0.2	156	10760	7	8	149	10752	10916	0.14138613966856858
M1	cpdb	0	network_modules	169	TRUE	3.570287182746748e-7	12	15	4	0.26666666666666666	0.3333333333333333	REAC:R-HSA-209822	REAC	Glycoprotein hormones	10916	1075		0.2222222222222222	0.3	12	10904	4	11	8	10893	10916	0.29728099320911083
M1	cpdb	0	network_modules	169	TRUE	7.208269529951809e-7	14	15	4	0.26666666666666666	0.2857142857142857	REAC:R-HSA-209952	REAC	Peptide hormone biosynthesis	10916	1724		0.3333333333333333	0.4	14	10902	4	11	10	10891	10916	0.2750640631766487
M1	cpdb	0	network_modules	169	TRUE	2.694194006224276e-6	223	15	7	0.4666666666666667	0.03139013452914798	KEGG:04024	KEGG	cAMP signaling pathway	8484	252		0.3333333333333333	0.5	223	8261	7	8	216	8253	8484	0.11584863915154735
M1	cpdb	0	network_modules	169	TRUE	1.4883184607549485e-5	17	25	4	0.16	0.23529411764705882	GO:0002098	GO:BP	tRNA wobble uridine modification	16175	681		0.09090909090909091	0.16666666666666666	17	16158	4	21	13	16137	16175	0.19300455338766612
M1	cpdb	0	network_modules	169	TRUE	1.861853022027406e-5	4	25	3	0.12	0.75	GO:0002143	GO:BP	tRNA wobble position uridine thiolation	16175	711		0.18181818181818182	0.25	4	16171	3	22	1	16149	16175	0.29965044535356145
M1	cpdb	0	network_modules	169	TRUE	3.020356971213696e-5	20	25	4	0.16	0.2	GO:0002097	GO:BP	tRNA wobble base modification	16175	680		0.2727272727272727	0.3333333333333333	20	16155	4	21	16	16134	16175	0.17775027503475063
M1	cpdb	0	network_modules	169	TRUE	3.412888535696302e-5	328	15	7	0.4666666666666667	0.021341463414634148	REAC:R-HSA-373076	REAC	Class A/1 (Rhodopsin-like receptors)	10916	365		0.4444444444444444	0.5	328	10588	7	8	321	10580	10916	0.0948712797960873
M1	cpdb	0	network_modules	169	TRUE	7.13523432673031e-5	41	15	4	0.26666666666666666	0.0975609756097561	REAC:R-HSA-6782315	REAC	tRNA modification in the nucleus and cytosol	10916	2742		0.5555555555555556	0.6	41	10875	4	11	37	10864	10916	0.1594328123539581
M1	cpdb	0	network_modules	169	TRUE	7.801825862621423e-5	365	15	7	0.4666666666666667	0.019178082191780823	KEGG:04080	KEGG	Neuroactive ligand-receptor interaction	8484	263		0.6666666666666666	0.75	365	8119	7	8	358	8111	8484	0.087868679538237085
M1	cpdb	0	network_modules	169	TRUE	9.555175264447691e-5	51	15	4	0.26666666666666666	0.0784313725490196	KEGG:04913	KEGG	Ovarian steroidogenesis	8484	370		1	1	51	8433	4	11	47	8422	8484	0.14191252590479644
M1	cpdb	0	network_modules	169	TRUE	3.132861120311294e-4	89	25	5	0.2	0.056179775280898875	GO:0006400	GO:BP	tRNA modification	16175	2161		0.36363636363636365	0.4166666666666667	89	16086	5	20	84	16066	16175	0.10344831563247758
M1	cpdb	0	network_modules	169	TRUE	3.4005373858409215e-4	460	15	7	0.4666666666666667	0.015217391304347827	REAC:R-HSA-500792	REAC	GPCR ligand binding	10916	1019		0.6666666666666666	0.7	460	10456	7	8	453	10448	10916	0.07838253079160425
M1	cpdb	0	network_modules	169	TRUE	0.0013930616540286588	120	25	5	0.2	0.041666666666666664	GO:0008033	GO:BP	tRNA processing	16175	3098		0.45454545454545453	0.5	120	16055	5	20	115	16035	16175	0.08829701339569333
M1	cpdb	0	network_modules	169	TRUE	0.00158170566349151	88	15	4	0.26666666666666666	0.045454545454545456	REAC:R-HSA-2980736	REAC	Peptide hormone metabolism	10916	1725		0.7777777777777778	0.8	88	10828	4	11	84	10817	10916	0.1072747773961193
M1	cpdb	0	network_modules	169	TRUE	0.002962710166132853	103	15	4	0.26666666666666666	0.038834951456310676	REAC:R-HSA-72306	REAC	tRNA processing	10916	2743		0.8888888888888888	0.9	103	10813	4	11	99	10802	10916	0.09869781501498497
M1	cpdb	0	network_modules	169	TRUE	0.003276358997535711	2	25	2	0.08	1	GO:0032447	GO:BP	protein urmylation	16175	7569		0.5454545454545454	0.5833333333333334	2	16173	2	23	0	16150	16175	0.282641522315189
M1	cpdb	0	network_modules	169	TRUE	0.0037442930207189206	18	25	3	0.12	0.16666666666666666	GO:0022602	GO:BP	ovulation cycle process	16175	6610		0.6363636363636364	0.6666666666666666	18	16157	3	22	15	16135	16175	0.14029636220631622
M1	cpdb	0	network_modules	169	TRUE	0.004924451838749617	155	25	5	0.2	0.03225806451612903	GO:0009451	GO:BP	RNA modification	16175	3498		0.7272727272727273	0.75	155	16020	5	20	150	16000	16175	0.0769019500377032
M1	cpdb	0	network_modules	169	TRUE	0.007037649377665408	22	25	3	0.12	0.13636363636363635	GO:0042698	GO:BP	ovulation cycle	16175	10308		0.8181818181818182	0.8333333333333334	22	16153	3	22	19	16131	16175	0.12665454491867303
M1	cpdb	0	network_modules	169	TRUE	0.008085042301513865	23	25	3	0.12	0.13043478260869565	GO:0001541	GO:BP	ovarian follicle development	16175	332		0.9090909090909091	0.9166666666666666	23	16152	3	22	20	16130	16175	0.12380987150270771
M1	cpdb	0	network_modules	169	TRUE	0.008287360130236775	6	15	2	0.13333333333333333	0.3333333333333333	REAC:R-HSA-193993	REAC	Mineralocorticoid biosynthesis	10916	1452		1	1	6	10910	2	13	4	10897	10916	0.21015159549681772
M1	cpdb	0	network_modules	169	TRUE	0.009819758219721055	3	25	2	0.08	0.6666666666666666	GO:0042699	GO:BP	follicle-stimulating hormone signaling pathway	16175	10309		1	1	3	16172	2	23	1	16149	16175	0.23060434694047444
M1	cpdb	0	network_modules	170	TRUE	3.881213975156383e-17	53	18	10	0.5555555555555556	0.18867924528301888	REAC:R-HSA-9662361	REAC	Sensory processing of sound by outer hair cells of the cochlea	10916	2203		0	0.3333333333333333	53	10863	10	8	43	10855	10916	0.32197997629505337
M1	cpdb	0	network_modules	170	TRUE	4.163079445950976e-16	66	18	10	0.5555555555555556	0.15151515151515152	REAC:R-HSA-9662360	REAC	Sensory processing of sound by inner hair cells of the cochlea	10916	2202		0.5	0.6666666666666666	66	10850	10	8	56	10842	10916	0.2880810258138
M1	cpdb	0	network_modules	170	TRUE	1.4099842816575852e-15	74	18	10	0.5555555555555556	0.13513513513513514	REAC:R-HSA-9659379	REAC	Sensory processing of sound	10916	2201		1	1	74	10842	10	8	64	10834	10916	0.27180117777266527
M1	cpdb	0	network_modules	170	TRUE	1.903033305891107e-15	101	25	11	0.44	0.10891089108910891	GO:0007605	GO:BP	sensory perception of sound	16175	3064		0	0.030303030303030304	101	16074	11	14	90	16060	16175	0.21664598879487562
M1	cpdb	0	network_modules	170	TRUE	3.6921695699420056e-15	107	25	11	0.44	0.102803738317757	GO:0050954	GO:BP	sensory perception of mechanical stimulus	16175	13396		0.03125	0.06060606060606061	107	16068	11	14	96	16054	16175	0.21034343341984177
M1	cpdb	0	network_modules	170	TRUE	9.488030932498155e-8	6	25	4	0.16	0.6666666666666666	GO:1904970	GO:BP	brush border assembly	16175	24257		0.0625	0.09090909090909091	6	16169	4	21	2	16148	16175	0.32615404812435905
M1	cpdb	0	network_modules	170	TRUE	1.7363386556635113e-7	529	25	11	0.44	0.020793950850661626	GO:0007600	GO:BP	sensory perception	16175	3059		0.09375	0.12121212121212122	529	15646	11	14	518	15632	16175	0.09009648181887923
M1	cpdb	0	network_modules	170	TRUE	2.1299617083349923e-7	22	25	5	0.2	0.22727272727272727	GO:0042490	GO:BP	mechanoreceptor differentiation	16175	10219		0.125	0.15151515151515152	22	16153	5	20	17	16133	16175	0.21205891236253072
M1	cpdb	0	network_modules	170	TRUE	2.2115738601389023e-7	7	25	4	0.16	0.5714285714285714	GO:0050957	GO:BP	equilibrioception	16175	13399		0.15625	0.18181818181818182	7	16168	4	21	3	16147	16175	0.30185235972088303
M1	cpdb	0	network_modules	170	TRUE	6.739880640947195e-6	42	25	5	0.2	0.11904761904761904	GO:0001895	GO:BP	retina homeostasis	16175	520		0.1875	0.21212121212121213	42	16133	5	20	37	16113	16175	0.15261613379814654
M1	cpdb	0	network_modules	170	TRUE	8.553709378839232e-6	15	25	4	0.16	0.26666666666666666	GO:0050885	GO:BP	neuromuscular process controlling balance	16175	13329		0.21875	0.24242424242424243	15	16160	4	21	11	16139	16175	0.2056161482942495
M1	cpdb	0	network_modules	170	TRUE	1.4727448215942363e-5	806	25	11	0.44	0.013647642679900745	GO:0050877	GO:BP	nervous system process	16175	13322		0.25	0.2727272727272727	806	15369	11	14	795	15355	16175	0.07054911903490077
M1	cpdb	0	network_modules	170	TRUE	1.861853022027406e-5	4	25	3	0.12	0.75	GO:0032532	GO:BP	regulation of microvillus length	16175	7626		0.28125	0.3333333333333333	4	16171	3	22	1	16149	16175	0.29965044535356145
M1	cpdb	0	network_modules	170	TRUE	1.861853022027406e-5	4	25	3	0.12	0.75	GO:0032536	GO:BP	regulation of cell projection size	16175	7630		0.28125	0.3333333333333333	4	16171	3	22	1	16149	16175	0.29965044535356145
M1	cpdb	0	network_modules	170	TRUE	1.9115641141113835e-5	18	25	4	0.16	0.2222222222222222	GO:0032528	GO:BP	microvillus organization	16175	7622		0.34375	0.36363636363636365	18	16157	4	21	14	16136	16175	0.1874995584348584
M1	cpdb	0	network_modules	170	TRUE	2.418798763803228e-5	19	25	4	0.16	0.21052631578947367	GO:0060113	GO:BP	inner ear receptor cell differentiation	16175	14359		0.375	0.3939393939393939	19	16156	4	21	15	16135	16175	0.18243330355913667
M1	cpdb	0	network_modules	170	TRUE	5.022230350630886e-5	62	25	5	0.2	0.08064516129032258	GO:0048839	GO:BP	inner ear development	16175	13083		0.40625	0.42424242424242425	62	16113	5	20	57	16093	16175	0.12490210704744546
M1	cpdb	0	network_modules	170	TRUE	5.502988534246868e-5	23	25	4	0.16	0.17391304347826086	GO:0035315	GO:BP	hair cell differentiation	16175	8965		0.4375	0.45454545454545453	23	16152	4	21	19	16131	16175	0.16557472388135833
M1	cpdb	0	network_modules	170	TRUE	7.993105233745096e-5	139	25	6	0.24	0.04316546762589928	GO:0050953	GO:BP	sensory perception of light stimulus	16175	13395		0.46875	0.48484848484848486	139	16036	6	19	133	16017	16175	0.0986388826807293
M1	cpdb	0	network_modules	170	TRUE	1.0747456078930176e-4	72	25	5	0.2	0.06944444444444445	GO:0043583	GO:BP	ear development	16175	10787		0.5	0.5151515151515151	72	16103	5	20	67	16083	16175	0.1155748366354505
M1	cpdb	0	network_modules	170	TRUE	2.2180372481492226e-4	279	25	7	0.28	0.025089605734767026	GO:0007423	GO:BP	sensory organ development	16175	2918		0.53125	0.5454545454545454	279	15896	7	18	272	15878	16175	0.07940112254367322
M1	cpdb	0	network_modules	170	TRUE	2.5166950824690083e-4	33	25	4	0.16	0.12121212121212122	GO:0045494	GO:BP	photoreceptor cell maintenance	16175	11413		0.5625	0.5757575757575758	33	16142	4	21	29	16121	16175	0.13773331618221063
M1	cpdb	0	network_modules	170	TRUE	3.213598068918565e-4	35	25	4	0.16	0.11428571428571428	GO:0042472	GO:BP	inner ear morphogenesis	16175	10205		0.59375	0.6060606060606061	35	16140	4	21	31	16119	16175	0.13364378543161362
M1	cpdb	0	network_modules	170	TRUE	3.8899871601792674e-4	9	25	3	0.12	0.3333333333333333	GO:0032530	GO:BP	regulation of microvillus organization	16175	7624		0.625	0.6363636363636364	9	16166	3	22	6	16144	16175	0.19928211379297658
M1	cpdb	0	network_modules	170	TRUE	6.176799149104499e-4	41	25	4	0.16	0.0975609756097561	GO:0042471	GO:BP	ear morphogenesis	16175	10204		0.65625	0.6666666666666666	41	16134	4	21	37	16113	16175	0.12321107061738303
M1	cpdb	0	network_modules	170	TRUE	0.0013190517910497343	13	25	3	0.12	0.23076923076923078	GO:0060122	GO:BP	inner ear receptor cell stereocilium organization	16175	14368		0.6875	0.696969696969697	13	16162	3	22	10	16140	16175	0.16548991892696704
M1	cpdb	0	network_modules	170	TRUE	0.0013363984806103134	119	25	5	0.2	0.04201680672268908	GO:0090596	GO:BP	sensory organ morphogenesis	16175	18358		0.71875	0.7272727272727273	119	16056	5	20	114	16036	16175	0.08869293558995771
M1	cpdb	0	network_modules	170	TRUE	0.0016170891087751973	193	9	4	0.4444444444444444	0.02072538860103627	KEGG:04814	KEGG	Motor proteins	8484	366		NA	1	193	8291	4	5	189	8286	8484	0.09216566560703329
M1	cpdb	0	network_modules	170	TRUE	0.0016770806674558068	14	25	3	0.12	0.21428571428571427	GO:0042491	GO:BP	inner ear auditory receptor cell differentiation	16175	10220		0.75	0.7575757575757576	14	16161	3	22	11	16139	16175	0.15939229457778828
M1	cpdb	0	network_modules	170	TRUE	0.002094212406975043	15	25	3	0.12	0.2	GO:0060119	GO:BP	inner ear receptor cell development	16175	14365		0.78125	0.7878787878787878	15	16160	3	22	12	16138	16175	0.15391243747171574
M1	cpdb	0	network_modules	170	TRUE	0.003276358997535711	2	25	2	0.08	1	GO:0090675	GO:BP	intermicrovillar adhesion	16175	18405		0.8125	0.8181818181818182	2	16173	2	23	0	16150	16175	0.282641522315189
M1	cpdb	0	network_modules	170	TRUE	0.0037442930207189206	18	25	3	0.12	0.16666666666666666	GO:0030050	GO:BP	vesicle transport along actin filament	16175	6669		0.84375	0.8484848484848485	18	16157	3	22	15	16135	16175	0.14029636220631622
M1	cpdb	0	network_modules	170	TRUE	0.004474056173616639	152	25	5	0.2	0.03289473684210526	GO:0001894	GO:BP	tissue homeostasis	16175	519		0.875	0.9090909090909091	152	16023	5	20	147	16003	16175	0.0777255055332122
M1	cpdb	0	network_modules	170	TRUE	0.004474056173616639	152	25	5	0.2	0.03289473684210526	GO:0060249	GO:BP	anatomical structure homeostasis	16175	14466		0.875	0.9090909090909091	152	16023	5	20	147	16003	16175	0.0777255055332122
M1	cpdb	0	network_modules	170	TRUE	0.00522033197525266	20	25	3	0.12	0.15	GO:0099515	GO:BP	actin filament-based transport	16175	19105		0.9375	0.9393939393939394	20	16155	3	22	17	16133	16175	0.13296661929196105
M1	cpdb	0	network_modules	170	TRUE	0.006075886768903868	72	25	4	0.16	0.05555555555555555	GO:0050905	GO:BP	neuromuscular process	16175	13347		0.96875	0.9696969696969697	72	16103	4	21	68	16082	16175	0.09193369869579306
M1	cpdb	0	network_modules	170	TRUE	0.009819758219721055	3	25	2	0.08	0.6666666666666666	GO:0009258	GO:BP	10-formyltetrahydrofolate catabolic process	16175	3423		1	1	3	16172	2	23	1	16149	16175	0.23060434694047444
M1	cpdb	0	network_modules	171	TRUE	8.531258280244215e-4	397	22	7	0.3181818181818182	0.017632241813602016	GO:0008380	GO:BP	RNA splicing	16175	3186		NA	1	397	15778	7	15	390	15763	16175	0.0700357395987281
M1	cpdb	0	network_modules	171	TRUE	0.003704804602453574	202	9	4	0.4444444444444444	0.019801980198019802	REAC:R-HSA-72163	REAC	mRNA Splicing - Major Pathway	10916	2707		0	0.5	202	10714	4	5	198	10709	10916	0.0907880177077085
M1	cpdb	0	network_modules	171	TRUE	0.004238904221897938	209	9	4	0.4444444444444444	0.019138755980861243	REAC:R-HSA-72172	REAC	mRNA Splicing	10916	2706		1	1	209	10707	4	5	205	10702	10916	0.08914944898364399
M1	cpdb	0	network_modules	172	TRUE	3.828895342097418e-8	94	22	7	0.3181818181818182	0.07446808510638298	GO:0006493	GO:BP	protein O-linked glycosylation	16175	2225		0	0.07142857142857142	94	16081	7	15	87	16066	16175	0.151662575721029
M1	cpdb	0	network_modules	172	TRUE	8.691140573933838e-8	183	22	8	0.36363636363636365	0.04371584699453552	GO:0006486	GO:BP	protein glycosylation	16175	2220		0.07692307692307693	0.21428571428571427	183	15992	8	14	175	15978	16175	0.12293983040648324
M1	cpdb	0	network_modules	172	TRUE	8.691140573933838e-8	183	22	8	0.36363636363636365	0.04371584699453552	GO:0043413	GO:BP	macromolecule glycosylation	16175	10680		0.07692307692307693	0.21428571428571427	183	15992	8	14	175	15978	16175	0.12293983040648324
M1	cpdb	0	network_modules	172	TRUE	2.0722844742677606e-7	204	22	8	0.36363636363636365	0.0392156862745098	GO:0070085	GO:BP	glycosylation	16175	15903		0.23076923076923078	0.2857142857142857	204	15971	8	14	196	15957	16175	0.11608740055412482
M1	cpdb	0	network_modules	172	TRUE	1.6549623395095334e-6	265	22	8	0.36363636363636365	0.03018867924528302	GO:0009101	GO:BP	glycoprotein biosynthetic process	16175	3273		0.3076923076923077	0.35714285714285715	265	15910	8	14	257	15896	16175	0.10095250106990326
M1	cpdb	0	network_modules	172	TRUE	3.485853485143195e-6	23	15	4	0.26666666666666666	0.17391304347826086	KEGG:00515	KEGG	Mannose type O-glycan biosynthesis	8484	68		0	0.25	23	8461	4	11	19	8450	8484	0.21364191956405446
M1	cpdb	0	network_modules	172	TRUE	6.4532573717252425e-6	315	22	8	0.36363636363636365	0.025396825396825397	GO:0009100	GO:BP	glycoprotein metabolic process	16175	3272		0.38461538461538464	0.42857142857142855	315	15860	8	14	307	15846	16175	0.09191468697658867
M1	cpdb	0	network_modules	172	TRUE	2.287719449481725e-5	36	15	4	0.26666666666666666	0.1111111111111111	KEGG:00512	KEGG	Mucin type O-glycan biosynthesis	8484	65		0.3333333333333333	0.5	36	8448	4	11	32	8437	8484	0.16990437165207878
M1	cpdb	0	network_modules	172	TRUE	5.0652638266482184e-5	108	14	5	0.35714285714285715	0.046296296296296294	REAC:R-HSA-5173105	REAC	O-linked glycosylation	10916	1631		0	0.3333333333333333	108	10808	5	9	103	10799	10916	0.1257277281312248
M1	cpdb	0	network_modules	172	TRUE	6.848415493897093e-5	47	15	4	0.26666666666666666	0.0851063829787234	KEGG:00514	KEGG	Other types of O-glycan biosynthesis	8484	67		0.6666666666666666	0.75	47	8437	4	11	43	8426	8484	0.14806034634272427
M1	cpdb	0	network_modules	172	TRUE	2.845892308795431e-4	62	14	4	0.2857142857142857	0.06451612903225806	REAC:R-HSA-913709	REAC	O-linked glycosylation of mucins	10916	1632		0.5	0.6666666666666666	62	10854	4	10	58	10844	10916	0.13353506396633433
M1	cpdb	0	network_modules	172	TRUE	2.87298439190594e-4	514	22	8	0.36363636363636365	0.01556420233463035	GO:1901137	GO:BP	carbohydrate derivative biosynthetic process	16175	21245		0.46153846153846156	0.5	514	15661	8	14	506	15647	16175	0.06982183150004787
M1	cpdb	0	network_modules	172	TRUE	3.068629509315656e-4	40	22	4	0.18181818181818182	0.1	GO:0016266	GO:BP	O-glycan processing	16175	5194		0.5384615384615384	0.5714285714285714	40	16135	4	18	36	16117	16175	0.13326140333432707
M1	cpdb	0	network_modules	172	TRUE	0.00048351415682192865	11	22	3	0.13636363636363635	0.2727272727272727	GO:0005984	GO:BP	disaccharide metabolic process	16175	1859		0.6153846153846154	0.6428571428571429	11	16164	3	19	8	16145	16175	0.19208150336741148
M1	cpdb	0	network_modules	172	TRUE	0.0013647811100557564	32	15	3	0.2	0.09375	KEGG:00052	KEGG	Galactose metabolism	8484	7		1	1	32	8452	3	12	29	8440	8484	0.13472149605908942
M1	cpdb	0	network_modules	172	TRUE	0.0014399910723973813	3	14	2	0.14285714285714285	0.6666666666666666	REAC:R-HSA-5653890	REAC	Lactose synthesis	10916	1301		1	1	3	10913	2	12	1	10901	10916	0.30825307569254096
M1	cpdb	0	network_modules	172	TRUE	0.0019821535752296933	17	22	3	0.13636363636363635	0.17647058823529413	GO:0035268	GO:BP	protein mannosylation	16175	8932		0.6923076923076923	0.7857142857142857	17	16158	3	19	14	16139	16175	0.15411649072490274
M1	cpdb	0	network_modules	172	TRUE	0.0019821535752296933	17	22	3	0.13636363636363635	0.17647058823529413	GO:0035269	GO:BP	protein O-linked mannosylation	16175	8933		0.6923076923076923	0.7857142857142857	17	16158	3	19	14	16139	16175	0.15411649072490274
M1	cpdb	0	network_modules	172	TRUE	0.002376488672544942	18	22	3	0.13636363636363635	0.16666666666666666	GO:0097502	GO:BP	mannosylation	16175	18684		0.8461538461538461	0.8571428571428571	18	16157	3	19	15	16138	16175	0.14971050876290892
M1	cpdb	0	network_modules	172	TRUE	0.0023864290536104726	2	22	2	0.09090909090909091	1	GO:0005989	GO:BP	lactose biosynthetic process	16175	1864		0.9230769230769231	0.9285714285714286	2	16173	2	20	0	16153	16175	0.30132485807762605
M1	cpdb	0	network_modules	172	TRUE	0.007153384906324254	3	22	2	0.09090909090909091	0.6666666666666666	GO:0005988	GO:BP	lactose metabolic process	16175	1863		1	1	3	16172	2	20	1	16152	16175	0.2458707737811223
M1	cpdb	0	network_modules	173	TRUE	8.00216415221853e-6	156	27	7	0.25925925925925924	0.04487179487179487	GO:0042063	GO:BP	gliogenesis	16175	9949		0	0.09090909090909091	156	16019	7	20	149	15999	16175	0.1044376375251796
M1	cpdb	0	network_modules	173	TRUE	1.7899249361227236e-5	46	27	5	0.18518518518518517	0.10869565217391304	GO:0048709	GO:BP	oligodendrocyte differentiation	16175	12966		0.1	0.18181818181818182	46	16129	5	22	41	16107	16175	0.1400132665338203
M1	cpdb	0	network_modules	173	TRUE	5.6935343329709365e-5	119	27	6	0.2222222222222222	0.05042016806722689	GO:0010001	GO:BP	glial cell differentiation	16175	3822		0.2	0.2727272727272727	119	16056	6	21	113	16035	16175	0.10281126479202106
M1	cpdb	0	network_modules	173	TRUE	1.9162368507102604e-4	28	27	4	0.14814814814814814	0.14285714285714285	GO:0048483	GO:BP	autonomic nervous system development	16175	12777		0.3	0.36363636363636365	28	16147	4	23	24	16124	16175	0.14402358239087304
M1	cpdb	0	network_modules	173	TRUE	4.5639053544601764e-4	593	27	9	0.3333333333333333	0.01517706576728499	GO:0007417	GO:BP	central nervous system development	16175	2912		0.4	0.45454545454545453	593	15582	9	18	584	15564	16175	0.06455117445221863
M1	cpdb	0	network_modules	173	TRUE	6.440238330897425e-4	179	27	6	0.2222222222222222	0.0335195530726257	GO:0043009	GO:BP	chordate embryonic development	16175	10479		0.5	0.5454545454545454	179	15996	6	21	173	15975	16175	0.08253487996262902
M1	cpdb	0	network_modules	173	TRUE	7.278091275507843e-4	28	11	3	0.2727272727272727	0.10714285714285714	REAC:R-HSA-9619665	REAC	EGR2 and SOX10-mediated initiation of Schwann cell myelination	10916	816		NA	1	28	10888	3	8	25	10880	10916	0.16963622379367638
M1	cpdb	0	network_modules	173	TRUE	0.0010331630547019079	194	27	6	0.2222222222222222	0.030927835051546393	GO:0009792	GO:BP	embryo development ending in birth or egg hatching	16175	3679		0.6	0.6363636363636364	194	15981	6	21	188	15960	16175	0.07896876659139321
M1	cpdb	0	network_modules	173	TRUE	0.002465389506179408	52	27	4	0.14814814814814814	0.07692307692307693	GO:0001701	GO:BP	in utero embryonic development	16175	393		0.7	0.7272727272727273	52	16123	4	23	48	16100	16175	0.10469125700698584
M1	cpdb	0	network_modules	173	TRUE	0.004192715654658986	2	27	2	0.07407407407407407	1	GO:0021529	GO:BP	spinal cord oligodendrocyte cell differentiation	16175	6113		0.8	0.8181818181818182	2	16173	2	25	0	16148	16175	0.27195509076604235
M1	cpdb	0	network_modules	173	TRUE	0.00504812431324834	791	27	9	0.3333333333333333	0.011378002528445006	GO:0000122	GO:BP	negative regulation of transcription by RNA polymerase II	16175	48		0.9	0.9090909090909091	791	15384	9	18	782	15366	16175	0.05392875604571665
M1	cpdb	0	network_modules	173	TRUE	0.005202073004669291	103	8	3	0.375	0.02912621359223301	KEGG:04137	KEGG	Mitophagy - animal	8484	274		NA	1	103	8381	3	5	100	8376	8484	0.1017939916561269
M1	cpdb	0	network_modules	173	TRUE	0.009235357094273961	283	27	6	0.2222222222222222	0.02120141342756184	GO:0001501	GO:BP	skeletal system development	16175	318		1	1	283	15892	6	21	277	15871	16175	0.06384949829815004
M1	cpdb	0	network_modules	174	TRUE	6.562738482512784e-14	64	18	9	0.5	0.140625	REAC:R-HSA-373755	REAC	Semaphorin interactions	10916	2193		0	0.125	64	10852	9	9	55	10843	10916	0.2630443108982743
M1	cpdb	0	network_modules	174	TRUE	1.522830976586123e-12	42	25	8	0.32	0.19047619047619047	GO:0071526	GO:BP	semaphorin-plexin signaling pathway	16175	16747		0	0.01639344262295082	42	16133	8	17	34	16116	16175	0.2453903009457201
M1	cpdb	0	network_modules	174	TRUE	1.5940920842855543e-11	181	17	10	0.5882352941176471	0.055248618784530384	KEGG:04360	KEGG	Axon guidance	8484	305		NA	1	181	8303	10	7	171	8296	8484	0.175796721297559
M1	cpdb	0	network_modules	174	TRUE	2.237152252864723e-11	99	25	9	0.36	0.09090909090909091	GO:0050770	GO:BP	regulation of axonogenesis	16175	13244		0.016666666666666666	0.03278688524590164	99	16076	9	16	90	16060	16175	0.17851584502289328
M1	cpdb	0	network_modules	174	TRUE	2.4370583663765012e-9	165	25	9	0.36	0.05454545454545454	GO:0097485	GO:BP	neuron projection guidance	16175	18673		0.03333333333333333	0.06557377049180328	165	16010	9	16	156	15994	16175	0.13696482472192897
M1	cpdb	0	network_modules	174	TRUE	2.4370583663765012e-9	165	25	9	0.36	0.05454545454545454	GO:0007411	GO:BP	axon guidance	16175	2906		0.03333333333333333	0.06557377049180328	165	16010	9	16	156	15994	16175	0.13696482472192897
M1	cpdb	0	network_modules	174	TRUE	3.826613071161831e-9	449	18	11	0.6111111111111112	0.024498886414253896	REAC:R-HSA-9012999	REAC	RHO GTPase cycle	10916	1847		0.14285714285714285	0.25	449	10467	11	7	438	10460	10916	0.11664088854559143
M1	cpdb	0	network_modules	174	TRUE	4.802174770946243e-9	379	25	11	0.44	0.029023746701846966	GO:0048667	GO:BP	cell morphogenesis involved in neuron differentiation	16175	12925		0.06666666666666667	0.08196721311475409	379	15796	11	14	368	15782	16175	0.10834816991141358
M1	cpdb	0	network_modules	174	TRUE	1.2826298112642595e-8	295	25	10	0.4	0.03389830508474576	GO:0010975	GO:BP	regulation of neuron projection development	16175	4551		0.08333333333333333	0.09836065573770492	295	15880	10	15	285	15865	16175	0.11224950794132488
M1	cpdb	0	network_modules	174	TRUE	1.3713806936984035e-8	297	25	10	0.4	0.03367003367003367	GO:0007409	GO:BP	axonogenesis	16175	2905		0.1	0.11475409836065574	297	15878	10	15	287	15863	16175	0.11184173470277964
M1	cpdb	0	network_modules	174	TRUE	2.200870359867944e-8	761	25	13	0.52	0.017082785808147174	GO:0048666	GO:BP	neuron development	16175	12924		0.11666666666666667	0.13114754098360656	761	15414	13	12	748	15402	16175	0.08788103648877413
M1	cpdb	0	network_modules	174	TRUE	2.3499530007239846e-8	19	18	5	0.2777777777777778	0.2631578947368421	REAC:R-HSA-416700	REAC	Other semaphorin interactions	10916	1652		0.2857142857142857	0.375	19	10897	5	13	14	10884	10916	0.2691310070674166
M1	cpdb	0	network_modules	174	TRUE	2.468389338031783e-8	441	25	11	0.44	0.024943310657596373	GO:0048812	GO:BP	neuron projection morphogenesis	16175	13058		0.13333333333333333	0.14754098360655737	441	15734	11	14	430	15720	16175	0.0997151625056041
M1	cpdb	0	network_modules	174	TRUE	3.5376887263017236e-8	456	25	11	0.44	0.02412280701754386	GO:0120039	GO:BP	plasma membrane bounded cell projection morphogenesis	16175	19473		0.15	0.16393442622950818	456	15719	11	14	445	15705	16175	0.0978877387778228
M1	cpdb	0	network_modules	174	TRUE	3.8859119047813136e-8	460	25	11	0.44	0.02391304347826087	GO:0048858	GO:BP	cell projection morphogenesis	16175	13102		0.16666666666666666	0.18032786885245902	460	15715	11	14	449	15701	16175	0.09741507953317315
M1	cpdb	0	network_modules	174	TRUE	5.0614919733800905e-8	339	25	10	0.4	0.029498525073746312	GO:0061564	GO:BP	axon development	16175	15561		0.18333333333333332	0.19672131147540983	339	15836	10	15	329	15821	16175	0.10411000359841924
M1	cpdb	0	network_modules	174	TRUE	8.547225050609658e-8	24	18	5	0.2777777777777778	0.20833333333333334	REAC:R-HSA-400685	REAC	Sema4D in semaphorin signaling	10916	2190		0.42857142857142855	0.5	24	10892	5	13	19	10879	10916	0.23911858315165752
M1	cpdb	0	network_modules	174	TRUE	9.159355572906404e-8	46	25	6	0.24	0.13043478260869565	GO:0050772	GO:BP	positive regulation of axonogenesis	16175	13246		0.2	0.21311475409836064	46	16129	6	19	40	16110	16175	0.17521839694632815
M1	cpdb	0	network_modules	174	TRUE	1.113489929661048e-7	8	18	4	0.2222222222222222	0.5	REAC:R-HSA-416550	REAC	Sema4D mediated inhibition of cell attachment and migration	10916	2192		0.5714285714285714	0.625	8	10908	4	14	4	10894	10916	0.33263019792886145
M1	cpdb	0	network_modules	174	TRUE	1.3317039071341806e-7	684	25	12	0.48	0.017543859649122806	GO:0031175	GO:BP	neuron projection development	16175	7086		0.21666666666666667	0.22950819672131148	684	15491	12	13	672	15478	16175	0.08557545577348365
M1	cpdb	0	network_modules	174	TRUE	7.945131318747407e-7	9	25	4	0.16	0.4444444444444444	GO:1902287	GO:BP	semaphorin-plexin signaling pathway involved in axon guidance	16175	22180		0.23333333333333334	0.26229508196721313	9	16166	4	21	5	16145	16175	0.2660189293333782
M1	cpdb	0	network_modules	174	TRUE	7.945131318747407e-7	9	25	4	0.16	0.4444444444444444	GO:1902285	GO:BP	semaphorin-plexin signaling pathway involved in neuron projection guidance	16175	22178		0.23333333333333334	0.26229508196721313	9	16166	4	21	5	16145	16175	0.2660189293333782
M1	cpdb	0	network_modules	174	TRUE	1.1340811766044594e-6	466	25	10	0.4	0.02145922746781116	GO:0120035	GO:BP	regulation of plasma membrane bounded cell projection organization	16175	19471		0.26666666666666666	0.2786885245901639	466	15709	10	15	456	15694	16175	0.08730863458780654
M1	cpdb	0	network_modules	174	TRUE	1.3059519997563798e-6	220	25	8	0.32	0.03636363636363636	GO:0050767	GO:BP	regulation of neurogenesis	16175	13241		0.2833333333333333	0.29508196721311475	220	15955	8	17	212	15938	16175	0.10407712671384943
M1	cpdb	0	network_modules	174	TRUE	1.5107277040048657e-6	480	25	10	0.4	0.020833333333333332	GO:0031344	GO:BP	regulation of cell projection organization	16175	7135		0.3	0.3114754098360656	480	15695	10	15	470	15680	16175	0.08586363786351457
M1	cpdb	0	network_modules	174	TRUE	1.5711195315940025e-6	651	25	11	0.44	0.016897081413210446	GO:0000902	GO:BP	cell morphogenesis	16175	240		0.31666666666666665	0.32786885245901637	651	15524	11	14	640	15510	16175	0.08002526665747695
M1	cpdb	0	network_modules	174	TRUE	3.514179323316621e-6	153	25	7	0.28	0.0457516339869281	GO:0051962	GO:BP	positive regulation of nervous system development	16175	14031		0.3333333333333333	0.3442622950819672	153	16022	7	18	146	16004	16175	0.10996563216478723
M1	cpdb	0	network_modules	174	TRUE	3.817647746454164e-6	252	25	8	0.32	0.031746031746031744	GO:0031346	GO:BP	positive regulation of cell projection organization	16175	7137		0.35	0.36065573770491804	252	15923	8	17	244	15906	16175	0.09671393801296173
M1	cpdb	0	network_modules	174	TRUE	5.082712910913986e-6	52	18	5	0.2777777777777778	0.09615384615384616	REAC:R-HSA-9013405	REAC	RHOD GTPase cycle	10916	1866		0.7142857142857143	0.75	52	10864	5	13	47	10851	10916	0.16114430036097885
M1	cpdb	0	network_modules	174	TRUE	5.840984032807411e-6	266	25	8	0.32	0.03007518796992481	GO:0051960	GO:BP	regulation of nervous system development	16175	14029		0.36666666666666664	0.3770491803278688	266	15909	8	17	258	15892	16175	0.09390808273135712
M1	cpdb	0	network_modules	174	TRUE	7.61252099754736e-6	20	18	4	0.2222222222222222	0.2	REAC:R-HSA-416572	REAC	Sema4D induced cell migration and growth-cone collapse	10916	2191		0.8571428571428571	0.875	20	10896	4	14	16	10882	10916	0.20944491201331264
M1	cpdb	0	network_modules	174	TRUE	3.020356971213696e-5	20	25	4	0.16	0.2	GO:0048843	GO:BP	negative regulation of axon extension involved in axon guidance	16175	13087		0.38333333333333336	0.39344262295081966	20	16155	4	21	16	16134	16175	0.17775027503475063
M1	cpdb	0	network_modules	174	TRUE	3.483956381930125e-5	121	25	6	0.24	0.049586776859504134	GO:0008361	GO:BP	regulation of cell size	16175	3180		0.4	0.4098360655737705	121	16054	6	19	115	16035	16175	0.10617023043072189
M1	cpdb	0	network_modules	174	TRUE	4.657663788767387e-5	127	25	6	0.24	0.047244094488188976	GO:0050769	GO:BP	positive regulation of neurogenesis	16175	13243		0.4166666666666667	0.4262295081967213	127	16048	6	19	121	16029	16175	0.10348594361082579
M1	cpdb	0	network_modules	174	TRUE	5.1147460835385216e-5	129	25	6	0.24	0.046511627906976744	GO:0007266	GO:BP	Rho protein signal transduction	16175	2794		0.43333333333333335	0.4426229508196721	129	16046	6	19	123	16027	16175	0.10263229875615013
M1	cpdb	0	network_modules	174	TRUE	6.287898355273142e-5	232	25	7	0.28	0.03017241379310345	GO:0007162	GO:BP	negative regulation of cell adhesion	16175	2726		0.45	0.45901639344262296	232	15943	7	18	225	15925	16175	0.08790631585401286
M1	cpdb	0	network_modules	174	TRUE	6.596724747445044e-5	24	25	4	0.16	0.16666666666666666	GO:0048841	GO:BP	regulation of axon extension involved in axon guidance	16175	13085		0.4666666666666667	0.47540983606557374	24	16151	4	21	20	16130	16175	0.16203037324710862
M1	cpdb	0	network_modules	174	TRUE	8.398098585443828e-5	242	25	7	0.28	0.028925619834710745	GO:0051056	GO:BP	regulation of small GTPase mediated signal transduction	16175	13466		0.48333333333333334	0.4918032786885246	242	15933	7	18	235	15915	16175	0.08589754733875851
M1	cpdb	0	network_modules	174	TRUE	1.4668406750367057e-4	29	25	4	0.16	0.13793103448275862	GO:0048846	GO:BP	axon extension involved in axon guidance	16175	13090		0.5	0.5245901639344263	29	16146	4	21	25	16125	16175	0.1471372225785833
M1	cpdb	0	network_modules	174	TRUE	1.4668406750367057e-4	29	25	4	0.16	0.13793103448275862	GO:1902284	GO:BP	neuron projection extension involved in neuron projection guidance	16175	22177		0.5	0.5245901639344263	29	16146	4	21	25	16125	16175	0.1471372225785833
M1	cpdb	0	network_modules	174	TRUE	1.592885255075473e-4	407	25	8	0.32	0.019656019656019656	GO:0007015	GO:BP	actin filament organization	16175	2624		0.5333333333333333	0.5409836065573771	407	15768	8	17	399	15751	16175	0.07406713622964352
M1	cpdb	0	network_modules	174	TRUE	1.89373045037641e-4	43	18	4	0.2222222222222222	0.09302325581395349	REAC:R-HSA-9696270	REAC	RND2 GTPase cycle	10916	1906		1	1	43	10873	4	14	39	10859	10916	0.14162420014386165
M1	cpdb	0	network_modules	174	TRUE	2.2139417037615e-4	32	25	4	0.16	0.125	GO:0030517	GO:BP	negative regulation of axon extension	16175	6832		0.55	0.5573770491803278	32	16143	4	21	28	16122	16175	0.13991925302498212
M1	cpdb	0	network_modules	174	TRUE	3.293153767991981e-4	631	25	9	0.36	0.014263074484944533	GO:0022603	GO:BP	regulation of anatomical structure morphogenesis	16175	6611		0.5666666666666667	0.5737704918032787	631	15544	9	16	622	15528	16175	0.0652262410904565
M1	cpdb	0	network_modules	174	TRUE	4.0450956451494396e-4	37	25	4	0.16	0.10810810810810811	GO:0090497	GO:BP	mesenchymal cell migration	16175	18319		0.5833333333333334	0.6065573770491803	37	16138	4	21	33	16117	16175	0.12988783621780656
M1	cpdb	0	network_modules	174	TRUE	4.0450956451494396e-4	37	25	4	0.16	0.10810810810810811	GO:0001755	GO:BP	neural crest cell migration	16175	424		0.5833333333333334	0.6065573770491803	37	16138	4	21	33	16117	16175	0.12988783621780656
M1	cpdb	0	network_modules	174	TRUE	6.202692907738243e-4	102	25	5	0.2	0.049019607843137254	GO:0008360	GO:BP	regulation of cell shape	16175	3179		0.6166666666666667	0.6229508196721312	102	16073	5	20	97	16053	16175	0.09627102098019091
M1	cpdb	0	network_modules	174	TRUE	7.511556027579543e-4	43	25	4	0.16	0.09302325581395349	GO:0050771	GO:BP	negative regulation of axonogenesis	16175	13245		0.6333333333333333	0.639344262295082	43	16132	4	21	39	16111	16175	0.12022455914394735
M1	cpdb	0	network_modules	174	TRUE	9.505892393729258e-4	346	25	7	0.28	0.02023121387283237	GO:0034329	GO:BP	cell junction assembly	16175	8571		0.65	0.6557377049180327	346	15829	7	18	339	15811	16175	0.07032452648827617
M1	cpdb	0	network_modules	174	TRUE	0.001391593848909313	50	25	4	0.16	0.08	GO:0050922	GO:BP	negative regulation of chemotaxis	16175	13364		0.6666666666666666	0.6721311475409836	50	16125	4	21	46	16104	16175	0.11120914324016563
M1	cpdb	0	network_modules	174	TRUE	0.0015084580400190938	51	25	4	0.16	0.0784313725490196	GO:0014032	GO:BP	neural crest cell development	16175	4602		0.6833333333333333	0.6885245901639344	51	16124	4	21	47	16103	16175	0.11007348720207513
M1	cpdb	0	network_modules	174	TRUE	0.00170550472180571	125	25	5	0.2	0.04	GO:0007416	GO:BP	synapse assembly	16175	2911		0.7	0.7049180327868853	125	16050	5	20	120	16030	16175	0.0863876390767625
M1	cpdb	0	network_modules	174	TRUE	0.0017638918393886789	53	25	4	0.16	0.07547169811320754	GO:0048864	GO:BP	stem cell development	16175	13107		0.7166666666666667	0.7213114754098361	53	16122	4	21	49	16101	16175	0.10789822777369211
M1	cpdb	0	network_modules	174	TRUE	0.0019770123078114406	781	25	9	0.36	0.011523687580025609	GO:0030334	GO:BP	regulation of cell migration	16175	6780		0.7333333333333333	0.7377049180327869	781	15394	9	16	772	15378	16175	0.05721176212896484
M1	cpdb	0	network_modules	174	TRUE	0.00208256228513503	389	25	7	0.28	0.017994858611825194	GO:0007264	GO:BP	small GTPase-mediated signal transduction	16175	2792		0.75	0.7540983606557377	389	15786	7	18	382	15768	16175	0.06573145295741863
M1	cpdb	0	network_modules	174	TRUE	0.002085323841938772	571	25	8	0.32	0.014010507880910683	GO:0060284	GO:BP	regulation of cell development	16175	14500		0.7666666666666667	0.7704918032786885	571	15604	8	17	563	15587	16175	0.06069841499640642
M1	cpdb	0	network_modules	174	TRUE	0.0021507711600474736	131	25	5	0.2	0.03816793893129771	GO:0031345	GO:BP	negative regulation of cell projection organization	16175	7136		0.7833333333333333	0.7868852459016393	131	16044	5	20	126	16024	16175	0.08423905361294648
M1	cpdb	0	network_modules	174	TRUE	0.0025424248046043182	58	25	4	0.16	0.06896551724137931	GO:0048640	GO:BP	negative regulation of developmental growth	16175	12898		0.8	0.819672131147541	58	16117	4	21	54	16096	16175	0.1029551705675145
M1	cpdb	0	network_modules	174	TRUE	0.0025424248046043182	58	25	4	0.16	0.06896551724137931	GO:0014033	GO:BP	neural crest cell differentiation	16175	4603		0.8	0.819672131147541	58	16117	4	21	54	16096	16175	0.1029551705675145
M1	cpdb	0	network_modules	174	TRUE	0.002724493825054791	59	25	4	0.16	0.06779661016949153	GO:0030516	GO:BP	regulation of axon extension	16175	6831		0.8333333333333334	0.8360655737704918	59	16116	4	21	55	16095	16175	0.10204175871319976
M1	cpdb	0	network_modules	174	TRUE	0.0029800638445438596	257	25	6	0.24	0.023346303501945526	GO:0032535	GO:BP	regulation of cellular component size	16175	7629		0.85	0.8524590163934426	257	15918	6	19	251	15899	16175	0.07051490742126283
M1	cpdb	0	network_modules	174	TRUE	0.003952922809201576	622	25	8	0.32	0.012861736334405145	GO:0030155	GO:BP	regulation of cell adhesion	16175	6688		0.8666666666666667	0.8688524590163934	622	15553	8	17	614	15536	16175	0.05760689784714884
M1	cpdb	0	network_modules	174	TRUE	0.004027715377862427	65	25	4	0.16	0.06153846153846154	GO:0061387	GO:BP	regulation of extent of cell growth	16175	15458		0.8833333333333333	0.8852459016393442	65	16110	4	21	61	16089	16175	0.09700554120519962
M1	cpdb	0	network_modules	174	TRUE	0.00444181271442159	19	25	3	0.12	0.15789473684210525	GO:1904862	GO:BP	inhibitory synapse assembly	16175	24170		0.9	0.9016393442622951	19	16156	3	22	16	16134	16175	0.13648766424315323
M1	cpdb	0	network_modules	174	TRUE	0.0044511423715916446	632	25	8	0.32	0.012658227848101266	GO:0030036	GO:BP	actin cytoskeleton organization	16175	6660		0.9166666666666666	0.9180327868852459	632	15543	8	17	624	15526	16175	0.05704217820359323
M1	cpdb	0	network_modules	174	TRUE	0.00520271366008081	283	25	6	0.24	0.02120141342756184	GO:0010720	GO:BP	positive regulation of cell development	16175	4346		0.9333333333333333	0.9344262295081968	283	15892	6	19	277	15873	16175	0.06677026374277044
M1	cpdb	0	network_modules	174	TRUE	0.007950797269081544	77	25	4	0.16	0.05194805194805195	GO:0048675	GO:BP	axon extension	16175	12933		0.95	0.9508196721311475	77	16098	4	21	73	16077	16175	0.08873585323622328
M1	cpdb	0	network_modules	174	TRUE	0.008809191312596065	79	25	4	0.16	0.05063291139240506	GO:0035023	GO:BP	regulation of Rho protein signal transduction	16175	8766		0.9666666666666667	0.9672131147540983	79	16096	4	21	75	16075	16175	0.08754107491124559
M1	cpdb	0	network_modules	174	TRUE	0.009263193951286131	80	25	4	0.16	0.05	GO:0050768	GO:BP	negative regulation of neurogenesis	16175	13242		0.9833333333333333	0.9836065573770492	80	16095	4	21	76	16074	16175	0.08696025190846673
M1	cpdb	0	network_modules	174	TRUE	0.009819758219721055	3	25	2	0.08	0.6666666666666666	GO:1905704	GO:BP	positive regulation of inhibitory synapse assembly	16175	24844		1	1	3	16172	2	23	1	16149	16175	0.23060434694047444
M1	cpdb	0	network_modules	175	TRUE	3.5092568638648223e-9	128	18	8	0.4444444444444444	0.0625	REAC:R-HSA-6809371	REAC	Formation of the cornified envelope	10916	969		0	0.25	128	10788	8	10	120	10778	10916	0.16336402483421061
M1	cpdb	0	network_modules	175	TRUE	2.2675622218378056e-7	215	18	8	0.4444444444444444	0.037209302325581395	REAC:R-HSA-6805567	REAC	Keratinization	10916	1288		0.3333333333333333	0.5	215	10701	8	10	207	10691	10916	0.12423012055815046
M1	cpdb	0	network_modules	175	TRUE	1.901628062032523e-4	11	18	3	0.16666666666666666	0.2727272727272727	REAC:R-HSA-351906	REAC	Apoptotic cleavage of cell adhesion  proteins	10916	160		0.6666666666666666	0.75	11	10905	3	15	8	10890	10916	0.21219354140982122
M1	cpdb	0	network_modules	175	TRUE	6.148383252507942e-4	745	23	9	0.391304347826087	0.012080536912751677	GO:0098609	GO:BP	cell-cell adhesion	16175	18805		NA	1	745	15430	9	14	736	15416	16175	0.062153004366297476
M1	cpdb	0	network_modules	175	TRUE	0.008717968689634708	37	18	3	0.16666666666666666	0.08108108108108109	REAC:R-HSA-111465	REAC	Apoptotic cleavage of cellular proteins	10916	161		1	1	37	10879	3	15	34	10864	10916	0.1141711642451983
M1	cpdb	0	network_modules	176	TRUE	3.9185460009327994e-9	12	21	5	0.23809523809523808	0.4166666666666667	REAC:R-HSA-8866907	REAC	Activation of the TFAP2 (AP-2) family of transcription factors	10916	104		0	0.2	12	10904	5	16	7	10888	10916	0.3139907891756531
M1	cpdb	0	network_modules	176	TRUE	2.4056622623401966e-6	38	21	5	0.23809523809523808	0.13157894736842105	REAC:R-HSA-8864260	REAC	Transcriptional regulation by the AP-2 (TFAP2) family of transcription factors	10916	2556		0.25	0.4	38	10878	5	16	33	10862	10916	0.1748829047504067
M1	cpdb	0	network_modules	176	TRUE	0.0017638918393886789	53	25	4	0.16	0.07547169811320754	GO:0140527	GO:BP	reciprocal homologous recombination	16175	19808		0	0.6666666666666666	53	16122	4	21	49	16101	16175	0.10789822777369211
M1	cpdb	0	network_modules	176	TRUE	0.0017638918393886789	53	25	4	0.16	0.07547169811320754	GO:0007131	GO:BP	reciprocal meiotic recombination	16175	2702		0	0.6666666666666666	53	16122	4	21	49	16101	16175	0.10789822777369211
M1	cpdb	0	network_modules	176	TRUE	0.0028098527460448546	154	21	5	0.23809523809523808	0.032467532467532464	REAC:R-HSA-1474165	REAC	Reproduction	10916	2064		0.5	0.6	154	10762	5	16	149	10746	10916	0.08338280439027602
M1	cpdb	0	network_modules	176	TRUE	0.0031174593435750113	61	25	4	0.16	0.06557377049180328	GO:0035825	GO:BP	homologous recombination	16175	9273		1	1	61	16114	4	21	57	16093	16175	0.10028186120742445
M1	cpdb	0	network_modules	176	TRUE	0.006140183975953195	86	21	4	0.19047619047619047	0.046511627906976744	REAC:R-HSA-912446	REAC	Meiotic recombination	10916	1411		0.75	0.8	86	10830	4	17	82	10813	10916	0.09067587498965846
M1	cpdb	0	network_modules	176	TRUE	0.006677556473919444	4	21	2	0.09523809523809523	0.5	REAC:R-HSA-8866906	REAC	TFAP2 (AP-2) family regulates transcription of other transcription factors	10916	2426		1	1	4	10912	2	19	2	10893	10916	0.21762755623977673
M1	cpdb	0	network_modules	177	TRUE	6.234303747048373e-29	55	27	16	0.5925925925925926	0.2909090909090909	REAC:R-HSA-75893	REAC	TNF signaling	10916	2446		0	0.010638297872340425	55	10861	16	11	39	10850	10916	0.4132216164651894
M1	cpdb	0	network_modules	177	TRUE	9.791458921612681e-28	46	27	15	0.5555555555555556	0.32608695652173914	REAC:R-HSA-5357905	REAC	Regulation of TNFR1 signaling	10916	2011		0.010752688172043012	0.02127659574468085	46	10870	15	12	31	10858	10916	0.42381707637097954
M1	cpdb	0	network_modules	177	TRUE	7.132253509740323e-26	252	27	19	0.7037037037037037	0.07539682539682539	GO:0043122	GO:BP	regulation of canonical NF-kappaB signal transduction	16175	10541		0	0.010638297872340425	252	15923	19	8	233	15915	16175	0.22720655402063614
M1	cpdb	0	network_modules	177	TRUE	2.1090947409981993e-25	153	27	18	0.6666666666666666	0.11764705882352941	REAC:R-HSA-73887	REAC	Death Receptor Signaling	10916	455		0.021505376344086023	0.031914893617021274	153	10763	18	9	135	10754	10916	0.27645199520398195
M1	cpdb	0	network_modules	177	TRUE	5.594108336450779e-25	280	27	19	0.7037037037037037	0.06785714285714285	GO:0007249	GO:BP	canonical NF-kappaB signal transduction	16175	2783		0.010752688172043012	0.02127659574468085	280	15895	19	8	261	15887	16175	0.21519411474525046
M1	cpdb	0	network_modules	177	TRUE	7.221188646187207e-25	33	27	13	0.48148148148148145	0.3939393939393939	REAC:R-HSA-5357956	REAC	TNFR1-induced NF-kappa-B signaling pathway	10916	2447		0.03225806451612903	0.0425531914893617	33	10883	13	14	20	10869	10916	0.43397459420734746
M1	cpdb	0	network_modules	177	TRUE	4.797823837082281e-24	25	27	12	0.4444444444444444	0.48	REAC:R-HSA-5357786	REAC	TNFR1-induced proapoptotic signaling	10916	2448		0.043010752688172046	0.05319148936170213	25	10891	12	15	13	10876	10916	0.4605972166954403
M1	cpdb	0	network_modules	177	TRUE	1.0663460937184962e-23	192	27	17	0.6296296296296297	0.08854166666666667	GO:0043123	GO:BP	positive regulation of canonical NF-kappaB signal transduction	16175	10542		0.021505376344086023	0.031914893617021274	192	15983	17	10	175	15973	16175	0.2332418306141324
M1	cpdb	0	network_modules	177	TRUE	9.859188505278544e-23	84	27	14	0.5185185185185185	0.16666666666666666	GO:0033209	GO:BP	tumor necrosis factor-mediated signaling pathway	16175	8075		0.03225806451612903	0.0425531914893617	84	16091	14	13	70	16078	16175	0.2920305769242664
M1	cpdb	0	network_modules	177	TRUE	2.397614720872121e-22	113	27	16	0.5925925925925926	0.1415929203539823	KEGG:04668	KEGG	TNF signaling pathway	8484	342		0	0.023255813953488372	113	8371	16	11	97	8360	8484	0.2855157516608964
M1	cpdb	0	network_modules	177	TRUE	5.140753994177502e-22	180	27	16	0.5925925925925926	0.08888888888888889	GO:0034612	GO:BP	response to tumor necrosis factor	16175	8690		0.043010752688172046	0.05319148936170213	180	15995	16	11	164	15984	16175	0.2266530084799485
M1	cpdb	0	network_modules	177	TRUE	7.363314735932187e-22	103	27	15	0.5555555555555556	0.14563106796116504	REAC:R-HSA-168164	REAC	Toll Like Receptor 3 (TLR3) Cascade	10916	2515		0.053763440860215055	0.06382978723404255	103	10813	15	12	88	10801	10916	0.28128571056883234
M1	cpdb	0	network_modules	177	TRUE	1.3543062497111788e-21	107	27	15	0.5555555555555556	0.14018691588785046	REAC:R-HSA-166166	REAC	MyD88-independent TLR4 cascade 	10916	1501		0.06451612903225806	0.0851063829787234	107	10809	15	12	92	10797	10916	0.27584380634593625
M1	cpdb	0	network_modules	177	TRUE	1.3543062497111788e-21	107	27	15	0.5555555555555556	0.14018691588785046	REAC:R-HSA-937061	REAC	TRIF (TICAM1)-mediated TLR4 signaling 	10916	2471		0.06451612903225806	0.0851063829787234	107	10809	15	12	92	10797	10916	0.27584380634593625
M1	cpdb	0	network_modules	177	TRUE	9.017034826481253e-21	182	27	17	0.6296296296296297	0.09340659340659341	KEGG:04621	KEGG	NOD-like receptor signaling pathway	8484	326		0.023809523809523808	0.046511627906976744	182	8302	17	10	165	8292	8484	0.23717977679895894
M1	cpdb	0	network_modules	177	TRUE	1.566382956815361e-20	164	27	15	0.5555555555555556	0.09146341463414634	GO:0071356	GO:BP	cellular response to tumor necrosis factor	16175	16608		0.053763440860215055	0.06382978723404255	164	16011	15	12	149	15999	16175	0.2226198481467063
M1	cpdb	0	network_modules	177	TRUE	1.3222401240235742e-19	143	27	15	0.5555555555555556	0.1048951048951049	REAC:R-HSA-166016	REAC	Toll Like Receptor 4 (TLR4) Cascade	10916	2516		0.08602150537634409	0.09574468085106383	143	10773	15	12	128	10761	10916	0.23756321473044992
M1	cpdb	0	network_modules	177	TRUE	1.1169101024096867e-18	164	27	15	0.5555555555555556	0.09146341463414634	REAC:R-HSA-168898	REAC	Toll-like Receptor Cascades	10916	2522		0.0967741935483871	0.10638297872340426	164	10752	15	12	149	10740	10916	0.2212616042590745
M1	cpdb	0	network_modules	177	TRUE	2.7850011249072263e-18	198	27	16	0.5925925925925926	0.08080808080808081	KEGG:05169	KEGG	Epstein-Barr virus infection	8484	450		0.047619047619047616	0.06976744186046512	198	8286	16	11	182	8275	8484	0.21304719636795905
M1	cpdb	0	network_modules	177	TRUE	2.833986543482378e-18	625	27	19	0.7037037037037037	0.0304	GO:0034097	GO:BP	response to cytokine	16175	8408		0.06451612903225806	0.0851063829787234	625	15550	19	8	606	15542	16175	0.14109932072980766
M1	cpdb	0	network_modules	177	TRUE	2.833986543482378e-18	625	27	19	0.7037037037037037	0.0304	GO:1901652	GO:BP	response to peptide	16175	21619		0.06451612903225806	0.0851063829787234	625	15550	19	8	606	15542	16175	0.14109932072980766
M1	cpdb	0	network_modules	177	TRUE	8.031571734991694e-18	419	27	17	0.6296296296296297	0.0405727923627685	GO:0019221	GO:BP	cytokine-mediated signaling pathway	16175	5598		0.08602150537634409	0.09574468085106383	419	15756	17	10	402	15746	16175	0.15540904514362402
M1	cpdb	0	network_modules	177	TRUE	4.450086351865595e-17	71	27	12	0.4444444444444444	0.16901408450704225	KEGG:04622	KEGG	RIG-I-like receptor signaling pathway	8484	327		0.07142857142857142	0.09302325581395349	71	8413	12	15	59	8398	8484	0.2704778431689911
M1	cpdb	0	network_modules	177	TRUE	5.5274414916938465e-17	102	27	13	0.48148148148148145	0.12745098039215685	KEGG:04064	KEGG	NF-kappa B signaling pathway	8484	256		0.09523809523809523	0.11627906976744186	102	8382	13	14	89	8368	8484	0.2433873452596629
M1	cpdb	0	network_modules	177	TRUE	7.107975043147779e-17	82	27	12	0.4444444444444444	0.14634146341463414	REAC:R-HSA-168928	REAC	DDX58/IFIH1-mediated induction of interferon-alpha/beta	10916	436		0.10752688172043011	0.11702127659574468	82	10834	12	15	70	10819	10916	0.2519790609713505
M1	cpdb	0	network_modules	177	TRUE	1.0047117483675496e-16	36	27	10	0.37037037037037035	0.2777777777777778	REAC:R-HSA-168638	REAC	NOD1/2 Signaling Pathway	10916	1529		0.11827956989247312	0.1276595744680851	36	10880	10	17	26	10863	10916	0.31881409476936456
M1	cpdb	0	network_modules	177	TRUE	1.1647646393039407e-16	249	27	16	0.5925925925925926	0.0642570281124498	KEGG:05132	KEGG	Salmonella infection	8484	429		0.11904761904761904	0.13953488372093023	249	8235	16	11	233	8224	8484	0.18855535935325904
M1	cpdb	0	network_modules	177	TRUE	3.4591750623571917e-16	654	27	18	0.6666666666666666	0.027522935779816515	GO:0031347	GO:BP	regulation of defense response	16175	7138		0.0967741935483871	0.10638297872340426	654	15521	18	9	636	15512	16175	0.13000338218160087
M1	cpdb	0	network_modules	177	TRUE	3.485673629718331e-16	158	27	14	0.5185185185185185	0.08860759493670886	KEGG:05160	KEGG	Hepatitis C	8484	441		0.14285714285714285	0.16279069767441862	158	8326	14	13	144	8313	8484	0.2089327981077327
M1	cpdb	0	network_modules	177	TRUE	5.50797644484e-16	214	27	15	0.5555555555555556	0.07009345794392523	KEGG:05417	KEGG	Lipid and atherosclerosis	8484	494		0.16666666666666666	0.18604651162790697	214	8270	15	12	199	8258	8484	0.19110068527864543
M1	cpdb	0	network_modules	177	TRUE	9.55043921450625e-16	555	27	17	0.6296296296296297	0.03063063063063063	GO:0071345	GO:BP	cellular response to cytokine stimulus	16175	16597		0.10752688172043011	0.11702127659574468	555	15620	17	10	538	15610	16175	0.13372985854828198
M1	cpdb	0	network_modules	177	TRUE	1.2182734865654765e-15	92	27	12	0.4444444444444444	0.13043478260869565	KEGG:04657	KEGG	IL-17 signaling pathway	8484	335		0.19047619047619047	0.20930232558139536	92	8392	12	15	80	8377	8484	0.23655792529639097
M1	cpdb	0	network_modules	177	TRUE	2.4565857510894484e-15	135	27	13	0.48148148148148145	0.0962962962962963	KEGG:04210	KEGG	Apoptosis	8484	287		0.21428571428571427	0.23255813953488372	135	8349	13	14	122	8335	8484	0.21022021746977576
M1	cpdb	0	network_modules	177	TRUE	3.008223677466866e-15	594	27	17	0.6296296296296297	0.02861952861952862	GO:0006954	GO:BP	inflammatory response	16175	2585		0.11827956989247312	0.1276595744680851	594	15581	17	10	577	15571	16175	0.1289026878647979
M1	cpdb	0	network_modules	177	TRUE	3.297670101525322e-15	138	27	13	0.48148148148148145	0.09420289855072464	KEGG:05162	KEGG	Measles	8484	443		0.23809523809523808	0.2558139534883721	138	8346	13	14	125	8332	8484	0.20780207692249733
M1	cpdb	0	network_modules	177	TRUE	4.8325973450107626e-15	142	27	13	0.48148148148148145	0.09154929577464789	KEGG:04936	KEGG	Alcoholic liver disease	8484	393		0.2619047619047619	0.27906976744186046	142	8342	13	14	129	8328	8484	0.204695827723109
M1	cpdb	0	network_modules	177	TRUE	8.149511813591485e-15	197	27	14	0.5185185185185185	0.07106598984771574	KEGG:05130	KEGG	Pathogenic Escherichia coli infection	8484	427		0.2857142857142857	0.3023255813953488	197	8287	14	13	183	8274	8484	0.18582727826163342
M1	cpdb	0	network_modules	177	TRUE	1.0601157690726451e-14	19	27	8	0.2962962962962963	0.42105263157894735	REAC:R-HSA-168927	REAC	TICAM1, RIP1-mediated IKK complex recruitment	10916	2440		0.12903225806451613	0.13829787234042554	19	10897	8	19	11	10878	10916	0.35187516243242095
M1	cpdb	0	network_modules	177	TRUE	1.1252867310813449e-14	55	27	10	0.37037037037037035	0.18181818181818182	REAC:R-HSA-168643	REAC	Nucleotide-binding domain, leucine rich repeat containing receptor (NLR) signaling pathways	10916	1628		0.13978494623655913	0.14893617021276595	55	10861	10	17	45	10844	10916	0.2569346920263166
M1	cpdb	0	network_modules	177	TRUE	2.0156548960726035e-14	210	27	14	0.5185185185185185	0.06666666666666667	KEGG:05170	KEGG	Human immunodeficiency virus 1 infection	8484	451		0.30952380952380953	0.32558139534883723	210	8274	14	13	196	8261	8484	0.17956768791836253
M1	cpdb	0	network_modules	177	TRUE	2.919838394261397e-14	423	27	15	0.5555555555555556	0.03546099290780142	GO:0031349	GO:BP	positive regulation of defense response	16175	7140		0.12903225806451613	0.13829787234042554	423	15752	15	12	408	15740	16175	0.1356488310919971
M1	cpdb	0	network_modules	177	TRUE	4.464288780599008e-14	22	27	8	0.2962962962962963	0.36363636363636365	REAC:R-HSA-937041	REAC	IKK complex recruitment mediated by RIP1	10916	1145		0.15053763440860216	0.1595744680851064	22	10894	8	19	14	10875	10916	0.32674463755684513
M1	cpdb	0	network_modules	177	TRUE	1.8715492366698451e-13	246	27	14	0.5185185185185185	0.056910569105691054	KEGG:05131	KEGG	Shigellosis	8484	428		0.3333333333333333	0.3488372093023256	246	8238	14	13	232	8225	8484	0.16484235852326357
M1	cpdb	0	network_modules	177	TRUE	5.9086996633161e-13	108	27	11	0.4074074074074074	0.10185185185185185	KEGG:05145	KEGG	Toxoplasmosis	8484	437		0.35714285714285715	0.37209302325581395	108	8376	11	16	97	8360	8484	0.1989237338519651
M1	cpdb	0	network_modules	177	TRUE	8.620582111852084e-13	531	27	15	0.5555555555555556	0.02824858757062147	GO:0032103	GO:BP	positive regulation of response to external stimulus	16175	7367		0.13978494623655913	0.14893617021276595	531	15644	15	12	516	15632	16175	0.11995563848635592
M1	cpdb	0	network_modules	177	TRUE	1.895199565983172e-12	82	27	10	0.37037037037037035	0.12195121951219512	KEGG:04623	KEGG	Cytosolic DNA-sensing pathway	8484	328		0.38095238095238093	0.3953488372093023	82	8402	10	17	72	8385	8484	0.2083187766500266
M1	cpdb	0	network_modules	177	TRUE	2.6588154529148253e-12	721	27	16	0.5925925925925926	0.022191400832177532	GO:0045087	GO:BP	innate immune response	16175	11270		0.15053763440860216	0.1595744680851064	721	15454	16	11	705	15443	16175	0.1085858526447703
M1	cpdb	0	network_modules	177	TRUE	5.588735704006093e-12	756	27	16	0.5925925925925926	0.021164021164021163	GO:0050776	GO:BP	regulation of immune response	16175	13250		0.16129032258064516	0.1702127659574468	756	15419	16	11	740	15408	16175	0.10574361069635574
M1	cpdb	0	network_modules	177	TRUE	1.188931051391466e-11	194	27	12	0.4444444444444444	0.061855670103092786	KEGG:05167	KEGG	Kaposi sarcoma-associated herpesvirus infection	8484	448		0.40476190476190477	0.4186046511627907	194	8290	12	15	182	8275	8484	0.15935806723263807
M1	cpdb	0	network_modules	177	TRUE	2.391281116727619e-11	44	27	8	0.2962962962962963	0.18181818181818182	REAC:R-HSA-445989	REAC	TAK1-dependent IKK and NF-kappa-B activation  	10916	2417		0.16129032258064516	0.1702127659574468	44	10872	8	19	36	10853	10916	0.2296930879360816
M1	cpdb	0	network_modules	177	TRUE	2.700035630284665e-11	106	27	10	0.37037037037037035	0.09433962264150944	KEGG:04620	KEGG	Toll-like receptor signaling pathway	8484	325		0.42857142857142855	0.4418604651162791	106	8378	10	17	96	8361	8484	0.18204726585244077
M1	cpdb	0	network_modules	177	TRUE	4.217484916673814e-11	158	27	11	0.4074074074074074	0.06962025316455696	KEGG:04217	KEGG	Necroptosis	8484	294		0.4523809523809524	0.46511627906976744	158	8326	11	16	147	8310	8484	0.16249355631716408
M1	cpdb	0	network_modules	177	TRUE	7.786664034078577e-11	167	27	11	0.4074074074074074	0.0658682634730539	KEGG:05164	KEGG	Influenza A	8484	445		0.47619047619047616	0.4883720930232558	167	8317	11	16	156	8301	8484	0.15770834942849826
M1	cpdb	0	network_modules	177	TRUE	1.9689533755060293e-10	31	27	7	0.25925925925925924	0.22580645161290322	REAC:R-HSA-5675482	REAC	Regulation of necroptotic cell death	10916	2045		0.17204301075268819	0.19148936170212766	31	10885	7	20	24	10865	10916	0.2399425175334911
M1	cpdb	0	network_modules	177	TRUE	1.9689533755060293e-10	31	27	7	0.25925925925925924	0.22580645161290322	REAC:R-HSA-5213460	REAC	RIPK1-mediated regulated necrosis	10916	1877		0.17204301075268819	0.19148936170212766	31	10885	7	20	24	10865	10916	0.2399425175334911
M1	cpdb	0	network_modules	177	TRUE	2.5305603032593496e-10	58	27	8	0.2962962962962963	0.13793103448275862	REAC:R-HSA-5218859	REAC	Regulated Necrosis	10916	1959		0.1935483870967742	0.20212765957446807	58	10858	8	19	50	10839	10916	0.19931046571917468
M1	cpdb	0	network_modules	177	TRUE	2.5341256007118415e-10	472	27	14	0.5185185185185185	0.029661016949152543	REAC:R-HSA-449147	REAC	Signaling by Interleukins	10916	2261		0.20430107526881722	0.2127659574468085	472	10444	14	13	458	10431	10916	0.11635788569254352
M1	cpdb	0	network_modules	177	TRUE	2.8761500170901485e-10	32	27	7	0.25925925925925924	0.21875	KEGG:04215	KEGG	Apoptosis - multiple species	8484	292		0.5	0.5116279069767442	32	8452	7	20	25	8432	8484	0.23549908328567767
M1	cpdb	0	network_modules	177	TRUE	2.9487086559335393e-10	627	27	14	0.5185185185185185	0.022328548644338118	GO:0050778	GO:BP	positive regulation of immune response	16175	13252		0.17204301075268819	0.18085106382978725	627	15548	14	13	613	15535	16175	0.10162844238234513
M1	cpdb	0	network_modules	177	TRUE	3.4314634221627296e-10	634	27	14	0.5185185185185185	0.022082018927444796	GO:0001817	GO:BP	regulation of cytokine production	16175	474		0.1827956989247312	0.19148936170212766	634	15541	14	13	620	15528	16175	0.10099741567648145
M1	cpdb	0	network_modules	177	TRUE	3.5253495740807106e-10	92	27	9	0.3333333333333333	0.09782608695652174	KEGG:05222	KEGG	Small cell lung cancer	8484	473		0.5238095238095238	0.5348837209302325	92	8392	9	18	83	8374	8484	0.17593942106132449
M1	cpdb	0	network_modules	177	TRUE	3.739084279571357e-10	638	27	14	0.5185185185185185	0.0219435736677116	GO:0001816	GO:BP	cytokine production	16175	473		0.1935483870967742	0.20212765957446807	638	15537	14	13	624	15524	16175	0.1006413204224833
M1	cpdb	0	network_modules	177	TRUE	4.442087968965949e-10	124	27	9	0.3333333333333333	0.07258064516129033	GO:0051092	GO:BP	positive regulation of NF-kappaB transcription factor activity	16175	13487		0.20430107526881722	0.2127659574468085	124	16051	9	18	115	16033	16175	0.15267885950034357
M1	cpdb	0	network_modules	177	TRUE	5.663325595171116e-10	386	27	12	0.4444444444444444	0.031088082901554404	GO:0045088	GO:BP	regulation of innate immune response	16175	11271		0.21505376344086022	0.22340425531914893	386	15789	12	15	374	15774	16175	0.11267950350984021
M1	cpdb	0	network_modules	177	TRUE	7.358071093974655e-10	18	27	6	0.2222222222222222	0.3333333333333333	REAC:R-HSA-9758274	REAC	Regulation of NF-kappa B signaling	10916	1992		0.21505376344086022	0.22340425531914893	18	10898	6	21	12	10877	10916	0.2707039735980809
M1	cpdb	0	network_modules	177	TRUE	1.0846795637954743e-9	208	27	10	0.37037037037037035	0.04807692307692308	GO:0051091	GO:BP	positive regulation of DNA-binding transcription factor activity	16175	13486		0.22580645161290322	0.23404255319148937	208	15967	10	17	198	15950	16175	0.1297516542335628
M1	cpdb	0	network_modules	177	TRUE	1.3715345752632239e-9	416	27	12	0.4444444444444444	0.028846153846153848	GO:0002757	GO:BP	immune response-activating signaling pathway	16175	1268		0.23655913978494625	0.24468085106382978	416	15759	12	15	404	15744	16175	0.10816467995028899
M1	cpdb	0	network_modules	177	TRUE	1.8502121203360265e-9	223	27	11	0.4074074074074074	0.04932735426008968	KEGG:05163	KEGG	Human cytomegalovirus infection	8484	444		0.5476190476190477	0.5581395348837209	223	8261	11	16	212	8245	8484	0.13460784691949682
M1	cpdb	0	network_modules	177	TRUE	1.9752566864148776e-9	162	27	10	0.37037037037037035	0.06172839506172839	KEGG:05161	KEGG	Hepatitis B	8484	442		0.5714285714285714	0.5813953488372093	162	8322	10	17	152	8305	8484	0.14502771435508197
M1	cpdb	0	network_modules	177	TRUE	2.140186358291353e-9	21	27	6	0.2222222222222222	0.2857142857142857	REAC:R-HSA-1606322	REAC	ZBP1(DAI) mediated induction of type I IFNs	10916	2680		0.22580645161290322	0.23404255319148937	21	10895	6	21	15	10874	10916	0.2503453727392346
M1	cpdb	0	network_modules	177	TRUE	2.201985265492122e-9	120	27	9	0.3333333333333333	0.075	REAC:R-HSA-9705671	REAC	SARS-CoV-2 activates/modulates innate and adaptive immune responses	10916	2123		0.23655913978494625	0.24468085106382978	120	10796	9	18	111	10778	10916	0.15393732981074237
M1	cpdb	0	network_modules	177	TRUE	2.2741584735316534e-9	319	27	11	0.4074074074074074	0.034482758620689655	GO:0045089	GO:BP	positive regulation of innate immune response	16175	11272		0.24731182795698925	0.2553191489361702	319	15856	11	16	308	15840	16175	0.11401298791911474
M1	cpdb	0	network_modules	177	TRUE	2.3801465097921095e-9	149	27	9	0.3333333333333333	0.06040268456375839	GO:0002753	GO:BP	cytoplasmic pattern recognition receptor signaling pathway	16175	1264		0.25806451612903225	0.26595744680851063	149	16026	9	18	140	16008	16175	0.13872957444392944
M1	cpdb	0	network_modules	177	TRUE	2.4504578756208507e-9	437	27	12	0.4444444444444444	0.02745995423340961	GO:0002764	GO:BP	immune response-regulating signaling pathway	16175	1275		0.26881720430107525	0.2765957446808511	437	15738	12	15	425	15723	16175	0.10527671125540505
M1	cpdb	0	network_modules	177	TRUE	2.6004911289254877e-9	227	27	10	0.37037037037037035	0.04405286343612335	GO:0002221	GO:BP	pattern recognition receptor signaling pathway	16175	755		0.27956989247311825	0.2872340425531915	227	15948	10	17	217	15931	16175	0.12386850818010146
M1	cpdb	0	network_modules	177	TRUE	3.5508286984440677e-9	451	27	12	0.4444444444444444	0.026607538802660754	GO:0002831	GO:BP	regulation of response to biotic stimulus	16175	1341		0.2903225806451613	0.2978723404255319	451	15724	12	15	439	15709	16175	0.10346097532300383
M1	cpdb	0	network_modules	177	TRUE	3.74767329099747e-9	334	27	11	0.4074074074074074	0.03293413173652695	GO:0009615	GO:BP	response to virus	16175	3541		0.3010752688172043	0.30851063829787234	334	15841	11	16	323	15825	16175	0.1112094942079408
M1	cpdb	0	network_modules	177	TRUE	4.4037271363978726e-9	339	27	11	0.4074074074074074	0.032448377581120944	GO:0002833	GO:BP	positive regulation of response to biotic stimulus	16175	1343		0.3118279569892473	0.3191489361702128	339	15836	11	16	328	15820	16175	0.1103155028210698
M1	cpdb	0	network_modules	177	TRUE	5.128215583557017e-9	243	27	10	0.37037037037037035	0.0411522633744856	GO:0002758	GO:BP	innate immune response-activating signaling pathway	16175	1269		0.3225806451612903	0.32978723404255317	243	15932	10	17	233	15915	16175	0.1194486914720089
M1	cpdb	0	network_modules	177	TRUE	5.326957143479681e-9	345	27	11	0.4074074074074074	0.03188405797101449	GO:0051090	GO:BP	regulation of DNA-binding transcription factor activity	16175	13485		0.3333333333333333	0.3404255319148936	345	15830	11	16	334	15814	16175	0.10926776777107247
M1	cpdb	0	network_modules	177	TRUE	6.419585521990258e-9	330	27	12	0.4444444444444444	0.03636363636363636	KEGG:05165	KEGG	Human papillomavirus infection	8484	446		0.5952380952380952	0.6046511627906976	330	8154	12	15	318	8139	8484	0.11851518350534115
M1	cpdb	0	network_modules	177	TRUE	6.526079114852199e-9	475	27	12	0.4444444444444444	0.02526315789473684	GO:0002253	GO:BP	activation of immune response	16175	785		0.34408602150537637	0.35106382978723405	475	15700	12	15	463	15685	16175	0.100531006423987
M1	cpdb	0	network_modules	177	TRUE	1.0364541705265484e-8	208	27	10	0.37037037037037035	0.04807692307692308	REAC:R-HSA-5357801	REAC	Programmed Cell Death	10916	1803		0.24731182795698925	0.2553191489361702	208	10708	10	17	198	10691	10916	0.12795675224714037
M1	cpdb	0	network_modules	177	TRUE	1.1254539609567622e-8	263	27	10	0.37037037037037035	0.03802281368821293	GO:0002218	GO:BP	activation of innate immune response	16175	753		0.3548387096774194	0.3617021276595745	263	15912	10	17	253	15895	16175	0.11448948566402699
M1	cpdb	0	network_modules	177	TRUE	1.2475558785317343e-8	136	27	9	0.3333333333333333	0.0661764705882353	KEGG:05135	KEGG	Yersinia infection	8484	432		0.6190476190476191	0.627906976744186	136	8348	9	18	127	8330	8484	0.14275393814926435
M1	cpdb	0	network_modules	177	TRUE	1.514931653076311e-8	95	27	8	0.2962962962962963	0.08421052631578947	REAC:R-HSA-168176	REAC	Toll Like Receptor 5 (TLR5) Cascade	10916	2517		0.25806451612903225	0.2872340425531915	95	10821	8	19	87	10802	10916	0.15418244808938447
M1	cpdb	0	network_modules	177	TRUE	1.514931653076311e-8	95	27	8	0.2962962962962963	0.08421052631578947	REAC:R-HSA-168142	REAC	Toll Like Receptor 10 (TLR10) Cascade	10916	2513		0.25806451612903225	0.2872340425531915	95	10821	8	19	87	10802	10916	0.15418244808938447
M1	cpdb	0	network_modules	177	TRUE	1.514931653076311e-8	95	27	8	0.2962962962962963	0.08421052631578947	REAC:R-HSA-975871	REAC	MyD88 cascade initiated on plasma membrane	10916	1497		0.25806451612903225	0.2872340425531915	95	10821	8	19	87	10802	10916	0.15418244808938447
M1	cpdb	0	network_modules	177	TRUE	1.7730855242878084e-8	151	27	9	0.3333333333333333	0.059602649006622516	REAC:R-HSA-446652	REAC	Interleukin-1 family signaling	10916	1231		0.2903225806451613	0.2978723404255319	151	10765	9	18	142	10747	10916	0.13621576163571736
M1	cpdb	0	network_modules	177	TRUE	2.3072891963299078e-8	30	27	6	0.2222222222222222	0.2	REAC:R-HSA-933541	REAC	TRAF6 mediated IRF7 activation	10916	2465		0.3010752688172043	0.30851063829787234	30	10886	6	21	24	10865	10916	0.208756315516789
M1	cpdb	0	network_modules	177	TRUE	2.4953462989064203e-8	101	27	8	0.2962962962962963	0.07920792079207921	REAC:R-HSA-975138	REAC	TRAF6 mediated induction of NFkB and MAP kinases upon TLR7/8 or 9 activation	10916	2468		0.3118279569892473	0.3191489361702128	101	10815	8	19	93	10796	10916	0.14928826361551903
M1	cpdb	0	network_modules	177	TRUE	2.5461094200949235e-8	13	27	5	0.18518518518518517	0.38461538461538464	REAC:R-HSA-933543	REAC	NF-kB activation through FADD/RIP-1 pathway mediated by caspase-8 and -10	10916	1515		0.3225806451612903	0.32978723404255317	13	10903	5	22	8	10881	10916	0.2656507416993543
M1	cpdb	0	network_modules	177	TRUE	2.7034992223151006e-8	102	27	8	0.2962962962962963	0.0784313725490196	REAC:R-HSA-975155	REAC	MyD88 dependent cascade initiated on endosome	10916	1500		0.3333333333333333	0.3404255319148936	102	10814	8	19	94	10795	10916	0.14851411169066586
M1	cpdb	0	network_modules	177	TRUE	2.8555389033730392e-8	403	27	11	0.4074074074074074	0.02729528535980149	GO:0001819	GO:BP	positive regulation of cytokine production	16175	476		0.3655913978494624	0.3723404255319149	403	15772	11	16	392	15756	16175	0.10034453418761648
M1	cpdb	0	network_modules	177	TRUE	2.9265970608247063e-8	103	27	8	0.2962962962962963	0.07766990291262135	REAC:R-HSA-168181	REAC	Toll Like Receptor 7/8 (TLR7/8) Cascade	10916	2518		0.34408602150537637	0.35106382978723405	103	10813	8	19	95	10794	10916	0.14775106065186208
M1	cpdb	0	network_modules	177	TRUE	3.6948033508271055e-8	106	27	8	0.2962962962962963	0.07547169811320754	REAC:R-HSA-168138	REAC	Toll Like Receptor 9 (TLR9) Cascade	10916	2519		0.3548387096774194	0.3617021276595745	106	10810	8	19	98	10791	10916	0.14552589116676995
M1	cpdb	0	network_modules	177	TRUE	3.9539581683653345e-8	14	27	5	0.18518518518518517	0.35714285714285715	REAC:R-HSA-975144	REAC	IRAK1 recruits IKK complex upon TLR7/8 or 9 stimulation	10916	1155		0.3655913978494624	0.3829787234042553	14	10902	5	22	9	10880	10916	0.25587174102319055
M1	cpdb	0	network_modules	177	TRUE	3.9539581683653345e-8	14	27	5	0.18518518518518517	0.35714285714285715	REAC:R-HSA-937039	REAC	IRAK1 recruits IKK complex	10916	1154		0.3655913978494624	0.3829787234042553	14	10902	5	22	9	10880	10916	0.25587174102319055
M1	cpdb	0	network_modules	177	TRUE	4.003901698532867e-8	299	27	10	0.37037037037037035	0.033444816053511704	GO:0050727	GO:BP	regulation of inflammatory response	16175	13226		0.3763440860215054	0.3829787234042553	299	15876	10	17	289	15859	16175	0.1068221911788584
M1	cpdb	0	network_modules	177	TRUE	5.7712311220701976e-8	112	27	8	0.2962962962962963	0.07142857142857142	REAC:R-HSA-166058	REAC	MyD88:MAL(TIRAP) cascade initiated on plasma membrane	10916	1502		0.3870967741935484	0.40425531914893614	112	10804	8	19	104	10785	10916	0.14134192476560759
M1	cpdb	0	network_modules	177	TRUE	5.7712311220701976e-8	112	27	8	0.2962962962962963	0.07142857142857142	REAC:R-HSA-168188	REAC	Toll Like Receptor TLR6:TLR2 Cascade	10916	2521		0.3870967741935484	0.40425531914893614	112	10804	8	19	104	10785	10916	0.14134192476560759
M1	cpdb	0	network_modules	177	TRUE	6.201264421799798e-8	113	27	8	0.2962962962962963	0.07079646017699115	REAC:R-HSA-9020702	REAC	Interleukin-1 signaling	10916	1233		0.40860215053763443	0.4148936170212766	113	10803	8	19	105	10784	10916	0.14067657199900319
M1	cpdb	0	network_modules	177	TRUE	6.579842802789373e-8	231	27	10	0.37037037037037035	0.04329004329004329	KEGG:05171	KEGG	Coronavirus disease - COVID-19	8484	452		0.6428571428571429	0.6511627906976745	231	8253	10	17	221	8236	8484	0.11913439453040851
M1	cpdb	0	network_modules	177	TRUE	7.022365562444726e-8	176	27	9	0.3333333333333333	0.05113636363636364	REAC:R-HSA-109581	REAC	Apoptosis	10916	158		0.41935483870967744	0.425531914893617	176	10740	9	18	167	10722	10916	0.12541228907184906
M1	cpdb	0	network_modules	177	TRUE	7.14559584116391e-8	115	27	8	0.2962962962962963	0.06956521739130435	REAC:R-HSA-168179	REAC	Toll Like Receptor TLR1:TLR2 Cascade	10916	2520		0.43010752688172044	0.44680851063829785	115	10801	8	19	107	10782	10916	0.1393714834424966
M1	cpdb	0	network_modules	177	TRUE	7.14559584116391e-8	115	27	8	0.2962962962962963	0.06956521739130435	REAC:R-HSA-181438	REAC	Toll Like Receptor 2 (TLR2) Cascade	10916	2514		0.43010752688172044	0.44680851063829785	115	10801	8	19	107	10782	10916	0.1393714834424966
M1	cpdb	0	network_modules	177	TRUE	9.467653754277646e-8	70	27	7	0.25925925925925924	0.1	KEGG:04920	KEGG	Adipocytokine signaling pathway	8484	377		0.6666666666666666	0.6744186046511628	70	8414	7	20	63	8394	8484	0.15678785452985947
M1	cpdb	0	network_modules	177	TRUE	1.9191675878705288e-7	197	27	9	0.3333333333333333	0.04568527918781726	REAC:R-HSA-9705683	REAC	SARS-CoV-2-host interactions	10916	2128		0.45161290322580644	0.4574468085106383	197	10719	9	18	188	10701	10916	0.11793601259682832
M1	cpdb	0	network_modules	177	TRUE	3.312742119104636e-7	7	27	4	0.14814814814814814	0.5714285714285714	REAC:R-HSA-9693928	REAC	Defective RIPK1-mediated regulated necrosis	10916	613		0.46236559139784944	0.46808510638297873	7	10909	4	23	3	10886	10916	0.2901497620963268
M1	cpdb	0	network_modules	177	TRUE	4.026863620357921e-7	102	27	7	0.25925925925925924	0.06862745098039216	GO:0038061	GO:BP	non-canonical NF-kappaB signal transduction	16175	9680		0.3870967741935484	0.39361702127659576	102	16073	7	20	95	16053	16175	0.1306647598620728
M1	cpdb	0	network_modules	177	TRUE	8.532850890854411e-7	301	27	10	0.37037037037037035	0.03322259136212625	KEGG:04010	KEGG	MAPK signaling pathway	8484	243		0.6904761904761905	0.6976744186046512	301	8183	10	17	291	8166	8484	0.10229146444532125
M1	cpdb	0	network_modules	177	TRUE	8.648931710577154e-7	97	27	7	0.25925925925925924	0.07216494845360824	REAC:R-HSA-5607764	REAC	CLEC7A (Dectin-1) signaling	10916	275		0.4731182795698925	0.4787234042553192	97	10819	7	20	90	10799	10916	0.13284947977995548
M1	cpdb	0	network_modules	177	TRUE	1.0300792550419316e-6	25	27	5	0.18518518518518517	0.2	REAC:R-HSA-5357769	REAC	Caspase activation via extrinsic apoptotic signalling pathway	10916	315		0.4838709677419355	0.5	25	10891	5	22	20	10869	10916	0.19052382241739535
M1	cpdb	0	network_modules	177	TRUE	1.0300792550419316e-6	25	27	5	0.18518518518518517	0.2	REAC:R-HSA-933542	REAC	TRAF6 mediated NF-kB activation	10916	2467		0.4838709677419355	0.5	25	10891	5	22	20	10869	10916	0.19052382241739535
M1	cpdb	0	network_modules	177	TRUE	1.3348258682880062e-6	302	27	9	0.3333333333333333	0.029801324503311258	GO:0030522	GO:BP	intracellular receptor signaling pathway	16175	6836		0.3978494623655914	0.40425531914893614	302	15873	9	18	293	15855	16175	0.09505585498518143
M1	cpdb	0	network_modules	177	TRUE	1.5816551477269786e-6	66	27	6	0.2222222222222222	0.09090909090909091	GO:0032481	GO:BP	positive regulation of type I interferon production	16175	7592		0.40860215053763443	0.4148936170212766	66	16109	6	21	60	16088	16175	0.13992636010798123
M1	cpdb	0	network_modules	177	TRUE	1.977607176212533e-6	10	27	4	0.14814814814814814	0.4	REAC:R-HSA-5218900	REAC	CASP8 activity is inhibited	10916	263		0.5053763440860215	0.5319148936170213	10	10906	4	23	6	10883	10916	0.24233774199469071
M1	cpdb	0	network_modules	177	TRUE	1.977607176212533e-6	10	27	4	0.14814814814814814	0.4	REAC:R-HSA-69416	REAC	Dimerization of procaspase-8	10916	745		0.5053763440860215	0.5319148936170213	10	10906	4	23	6	10883	10916	0.24233774199469071
M1	cpdb	0	network_modules	177	TRUE	1.977607176212533e-6	10	27	4	0.14814814814814814	0.4	REAC:R-HSA-3371378	REAC	Regulation by c-FLIP	10916	1962		0.5053763440860215	0.5319148936170213	10	10906	4	23	6	10883	10916	0.24233774199469071
M1	cpdb	0	network_modules	177	TRUE	2.006064875401066e-6	10	27	4	0.14814814814814814	0.4	GO:0060546	GO:BP	negative regulation of necroptotic process	16175	14735		0.41935483870967744	0.425531914893617	10	16165	4	23	6	16142	16175	0.24269399150603854
M1	cpdb	0	network_modules	177	TRUE	2.4873426191420224e-6	132	27	7	0.25925925925925924	0.05303030303030303	GO:0001959	GO:BP	regulation of cytokine-mediated signaling pathway	16175	568		0.43010752688172044	0.43617021276595747	132	16043	7	20	125	16023	16175	0.1141251055224829
M1	cpdb	0	network_modules	177	TRUE	2.4999594164515113e-6	63	27	6	0.2222222222222222	0.09523809523809523	REAC:R-HSA-450294	REAC	MAP kinase activation	10916	1345		0.5376344086021505	0.5425531914893617	63	10853	6	21	57	10832	10916	0.14228711854091058
M1	cpdb	0	network_modules	177	TRUE	2.754012856831011e-6	64	27	6	0.2222222222222222	0.09375	REAC:R-HSA-1834949	REAC	Cytosolic sensors of pathogen-associated DNA 	10916	428		0.5483870967741935	0.5531914893617021	64	10852	6	21	58	10831	10916	0.14111787744231624
M1	cpdb	0	network_modules	177	TRUE	3.148800664334475e-6	11	27	4	0.14814814814814814	0.36363636363636365	GO:0062099	GO:BP	negative regulation of programmed necrotic cell death	16175	15820		0.44086021505376344	0.44680851063829785	11	16164	4	23	7	16141	16175	0.23130982609088233
M1	cpdb	0	network_modules	177	TRUE	3.4226435909584915e-6	632	27	11	0.4074074074074074	0.01740506329113924	GO:0031401	GO:BP	positive regulation of protein modification process	16175	7157		0.45161290322580644	0.4574468085106383	632	15543	11	16	621	15527	16175	0.07772908387659808
M1	cpdb	0	network_modules	177	TRUE	3.7966959569387456e-6	228	27	8	0.2962962962962963	0.03508771929824561	GO:0051607	GO:BP	defense response to virus	16175	13823		0.46236559139784944	0.46808510638297873	228	15947	8	19	220	15928	16175	0.09788533066511487
M1	cpdb	0	network_modules	177	TRUE	4.325649339696747e-6	3	27	3	0.1111111111111111	1	REAC:R-HSA-5603027	REAC	IKBKG deficiency causes anhidrotic ectodermal dysplasia with immunodeficiency (EDA-ID) (via TLR)	10916	1144		0.5591397849462365	0.574468085106383	3	10913	3	24	0	10889	10916	0.33296659626437475
M1	cpdb	0	network_modules	177	TRUE	4.325649339696747e-6	3	27	3	0.1111111111111111	1	REAC:R-HSA-5602636	REAC	IKBKB deficiency causes SCID	10916	1143		0.5591397849462365	0.574468085106383	3	10913	3	24	0	10889	10916	0.33296659626437475
M1	cpdb	0	network_modules	177	TRUE	4.358731716099324e-6	143	27	7	0.25925925925925924	0.04895104895104895	GO:0060759	GO:BP	regulation of response to cytokine stimulus	16175	14927		0.4731182795698925	0.4787234042553192	143	16032	7	20	136	16012	16175	0.10938839820994371
M1	cpdb	0	network_modules	177	TRUE	4.645794676860853e-6	12	27	4	0.14814814814814814	0.3333333333333333	REAC:R-HSA-9013973	REAC	TICAM1-dependent activation of IRF3/IRF7	10916	2442		0.5806451612903226	0.5957446808510638	12	10904	4	23	8	10881	10916	0.2209680492010615
M1	cpdb	0	network_modules	177	TRUE	4.645794676860853e-6	12	27	4	0.14814814814814814	0.3333333333333333	REAC:R-HSA-264870	REAC	Caspase-mediated cleavage of cytoskeletal proteins	10916	316		0.5806451612903226	0.5957446808510638	12	10904	4	23	8	10881	10916	0.2209680492010615
M1	cpdb	0	network_modules	177	TRUE	5.200200040171418e-6	71	27	6	0.2222222222222222	0.08450704225352113	REAC:R-HSA-448424	REAC	Interleukin-17 signaling	10916	1238		0.6021505376344086	0.6063829787234043	71	10845	6	21	65	10824	10916	0.1336268895290225
M1	cpdb	0	network_modules	177	TRUE	6.102468220771846e-6	292	27	9	0.3333333333333333	0.030821917808219176	REAC:R-HSA-9694516	REAC	SARS-CoV-2 Infection	10916	2122		0.6129032258064516	0.6170212765957447	292	10624	9	18	283	10606	10916	0.09461606551666539
M1	cpdb	0	network_modules	177	TRUE	7.453615890981367e-6	85	27	6	0.2222222222222222	0.07058823529411765	GO:0002220	GO:BP	innate immune response activating cell surface receptor signaling pathway	16175	754		0.4838709677419355	0.48936170212765956	85	16090	6	21	79	16069	16175	0.12270814718718494
M1	cpdb	0	network_modules	177	TRUE	8.181249852482337e-6	132	27	7	0.25925925925925924	0.05303030303030303	KEGG:04380	KEGG	Osteoclast differentiation	8484	309		0.7142857142857143	0.7209302325581395	132	8352	7	20	125	8332	8484	0.11126246983406686
M1	cpdb	0	network_modules	177	TRUE	8.20100569644777e-6	382	27	10	0.37037037037037035	0.02617801047120419	KEGG:05010	KEGG	Alzheimer disease	8484	411		0.7380952380952381	0.7441860465116279	382	8102	10	17	372	8085	8484	0.08865229111406071
M1	cpdb	0	network_modules	177	TRUE	8.26529226920985e-6	201	27	8	0.2962962962962963	0.03980099502487562	KEGG:05203	KEGG	Viral carcinogenesis	8484	455		0.7619047619047619	0.7674418604651163	201	8283	8	19	193	8264	8484	0.10127815081235941
M1	cpdb	0	network_modules	177	TRUE	8.282164562430202e-6	37	27	5	0.18518518518518517	0.13513513513513514	REAC:R-HSA-111465	REAC	Apoptotic cleavage of cellular proteins	10916	161		0.6236559139784946	0.6276595744680851	37	10879	5	22	32	10857	10916	0.15575413431583363
M1	cpdb	0	network_modules	177	TRUE	9.22604978850208e-6	136	27	7	0.25925925925925924	0.051470588235294115	REAC:R-HSA-5621481	REAC	C-type lectin receptors (CLRs)	10916	261		0.6344086021505376	0.6382978723404256	136	10780	7	20	129	10760	10916	0.11079459674097382
M1	cpdb	0	network_modules	177	TRUE	1.2374586205234115e-5	265	27	8	0.2962962962962963	0.03018867924528302	GO:0002429	GO:BP	immune response-activating cell surface receptor signaling pathway	16175	952		0.4946236559139785	0.5	265	15910	8	19	257	15891	16175	0.0901637208274435
M1	cpdb	0	network_modules	177	TRUE	1.2746429581996568e-5	15	27	4	0.14814814814814814	0.26666666666666666	REAC:R-HSA-140534	REAC	Caspase activation via Death Receptors in the presence of ligand	10916	313		0.6451612903225806	0.648936170212766	15	10901	4	23	11	10878	10916	0.197297596873097
M1	cpdb	0	network_modules	177	TRUE	1.45479353381442e-5	170	27	7	0.25925925925925924	0.041176470588235294	GO:0097191	GO:BP	extrinsic apoptotic signaling pathway	16175	18535		0.5053763440860215	0.5106382978723404	170	16005	7	20	163	15985	16175	0.09974157374183376
M1	cpdb	0	network_modules	177	TRUE	1.5809399172133567e-5	147	27	7	0.25925925925925924	0.047619047619047616	REAC:R-HSA-1169410	REAC	Antiviral mechanism by IFN-stimulated genes	10916	157		0.6559139784946236	0.6595744680851063	147	10769	7	20	140	10749	10916	0.10618769411564946
M1	cpdb	0	network_modules	177	TRUE	1.6966579965284524e-5	16	27	4	0.14814814814814814	0.25	REAC:R-HSA-936964	REAC	Activation of IRF3, IRF7 mediated by TBK1, IKKε (IKBKE)	10916	85		0.6666666666666666	0.6702127659574468	16	10900	4	23	12	10877	10916	0.1909221015063165
M1	cpdb	0	network_modules	177	TRUE	2.2149651323819308e-5	17	27	4	0.14814814814814814	0.23529411764705882	REAC:R-HSA-1810476	REAC	RIP-mediated NFkB activation via ZBP1	10916	1876		0.6774193548387096	0.6808510638297872	17	10899	4	23	13	10876	10916	0.18511445873127344
M1	cpdb	0	network_modules	177	TRUE	2.2250955261925513e-5	459	27	10	0.37037037037037035	0.02178649237472767	REAC:R-HSA-9679506	REAC	SARS-CoV Infections	10916	2112		0.6881720430107527	0.6914893617021277	459	10457	10	17	449	10440	10916	0.0814594548558763
M1	cpdb	0	network_modules	177	TRUE	2.3072858286759547e-5	287	27	8	0.2962962962962963	0.027874564459930314	GO:0002768	GO:BP	immune response-regulating cell surface receptor signaling pathway	16175	1279		0.5161290322580645	0.5212765957446809	287	15888	8	19	279	15869	16175	0.08627776114349116
M1	cpdb	0	network_modules	177	TRUE	2.353385560978e-5	154	27	7	0.25925925925925924	0.045454545454545456	KEGG:04932	KEGG	Non-alcoholic fatty liver disease	8484	389		0.7857142857142857	0.7906976744186046	154	8330	7	20	147	8310	8484	0.1020474447960173
M1	cpdb	0	network_modules	177	TRUE	2.4815342702639913e-5	49	27	5	0.18518518518518517	0.10204081632653061	GO:0010803	GO:BP	regulation of tumor necrosis factor-mediated signaling pathway	16175	4417		0.5268817204301075	0.5425531914893617	49	16126	5	22	44	16104	16175	0.13553407072612547
M1	cpdb	0	network_modules	177	TRUE	2.4815342702639913e-5	49	27	5	0.18518518518518517	0.10204081632653061	GO:0140374	GO:BP	antiviral innate immune response	16175	19754		0.5268817204301075	0.5425531914893617	49	16126	5	22	44	16104	16175	0.13553407072612547
M1	cpdb	0	network_modules	177	TRUE	3.549738799089023e-5	110	27	6	0.2222222222222222	0.05454545454545454	GO:0032606	GO:BP	type I interferon production	16175	7654		0.5483870967741935	0.5638297872340425	110	16065	6	21	104	16044	16175	0.10718138106479634
M1	cpdb	0	network_modules	177	TRUE	3.549738799089023e-5	110	27	6	0.2222222222222222	0.05454545454545454	GO:0032479	GO:BP	regulation of type I interferon production	16175	7590		0.5483870967741935	0.5638297872340425	110	16065	6	21	104	16044	16175	0.10718138106479634
M1	cpdb	0	network_modules	177	TRUE	3.6547675747295794e-5	98	27	6	0.2222222222222222	0.061224489795918366	REAC:R-HSA-202424	REAC	Downstream TCR signaling	10916	789		0.6989247311827957	0.7021276595744681	98	10818	6	21	92	10797	10916	0.11257523821871547
M1	cpdb	0	network_modules	177	TRUE	3.7175575410769416e-5	53	27	5	0.18518518518518517	0.09433962264150944	GO:0034142	GO:BP	toll-like receptor 4 signaling pathway	16175	8450		0.5698924731182796	0.574468085106383	53	16122	5	22	48	16100	16175	0.13015847665579391
M1	cpdb	0	network_modules	177	TRUE	3.7601918998994804e-5	101	27	6	0.2222222222222222	0.0594059405940594	KEGG:05142	KEGG	Chagas disease	8484	434		0.8095238095238095	0.813953488372093	101	8383	6	21	95	8362	8484	0.10956940050709171
M1	cpdb	0	network_modules	177	TRUE	3.778404889880319e-5	443	27	9	0.3333333333333333	0.020316027088036117	GO:0009617	GO:BP	response to bacterium	16175	3543		0.5806451612903226	0.5851063829787234	443	15732	9	18	434	15714	16175	0.07665083341162805
M1	cpdb	0	network_modules	177	TRUE	4.125189665151565e-5	100	27	6	0.2222222222222222	0.06	REAC:R-HSA-5668541	REAC	TNFR2 non-canonical NF-kB pathway	10916	2450		0.7096774193548387	0.7127659574468085	100	10816	6	21	94	10795	10916	0.11135834311423873
M1	cpdb	0	network_modules	177	TRUE	4.359307217570889e-5	51	27	5	0.18518518518518517	0.09803921568627451	REAC:R-HSA-75153	REAC	Apoptotic execution phase	10916	162		0.7204301075268817	0.723404255319149	51	10865	5	22	46	10843	10916	0.1318136200917313
M1	cpdb	0	network_modules	177	TRUE	4.63727415007722e-5	115	27	6	0.2222222222222222	0.05217391304347826	GO:1903322	GO:BP	positive regulation of protein modification by small protein conjugation or removal	16175	22906		0.5913978494623656	0.5957446808510638	115	16060	6	21	109	16039	16175	0.1046913325402706
M1	cpdb	0	network_modules	177	TRUE	4.884754237615008e-5	116	27	6	0.2222222222222222	0.05172413793103448	GO:1901875	GO:BP	positive regulation of post-translational protein modification	16175	21819		0.6021505376344086	0.6063829787234043	116	16059	6	21	110	16038	16175	0.104212386021723
M1	cpdb	0	network_modules	177	TRUE	5.486332599299876e-5	206	27	7	0.25925925925925924	0.03398058252427184	GO:1903320	GO:BP	regulation of protein modification by small protein conjugation or removal	16175	22904		0.6129032258064516	0.6170212765957447	206	15969	7	20	199	15949	16175	0.08989856389762567
M1	cpdb	0	network_modules	177	TRUE	5.527894421239733e-5	463	27	9	0.3333333333333333	0.019438444924406047	GO:0097190	GO:BP	apoptotic signaling pathway	16175	18534		0.6236559139784946	0.6276595744680851	463	15712	9	18	454	15694	16175	0.07472152521410388
M1	cpdb	0	network_modules	177	TRUE	5.646128674501929e-5	21	27	4	0.14814814814814814	0.19047619047619047	GO:0060544	GO:BP	regulation of necroptotic process	16175	14733		0.6344086021505376	0.6382978723404256	21	16154	4	23	17	16131	16175	0.16675951241866255
M1	cpdb	0	network_modules	177	TRUE	6.059867000221213e-5	209	27	7	0.25925925925925924	0.03349282296650718	GO:1901873	GO:BP	regulation of post-translational protein modification	16175	21817		0.6451612903225806	0.648936170212766	209	15966	7	20	202	15946	16175	0.08919225740077474
M1	cpdb	0	network_modules	177	TRUE	6.441525201900487e-5	59	27	5	0.18518518518518517	0.0847457627118644	GO:0002224	GO:BP	toll-like receptor signaling pathway	16175	758		0.6559139784946236	0.6595744680851063	59	16116	5	22	54	16094	16175	0.1231342046915568
M1	cpdb	0	network_modules	177	TRUE	6.750552061593281e-5	22	27	4	0.14814814814814814	0.18181818181818182	REAC:R-HSA-450321	REAC	JNK (c-Jun kinases) phosphorylation and  activation mediated by activated human TAK1	10916	1279		0.7311827956989247	0.7340425531914894	22	10894	4	23	18	10871	10916	0.162253459307461
M1	cpdb	0	network_modules	177	TRUE	7.01914242112404e-5	60	27	5	0.18518518518518517	0.08333333333333333	GO:0140895	GO:BP	cell surface toll-like receptor signaling pathway	16175	19927		0.6666666666666666	0.6702127659574468	60	16115	5	22	55	16093	16175	0.122065978751826
M1	cpdb	0	network_modules	177	TRUE	8.157940229320457e-5	23	27	4	0.14814814814814814	0.17391304347826086	REAC:R-HSA-450302	REAC	activated TAK1 mediates p38 MAPK activation	10916	2685		0.7419354838709677	0.7446808510638298	23	10893	4	23	19	10870	10916	0.15859481412000134
M1	cpdb	0	network_modules	177	TRUE	8.334628317719751e-5	23	27	4	0.14814814814814814	0.17391304347826086	GO:0062098	GO:BP	regulation of programmed necrotic cell death	16175	15819		0.6774193548387096	0.6808510638297872	23	16152	4	23	19	16129	16175	0.15921992031033882
M1	cpdb	0	network_modules	177	TRUE	8.608562234815574e-5	6	27	3	0.1111111111111111	0.5	REAC:R-HSA-111459	REAC	Activation of caspases through apoptosome-mediated cleavage	10916	100		0.7526881720430108	0.7553191489361702	6	10910	3	24	3	10886	10916	0.23489142991848785
M1	cpdb	0	network_modules	177	TRUE	9.754617613868367e-5	64	27	5	0.18518518518518517	0.078125	GO:0070534	GO:BP	protein K63-linked ubiquitination	16175	16168		0.6881720430107527	0.6914893617021277	64	16111	5	22	59	16089	16175	0.11804347058849374
M1	cpdb	0	network_modules	177	TRUE	1.2228089691050266e-4	120	27	6	0.2222222222222222	0.05	REAC:R-HSA-202403	REAC	TCR signaling	10916	2422		0.7634408602150538	0.7659574468085106	120	10796	6	21	114	10775	10916	0.10087493584162327
M1	cpdb	0	network_modules	177	TRUE	1.2313733282050517e-4	67	27	5	0.18518518518518517	0.07462686567164178	GO:0002752	GO:BP	cell surface pattern recognition receptor signaling pathway	16175	1263		0.6989247311827957	0.7021276595744681	67	16108	5	22	62	16086	16175	0.11526310214969986
M1	cpdb	0	network_modules	177	TRUE	1.4719191201560268e-4	70	27	5	0.18518518518518517	0.07142857142857142	KEGG:05120	KEGG	Epithelial cell signaling in Helicobacter pylori infection	8484	426		0.8333333333333334	0.8372093023255814	70	8414	5	22	65	8392	8484	0.11051883098708136
M1	cpdb	0	network_modules	177	TRUE	1.5040138345034023e-4	7	27	3	0.1111111111111111	0.42857142857142855	REAC:R-HSA-111469	REAC	SMAC, XIAP-regulated apoptotic response	10916	2151		0.7741935483870968	0.8085106382978723	7	10909	3	24	4	10885	10916	0.2172969776674941
M1	cpdb	0	network_modules	177	TRUE	1.5040138345034023e-4	7	27	3	0.1111111111111111	0.42857142857142855	REAC:R-HSA-111464	REAC	SMAC(DIABLO)-mediated dissociation of IAP:caspase complexes 	10916	2150		0.7741935483870968	0.8085106382978723	7	10909	3	24	4	10885	10916	0.2172969776674941
M1	cpdb	0	network_modules	177	TRUE	1.5040138345034023e-4	7	27	3	0.1111111111111111	0.42857142857142855	REAC:R-HSA-111463	REAC	SMAC (DIABLO) binds to IAPs 	10916	2149		0.7741935483870968	0.8085106382978723	7	10909	3	24	4	10885	10916	0.2172969776674941
M1	cpdb	0	network_modules	177	TRUE	1.5040138345034023e-4	7	27	3	0.1111111111111111	0.42857142857142855	REAC:R-HSA-5603029	REAC	IkBA variant leads to EDA-ID	10916	1167		0.7741935483870968	0.8085106382978723	7	10909	3	24	4	10885	10916	0.2172969776674941
M1	cpdb	0	network_modules	177	TRUE	1.6942257793592993e-4	72	27	5	0.18518518518518517	0.06944444444444445	KEGG:01524	KEGG	Platinum drug resistance	8484	198		0.8571428571428571	0.8604651162790697	72	8412	5	22	67	8390	8484	0.10884078355331543
M1	cpdb	0	network_modules	177	TRUE	1.9547993548485625e-4	248	27	7	0.25925925925925924	0.028225806451612902	GO:0000209	GO:BP	protein polyubiquitination	16175	59		0.7096774193548387	0.7127659574468085	248	15927	7	20	241	15907	16175	0.08117714392746271
M1	cpdb	0	network_modules	177	TRUE	2.561795155780046e-4	136	27	6	0.2222222222222222	0.04411764705882353	REAC:R-HSA-2871837	REAC	FCERI mediated NF-kB activation	10916	896		0.8172043010752689	0.8191489361702128	136	10780	6	21	130	10759	10916	0.09416779143406606
M1	cpdb	0	network_modules	177	TRUE	3.0760300506258223e-4	75	27	5	0.18518518518518517	0.06666666666666667	REAC:R-HSA-9833482	REAC	PKR-mediated signaling	10916	1692		0.8279569892473119	0.8297872340425532	75	10841	5	22	70	10819	10916	0.10749118621035741
M1	cpdb	0	network_modules	177	TRUE	3.3501712895848984e-4	32	27	4	0.14814814814814814	0.125	GO:0070266	GO:BP	necroptotic process	16175	16027		0.7204301075268817	0.7340425531914894	32	16143	4	23	28	16120	16175	0.1345108450366454
M1	cpdb	0	network_modules	177	TRUE	3.3501712895848984e-4	32	27	4	0.14814814814814814	0.125	GO:2000116	GO:BP	regulation of cysteine-type endopeptidase activity	16175	25465		0.7204301075268817	0.7340425531914894	32	16143	4	23	28	16120	16175	0.1345108450366454
M1	cpdb	0	network_modules	177	TRUE	4.4315242861884803e-4	168	27	6	0.2222222222222222	0.03571428571428571	GO:0031396	GO:BP	regulation of protein ubiquitination	16175	7152		0.7419354838709677	0.7446808510638298	168	16007	6	21	162	15986	16175	0.08543908585721967
M1	cpdb	0	network_modules	177	TRUE	4.7271046569384416e-4	35	27	4	0.14814814814814814	0.11428571428571428	REAC:R-HSA-936440	REAC	Negative regulators of DDX58/IFIH1 signaling	10916	1581		0.8387096774193549	0.8404255319148937	35	10881	4	23	31	10858	10916	0.1276664462751998
M1	cpdb	0	network_modules	177	TRUE	6.78730328217653e-4	94	27	5	0.18518518518518517	0.05319148936170213	GO:0031398	GO:BP	positive regulation of protein ubiquitination	16175	7154		0.7526881720430108	0.7553191489361702	94	16081	5	22	89	16059	16175	0.0964950933371314
M1	cpdb	0	network_modules	177	TRUE	6.830067239995707e-4	38	27	4	0.14814814814814814	0.10526315789473684	GO:0097300	GO:BP	programmed necrotic cell death	16175	18585		0.7634408602150538	0.7659574468085106	38	16137	4	23	34	16114	16175	0.12314525513013563
M1	cpdb	0	network_modules	177	TRUE	7.375721817028207e-4	39	27	4	0.14814814814814814	0.10256410256410256	REAC:R-HSA-5689896	REAC	Ovarian tumor domain proteases	10916	1653		0.8494623655913979	0.851063829787234	39	10877	4	23	35	10854	10916	0.12065879329387788
M1	cpdb	0	network_modules	177	TRUE	8.181424955110172e-4	40	27	4	0.14814814814814814	0.1	REAC:R-HSA-9692916	REAC	SARS-CoV-1 activates/modulates innate immune responses	10916	2115		0.8602150537634409	0.8617021276595744	40	10876	4	23	36	10853	10916	0.1190709934365057
M1	cpdb	0	network_modules	177	TRUE	8.196496803576418e-4	263	27	7	0.25925925925925924	0.026615969581749048	REAC:R-HSA-913531	REAC	Interferon Signaling	10916	1227		0.8709677419354839	0.8723404255319149	263	10653	7	20	256	10633	10916	0.07636818094573995
M1	cpdb	0	network_modules	177	TRUE	8.327824042089492e-4	187	27	6	0.2222222222222222	0.03208556149732621	GO:0032496	GO:BP	response to lipopolysaccharide	16175	7607		0.7741935483870968	0.776595744680851	187	15988	6	21	181	15967	16175	0.08058114282789251
M1	cpdb	0	network_modules	177	TRUE	9.37610931442113e-4	12	27	3	0.1111111111111111	0.25	REAC:R-HSA-4755510	REAC	SUMOylation of immune response proteins	10916	2174		0.8817204301075269	0.8829787234042553	12	10904	3	24	9	10880	10916	0.16531306015909594
M1	cpdb	0	network_modules	177	TRUE	9.984041619091697e-4	95	27	5	0.18518518518518517	0.05263157894736842	REAC:R-HSA-9692914	REAC	SARS-CoV-1-host interactions	10916	2119		0.8924731182795699	0.8936170212765957	95	10821	5	22	90	10799	10916	0.0946143958728376
M1	cpdb	0	network_modules	177	TRUE	0.0010388234831356928	104	27	5	0.18518518518518517	0.04807692307692308	KEGG:04625	KEGG	C-type lectin receptor signaling pathway	8484	330		0.8809523809523809	0.8837209302325582	104	8380	5	22	99	8358	8484	0.08879694901079248
M1	cpdb	0	network_modules	177	TRUE	0.0010714362063993232	103	27	5	0.18518518518518517	0.04854368932038835	GO:0052547	GO:BP	regulation of peptidase activity	16175	14133		0.7849462365591398	0.7978723404255319	103	16072	5	22	98	16050	16175	0.09192271465678588
M1	cpdb	0	network_modules	177	TRUE	0.0010714362063993232	103	27	5	0.18518518518518517	0.04854368932038835	GO:0039531	GO:BP	regulation of cytoplasmic pattern recognition receptor signaling pathway	16175	9804		0.7849462365591398	0.7978723404255319	103	16072	5	22	98	16050	16175	0.09192271465678588
M1	cpdb	0	network_modules	177	TRUE	0.001216884427994001	13	27	3	0.1111111111111111	0.23076923076923078	REAC:R-HSA-111461	REAC	Cytochrome c-mediated apoptotic response	10916	424		0.9032258064516129	0.9042553191489362	13	10903	3	24	10	10879	10916	0.15870266976772543
M1	cpdb	0	network_modules	177	TRUE	0.0013473253753211738	203	27	6	0.2222222222222222	0.029556650246305417	GO:0002237	GO:BP	response to molecule of bacterial origin	16175	770		0.8064516129032258	0.8085106382978723	203	15972	6	21	197	15951	16175	0.07701575003268618
M1	cpdb	0	network_modules	177	TRUE	0.0014025747022959952	182	27	6	0.2222222222222222	0.03296703296703297	REAC:R-HSA-2454202	REAC	Fc epsilon receptor (FCERI) signaling	10916	938		0.9139784946236559	0.9148936170212766	182	10734	6	21	176	10713	10916	0.07993762412652453
M1	cpdb	0	network_modules	177	TRUE	0.0014116110841080967	12	27	3	0.1111111111111111	0.25	GO:0035666	GO:BP	TRIF-dependent toll-like receptor signaling pathway	16175	9146		0.8172043010752689	0.8191489361702128	12	16163	3	24	9	16139	16175	0.16575368276393845
M1	cpdb	0	network_modules	177	TRUE	0.0018330523440763533	13	27	3	0.1111111111111111	0.23076923076923078	GO:0070424	GO:BP	regulation of nucleotide-binding domain, leucine rich repeat containing receptor signaling pathway	16175	16110		0.8279569892473119	0.8404255319148937	13	16162	3	24	10	16138	16175	0.15916670598500132
M1	cpdb	0	network_modules	177	TRUE	0.0018330523440763533	13	27	3	0.1111111111111111	0.23076923076923078	GO:1902916	GO:BP	positive regulation of protein polyubiquitination	16175	22613		0.8279569892473119	0.8404255319148937	13	16162	3	24	10	16138	16175	0.15916670598500132
M1	cpdb	0	network_modules	177	TRUE	0.0018742064855501335	298	27	7	0.25925925925925924	0.02348993288590604	REAC:R-HSA-5688426	REAC	Deubiquitination	10916	736		0.9247311827956989	0.925531914893617	298	10618	7	20	291	10598	10916	0.07088180970926222
M1	cpdb	0	network_modules	177	TRUE	0.0019295739015912658	15	27	3	0.1111111111111111	0.2	REAC:R-HSA-918233	REAC	TRAF3-dependent IRF activation pathway	10916	2464		0.9354838709677419	0.9361702127659575	15	10901	3	24	12	10877	10916	0.14751141209150873
M1	cpdb	0	network_modules	177	TRUE	0.0021020360648803292	50	27	4	0.14814814814814814	0.08	GO:0043124	GO:BP	negative regulation of canonical NF-kappaB signal transduction	16175	10543		0.8494623655913979	0.851063829787234	50	16125	4	23	46	16102	16175	0.10684901008545478
M1	cpdb	0	network_modules	177	TRUE	0.0023709448219664934	16	27	3	0.1111111111111111	0.1875	REAC:R-HSA-5676594	REAC	TNF receptor superfamily (TNFSF) members mediating non-canonical NF-kB pathway	10916	2445		0.946236559139785	0.9574468085106383	16	10900	3	24	13	10876	10916	0.1427146241737168
M1	cpdb	0	network_modules	177	TRUE	0.0023709448219664934	16	27	3	0.1111111111111111	0.1875	REAC:R-HSA-5684264	REAC	MAP3K8 (TPL2)-dependent MAPK1/3 activation	10916	1347		0.946236559139785	0.9574468085106383	16	10900	3	24	13	10876	10916	0.1427146241737168
M1	cpdb	0	network_modules	177	TRUE	0.0027650239498311796	54	27	4	0.14814814814814814	0.07407407407407407	REAC:R-HSA-109606	REAC	Intrinsic Pathway for Apoptosis	10916	1268		0.967741935483871	0.9680851063829787	54	10862	4	23	50	10839	10916	0.1016357589346268
M1	cpdb	0	network_modules	177	TRUE	0.003165093192668815	375	27	7	0.25925925925925924	0.018666666666666668	GO:0030162	GO:BP	regulation of proteolysis	16175	6690		0.8602150537634409	0.8617021276595744	375	15800	7	20	368	15780	16175	0.06414653993496353
M1	cpdb	0	network_modules	177	TRUE	0.0032188331272367536	749	27	9	0.3333333333333333	0.012016021361815754	GO:0070647	GO:BP	protein modification by small protein conjugation or removal	16175	16231		0.8709677419354839	0.8723404255319149	749	15426	9	18	740	15408	16175	0.05584990551623391
M1	cpdb	0	network_modules	177	TRUE	0.0035772253304888753	16	27	3	0.1111111111111111	0.1875	GO:0002756	GO:BP	MyD88-independent toll-like receptor signaling pathway	16175	1267		0.8817204301075269	0.8829787234042553	16	16159	3	24	13	16135	16175	0.14324299225971948
M1	cpdb	0	network_modules	177	TRUE	0.0037693204982075105	385	27	7	0.25925925925925924	0.01818181818181818	GO:0043065	GO:BP	positive regulation of apoptotic process	16175	10511		0.8924731182795699	0.8936170212765957	385	15790	7	20	378	15770	16175	0.0631621861987438
M1	cpdb	0	network_modules	177	TRUE	0.004082324843111208	19	27	3	0.1111111111111111	0.15789473684210525	REAC:R-HSA-111471	REAC	Apoptotic factor-mediated response	10916	163		0.978494623655914	0.9787234042553191	19	10897	3	24	16	10873	10916	0.13065364120266185
M1	cpdb	0	network_modules	177	TRUE	0.004276376400039186	221	27	6	0.2222222222222222	0.027149321266968326	REAC:R-HSA-5689880	REAC	Ub-specific processing proteases	10916	2617		0.989247311827957	0.9893617021276596	221	10695	6	21	215	10674	10916	0.07141117431012618
M1	cpdb	0	network_modules	177	TRUE	0.004355560797075294	140	27	5	0.18518518518518517	0.03571428571428571	KEGG:04120	KEGG	Ubiquitin mediated proteolysis	8484	270		0.9047619047619048	0.9069767441860465	140	8344	5	22	135	8322	8484	0.07481624456797503
M1	cpdb	0	network_modules	177	TRUE	0.004935951126472971	401	27	7	0.25925925925925924	0.017456359102244388	GO:0043068	GO:BP	positive regulation of programmed cell death	16175	10514		0.9032258064516129	0.9042553191489362	401	15774	7	20	394	15754	16175	0.0616605106733243
M1	cpdb	0	network_modules	177	TRUE	0.005246171836305535	142	27	5	0.18518518518518517	0.035211267605633804	GO:0071222	GO:BP	cellular response to lipopolysaccharide	16175	16484		0.9139784946236559	0.9148936170212766	142	16033	5	22	137	16011	16175	0.07732663124105855
M1	cpdb	0	network_modules	177	TRUE	0.005356972408956156	63	27	4	0.14814814814814814	0.06349206349206349	GO:0008625	GO:BP	extrinsic apoptotic signaling pathway via death domain receptors	16175	3214		0.9247311827956989	0.925531914893617	63	16112	4	23	59	16089	16175	0.09469943808580808
M1	cpdb	0	network_modules	177	TRUE	0.0054272853725923316	798	27	9	0.3333333333333333	0.011278195488721804	GO:0043687	GO:BP	post-translational protein modification	16175	10838		0.9354838709677419	0.9361702127659575	798	15377	9	18	789	15359	16175	0.05362221342107132
M1	cpdb	0	network_modules	177	TRUE	0.005608556480934169	590	27	8	0.2962962962962963	0.013559322033898305	GO:0016567	GO:BP	protein ubiquitination	16175	5254		0.946236559139785	0.9468085106382979	590	15585	8	19	582	15566	16175	0.056670936992159165
M1	cpdb	0	network_modules	177	TRUE	0.005663936857428923	76	27	4	0.14814814814814814	0.05263157894736842	KEGG:05133	KEGG	Pertussis	8484	430		0.9285714285714286	0.9534883720930233	76	8408	4	23	72	8385	8484	0.08346984469189521
M1	cpdb	0	network_modules	177	TRUE	0.005663936857428923	76	27	4	0.14814814814814814	0.05263157894736842	KEGG:05212	KEGG	Pancreatic cancer	8484	463		0.9285714285714286	0.9534883720930233	76	8408	4	23	72	8385	8484	0.08346984469189521
M1	cpdb	0	network_modules	177	TRUE	0.006012356803106936	146	27	5	0.18518518518518517	0.03424657534246575	GO:0062207	GO:BP	regulation of pattern recognition receptor signaling pathway	16175	15863		0.956989247311828	0.9574468085106383	146	16029	5	22	141	16007	16175	0.07616260209093298
M1	cpdb	0	network_modules	177	TRUE	0.006641791390288292	363	27	7	0.25925925925925924	0.01928374655647383	KEGG:05014	KEGG	Amyotrophic lateral sclerosis	8484	413		0.9761904761904762	0.9767441860465116	363	8121	7	20	356	8101	8484	0.060439340844721974
M1	cpdb	0	network_modules	177	TRUE	0.006659653145201515	140	27	5	0.18518518518518517	0.03571428571428571	REAC:R-HSA-9678108	REAC	SARS-CoV-1 Infection	10916	2114		1	1	140	10776	5	22	135	10754	10916	0.07627724910992299
M1	cpdb	0	network_modules	177	TRUE	0.006993599586902296	30	27	3	0.1111111111111111	0.1	KEGG:01523	KEGG	Antifolate resistance	8484	197		1	1	30	8454	3	24	27	8430	8484	0.10239863248515033
M1	cpdb	0	network_modules	177	TRUE	0.0073237301418995785	152	27	5	0.18518518518518517	0.03289473684210526	GO:0071219	GO:BP	cellular response to molecule of bacterial origin	16175	16481		0.967741935483871	0.9680851063829787	152	16023	5	22	147	16001	16175	0.07450102276832485
M1	cpdb	0	network_modules	177	TRUE	0.00844875176401832	21	27	3	0.1111111111111111	0.14285714285714285	GO:0034138	GO:BP	toll-like receptor 3 signaling pathway	16175	8446		0.978494623655914	0.9787234042553191	21	16154	3	24	18	16130	16175	0.12470105400611571
M1	cpdb	0	network_modules	177	TRUE	0.0097718815614133165	22	27	3	0.1111111111111111	0.13636363636363635	GO:0035872	GO:BP	nucleotide-binding domain, leucine rich repeat containing receptor signaling pathway	16175	9301		0.989247311827957	1	22	16153	3	24	19	16129	16175	0.12176915729780585
M1	cpdb	0	network_modules	177	TRUE	0.0097718815614133165	22	27	3	0.1111111111111111	0.13636363636363635	GO:1902914	GO:BP	regulation of protein polyubiquitination	16175	22611		0.989247311827957	1	22	16153	3	24	19	16129	16175	0.12176915729780585
M1	cpdb	0	network_modules	178	TRUE	5.4287240901744725e-52	57	27	24	0.8888888888888888	0.42105263157894735	REAC:R-HSA-6799198	REAC	Complex I biogenesis	10916	391		0	0.3333333333333333	57	10859	24	3	33	10856	10916	0.6105311104543412
M1	cpdb	0	network_modules	178	TRUE	1.1823052605377363e-44	61	27	21	0.7777777777777778	0.3442622950819672	GO:0010257	GO:BP	NADH dehydrogenase complex assembly	16175	4030		0	0.044444444444444446	61	16114	21	6	40	16108	16175	0.516350766724397
M1	cpdb	0	network_modules	178	TRUE	1.1823052605377363e-44	61	27	21	0.7777777777777778	0.3442622950819672	GO:0032981	GO:BP	mitochondrial respiratory chain complex I assembly	16175	7963		0	0.044444444444444446	61	16114	21	6	40	16108	16175	0.516350766724397
M1	cpdb	0	network_modules	178	TRUE	1.2719077380786603e-44	103	27	24	0.8888888888888888	0.23300970873786409	REAC:R-HSA-611105	REAC	Respiratory electron transport	10916	2081		0.5	0.6666666666666666	103	10813	24	3	79	10810	10916	0.452973117604937
M1	cpdb	0	network_modules	178	TRUE	6.322762584699286e-41	65	27	20	0.7407407407407407	0.3076923076923077	GO:0042776	GO:BP	proton motive force-driven mitochondrial ATP synthesis	16175	10361		0.045454545454545456	0.06666666666666667	65	16110	20	7	45	16103	16175	0.4761744683783801
M1	cpdb	0	network_modules	178	TRUE	6.9418889187190266e-40	72	27	20	0.7407407407407407	0.2777777777777778	GO:0015986	GO:BP	proton motive force-driven ATP synthesis	16175	5062		0.06818181818181818	0.08888888888888889	72	16103	20	7	52	16096	16175	0.45226785414564635
M1	cpdb	0	network_modules	178	TRUE	9.572475368068908e-40	97	27	21	0.7777777777777778	0.21649484536082475	GO:0033108	GO:BP	mitochondrial respiratory chain complex assembly	16175	8042		0.09090909090909091	0.1111111111111111	97	16078	21	6	76	16072	16175	0.4087510965643818
M1	cpdb	0	network_modules	178	TRUE	1.4543602251567545e-38	109	27	21	0.7777777777777778	0.1926605504587156	GO:0097250	GO:BP	mitochondrial respirasome assembly	16175	18559		0.11363636363636363	0.13333333333333333	109	16066	21	6	88	16060	16175	0.3853683176685286
M1	cpdb	0	network_modules	178	TRUE	1.96682379042507e-38	177	27	24	0.8888888888888888	0.13559322033898305	REAC:R-HSA-1428517	REAC	Aerobic respiration and respiratory electron transport	10916	127		1	1	177	10739	24	3	153	10736	10916	0.34406062312869257
M1	cpdb	0	network_modules	178	TRUE	1.1257006313856747e-37	90	27	20	0.7407407407407407	0.2222222222222222	GO:0006754	GO:BP	ATP biosynthetic process	16175	2451		0.13636363636363635	0.15555555555555556	90	16085	20	7	70	16078	16175	0.40413520865812663
M1	cpdb	0	network_modules	178	TRUE	1.8420494919598436e-37	92	27	20	0.7407407407407407	0.21739130434782608	GO:0009145	GO:BP	purine nucleoside triphosphate biosynthetic process	16175	3312		0.1590909090909091	0.2	92	16083	20	7	72	16076	16175	0.3996759186448458
M1	cpdb	0	network_modules	178	TRUE	1.8420494919598436e-37	92	27	20	0.7407407407407407	0.21739130434782608	GO:0009206	GO:BP	purine ribonucleoside triphosphate biosynthetic process	16175	3372		0.1590909090909091	0.2	92	16083	20	7	72	16076	16175	0.3996759186448458
M1	cpdb	0	network_modules	178	TRUE	4.8788976891559165e-37	127	27	21	0.7777777777777778	0.16535433070866143	GO:0006119	GO:BP	oxidative phosphorylation	16175	1977		0.20454545454545456	0.2222222222222222	127	16048	21	6	106	16042	16175	0.3567003667645523
M1	cpdb	0	network_modules	178	TRUE	5.99595480502268e-37	97	27	20	0.7407407407407407	0.20618556701030927	GO:0009201	GO:BP	ribonucleoside triphosphate biosynthetic process	16175	3367		0.22727272727272727	0.24444444444444444	97	16078	20	7	77	16071	16175	0.3891355164028393
M1	cpdb	0	network_modules	178	TRUE	2.26573550315317e-36	103	27	20	0.7407407407407407	0.1941747572815534	GO:0009142	GO:BP	nucleoside triphosphate biosynthetic process	16175	3309		0.25	0.26666666666666666	103	16072	20	7	83	16065	16175	0.3775112188133494
M1	cpdb	0	network_modules	178	TRUE	2.2905112541882183e-35	46	27	17	0.6296296296296297	0.3695652173913043	GO:0006120	GO:BP	mitochondrial electron transport, NADH to ubiquinone	16175	1978		0.2727272727272727	0.28888888888888886	46	16129	17	10	29	16119	16175	0.4812860433250315
M1	cpdb	0	network_modules	178	TRUE	1.1876853124070097e-34	162	27	21	0.7777777777777778	0.12962962962962962	GO:0009060	GO:BP	aerobic respiration	16175	3236		0.29545454545454547	0.3111111111111111	162	16013	21	6	141	16007	16175	0.31528240675678393
M1	cpdb	0	network_modules	178	TRUE	2.600798976473791e-34	128	27	20	0.7407407407407407	0.15625	GO:0009152	GO:BP	purine ribonucleotide biosynthetic process	16175	3319		0.3181818181818182	0.3333333333333333	128	16047	20	7	108	16040	16175	0.33819448883687775
M1	cpdb	0	network_modules	178	TRUE	1.123894897647007e-33	137	27	20	0.7407407407407407	0.145985401459854	GO:0009260	GO:BP	ribonucleotide biosynthetic process	16175	3425		0.3409090909090909	0.35555555555555557	137	16038	20	7	117	16031	16175	0.32674065613675873
M1	cpdb	0	network_modules	178	TRUE	2.8173935872023613e-33	143	27	20	0.7407407407407407	0.13986013986013987	GO:0046390	GO:BP	ribose phosphate biosynthetic process	16175	12117		0.36363636363636365	0.37777777777777777	143	16032	20	7	123	16025	16175	0.3197103088349749
M1	cpdb	0	network_modules	178	TRUE	3.2563445418353446e-33	188	27	21	0.7777777777777778	0.11170212765957446	GO:0045333	GO:BP	cellular respiration	16175	11360		0.38636363636363635	0.4	188	15987	21	6	167	15981	16175	0.2922947225320257
M1	cpdb	0	network_modules	178	TRUE	1.920570772877462e-32	88	27	18	0.6666666666666666	0.20454545454545456	GO:0042773	GO:BP	ATP synthesis coupled electron transport	16175	10358		0.4090909090909091	0.4444444444444444	88	16087	18	9	70	16078	16175	0.367568231846061
M1	cpdb	0	network_modules	178	TRUE	1.920570772877462e-32	88	27	18	0.6666666666666666	0.20454545454545456	GO:0042775	GO:BP	mitochondrial ATP synthesis coupled electron transport	16175	10360		0.4090909090909091	0.4444444444444444	88	16087	18	9	70	16078	16175	0.367568231846061
M1	cpdb	0	network_modules	178	TRUE	5.212632065316241e-32	164	27	20	0.7407407407407407	0.12195121951219512	GO:0006164	GO:BP	purine nucleotide biosynthetic process	16175	1999		0.45454545454545453	0.4666666666666667	164	16011	20	7	144	16004	16175	0.29820593957046426
M1	cpdb	0	network_modules	178	TRUE	5.784953755399332e-32	232	26	23	0.8846153846153846	0.09913793103448276	KEGG:04714	KEGG	Thermogenesis	8484	349		0	0.09090909090909091	232	8252	23	3	209	8249	8484	0.2914388284055967
M1	cpdb	0	network_modules	178	TRUE	1.9851366436943203e-31	99	27	18	0.6666666666666666	0.18181818181818182	GO:0022904	GO:BP	respiratory electron transport chain	16175	6631		0.4772727272727273	0.4888888888888889	99	16076	18	9	81	16067	16175	0.3463086540696267
M1	cpdb	0	network_modules	178	TRUE	5.916825387740839e-31	184	27	20	0.7407407407407407	0.10869565217391304	GO:0046034	GO:BP	ATP metabolic process	16175	11811		0.5	0.5111111111111111	184	15991	20	7	164	15984	16175	0.2812322314945008
M1	cpdb	0	network_modules	178	TRUE	7.427102492034491e-31	186	27	20	0.7407407407407407	0.10752688172043011	GO:0009165	GO:BP	nucleotide biosynthetic process	16175	3331		0.5227272727272727	0.5333333333333333	186	15989	20	7	166	15982	16175	0.2796862148669605
M1	cpdb	0	network_modules	178	TRUE	9.123007477713537e-31	107	27	18	0.6666666666666666	0.16822429906542055	GO:0022900	GO:BP	electron transport chain	16175	6630		0.5454545454545454	0.5555555555555556	107	16068	18	9	89	16059	16175	0.33294449311509183
M1	cpdb	0	network_modules	178	TRUE	2.0252893379609385e-30	252	27	21	0.7777777777777778	0.08333333333333333	GO:0015980	GO:BP	energy derivation by oxidation of organic compounds	16175	5060		0.5681818181818182	0.5777777777777777	252	15923	21	6	231	15917	16175	0.2516645187637575
M1	cpdb	0	network_modules	178	TRUE	2.0769808248036784e-30	82	27	17	0.6296296296296297	0.2073170731707317	GO:0019646	GO:BP	aerobic electron transport chain	16175	5967		0.5909090909090909	0.6	82	16093	17	10	65	16083	16175	0.35959661068143906
M1	cpdb	0	network_modules	178	TRUE	2.7577315594689174e-30	198	27	20	0.7407407407407407	0.10101010101010101	GO:0009205	GO:BP	purine ribonucleoside triphosphate metabolic process	16175	3371		0.6136363636363636	0.6222222222222222	198	15977	20	7	178	15970	16175	0.27090431501332674
M1	cpdb	0	network_modules	178	TRUE	2.9319863560928118e-30	134	26	20	0.7692307692307693	0.14925373134328357	KEGG:00190	KEGG	Oxidative phosphorylation	8484	18		0.1	0.18181818181818182	134	8350	20	6	114	8344	8484	0.33504598323133994
M1	cpdb	0	network_modules	178	TRUE	3.778188144306932e-30	201	27	20	0.7407407407407407	0.09950248756218906	GO:0009144	GO:BP	purine nucleoside triphosphate metabolic process	16175	3311		0.6363636363636364	0.6444444444444445	201	15974	20	7	181	15967	16175	0.268831827197225
M1	cpdb	0	network_modules	178	TRUE	5.150831373711477e-30	204	27	20	0.7407407407407407	0.09803921568627451	GO:0009199	GO:BP	ribonucleoside triphosphate metabolic process	16175	3365		0.6590909090909091	0.6666666666666666	204	15971	20	7	184	15964	16175	0.26680490113833494
M1	cpdb	0	network_modules	178	TRUE	1.5421489114639403e-29	215	27	20	0.7407407407407407	0.09302325581395349	GO:0009141	GO:BP	nucleoside triphosphate metabolic process	16175	3308		0.6818181818181818	0.6888888888888889	215	15960	20	7	195	15953	16175	0.2597367810002887
M1	cpdb	0	network_modules	178	TRUE	2.456986702780494e-29	148	26	20	0.7692307692307693	0.13513513513513514	KEGG:04723	KEGG	Retrograde endocannabinoid signaling	8484	353		0.2	0.2727272727272727	148	8336	20	6	128	8330	8484	0.31837438090649306
M1	cpdb	0	network_modules	178	TRUE	2.4899226500827393e-29	220	27	20	0.7407407407407407	0.09090909090909091	GO:0072522	GO:BP	purine-containing compound biosynthetic process	16175	17424		0.7045454545454546	0.7111111111111111	220	15955	20	7	200	15948	16175	0.2566993660604077
M1	cpdb	0	network_modules	178	TRUE	3.3969082280885966e-29	364	27	22	0.8148148148148148	0.06043956043956044	GO:0007005	GO:BP	mitochondrion organization	16175	2617		0.7272727272727273	0.7333333333333333	364	15811	22	5	342	15806	16175	0.21843996506482502
M1	cpdb	0	network_modules	178	TRUE	7.961488196363189e-28	260	27	20	0.7407407407407407	0.07692307692307693	GO:1901293	GO:BP	nucleoside phosphate biosynthetic process	16175	21368		0.75	0.7555555555555555	260	15915	20	7	240	15908	16175	0.2356215572710252
M1	cpdb	0	network_modules	178	TRUE	1.2752713908389104e-27	266	27	20	0.7407407407407407	0.07518796992481203	GO:0009150	GO:BP	purine ribonucleotide metabolic process	16175	3317		0.7727272727272727	0.7777777777777778	266	15909	20	7	246	15902	16175	0.23287367365294623
M1	cpdb	0	network_modules	178	TRUE	2.7298714591295083e-27	276	27	20	0.7407407407407407	0.07246376811594203	GO:0009259	GO:BP	ribonucleotide metabolic process	16175	3424		0.7954545454545454	0.8	276	15899	20	7	256	15892	16175	0.2284927098224604
M1	cpdb	0	network_modules	178	TRUE	4.572707159452531e-27	283	27	20	0.7407407407407407	0.0706713780918728	GO:0019693	GO:BP	ribose phosphate metabolic process	16175	6010		0.8181818181818182	0.8222222222222222	283	15892	20	7	263	15885	16175	0.22556385467856
M1	cpdb	0	network_modules	178	TRUE	9.162732111540919e-27	372	27	21	0.7777777777777778	0.056451612903225805	GO:0006091	GO:BP	generation of precursor metabolites and energy	16175	1954		0.8409090909090909	0.8444444444444444	372	15803	21	6	351	15797	16175	0.2058948839862589
M1	cpdb	0	network_modules	178	TRUE	1.728010050662242e-26	202	26	20	0.7692307692307693	0.09900990099009901	KEGG:05415	KEGG	Diabetic cardiomyopathy	8484	492		0.3	0.36363636363636365	202	8282	20	6	182	8276	8484	0.27108904157355357
M1	cpdb	0	network_modules	178	TRUE	1.1223154895671693e-25	221	26	20	0.7692307692307693	0.09049773755656108	KEGG:05208	KEGG	Chemical carcinogenesis - reactive oxygen species	8484	460		0.4	0.45454545454545453	221	8263	20	6	201	8257	8484	0.25869230364341256
M1	cpdb	0	network_modules	178	TRUE	3.3609544592340307e-25	349	27	20	0.7407407407407407	0.05730659025787966	GO:0006163	GO:BP	purine nucleotide metabolic process	16175	1998		0.8636363636363636	0.8666666666666667	349	15826	20	7	329	15819	16175	0.20239351240525527
M1	cpdb	0	network_modules	178	TRUE	2.9113494829621447e-24	388	27	20	0.7407407407407407	0.05154639175257732	GO:0009117	GO:BP	nucleotide metabolic process	16175	3286		0.8863636363636364	0.8888888888888888	388	15787	20	7	368	15780	16175	0.19154495467170918
M1	cpdb	0	network_modules	178	TRUE	4.780903419867815e-24	265	26	20	0.7692307692307693	0.07547169811320754	KEGG:05012	KEGG	Parkinson disease	8484	412		0.5	0.5454545454545454	265	8219	20	6	245	8213	8484	0.23522029027753247
M1	cpdb	0	network_modules	178	TRUE	7.57559132872888e-24	271	26	20	0.7692307692307693	0.07380073800738007	KEGG:05020	KEGG	Prion disease	8484	416		0.6	0.6363636363636364	271	8213	20	6	251	8207	8484	0.23246376768589788
M1	cpdb	0	network_modules	178	TRUE	8.537143356962239e-23	305	26	20	0.7692307692307693	0.06557377049180328	KEGG:05016	KEGG	Huntington disease	8484	414		0.7	0.7272727272727273	305	8179	20	6	285	8173	8484	0.218385475742137
M1	cpdb	0	network_modules	178	TRUE	1.361252026318296e-22	469	27	20	0.7407407407407407	0.042643923240938165	GO:0072521	GO:BP	purine-containing compound metabolic process	16175	17423		0.9090909090909091	0.9111111111111111	469	15706	20	7	449	15699	16175	0.17344917496905388
M1	cpdb	0	network_modules	178	TRUE	1.7866902855980721e-22	154	26	17	0.6538461538461539	0.11038961038961038	KEGG:04932	KEGG	Non-alcoholic fatty liver disease	8484	389		0.8	0.8181818181818182	154	8330	17	9	137	8321	8484	0.2640091482803621
M1	cpdb	0	network_modules	178	TRUE	8.000867087628339e-22	512	27	20	0.7407407407407407	0.0390625	GO:0090407	GO:BP	organophosphate biosynthetic process	16175	18274		0.9318181818181818	0.9333333333333333	512	15663	20	7	492	15656	16175	0.16561277787305229
M1	cpdb	0	network_modules	178	TRUE	8.655149856444641e-22	514	27	20	0.7407407407407407	0.038910505836575876	GO:1901137	GO:BP	carbohydrate derivative biosynthetic process	16175	21245		0.9545454545454546	0.9555555555555556	514	15661	20	7	494	15654	16175	0.16527198944706278
M1	cpdb	0	network_modules	178	TRUE	1.1368083091101708e-21	521	27	20	0.7407407407407407	0.03838771593090211	GO:0006753	GO:BP	nucleoside phosphate metabolic process	16175	2450		0.9772727272727273	0.9777777777777777	521	15654	20	7	501	15647	16175	0.16409443354669284
M1	cpdb	0	network_modules	178	TRUE	2.9568099542266114e-21	363	26	20	0.7692307692307693	0.05509641873278237	KEGG:05014	KEGG	Amyotrophic lateral sclerosis	8484	413		0.9	0.9090909090909091	363	8121	20	6	343	8115	8484	0.19902048243191586
M1	cpdb	0	network_modules	178	TRUE	4.524184006279563e-21	558	27	20	0.7407407407407407	0.035842293906810034	GO:0055086	GO:BP	nucleobase-containing small molecule metabolic process	16175	14237		1	1	558	15617	20	7	538	15610	16175	0.15823592461489075
M1	cpdb	0	network_modules	178	TRUE	8.31525753398251e-21	382	26	20	0.7692307692307693	0.05235602094240838	KEGG:05010	KEGG	Alzheimer disease	8484	411		1	1	382	8102	20	6	362	8096	8484	0.19363645105643762
M1	cpdb	0	network_modules	179	TRUE	2.1174054980565555e-9	367	24	11	0.4583333333333333	0.02997275204359673	GO:0005975	GO:BP	carbohydrate metabolic process	16175	1850		0	0.014492753623188406	367	15808	11	13	356	15795	16175	0.11277437809680861
M1	cpdb	0	network_modules	179	TRUE	1.0080650574108159e-8	115	21	8	0.38095238095238093	0.06956521739130435	KEGG:01200	KEGG	Carbon metabolism	8484	184		0	0.14285714285714285	115	8369	8	13	107	8356	8484	0.15826999006584805
M1	cpdb	0	network_modules	179	TRUE	8.967303700667056e-8	163	24	8	0.3333333333333333	0.049079754601226995	GO:0005996	GO:BP	monosaccharide metabolic process	16175	1871		0.014705882352941176	0.028985507246376812	163	16012	8	16	155	15996	16175	0.12476141028779222
M1	cpdb	0	network_modules	179	TRUE	9.306667904580599e-8	521	24	11	0.4583333333333333	0.02111324376199616	GO:0006753	GO:BP	nucleoside phosphate metabolic process	16175	2450		0.029411764705882353	0.043478260869565216	521	15654	11	13	510	15641	16175	0.09303659041306192
M1	cpdb	0	network_modules	179	TRUE	1.2767782090597765e-7	388	24	10	0.4166666666666667	0.02577319587628866	GO:0009117	GO:BP	nucleotide metabolic process	16175	3286		0.04411764705882353	0.057971014492753624	388	15787	10	14	378	15773	16175	0.09892868708513404
M1	cpdb	0	network_modules	179	TRUE	1.938438749102951e-7	558	24	11	0.4583333333333333	0.01971326164874552	GO:0055086	GO:BP	nucleobase-containing small molecule metabolic process	16175	14237		0.058823529411764705	0.07246376811594203	558	15617	11	13	547	15604	16175	0.08952241355635851
M1	cpdb	0	network_modules	179	TRUE	3.853415439354411e-7	288	21	9	0.42857142857142855	0.03125	REAC:R-HSA-71387	REAC	Metabolism of carbohydrates	10916	1422		0	0.25	288	10628	9	12	279	10616	10916	0.11017087477827077
M1	cpdb	0	network_modules	179	TRUE	6.012411818211323e-7	123	24	7	0.2916666666666667	0.056910569105691054	GO:0016052	GO:BP	carbohydrate catabolic process	16175	5084		0.07352941176470588	0.08695652173913043	123	16052	7	17	116	16035	16175	0.1260511258845168
M1	cpdb	0	network_modules	179	TRUE	6.607086317001669e-7	65	24	6	0.25	0.09230769230769231	GO:0046364	GO:BP	monosaccharide biosynthetic process	16175	12095		0.08823529411764706	0.10144927536231885	65	16110	6	18	59	16092	16175	0.14988152918463105
M1	cpdb	0	network_modules	179	TRUE	1.12820974363879e-6	74	21	6	0.2857142857142857	0.08108108108108109	KEGG:01230	KEGG	Biosynthesis of amino acids	8484	188		0.16666666666666666	0.2857142857142857	74	8410	6	15	68	8395	8484	0.14838892255055933
M1	cpdb	0	network_modules	179	TRUE	1.1444672762835888e-6	33	21	5	0.23809523809523808	0.15151515151515152	REAC:R-HSA-70263	REAC	Gluconeogenesis	10916	1052		0.3333333333333333	0.5	33	10883	5	16	28	10867	10916	0.18798770979694032
M1	cpdb	0	network_modules	179	TRUE	1.3526302032128244e-6	138	24	7	0.2916666666666667	0.050724637681159424	GO:0019362	GO:BP	pyridine nucleotide metabolic process	16175	5724		0.10294117647058823	0.13043478260869565	138	16037	7	17	131	16020	16175	0.11867045966069663
M1	cpdb	0	network_modules	179	TRUE	1.3526302032128244e-6	138	24	7	0.2916666666666667	0.050724637681159424	GO:0046496	GO:BP	nicotinamide nucleotide metabolic process	16175	12199		0.10294117647058823	0.13043478260869565	138	16037	7	17	131	16020	16175	0.11867045966069663
M1	cpdb	0	network_modules	179	TRUE	1.4230432209927798e-6	139	24	7	0.2916666666666667	0.050359712230215826	GO:1901292	GO:BP	nucleoside phosphate catabolic process	16175	21367		0.1323529411764706	0.14492753623188406	139	16036	7	17	132	16019	16175	0.11822068405087036
M1	cpdb	0	network_modules	179	TRUE	1.736812387361743e-6	143	24	7	0.2916666666666667	0.04895104895104895	GO:0072524	GO:BP	pyridine-containing compound metabolic process	16175	17426		0.14705882352941177	0.15942028985507245	143	16032	7	17	136	16015	16175	0.11646822364228615
M1	cpdb	0	network_modules	179	TRUE	2.3170731876694746e-6	149	24	7	0.2916666666666667	0.04697986577181208	GO:0019318	GO:BP	hexose metabolic process	16175	5681		0.16176470588235295	0.17391304347826086	149	16026	7	17	142	16009	16175	0.1139708119886462
M1	cpdb	0	network_modules	179	TRUE	1.0473628201665213e-5	16	24	4	0.16666666666666666	0.25	GO:0006735	GO:BP	NADH regeneration	16175	2436		0.17647058823529413	0.21739130434782608	16	16159	4	20	12	16139	16175	0.20316386454915059
M1	cpdb	0	network_modules	179	TRUE	1.0473628201665213e-5	16	24	4	0.16666666666666666	0.25	GO:0061718	GO:BP	glucose catabolic process to pyruvate	16175	15628		0.17647058823529413	0.21739130434782608	16	16159	4	20	12	16139	16175	0.20316386454915059
M1	cpdb	0	network_modules	179	TRUE	1.0473628201665213e-5	16	24	4	0.16666666666666666	0.25	GO:0061621	GO:BP	canonical glycolysis	16175	15590		0.17647058823529413	0.21739130434782608	16	16159	4	20	12	16139	16175	0.20316386454915059
M1	cpdb	0	network_modules	179	TRUE	1.0485466195974078e-5	185	24	7	0.2916666666666667	0.03783783783783784	GO:0046434	GO:BP	organophosphate catabolic process	16175	12142		0.22058823529411764	0.2318840579710145	185	15990	7	17	178	15973	16175	0.10159061526997411
M1	cpdb	0	network_modules	179	TRUE	1.3682729925989265e-5	17	24	4	0.16666666666666666	0.23529411764705882	GO:0061615	GO:BP	glycolytic process through fructose-6-phosphate	16175	15586		0.23529411764705882	0.2608695652173913	17	16158	4	20	13	16138	16175	0.19703044763732533
M1	cpdb	0	network_modules	179	TRUE	1.3682729925989265e-5	17	24	4	0.16666666666666666	0.23529411764705882	GO:0061620	GO:BP	glycolytic process through glucose-6-phosphate	16175	15589		0.23529411764705882	0.2608695652173913	17	16158	4	20	13	16138	16175	0.19703044763732533
M1	cpdb	0	network_modules	179	TRUE	2.2239223453534354e-5	19	24	4	0.16666666666666666	0.21052631578947367	GO:0019677	GO:BP	NAD catabolic process	16175	5995		0.2647058823529412	0.2898550724637681	19	16156	4	20	15	16136	16175	0.186244527810873
M1	cpdb	0	network_modules	179	TRUE	2.2239223453534354e-5	19	24	4	0.16666666666666666	0.21052631578947367	GO:0006007	GO:BP	glucose catabolic process	16175	1882		0.2647058823529412	0.2898550724637681	19	16156	4	20	15	16136	16175	0.186244527810873
M1	cpdb	0	network_modules	179	TRUE	2.3802622241755094e-5	117	24	6	0.25	0.05128205128205128	GO:0009166	GO:BP	nucleotide catabolic process	16175	3332		0.29411764705882354	0.30434782608695654	117	16058	6	18	111	16040	16175	0.11043341619713334
M1	cpdb	0	network_modules	179	TRUE	2.9675761601236866e-5	215	24	7	0.2916666666666667	0.03255813953488372	GO:0009141	GO:BP	nucleoside triphosphate metabolic process	16175	3308		0.3088235294117647	0.3188405797101449	215	15960	7	17	208	15943	16175	0.0937009631282118
M1	cpdb	0	network_modules	179	TRUE	3.1347729566405854e-5	67	21	5	0.23809523809523808	0.07462686567164178	KEGG:00010	KEGG	Glycolysis / Gluconeogenesis	8484	2		0.3333333333333333	0.42857142857142855	67	8417	5	16	62	8401	8484	0.12954887778784227
M1	cpdb	0	network_modules	179	TRUE	4.782643794439696e-5	63	24	5	0.20833333333333334	0.07936507936507936	GO:0019319	GO:BP	hexose biosynthetic process	16175	5682		0.3235294117647059	0.3333333333333333	63	16112	5	19	58	16093	16175	0.1265224943967709
M1	cpdb	0	network_modules	179	TRUE	4.815672687545428e-5	68	21	5	0.23809523809523808	0.07352941176470588	REAC:R-HSA-70171	REAC	Glycolysis	10916	1074		0.6666666666666666	0.75	68	10848	5	16	63	10832	10916	0.12937997160757578
M1	cpdb	0	network_modules	179	TRUE	5.3793301826130676e-5	31	21	4	0.19047619047619047	0.12903225806451613	KEGG:00030	KEGG	Pentose phosphate pathway	8484	4		0.5	0.5714285714285714	31	8453	4	17	27	8436	8484	0.15423767218906545
M1	cpdb	0	network_modules	179	TRUE	6.047219376542595e-5	372	24	8	0.3333333333333333	0.021505376344086023	GO:0006091	GO:BP	generation of precursor metabolites and energy	16175	1954		0.3382352941176471	0.34782608695652173	372	15803	8	16	364	15787	16175	0.07980673633467084
M1	cpdb	0	network_modules	179	TRUE	8.943139015632971e-5	6	24	3	0.125	0.5	GO:0009130	GO:BP	pyrimidine nucleoside monophosphate biosynthetic process	16175	3297		0.35294117647058826	0.36231884057971014	6	16169	3	21	3	16148	16175	0.249489518890329
M1	cpdb	0	network_modules	179	TRUE	9.345781631474353e-5	147	24	6	0.25	0.04081632653061224	GO:0016051	GO:BP	carbohydrate biosynthetic process	16175	5083		0.36764705882352944	0.37681159420289856	147	16028	6	18	141	16010	16175	0.09786110653644682
M1	cpdb	0	network_modules	179	TRUE	9.436578599033047e-5	72	24	5	0.20833333333333334	0.06944444444444445	GO:0006096	GO:BP	glycolytic process	16175	1956		0.38235294117647056	0.4057971014492754	72	16103	5	19	67	16084	16175	0.11806182271098369
M1	cpdb	0	network_modules	179	TRUE	9.436578599033047e-5	72	24	5	0.20833333333333334	0.06944444444444445	GO:0046032	GO:BP	ADP catabolic process	16175	11809		0.38235294117647056	0.4057971014492754	72	16103	5	19	67	16084	16175	0.11806182271098369
M1	cpdb	0	network_modules	179	TRUE	9.990172978933945e-5	27	24	4	0.16666666666666666	0.14814814814814814	GO:0006734	GO:BP	NADH metabolic process	16175	2435		0.4117647058823529	0.42028985507246375	27	16148	4	20	23	16128	16175	0.1558066942008116
M1	cpdb	0	network_modules	179	TRUE	1.0843233122548373e-4	74	24	5	0.20833333333333334	0.06756756756756757	GO:0009137	GO:BP	purine nucleoside diphosphate catabolic process	16175	3304		0.4264705882352941	0.463768115942029	74	16101	5	19	69	16082	16175	0.11639206642517382
M1	cpdb	0	network_modules	179	TRUE	1.0843233122548373e-4	74	24	5	0.20833333333333334	0.06756756756756757	GO:0009181	GO:BP	purine ribonucleoside diphosphate catabolic process	16175	3347		0.4264705882352941	0.463768115942029	74	16101	5	19	69	16082	16175	0.11639206642517382
M1	cpdb	0	network_modules	179	TRUE	1.0843233122548373e-4	74	24	5	0.20833333333333334	0.06756756756756757	GO:0046031	GO:BP	ADP metabolic process	16175	11808		0.4264705882352941	0.463768115942029	74	16101	5	19	69	16082	16175	0.11639206642517382
M1	cpdb	0	network_modules	179	TRUE	1.2411517304971272e-4	76	24	5	0.20833333333333334	0.06578947368421052	GO:0019364	GO:BP	pyridine nucleotide catabolic process	16175	5726		0.47058823529411764	0.4927536231884058	76	16099	5	19	71	16080	16175	0.11478781586853762
M1	cpdb	0	network_modules	179	TRUE	1.2411517304971272e-4	76	24	5	0.20833333333333334	0.06578947368421052	GO:0009179	GO:BP	purine ribonucleoside diphosphate metabolic process	16175	3345		0.47058823529411764	0.4927536231884058	76	16099	5	19	71	16080	16175	0.11478781586853762
M1	cpdb	0	network_modules	179	TRUE	1.326040833981366e-4	77	24	5	0.20833333333333334	0.06493506493506493	GO:0009135	GO:BP	purine nucleoside diphosphate metabolic process	16175	3302		0.5	0.5217391304347826	77	16098	5	19	72	16079	16175	0.11400892275878596
M1	cpdb	0	network_modules	179	TRUE	1.326040833981366e-4	77	24	5	0.20833333333333334	0.06493506493506493	GO:0009191	GO:BP	ribonucleoside diphosphate catabolic process	16175	3357		0.5	0.5217391304347826	77	16098	5	19	72	16079	16175	0.11400892275878596
M1	cpdb	0	network_modules	179	TRUE	1.5096336398658048e-4	79	24	5	0.20833333333333334	0.06329113924050633	GO:0072526	GO:BP	pyridine-containing compound catabolic process	16175	17428		0.5294117647058824	0.5362318840579711	79	16096	5	19	74	16077	16175	0.11249514344477511
M1	cpdb	0	network_modules	179	TRUE	1.5635251887141397e-4	7	24	3	0.125	0.42857142857142855	GO:0009129	GO:BP	pyrimidine nucleoside monophosphate metabolic process	16175	3296		0.5441176470588235	0.5507246376811594	7	16168	3	21	4	16147	16175	0.23087496910088323
M1	cpdb	0	network_modules	179	TRUE	1.573752337945435e-4	86	21	5	0.23809523809523808	0.05813953488372093	REAC:R-HSA-70326	REAC	Glucose metabolism	10916	1053		1	1	86	10830	5	16	81	10814	10916	0.11432291620966685
M1	cpdb	0	network_modules	179	TRUE	1.8222841321506976e-4	82	24	5	0.20833333333333334	0.06097560975609756	GO:0009134	GO:BP	nucleoside diphosphate catabolic process	16175	3301		0.5588235294117647	0.5652173913043478	82	16093	5	19	77	16074	16175	0.11032775239916728
M1	cpdb	0	network_modules	179	TRUE	1.9532935805735744e-4	283	24	7	0.2916666666666667	0.024734982332155476	GO:0019693	GO:BP	ribose phosphate metabolic process	16175	6010		0.5735294117647058	0.5797101449275363	283	15892	7	17	276	15875	16175	0.08060991780069245
M1	cpdb	0	network_modules	179	TRUE	2.1842476362494292e-4	85	24	5	0.20833333333333334	0.058823529411764705	GO:0009185	GO:BP	ribonucleoside diphosphate metabolic process	16175	3351		0.5882352941176471	0.5942028985507246	85	16090	5	19	80	16071	16175	0.10827451763826942
M1	cpdb	0	network_modules	179	TRUE	2.6216757834744833e-4	34	24	4	0.16666666666666666	0.11764705882352941	GO:0019320	GO:BP	hexose catabolic process	16175	5683		0.6029411764705882	0.6086956521739131	34	16141	4	20	30	16121	16175	0.1385103077811109
M1	cpdb	0	network_modules	179	TRUE	2.9122454789603776e-4	90	24	5	0.20833333333333334	0.05555555555555555	GO:0009154	GO:BP	purine ribonucleotide catabolic process	16175	3321		0.6176470588235294	0.6231884057971014	90	16085	5	19	85	16066	16175	0.10508007716222703
M1	cpdb	0	network_modules	179	TRUE	3.252271387951704e-4	92	24	5	0.20833333333333334	0.05434782608695652	GO:0009261	GO:BP	ribonucleotide catabolic process	16175	3426		0.6323529411764706	0.6376811594202898	92	16083	5	19	87	16064	16175	0.10387470762965521
M1	cpdb	0	network_modules	179	TRUE	3.4336868142841514e-4	93	24	5	0.20833333333333334	0.053763440860215055	GO:0009132	GO:BP	nucleoside diphosphate metabolic process	16175	3299		0.6470588235294118	0.6521739130434783	93	16082	5	19	88	16063	16175	0.10328642355870149
M1	cpdb	0	network_modules	179	TRUE	3.7225067479315904e-4	37	24	4	0.16666666666666666	0.10810810810810811	GO:0046365	GO:BP	monosaccharide catabolic process	16175	12096		0.6617647058823529	0.6666666666666666	37	16138	4	20	33	16118	16175	0.13263902154438909
M1	cpdb	0	network_modules	179	TRUE	4.02652388735314e-4	96	24	5	0.20833333333333334	0.052083333333333336	GO:0006090	GO:BP	pyruvate metabolic process	16175	1953		0.6764705882352942	0.6811594202898551	96	16079	5	19	91	16060	16175	0.10157616616915773
M1	cpdb	0	network_modules	179	TRUE	4.697701067125454e-4	99	24	5	0.20833333333333334	0.050505050505050504	GO:0006195	GO:BP	purine nucleotide catabolic process	16175	2024		0.6911764705882353	0.6956521739130435	99	16076	5	19	94	16057	16175	0.09994295794365361
M1	cpdb	0	network_modules	179	TRUE	5.142158783368583e-4	196	24	6	0.25	0.030612244897959183	GO:1901136	GO:BP	carbohydrate derivative catabolic process	16175	21244		0.7058823529411765	0.7101449275362319	196	15979	6	18	190	15961	16175	0.0838127180527561
M1	cpdb	0	network_modules	179	TRUE	6.032009903669477e-4	56	21	4	0.19047619047619047	0.07142857142857142	KEGG:00480	KEGG	Glutathione metabolism	8484	61		0.6666666666666666	0.7142857142857143	56	8428	4	17	52	8411	8484	0.11311385359660081
M1	cpdb	0	network_modules	179	TRUE	8.081831148705464e-4	349	24	7	0.2916666666666667	0.02005730659025788	GO:0006163	GO:BP	purine nucleotide metabolic process	16175	1998		0.7205882352941176	0.7246376811594203	349	15826	7	17	342	15809	16175	0.07165733777127715
M1	cpdb	0	network_modules	179	TRUE	0.0010360093832625565	116	24	5	0.20833333333333334	0.04310344827586207	GO:0072523	GO:BP	purine-containing compound catabolic process	16175	17425		0.7352941176470589	0.7391304347826086	116	16059	5	19	111	16040	16175	0.09189828594819269
M1	cpdb	0	network_modules	179	TRUE	0.0011762436886734971	119	24	5	0.20833333333333334	0.04201680672268908	GO:0006006	GO:BP	glucose metabolic process	16175	1881		0.75	0.7536231884057971	119	16056	5	19	114	16037	16175	0.09065732277126501
M1	cpdb	0	network_modules	179	TRUE	0.00188833178656901	55	24	4	0.16666666666666666	0.07272727272727272	GO:0019674	GO:BP	NAD metabolic process	16175	5993		0.7647058823529411	0.7681159420289855	55	16120	4	20	51	16100	16175	0.10811427540071517
M1	cpdb	0	network_modules	179	TRUE	0.0020168021160694542	15	24	3	0.125	0.2	GO:0006221	GO:BP	pyrimidine nucleotide biosynthetic process	16175	2044		0.7794117647058824	0.782608695652174	15	16160	3	21	12	16139	16175	0.15713029557594074
M1	cpdb	0	network_modules	179	TRUE	0.0023779606691678597	79	21	4	0.19047619047619047	0.05063291139240506	KEGG:00983	KEGG	Drug metabolism - other enzymes	8484	157		0.8333333333333334	0.8571428571428571	79	8405	4	17	75	8388	8484	0.09395911984338853
M1	cpdb	0	network_modules	179	TRUE	0.0026865693280671023	60	24	4	0.16666666666666666	0.06666666666666667	GO:0006094	GO:BP	gluconeogenesis	16175	1955		0.7941176470588235	0.7971014492753623	60	16115	4	20	56	16095	16175	0.10333158190001307
M1	cpdb	0	network_modules	179	TRUE	0.0032968362412703106	2	24	2	0.08333333333333333	1	GO:0009177	GO:BP	pyrimidine deoxyribonucleoside monophosphate biosynthetic process	16175	3343		0.8088235294117647	0.8405797101449275	2	16173	2	22	0	16151	16175	0.28847872656338225
M1	cpdb	0	network_modules	179	TRUE	0.0032968362412703106	2	24	2	0.08333333333333333	1	GO:0046073	GO:BP	dTMP metabolic process	16175	11850		0.8088235294117647	0.8405797101449275	2	16173	2	22	0	16151	16175	0.28847872656338225
M1	cpdb	0	network_modules	179	TRUE	0.0032968362412703106	2	24	2	0.08333333333333333	1	GO:0006231	GO:BP	dTMP biosynthetic process	16175	2053		0.8088235294117647	0.8405797101449275	2	16173	2	22	0	16151	16175	0.28847872656338225
M1	cpdb	0	network_modules	179	TRUE	0.003796894706182494	276	24	6	0.25	0.021739130434782608	GO:0009259	GO:BP	ribonucleotide metabolic process	16175	3424		0.8529411764705882	0.855072463768116	276	15899	6	18	270	15881	16175	0.06933436542803655
M1	cpdb	0	network_modules	179	TRUE	0.004278419411008274	19	24	3	0.125	0.15789473684210525	GO:0006098	GO:BP	pentose-phosphate shunt	16175	1958		0.8676470588235294	0.8695652173913043	19	16156	3	21	16	16135	16175	0.1393529077787942
M1	cpdb	0	network_modules	179	TRUE	0.004288643591038605	448	24	7	0.2916666666666667	0.015625	GO:0034655	GO:BP	nucleobase-containing compound catabolic process	16175	8711		0.8823529411764706	0.8840579710144928	448	15727	7	17	441	15710	16175	0.06200720716976161
M1	cpdb	0	network_modules	179	TRUE	0.005807071397301563	469	24	7	0.2916666666666667	0.014925373134328358	GO:0072521	GO:BP	purine-containing compound metabolic process	16175	17423		0.8970588235294118	0.8985507246376812	469	15706	7	17	462	15689	16175	0.06034532254082925
M1	cpdb	0	network_modules	179	TRUE	0.0058609106943852286	21	24	3	0.125	0.14285714285714285	GO:0072528	GO:BP	pyrimidine-containing compound biosynthetic process	16175	17430		0.9117647058823529	0.9130434782608695	21	16154	3	21	18	16133	16175	0.1324268911233211
M1	cpdb	0	network_modules	179	TRUE	0.006779710287488683	22	24	3	0.125	0.13636363636363635	GO:0006740	GO:BP	NADPH regeneration	16175	2439		0.9264705882352942	0.927536231884058	22	16153	3	21	19	16132	16175	0.1293215278126346
M1	cpdb	0	network_modules	179	TRUE	0.006955228745253634	482	24	7	0.2916666666666667	0.014522821576763486	GO:0044283	GO:BP	small molecule biosynthetic process	16175	10950		0.9411764705882353	0.9420289855072463	482	15693	7	17	475	15676	16175	0.05936841483000995
M1	cpdb	0	network_modules	179	TRUE	0.007789075887658279	23	24	3	0.125	0.13043478260869565	GO:0009124	GO:BP	nucleoside monophosphate biosynthetic process	16175	3291		0.9558823529411765	0.9565217391304348	23	16152	3	21	20	16131	16175	0.12641961913648028
M1	cpdb	0	network_modules	179	TRUE	0.008389788579208754	109	21	4	0.19047619047619047	0.03669724770642202	KEGG:04066	KEGG	HIF-1 signaling pathway	8484	257		1	1	109	8375	4	17	105	8358	8484	0.07856969593361632
M1	cpdb	0	network_modules	179	TRUE	0.009329604801346576	504	24	7	0.2916666666666667	0.013888888888888888	GO:0032787	GO:BP	monocarboxylic acid metabolic process	16175	7822		0.9705882352941176	0.9710144927536232	504	15671	7	17	497	15654	16175	0.05779719473340078
M1	cpdb	0	network_modules	179	TRUE	0.009881539404908083	3	24	2	0.08333333333333333	0.6666666666666666	GO:0009176	GO:BP	pyrimidine deoxyribonucleoside monophosphate metabolic process	16175	3342		0.9852941176470589	1	3	16172	2	22	1	16150	16175	0.23537416597204877
M1	cpdb	0	network_modules	179	TRUE	0.009881539404908083	3	24	2	0.08333333333333333	0.6666666666666666	GO:0009157	GO:BP	deoxyribonucleoside monophosphate biosynthetic process	16175	3324		0.9852941176470589	1	3	16172	2	22	1	16150	16175	0.23537416597204877
M1	cpdb	0	network_modules	181	TRUE	3.314398632017537e-11	6	23	5	0.21739130434782608	0.8333333333333334	GO:0016255	GO:BP	attachment of GPI anchor to protein	16175	5186		0	0.5	6	16169	5	18	1	16151	16175	0.4252833020674166
M1	cpdb	0	network_modules	181	TRUE	4.2948935396046823e-11	7	18	5	0.2777777777777778	0.7142857142857143	REAC:R-HSA-162791	REAC	Attachment of GPI anchor to uPAR	10916	188		0	0.5	7	10909	5	13	2	10896	10916	0.4449166328433775
M1	cpdb	0	network_modules	181	TRUE	2.1503911794107557e-10	91	18	8	0.4444444444444444	0.08791208791208792	REAC:R-HSA-163125	REAC	Post-translational modification: synthesis of GPI-anchored proteins	10916	1775		1	1	91	10825	8	10	83	10815	10916	0.19493321240929778
M1	cpdb	0	network_modules	181	TRUE	4.8222670979213016e-8	26	16	5	0.3125	0.19230769230769232	KEGG:00563	KEGG	Glycosylphosphatidylinositol (GPI)-anchor biosynthesis	8484	87		0	0.25	26	8458	5	11	21	8447	8484	0.24334348274946357
M1	cpdb	0	network_modules	181	TRUE	7.144372995976435e-7	15	16	4	0.25	0.26666666666666666	KEGG:00730	KEGG	Thiamine metabolism	8484	118		0.3333333333333333	0.5	15	8469	4	12	11	8457	8484	0.2568421150169717
M1	cpdb	0	network_modules	181	TRUE	9.170543711301648e-7	31	23	5	0.21739130434782608	0.16129032258064516	GO:0180046	GO:BP	GPI anchored protein biosynthesis	16175	20314		1	1	31	16144	5	18	26	16126	16175	0.1859109849439498
M1	cpdb	0	network_modules	181	TRUE	9.061507140871791e-6	27	16	4	0.25	0.14814814814814814	KEGG:00790	KEGG	Folate biosynthesis	8484	125		0.6666666666666666	0.75	27	8457	4	12	23	8445	8484	0.1904829887181242
M1	cpdb	0	network_modules	181	TRUE	0.009818959584523196	153	16	4	0.25	0.026143790849673203	KEGG:01240	KEGG	Biosynthesis of cofactors	8484	190		1	1	153	8331	4	12	149	8319	8484	0.0757705392539701
M1	cpdb	0	network_modules	182	TRUE	1.9294115359879064e-4	22	12	3	0.25	0.13636363636363635	KEGG:00900	KEGG	Terpenoid backbone biosynthesis	8484	129		NA	1	22	8462	3	9	19	8453	8484	0.18308899346777507
M1	cpdb	0	network_modules	182	TRUE	0.004204086732519456	22	21	3	0.14285714285714285	0.13636363636363635	GO:0008299	GO:BP	isoprenoid biosynthetic process	16175	3159		NA	1	22	16153	3	18	19	16135	16175	0.13842777919895227
M1	cpdb	0	network_modules	184	TRUE	8.466723357895042e-5	16	13	3	0.23076923076923078	0.1875	KEGG:00450	KEGG	Selenocompound metabolism	8484	58		NA	1	16	8468	3	10	13	8458	8484	0.2066658594533381
M1	cpdb	0	network_modules	184	TRUE	0.001661426593849282	3	15	2	0.13333333333333333	0.6666666666666666	REAC:R-HSA-2408550	REAC	Metabolism of ingested H2SeO4 and H2SeO3 into H2Se	10916	1426		0	0.5	3	10913	2	13	1	10900	10916	0.29777342010998115
M1	cpdb	0	network_modules	184	TRUE	0.001768277833263965	370	15	6	0.4	0.016216216216216217	REAC:R-HSA-71291	REAC	Metabolism of amino acids and derivatives	10916	1421		1	1	370	10546	6	9	364	10537	10916	0.07504757516497622
M1	cpdb	0	network_modules	185	TRUE	2.7264062008637062e-11	8	14	5	0.35714285714285715	0.625	REAC:R-HSA-446388	REAC	Regulation of cytoskeletal remodeling and cell spreading by IPP complex components	10916	2026		0	0.25	8	10908	5	9	3	10899	10916	0.47196170781512053
M1	cpdb	0	network_modules	185	TRUE	4.1428040602776925e-9	18	14	5	0.35714285714285715	0.2777777777777778	REAC:R-HSA-446353	REAC	Cell-extracellular matrix interactions	10916	330		0.3333333333333333	0.5	18	10898	5	9	13	10889	10916	0.3139763644542408
M1	cpdb	0	network_modules	185	TRUE	1.4165584874826402e-6	86	21	6	0.2857142857142857	0.06976744186046512	GO:0034446	GO:BP	substrate adhesion-dependent cell spreading	16175	8640		0	0.5	86	16089	6	15	80	16074	16175	0.1390190089818859
M1	cpdb	0	network_modules	185	TRUE	1.7466171036307353e-6	279	21	8	0.38095238095238093	0.02867383512544803	GO:0031589	GO:BP	cell-substrate adhesion	16175	7233		1	1	279	15896	8	13	271	15883	16175	0.10071992578128343
M1	cpdb	0	network_modules	185	TRUE	6.643242309128801e-5	114	14	5	0.35714285714285715	0.043859649122807015	REAC:R-HSA-446728	REAC	Cell junction organization	10916	324		0.6666666666666666	0.75	114	10802	5	9	109	10793	10916	0.12221460915196215
M1	cpdb	0	network_modules	185	TRUE	2.6112092053516886e-4	150	14	5	0.35714285714285715	0.03333333333333333	REAC:R-HSA-1500931	REAC	Cell-Cell communication	10916	328		1	1	150	10766	5	9	145	10757	10916	0.10570703768696453
M1	cpdb	0	network_modules	186	TRUE	2.110251465099678e-8	81	23	7	0.30434782608695654	0.08641975308641975	GO:0007565	GO:BP	female pregnancy	16175	3043		0	0.2	81	16094	7	16	74	16078	16175	0.16002411834164865
M1	cpdb	0	network_modules	186	TRUE	4.8695714485424004e-8	91	23	7	0.30434782608695654	0.07692307692307693	GO:0044703	GO:BP	multi-organism reproductive process	16175	11118		0.25	0.4	91	16084	7	16	84	16068	16175	0.15071078464063734
M1	cpdb	0	network_modules	186	TRUE	6.142145788922723e-8	94	23	7	0.30434782608695654	0.07446808510638298	GO:0044706	GO:BP	multi-multicellular organism process	16175	11119		0.5	0.6	94	16081	7	16	87	16065	16175	0.14820807844711162
M1	cpdb	0	network_modules	186	TRUE	2.6982144397935586e-7	191	20	8	0.4	0.041884816753926704	REAC:R-HSA-202733	REAC	Cell surface interactions at the vascular wall	10916	327		NA	1	191	10725	8	12	183	10713	10916	0.12498681562281261
M1	cpdb	0	network_modules	186	TRUE	0.0031299824748898487	365	11	5	0.45454545454545453	0.0136986301369863	KEGG:04080	KEGG	Neuroactive ligand-receptor interaction	8484	263		NA	1	365	8119	5	6	360	8113	8484	0.07307605949994372
M1	cpdb	0	network_modules	186	TRUE	0.0038269122452394126	69	23	4	0.17391304347826086	0.057971014492753624	GO:0007218	GO:BP	neuropeptide signaling pathway	16175	2772		0.75	0.8	69	16106	4	19	65	16087	16175	0.09822529925244423
M1	cpdb	0	network_modules	186	TRUE	0.008783952978863854	3	23	2	0.08695652173913043	0.6666666666666666	GO:0042756	GO:BP	drinking behavior	16175	10349		1	1	3	16172	2	21	1	16151	16175	0.24045145819458102
M1	cpdb	0	network_modules	187	TRUE	1.1046729596474314e-10	41	10	6	0.6	0.14634146341463414	KEGG:03440	KEGG	Homologous recombination	8484	240		0	0.5	41	8443	6	4	35	8439	8484	0.29481883307803824
M1	cpdb	0	network_modules	187	TRUE	3.1845744691854415e-10	27	16	6	0.375	0.2222222222222222	REAC:R-HSA-5693554	REAC	Resolution of D-loop Structures through Synthesis-Dependent Strand Annealing (SDSA)	10916	2078		0	0.05	27	10889	6	10	21	10879	10916	0.28733705617151595
M1	cpdb	0	network_modules	187	TRUE	1.4389419984655033e-9	34	16	6	0.375	0.17647058823529413	REAC:R-HSA-5693568	REAC	Resolution of D-loop Structures through Holliday Junction Intermediates	10916	2077		0.05263157894736842	0.1	34	10882	6	10	28	10872	10916	0.2556969035346437
M1	cpdb	0	network_modules	187	TRUE	1.735287295880192e-9	35	16	6	0.375	0.17142857142857143	REAC:R-HSA-5693537	REAC	Resolution of D-Loop Structures	10916	2076		0.10526315789473684	0.15	35	10881	6	10	29	10871	10916	0.2519671161363965
M1	cpdb	0	network_modules	187	TRUE	6.476658367668814e-9	43	16	6	0.375	0.13953488372093023	REAC:R-HSA-5693579	REAC	Homologous DNA Pairing and Strand Exchange	10916	1129		0.15789473684210525	0.2	43	10873	6	10	37	10863	10916	0.22695850239070323
M1	cpdb	0	network_modules	187	TRUE	4.538168516748687e-8	24	16	5	0.3125	0.20833333333333334	REAC:R-HSA-9709603	REAC	Impaired BRCA2 binding to PALB2	10916	1172		0.21052631578947367	0.25	24	10892	5	11	19	10881	10916	0.25382509454015084
M1	cpdb	0	network_modules	187	TRUE	5.6679398908668936e-8	25	16	5	0.3125	0.2	REAC:R-HSA-9701193	REAC	Defective homologous recombination repair (HRR) due to PALB2 loss of function	10916	699		0.2631578947368421	0.45	25	10891	5	11	20	10880	10916	0.24863477867486725
M1	cpdb	0	network_modules	187	TRUE	5.6679398908668936e-8	25	16	5	0.3125	0.2	REAC:R-HSA-9704331	REAC	Defective HDR through Homologous Recombination Repair (HRR) due to PALB2 loss of BRCA1 binding function	10916	562		0.2631578947368421	0.45	25	10891	5	11	20	10880	10916	0.24863477867486725
M1	cpdb	0	network_modules	187	TRUE	5.6679398908668936e-8	25	16	5	0.3125	0.2	REAC:R-HSA-9701192	REAC	Defective homologous recombination repair (HRR) due to BRCA1 loss of function	10916	697		0.2631578947368421	0.45	25	10891	5	11	20	10880	10916	0.24863477867486725
M1	cpdb	0	network_modules	187	TRUE	5.6679398908668936e-8	25	16	5	0.3125	0.2	REAC:R-HSA-9704646	REAC	Defective HDR through Homologous Recombination Repair (HRR) due to PALB2 loss of BRCA2/RAD51/RAD51C binding function	10916	563		0.2631578947368421	0.45	25	10891	5	11	20	10880	10916	0.24863477867486725
M1	cpdb	0	network_modules	187	TRUE	1.1400989979930259e-7	68	16	6	0.375	0.08823529411764706	REAC:R-HSA-5685942	REAC	HDR through Homologous Recombination (HRR)	10916	1097		0.47368421052631576	0.5	68	10848	6	10	62	10838	10916	0.1795714455445872
M1	cpdb	0	network_modules	187	TRUE	7.88767324846389e-7	41	16	5	0.3125	0.12195121951219512	REAC:R-HSA-9675136	REAC	Diseases of DNA Double-Strand Break Repair	10916	757		0.5263157894736842	0.6	41	10875	5	11	36	10864	10916	0.19337587799038708
M1	cpdb	0	network_modules	187	TRUE	7.88767324846389e-7	41	16	5	0.3125	0.12195121951219512	REAC:R-HSA-9701190	REAC	Defective homologous recombination repair (HRR) due to BRCA2 loss of function	10916	698		0.5263157894736842	0.6	41	10875	5	11	36	10864	10916	0.19337587799038708
M1	cpdb	0	network_modules	187	TRUE	2.213226312542e-6	50	16	5	0.3125	0.1	REAC:R-HSA-9675135	REAC	Diseases of DNA repair	10916	758		0.631578947368421	0.65	50	10866	5	11	45	10855	10916	0.17471399930099232
M1	cpdb	0	network_modules	187	TRUE	4.377859045667499e-6	172	23	7	0.30434782608695654	0.040697674418604654	GO:0000724	GO:BP	double-strand break repair via homologous recombination	16175	203		0	0.16666666666666666	172	16003	7	16	165	15987	16175	0.10805751391981787
M1	cpdb	0	network_modules	187	TRUE	4.451291590743172e-6	281	23	8	0.34782608695652173	0.028469750889679714	GO:0006310	GO:BP	DNA recombination	16175	2115		0.2	0.3333333333333333	281	15894	8	15	273	15879	16175	0.09544117461885149
M1	cpdb	0	network_modules	187	TRUE	5.138922625140055e-6	176	23	7	0.30434782608695654	0.03977272727272727	GO:0000725	GO:BP	recombinational repair	16175	204		0.4	0.5	176	15999	7	16	169	15983	16175	0.10674593174506464
M1	cpdb	0	network_modules	187	TRUE	6.483308451051515e-6	132	16	6	0.375	0.045454545454545456	REAC:R-HSA-5693567	REAC	HDR through Homologous Recombination (HRR) or Single Strand Annealing (SSA)	10916	1098		0.6842105263157895	0.7	132	10784	6	10	126	10774	10916	0.1272124150235321
M1	cpdb	0	network_modules	187	TRUE	7.061684213744595e-6	298	23	8	0.34782608695652173	0.026845637583892617	GO:0006302	GO:BP	double-strand break repair	16175	2109		0.6	0.6666666666666666	298	15877	8	15	290	15862	16175	0.09243356741742612
M1	cpdb	0	network_modules	187	TRUE	8.467760960860595e-6	138	16	6	0.375	0.043478260869565216	REAC:R-HSA-5693538	REAC	Homology Directed Repair	10916	1130		0.7368421052631579	0.75	138	10778	6	10	132	10768	10916	0.12426233163576855
M1	cpdb	0	network_modules	187	TRUE	1.8359549696042907e-5	54	10	4	0.4	0.07407407407407407	KEGG:03460	KEGG	Fanconi anemia pathway	8484	242		1	1	54	8430	4	6	50	8424	8484	0.17003548140603927
M1	cpdb	0	network_modules	187	TRUE	2.7456980700578403e-5	168	16	6	0.375	0.03571428571428571	REAC:R-HSA-5693532	REAC	DNA Double-Strand Break Repair	10916	443		0.7894736842105263	0.8	168	10748	6	10	162	10738	10916	0.11192400811781146
M1	cpdb	0	network_modules	187	TRUE	6.1516949064631e-5	329	16	7	0.4375	0.02127659574468085	REAC:R-HSA-73894	REAC	DNA Repair	10916	444		0.8421052631578947	0.85	329	10587	7	9	322	10578	10916	0.09128618352948653
M1	cpdb	0	network_modules	187	TRUE	8.734558834684581e-5	40	16	4	0.25	0.1	REAC:R-HSA-5693616	REAC	Presynaptic phase of homologous DNA pairing and strand exchange	10916	1793		0.8947368421052632	0.9	40	10876	4	12	36	10864	10916	0.1561970939140911
M1	cpdb	0	network_modules	187	TRUE	1.3268737583468042e-4	7	23	3	0.13043478260869565	0.42857142857142855	GO:0045003	GO:BP	double-strand break repair via synthesis-dependent strand annealing	16175	11221		0.8	0.8333333333333334	7	16168	3	20	4	16148	16175	0.23586742795786067
M1	cpdb	0	network_modules	187	TRUE	5.892833530956899e-4	528	23	8	0.34782608695652173	0.015151515151515152	GO:0006281	GO:BP	DNA repair	16175	2095		1	1	528	15647	8	15	520	15632	16175	0.06693072068012786
M1	cpdb	0	network_modules	187	TRUE	6.456087096540229e-4	2	16	2	0.125	1	REAC:R-HSA-3359467	REAC	Defective MTRR causes HMAE	10916	588		0.9473684210526315	1	2	10914	2	14	0	10900	10916	0.35332655644370065
M1	cpdb	0	network_modules	187	TRUE	6.456087096540229e-4	2	16	2	0.125	1	REAC:R-HSA-3359469	REAC	Defective MTR causes HMAG	10916	587		0.9473684210526315	1	2	10914	2	14	0	10900	10916	0.35332655644370065
M1	cpdb	0	network_modules	188	TRUE	3.7303619798021115e-8	19	21	5	0.23809523809523808	0.2631578947368421	GO:0030150	GO:BP	protein import into mitochondrial matrix	16175	6684		0	0.1111111111111111	19	16156	5	16	14	16140	16175	0.24938651861283453
M1	cpdb	0	network_modules	188	TRUE	1.1925698263323847e-6	36	21	5	0.23809523809523808	0.1388888888888889	GO:0044743	GO:BP	protein transmembrane import into intracellular organelle	16175	11137		0.125	0.2222222222222222	36	16139	5	16	31	16123	16175	0.18046636560972235
M1	cpdb	0	network_modules	188	TRUE	1.6302136522272812e-6	88	21	6	0.2857142857142857	0.06818181818181818	GO:1990542	GO:BP	mitochondrial transmembrane transport	16175	25201		0.25	0.3333333333333333	88	16087	6	15	82	16072	16175	0.13737810408135936
M1	cpdb	0	network_modules	188	TRUE	3.836274037433408e-6	45	21	5	0.23809523809523808	0.1111111111111111	GO:0170036	GO:BP	import into the mitochondrion	16175	20284		0.375	0.4444444444444444	45	16130	5	16	40	16114	16175	0.16107816954742923
M1	cpdb	0	network_modules	188	TRUE	5.9677907374180595e-6	49	21	5	0.23809523809523808	0.10204081632653061	GO:0071806	GO:BP	protein transmembrane transport	16175	16919		0.5	0.5555555555555556	49	16126	5	16	44	16110	16175	0.15422050113854963
M1	cpdb	0	network_modules	188	TRUE	5.174433059587531e-5	156	21	6	0.2857142857142857	0.038461538461538464	GO:0006839	GO:BP	mitochondrial transport	16175	2508		0.625	0.6666666666666666	156	16019	6	15	150	16004	16175	0.10184805860892704
M1	cpdb	0	network_modules	188	TRUE	2.1477674286317838e-4	99	21	5	0.23809523809523808	0.050505050505050504	GO:0006626	GO:BP	protein targeting to mitochondrion	16175	2340		0.75	0.7777777777777778	99	16076	5	16	94	16060	16175	0.10723779828201721
M1	cpdb	0	network_modules	188	TRUE	3.641998770603461e-4	110	21	5	0.23809523809523808	0.045454545454545456	GO:0072655	GO:BP	establishment of protein localization to mitochondrion	16175	17476		0.875	0.8888888888888888	110	16065	5	16	105	16049	16175	0.10147118231314238
M1	cpdb	0	network_modules	188	TRUE	4.956972536978752e-4	117	21	5	0.23809523809523808	0.042735042735042736	GO:0070585	GO:BP	protein localization to mitochondrion	16175	16190		1	1	117	16058	5	16	112	16042	16175	0.09822621679198683
M1	cpdb	0	network_modules	188	TRUE	0.0027211736110015518	65	8	3	0.375	0.046153846153846156	REAC:R-HSA-1268020	REAC	Mitochondrial protein import	10916	1468		NA	1	65	10851	3	5	62	10846	10916	0.1299045123006289
M1	cpdb	0	network_modules	189	TRUE	3.339359545213999e-6	28	11	4	0.36363636363636365	0.14285714285714285	REAC:R-HSA-525793	REAC	Myogenesis	10916	1504		0	0.2	28	10888	4	7	24	10881	10916	0.22671849934644367
M1	cpdb	0	network_modules	189	TRUE	3.525053172606614e-5	347	24	8	0.3333333333333333	0.023054755043227664	GO:0007507	GO:BP	heart development	16175	2993		0	0.5	347	15828	8	16	339	15812	16175	0.08297755407544831
M1	cpdb	0	network_modules	189	TRUE	8.367891813927e-5	61	11	4	0.36363636363636365	0.06557377049180328	REAC:R-HSA-198725	REAC	Nuclear Events (kinase and transcription factor activation)	10916	1614		0.25	0.4	61	10855	4	7	57	10848	10916	0.1525487810671742
M1	cpdb	0	network_modules	189	TRUE	7.933220412708321e-4	211	24	6	0.25	0.02843601895734597	GO:0048568	GO:BP	embryonic organ development	16175	12840		1	1	211	15964	6	18	205	15946	16175	0.08050156388712533
M1	cpdb	0	network_modules	189	TRUE	8.003763867779026e-4	138	10	4	0.4	0.028985507246376812	KEGG:04371	KEGG	Apelin signaling pathway	8484	308		0	0.5	138	8346	4	6	134	8340	8484	0.10420968342926977
M1	cpdb	0	network_modules	189	TRUE	9.700500105358374e-4	112	11	4	0.36363636363636365	0.03571428571428571	REAC:R-HSA-187037	REAC	Signaling by NTRK1 (TRKA)	10916	2284		0.5	0.6	112	10804	4	7	108	10797	10916	0.11137379692437539
M1	cpdb	0	network_modules	189	TRUE	0.0015839106256458919	164	10	4	0.4	0.024390243902439025	KEGG:04022	KEGG	cGMP-PKG signaling pathway	8484	251		1	1	164	8320	4	6	160	8314	8484	0.09497754057070729
M1	cpdb	0	network_modules	189	TRUE	0.001812112717273187	131	11	4	0.36363636363636365	0.030534351145038167	REAC:R-HSA-166520	REAC	Signaling by NTRKs	10916	2287		0.75	0.8	131	10785	4	7	127	10778	10916	0.10256381984960164
M1	cpdb	0	network_modules	189	TRUE	0.007622787767750788	8	11	2	0.18181818181818182	0.25	REAC:R-HSA-8951671	REAC	RUNX3 regulates YAP1-mediated transcription	10916	1937		1	1	8	10908	2	9	6	10899	10916	0.21252631092836188
M1	cpdb	0	network_modules	190	TRUE	1.806499489590138e-13	33	25	8	0.32	0.24242424242424243	GO:0045730	GO:BP	respiratory burst	16175	11572		0	0.2	33	16142	8	17	25	16125	16175	0.27724557539143224
M1	cpdb	0	network_modules	190	TRUE	1.493867916243029e-12	24	19	7	0.3684210526315789	0.2916666666666667	REAC:R-HSA-5668599	REAC	RHO GTPases Activate NADPH Oxidases	10916	1849		0	0.07142857142857142	24	10892	7	12	17	10880	10916	0.326491871024511
M1	cpdb	0	network_modules	190	TRUE	4.825063532994881e-12	94	19	9	0.47368421052631576	0.09574468085106383	REAC:R-HSA-9013423	REAC	RAC3 GTPase cycle	10916	1838		0.07692307692307693	0.14285714285714285	94	10822	9	10	85	10812	10916	0.21017946649273195
M1	cpdb	0	network_modules	190	TRUE	1.3311337339147748e-8	34	25	6	0.24	0.17647058823529413	GO:0042554	GO:BP	superoxide anion generation	16175	10244		0.25	0.4	34	16141	6	19	28	16122	16175	0.20436857987076248
M1	cpdb	0	network_modules	190	TRUE	1.1498877629070599e-7	184	19	8	0.42105263157894735	0.043478260869565216	REAC:R-HSA-9013149	REAC	RAC1 GTPase cycle	10916	1836		0.15384615384615385	0.21428571428571427	184	10732	8	11	176	10721	10916	0.13110833674603398
M1	cpdb	0	network_modules	190	TRUE	1.4549112613660312e-7	8	19	4	0.21052631578947367	0.5	REAC:R-HSA-1236973	REAC	Cross-presentation of particulate exogenous antigens (phagosomes)	10916	415		0.23076923076923078	0.2857142857142857	8	10908	4	15	4	10893	10916	0.323713798413934
M1	cpdb	0	network_modules	190	TRUE	2.6475706048519617e-7	449	19	10	0.5263157894736842	0.022271714922048998	REAC:R-HSA-9012999	REAC	RHO GTPase cycle	10916	1847		0.3076923076923077	0.35714285714285715	449	10467	10	9	439	10458	10916	0.10201372321883205
M1	cpdb	0	network_modules	190	TRUE	2.809128227429181e-7	55	25	6	0.24	0.10909090909090909	GO:0006801	GO:BP	superoxide metabolic process	16175	2486		0.5	0.6	55	16120	6	19	49	16101	16175	0.1599110002239701
M1	cpdb	0	network_modules	190	TRUE	1.046539008711975e-6	36	19	5	0.2631578947368421	0.1388888888888889	REAC:R-HSA-1222556	REAC	ROS and RNS production in phagocytes	10916	1910		0.38461538461538464	0.42857142857142855	36	10880	5	14	31	10866	10916	0.18926075156011787
M1	cpdb	0	network_modules	190	TRUE	1.4123510051612756e-6	138	13	6	0.46153846153846156	0.043478260869565216	KEGG:05418	KEGG	Fluid shear stress and atherosclerosis	8484	495		0	0.1111111111111111	138	8346	6	7	132	8339	8484	0.1378961635533635
M1	cpdb	0	network_modules	190	TRUE	1.8347077488016296e-6	88	19	6	0.3157894736842105	0.06818181818181818	REAC:R-HSA-9013404	REAC	RAC2 GTPase cycle	10916	1837		0.46153846153846156	0.5	88	10828	6	13	82	10815	10916	0.1436938838794363
M1	cpdb	0	network_modules	190	TRUE	8.965603073521986e-6	175	25	7	0.28	0.04	GO:0072593	GO:BP	reactive oxygen species metabolic process	16175	17457		0.75	0.8	175	16000	7	18	168	15982	16175	0.10237481973205265
M1	cpdb	0	network_modules	190	TRUE	2.577897870160511e-5	114	13	5	0.38461538461538464	0.043859649122807015	KEGG:04670	KEGG	Leukocyte transendothelial migration	8484	343		0.125	0.2222222222222222	114	8370	5	8	109	8362	8484	0.12629101392105999
M1	cpdb	0	network_modules	190	TRUE	1.1871441642676017e-4	36	19	4	0.21052631578947367	0.1111111111111111	REAC:R-HSA-3299685	REAC	Detoxification of Reactive Oxygen Species	10916	735		0.5384615384615384	0.5714285714285714	36	10880	4	15	32	10865	10916	0.15092821549008953
M1	cpdb	0	network_modules	190	TRUE	1.7509158954298005e-4	72	13	4	0.3076923076923077	0.05555555555555555	KEGG:05140	KEGG	Leishmaniasis	8484	433		0.25	0.3333333333333333	72	8412	4	9	68	8403	8484	0.12777886984082035
M1	cpdb	0	network_modules	190	TRUE	1.9792170958576413e-4	318	19	7	0.3684210526315789	0.0220125786163522	REAC:R-HSA-195258	REAC	RHO GTPase Effectors	10916	1846		0.6153846153846154	0.6428571428571429	318	10598	7	12	311	10586	10916	0.08424259910767415
M1	cpdb	0	network_modules	190	TRUE	3.071012376429728e-4	188	13	5	0.38461538461538464	0.026595744680851064	KEGG:04613	KEGG	Neutrophil extracellular trap formation	8484	323		0.375	0.4444444444444444	188	8296	5	8	183	8288	8484	0.09645994791635527
M1	cpdb	0	network_modules	190	TRUE	3.101676550999531e-4	12	19	3	0.15789473684210525	0.25	REAC:R-HSA-9664420	REAC	Killing mechanisms	10916	1291		0.6923076923076923	0.7857142857142857	12	10904	3	16	9	10888	10916	0.19757715000289244
M1	cpdb	0	network_modules	190	TRUE	3.101676550999531e-4	12	19	3	0.15789473684210525	0.25	REAC:R-HSA-9673324	REAC	WNT5:FZD7-mediated leishmania damping	10916	2670		0.6923076923076923	0.7857142857142857	12	10904	3	16	9	10888	10916	0.19757715000289244
M1	cpdb	0	network_modules	190	TRUE	4.365371264064228e-4	202	13	5	0.38461538461538464	0.024752475247524754	KEGG:05415	KEGG	Diabetic cardiomyopathy	8484	492		0.5	0.5555555555555556	202	8282	5	8	197	8274	8484	0.09271185716701433
M1	cpdb	0	network_modules	190	TRUE	5.786175042074938e-4	214	13	5	0.38461538461538464	0.02336448598130841	KEGG:05417	KEGG	Lipid and atherosclerosis	8484	494		0.625	0.6666666666666666	214	8270	5	8	209	8262	8484	0.08978692017208036
M1	cpdb	0	network_modules	190	TRUE	7.511556027579543e-4	43	25	4	0.16	0.09302325581395349	GO:0042743	GO:BP	hydrogen peroxide metabolic process	16175	10336		1	1	43	16132	4	21	39	16111	16175	0.12022455914394735
M1	cpdb	0	network_modules	190	TRUE	0.001818256103227783	271	13	5	0.38461538461538464	0.01845018450184502	KEGG:05020	KEGG	Prion disease	8484	416		0.75	0.7777777777777778	271	8213	5	8	266	8205	8484	0.07856724651136121
M1	cpdb	0	network_modules	190	TRUE	0.0019536042142811174	132	13	4	0.3076923076923077	0.030303030303030304	KEGG:04380	KEGG	Osteoclast differentiation	8484	309		0.875	0.8888888888888888	132	8352	4	9	128	8343	8484	0.09247073521549008
M1	cpdb	0	network_modules	190	TRUE	0.002980429093050818	147	13	4	0.3076923076923077	0.027210884353741496	KEGG:04145	KEGG	Phagosome	8484	281		1	1	147	8337	4	9	143	8328	8484	0.08717391551872344
M1	cpdb	0	network_modules	190	TRUE	0.005765195229821226	94	19	4	0.21052631578947367	0.0425531914893617	REAC:R-HSA-4420097	REAC	VEGFA-VEGFR2 Pathway	10916	2634		0.8461538461538461	0.8571428571428571	94	10822	4	15	90	10807	10916	0.09125106987271796
M1	cpdb	0	network_modules	190	TRUE	0.008597538012407941	104	19	4	0.21052631578947367	0.038461538461538464	REAC:R-HSA-194138	REAC	Signaling by VEGF	10916	2313		0.9230769230769231	0.9285714285714286	104	10812	4	15	100	10797	10916	0.08639947351634902
M1	cpdb	0	network_modules	190	TRUE	0.008928176229262832	105	19	4	0.21052631578947367	0.0380952380952381	REAC:R-HSA-1236975	REAC	Antigen processing-Cross presentation	10916	153		1	1	105	10811	4	15	101	10796	10916	0.08595184806561525
M1	cpdb	0	network_modules	191	TRUE	2.3862797262692627e-6	112	18	6	0.3333333333333333	0.05357142857142857	GO:0031047	GO:BP	regulatory ncRNA-mediated gene silencing	16175	7011		0	0.14285714285714285	112	16063	6	12	106	16051	16175	0.13138326585774493
M1	cpdb	0	network_modules	191	TRUE	1.0531807192354947e-5	65	18	5	0.2777777777777778	0.07692307692307693	GO:0070918	GO:BP	regulatory ncRNA processing	16175	16370		0.16666666666666666	0.2857142857142857	65	16110	5	13	60	16097	16175	0.1444323583180754
M1	cpdb	0	network_modules	191	TRUE	2.5283101891525648e-5	9	12	3	0.25	0.3333333333333333	REAC:R-HSA-426486	REAC	Small interfering RNA (siRNA) biogenesis	10916	2335		0	0.3333333333333333	9	10907	3	9	6	10898	10916	0.2880001370043884
M1	cpdb	0	network_modules	191	TRUE	9.225033858072778e-5	8	18	3	0.16666666666666666	0.375	GO:0030422	GO:BP	siRNA processing	16175	6799		0.3333333333333333	0.42857142857142855	8	16167	3	15	5	16152	16175	0.24945861854572904
M1	cpdb	0	network_modules	191	TRUE	1.3667237276418888e-4	40	18	4	0.2222222222222222	0.1	GO:0035196	GO:BP	miRNA processing	16175	8885		0.5	0.5714285714285714	40	16135	4	14	36	16121	16175	0.147677094844667
M1	cpdb	0	network_modules	191	TRUE	1.974043581156527e-4	10	18	3	0.16666666666666666	0.3	GO:0070922	GO:BP	RISC complex assembly	16175	16373		0.6666666666666666	0.7142857142857143	10	16165	3	15	7	16150	16175	0.22297033946633493
M1	cpdb	0	network_modules	191	TRUE	5.284528373176585e-4	23	12	3	0.25	0.13043478260869565	REAC:R-HSA-203927	REAC	MicroRNA (miRNA) biogenesis	10916	1449		0.5	0.6666666666666666	23	10893	3	9	20	10884	10916	0.1793444014860522
M1	cpdb	0	network_modules	191	TRUE	9.173818459400518e-4	16	18	3	0.16666666666666666	0.1875	GO:0031054	GO:BP	pre-miRNA processing	16175	7016		0.8333333333333334	0.8571428571428571	16	16159	3	15	13	16144	16175	0.17591239566271397
M1	cpdb	0	network_modules	191	TRUE	0.0029635910325082893	134	12	4	0.3333333333333333	0.029850746268656716	REAC:R-HSA-211000	REAC	Gene Silencing by RNA	10916	1041		1	1	134	10782	4	8	130	10774	10916	0.0967258058513863
M1	cpdb	0	network_modules	191	TRUE	0.005009523127675268	3	18	2	0.1111111111111111	0.6666666666666666	GO:0098795	GO:BP	global gene silencing by mRNA cleavage	16175	18897		1	1	3	16172	2	16	1	16156	16175	0.27188774182133574
M1	cpdb	0	network_modules	192	TRUE	2.2247627193969614e-15	38	25	9	0.36	0.23684210526315788	GO:0000731	GO:BP	DNA synthesis involved in DNA repair	16175	208		0	0.1	38	16137	9	16	29	16121	16175	0.29065908796462286
M1	cpdb	0	network_modules	192	TRUE	9.429076610400072e-15	12	25	7	0.28	0.5833333333333334	GO:0042276	GO:BP	error-prone translesion synthesis	16175	10073		0.1111111111111111	0.2	12	16163	7	18	5	16145	16175	0.40353594172354845
M1	cpdb	0	network_modules	192	TRUE	7.12307378443776e-12	140	25	10	0.4	0.07142857142857142	GO:0071897	GO:BP	DNA biosynthetic process	16175	16970		0.2222222222222222	0.3	140	16035	10	15	130	16020	16175	0.16622217130214248
M1	cpdb	0	network_modules	192	TRUE	7.725193077391817e-12	26	25	7	0.28	0.2692307692307692	GO:0019985	GO:BP	translesion synthesis	16175	6075		0.3333333333333333	0.4	26	16149	7	18	19	16131	16175	0.27341742993606694
M1	cpdb	0	network_modules	192	TRUE	6.543426062587562e-11	39	19	7	0.3684210526315789	0.1794871794871795	REAC:R-HSA-110313	REAC	Translesion synthesis by Y family DNA polymerases bypasses lesions on DNA template	10916	2577		0	0.03125	39	10877	7	12	32	10865	10916	0.25533616400100123
M1	cpdb	0	network_modules	192	TRUE	7.828234886754248e-11	35	25	7	0.28	0.2	GO:0006301	GO:BP	postreplication repair	16175	2108		0.4444444444444444	0.5	35	16140	7	18	28	16122	16175	0.23525075273390977
M1	cpdb	0	network_modules	192	TRUE	3.0665246546744575e-10	329	19	11	0.5789473684210527	0.03343465045592705	REAC:R-HSA-73894	REAC	DNA Repair	10916	444		0.03225806451612903	0.0625	329	10587	11	8	318	10579	10916	0.13403646872116026
M1	cpdb	0	network_modules	192	TRUE	3.1052661664781836e-10	48	19	7	0.3684210526315789	0.14583333333333334	REAC:R-HSA-73893	REAC	DNA Damage Bypass	10916	438		0.06451612903225806	0.09375	48	10868	7	12	41	10856	10916	0.22973186705004794
M1	cpdb	0	network_modules	192	TRUE	8.518000050612259e-10	147	25	9	0.36	0.061224489795918366	GO:0006261	GO:BP	DNA-templated DNA replication	16175	2078		0.5555555555555556	0.6	147	16028	9	16	138	16012	16175	0.14548820762895748
M1	cpdb	0	network_modules	192	TRUE	1.1244466312384131e-09	231	25	10	0.4	0.04329004329004329	GO:0006260	GO:BP	DNA replication	16175	2077		0.6666666666666666	0.7	231	15944	10	15	221	15929	16175	0.12790693549002427
M1	cpdb	0	network_modules	192	TRUE	3.249178299426184e-9	32	19	6	0.3157894736842105	0.1875	REAC:R-HSA-5656169	REAC	Termination of translesion DNA synthesis	10916	2492		0.0967741935483871	0.125	32	10884	6	13	26	10871	10916	0.24163779094656473
M1	cpdb	0	network_modules	192	TRUE	5.6900826378407484e-9	14	19	5	0.2631578947368421	0.35714285714285715	REAC:R-HSA-69109	REAC	Leading Strand Synthesis	10916	1308		0.12903225806451613	0.21875	14	10902	5	14	9	10888	10916	0.30553741878796276
M1	cpdb	0	network_modules	192	TRUE	5.6900826378407484e-9	14	19	5	0.2631578947368421	0.35714285714285715	REAC:R-HSA-69091	REAC	Polymerase switching	10916	1769		0.12903225806451613	0.21875	14	10902	5	14	9	10888	10916	0.30553741878796276
M1	cpdb	0	network_modules	192	TRUE	5.6900826378407484e-9	14	19	5	0.2631578947368421	0.35714285714285715	REAC:R-HSA-69166	REAC	Removal of the Flap Intermediate	10916	2058		0.12903225806451613	0.21875	14	10902	5	14	9	10888	10916	0.30553741878796276
M1	cpdb	0	network_modules	192	TRUE	8.525993775446045e-9	15	19	5	0.2631578947368421	0.3333333333333333	REAC:R-HSA-69183	REAC	Processive synthesis on the lagging strand	10916	1802		0.22580645161290322	0.25	15	10901	5	14	10	10887	10916	0.29508746545026604
M1	cpdb	0	network_modules	192	TRUE	4.378335092839243e-8	20	19	5	0.2631578947368421	0.25	REAC:R-HSA-69186	REAC	Lagging Strand Synthesis	10916	1302		0.25806451612903225	0.28125	20	10896	5	14	15	10882	10916	0.25516462507024346
M1	cpdb	0	network_modules	192	TRUE	5.551552906484103e-8	168	19	8	0.42105263157894735	0.047619047619047616	REAC:R-HSA-5693532	REAC	DNA Double-Strand Break Repair	10916	443		0.2903225806451613	0.3125	168	10748	8	11	160	10737	10916	0.13760465165237237
M1	cpdb	0	network_modules	192	TRUE	7.04130210570301e-8	36	13	5	0.38461538461538464	0.1388888888888889	KEGG:03030	KEGG	DNA replication	8484	214		0	0.16666666666666666	36	8448	5	8	31	8440	8484	0.22923738730113943
M1	cpdb	0	network_modules	192	TRUE	1.7016210792680037e-7	528	25	11	0.44	0.020833333333333332	GO:0006281	GO:BP	DNA repair	16175	2095		0.7777777777777778	0.8	528	15647	11	14	517	15633	16175	0.09019256664756596
M1	cpdb	0	network_modules	192	TRUE	1.8457337001704022e-7	26	19	5	0.2631578947368421	0.19230769230769232	REAC:R-HSA-174411	REAC	Polymerase switching on the C-strand of the telomere	10916	1770		0.3225806451612903	0.34375	26	10890	5	14	21	10876	10916	0.22338498279929966
M1	cpdb	0	network_modules	192	TRUE	5.614253490880159e-7	32	19	5	0.2631578947368421	0.15625	REAC:R-HSA-69190	REAC	DNA strand elongation	10916	449		0.3548387096774194	0.375	32	10884	5	14	27	10870	10916	0.20098746845284168
M1	cpdb	0	network_modules	192	TRUE	7.741023382186853e-7	34	19	5	0.2631578947368421	0.14705882352941177	REAC:R-HSA-174417	REAC	Telomere C-strand (Lagging Strand) Synthesis	10916	2486		0.3870967741935484	0.40625	34	10882	5	14	29	10868	10916	0.19486710606652838
M1	cpdb	0	network_modules	192	TRUE	6.417049728353829e-6	51	19	5	0.2631578947368421	0.09803921568627451	REAC:R-HSA-180786	REAC	Extension of Telomeres	10916	887		0.41935483870967744	0.4375	51	10865	5	14	46	10851	10916	0.15827913889104606
M1	cpdb	0	network_modules	192	TRUE	1.3275467889684885e-5	798	25	11	0.44	0.013784461152882205	GO:0006974	GO:BP	DNA damage response	16175	2601		0.8888888888888888	0.9	798	15377	11	14	787	15363	16175	0.07097327462031938
M1	cpdb	0	network_modules	192	TRUE	4.649883605893815e-5	5	25	3	0.12	0.6	GO:0006269	GO:BP	DNA replication, synthesis of primer	16175	2084		1	1	5	16170	3	22	2	16148	16175	0.26788542285229483
M1	cpdb	0	network_modules	192	TRUE	5.4655639734916054e-5	54	13	4	0.3076923076923077	0.07407407407407407	KEGG:03460	KEGG	Fanconi anemia pathway	8484	242		0.2	0.3333333333333333	54	8430	4	9	50	8421	8484	0.14843384288463274
M1	cpdb	0	network_modules	192	TRUE	2.6610607241321014e-4	23	13	3	0.23076923076923078	0.13043478260869565	KEGG:03430	KEGG	Mismatch repair	8484	239		0.4	0.5	23	8461	3	10	20	8451	8484	0.17182090740223027
M1	cpdb	0	network_modules	192	TRUE	3.282706366902642e-4	111	19	5	0.2631578947368421	0.04504504504504504	REAC:R-HSA-157579	REAC	Telomere Maintenance	10916	2489		0.45161290322580644	0.46875	111	10805	5	14	106	10791	10916	0.10529680415692226
M1	cpdb	0	network_modules	192	TRUE	5.037245688008504e-4	121	19	5	0.2631578947368421	0.04132231404958678	REAC:R-HSA-69239	REAC	Synthesis of DNA	10916	2376		0.4838709677419355	0.5	121	10795	5	14	116	10781	10916	0.10053322199279971
M1	cpdb	0	network_modules	192	TRUE	5.120585011759356e-4	14	19	3	0.15789473684210525	0.21428571428571427	REAC:R-HSA-5358606	REAC	Mismatch repair (MMR) directed by MSH2:MSH3 (MutSbeta)	10916	1458		0.5161290322580645	0.5625	14	10902	3	16	11	10886	10916	0.1827239098035609
M1	cpdb	0	network_modules	192	TRUE	5.120585011759356e-4	14	19	3	0.15789473684210525	0.21428571428571427	REAC:R-HSA-5358565	REAC	Mismatch repair (MMR) directed by MSH2:MSH6 (MutSalpha)	10916	1459		0.5161290322580645	0.5625	14	10902	3	16	11	10886	10916	0.1827239098035609
M1	cpdb	0	network_modules	192	TRUE	6.393693003224962e-4	15	19	3	0.15789473684210525	0.2	REAC:R-HSA-5358508	REAC	Mismatch Repair	10916	1457		0.5806451612903226	0.59375	15	10901	3	16	12	10885	10916	0.17643290157310962
M1	cpdb	0	network_modules	192	TRUE	9.534406584359109e-4	17	19	3	0.15789473684210525	0.17647058823529413	REAC:R-HSA-5656121	REAC	Translesion synthesis by POLI	10916	2574		0.6129032258064516	0.65625	17	10899	3	16	14	10883	10916	0.16555104323798445
M1	cpdb	0	network_modules	192	TRUE	9.534406584359109e-4	17	19	3	0.15789473684210525	0.17647058823529413	REAC:R-HSA-174437	REAC	Removal of the Flap Intermediate from the C-strand	10916	2059		0.6129032258064516	0.65625	17	10899	3	16	14	10883	10916	0.16555104323798445
M1	cpdb	0	network_modules	192	TRUE	9.643699573272321e-4	138	19	5	0.2631578947368421	0.036231884057971016	REAC:R-HSA-73886	REAC	Chromosome Maintenance	10916	357		0.6774193548387096	0.71875	138	10778	5	14	133	10764	10916	0.0936296752010005
M1	cpdb	0	network_modules	192	TRUE	9.643699573272321e-4	138	19	5	0.2631578947368421	0.036231884057971016	REAC:R-HSA-5693538	REAC	Homology Directed Repair	10916	1130		0.6774193548387096	0.71875	138	10778	5	14	133	10764	10916	0.0936296752010005
M1	cpdb	0	network_modules	192	TRUE	0.0013556666295242643	19	19	3	0.15789473684210525	0.15789473684210525	REAC:R-HSA-174414	REAC	Processive synthesis on the C-strand of the telomere	10916	1801		0.7419354838709677	0.75	19	10897	3	16	16	10881	10916	0.1564264428162266
M1	cpdb	0	network_modules	192	TRUE	0.0015764144106199696	41	13	3	0.23076923076923078	0.07317073170731707	KEGG:03440	KEGG	Homologous recombination	8484	240		0.6	0.6666666666666666	41	8443	3	10	38	8433	8484	0.12762955942702883
M1	cpdb	0	network_modules	192	TRUE	0.0015844105071618386	68	19	4	0.21052631578947367	0.058823529411764705	REAC:R-HSA-5685942	REAC	HDR through Homologous Recombination (HRR)	10916	1097		0.7741935483870968	0.78125	68	10848	4	15	64	10833	10916	0.1084224940265789
M1	cpdb	0	network_modules	192	TRUE	0.0018566290623475562	21	19	3	0.15789473684210525	0.14285714285714285	REAC:R-HSA-5651801	REAC	PCNA-Dependent Long Patch Base Excision Repair	10916	1658		0.8064516129032258	0.8125	21	10895	3	16	18	10879	10916	0.14863028800788033
M1	cpdb	0	network_modules	192	TRUE	0.0019533411790221347	44	13	3	0.23076923076923078	0.06818181818181818	KEGG:03410	KEGG	Base excision repair	8484	237		0.8	0.8333333333333334	44	8440	3	10	41	8430	8484	0.123030785679778
M1	cpdb	0	network_modules	192	TRUE	0.002118137767699374	162	19	5	0.2631578947368421	0.030864197530864196	REAC:R-HSA-69242	REAC	S Phase	10916	2111		0.8387096774193549	0.84375	162	10754	5	14	157	10740	10916	0.08575338954262401
M1	cpdb	0	network_modules	192	TRUE	0.0031966132300736048	25	19	3	0.15789473684210525	0.12	REAC:R-HSA-5696397	REAC	Gap-filling DNA repair synthesis and ligation in GG-NER	10916	1037		0.8709677419354839	0.90625	25	10891	3	16	22	10875	10916	0.13592682687611676
M1	cpdb	0	network_modules	192	TRUE	0.0031966132300736048	25	19	3	0.15789473684210525	0.12	REAC:R-HSA-110373	REAC	Resolution of AP sites via the multiple-nucleotide patch replacement pathway	10916	2073		0.8709677419354839	0.90625	25	10891	3	16	22	10875	10916	0.13592682687611676
M1	cpdb	0	network_modules	192	TRUE	0.004261139401862768	187	19	5	0.2631578947368421	0.026737967914438502	REAC:R-HSA-69306	REAC	DNA Replication	10916	445		0.9354838709677419	0.9375	187	10729	5	14	182	10715	10916	0.07917158399882725
M1	cpdb	0	network_modules	192	TRUE	0.005228748344179388	61	13	3	0.23076923076923078	0.04918032786885246	KEGG:03420	KEGG	Nucleotide excision repair	8484	238		1	1	61	8423	3	10	58	8413	8484	0.10366642591934026
M1	cpdb	0	network_modules	192	TRUE	0.0056117619559253856	30	19	3	0.15789473684210525	0.1	REAC:R-HSA-110314	REAC	Recognition of DNA damage by PCNA-containing replication complex	10916	1948		0.967741935483871	0.96875	30	10886	3	16	27	10870	10916	0.12374680052774317
M1	cpdb	0	network_modules	192	TRUE	0.009804028720571397	36	19	3	0.15789473684210525	0.08333333333333333	REAC:R-HSA-73933	REAC	Resolution of Abasic Sites (AP sites)	10916	2075		1	1	36	10880	3	16	33	10864	10916	0.11259567942006121
M1	cpdb	0	network_modules	193	TRUE	3.165966116474535e-8	5	25	4	0.16	0.8	GO:0140639	GO:BP	positive regulation of pyroptotic inflammatory response	16175	19843		0	0.041666666666666664	5	16170	4	21	1	16149	16175	0.35741118141915157
M1	cpdb	0	network_modules	193	TRUE	9.488030932498155e-8	6	25	4	0.16	0.6666666666666666	GO:0051715	GO:BP	cytolysis in another organism	16175	13908		0.043478260869565216	0.08333333333333333	6	16169	4	21	2	16148	16175	0.32615404812435905
M1	cpdb	0	network_modules	193	TRUE	4.4185524136196694e-7	8	25	4	0.16	0.5	GO:0019835	GO:BP	cytolysis	16175	6047		0.08695652173913043	0.125	8	16167	4	21	4	16146	16175	0.2822563585533348
M1	cpdb	0	network_modules	193	TRUE	1.6616200288703108e-5	107	25	6	0.24	0.056074766355140186	GO:0034341	GO:BP	response to type II interferon	16175	8579		0.13043478260869565	0.16666666666666666	107	16068	6	19	101	16049	16175	0.11327338960911594
M1	cpdb	0	network_modules	193	TRUE	9.660345401874011e-5	247	25	7	0.28	0.02834008097165992	GO:0006520	GO:BP	amino acid metabolic process	16175	2241		0.17391304347826086	0.20833333333333334	247	15928	7	18	240	15910	16175	0.08493785785459565
M1	cpdb	0	network_modules	193	TRUE	1.1247648626825056e-4	389	25	8	0.32	0.02056555269922879	GO:0043603	GO:BP	amide metabolic process	16175	10795		0.21739130434782608	0.25	389	15786	8	17	381	15769	16175	0.07600397712733405
M1	cpdb	0	network_modules	193	TRUE	2.486004177930065e-4	85	25	5	0.2	0.058823529411764705	GO:0071346	GO:BP	cellular response to type II interferon	16175	16598		0.2608695652173913	0.2916666666666667	85	16090	5	20	80	16070	16175	0.10597582591232729
M1	cpdb	0	network_modules	193	TRUE	2.5166950824690083e-4	33	25	4	0.16	0.12121212121212122	GO:0070269	GO:BP	pyroptotic inflammatory response	16175	16029		0.30434782608695654	0.3333333333333333	33	16142	4	21	29	16121	16175	0.13773331618221063
M1	cpdb	0	network_modules	193	TRUE	2.8176964774975164e-4	289	25	7	0.28	0.02422145328719723	GO:0006790	GO:BP	sulfur compound metabolic process	16175	2476		0.34782608695652173	0.375	289	15886	7	18	282	15868	16175	0.07785623481895292
M1	cpdb	0	network_modules	193	TRUE	3.357824867506015e-4	177	25	6	0.24	0.03389830508474576	GO:1901605	GO:BP	alpha-amino acid metabolic process	16175	21589		0.391304347826087	0.4166666666666667	177	15998	6	19	171	15979	16175	0.08662684030873835
M1	cpdb	0	network_modules	193	TRUE	5.910159453879682e-4	91	25	5	0.2	0.054945054945054944	REAC:R-HSA-877300	REAC	Interferon gamma signaling	10916	1229		0	0.3333333333333333	91	10825	5	20	86	10805	10916	0.10099611644822065
M1	cpdb	0	network_modules	193	TRUE	8.109585949270158e-4	12	25	3	0.12	0.25	REAC:R-HSA-174403	REAC	Glutathione synthesis and recycling	10916	1059		0.5	0.6666666666666666	12	10904	3	22	9	10882	10916	0.17190974872371378
M1	cpdb	0	network_modules	193	TRUE	9.267140811805066e-4	182	26	6	0.23076923076923078	0.03296703296703297	KEGG:04621	KEGG	NOD-like receptor signaling pathway	8484	326		0	0.3333333333333333	182	8302	6	20	176	8282	8484	0.08009974141925674
M1	cpdb	0	network_modules	193	TRUE	9.298447536883358e-4	50	26	4	0.15384615384615385	0.08	KEGG:00270	KEGG	Cysteine and methionine metabolism	8484	30		0.5	0.6666666666666666	50	8434	4	22	46	8412	8484	0.10717034025582045
M1	cpdb	0	network_modules	193	TRUE	0.001289332084866536	742	25	9	0.36	0.012129380053908356	GO:0019752	GO:BP	carboxylic acid metabolic process	16175	6036		0.43478260869565216	0.4583333333333333	742	15433	9	16	733	15417	16175	0.059075282236064446
M1	cpdb	0	network_modules	193	TRUE	0.0014645666855869922	56	26	4	0.15384615384615385	0.07142857142857142	KEGG:00480	KEGG	Glutathione metabolism	8484	61		1	1	56	8428	4	22	52	8406	8484	0.10081826729683109
M1	cpdb	0	network_modules	193	TRUE	0.0015925970201169422	761	25	9	0.36	0.011826544021024968	GO:0043436	GO:BP	oxoacid metabolic process	16175	10693		0.4782608695652174	0.5	761	15414	9	16	752	15398	16175	0.0581508244060359
M1	cpdb	0	network_modules	193	TRUE	0.0017004262260472325	767	25	9	0.36	0.011734028683181226	GO:0006082	GO:BP	organic acid metabolic process	16175	1947		0.5217391304347826	0.5416666666666666	767	15408	9	16	758	15392	16175	0.05786553721622982
M1	cpdb	0	network_modules	193	TRUE	0.0017731506814441475	2	25	2	0.08	1	REAC:R-HSA-5578999	REAC	Defective GCLC causes HAGGSD	10916	556		1	1	2	10914	2	23	0	10891	10916	0.28254452604712355
M1	cpdb	0	network_modules	193	TRUE	0.002781050920043275	138	25	5	0.2	0.036231884057971016	GO:0170039	GO:BP	proteinogenic amino acid metabolic process	16175	20287		0.5652173913043478	0.5833333333333334	138	16037	5	20	133	16017	16175	0.08190753169601155
M1	cpdb	0	network_modules	193	TRUE	0.0029160665878868487	60	25	4	0.16	0.06666666666666667	GO:0141061	GO:BP	disruption of cell in another organism	16175	19997		0.6086956521739131	0.6666666666666666	60	16115	4	21	56	16094	16175	0.10115096502698866
M1	cpdb	0	network_modules	193	TRUE	0.0029160665878868487	60	25	4	0.16	0.06666666666666667	GO:0031640	GO:BP	killing of cells of another organism	16175	7250		0.6086956521739131	0.6666666666666666	60	16115	4	21	56	16094	16175	0.10115096502698866
M1	cpdb	0	network_modules	193	TRUE	0.0031234301241226206	17	25	3	0.12	0.17647058823529413	GO:0042832	GO:BP	defense response to protozoan	16175	10388		0.6956521739130435	0.75	17	16158	3	22	14	16136	16175	0.14443436822943198
M1	cpdb	0	network_modules	193	TRUE	0.0031234301241226206	17	25	3	0.12	0.17647058823529413	GO:0001562	GO:BP	response to protozoan	16175	351		0.6956521739130435	0.75	17	16158	3	22	14	16136	16175	0.14443436822943198
M1	cpdb	0	network_modules	193	TRUE	0.003276358997535711	2	25	2	0.08	1	GO:0140973	GO:BP	positive regulation of AIM2 inflammasome complex assembly	16175	19957		0.782608695652174	0.7916666666666666	2	16173	2	23	0	16150	16175	0.282641522315189
M1	cpdb	0	network_modules	193	TRUE	0.003429811814876714	144	25	5	0.2	0.034722222222222224	GO:0170033	GO:BP	L-amino acid metabolic process	16175	20281		0.8260869565217391	0.8333333333333334	144	16031	5	20	139	16011	16175	0.08004260105208374
M1	cpdb	0	network_modules	193	TRUE	0.0051215732540826975	69	25	4	0.16	0.057971014492753624	GO:0141060	GO:BP	disruption of anatomical structure in another organism	16175	19996		0.8695652173913043	0.875	69	16106	4	21	65	16085	16175	0.09401421318796238
M1	cpdb	0	network_modules	193	TRUE	0.006781313211558385	74	25	4	0.16	0.05405405405405406	GO:0043648	GO:BP	dicarboxylic acid metabolic process	16175	10828		0.9130434782608695	0.9166666666666666	74	16101	4	21	70	16080	16175	0.09061638433209257
M1	cpdb	0	network_modules	193	TRUE	0.007278651976749593	300	25	6	0.24	0.02	GO:0044282	GO:BP	small molecule catabolic process	16175	10949		0.9565217391304348	0.9583333333333334	300	15875	6	19	294	15856	16175	0.06457907620086795
M1	cpdb	0	network_modules	193	TRUE	0.009819758219721055	3	25	2	0.08	0.6666666666666666	GO:0019405	GO:BP	alditol catabolic process	16175	5762		1	1	3	16172	2	23	1	16149	16175	0.23060434694047444
M1	cpdb	0	network_modules	195	TRUE	1.2699453091760143e-6	5	12	3	0.25	0.6	KEGG:00524	KEGG	Neomycin, kanamycin and gentamicin biosynthesis	8484	73		0	0.1	5	8479	3	9	2	8470	8484	0.3867728610394181
M1	cpdb	0	network_modules	195	TRUE	8.734510314481114e-5	9	17	3	0.17647058823529413	0.3333333333333333	REAC:R-HSA-391908	REAC	Prostanoid ligand receptors	10916	1810		0	0.5	9	10907	3	14	6	10893	10916	0.24169033691262573
M1	cpdb	0	network_modules	195	TRUE	4.703943772509993e-4	15	17	3	0.17647058823529413	0.2	REAC:R-HSA-391903	REAC	Eicosanoid ligand-binding receptors	10916	834		1	1	15	10901	3	14	12	10887	10916	0.18667803647579717
M1	cpdb	0	network_modules	195	TRUE	5.55145531681995e-4	10	25	3	0.12	0.3	GO:0046835	GO:BP	carbohydrate phosphorylation	16175	12392		NA	1	10	16165	3	22	7	16143	16175	0.18896360264999645
M1	cpdb	0	network_modules	195	TRUE	6.164879317377822e-4	32	12	3	0.25	0.09375	KEGG:00052	KEGG	Galactose metabolism	8484	7		0.1111111111111111	0.2	32	8452	3	9	29	8443	8484	0.15117547996097347
M1	cpdb	0	network_modules	195	TRUE	7.425779836529669e-4	34	12	3	0.25	0.08823529411764706	KEGG:00051	KEGG	Fructose and mannose metabolism	8484	6		0.2222222222222222	0.3	34	8450	3	9	31	8441	8484	0.14653868350479857
M1	cpdb	0	network_modules	195	TRUE	8.846189137259222e-4	36	12	3	0.25	0.08333333333333333	KEGG:00500	KEGG	Starch and sucrose metabolism	8484	62		0.3333333333333333	0.4	36	8448	3	9	33	8439	8484	0.1422903690594377
M1	cpdb	0	network_modules	195	TRUE	9.619062995434115e-4	37	12	3	0.25	0.08108108108108109	KEGG:01250	KEGG	Biosynthesis of nucleotide sugars	8484	191		0.4444444444444444	0.5	37	8447	3	9	34	8438	8484	0.14029534293306822
M1	cpdb	0	network_modules	195	TRUE	0.001865806324059758	46	12	3	0.25	0.06521739130434782	KEGG:04930	KEGG	Type II diabetes mellitus	8484	387		0.5555555555555556	0.6	46	8438	3	9	43	8429	8484	0.12534790337699803
M1	cpdb	0	network_modules	195	TRUE	0.001991431365284632	47	12	3	0.25	0.06382978723404255	KEGG:04973	KEGG	Carbohydrate digestion and absorption	8484	404		0.6666666666666666	0.7	47	8437	3	9	44	8428	8484	0.1239548282695433
M1	cpdb	0	network_modules	195	TRUE	0.002259120906122989	49	12	3	0.25	0.061224489795918366	KEGG:00520	KEGG	Amino sugar and nucleotide sugar metabolism	8484	69		0.7777777777777778	0.8	49	8435	3	9	46	8426	8484	0.12129609433867922
M1	cpdb	0	network_modules	195	TRUE	0.005790263335075804	67	12	3	0.25	0.04477611940298507	KEGG:00010	KEGG	Glycolysis / Gluconeogenesis	8484	2		0.8888888888888888	0.9	67	8417	3	9	64	8408	8484	0.10293949273332638
M1	cpdb	0	network_modules	195	TRUE	0.006600580703949156	70	12	3	0.25	0.04285714285714286	KEGG:05230	KEGG	Central carbon metabolism in cancer	8484	478		1	1	70	8414	3	9	67	8405	8484	0.10058032532293186
M1	cpdb	0	network_modules	197	TRUE	4.380501278815439e-4	202	12	5	0.4166666666666667	0.024752475247524754	REAC:R-HSA-72163	REAC	mRNA Splicing - Major Pathway	10916	2707		0	0.3333333333333333	202	10714	5	7	197	10707	10916	0.0980097376022135
M1	cpdb	0	network_modules	197	TRUE	5.183017846343822e-4	209	12	5	0.4166666666666667	0.023923444976076555	REAC:R-HSA-72172	REAC	mRNA Splicing	10916	2706		0.5	0.6666666666666666	209	10707	5	7	204	10700	10916	0.09623070548611044
M1	cpdb	0	network_modules	197	TRUE	0.00203099797886354	276	12	5	0.4166666666666667	0.018115942028985508	REAC:R-HSA-72203	REAC	Processing of Capped Intron-Containing Pre-mRNA	10916	1796		1	1	276	10640	5	7	271	10633	10916	0.08270608743308991
M1	cpdb	0	network_modules	197	TRUE	0.002725831807807856	397	17	6	0.35294117647058826	0.015113350125944584	GO:0008380	GO:BP	RNA splicing	16175	3186		NA	1	397	15778	6	11	391	15767	16175	0.0688419348415199
M1	cpdb	0	network_modules	197	TRUE	0.007944034410447748	174	6	3	0.5	0.017241379310344827	KEGG:03040	KEGG	Spliceosome	8484	215		NA	1	174	8310	3	3	171	8307	8484	0.08999838729959335
M1	cpdb	0	network_modules	198	TRUE	2.0651948953475956e-10	60	15	7	0.4666666666666667	0.11666666666666667	REAC:R-HSA-9033241	REAC	Peroxisomal protein import	10916	1728		0	0.2	60	10856	7	8	53	10848	10916	0.2313804339310344
M1	cpdb	0	network_modules	198	TRUE	6.453120790324643e-8	83	13	6	0.46153846153846156	0.07228915662650602	KEGG:04146	KEGG	Peroxisome	8484	282		NA	1	83	8401	6	7	77	8394	8484	0.1798058228270868
M1	cpdb	0	network_modules	198	TRUE	2.1392494571822278e-7	158	15	7	0.4666666666666667	0.04430379746835443	REAC:R-HSA-9609507	REAC	Protein localization	10916	1815		0.25	0.4	158	10758	7	8	151	10750	10916	0.14044459448336283
M1	cpdb	0	network_modules	198	TRUE	2.000333810684384e-6	91	21	6	0.2857142857142857	0.06593406593406594	GO:0019395	GO:BP	fatty acid oxidation	16175	5752		0	0.08333333333333333	91	16084	6	15	85	16069	16175	0.13501784352415463
M1	cpdb	0	network_modules	198	TRUE	2.4375916772794315e-6	94	21	6	0.2857142857142857	0.06382978723404255	GO:0009062	GO:BP	fatty acid catabolic process	16175	3238		0.09090909090909091	0.16666666666666666	94	16081	6	15	88	16066	16175	0.1327702468067438
M1	cpdb	0	network_modules	198	TRUE	2.7709585891070246e-6	96	21	6	0.2857142857142857	0.0625	GO:0034440	GO:BP	lipid oxidation	16175	8634		0.18181818181818182	0.25	96	16079	6	15	90	16064	16175	0.1313300738346119
M1	cpdb	0	network_modules	198	TRUE	5.665103906091042e-6	108	21	6	0.2857142857142857	0.05555555555555555	GO:0072329	GO:BP	monocarboxylic acid catabolic process	16175	17352		0.2727272727272727	0.3333333333333333	108	16067	6	15	102	16052	16175	0.1235369592318838
M1	cpdb	0	network_modules	198	TRUE	7.590332384015425e-6	24	15	4	0.26666666666666666	0.16666666666666666	REAC:R-HSA-390918	REAC	Peroxisomal lipid metabolism	10916	1727		0.5	0.6	24	10892	4	11	20	10881	10916	0.20945453964332494
M1	cpdb	0	network_modules	198	TRUE	2.5510721268880828e-5	65	21	5	0.23809523809523808	0.07692307692307693	GO:0006635	GO:BP	fatty acid beta-oxidation	16175	2346		0.36363636363636365	0.4166666666666667	65	16110	5	16	60	16094	16175	0.13340362112544418
M1	cpdb	0	network_modules	198	TRUE	6.724256786383379e-5	163	21	6	0.2857142857142857	0.03680981595092025	GO:0030258	GO:BP	lipid modification	16175	6747		0.45454545454545453	0.5	163	16012	6	15	157	15997	16175	0.09950269150167702
M1	cpdb	0	network_modules	198	TRUE	3.110252615027828e-4	211	21	6	0.2857142857142857	0.02843601895734597	GO:0046395	GO:BP	carboxylic acid catabolic process	16175	12121		0.5454545454545454	0.6666666666666666	211	15964	6	15	205	15949	16175	0.08664396411124287
M1	cpdb	0	network_modules	198	TRUE	3.110252615027828e-4	211	21	6	0.2857142857142857	0.02843601895734597	GO:0016054	GO:BP	organic acid catabolic process	16175	5086		0.5454545454545454	0.6666666666666666	211	15964	6	15	205	15949	16175	0.08664396411124287
M1	cpdb	0	network_modules	198	TRUE	7.836184461236771e-4	173	15	5	0.3333333333333333	0.028901734104046242	REAC:R-HSA-8978868	REAC	Fatty acid metabolism	10916	935		0.75	0.8	173	10743	5	10	168	10733	10916	0.09430037277404497
M1	cpdb	0	network_modules	198	TRUE	8.046433956288291e-4	248	21	6	0.2857142857142857	0.024193548387096774	GO:0016042	GO:BP	lipid catabolic process	16175	5076		0.7272727272727273	0.75	248	15927	6	15	242	15912	16175	0.0793412092812904
M1	cpdb	0	network_modules	198	TRUE	0.0013519152960609607	271	21	6	0.2857142857142857	0.02214022140221402	GO:0044248	GO:BP	cellular catabolic process	16175	10939		0.8181818181818182	0.8333333333333334	271	15904	6	15	265	15889	16175	0.07555510641825004
M1	cpdb	0	network_modules	198	TRUE	0.0024439490156563997	300	21	6	0.2857142857142857	0.02	GO:0044282	GO:BP	small molecule catabolic process	16175	10949		0.9090909090909091	0.9166666666666666	300	15875	6	15	294	15860	16175	0.07139691599303766
M1	cpdb	0	network_modules	198	TRUE	0.003489629551516771	319	21	6	0.2857142857142857	0.018808777429467086	GO:0006631	GO:BP	fatty acid metabolic process	16175	2343		1	1	319	15856	6	15	313	15841	16175	0.06897490594343615
M1	cpdb	0	network_modules	198	TRUE	0.0055292970928870625	5	15	2	0.13333333333333333	0.4	REAC:R-HSA-389599	REAC	Alpha-oxidation of phytanate	10916	134		1	1	5	10911	2	13	3	10898	10916	0.23035780537119116
M1	cpdb	0	network_modules	199	TRUE	2.0643712613170218e-8	42	22	6	0.2727272727272727	0.14285714285714285	GO:0097720	GO:BP	calcineurin-mediated signaling	16175	18746		0	0.047619047619047616	42	16133	6	16	36	16117	16175	0.19589381392743466
M1	cpdb	0	network_modules	199	TRUE	5.576658559047211e-7	107	14	6	0.42857142857142855	0.056074766355140186	KEGG:04922	KEGG	Glucagon signaling pathway	8484	379		0	0.07692307692307693	107	8377	6	8	101	8369	8484	0.15154367834943658
M1	cpdb	0	network_modules	199	TRUE	1.4159251724087066e-6	36	22	5	0.22727272727272727	0.1388888888888889	GO:0106056	GO:BP	regulation of calcineurin-mediated signaling	16175	19232		0.05	0.09523809523809523	36	16139	5	17	31	16122	16175	0.17624338920373095
M1	cpdb	0	network_modules	199	TRUE	2.8023067276434797e-6	41	22	5	0.22727272727272727	0.12195121951219512	GO:0033173	GO:BP	calcineurin-NFAT signaling cascade	16175	8068		0.1	0.14285714285714285	41	16134	5	17	36	16117	16175	0.16494626891624556
M1	cpdb	0	network_modules	199	TRUE	3.026617087778749e-6	251	14	7	0.5	0.027888446215139442	KEGG:04020	KEGG	Calcium signaling pathway	8484	250		0.08333333333333333	0.15384615384615385	251	8233	7	7	244	8226	8484	0.11287249420994752
M1	cpdb	0	network_modules	199	TRUE	4.050354354633369e-6	44	22	5	0.22727272727272727	0.11363636363636363	GO:0098703	GO:BP	calcium ion import across plasma membrane	16175	18835		0.15	0.19047619047619047	44	16131	5	17	39	16114	16175	0.15910722644364675
M1	cpdb	0	network_modules	199	TRUE	5.103373670945007e-6	46	22	5	0.22727272727272727	0.10869565217391304	GO:1902656	GO:BP	calcium ion import into cytosol	16175	22422		0.2	0.23809523809523808	46	16129	5	17	41	16112	16175	0.1555338944014696
M1	cpdb	0	network_modules	199	TRUE	6.330386275525184e-6	23	15	4	0.26666666666666666	0.17391304347826086	REAC:R-HSA-180024	REAC	DARPP-32 events	10916	434		0	0.5	23	10893	4	11	19	10882	10916	0.21402374219057202
M1	cpdb	0	network_modules	199	TRUE	7.2553575993626115e-6	164	14	6	0.42857142857142855	0.036585365853658534	KEGG:04022	KEGG	cGMP-PKG signaling pathway	8484	251		0.16666666666666666	0.23076923076923078	164	8320	6	8	158	8312	8484	0.12084214957043317
M1	cpdb	0	network_modules	199	TRUE	2.9459287822291964e-5	5	22	3	0.13636363636363635	0.6	GO:1905949	GO:BP	negative regulation of calcium ion import across plasma membrane	16175	25040		0.25	0.2857142857142857	5	16170	3	19	2	16151	16175	0.2856287946220628
M1	cpdb	0	network_modules	199	TRUE	5.8517472043944246e-5	74	22	5	0.22727272727272727	0.06756756756756757	GO:0070509	GO:BP	calcium ion import	16175	16164		0.3	0.38095238095238093	74	16101	5	17	69	16084	16175	0.1217874700041698
M1	cpdb	0	network_modules	199	TRUE	5.8517472043944246e-5	74	22	5	0.22727272727272727	0.06756756756756757	GO:0050848	GO:BP	regulation of calcium-mediated signaling	16175	13296		0.3	0.38095238095238093	74	16101	5	17	69	16084	16175	0.1217874700041698
M1	cpdb	0	network_modules	199	TRUE	9.391847440748302e-5	166	22	6	0.2727272727272727	0.03614457831325301	GO:0019722	GO:BP	calcium-mediated signaling	16175	6018		0.4	0.42857142857142855	166	16009	6	16	160	15993	16175	0.09610887489535333
M1	cpdb	0	network_modules	199	TRUE	1.0292588478150545e-4	7	22	3	0.13636363636363635	0.42857142857142855	GO:1905665	GO:BP	positive regulation of calcium ion import across plasma membrane	16175	24810		0.45	0.47619047619047616	7	16168	3	19	4	16149	16175	0.24119592085972666
M1	cpdb	0	network_modules	199	TRUE	1.7659599310929251e-4	35	22	4	0.18181818181818182	0.11428571428571428	GO:0070884	GO:BP	regulation of calcineurin-NFAT signaling cascade	16175	16355		0.5	0.5238095238095238	35	16140	4	18	31	16122	16175	0.1426858741080568
M1	cpdb	0	network_modules	199	TRUE	1.868366414816182e-4	154	14	5	0.35714285714285715	0.032467532467532464	KEGG:04921	KEGG	Oxytocin signaling pathway	8484	378		0.25	0.3076923076923077	154	8330	5	9	149	8321	8484	0.10323532593235851
M1	cpdb	0	network_modules	199	TRUE	1.932549016702055e-4	67	14	4	0.2857142857142857	0.05970149253731343	KEGG:04720	KEGG	Long-term potentiation	8484	350		0.3333333333333333	0.38461538461538464	67	8417	4	10	63	8407	8484	0.1276044530230568
M1	cpdb	0	network_modules	199	TRUE	2.1755663137415938e-4	69	14	4	0.2857142857142857	0.057971014492753624	KEGG:05031	KEGG	Amphetamine addiction	8484	419		0.4166666666666667	0.46153846153846156	69	8415	4	10	65	8405	8484	0.12564974704375417
M1	cpdb	0	network_modules	199	TRUE	2.465870052445487e-4	9	22	3	0.13636363636363635	0.3333333333333333	GO:1905664	GO:BP	regulation of calcium ion import across plasma membrane	16175	24809		0.55	0.5714285714285714	9	16166	3	19	6	16147	16175	0.21253446069585727
M1	cpdb	0	network_modules	199	TRUE	5.797163640585995e-4	194	14	5	0.35714285714285715	0.02577319587628866	KEGG:05167	KEGG	Kaposi sarcoma-associated herpesvirus infection	8484	448		0.5	0.5384615384615384	194	8290	5	9	189	8281	8484	0.09091811206926166
M1	cpdb	0	network_modules	199	TRUE	5.860815889121664e-4	117	22	5	0.22727272727272727	0.042735042735042736	GO:0099587	GO:BP	inorganic ion import across plasma membrane	16175	19152		0.6	0.6666666666666666	117	16058	5	17	112	16041	16175	0.09582762263176439
M1	cpdb	0	network_modules	199	TRUE	5.860815889121664e-4	117	22	5	0.22727272727272727	0.042735042735042736	GO:0098659	GO:BP	inorganic cation import across plasma membrane	16175	18815		0.6	0.6666666666666666	117	16058	5	17	112	16041	16175	0.09582762263176439
M1	cpdb	0	network_modules	199	TRUE	6.441175188545482e-4	12	22	3	0.13636363636363635	0.25	GO:0090281	GO:BP	negative regulation of calcium ion import	16175	18170		0.7	0.7142857142857143	12	16163	3	19	9	16144	16175	0.183825929278777
M1	cpdb	0	network_modules	199	TRUE	0.0010224125138360563	218	14	5	0.35714285714285715	0.022935779816513763	KEGG:05166	KEGG	Human T-cell leukemia virus 1 infection	8484	447		0.5833333333333334	0.6153846153846154	218	8266	5	9	213	8257	8484	0.0851651041274212
M1	cpdb	0	network_modules	199	TRUE	0.0011193659084088134	104	14	4	0.2857142857142857	0.038461538461538464	KEGG:04625	KEGG	C-type lectin receptor signaling pathway	8484	330		0.6666666666666666	0.6923076923076923	104	8380	4	10	100	8370	8484	0.10103494714384272
M1	cpdb	0	network_modules	199	TRUE	0.001328634086941117	15	22	3	0.13636363636363635	0.2	GO:0090280	GO:BP	positive regulation of calcium ion import	16175	18169		0.75	0.7619047619047619	15	16160	3	19	12	16141	16175	0.16420929627491795
M1	cpdb	0	network_modules	199	TRUE	0.0015025245312678631	59	22	4	0.18181818181818182	0.06779661016949153	GO:0007613	GO:BP	memory	16175	3070		0.8	0.8095238095238095	59	16116	4	18	55	16098	16175	0.10907127394133746
M1	cpdb	0	network_modules	199	TRUE	0.001654798514995453	89	15	4	0.26666666666666666	0.0449438202247191	REAC:R-HSA-111885	REAC	Opioid Signalling	10916	1642		1	1	89	10827	4	11	85	10816	10916	0.10663754483457828
M1	cpdb	0	network_modules	199	TRUE	0.00276314271230774	160	22	5	0.22727272727272727	0.03125	GO:0097553	GO:BP	calcium ion transmembrane import into cytosol	16175	18700		0.85	0.8571428571428571	160	16015	5	17	155	15998	16175	0.08106380607201721
M1	cpdb	0	network_modules	199	TRUE	0.003314246886999841	20	22	3	0.13636363636363635	0.15	GO:0070886	GO:BP	positive regulation of calcineurin-NFAT signaling cascade	16175	16357		0.9	0.9523809523809523	20	16155	3	19	17	16136	16175	0.14190679921914243
M1	cpdb	0	network_modules	199	TRUE	0.003314246886999841	20	22	3	0.13636363636363635	0.15	GO:0106058	GO:BP	positive regulation of calcineurin-mediated signaling	16175	19234		0.9	0.9523809523809523	20	16155	3	19	17	16136	16175	0.14190679921914243
M1	cpdb	0	network_modules	199	TRUE	0.005201012089016064	182	22	5	0.22727272727272727	0.027472527472527472	GO:0098739	GO:BP	import across plasma membrane	16175	18866		1	1	182	15993	5	17	177	15976	16175	0.07558296614811577
M1	cpdb	0	network_modules	199	TRUE	0.005364257505533883	155	14	4	0.2857142857142857	0.025806451612903226	KEGG:04218	KEGG	Cellular senescence	8484	295		0.75	0.7692307692307693	155	8329	4	10	151	8319	8484	0.08118850201325158
M1	cpdb	0	network_modules	199	TRUE	0.006351412854562957	59	14	3	0.21428571428571427	0.05084745762711865	KEGG:04370	KEGG	VEGF signaling pathway	8484	307		0.8333333333333334	0.8461538461538461	59	8425	3	11	56	8414	8484	0.10143251445583629
M1	cpdb	0	network_modules	199	TRUE	0.008401973372103556	174	14	4	0.2857142857142857	0.022988505747126436	KEGG:04310	KEGG	Wnt signaling pathway	8484	299		0.9166666666666666	0.9230769230769231	174	8310	4	10	170	8300	8484	0.07607285135664255
M1	cpdb	0	network_modules	199	TRUE	0.009785596017325267	181	14	4	0.2857142857142857	0.022099447513812154	KEGG:04360	KEGG	Axon guidance	8484	305		1	1	181	8303	4	10	177	8293	8484	0.07438661217203957
M1	cpdb	0	network_modules	200	TRUE	1.0571026793815046e-4	86	21	5	0.23809523809523808	0.05813953488372093	GO:0045103	GO:BP	intermediate filament-based process	16175	11274		0	0.3333333333333333	86	16089	5	16	81	16073	16175	0.11540983181290934
M1	cpdb	0	network_modules	200	TRUE	0.005838654153029089	85	21	4	0.19047619047619047	0.047058823529411764	GO:0045104	GO:BP	intermediate filament cytoskeleton organization	16175	11275		0.5	0.6666666666666666	85	16090	4	17	81	16073	16175	0.09236704063291762
M1	cpdb	0	network_modules	200	TRUE	0.007077170072321803	3	21	2	0.09523809523809523	0.6666666666666666	GO:0033693	GO:BP	neurofilament bundle assembly	16175	8354		1	1	3	16172	2	19	1	16153	16175	0.25167235521278336
M1	cpdb	0	network_modules	201	TRUE	4.1720323104310685e-18	24	22	9	0.4090909090909091	0.375	GO:0031145	GO:BP	anaphase-promoting complex-dependent catabolic process	16175	7063		0	0.043478260869565216	24	16151	9	13	15	16138	16175	0.39080983487799675
M1	cpdb	0	network_modules	201	TRUE	2.5935290106386955e-17	50	22	10	0.45454545454545453	0.2	GO:0051445	GO:BP	regulation of meiotic cell cycle	16175	13708		0.045454545454545456	0.08695652173913043	50	16125	10	12	40	16113	16175	0.3001289778238742
M1	cpdb	0	network_modules	201	TRUE	2.0287674133552768e-16	20	17	8	0.47058823529411764	0.4	REAC:R-HSA-9687136	REAC	Aberrant regulation of mitotic exit in cancer due to RB1 defects	10916	49		0	0.08108108108108109	20	10896	8	9	12	10887	10916	0.43290541049535863
M1	cpdb	0	network_modules	201	TRUE	2.0287674133552768e-16	20	17	8	0.47058823529411764	0.4	REAC:R-HSA-176407	REAC	Conversion from APC/C:Cdc20 to APC/C:Cdh1 in late anaphase	10916	409		0	0.08108108108108109	20	10896	8	9	12	10887	10916	0.43290541049535863
M1	cpdb	0	network_modules	201	TRUE	2.0287674133552768e-16	20	17	8	0.47058823529411764	0.4	REAC:R-HSA-176412	REAC	Phosphorylation of the APC/C	10916	1753		0	0.08108108108108109	20	10896	8	9	12	10887	10916	0.43290541049535863
M1	cpdb	0	network_modules	201	TRUE	3.274834001785644e-16	21	17	8	0.47058823529411764	0.38095238095238093	REAC:R-HSA-141405	REAC	Inhibition of the proteolytic activity of APC/C required for the onset of anaphase by mitotic spindle checkpoint components	10916	1199		0.08333333333333333	0.13513513513513514	21	10895	8	9	13	10886	10916	0.42240924234056426
M1	cpdb	0	network_modules	201	TRUE	3.274834001785644e-16	21	17	8	0.47058823529411764	0.38095238095238093	REAC:R-HSA-141430	REAC	Inactivation of APC/C via direct inhibition of the APC/C complex	10916	1176		0.08333333333333333	0.13513513513513514	21	10895	8	9	13	10886	10916	0.42240924234056426
M1	cpdb	0	network_modules	201	TRUE	1.1810135913324756e-15	24	17	8	0.47058823529411764	0.3333333333333333	REAC:R-HSA-174048	REAC	APC/C:Cdc20 mediated degradation of Cyclin B	10916	25		0.1388888888888889	0.16216216216216217	24	10892	8	9	16	10883	10916	0.39495034131535023
M1	cpdb	0	network_modules	201	TRUE	2.059819618691289e-15	131	12	10	0.8333333333333334	0.07633587786259542	KEGG:04114	KEGG	Oocyte meiosis	8484	268		0	0.2	131	8353	10	2	121	8351	8484	0.24965349392860503
M1	cpdb	0	network_modules	201	TRUE	2.505006118743916e-15	26	17	8	0.47058823529411764	0.3076923076923077	REAC:R-HSA-179409	REAC	APC-Cdc20 mediated degradation of Nek2A	10916	23		0.16666666666666666	0.1891891891891892	26	10890	8	9	18	10881	10916	0.37934241357193665
M1	cpdb	0	network_modules	201	TRUE	1.3289661746364877e-14	157	12	10	0.8333333333333334	0.06369426751592357	KEGG:04110	KEGG	Cell cycle	8484	264		0.25	0.4	157	8327	10	2	147	8325	8484	0.22754646752439567
M1	cpdb	0	network_modules	201	TRUE	4.60423045459284e-14	102	12	9	0.75	0.08823529411764706	KEGG:04914	KEGG	Progesterone-mediated oocyte maturation	8484	371		0.5	0.6	102	8382	9	3	93	8379	8484	0.2548399077091743
M1	cpdb	0	network_modules	201	TRUE	4.8165218178479434e-14	36	17	8	0.47058823529411764	0.2222222222222222	REAC:R-HSA-9687139	REAC	Aberrant regulation of mitotic cell cycle due to RB1 defects	10916	48		0.19444444444444445	0.21621621621621623	36	10880	8	9	28	10871	10916	0.3218961272186436
M1	cpdb	0	network_modules	201	TRUE	7.772504869111084e-14	38	17	8	0.47058823529411764	0.21052631578947367	REAC:R-HSA-9675126	REAC	Diseases of mitotic cell cycle	10916	769		0.2222222222222222	0.24324324324324326	38	10878	8	9	30	10869	10916	0.31321662863516947
M1	cpdb	0	network_modules	201	TRUE	9.771125293489389e-14	39	17	8	0.47058823529411764	0.20512820512820512	REAC:R-HSA-8853884	REAC	Transcriptional Regulation by VENTX	10916	2547		0.25	0.2702702702702703	39	10877	8	9	31	10868	10916	0.30912852850626155
M1	cpdb	0	network_modules	201	TRUE	3.334545210324198e-13	81	17	9	0.5294117647058824	0.1111111111111111	REAC:R-HSA-176408	REAC	Regulation of APC/C activators between G1/S and early anaphase	10916	1963		0.2777777777777778	0.2972972972972973	81	10835	9	8	72	10827	10916	0.24021553787377195
M1	cpdb	0	network_modules	201	TRUE	6.371036550769467e-13	130	22	10	0.45454545454545453	0.07692307692307693	GO:2000241	GO:BP	regulation of reproductive process	16175	25569		0.09090909090909091	0.13043478260869565	130	16045	10	12	120	16033	16175	0.18455129254709363
M1	cpdb	0	network_modules	201	TRUE	7.268858149925227e-13	88	17	9	0.5294117647058824	0.10227272727272728	REAC:R-HSA-453276	REAC	Regulation of mitotic cell cycle	10916	2044		0.3055555555555556	0.35135135135135137	88	10828	9	8	79	10820	10916	0.23025483014570913
M1	cpdb	0	network_modules	201	TRUE	7.268858149925227e-13	88	17	9	0.5294117647058824	0.10227272727272728	REAC:R-HSA-174143	REAC	APC/C-mediated degradation of cell cycle proteins	10916	24		0.3055555555555556	0.35135135135135137	88	10828	9	8	79	10820	10916	0.23025483014570913
M1	cpdb	0	network_modules	201	TRUE	8.695711768603092e-13	140	12	9	0.75	0.06428571428571428	KEGG:04120	KEGG	Ubiquitin mediated proteolysis	8484	270		0.75	0.8	140	8344	9	3	131	8341	8484	0.21669369988958767
M1	cpdb	0	network_modules	201	TRUE	6.901420007193798e-12	64	17	8	0.47058823529411764	0.125	REAC:R-HSA-174084	REAC	Autodegradation of Cdh1 by Cdh1:APC/C	10916	190		0.3611111111111111	0.3783783783783784	64	10852	8	9	56	10843	10916	0.2404064311278447
M1	cpdb	0	network_modules	201	TRUE	1.035394503627376e-11	31	22	7	0.3181818181818182	0.22580645161290322	GO:0070979	GO:BP	protein K11-linked ubiquitination	16175	16411		0.13636363636363635	0.17391304347826086	31	16144	7	15	24	16129	16175	0.26686654277037536
M1	cpdb	0	network_modules	201	TRUE	1.14919422675325e-11	68	17	8	0.47058823529411764	0.11764705882352941	REAC:R-HSA-174154	REAC	APC/C:Cdc20 mediated degradation of Securin	10916	26		0.3888888888888889	0.40540540540540543	68	10848	8	9	60	10839	10916	0.23308755761442093
M1	cpdb	0	network_modules	201	TRUE	2.082084917829692e-11	73	17	8	0.47058823529411764	0.1095890410958904	REAC:R-HSA-174184	REAC	Cdc20:Phospho-APC/C mediated degradation of Cyclin A	10916	319		0.4166666666666667	0.4594594594594595	73	10843	8	9	65	10834	10916	0.22479343705339558
M1	cpdb	0	network_modules	201	TRUE	2.082084917829692e-11	73	17	8	0.47058823529411764	0.1095890410958904	REAC:R-HSA-69017	REAC	CDK-mediated phosphorylation and removal of Cdc6	10916	272		0.4166666666666667	0.4594594594594595	73	10843	8	9	65	10834	10916	0.22479343705339558
M1	cpdb	0	network_modules	201	TRUE	2.332738547959925e-11	74	17	8	0.47058823529411764	0.10810810810810811	REAC:R-HSA-179419	REAC	APC:Cdc20 mediated degradation of cell cycle proteins prior to satisfation of the cell cycle checkpoint	10916	29		0.4722222222222222	0.5135135135135135	74	10842	8	9	66	10833	10916	0.22323560036702442
M1	cpdb	0	network_modules	201	TRUE	2.332738547959925e-11	74	17	8	0.47058823529411764	0.10810810810810811	REAC:R-HSA-174178	REAC	APC/C:Cdh1 mediated degradation of Cdc20 and other APC/C:Cdh1 targeted proteins in late mitosis/early G1	10916	28		0.4722222222222222	0.5135135135135135	74	10842	8	9	66	10833	10916	0.22323560036702442
M1	cpdb	0	network_modules	201	TRUE	2.914183016619372e-11	76	17	8	0.47058823529411764	0.10526315789473684	REAC:R-HSA-176409	REAC	APC/C:Cdc20 mediated degradation of mitotic proteins	10916	27		0.5277777777777778	0.5405405405405406	76	10840	8	9	68	10831	10916	0.22021200274145772
M1	cpdb	0	network_modules	201	TRUE	3.249662286171042e-11	77	17	8	0.47058823529411764	0.1038961038961039	REAC:R-HSA-176814	REAC	Activation of APC/C and APC/C:Cdc20 mediated degradation of mitotic proteins	10916	74		0.5555555555555556	0.5675675675675675	77	10839	8	9	69	10830	10916	0.21874424290468183
M1	cpdb	0	network_modules	201	TRUE	5.0189341190754955e-11	218	12	9	0.75	0.04128440366972477	KEGG:05166	KEGG	Human T-cell leukemia virus 1 infection	8484	447		1	1	218	8266	9	3	209	8263	8484	0.17228346167738084
M1	cpdb	0	network_modules	201	TRUE	5.949587341108574e-11	203	22	10	0.45454545454545453	0.04926108374384237	GO:0051321	GO:BP	meiotic cell cycle	16175	13648		0.18181818181818182	0.21739130434782608	203	15972	10	12	193	15960	16175	0.14652743215623487
M1	cpdb	0	network_modules	201	TRUE	1.421686983637954e-10	92	17	8	0.47058823529411764	0.08695652173913043	REAC:R-HSA-69052	REAC	Switching of origins to a post-replicative state	10916	2365		0.5833333333333334	0.5945945945945946	92	10824	8	9	84	10815	10916	0.1996638475170651
M1	cpdb	0	network_modules	201	TRUE	5.730194913192375e-10	109	17	8	0.47058823529411764	0.07339449541284404	REAC:R-HSA-69618	REAC	Mitotic Spindle Checkpoint	10916	1486		0.6111111111111112	0.6216216216216216	109	10807	8	9	101	10798	10916	0.18295972456054954
M1	cpdb	0	network_modules	201	TRUE	6.649754723071446e-10	111	17	8	0.47058823529411764	0.07207207207207207	REAC:R-HSA-2559582	REAC	Senescence-Associated Secretory Phenotype (SASP)	10916	2194		0.6388888888888888	0.6486486486486487	111	10805	8	9	103	10796	10916	0.18124860001106893
M1	cpdb	0	network_modules	201	TRUE	1.3451104837979142e-9	121	17	8	0.47058823529411764	0.06611570247933884	REAC:R-HSA-69239	REAC	Synthesis of DNA	10916	2376		0.6666666666666666	0.6756756756756757	121	10795	8	9	113	10786	10916	0.17333232426768783
M1	cpdb	0	network_modules	201	TRUE	4.712835317053957e-9	229	17	9	0.5294117647058824	0.039301310043668124	REAC:R-HSA-2555396	REAC	Mitotic Metaphase and Anaphase	10916	1482		0.6944444444444444	0.7027027027027027	229	10687	9	8	220	10679	10916	0.1401144978359615
M1	cpdb	0	network_modules	201	TRUE	4.93726440708682e-9	142	17	8	0.47058823529411764	0.056338028169014086	REAC:R-HSA-68867	REAC	Assembly of the pre-replicative complex	10916	181		0.7222222222222222	0.7297297297297297	142	10774	8	9	134	10765	10916	0.15948830946934606
M1	cpdb	0	network_modules	201	TRUE	1.231277763153637e-8	159	17	8	0.47058823529411764	0.050314465408805034	REAC:R-HSA-69002	REAC	DNA Replication Pre-Initiation	10916	446		0.75	0.7567567567567568	159	10757	8	9	151	10748	10916	0.15032691612564514
M1	cpdb	0	network_modules	201	TRUE	1.4315104497459654e-8	162	17	8	0.47058823529411764	0.04938271604938271	REAC:R-HSA-69242	REAC	S Phase	10916	2111		0.7777777777777778	0.7837837837837838	162	10754	8	9	154	10745	10916	0.1488595017709696
M1	cpdb	0	network_modules	201	TRUE	4.536045693402774e-8	187	17	8	0.47058823529411764	0.0427807486631016	REAC:R-HSA-69306	REAC	DNA Replication	10916	445		0.8055555555555556	0.8108108108108109	187	10729	8	9	179	10720	10916	0.13801641629902303
M1	cpdb	0	network_modules	201	TRUE	4.734127016110305e-8	188	17	8	0.47058823529411764	0.0425531914893617	REAC:R-HSA-2467813	REAC	Separation of Sister Chromatids	10916	2204		0.8333333333333334	0.8378378378378378	188	10728	8	9	180	10719	10916	0.13762746771623716
M1	cpdb	0	network_modules	201	TRUE	6.088463992574282e-8	194	17	8	0.47058823529411764	0.041237113402061855	REAC:R-HSA-2559583	REAC	Cellular Senescence	10916	331		0.8611111111111112	0.8648648648648649	194	10722	8	9	186	10713	10916	0.1353560930048147
M1	cpdb	0	network_modules	201	TRUE	9.745280996543459e-8	427	22	10	0.45454545454545453	0.0234192037470726	GO:0007346	GO:BP	regulation of mitotic cell cycle	16175	2855		0.22727272727272727	0.2608695652173913	427	15748	10	12	417	15736	16175	0.09855870409756365
M1	cpdb	0	network_modules	201	TRUE	2.20878137077849e-7	228	17	8	0.47058823529411764	0.03508771929824561	REAC:R-HSA-68882	REAC	Mitotic Anaphase	10916	1479		0.8888888888888888	0.8918918918918919	228	10688	8	9	220	10679	10916	0.12419477251888864
M1	cpdb	0	network_modules	201	TRUE	6.797217383794806e-7	363	22	9	0.4090909090909091	0.024793388429752067	GO:0043161	GO:BP	proteasome-mediated ubiquitin-dependent protein catabolic process	16175	10561		0.2727272727272727	0.30434782608695654	363	15812	9	13	354	15799	16175	0.09633831851834769
M1	cpdb	0	network_modules	201	TRUE	7.760059560600938e-7	406	17	9	0.5294117647058824	0.022167487684729065	REAC:R-HSA-68886	REAC	M Phase	10916	1343		0.9166666666666666	0.918918918918919	406	10510	9	8	397	10502	10916	0.10272788689193847
M1	cpdb	0	network_modules	201	TRUE	1.443915351007293e-6	289	17	8	0.47058823529411764	0.02768166089965398	REAC:R-HSA-69620	REAC	Cell Cycle Checkpoints	10916	321		0.9444444444444444	0.9459459459459459	289	10627	8	9	281	10618	10916	0.10925321210172406
M1	cpdb	0	network_modules	201	TRUE	2.1036953020415804e-6	792	22	11	0.5	0.013888888888888888	GO:0000278	GO:BP	mitotic cell cycle	16175	76		0.3181818181818182	0.34782608695652173	792	15383	11	11	781	15372	16175	0.07713592552986676
M1	cpdb	0	network_modules	201	TRUE	5.8719674439254974e-6	651	22	10	0.45454545454545453	0.015360983102918587	GO:0019953	GO:BP	sexual reproduction	16175	6073		0.36363636363636365	0.391304347826087	651	15524	10	12	641	15512	16175	0.0777946490070471
M1	cpdb	0	network_modules	201	TRUE	6.5716144169005465e-6	470	22	9	0.4090909090909091	0.019148936170212766	GO:0010498	GO:BP	proteasomal protein catabolic process	16175	4177		0.4090909090909091	0.43478260869565216	470	15705	9	13	461	15692	16175	0.08349938352001958
M1	cpdb	0	network_modules	201	TRUE	2.4581070572968714e-5	547	22	9	0.4090909090909091	0.016453382084095063	GO:0006511	GO:BP	ubiquitin-dependent protein catabolic process	16175	2235		0.45454545454545453	0.4782608695652174	547	15628	9	13	538	15615	16175	0.0766180902359705
M1	cpdb	0	network_modules	201	TRUE	2.7873061781733482e-5	555	22	9	0.4090909090909091	0.016216216216216217	GO:0019941	GO:BP	modification-dependent protein catabolic process	16175	6072		0.5	0.5217391304347826	555	15620	9	13	546	15607	16175	0.07598308562868229
M1	cpdb	0	network_modules	201	TRUE	2.965962889586642e-5	559	22	9	0.4090909090909091	0.016100178890876567	GO:0043632	GO:BP	modification-dependent macromolecule catabolic process	16175	10812		0.5454545454545454	0.5652173913043478	559	15616	9	13	550	15603	16175	0.07567047625935447
M1	cpdb	0	network_modules	201	TRUE	3.4664891353579595e-5	248	22	7	0.3181818181818182	0.028225806451612902	GO:0000209	GO:BP	protein polyubiquitination	16175	59		0.5909090909090909	0.6086956521739131	248	15927	7	15	241	15912	16175	0.09096264613066457
M1	cpdb	0	network_modules	201	TRUE	4.727045705496034e-5	590	22	9	0.4090909090909091	0.015254237288135594	GO:0016567	GO:BP	protein ubiquitination	16175	5254		0.6363636363636364	0.6521739130434783	590	15585	9	13	581	15572	16175	0.07335163549136033
M1	cpdb	0	network_modules	201	TRUE	6.763840579729551e-5	308	17	7	0.4117647058823529	0.022727272727272728	REAC:R-HSA-983168	REAC	Antigen processing: Ubiquitination & Proteasome degradation	10916	154		0.9722222222222222	0.972972972972973	308	10608	7	10	301	10598	10916	0.09147947779520939
M1	cpdb	0	network_modules	201	TRUE	1.3557559803782713e-4	667	22	9	0.4090909090909091	0.013493253373313344	GO:0032446	GO:BP	protein modification by small protein conjugation	16175	7568		0.6818181818181818	0.6956521739130435	667	15508	9	13	658	15495	16175	0.06827539387423957
M1	cpdb	0	network_modules	201	TRUE	1.463681053345962e-4	673	22	9	0.4090909090909091	0.01337295690936107	GO:0051603	GO:BP	proteolysis involved in protein catabolic process	16175	13820		0.7272727272727273	0.7391304347826086	673	15502	9	13	664	15489	16175	0.06791496282918136
M1	cpdb	0	network_modules	201	TRUE	1.574242259640643e-4	90	22	5	0.22727272727272727	0.05555555555555555	GO:0007091	GO:BP	metaphase/anaphase transition of mitotic cell cycle	16175	2675		0.7727272727272727	0.782608695652174	90	16085	5	17	85	16068	16175	0.10999672535113665
M1	cpdb	0	network_modules	201	TRUE	1.758409279191075e-4	92	22	5	0.22727272727272727	0.05434782608695652	GO:0044784	GO:BP	metaphase/anaphase transition of cell cycle	16175	11156		0.8181818181818182	0.8260869565217391	92	16083	5	17	87	16066	16175	0.10874062476473827
M1	cpdb	0	network_modules	201	TRUE	2.541746114355271e-4	99	22	5	0.22727272727272727	0.050505050505050504	GO:0033045	GO:BP	regulation of sister chromatid segregation	16175	8000		0.8636363636363636	0.8695652173913043	99	16076	5	17	94	16059	16175	0.10464383418693096
M1	cpdb	0	network_modules	201	TRUE	2.810778601583034e-4	380	17	7	0.4117647058823529	0.018421052631578946	REAC:R-HSA-983169	REAC	Class I MHC mediated antigen processing & presentation	10916	368		1	1	380	10536	7	10	373	10526	10916	0.08121807086237652
M1	cpdb	0	network_modules	201	TRUE	3.6415572525303857e-4	749	22	9	0.4090909090909091	0.012016021361815754	GO:0070647	GO:BP	protein modification by small protein conjugation or removal	16175	16231		0.9090909090909091	0.9130434782608695	749	15426	9	13	740	15413	16175	0.06371044533297189
M1	cpdb	0	network_modules	201	TRUE	6.226875545589874e-4	798	22	9	0.4090909090909091	0.011278195488721804	GO:0043687	GO:BP	post-translational protein modification	16175	10838		0.9545454545454546	0.9565217391304348	798	15377	9	13	789	15364	16175	0.06130547202364936
M1	cpdb	0	network_modules	201	TRUE	7.827323433297902e-4	124	22	5	0.22727272727272727	0.04032258064516129	GO:0051983	GO:BP	regulation of chromosome segregation	16175	14045		1	1	124	16051	5	17	119	16034	16175	0.09292070229959896
M1	cpdb	0	network_modules	202	TRUE	2.0838493676718797e-7	91	14	6	0.42857142857142855	0.06593406593406594	KEGG:04970	KEGG	Salivary secretion	8484	401		NA	1	91	8393	6	8	85	8385	8484	0.16491465268670513
M1	cpdb	0	network_modules	202	TRUE	6.34610560184145e-4	195	13	5	0.38461538461538464	0.02564102564102564	REAC:R-HSA-375276	REAC	Peptide ligand-binding receptors	10916	1726		0	0.5	195	10721	5	8	190	10713	10916	0.09560913234704949
M1	cpdb	0	network_modules	202	TRUE	0.00803503207395748	328	13	5	0.38461538461538464	0.01524390243902439	REAC:R-HSA-373076	REAC	Class A/1 (Rhodopsin-like receptors)	10916	365		1	1	328	10588	5	8	323	10580	10916	0.07171624431948669
M1	cpdb	0	network_modules	203	TRUE	2.465314522618183e-15	26	20	8	0.4	0.3076923076923077	GO:0006506	GO:BP	GPI anchor biosynthetic process	16175	2232		0	0.047619047619047616	26	16149	8	12	18	16137	16175	0.34991096916176556
M1	cpdb	0	network_modules	203	TRUE	3.501028280752364e-15	27	20	8	0.4	0.2962962962962963	GO:0006505	GO:BP	GPI anchor metabolic process	16175	2231		0.05	0.09523809523809523	27	16148	8	12	19	16136	16175	0.34332734538590187
M1	cpdb	0	network_modules	203	TRUE	1.240758160182498e-14	31	20	8	0.4	0.25806451612903225	GO:0180046	GO:BP	GPI anchored protein biosynthesis	16175	20314		0.1	0.14285714285714285	31	16144	8	12	23	16132	16175	0.3202532312913742
M1	cpdb	0	network_modules	203	TRUE	2.050802908129682e-13	26	14	7	0.5	0.2692307692307692	KEGG:00563	KEGG	Glycosylphosphatidylinositol (GPI)-anchor biosynthesis	8484	87		NA	1	26	8458	7	7	19	8451	8484	0.36551264029451386
M1	cpdb	0	network_modules	203	TRUE	1.0017204518694466e-11	67	20	8	0.4	0.11940298507462686	GO:0009247	GO:BP	glycolipid biosynthetic process	16175	3412		0.15	0.19047619047619047	67	16108	8	12	59	16096	16175	0.21686367177957225
M1	cpdb	0	network_modules	203	TRUE	2.1550429640175418e-11	17	17	6	0.35294117647058826	0.35294117647058826	REAC:R-HSA-162710	REAC	Synthesis of glycosylphosphatidylinositol (GPI)	10916	2409		0	0.16666666666666666	17	10899	6	11	11	10888	10916	0.35193190956536763
M1	cpdb	0	network_modules	203	TRUE	1.4060869086738053e-10	92	20	8	0.4	0.08695652173913043	GO:0006664	GO:BP	glycolipid metabolic process	16175	2373		0.2	0.23809523809523808	92	16083	8	12	84	16071	16175	0.1844881971647466
M1	cpdb	0	network_modules	203	TRUE	1.537405425152922e-10	93	20	8	0.4	0.08602150537634409	GO:1903509	GO:BP	liposaccharide metabolic process	16175	23059		0.25	0.2857142857142857	93	16082	8	12	85	16070	16175	0.18347057855957707
M1	cpdb	0	network_modules	203	TRUE	9.445391916265624e-10	116	20	8	0.4	0.06896551724137931	GO:0006661	GO:BP	phosphatidylinositol biosynthetic process	16175	2370		0.3	0.3333333333333333	116	16059	8	12	108	16047	16175	0.16380248403869307
M1	cpdb	0	network_modules	203	TRUE	2.392434435526964e-9	130	20	8	0.4	0.06153846153846154	GO:0046467	GO:BP	membrane lipid biosynthetic process	16175	12175		0.35	0.38095238095238093	130	16045	8	12	122	16033	16175	0.15445758409771046
M1	cpdb	0	network_modules	203	TRUE	3.452735801444053e-9	136	20	8	0.4	0.058823529411764705	GO:0046488	GO:BP	phosphatidylinositol metabolic process	16175	12192		0.4	0.42857142857142855	136	16039	8	12	128	16027	16175	0.1508973030514619
M1	cpdb	0	network_modules	203	TRUE	1.3408541815768586e-8	91	17	7	0.4117647058823529	0.07692307692307693	REAC:R-HSA-163125	REAC	Post-translational modification: synthesis of GPI-anchored proteins	10916	1775		0.2	0.3333333333333333	91	10825	7	10	84	10815	10916	0.17523723551297352
M1	cpdb	0	network_modules	203	TRUE	3.3259759722990505e-8	180	20	8	0.4	0.044444444444444446	GO:0006643	GO:BP	membrane lipid metabolic process	16175	2354		0.45	0.47619047619047616	180	15995	8	12	172	15983	16175	0.13043188998420216
M1	cpdb	0	network_modules	203	TRUE	4.92197176323308e-8	189	20	8	0.4	0.042328042328042326	GO:0046474	GO:BP	glycerophospholipid biosynthetic process	16175	12181		0.5	0.5238095238095238	189	15986	8	12	181	15974	16175	0.12714213609112734
M1	cpdb	0	network_modules	203	TRUE	1.5434171166780449e-7	218	20	8	0.4	0.03669724770642202	GO:0008654	GO:BP	phospholipid biosynthetic process	16175	3225		0.55	0.5714285714285714	218	15957	8	12	210	15945	16175	0.11794420752547223
M1	cpdb	0	network_modules	203	TRUE	2.0577974541871455e-7	226	20	8	0.4	0.035398230088495575	GO:0045017	GO:BP	glycerolipid biosynthetic process	16175	11231		0.6	0.6190476190476191	226	15949	8	12	218	15937	16175	0.11571867771673931
M1	cpdb	0	network_modules	203	TRUE	8.219920009879773e-7	269	20	8	0.4	0.02973977695167286	GO:0006650	GO:BP	glycerophospholipid metabolic process	16175	2360		0.65	0.6666666666666666	269	15906	8	12	261	15894	16175	0.10547914940587087
M1	cpdb	0	network_modules	203	TRUE	3.9351904024788275e-6	328	20	8	0.4	0.024390243902439025	GO:0006644	GO:BP	phospholipid metabolic process	16175	2355		0.7	0.7142857142857143	328	15847	8	12	320	15835	16175	0.09478964088897138
M1	cpdb	0	network_modules	203	TRUE	4.868551057125387e-6	337	20	8	0.4	0.02373887240356083	GO:0046486	GO:BP	glycerolipid metabolic process	16175	12190		0.75	0.7619047619047619	337	15838	8	12	329	15826	16175	0.0934048358597182
M1	cpdb	0	network_modules	203	TRUE	8.059890583092464e-5	483	20	8	0.4	0.016563146997929608	GO:0051604	GO:BP	protein maturation	16175	13821		0.8	0.8095238095238095	483	15692	8	12	475	15680	16175	0.07651702209024422
M1	cpdb	0	network_modules	203	TRUE	1.2642830923176516e-4	512	20	8	0.4	0.015625	GO:0090407	GO:BP	organophosphate biosynthetic process	16175	18274		0.85	0.8571428571428571	512	15663	8	12	504	15651	16175	0.07402689968030168
M1	cpdb	0	network_modules	203	TRUE	1.3028539329443297e-4	514	20	8	0.4	0.01556420233463035	GO:1901137	GO:BP	carbohydrate derivative biosynthetic process	16175	21245		0.9	0.9047619047619048	514	15661	8	12	506	15649	16175	0.0738626528069823
M1	cpdb	0	network_modules	203	TRUE	1.987554200039531e-4	9	20	3	0.15	0.3333333333333333	GO:0050915	GO:BP	sensory perception of sour taste	16175	13357		0.95	0.9523809523809523	9	16166	3	17	6	16149	16175	0.22297724417132353
M1	cpdb	0	network_modules	203	TRUE	5.831672584407292e-4	625	20	8	0.4	0.0128	GO:0008610	GO:BP	lipid biosynthetic process	16175	3206		1	1	625	15550	8	12	617	15538	16175	0.0659691406559241
M1	cpdb	0	network_modules	203	TRUE	0.0022807807055670263	3	17	2	0.11764705882352941	0.6666666666666666	REAC:R-HSA-4719377	REAC	Defective DPM2 causes DPM2-CDG	10916	536		0.4	1	3	10913	2	15	1	10898	10916	0.2796580487130793
M1	cpdb	0	network_modules	203	TRUE	0.0022807807055670263	3	17	2	0.11764705882352941	0.6666666666666666	REAC:R-HSA-4717374	REAC	Defective DPM1 causes DPM1-CDG	10916	535		0.4	1	3	10913	2	15	1	10898	10916	0.2796580487130793
M1	cpdb	0	network_modules	203	TRUE	0.0022807807055670263	3	17	2	0.11764705882352941	0.6666666666666666	REAC:R-HSA-162699	REAC	Synthesis of dolichyl-phosphate mannose	10916	2406		0.4	1	3	10913	2	15	1	10898	10916	0.2796580487130793
M1	cpdb	0	network_modules	203	TRUE	0.0022807807055670263	3	17	2	0.11764705882352941	0.6666666666666666	REAC:R-HSA-4719360	REAC	Defective DPM3 causes DPM3-CDG	10916	537		0.4	1	3	10913	2	15	1	10898	10916	0.2796580487130793
M1	cpdb	0	network_modules	204	TRUE	1.1584732512275985e-12	141	18	10	0.5555555555555556	0.07092198581560284	REAC:R-HSA-3214847	REAC	HATs acetylate histones	10916	1087		0	0.16666666666666666	141	10775	10	8	131	10767	10916	0.1953075241384409
M1	cpdb	0	network_modules	204	TRUE	8.55052242210717e-10	271	18	10	0.5555555555555556	0.03690036900369004	REAC:R-HSA-3247509	REAC	Chromatin modifying enzymes	10916	355		0.2	0.5	271	10645	10	8	261	10637	10916	0.13862521066649117
M1	cpdb	0	network_modules	204	TRUE	8.55052242210717e-10	271	18	10	0.5555555555555556	0.03690036900369004	REAC:R-HSA-4839726	REAC	Chromatin organization	10916	356		0.2	0.5	271	10645	10	8	261	10637	10916	0.13862521066649117
M1	cpdb	0	network_modules	204	TRUE	1.5571903562536723e-4	41	18	4	0.2222222222222222	0.0975609756097561	REAC:R-HSA-9772755	REAC	Formation of WDR5-containing histone-modifying complexes	10916	952		0.6	0.8333333333333334	41	10875	4	14	37	10861	10916	0.14514571053294437
M1	cpdb	0	network_modules	204	TRUE	1.5571903562536723e-4	41	18	4	0.2222222222222222	0.0975609756097561	REAC:R-HSA-9917777	REAC	Epigenetic regulation by WDR5-containing histone modifying complexes	10916	850		0.6	0.8333333333333334	41	10875	4	14	37	10861	10916	0.14514571053294437
M1	cpdb	0	network_modules	204	TRUE	0.002928219035907725	185	18	5	0.2777777777777778	0.02702702702702703	REAC:R-HSA-212165	REAC	Epigenetic regulation of gene expression	10916	852		1	1	185	10731	5	13	180	10718	10916	0.08212554294295552
M1	cpdb	0	network_modules	204	TRUE	0.0030082549124477594	17	24	3	0.125	0.17647058823529413	GO:0002098	GO:BP	tRNA wobble uridine modification	16175	681		0	0.5	17	16158	3	21	14	16137	16175	0.1474602446488705
M1	cpdb	0	network_modules	204	TRUE	0.00502853374470541	20	24	3	0.125	0.15	GO:0002097	GO:BP	tRNA wobble base modification	16175	680		1	1	20	16155	3	21	17	16134	16175	0.13576080024891163
M1	cpdb	0	network_modules	205	TRUE	1.3219268546021136e-5	108	12	5	0.4166666666666667	0.046296296296296294	KEGG:03013	KEGG	Nucleocytoplasmic transport	8484	209		0	0.5	108	8376	5	7	103	8369	8484	0.13560682312519928
M1	cpdb	0	network_modules	205	TRUE	8.392913225502298e-5	2	7	2	0.2857142857142857	1	REAC:R-HSA-141333	REAC	Biogenic amines are oxidatively deaminated to aldehydes by MAOA and MAOB	10916	226		0	0.25	2	10914	2	5	0	10909	10916	0.5344000301603649
M1	cpdb	0	network_modules	205	TRUE	2.517104963323631e-4	3	7	2	0.2857142857142857	0.6666666666666666	REAC:R-HSA-140179	REAC	Amine Oxidase reactions	10916	138		0.3333333333333333	0.5	3	10913	2	5	1	10908	10916	0.4362157899272416
M1	cpdb	0	network_modules	205	TRUE	0.0013527619567455787	261	22	6	0.2727272727272727	0.022988505747126436	GO:0051169	GO:BP	nuclear transport	16175	13552		0	0.25	261	15914	6	16	255	15898	16175	0.07515553360956014
M1	cpdb	0	network_modules	205	TRUE	0.0013527619567455787	261	22	6	0.2727272727272727	0.022988505747126436	GO:0006913	GO:BP	nucleocytoplasmic transport	16175	2562		0	0.25	261	15914	6	16	255	15898	16175	0.07515553360956014
M1	cpdb	0	network_modules	205	TRUE	0.0021459643839355797	152	22	5	0.22727272727272727	0.03289473684210526	GO:0051168	GO:BP	nuclear export	16175	13551		0.2857142857142857	0.375	152	16023	5	17	147	16006	16175	0.08333812752020428
M1	cpdb	0	network_modules	205	TRUE	0.002156842971704246	71	7	3	0.42857142857142855	0.04225352112676056	REAC:R-HSA-159236	REAC	Transport of Mature mRNA derived from an Intron-Containing Transcript	10916	2586		0.6666666666666666	0.75	71	10845	3	4	68	10841	10916	0.1330018683675745
M1	cpdb	0	network_modules	205	TRUE	0.0028286756272065698	69	22	4	0.18181818181818182	0.057971014492753624	GO:0006406	GO:BP	mRNA export from nucleus	16175	2167		0.42857142857142855	0.5	69	16106	4	18	65	16088	16175	0.10053957371608498
M1	cpdb	0	network_modules	205	TRUE	0.0030927571820933662	80	7	3	0.42857142857142855	0.0375	REAC:R-HSA-72202	REAC	Transport of Mature Transcript to Cytoplasm	10916	2584		1	1	80	10836	3	4	77	10832	10916	0.12510452263556632
M1	cpdb	0	network_modules	205	TRUE	0.0035124324882874524	168	22	5	0.22727272727272727	0.02976190476190476	GO:0015931	GO:BP	nucleobase-containing compound transport	16175	5016		0.5714285714285714	0.625	168	16007	5	17	163	15990	16175	0.07894990229569333
M1	cpdb	0	network_modules	205	TRUE	0.004171813970803954	76	22	4	0.18181818181818182	0.05263157894736842	GO:0051028	GO:BP	mRNA transport	16175	13445		0.7142857142857143	0.75	76	16099	4	18	72	16081	16175	0.09558491164917571
M1	cpdb	0	network_modules	205	TRUE	0.005066760425508641	363	12	5	0.4166666666666667	0.013774104683195593	KEGG:05014	KEGG	Amyotrophic lateral sclerosis	8484	413		1	1	363	8121	5	7	358	8114	8484	0.0695300850078261
M1	cpdb	0	network_modules	205	TRUE	0.005863533221611846	24	22	3	0.13636363636363635	0.125	GO:0016973	GO:BP	poly(A)+ mRNA export from nucleus	16175	5260		0.8571428571428571	0.875	24	16151	3	19	21	16132	16175	0.1293215278126346
M1	cpdb	0	network_modules	205	TRUE	0.008205543522664399	90	22	4	0.18181818181818182	0.044444444444444446	GO:0006405	GO:BP	RNA export from nucleus	16175	2166		1	1	90	16085	4	18	86	16067	16175	0.08744527047370924
M1	cpdb	0	network_modules	206	TRUE	4.681073596105723e-15	575	24	16	0.6666666666666666	0.02782608695652174	GO:0098662	GO:BP	inorganic cation transmembrane transport	16175	18818		0	0.02631578947368421	575	15600	16	8	559	15592	16175	0.13139067187033643
M1	cpdb	0	network_modules	206	TRUE	4.9473743801405345e-15	577	24	16	0.6666666666666666	0.02772963604852686	GO:0098655	GO:BP	monoatomic cation transmembrane transport	16175	18811		0.02702702702702703	0.05263157894736842	577	15598	16	8	561	15590	16175	0.13114547056925843
M1	cpdb	0	network_modules	206	TRUE	2.0028312137636682e-14	630	24	16	0.6666666666666666	0.025396825396825397	GO:0098660	GO:BP	inorganic ion transmembrane transport	16175	18816		0.05405405405405406	0.07894736842105263	630	15545	16	8	614	15537	16175	0.12506878148868114
M1	cpdb	0	network_modules	206	TRUE	2.4110395390666238e-14	43	23	9	0.391304347826087	0.20930232558139536	REAC:R-HSA-1296072	REAC	Voltage gated Potassium channels	10916	2663		0	0.14285714285714285	43	10873	9	14	34	10859	10916	0.2841615719398652
M1	cpdb	0	network_modules	206	TRUE	5.448584211522463e-14	671	24	16	0.6666666666666666	0.02384500745156483	GO:0034220	GO:BP	monoatomic ion transmembrane transport	16175	8508		0.08108108108108109	0.10526315789473684	671	15504	16	8	655	15496	16175	0.1208576510520046
M1	cpdb	0	network_modules	206	TRUE	6.274506619723958e-14	677	24	16	0.6666666666666666	0.023633677991137372	GO:0030001	GO:BP	metal ion transport	16175	6646		0.10810810810810811	0.13157894736842105	677	15498	16	8	661	15490	16175	0.12027278513789096
M1	cpdb	0	network_modules	206	TRUE	3.0411591045971907e-13	748	24	16	0.6666666666666666	0.0213903743315508	GO:0006812	GO:BP	monoatomic cation transport	16175	2492		0.13513513513513514	0.15789473684210525	748	15427	16	8	732	15419	16175	0.1138796637568309
M1	cpdb	0	network_modules	206	TRUE	9.858452046546375e-13	183	24	11	0.4583333333333333	0.060109289617486336	GO:0071805	GO:BP	potassium ion transmembrane transport	16175	16918		0.16216216216216217	0.18421052631578946	183	15992	11	13	172	15979	16175	0.1629295319802257
M1	cpdb	0	network_modules	206	TRUE	2.374555543725756e-12	198	24	11	0.4583333333333333	0.05555555555555555	GO:0006813	GO:BP	potassium ion transport	16175	2493		0.1891891891891892	0.21052631578947367	198	15977	11	13	187	15964	16175	0.15638483580482695
M1	cpdb	0	network_modules	206	TRUE	1.0008097563451393e-10	103	23	9	0.391304347826087	0.08737864077669903	REAC:R-HSA-1296071	REAC	Potassium Channels	10916	1780		0.16666666666666666	0.2857142857142857	103	10813	9	14	94	10799	10916	0.18149973416683765
M1	cpdb	0	network_modules	206	TRUE	5.823512767746127e-9	4	24	4	0.16666666666666666	1	GO:1904045	GO:BP	cellular response to aldosterone	16175	23485		0.21621621621621623	0.2894736842105263	4	16171	4	20	0	16151	16175	0.40799575531012716
M1	cpdb	0	network_modules	206	TRUE	5.823512767746127e-9	4	24	4	0.16666666666666666	1	GO:1904044	GO:BP	response to aldosterone	16175	23484		0.21621621621621623	0.2894736842105263	4	16171	4	20	0	16151	16175	0.40799575531012716
M1	cpdb	0	network_modules	206	TRUE	5.823512767746127e-9	4	24	4	0.16666666666666666	1	GO:0050914	GO:BP	sensory perception of salty taste	16175	13356		0.21621621621621623	0.2894736842105263	4	16171	4	20	0	16151	16175	0.40799575531012716
M1	cpdb	0	network_modules	206	TRUE	2.9088754178139407e-8	5	24	4	0.16666666666666666	0.8	GO:1904116	GO:BP	response to vasopressin	16175	23539		0.2972972972972973	0.3684210526315789	5	16170	4	20	1	16150	16175	0.3647982104044354
M1	cpdb	0	network_modules	206	TRUE	2.9088754178139407e-8	5	24	4	0.16666666666666666	0.8	GO:1904117	GO:BP	cellular response to vasopressin	16175	23540		0.2972972972972973	0.3684210526315789	5	16170	4	20	1	16150	16175	0.3647982104044354
M1	cpdb	0	network_modules	206	TRUE	2.9088754178139407e-8	5	24	4	0.16666666666666666	0.8	GO:0071389	GO:BP	cellular response to mineralocorticoid stimulus	16175	16641		0.2972972972972973	0.3684210526315789	5	16170	4	20	1	16150	16175	0.3647982104044354
M1	cpdb	0	network_modules	206	TRUE	7.36870796790062e-8	6	23	4	0.17391304347826086	0.6666666666666666	REAC:R-HSA-9730628	REAC	Sensory perception of salty taste	10916	2197		0.3333333333333333	0.42857142857142855	6	10910	4	19	2	10891	10916	0.33987802614835777
M1	cpdb	0	network_modules	206	TRUE	1.7169700951004437e-7	7	23	4	0.17391304347826086	0.5714285714285714	REAC:R-HSA-447043	REAC	Neurofascin interactions	10916	1589		0.5	0.5714285714285714	7	10909	4	19	3	10890	10916	0.3145140467407918
M1	cpdb	0	network_modules	206	TRUE	4.060349208678262e-7	8	24	4	0.16666666666666666	0.5	GO:0051385	GO:BP	response to mineralocorticoid	16175	13689		0.3783783783783784	0.39473684210526316	8	16167	4	20	4	16147	16175	0.2881035005970586
M1	cpdb	0	network_modules	206	TRUE	7.301396935985964e-7	9	24	4	0.16666666666666666	0.4444444444444444	GO:0050915	GO:BP	sensory perception of sour taste	16175	13357		0.40540540540540543	0.42105263157894735	9	16166	4	20	5	16146	16175	0.27153392536451076
M1	cpdb	0	network_modules	206	TRUE	2.8598996174343425e-6	12	24	4	0.16666666666666666	0.3333333333333333	GO:0110096	GO:BP	cellular response to aldehyde	16175	19409		0.43243243243243246	0.4473684210526316	12	16163	4	20	8	16143	16175	0.23491451141052108
M1	cpdb	0	network_modules	206	TRUE	4.126878497071776e-6	13	24	4	0.16666666666666666	0.3076923076923077	GO:0071468	GO:BP	cellular response to acidic pH	16175	16701		0.4594594594594595	0.47368421052631576	13	16162	4	20	9	16142	16175	0.22562144616358287
M1	cpdb	0	network_modules	206	TRUE	1.2418087920911981e-5	47	23	5	0.21739130434782608	0.10638297872340426	REAC:R-HSA-9717189	REAC	Sensory perception of taste	10916	2200		0.6666666666666666	0.7142857142857143	47	10869	5	18	42	10851	10916	0.1495423740992222
M1	cpdb	0	network_modules	206	TRUE	1.8553523937558087e-5	400	23	9	0.391304347826087	0.0225	REAC:R-HSA-112316	REAC	Neuronal System	10916	1590		0.8333333333333334	0.8571428571428571	400	10516	9	14	391	10502	10916	0.08673845991552087
M1	cpdb	0	network_modules	206	TRUE	2.2239223453534354e-5	19	24	4	0.16666666666666666	0.21052631578947367	GO:0006883	GO:BP	intracellular sodium ion homeostasis	16175	2539		0.4864864864864865	0.5263157894736842	19	16156	4	20	15	16136	16175	0.186244527810873
M1	cpdb	0	network_modules	206	TRUE	2.2239223453534354e-5	19	24	4	0.16666666666666666	0.21052631578947367	GO:0010447	GO:BP	response to acidic pH	16175	4144		0.4864864864864865	0.5263157894736842	19	16156	4	20	15	16136	16175	0.186244527810873
M1	cpdb	0	network_modules	206	TRUE	4.184660472996148e-5	22	24	4	0.16666666666666666	0.18181818181818182	GO:0098719	GO:BP	sodium ion import across plasma membrane	16175	18849		0.5405405405405406	0.5789473684210527	22	16153	4	20	18	16133	16175	0.17290291232352828
M1	cpdb	0	network_modules	206	TRUE	4.184660472996148e-5	22	24	4	0.16666666666666666	0.18181818181818182	GO:0071467	GO:BP	cellular response to pH	16175	16700		0.5405405405405406	0.5789473684210527	22	16153	4	20	18	16133	16175	0.17290291232352828
M1	cpdb	0	network_modules	206	TRUE	4.2201768390601775e-5	119	23	6	0.2608695652173913	0.05042016806722689	REAC:R-HSA-373760	REAC	L1CAM interactions	10916	1294		1	1	119	10797	6	17	113	10780	10916	0.11061481917662792
M1	cpdb	0	network_modules	206	TRUE	7.215167692518026e-5	25	24	4	0.16666666666666666	0.16	GO:0071384	GO:BP	cellular response to corticosteroid stimulus	16175	16636		0.5945945945945946	0.6052631578947368	25	16150	4	20	21	16130	16175	0.16203037324710862
M1	cpdb	0	network_modules	206	TRUE	7.517497066509e-5	153	12	5	0.4166666666666667	0.032679738562091505	KEGG:04514	KEGG	Cell adhesion molecules	8484	315		0	0.3333333333333333	153	8331	5	7	148	8324	8484	0.11273972472949752
M1	cpdb	0	network_modules	206	TRUE	1.3493286859527135e-4	29	24	4	0.16666666666666666	0.13793103448275862	GO:0009268	GO:BP	response to pH	16175	3433		0.6216216216216216	0.631578947368421	29	16146	4	20	25	16126	16175	0.15023472075636082
M1	cpdb	0	network_modules	206	TRUE	2.3155350559415187e-4	33	24	4	0.16666666666666666	0.12121212121212122	GO:0055078	GO:BP	sodium ion homeostasis	16175	14232		0.6486486486486487	0.6578947368421053	33	16142	4	20	29	16122	16175	0.14064174805694146
M1	cpdb	0	network_modules	206	TRUE	2.570518174672454e-4	85	12	4	0.3333333333333333	0.047058823529411764	KEGG:04742	KEGG	Taste transduction	8484	361		0.5	0.6666666666666666	85	8399	4	8	81	8391	8484	0.1221800232928283
M1	cpdb	0	network_modules	206	TRUE	5.135751984268369e-4	40	24	4	0.16666666666666666	0.1	GO:0031960	GO:BP	response to corticosteroid	16175	7304		0.6756756756756757	0.6842105263157895	40	16135	4	20	36	16115	16175	0.1274360346078703
M1	cpdb	0	network_modules	206	TRUE	7.256967555315551e-4	108	24	5	0.20833333333333334	0.046296296296296294	GO:0001508	GO:BP	action potential	16175	323		0.7027027027027027	0.7105263157894737	108	16067	5	19	103	16048	16175	0.0954515217403917
M1	cpdb	0	network_modules	206	TRUE	9.619062995434115e-4	37	12	3	0.25	0.08108108108108109	KEGG:04960	KEGG	Aldosterone-regulated sodium reabsorption	8484	396		1	1	37	8447	3	9	34	8438	8484	0.14029534293306822
M1	cpdb	0	network_modules	206	TRUE	0.001081197185093845	117	24	5	0.20833333333333334	0.042735042735042736	GO:0099587	GO:BP	inorganic ion import across plasma membrane	16175	19152		0.7297297297297297	0.7631578947368421	117	16058	5	19	112	16039	16175	0.09147944124977832
M1	cpdb	0	network_modules	206	TRUE	0.001081197185093845	117	24	5	0.20833333333333334	0.042735042735042736	GO:0098659	GO:BP	inorganic cation import across plasma membrane	16175	18815		0.7297297297297297	0.7631578947368421	117	16058	5	19	112	16039	16175	0.09147944124977832
M1	cpdb	0	network_modules	206	TRUE	0.0013891227548571822	51	24	4	0.16666666666666666	0.0784313725490196	GO:1901655	GO:BP	cellular response to ketone	16175	21622		0.7837837837837838	0.7894736842105263	51	16124	4	20	47	16104	16175	0.11243013684192836
M1	cpdb	0	network_modules	206	TRUE	0.001503393320158339	52	24	4	0.16666666666666666	0.07692307692307693	GO:0050909	GO:BP	sensory perception of taste	16175	13351		0.8108108108108109	0.8157894736842105	52	16123	4	20	48	16103	16175	0.11130518282332948
M1	cpdb	0	network_modules	206	TRUE	0.0023421019681164187	58	24	4	0.16666666666666666	0.06896551724137931	GO:0097306	GO:BP	cellular response to alcohol	16175	18587		0.8378378378378378	0.8421052631578947	58	16117	4	20	54	16097	16175	0.1051712811966921
M1	cpdb	0	network_modules	206	TRUE	0.003711647367798777	65	24	4	0.16666666666666666	0.06153846153846154	GO:1901379	GO:BP	regulation of potassium ion transmembrane transport	16175	21429		0.8648648648648649	0.868421052631579	65	16110	4	20	61	16090	16175	0.0991048251410368
M1	cpdb	0	network_modules	206	TRUE	0.004921106233711784	159	24	5	0.20833333333333334	0.031446540880503145	GO:0006814	GO:BP	sodium ion transport	16175	2494		0.8918918918918919	0.8947368421052632	159	16016	5	19	154	15997	16175	0.07756082986709648
M1	cpdb	0	network_modules	206	TRUE	0.005919859389824494	73	24	4	0.16666666666666666	0.0547945205479452	GO:1901654	GO:BP	response to ketone	16175	21621		0.918918918918919	0.9210526315789473	73	16102	4	20	69	16082	16175	0.09325567405107683
M1	cpdb	0	network_modules	206	TRUE	0.00625194093603015	74	24	4	0.16666666666666666	0.05405405405405406	GO:0043266	GO:BP	regulation of potassium ion transport	16175	10590		0.9459459459459459	0.9473684210526315	74	16101	4	20	70	16081	16175	0.09259098582456968
M1	cpdb	0	network_modules	206	TRUE	0.008893134236368538	24	24	3	0.125	0.125	GO:0050891	GO:BP	multicellular organismal-level water homeostasis	16175	13335		0.972972972972973	0.9736842105263158	24	16151	3	21	21	16130	16175	0.12369977091201784
M1	cpdb	0	network_modules	206	TRUE	0.00953066367494341	182	24	5	0.20833333333333334	0.027472527472527472	GO:0098739	GO:BP	import across plasma membrane	16175	18866		1	1	182	15993	5	19	177	15974	16175	0.07202697584073496
M1	cpdb	0	network_modules	207	TRUE	6.732114156454804e-4	66	16	4	0.25	0.06060606060606061	REAC:R-HSA-1234176	REAC	Oxygen-dependent proline hydroxylation of Hypoxia-inducible Factor Alpha	10916	1655		0	0.5	66	10850	4	12	62	10838	10916	0.12056772657528957
M1	cpdb	0	network_modules	207	TRUE	0.0011263486588393198	75	16	4	0.25	0.05333333333333334	REAC:R-HSA-1234174	REAC	Cellular response to hypoxia	10916	335		1	1	75	10841	4	12	71	10829	10916	0.112767085727347
M1	cpdb	0	network_modules	209	TRUE	0.0016764303207580484	5	9	2	0.2222222222222222	0.4	REAC:R-HSA-203641	REAC	NOSTRIN mediated eNOS trafficking	10916	1531		NA	1	5	10911	2	7	3	10904	10916	0.2977187878175293
M1	cpdb	0	network_modules	210	TRUE	6.772874312605154e-8	36	12	5	0.4166666666666667	0.1388888888888889	REAC:R-HSA-390522	REAC	Striated Muscle Contraction	10916	2356		0	0.5	36	10880	5	7	31	10873	10916	0.23918458003755771
M1	cpdb	0	network_modules	210	TRUE	1.4234694002069354e-6	414	21	9	0.42857142857142855	0.021739130434782608	GO:0061061	GO:BP	muscle structure development	16175	15177		0	0.07692307692307693	414	15761	9	12	405	15749	16175	0.09200288109672675
M1	cpdb	0	network_modules	210	TRUE	9.627645361645717e-6	203	12	6	0.5	0.029556650246305417	REAC:R-HSA-397014	REAC	Muscle contraction	10916	1496		1	1	203	10713	6	6	197	10707	10916	0.11821343867069786
M1	cpdb	0	network_modules	210	TRUE	1.5539104908082145e-5	59	21	5	0.23809523809523808	0.0847457627118644	GO:0030239	GO:BP	myofibril assembly	16175	6736		0.08333333333333333	0.15384615384615385	59	16116	5	16	54	16100	16175	0.14021843517199745
M1	cpdb	0	network_modules	210	TRUE	3.421921584409331e-5	258	21	7	0.3333333333333333	0.027131782945736434	GO:0006936	GO:BP	muscle contraction	16175	2575		0.16666666666666666	0.23076923076923078	258	15917	7	14	251	15903	16175	0.0913391178973886
M1	cpdb	0	network_modules	210	TRUE	1.0312795087442726e-4	303	21	7	0.3333333333333333	0.0231023102310231	GO:0003012	GO:BP	muscle system process	16175	1463		0.25	0.3076923076923077	303	15872	7	14	296	15858	16175	0.08366358490797089
M1	cpdb	0	network_modules	210	TRUE	1.2960015766036082e-4	182	21	6	0.2857142857142857	0.03296703296703297	GO:0007517	GO:BP	muscle organ development	16175	2999		0.3333333333333333	0.38461538461538464	182	15993	6	15	176	15978	16175	0.09382012737702182
M1	cpdb	0	network_modules	210	TRUE	1.395979723681248e-4	34	21	4	0.19047619047619047	0.11764705882352941	GO:0045214	GO:BP	sarcomere organization	16175	11327		0.4166666666666667	0.46153846153846156	34	16141	4	17	30	16124	16175	0.14829639638244063
M1	cpdb	0	network_modules	210	TRUE	1.5093574894358834e-4	708	21	9	0.42857142857142855	0.012711864406779662	GO:0030029	GO:BP	actin filament-based process	16175	6653		0.5	0.5384615384615384	708	15467	9	12	699	15455	16175	0.06781558126402876
M1	cpdb	0	network_modules	210	TRUE	1.8400538392321814e-4	96	21	5	0.23809523809523808	0.052083333333333336	GO:0032989	GO:BP	cellular anatomical entity morphogenesis	16175	7969		0.5833333333333334	0.6923076923076923	96	16079	5	16	91	16063	16175	0.10897740064107224
M1	cpdb	0	network_modules	210	TRUE	1.8400538392321814e-4	96	21	5	0.23809523809523808	0.052083333333333336	GO:0010927	GO:BP	cellular component assembly involved in morphogenesis	16175	4511		0.5833333333333334	0.6923076923076923	96	16079	5	16	91	16063	16175	0.10897740064107224
M1	cpdb	0	network_modules	210	TRUE	2.6200908896625906e-4	103	21	5	0.23809523809523808	0.04854368932038835	GO:0055002	GO:BP	striated muscle cell development	16175	14191		0.75	0.7692307692307693	103	16072	5	16	98	16056	16175	0.10503588201989196
M1	cpdb	0	network_modules	210	TRUE	5.172025427930503e-4	118	21	5	0.23809523809523808	0.0423728813559322	GO:0055001	GO:BP	muscle cell development	16175	14190		0.8333333333333334	0.8461538461538461	118	16057	5	16	113	16041	16175	0.09778597041017502
M1	cpdb	0	network_modules	210	TRUE	0.003440757891907619	173	21	5	0.23809523809523808	0.028901734104046242	GO:0031032	GO:BP	actomyosin structure organization	16175	7004		0.9166666666666666	0.9230769230769231	173	16002	5	16	168	15986	16175	0.07970648161865315
M1	cpdb	0	network_modules	210	TRUE	0.0036407073587811545	175	21	5	0.23809523809523808	0.02857142857142857	GO:0051146	GO:BP	striated muscle cell differentiation	16175	13529		1	1	175	16000	5	16	170	15984	16175	0.0792115657661409
M1	cpdb	0	network_modules	211	TRUE	5.062180426355017e-8	193	11	7	0.6363636363636364	0.03626943005181347	KEGG:04814	KEGG	Motor proteins	8484	366		0	0.125	193	8291	7	4	186	8287	8484	0.1482832879263616
M1	cpdb	0	network_modules	211	TRUE	8.575040597394151e-8	116	20	7	0.35	0.0603448275862069	GO:0006937	GO:BP	regulation of muscle contraction	16175	2576		0	0.05263157894736842	116	16059	7	13	109	16046	16175	0.14295337183121856
M1	cpdb	0	network_modules	211	TRUE	6.354119421375748e-7	154	20	7	0.35	0.045454545454545456	GO:0090257	GO:BP	regulation of muscle system process	16175	18146		0.05555555555555555	0.10526315789473684	154	16021	7	13	147	16008	16175	0.12336476552393862
M1	cpdb	0	network_modules	211	TRUE	3.647380953330664e-6	93	11	5	0.45454545454545453	0.053763440860215055	KEGG:04520	KEGG	Adherens junction	8484	316		0.14285714285714285	0.25	93	8391	5	6	88	8385	8484	0.15349901351461592
M1	cpdb	0	network_modules	211	TRUE	9.627645361645717e-6	203	12	6	0.5	0.029556650246305417	REAC:R-HSA-397014	REAC	Muscle contraction	10916	1496		0	0.3333333333333333	203	10713	6	6	197	10707	10916	0.11821343867069786
M1	cpdb	0	network_modules	211	TRUE	2.3126273472386536e-5	258	20	7	0.35	0.027131782945736434	GO:0006936	GO:BP	muscle contraction	16175	2575		0.1111111111111111	0.15789473684210525	258	15917	7	13	251	15904	16175	0.09381582837873566
M1	cpdb	0	network_modules	211	TRUE	6.986817467345256e-5	303	20	7	0.35	0.0231023102310231	GO:0003012	GO:BP	muscle system process	16175	1463		0.16666666666666666	0.21052631578947367	303	15872	7	13	296	15859	16175	0.08597008331732518
M1	cpdb	0	network_modules	211	TRUE	1.276779561090346e-4	35	20	4	0.2	0.11428571428571428	GO:0055010	GO:BP	ventricular cardiac muscle tissue morphogenesis	16175	14199		0.2222222222222222	0.2631578947368421	35	16140	4	16	31	16124	16175	0.14980479257980603
M1	cpdb	0	network_modules	211	TRUE	1.7533636493526563e-4	202	11	5	0.45454545454545453	0.024752475247524754	KEGG:04510	KEGG	Focal adhesion	8484	313		0.2857142857142857	0.375	202	8282	5	6	197	8276	8484	0.10179963064376499
M1	cpdb	0	network_modules	211	TRUE	2.457720188151276e-4	41	20	4	0.2	0.0975609756097561	GO:0003229	GO:BP	ventricular cardiac muscle tissue development	16175	1659		0.2777777777777778	0.3157894736842105	41	16134	4	16	37	16118	16175	0.13817627281659906
M1	cpdb	0	network_modules	211	TRUE	2.917810495646966e-4	97	11	4	0.36363636363636365	0.041237113402061855	KEGG:05410	KEGG	Hypertrophic cardiomyopathy	8484	489		0.42857142857142855	0.5	97	8387	4	7	93	8380	8484	0.11936647170775842
M1	cpdb	0	network_modules	211	TRUE	3.112629695042232e-4	227	11	5	0.45454545454545453	0.022026431718061675	KEGG:04810	KEGG	Regulation of actin cytoskeleton	8484	365		0.5714285714285714	0.625	227	8257	5	6	222	8251	8484	0.09551776502935456
M1	cpdb	0	network_modules	211	TRUE	3.286716547135475e-4	44	20	4	0.2	0.09090909090909091	GO:0055008	GO:BP	cardiac muscle tissue morphogenesis	16175	14197		0.3333333333333333	0.3684210526315789	44	16131	4	16	40	16115	16175	0.13326967450420388
M1	cpdb	0	network_modules	211	TRUE	3.332006609517924e-4	381	20	7	0.35	0.01837270341207349	GO:0044057	GO:BP	regulation of system process	16175	10893		0.3888888888888889	0.42105263157894735	381	15794	7	13	374	15781	16175	0.07573688644018782
M1	cpdb	0	network_modules	211	TRUE	3.5667714108525856e-4	102	11	4	0.36363636363636365	0.0392156862745098	KEGG:05414	KEGG	Dilated cardiomyopathy	8484	491		0.7142857142857143	0.75	102	8382	4	7	98	8375	8484	0.11624393791893836
M1	cpdb	0	network_modules	211	TRUE	5.109520732725684e-4	49	20	4	0.2	0.08163265306122448	GO:0048644	GO:BP	muscle organ morphogenesis	16175	12902		0.4444444444444444	0.5263157894736842	49	16126	4	16	45	16110	16175	0.12610895309641054
M1	cpdb	0	network_modules	211	TRUE	5.109520732725684e-4	49	20	4	0.2	0.08163265306122448	GO:0060415	GO:BP	muscle tissue morphogenesis	16175	14616		0.4444444444444444	0.5263157894736842	49	16126	4	16	45	16110	16175	0.12610895309641054
M1	cpdb	0	network_modules	211	TRUE	5.556161634209492e-4	114	11	4	0.36363636363636365	0.03508771929824561	KEGG:04670	KEGG	Leukocyte transendothelial migration	8484	343		0.8571428571428571	0.875	114	8370	4	7	110	8363	8484	0.10959191736846893
M1	cpdb	0	network_modules	211	TRUE	7.039305106944525e-4	53	20	4	0.2	0.07547169811320754	GO:0003208	GO:BP	cardiac ventricle morphogenesis	16175	1638		0.5555555555555556	0.5789473684210527	53	16122	4	16	49	16106	16175	0.1211195639858134
M1	cpdb	0	network_modules	211	TRUE	0.0015023451919805011	708	20	8	0.4	0.011299435028248588	GO:0030029	GO:BP	actin filament-based process	16175	6653		0.6111111111111112	0.631578947368421	708	15467	8	12	700	15455	16175	0.061265375402864496
M1	cpdb	0	network_modules	211	TRUE	0.0019171105564017897	18	20	3	0.15	0.16666666666666666	GO:0002026	GO:BP	regulation of the force of heart contraction	16175	628		0.6666666666666666	0.6842105263157895	18	16157	3	17	15	16140	16175	0.15712542687316935
M1	cpdb	0	network_modules	211	TRUE	0.0021134394013098625	36	12	3	0.25	0.08333333333333333	REAC:R-HSA-390522	REAC	Striated Muscle Contraction	10916	2356		0.5	0.6666666666666666	36	10880	3	9	33	10871	10916	0.14274744937012845
M1	cpdb	0	network_modules	211	TRUE	0.002644355949331062	173	20	5	0.25	0.028901734104046242	GO:0031032	GO:BP	actomyosin structure organization	16175	7004		0.7222222222222222	0.7368421052631579	173	16002	5	15	168	15987	16175	0.08185523402922705
M1	cpdb	0	network_modules	211	TRUE	0.0030284577432423045	76	20	4	0.2	0.05263157894736842	GO:0003231	GO:BP	cardiac ventricle development	16175	1661		0.7777777777777778	0.7894736842105263	76	16099	4	16	72	16083	16175	0.1004858466941227
M1	cpdb	0	network_modules	211	TRUE	0.003361735675362324	78	20	4	0.2	0.05128205128205128	GO:0006942	GO:BP	regulation of striated muscle contraction	16175	2580		0.8333333333333334	0.8421052631578947	78	16097	4	16	74	16081	16175	0.09913256082814248
M1	cpdb	0	network_modules	211	TRUE	0.003637130098314877	43	12	3	0.25	0.06976744186046512	REAC:R-HSA-445355	REAC	Smooth Muscle Contraction	10916	2336		1	1	43	10873	3	9	40	10864	10916	0.13031511395583956
M1	cpdb	0	network_modules	211	TRUE	0.004313685359797789	83	20	4	0.2	0.04819277108433735	GO:0003206	GO:BP	cardiac chamber morphogenesis	16175	1636		0.8888888888888888	0.8947368421052632	83	16092	4	16	79	16076	16175	0.09596296705258629
M1	cpdb	0	network_modules	211	TRUE	0.00837929822998974	98	20	4	0.2	0.04081632653061224	GO:0003205	GO:BP	cardiac chamber development	16175	1635		0.9444444444444444	0.9473684210526315	98	16077	4	16	94	16061	16175	0.08793474157835751
M1	cpdb	0	network_modules	211	TRUE	0.009482354990975574	87	11	3	0.2727272727272727	0.034482758620689655	KEGG:04260	KEGG	Cardiac muscle contraction	8484	296		1	1	87	8397	3	8	84	8389	8484	0.09387302114083469
M1	cpdb	0	network_modules	211	TRUE	0.009827327590554106	632	20	7	0.35	0.011075949367088608	GO:0030036	GO:BP	actin cytoskeleton organization	16175	6660		1	1	632	15543	7	13	625	15530	16175	0.0564597276149367
M1	cpdb	0	network_modules	212	TRUE	2.311087858023994e-10	41	11	6	0.5454545454545454	0.14634146341463414	KEGG:03440	KEGG	Homologous recombination	8484	240		NA	1	41	8443	6	5	35	8438	8484	0.28088705600968383
M1	cpdb	0	network_modules	212	TRUE	1.2789196407824856e-9	36	15	6	0.4	0.16666666666666666	REAC:R-HSA-5689901	REAC	Metalloprotease DUBs	10916	1444		0	0.07692307692307693	36	10880	6	9	30	10871	10916	0.25666980208454276
M1	cpdb	0	network_modules	212	TRUE	5.354766419185816e-9	94	15	7	0.4666666666666667	0.07446808510638298	REAC:R-HSA-69473	REAC	G2/M DNA damage checkpoint	10916	1006		0.08333333333333333	0.15384615384615385	94	10822	7	8	87	10814	10916	0.18389772367226662
M1	cpdb	0	network_modules	212	TRUE	6.7073404386685755e-9	97	15	7	0.4666666666666667	0.07216494845360824	REAC:R-HSA-5693607	REAC	Processing of DNA double-strand break ends	10916	1798		0.16666666666666666	0.23076923076923078	97	10819	7	8	90	10811	10916	0.1809480759740062
M1	cpdb	0	network_modules	212	TRUE	4.2076366147287776e-8	47	22	6	0.2727272727272727	0.1276595744680851	GO:0044818	GO:BP	mitotic G2/M transition checkpoint	16175	11174		0	0.029411764705882353	47	16128	6	16	41	16112	16175	0.18499776691667869
M1	cpdb	0	network_modules	212	TRUE	6.015540446522354e-8	132	15	7	0.4666666666666667	0.05303030303030303	REAC:R-HSA-5693567	REAC	HDR through Homologous Recombination (HRR) or Single Strand Annealing (SSA)	10916	1098		0.25	0.3076923076923077	132	10784	7	8	125	10776	10916	0.1542779943014412
M1	cpdb	0	network_modules	212	TRUE	8.238097521103617e-8	138	15	7	0.4666666666666667	0.050724637681159424	REAC:R-HSA-5693538	REAC	Homology Directed Repair	10916	1130		0.3333333333333333	0.38461538461538464	138	10778	7	8	131	10770	10916	0.15074635104096631
M1	cpdb	0	network_modules	212	TRUE	1.7477094636639076e-7	59	22	6	0.2727272727272727	0.1016949152542373	GO:0010972	GO:BP	negative regulation of G2/M transition of mitotic cell cycle	16175	4548		0.030303030303030304	0.058823529411764705	59	16116	6	16	53	16100	16175	0.16472339393758784
M1	cpdb	0	network_modules	212	TRUE	2.1500838807528995e-7	61	22	6	0.2727272727272727	0.09836065573770492	GO:1902750	GO:BP	negative regulation of cell cycle G2/M phase transition	16175	22476		0.06060606060606061	0.08823529411764706	61	16114	6	16	55	16098	16175	0.16193611159951152
M1	cpdb	0	network_modules	212	TRUE	3.1574512759664737e-7	167	15	7	0.4666666666666667	0.041916167664670656	REAC:R-HSA-69481	REAC	G2/M Checkpoints	10916	1005		0.4166666666666667	0.46153846153846156	167	10749	7	8	160	10741	10916	0.13641574764940972
M1	cpdb	0	network_modules	212	TRUE	3.292593303074445e-7	168	15	7	0.4666666666666667	0.041666666666666664	REAC:R-HSA-5693532	REAC	DNA Double-Strand Break Repair	10916	443		0.5	0.5384615384615384	168	10748	7	8	161	10740	10916	0.13598786407014685
M1	cpdb	0	network_modules	212	TRUE	6.409651669777664e-7	31	22	5	0.22727272727272727	0.16129032258064516	GO:0007095	GO:BP	mitotic G2 DNA damage checkpoint signaling	16175	2678		0.09090909090909091	0.11764705882352941	31	16144	5	17	26	16127	16175	0.1901569059327076
M1	cpdb	0	network_modules	212	TRUE	1.7822542375215533e-6	86	22	6	0.2727272727272727	0.06976744186046512	GO:0010389	GO:BP	regulation of G2/M transition of mitotic cell cycle	16175	4098		0.12121212121212122	0.14705882352941177	86	16089	6	16	80	16073	16175	0.13570430250657844
M1	cpdb	0	network_modules	212	TRUE	3.217816086751097e-6	176	22	7	0.3181818181818182	0.03977272727272727	GO:0000075	GO:BP	cell cycle checkpoint signaling	16175	26		0.15151515151515152	0.17647058823529413	176	15999	7	15	169	15984	16175	0.10931758074277104
M1	cpdb	0	network_modules	212	TRUE	3.949694620639314e-6	98	22	6	0.2727272727272727	0.061224489795918366	GO:1902749	GO:BP	regulation of cell cycle G2/M phase transition	16175	22475		0.18181818181818182	0.20588235294117646	98	16077	6	16	92	16061	16175	0.12681927697713666
M1	cpdb	0	network_modules	212	TRUE	7.269222217987712e-6	68	15	5	0.3333333333333333	0.07352941176470588	REAC:R-HSA-5693571	REAC	Nonhomologous End-Joining (NHEJ)	10916	1605		0.5833333333333334	0.6153846153846154	68	10848	5	10	63	10838	10916	0.15421707950012983
M1	cpdb	0	network_modules	212	TRUE	9.871563416207952e-6	114	22	6	0.2727272727272727	0.05263157894736842	GO:0000086	GO:BP	G2/M transition of mitotic cell cycle	16175	34		0.21212121212121213	0.23529411764705882	114	16061	6	16	108	16045	16175	0.11720553773291578
M1	cpdb	0	network_modules	212	TRUE	1.1207037455471114e-5	338	22	8	0.36363636363636365	0.023668639053254437	GO:0045786	GO:BP	negative regulation of cell cycle	16175	11618		0.24242424242424243	0.2647058823529412	338	15837	8	14	330	15823	16175	0.08842985519369564
M1	cpdb	0	network_modules	212	TRUE	1.3683253670038123e-5	77	15	5	0.3333333333333333	0.06493506493506493	REAC:R-HSA-5693565	REAC	Recruitment and ATM-mediated phosphorylation of repair and signaling proteins at DNA double strand breaks	10916	1949		0.6666666666666666	0.6923076923076923	77	10839	5	10	72	10829	10916	0.1446191353879633
M1	cpdb	0	network_modules	212	TRUE	1.4308465885135065e-5	289	15	7	0.4666666666666667	0.02422145328719723	REAC:R-HSA-69620	REAC	Cell Cycle Checkpoints	10916	321		0.75	0.7692307692307693	289	10627	7	8	282	10619	10916	0.10170999689592236
M1	cpdb	0	network_modules	212	TRUE	1.4609250768171318e-5	78	15	5	0.3333333333333333	0.0641025641025641	REAC:R-HSA-5693606	REAC	DNA Double Strand Break Response	10916	442		0.8333333333333334	0.8461538461538461	78	10838	5	10	73	10828	10916	0.14365538286279878
M1	cpdb	0	network_modules	212	TRUE	1.560891916483927e-5	123	22	6	0.2727272727272727	0.04878048780487805	GO:0031570	GO:BP	DNA integrity checkpoint signaling	16175	7220		0.2727272727272727	0.29411764705882354	123	16052	6	16	117	16036	16175	0.11263133125805293
M1	cpdb	0	network_modules	212	TRUE	1.7178935305141564e-5	224	22	7	0.3181818181818182	0.03125	GO:1901988	GO:BP	negative regulation of cell cycle phase transition	16175	21921		0.30303030303030304	0.3235294117647059	224	15951	7	15	217	15936	16175	0.09610821749045811
M1	cpdb	0	network_modules	212	TRUE	1.9837310722442327e-5	128	22	6	0.2727272727272727	0.046875	GO:0044839	GO:BP	cell cycle G2/M phase transition	16175	11188		0.3333333333333333	0.35294117647058826	128	16047	6	16	122	16031	16175	0.11029803570168084
M1	cpdb	0	network_modules	212	TRUE	2.6120132454452392e-5	134	22	6	0.2727272727272727	0.04477611940298507	GO:0007093	GO:BP	mitotic cell cycle checkpoint signaling	16175	2676		0.36363636363636365	0.38235294117647056	134	16041	6	16	128	16025	16175	0.10766952529126575
M1	cpdb	0	network_modules	212	TRUE	3.484792093104062e-5	329	15	7	0.4666666666666667	0.02127659574468085	REAC:R-HSA-73894	REAC	DNA Repair	10916	444		0.9166666666666666	0.9230769230769231	329	10587	7	8	322	10579	10916	0.09471158647069369
M1	cpdb	0	network_modules	212	TRUE	5.056464637598841e-5	262	22	7	0.3181818181818182	0.026717557251908396	GO:0010948	GO:BP	negative regulation of cell cycle process	16175	4526		0.3939393939393939	0.4117647058823529	262	15913	7	15	255	15898	16175	0.08828486630424705
M1	cpdb	0	network_modules	212	TRUE	7.158434668418398e-5	77	22	5	0.22727272727272727	0.06493506493506493	GO:0044773	GO:BP	mitotic DNA damage checkpoint signaling	16175	11149		0.42424242424242425	0.4411764705882353	77	16098	5	17	72	16081	16175	0.1193030979654546
M1	cpdb	0	network_modules	212	TRUE	7.266273842661311e-5	159	22	6	0.2727272727272727	0.03773584905660377	GO:1901991	GO:BP	negative regulation of mitotic cell cycle phase transition	16175	21924		0.45454545454545453	0.47058823529411764	159	16016	6	16	153	16000	16175	0.09834211569871491
M1	cpdb	0	network_modules	212	TRUE	9.250380593193139e-5	81	22	5	0.22727272727272727	0.06172839506172839	GO:0044774	GO:BP	mitotic DNA integrity checkpoint signaling	16175	11150		0.48484848484848486	0.5	81	16094	5	17	76	16077	16175	0.11620521104815976
M1	cpdb	0	network_modules	212	TRUE	1.2209012513117015e-4	298	22	7	0.3181818181818182	0.02348993288590604	GO:0006302	GO:BP	double-strand break repair	16175	2109		0.5151515151515151	0.5294117647058824	298	15877	7	15	291	15862	16175	0.08226364190528285
M1	cpdb	0	network_modules	212	TRUE	1.574242259640643e-4	90	22	5	0.22727272727272727	0.05555555555555555	GO:0010212	GO:BP	response to ionizing radiation	16175	3993		0.5454545454545454	0.5588235294117647	90	16085	5	17	85	16068	16175	0.10999672535113665
M1	cpdb	0	network_modules	212	TRUE	3.006052388891104e-4	202	22	6	0.2727272727272727	0.0297029702970297	GO:0045930	GO:BP	negative regulation of mitotic cell cycle	16175	11724		0.5757575757575758	0.5882352941176471	202	15973	6	16	196	15957	16175	0.0864833010712916
M1	cpdb	0	network_modules	212	TRUE	3.528087783365912e-4	528	22	8	0.36363636363636365	0.015151515151515152	GO:0006281	GO:BP	DNA repair	16175	2095		0.6060606060606061	0.6176470588235294	528	15647	8	14	520	15633	16175	0.06874100219976403
M1	cpdb	0	network_modules	212	TRUE	5.03423659688108e-4	298	15	6	0.4	0.020134228187919462	REAC:R-HSA-5688426	REAC	Deubiquitination	10916	736		1	1	298	10618	6	9	292	10609	10916	0.08484116292677679
M1	cpdb	0	network_modules	212	TRUE	5.148675415694598e-4	114	22	5	0.22727272727272727	0.043859649122807015	GO:0000077	GO:BP	DNA damage checkpoint signaling	16175	28		0.6363636363636364	0.6470588235294118	114	16061	5	17	109	16044	16175	0.09715307879583054
M1	cpdb	0	network_modules	212	TRUE	5.842279221290673e-4	792	22	9	0.4090909090909091	0.011363636363636364	GO:0000278	GO:BP	mitotic cell cycle	16175	76		0.6666666666666666	0.6764705882352942	792	15383	9	13	783	15370	16175	0.061588687874704555
M1	cpdb	0	network_modules	212	TRUE	5.915913730893272e-4	376	22	7	0.3181818181818182	0.018617021276595744	GO:1901987	GO:BP	regulation of cell cycle phase transition	16175	21920		0.696969696969697	0.7058823529411765	376	15799	7	15	369	15784	16175	0.07223508665417747
M1	cpdb	0	network_modules	212	TRUE	8.815061779181616e-4	127	22	5	0.22727272727272727	0.03937007874015748	GO:0045739	GO:BP	positive regulation of DNA repair	16175	11579		0.7272727272727273	0.7352941176470589	127	16048	5	17	122	16031	16175	0.09174768430172926
M1	cpdb	0	network_modules	212	TRUE	9.572421919613536e-4	246	22	6	0.2727272727272727	0.024390243902439025	GO:0051054	GO:BP	positive regulation of DNA metabolic process	16175	13464		0.7575757575757576	0.7647058823529411	246	15929	6	16	240	15913	16175	0.07765615000211885
M1	cpdb	0	network_modules	212	TRUE	0.0018291947659762329	656	22	8	0.36363636363636365	0.012195121951219513	GO:1903047	GO:BP	mitotic cell cycle process	16175	22727		0.7878787878787878	0.7941176470588235	656	15519	8	14	648	15505	16175	0.06044428618735116
M1	cpdb	0	network_modules	212	TRUE	0.0023040090506577723	286	22	6	0.2727272727272727	0.02097902097902098	GO:1901990	GO:BP	regulation of mitotic cell cycle phase transition	16175	21923		0.8181818181818182	0.8235294117647058	286	15889	6	16	280	15873	16175	0.07141931507387127
M1	cpdb	0	network_modules	212	TRUE	0.002458285646872561	465	22	7	0.3181818181818182	0.015053763440860216	GO:0044770	GO:BP	cell cycle phase transition	16175	11146		0.8484848484848485	0.8529411764705882	465	15710	7	15	458	15695	16175	0.06392395484083555
M1	cpdb	0	network_modules	212	TRUE	0.0038632148352881605	21	22	3	0.13636363636363635	0.14285714285714285	GO:0140861	GO:BP	DNA repair-dependent chromatin remodeling	16175	19904		0.8787878787878788	0.8823529411764706	21	16154	3	19	18	16135	16175	0.13842777919895227
M1	cpdb	0	network_modules	212	TRUE	0.003942632622502406	172	22	5	0.22727272727272727	0.029069767441860465	GO:0042770	GO:BP	signal transduction in response to DNA damage	16175	10355		0.9090909090909091	0.9117647058823529	172	16003	5	17	167	15986	16175	0.07794725331121372
M1	cpdb	0	network_modules	212	TRUE	0.006657235897791603	25	22	3	0.13636363636363635	0.12	GO:0070536	GO:BP	protein K63-linked deubiquitination	16175	16169		0.9393939393939394	0.9411764705882353	25	16150	3	19	22	16131	16175	0.12665454491867303
M1	cpdb	0	network_modules	212	TRUE	0.007893871963105564	798	22	8	0.36363636363636365	0.010025062656641603	GO:0006974	GO:BP	DNA damage response	16175	2601		0.9696969696969697	0.9705882352941176	798	15377	8	14	790	15363	16175	0.053559621720315254
M1	cpdb	0	network_modules	212	TRUE	0.009748646174741802	207	22	5	0.22727272727272727	0.024154589371980676	GO:0006282	GO:BP	regulation of DNA repair	16175	2096		1	1	207	15968	5	17	202	15951	16175	0.07041994482402081
M1	cpdb	0	network_modules	213	TRUE	3.7279175096128554e-4	15	16	3	0.1875	0.2	REAC:R-HSA-71336	REAC	Pentose phosphate pathway	10916	1721		NA	1	15	10901	3	13	12	10888	10916	0.19250331445187688
M1	cpdb	0	network_modules	213	TRUE	5.591377148325997e-4	31	12	3	0.25	0.0967741935483871	KEGG:00030	KEGG	Pentose phosphate pathway	8484	4		NA	1	31	8453	3	9	28	8444	8484	0.1536588767568576
M1	cpdb	0	network_modules	213	TRUE	0.002651933779897005	19	21	3	0.14285714285714285	0.15789473684210525	GO:0006098	GO:BP	pentose-phosphate shunt	16175	1958		0	0.3333333333333333	19	16156	3	18	16	16138	16175	0.1491373278339042
M1	cpdb	0	network_modules	213	TRUE	0.004204086732519456	22	21	3	0.14285714285714285	0.13636363636363635	GO:0006740	GO:BP	NADPH regeneration	16175	2439		0.5	0.6666666666666666	22	16153	3	18	19	16135	16175	0.13842777919895227
M1	cpdb	0	network_modules	213	TRUE	0.00889854498437559	28	21	3	0.14285714285714285	0.10714285714285714	GO:0051156	GO:BP	glucose 6-phosphate metabolic process	16175	13539		1	1	28	16147	3	18	25	16129	16175	0.12240417370554593
M1	cpdb	0	network_modules	214	TRUE	1.8384563501353524e-6	298	17	8	0.47058823529411764	0.026845637583892617	REAC:R-HSA-1474244	REAC	Extracellular matrix organization	10916	889		0	0.2	298	10618	8	9	290	10609	10916	0.10743653287175353
M1	cpdb	0	network_modules	214	TRUE	9.625221720795651e-6	52	22	5	0.22727272727272727	0.09615384615384616	GO:0007157	GO:BP	heterophilic cell-cell adhesion via plasma membrane cell adhesion molecules	16175	2721		0	0.25	52	16123	5	17	47	16106	16175	0.1460712263298511
M1	cpdb	0	network_modules	214	TRUE	2.085659925632548e-5	6	17	3	0.17647058823529413	0.5	REAC:R-HSA-1566977	REAC	Fibronectin matrix formation	10916	941		0.25	0.4	6	10910	3	14	3	10896	10916	0.2964313888728945
M1	cpdb	0	network_modules	214	TRUE	4.589150876320527e-5	84	17	5	0.29411764705882354	0.05952380952380952	REAC:R-HSA-216083	REAC	Integrin cell surface interactions	10916	1216		0.5	0.6	84	10832	5	12	79	10820	10916	0.12945172891042667
M1	cpdb	0	network_modules	214	TRUE	9.323364587856495e-5	191	17	6	0.35294117647058826	0.031413612565445025	REAC:R-HSA-202733	REAC	Cell surface interactions at the vascular wall	10916	327		0.75	0.8	191	10725	6	11	185	10714	10916	0.1010413774358358
M1	cpdb	0	network_modules	214	TRUE	2.2963570185363305e-4	193	22	6	0.2727272727272727	0.031088082901554404	GO:0098742	GO:BP	cell-cell adhesion via plasma-membrane adhesion molecules	16175	18867		0.3333333333333333	0.5	193	15982	6	16	187	15966	16175	0.08864097834467921
M1	cpdb	0	network_modules	214	TRUE	2.6057119323894527e-4	4	8	2	0.25	0.5	KEGG:03264	KEGG	Virion - Flavivirus	8484	230		0	0.5	4	8480	2	6	2	8474	8484	0.3531363758964817
M1	cpdb	0	network_modules	214	TRUE	4.34080506746256e-4	5	8	2	0.25	0.4	KEGG:03260	KEGG	Virion - Human immunodeficiency virus	8484	226		1	1	5	8479	2	6	3	8473	8484	0.3157241938619226
M1	cpdb	0	network_modules	214	TRUE	0.0011729108839143418	20	17	3	0.17647058823529413	0.15	REAC:R-HSA-5621575	REAC	CD209 (DC-SIGN) signaling	10916	265		1	1	20	10896	3	14	17	10882	10916	0.1612819991646386
M1	cpdb	0	network_modules	214	TRUE	0.004740055451238507	745	22	8	0.36363636363636365	0.010738255033557046	GO:0098609	GO:BP	cell-cell adhesion	16175	18805		0.6666666666666666	0.75	745	15430	8	14	737	15416	16175	0.0559136493532417
M1	cpdb	0	network_modules	214	TRUE	0.007153384906324254	3	22	2	0.09090909090909091	0.6666666666666666	GO:0046968	GO:BP	peptide antigen transport	16175	12453		1	1	3	16172	2	20	1	16152	16175	0.2458707737811223
M1	cpdb	0	network_modules	216	TRUE	0.005632197509640658	155	6	3	0.5	0.01935483870967742	KEGG:04150	KEGG	mTOR signaling pathway	8484	284		NA	1	155	8329	3	3	152	8326	8484	0.09569104044165659
M1	cpdb	0	network_modules	217	TRUE	1.7720428564568168e-7	13	12	4	0.3333333333333333	0.3076923076923077	REAC:R-HSA-432047	REAC	Passive transport by Aquaporins	10916	1718		0	0.5	13	10903	4	8	9	10895	10916	0.3194779530919822
M1	cpdb	0	network_modules	217	TRUE	2.245941613341095e-5	20	23	4	0.17391304347826086	0.2	GO:0006833	GO:BP	water transport	16175	2504		0	0.25	20	16155	4	19	16	16136	16175	0.18542145398715104
M1	cpdb	0	network_modules	217	TRUE	4.093245232917705e-5	23	23	4	0.17391304347826086	0.17391304347826086	GO:0042044	GO:BP	fluid transport	16175	9936		0.3333333333333333	0.5	23	16152	4	19	19	16133	16175	0.17273671856493744
M1	cpdb	0	network_modules	217	TRUE	6.55760380088443e-5	52	12	4	0.3333333333333333	0.07692307692307693	REAC:R-HSA-445717	REAC	Aquaporin-mediated transport	10916	164		1	1	52	10864	4	8	48	10856	10916	0.158304101789563
M1	cpdb	0	network_modules	217	TRUE	1.3268737583468042e-4	7	23	3	0.13043478260869565	0.42857142857142855	GO:0015793	GO:BP	glycerol transmembrane transport	16175	4907		0.6666666666666666	0.75	7	16168	3	20	4	16148	16175	0.23586742795786067
M1	cpdb	0	network_modules	217	TRUE	3.178592664005211e-4	9	23	3	0.13043478260869565	0.3333333333333333	GO:0015791	GO:BP	polyol transmembrane transport	16175	4905		1	1	9	16166	3	20	6	16146	16175	0.20783052589345608
M1	cpdb	0	network_modules	218	TRUE	3.741343728890259e-36	141	23	21	0.9130434782608695	0.14893617021276595	REAC:R-HSA-3214847	REAC	HATs acetylate histones	10916	1087		0	0.125	141	10775	21	2	120	10773	10916	0.36630185818597605
M1	cpdb	0	network_modules	218	TRUE	7.195005622404789e-30	271	23	21	0.9130434782608695	0.07749077490774908	REAC:R-HSA-3247509	REAC	Chromatin modifying enzymes	10916	355		0.14285714285714285	0.375	271	10645	21	2	250	10643	10916	0.2623104288006001
M1	cpdb	0	network_modules	218	TRUE	7.195005622404789e-30	271	23	21	0.9130434782608695	0.07749077490774908	REAC:R-HSA-4839726	REAC	Chromatin organization	10916	356		0.14285714285714285	0.375	271	10645	21	2	250	10643	10916	0.2623104288006001
M1	cpdb	0	network_modules	218	TRUE	1.867992311108285e-23	175	24	16	0.6666666666666666	0.09142857142857143	GO:0043484	GO:BP	regulation of RNA splicing	16175	10730		0	0.05555555555555555	175	16000	16	8	159	15992	16175	0.24438472325934557
M1	cpdb	0	network_modules	218	TRUE	3.0231514117367243e-22	207	24	16	0.6666666666666666	0.07729468599033816	GO:0006282	GO:BP	regulation of DNA repair	16175	2096		0.058823529411764705	0.1111111111111111	207	15968	16	8	191	15960	16175	0.22424904776624133
M1	cpdb	0	network_modules	218	TRUE	7.278820755029921e-19	437	24	17	0.7083333333333334	0.038901601830663615	GO:0080135	GO:BP	regulation of cellular response to stress	16175	17817		0.11764705882352941	0.16666666666666666	437	15738	17	7	420	15731	16175	0.16198824944765255
M1	cpdb	0	network_modules	218	TRUE	1.2352923927706872e-17	397	24	16	0.6666666666666666	0.04030226700251889	GO:0008380	GO:BP	RNA splicing	16175	3186		0.17647058823529413	0.2222222222222222	397	15778	16	8	381	15770	16175	0.15997309218402173
M1	cpdb	0	network_modules	218	TRUE	5.380725197229619e-17	435	24	16	0.6666666666666666	0.0367816091954023	GO:0051052	GO:BP	regulation of DNA metabolic process	16175	13462		0.23529411764705882	0.2777777777777778	435	15740	16	8	419	15732	16175	0.15245066715367328
M1	cpdb	0	network_modules	218	TRUE	2.3891755426947663e-16	17	24	8	0.3333333333333333	0.47058823529411764	GO:0090043	GO:BP	regulation of tubulin deacetylation	16175	17974		0.29411764705882354	0.3333333333333333	17	16158	8	16	9	16142	16175	0.3953112595911446
M1	cpdb	0	network_modules	218	TRUE	1.2005808131709932e-15	528	24	16	0.6666666666666666	0.030303030303030304	GO:0006281	GO:BP	DNA repair	16175	2095		0.35294117647058826	0.3888888888888889	528	15647	16	8	512	15639	16175	0.13753815389392438
M1	cpdb	0	network_modules	218	TRUE	1.2347614395520914e-15	20	24	8	0.3333333333333333	0.4	GO:0090042	GO:BP	tubulin deacetylation	16175	17973		0.4117647058823529	0.4444444444444444	20	16155	8	16	12	16139	16175	0.36428936139222995
M1	cpdb	0	network_modules	218	TRUE	7.183757764717997e-15	24	24	8	0.3333333333333333	0.3333333333333333	GO:0090311	GO:BP	regulation of protein deacetylation	16175	18191		0.47058823529411764	0.5	24	16151	8	16	16	16135	16175	0.3323426825996326
M1	cpdb	0	network_modules	218	TRUE	2.0129769161392165e-14	798	24	17	0.7083333333333334	0.021303258145363407	GO:0006974	GO:BP	DNA damage response	16175	2601		0.5294117647058824	0.5555555555555556	798	15377	17	7	781	15370	16175	0.11729972805514993
M1	cpdb	0	network_modules	218	TRUE	5.930478245591169e-13	39	24	8	0.3333333333333333	0.20512820512820512	GO:0006476	GO:BP	protein deacetylation	16175	2213		0.5882352941176471	0.6111111111111112	39	16136	8	16	31	16120	16175	0.26010330167233214
M1	cpdb	0	network_modules	218	TRUE	2.967577627766343e-12	41	23	8	0.34782608695652173	0.1951219512195122	REAC:R-HSA-9917777	REAC	Epigenetic regulation by WDR5-containing histone modifying complexes	10916	850		0.42857142857142855	0.625	41	10875	8	15	33	10860	10916	0.2584604562230308
M1	cpdb	0	network_modules	218	TRUE	2.967577627766343e-12	41	23	8	0.34782608695652173	0.1951219512195122	REAC:R-HSA-9772755	REAC	Formation of WDR5-containing histone-modifying complexes	10916	952		0.42857142857142855	0.625	41	10875	8	15	33	10860	10916	0.2584604562230308
M1	cpdb	0	network_modules	218	TRUE	3.0098607736346333e-12	47	24	8	0.3333333333333333	0.1702127659574468	GO:0035601	GO:BP	protein deacylation	16175	9110		0.6470588235294118	0.7222222222222222	47	16128	8	16	39	16112	16175	0.23663956072997105
M1	cpdb	0	network_modules	218	TRUE	3.0098607736346333e-12	47	24	8	0.3333333333333333	0.1702127659574468	GO:0098732	GO:BP	macromolecule deacylation	16175	18861		0.6470588235294118	0.7222222222222222	47	16128	8	16	39	16112	16175	0.23663956072997105
M1	cpdb	0	network_modules	218	TRUE	7.84944214052117e-11	69	24	8	0.3333333333333333	0.11594202898550725	GO:0045995	GO:BP	regulation of embryonic development	16175	11787		0.7647058823529411	0.7777777777777778	69	16106	8	16	61	16090	16175	0.19463313983329655
M1	cpdb	0	network_modules	218	TRUE	1.5373123444624595e-8	131	24	8	0.3333333333333333	0.061068702290076333	GO:0051302	GO:BP	regulation of cell division	16175	13633		0.8235294117647058	0.8333333333333334	131	16044	8	16	123	16028	16175	0.13987970963865648
M1	cpdb	0	network_modules	218	TRUE	7.592161548184668e-7	185	23	8	0.34782608695652173	0.043243243243243246	REAC:R-HSA-212165	REAC	Epigenetic regulation of gene expression	10916	852		0.7142857142857143	0.75	185	10731	8	15	177	10716	10916	0.11779212669462753
M1	cpdb	0	network_modules	218	TRUE	3.0884215493143154e-6	221	23	8	0.34782608695652173	0.03619909502262444	REAC:R-HSA-5689880	REAC	Ub-specific processing proteases	10916	2617		0.8571428571428571	0.875	221	10695	8	15	213	10680	10916	0.10687725815458152
M1	cpdb	0	network_modules	218	TRUE	3.8252668350318185e-6	43	9	4	0.4444444444444444	0.09302325581395349	KEGG:03022	KEGG	Basal transcription factors	8484	213		NA	1	43	8441	4	5	39	8436	8484	0.2016309951266283
M1	cpdb	0	network_modules	218	TRUE	4.277890008842629e-6	265	24	8	0.3333333333333333	0.03018867924528302	GO:0051301	GO:BP	cell division	16175	13632		0.8823529411764706	0.8888888888888888	265	15910	8	16	257	15894	16175	0.09624606139597743
M1	cpdb	0	network_modules	218	TRUE	3.1712934405052855e-5	298	23	8	0.34782608695652173	0.026845637583892617	REAC:R-HSA-5688426	REAC	Deubiquitination	10916	736		1	1	298	10618	8	15	290	10603	10916	0.09038334837342393
M1	cpdb	0	network_modules	218	TRUE	3.9777991764816426e-5	512	24	9	0.375	0.017578125	GO:0009790	GO:BP	embryo development	16175	3677		0.9411764705882353	0.9444444444444444	512	15663	9	15	503	15648	16175	0.07559794831749214
M1	cpdb	0	network_modules	218	TRUE	0.0016079821387383888	791	24	9	0.375	0.011378002528445006	GO:0000122	GO:BP	negative regulation of transcription by RNA polymerase II	16175	48		1	1	791	15384	9	15	782	15369	16175	0.05828739200234675
M1	cpdb	0	network_modules	219	TRUE	1.9784003666116278e-42	18	22	16	0.7272727272727273	0.8888888888888888	REAC:R-HSA-8964315	REAC	G beta:gamma signalling through BTK	10916	991		0	0.016666666666666666	18	10898	16	6	2	10892	10916	0.8036797569632733
M1	cpdb	0	network_modules	219	TRUE	1.2523376427448355e-41	19	22	16	0.7272727272727273	0.8421052631578947	REAC:R-HSA-392851	REAC	Prostacyclin signalling through prostacyclin receptor	10916	1809		0.01694915254237288	0.03333333333333333	19	10897	16	6	3	10891	10916	0.7821815642469986
M1	cpdb	0	network_modules	219	TRUE	6.258443339938787e-41	20	22	16	0.7272727272727273	0.8	REAC:R-HSA-8964616	REAC	G beta:gamma signalling through CDC42	10916	992		0.03389830508474576	0.06666666666666667	20	10896	16	6	4	10890	10916	0.7623150029724765
M1	cpdb	0	network_modules	219	TRUE	6.258443339938787e-41	20	22	16	0.7272727272727273	0.8	REAC:R-HSA-418217	REAC	G beta:gamma signalling through PLC beta	10916	994		0.03389830508474576	0.06666666666666667	20	10896	16	6	4	10890	10916	0.7623150029724765
M1	cpdb	0	network_modules	219	TRUE	1.0899649848459885e-40	38	22	18	0.8181818181818182	0.47368421052631576	REAC:R-HSA-6814122	REAC	Cooperation of PDCL (PhLP1) and TRiC/CCT in G-protein beta folding	10916	410		0.06779661016949153	0.08333333333333333	38	10878	18	4	20	10874	10916	0.621602768827143
M1	cpdb	0	network_modules	219	TRUE	2.6271839464183302e-40	21	22	16	0.7272727272727273	0.7619047619047619	REAC:R-HSA-500657	REAC	Presynaptic function of Kainate receptors	10916	1791		0.0847457627118644	0.1	21	10895	16	6	5	10889	10916	0.7438834582443106
M1	cpdb	0	network_modules	219	TRUE	9.628015028466581e-40	22	22	16	0.7272727272727273	0.7272727272727273	REAC:R-HSA-392170	REAC	ADP signalling through P2Y purinoceptor 12	10916	13		0.1016949152542373	0.11666666666666667	22	10894	16	6	6	10888	10916	0.7267219653854499
M1	cpdb	0	network_modules	219	TRUE	9.480635456175342e-39	24	22	16	0.7272727272727273	0.6666666666666666	REAC:R-HSA-418592	REAC	ADP signalling through P2Y purinoceptor 1	10916	12		0.11864406779661017	0.16666666666666666	24	10892	16	6	8	10886	10916	0.6956713991550058
M1	cpdb	0	network_modules	219	TRUE	9.480635456175342e-39	24	22	16	0.7272727272727273	0.6666666666666666	REAC:R-HSA-428930	REAC	Thromboxane signalling through TP receptor	10916	2507		0.11864406779661017	0.16666666666666666	24	10892	16	6	8	10886	10916	0.6956713991550058
M1	cpdb	0	network_modules	219	TRUE	9.480635456175342e-39	24	22	16	0.7272727272727273	0.6666666666666666	REAC:R-HSA-202040	REAC	G-protein activation	10916	996		0.11864406779661017	0.16666666666666666	24	10892	16	6	8	10886	10916	0.6956713991550058
M1	cpdb	0	network_modules	219	TRUE	2.632144556651363e-38	25	22	16	0.7272727272727273	0.64	REAC:R-HSA-392451	REAC	G beta:gamma signalling through PI3Kgamma	10916	993		0.1694915254237288	0.18333333333333332	25	10891	16	6	9	10885	10916	0.6815611526054653
M1	cpdb	0	network_modules	219	TRUE	3.913408685278183e-37	28	22	16	0.7272727272727273	0.5714285714285714	REAC:R-HSA-400042	REAC	Adrenaline,noradrenaline inhibits insulin secretion	10916	124		0.1864406779661017	0.2	28	10888	16	6	12	10882	10916	0.6438593057553944
M1	cpdb	0	network_modules	219	TRUE	8.725384291060713e-37	29	22	16	0.7272727272727273	0.5517241379310345	REAC:R-HSA-1296041	REAC	Activation of G protein gated Potassium channels	10916	82		0.2033898305084746	0.25	29	10887	16	6	13	10881	10916	0.6326099765905413
M1	cpdb	0	network_modules	219	TRUE	8.725384291060713e-37	29	22	16	0.7272727272727273	0.5517241379310345	REAC:R-HSA-997272	REAC	Inhibition  of voltage gated Ca2+ channels via Gbeta/gamma subunits	10916	1188		0.2033898305084746	0.25	29	10887	16	6	13	10881	10916	0.6326099765905413
M1	cpdb	0	network_modules	219	TRUE	8.725384291060713e-37	29	22	16	0.7272727272727273	0.5517241379310345	REAC:R-HSA-1296059	REAC	G protein gated Potassium channels	10916	995		0.2033898305084746	0.25	29	10887	16	6	13	10881	10916	0.6326099765905413
M1	cpdb	0	network_modules	219	TRUE	1.8687554706819125e-36	30	22	16	0.7272727272727273	0.5333333333333333	REAC:R-HSA-451326	REAC	Activation of kainate receptors upon glutamate binding	10916	102		0.2542372881355932	0.26666666666666666	30	10886	16	6	14	10880	10916	0.6219270497057675
M1	cpdb	0	network_modules	219	TRUE	2.9672771697054643e-36	43	22	17	0.7727272727272727	0.3953488372093023	REAC:R-HSA-432040	REAC	Vasopressin regulates renal water homeostasis via Aquaporins	10916	2643		0.2711864406779661	0.2833333333333333	43	10873	17	5	26	10868	10916	0.5515424105993992
M1	cpdb	0	network_modules	219	TRUE	3.860091390642378e-36	31	22	16	0.7272727272727273	0.5161290322580645	REAC:R-HSA-456926	REAC	Thrombin signalling through proteinase activated receptors (PARs)	10916	2506		0.288135593220339	0.3	31	10885	16	6	15	10879	10916	0.6117644825425549
M1	cpdb	0	network_modules	219	TRUE	7.716178021733085e-36	32	22	16	0.7272727272727273	0.5	REAC:R-HSA-397795	REAC	G-protein beta:gamma signalling	10916	997		0.3050847457627119	0.3333333333333333	32	10884	16	6	16	10878	10916	0.6020813084449116
M1	cpdb	0	network_modules	219	TRUE	7.716178021733085e-36	32	22	16	0.7272727272727273	0.5	REAC:R-HSA-392518	REAC	Signal amplification	10916	2213		0.3050847457627119	0.3333333333333333	32	10884	16	6	16	10878	10916	0.6020813084449116
M1	cpdb	0	network_modules	219	TRUE	1.4970692646201393e-35	33	22	16	0.7272727272727273	0.48484848484848486	REAC:R-HSA-420092	REAC	Glucagon-type ligand receptors	10916	1050		0.3389830508474576	0.35	33	10883	16	6	17	10877	10916	0.5928409390968797
M1	cpdb	0	network_modules	219	TRUE	5.203696585077721e-35	35	22	16	0.7272727272727273	0.45714285714285713	REAC:R-HSA-1296065	REAC	Inwardly rectifying K+ channels	10916	1271		0.3559322033898305	0.36666666666666664	35	10881	16	6	19	10875	10916	0.5755607423458964
M1	cpdb	0	network_modules	219	TRUE	1.540096669474051e-34	52	22	17	0.7727272727272727	0.3269230769230769	REAC:R-HSA-445717	REAC	Aquaporin-mediated transport	10916	164		0.3728813559322034	0.38333333333333336	52	10864	17	5	35	10859	10916	0.5012164088121241
M1	cpdb	0	network_modules	219	TRUE	2.126448068947781e-33	42	22	16	0.7272727272727273	0.38095238095238093	REAC:R-HSA-381676	REAC	Glucagon-like Peptide-1 (GLP1) regulates insulin secretion	10916	1049		0.3898305084745763	0.4	42	10874	16	6	26	10868	10916	0.5251162813092022
M1	cpdb	0	network_modules	219	TRUE	3.3848070566680744e-33	43	22	16	0.7272727272727273	0.37209302325581395	REAC:R-HSA-9660821	REAC	ADORA2B mediated anti-inflammatory cytokines production	10916	11		0.4067796610169492	0.45	43	10873	16	6	27	10867	10916	0.5189325021677427
M1	cpdb	0	network_modules	219	TRUE	3.3848070566680744e-33	43	22	16	0.7272727272727273	0.37209302325581395	REAC:R-HSA-977444	REAC	GABA B receptor activation	10916	1010		0.4067796610169492	0.45	43	10873	16	6	27	10867	10916	0.5189325021677427
M1	cpdb	0	network_modules	219	TRUE	3.3848070566680744e-33	43	22	16	0.7272727272727273	0.37209302325581395	REAC:R-HSA-991365	REAC	Activation of GABAB receptors	10916	83		0.4067796610169492	0.45	43	10873	16	6	27	10867	10916	0.5189325021677427
M1	cpdb	0	network_modules	219	TRUE	5.3162205387565995e-33	44	22	16	0.7272727272727273	0.36363636363636365	REAC:R-HSA-9634597	REAC	GPER1 signaling	10916	1020		0.4576271186440678	0.4666666666666667	44	10872	16	6	28	10866	10916	0.5129602689190601
M1	cpdb	0	network_modules	219	TRUE	1.5053522207765862e-32	91	22	18	0.8181818181818182	0.1978021978021978	REAC:R-HSA-390466	REAC	Chaperonin-mediated protein folding	10916	345		0.4745762711864407	0.48333333333333334	91	10825	18	4	73	10821	10916	0.4002659710045263
M1	cpdb	0	network_modules	219	TRUE	2.870641885794437e-32	48	22	16	0.7272727272727273	0.3333333333333333	REAC:R-HSA-418597	REAC	G alpha (z) signalling events	10916	990		0.4915254237288136	0.5	48	10868	16	6	32	10862	10916	0.49096356228693433
M1	cpdb	0	network_modules	219	TRUE	6.539675071804714e-32	98	22	18	0.8181818181818182	0.1836734693877551	REAC:R-HSA-391251	REAC	Protein folding	10916	1812		0.5084745762711864	0.5166666666666667	98	10818	18	4	80	10814	10916	0.38552519724003576
M1	cpdb	0	network_modules	219	TRUE	4.352360001327516e-31	78	22	17	0.7727272727272727	0.21794871794871795	REAC:R-HSA-422356	REAC	Regulation of insulin secretion	10916	2040		0.5254237288135594	0.5333333333333333	78	10838	17	5	61	10833	10916	0.4084612920148367
M1	cpdb	0	network_modules	219	TRUE	1.3887864771933609e-30	59	22	16	0.7272727272727273	0.2711864406779661	REAC:R-HSA-4086398	REAC	Ca2+ pathway	10916	296		0.5423728813559322	0.55	59	10857	16	6	43	10851	10916	0.44244362036212237
M1	cpdb	0	network_modules	219	TRUE	1.8928150118290232e-30	60	22	16	0.7272727272727273	0.26666666666666666	REAC:R-HSA-977443	REAC	GABA receptor activation	10916	1011		0.559322033898305	0.5666666666666667	60	10856	16	6	44	10850	10916	0.4387056240284108
M1	cpdb	0	network_modules	219	TRUE	3.1524197341383356e-30	89	20	17	0.85	0.19101123595505617	KEGG:05032	KEGG	Morphine addiction	8484	420		0	0.11764705882352941	89	8395	17	3	72	8392	8484	0.40054210631337445
M1	cpdb	0	network_modules	219	TRUE	3.1524197341383356e-30	89	20	17	0.85	0.19101123595505617	KEGG:04727	KEGG	GABAergic synapse	8484	357		0	0.11764705882352941	89	8395	17	3	72	8392	8484	0.40054210631337445
M1	cpdb	0	network_modules	219	TRUE	6.624751741976772e-29	73	22	16	0.7272727272727273	0.2191780821917808	REAC:R-HSA-9009391	REAC	Extra-nuclear estrogen signaling	10916	888		0.576271186440678	0.5833333333333334	73	10843	16	6	57	10837	10916	0.3973108441590065
M1	cpdb	0	network_modules	219	TRUE	1.5902465724406764e-28	107	22	17	0.7727272727272727	0.1588785046728972	REAC:R-HSA-163685	REAC	Integration of energy metabolism	10916	1213		0.5932203389830508	0.6	107	10809	17	5	90	10804	10916	0.3479993757889159
M1	cpdb	0	network_modules	219	TRUE	2.217847545965896e-28	112	20	17	0.85	0.15178571428571427	KEGG:04726	KEGG	Serotonergic synapse	8484	356		0.125	0.17647058823529413	112	8372	17	3	95	8369	8484	0.35638974227816594
M1	cpdb	0	network_modules	219	TRUE	2.609708496567582e-28	113	20	17	0.85	0.1504424778761062	KEGG:04725	KEGG	Cholinergic synapse	8484	355		0.1875	0.23529411764705882	113	8371	17	3	96	8368	8484	0.35478050395975247
M1	cpdb	0	network_modules	219	TRUE	3.3753734070953335e-28	80	22	16	0.7272727272727273	0.2	REAC:R-HSA-416482	REAC	G alpha (12/13) signalling events	10916	986		0.6101694915254238	0.6166666666666667	80	10836	16	6	64	10830	10916	0.3793153590557779
M1	cpdb	0	network_modules	219	TRUE	9.825966486988455e-28	85	22	16	0.7272727272727273	0.18823529411764706	REAC:R-HSA-418346	REAC	Platelet homeostasis	10916	1765		0.6271186440677966	0.6333333333333333	85	10831	16	6	69	10825	10916	0.3678407032021169
M1	cpdb	0	network_modules	219	TRUE	2.1996230894841668e-27	89	22	16	0.7272727272727273	0.1797752808988764	REAC:R-HSA-111885	REAC	Opioid Signalling	10916	1642		0.6440677966101694	0.65	89	10827	16	6	73	10821	10916	0.3593628761677309
M1	cpdb	0	network_modules	219	TRUE	3.8397331482190656e-27	131	20	17	0.85	0.1297709923664122	KEGG:04728	KEGG	Dopaminergic synapse	8484	358		0.25	0.29411764705882354	131	8353	17	3	114	8350	8484	0.3290243769187673
M1	cpdb	0	network_modules	219	TRUE	4.73586911707884e-27	93	22	16	0.7272727272727273	0.17204301075268819	REAC:R-HSA-373080	REAC	Class B/2 (Secretin family receptors)	10916	366		0.6610169491525424	0.6666666666666666	93	10823	16	6	77	10817	10916	0.3514354950320376
M1	cpdb	0	network_modules	219	TRUE	6.899868518849703e-27	97	20	16	0.8	0.16494845360824742	KEGG:04713	KEGG	Circadian entrainment	8484	348		0.3125	0.35294117647058826	97	8387	16	4	81	8383	8484	0.3605596162293119
M1	cpdb	0	network_modules	219	TRUE	1.8783485181002923e-26	33	22	13	0.5909090909090909	0.3939393939393939	REAC:R-HSA-163359	REAC	Glucagon signaling in metabolic regulation	10916	1048		0.6779661016949152	0.6833333333333333	33	10883	13	9	20	10874	10916	0.48121928053570795
M1	cpdb	0	network_modules	219	TRUE	2.778071088982333e-26	103	22	16	0.7272727272727273	0.1553398058252427	REAC:R-HSA-1296071	REAC	Potassium Channels	10916	1780		0.6949152542372882	0.7	103	10813	16	6	87	10807	10916	0.333668592925054
M1	cpdb	0	network_modules	219	TRUE	3.458797031182393e-26	148	20	17	0.85	0.11486486486486487	KEGG:04723	KEGG	Retrograde endocannabinoid signaling	8484	353		0.375	0.4117647058823529	148	8336	17	3	131	8333	8484	0.30912295822187363
M1	cpdb	0	network_modules	219	TRUE	1.292815483756344e-25	115	20	16	0.8	0.1391304347826087	KEGG:04724	KEGG	Glutamatergic synapse	8484	354		0.4375	0.47058823529411764	115	8369	16	4	99	8365	8484	0.33060584100432727
M1	cpdb	0	network_modules	219	TRUE	1.4649166681909717e-25	156	22	17	0.7727272727272727	0.10897435897435898	REAC:R-HSA-418555	REAC	G alpha (s) signalling events	10916	989		0.711864406779661	0.7166666666666667	156	10760	17	5	139	10755	10916	0.2871652413674008
M1	cpdb	0	network_modules	219	TRUE	9.138558256705815e-25	129	20	16	0.8	0.12403100775193798	KEGG:04926	KEGG	Relaxin signaling pathway	8484	383		0.5	0.5294117647058824	129	8355	16	4	113	8351	8484	0.31175679254189925
M1	cpdb	0	network_modules	219	TRUE	1.9193716224501187e-24	132	22	16	0.7272727272727273	0.12121212121212122	REAC:R-HSA-9664433	REAC	Leishmania parasite growth and survival	10916	1311		0.7288135593220338	0.75	132	10784	16	6	116	10778	10916	0.2940491117954921
M1	cpdb	0	network_modules	219	TRUE	1.9193716224501187e-24	132	22	16	0.7272727272727273	0.12121212121212122	REAC:R-HSA-9662851	REAC	Anti-inflammatory response favouring Leishmania parasite infection	10916	150		0.7288135593220338	0.75	132	10784	16	6	116	10778	10916	0.2940491117954921
M1	cpdb	0	network_modules	219	TRUE	2.8597779978266008e-24	138	20	16	0.8	0.11594202898550725	KEGG:04371	KEGG	Apelin signaling pathway	8484	308		0.5625	0.5882352941176471	138	8346	16	4	122	8342	8484	0.30117424708275514
M1	cpdb	0	network_modules	219	TRUE	7.04886786505874e-24	259	22	18	0.8181818181818182	0.0694980694980695	REAC:R-HSA-112315	REAC	Transmission across Chemical Synapses	10916	2580		0.7627118644067796	0.7666666666666667	259	10657	18	4	241	10653	10916	0.23457580598141914
M1	cpdb	0	network_modules	219	TRUE	7.408333232006897e-24	143	22	16	0.7272727272727273	0.11188811188811189	REAC:R-HSA-3858494	REAC	Beta-catenin independent WNT signaling	10916	216		0.7796610169491526	0.7833333333333333	143	10773	16	6	127	10767	10916	0.2822591779738141
M1	cpdb	0	network_modules	219	TRUE	2.191683382654895e-22	312	22	18	0.8181818181818182	0.057692307692307696	REAC:R-HSA-418594	REAC	G alpha (i) signalling events	10916	987		0.7966101694915254	0.8	312	10604	18	4	294	10600	10916	0.21294925306287862
M1	cpdb	0	network_modules	219	TRUE	4.613444122232959e-22	187	20	16	0.8	0.0855614973262032	KEGG:05034	KEGG	Alcoholism	8484	422		0.625	0.6470588235294118	187	8297	16	4	171	8293	8484	0.25757453113799805
M1	cpdb	0	network_modules	219	TRUE	6.007367275874839e-22	190	20	16	0.8	0.08421052631578947	KEGG:04062	KEGG	Chemokine signaling pathway	8484	255		0.6875	0.7058823529411765	190	8294	16	4	174	8290	8484	0.2554629981436823
M1	cpdb	0	network_modules	219	TRUE	8.484888571591925e-22	194	20	16	0.8	0.08247422680412371	KEGG:05167	KEGG	Kaposi sarcoma-associated herpesvirus infection	8484	448		0.75	0.7647058823529411	194	8290	16	4	178	8286	8484	0.25272330369801377
M1	cpdb	0	network_modules	219	TRUE	1.4240818770243722e-21	196	22	16	0.7272727272727273	0.08163265306122448	REAC:R-HSA-112314	REAC	Neurotransmitter receptors and postsynaptic signal transmission	10916	1594		0.8135593220338984	0.8166666666666667	196	10720	16	6	180	10714	10916	0.24004705755542033
M1	cpdb	0	network_modules	219	TRUE	3.145961535010819e-21	210	20	16	0.8	0.0761904761904762	KEGG:05170	KEGG	Human immunodeficiency virus 1 infection	8484	451		0.8125	0.8235294117647058	210	8274	16	4	194	8270	8484	0.24254973974144892
M1	cpdb	0	network_modules	219	TRUE	5.623211373301773e-21	213	22	16	0.7272727272727273	0.07511737089201878	REAC:R-HSA-416476	REAC	G alpha (q) signalling events	10916	988		0.8305084745762712	0.8333333333333334	213	10703	16	6	197	10697	10916	0.2299453777915511
M1	cpdb	0	network_modules	219	TRUE	6.559346768348071e-21	215	22	16	0.7272727272727273	0.07441860465116279	REAC:R-HSA-9658195	REAC	Leishmania infection	10916	1310		0.847457627118644	0.8666666666666667	215	10701	16	6	199	10695	10916	0.2288354987615326
M1	cpdb	0	network_modules	219	TRUE	6.559346768348071e-21	215	22	16	0.7272727272727273	0.07441860465116279	REAC:R-HSA-9824443	REAC	Parasitic Infection Pathways	10916	1717		0.847457627118644	0.8666666666666667	215	10701	16	6	199	10695	10916	0.2288354987615326
M1	cpdb	0	network_modules	219	TRUE	7.080361384132714e-21	216	22	16	0.7272727272727273	0.07407407407407407	REAC:R-HSA-8939211	REAC	ESR-mediated signaling	10916	830		0.8813559322033898	0.8833333333333333	216	10700	16	6	200	10694	10916	0.22828628103693488
M1	cpdb	0	network_modules	219	TRUE	7.32753130421402e-21	774	23	20	0.8695652173913043	0.025839793281653745	GO:0007186	GO:BP	G protein-coupled receptor signaling pathway	16175	2744		NA	1	774	15401	20	3	754	15398	16175	0.14526821016231886
M1	cpdb	0	network_modules	219	TRUE	8.467460300800676e-21	223	20	16	0.8	0.07174887892376682	KEGG:05163	KEGG	Human cytomegalovirus infection	8484	444		0.875	0.8823529411764706	223	8261	16	4	207	8257	8484	0.23509328943067667
M1	cpdb	0	network_modules	219	TRUE	2.004886050152971e-20	235	20	16	0.8	0.06808510638297872	KEGG:04014	KEGG	Ras signaling pathway	8484	247		0.9375	0.9411764705882353	235	8249	16	4	219	8245	8484	0.2287598130478154
M1	cpdb	0	network_modules	219	TRUE	2.0790225798075134e-20	400	22	18	0.8181818181818182	0.045	REAC:R-HSA-112316	REAC	Neuronal System	10916	1590		0.8983050847457628	0.9	400	10516	18	4	382	10512	10916	0.18692879063277104
M1	cpdb	0	network_modules	219	TRUE	1.3919878103231678e-19	259	22	16	0.7272727272727273	0.06177606177606178	REAC:R-HSA-76002	REAC	Platelet activation, signaling and aggregation	10916	1762		0.9152542372881356	0.9166666666666666	259	10657	16	6	243	10651	10916	0.20773341908385456
M1	cpdb	0	network_modules	219	TRUE	8.798977524140359e-19	290	22	16	0.7272727272727273	0.05517241379310345	REAC:R-HSA-9006931	REAC	Signaling by Nuclear Receptors	10916	2289		0.9322033898305084	0.9333333333333333	290	10626	16	6	274	10620	10916	0.19580927051803376
M1	cpdb	0	network_modules	219	TRUE	6.184920554699802e-18	327	22	16	0.7272727272727273	0.04892966360856269	REAC:R-HSA-195721	REAC	Signaling by WNT	10916	2314		0.9491525423728814	0.95	327	10589	16	6	311	10583	10916	0.18382725295880306
M1	cpdb	0	network_modules	219	TRUE	1.747201889134924e-17	356	20	16	0.8	0.0449438202247191	KEGG:04151	KEGG	PI3K-Akt signaling pathway	8484	285		1	1	356	8128	16	4	340	8124	8484	0.18378173182516644
M1	cpdb	0	network_modules	219	TRUE	2.257641977369256e-17	460	22	17	0.7727272727272727	0.036956521739130437	REAC:R-HSA-500792	REAC	GPCR ligand binding	10916	1019		0.9661016949152542	0.9666666666666667	460	10456	17	5	443	10451	10916	0.1634148780376779
M1	cpdb	0	network_modules	219	TRUE	0.0030769327692432304	21	22	3	0.13636363636363635	0.14285714285714285	REAC:R-HSA-381771	REAC	Synthesis, secretion, and inactivation of Glucagon-like Peptide-1 (GLP-1)	10916	2415		0.9830508474576272	0.9833333333333333	21	10895	3	19	18	10876	10916	0.13787513538282495
M1	cpdb	0	network_modules	219	TRUE	0.004664176146263619	24	22	3	0.13636363636363635	0.125	REAC:R-HSA-400508	REAC	Incretin synthesis, secretion, and inactivation	10916	1180		1	1	24	10892	3	19	21	10873	10916	0.12872445833395138
M1	cpdb	0	network_modules	220	TRUE	2.640683117801438e-17	60	15	10	0.6666666666666666	0.16666666666666666	KEGG:04330	KEGG	Notch signaling pathway	8484	301		0	0.16666666666666666	60	8424	10	5	50	8419	8484	0.3312626445637647
M1	cpdb	0	network_modules	220	TRUE	1.8207838260885574e-16	109	20	11	0.55	0.10091743119266056	GO:0007219	GO:BP	Notch signaling pathway	16175	2773		0	0.2	109	16066	11	9	98	16057	16175	0.23364009209818792
M1	cpdb	0	network_modules	220	TRUE	8.653038958869935e-16	232	15	12	0.8	0.05172413793103448	REAC:R-HSA-157118	REAC	Signaling by NOTCH	10916	2274		0	0.03571428571428571	232	10684	12	3	220	10681	10916	0.20029094985845355
M1	cpdb	0	network_modules	220	TRUE	1.4964575787443656e-13	48	15	8	0.5333333333333333	0.16666666666666666	REAC:R-HSA-9012852	REAC	Signaling by NOTCH3	10916	2282		0.037037037037037035	0.07142857142857142	48	10868	8	7	40	10861	10916	0.29654033704360183
M1	cpdb	0	network_modules	220	TRUE	2.3244741662610005e-12	33	15	7	0.4666666666666667	0.21212121212121213	REAC:R-HSA-1980145	REAC	Signaling by NOTCH2	10916	2281		0.07407407407407407	0.10714285714285714	33	10883	7	8	26	10875	10916	0.3132773193269067
M1	cpdb	0	network_modules	220	TRUE	4.1975949560552935e-9	89	15	7	0.4666666666666667	0.07865168539325842	KEGG:04658	KEGG	Th1 and Th2 cell differentiation	8484	336		0.2	0.3333333333333333	89	8395	7	8	82	8387	8484	0.18843328447492488
M1	cpdb	0	network_modules	220	TRUE	5.472164517260085e-9	79	20	7	0.35	0.08860759493670886	GO:0008593	GO:BP	regulation of Notch signaling pathway	16175	3202		0.25	0.4	79	16096	7	13	72	16083	16175	0.1741799941806682
M1	cpdb	0	network_modules	220	TRUE	1.4455392968137306e-8	108	15	7	0.4666666666666667	0.06481481481481481	REAC:R-HSA-1912422	REAC	Pre-NOTCH Expression and Processing	10916	1783		0.1111111111111111	0.14285714285714285	108	10808	7	8	101	10800	10916	0.1711952859270812
M1	cpdb	0	network_modules	220	TRUE	1.9022300410852192e-8	22	15	5	0.3333333333333333	0.22727272727272727	REAC:R-HSA-2979096	REAC	NOTCH2 Activation and Transmission of Signal to the Nucleus	10916	1533		0.14814814814814814	0.17857142857142858	22	10894	5	10	17	10884	10916	0.27404123578175227
M1	cpdb	0	network_modules	220	TRUE	2.347463183737113e-8	57	15	6	0.4	0.10526315789473684	REAC:R-HSA-2894858	REAC	Signaling by NOTCH1 HD+PEST Domain Mutants in Cancer	10916	2277		0.18518518518518517	0.35714285714285715	57	10859	6	9	51	10850	10916	0.20318746995859754
M1	cpdb	0	network_modules	220	TRUE	2.347463183737113e-8	57	15	6	0.4	0.10526315789473684	REAC:R-HSA-2644602	REAC	Signaling by NOTCH1 PEST Domain Mutants in Cancer	10916	2278		0.18518518518518517	0.35714285714285715	57	10859	6	9	51	10850	10916	0.20318746995859754
M1	cpdb	0	network_modules	220	TRUE	2.347463183737113e-8	57	15	6	0.4	0.10526315789473684	REAC:R-HSA-2644603	REAC	Signaling by NOTCH1 in Cancer	10916	2279		0.18518518518518517	0.35714285714285715	57	10859	6	9	51	10850	10916	0.20318746995859754
M1	cpdb	0	network_modules	220	TRUE	2.347463183737113e-8	57	15	6	0.4	0.10526315789473684	REAC:R-HSA-2644606	REAC	Constitutive Signaling by NOTCH1 PEST Domain Mutants	10916	406		0.18518518518518517	0.35714285714285715	57	10859	6	9	51	10850	10916	0.20318746995859754
M1	cpdb	0	network_modules	220	TRUE	2.347463183737113e-8	57	15	6	0.4	0.10526315789473684	REAC:R-HSA-2894862	REAC	Constitutive Signaling by NOTCH1 HD+PEST Domain Mutants	10916	405		0.18518518518518517	0.35714285714285715	57	10859	6	9	51	10850	10916	0.20318746995859754
M1	cpdb	0	network_modules	220	TRUE	3.829036795810797e-8	25	15	5	0.3333333333333333	0.2	REAC:R-HSA-9013507	REAC	NOTCH3 Activation and Transmission of Signal to the Nucleus	10916	1535		0.37037037037037035	0.39285714285714285	25	10891	5	10	20	10881	10916	0.25689560007912876
M1	cpdb	0	network_modules	220	TRUE	9.999920093039745e-8	72	15	6	0.4	0.08333333333333333	REAC:R-HSA-1980143	REAC	Signaling by NOTCH1	10916	2275		0.4074074074074074	0.42857142857142855	72	10844	6	9	66	10835	10916	0.18028265746696417
M1	cpdb	0	network_modules	220	TRUE	9.821528082563338e-7	15	15	4	0.26666666666666666	0.26666666666666666	REAC:R-HSA-2691230	REAC	Signaling by NOTCH1 HD Domain Mutants in Cancer	10916	2276		0.4444444444444444	0.5	15	10901	4	11	11	10890	10916	0.2656575849310461
M1	cpdb	0	network_modules	220	TRUE	9.821528082563338e-7	15	15	4	0.26666666666666666	0.26666666666666666	REAC:R-HSA-2691232	REAC	Constitutive Signaling by NOTCH1 HD Domain Mutants	10916	404		0.4444444444444444	0.5	15	10901	4	11	11	10890	10916	0.2656575849310461
M1	cpdb	0	network_modules	220	TRUE	2.1964239102354938e-6	18	15	4	0.26666666666666666	0.2222222222222222	REAC:R-HSA-1912420	REAC	Pre-NOTCH Processing in Golgi	10916	1784		0.5185185185185185	0.5357142857142857	18	10898	4	11	14	10887	10916	0.24229320290385836
M1	cpdb	0	network_modules	220	TRUE	6.590944874074207e-6	5	15	3	0.2	0.6	REAC:R-HSA-5083630	REAC	Defective LFNG causes SCDO3	10916	575		0.5555555555555556	0.5714285714285714	5	10911	3	12	2	10899	10916	0.34593374890347606
M1	cpdb	0	network_modules	220	TRUE	7.590332384015425e-6	24	15	4	0.26666666666666666	0.16666666666666666	REAC:R-HSA-9013508	REAC	NOTCH3 Intracellular Domain Regulates Transcription	10916	1536		0.5925925925925926	0.6071428571428571	24	10892	4	11	20	10881	10916	0.20945453964332494
M1	cpdb	0	network_modules	220	TRUE	1.3171018187626472e-5	6	15	3	0.2	0.5	REAC:R-HSA-1912399	REAC	Pre-NOTCH Processing in the Endoplasmic Reticulum	10916	1785		0.6296296296296297	0.6428571428571429	6	10910	3	12	3	10898	10916	0.3156623496336617
M1	cpdb	0	network_modules	220	TRUE	1.457847485325953e-5	28	15	4	0.26666666666666666	0.14285714285714285	REAC:R-HSA-350054	REAC	Notch-HLH transcription pathway	10916	1610		0.6666666666666666	0.6785714285714286	28	10888	4	11	24	10877	10916	0.1936841078794688
M1	cpdb	0	network_modules	220	TRUE	1.7689836603106628e-5	81	15	5	0.3333333333333333	0.06172839506172839	REAC:R-HSA-9013694	REAC	Signaling by NOTCH4	10916	2283		0.7037037037037037	0.7142857142857143	81	10835	5	10	76	10825	10916	0.1408707241611773
M1	cpdb	0	network_modules	220	TRUE	2.2349286365171406e-5	31	15	4	0.26666666666666666	0.12903225806451613	REAC:R-HSA-2122948	REAC	Activated NOTCH1 Transmits Signal to the Nucleus	10916	58		0.7407407407407407	0.75	31	10885	4	11	27	10874	10916	0.18390766511096948
M1	cpdb	0	network_modules	220	TRUE	2.303027194167216e-5	7	15	3	0.2	0.42857142857142855	REAC:R-HSA-2660825	REAC	Signaling by NOTCH1 t(7;9)(NOTCH1:M1580_K2555) Translocation Mutant	10916	2280		0.7777777777777778	0.8214285714285714	7	10909	3	12	4	10897	10916	0.2921257058626122
M1	cpdb	0	network_modules	220	TRUE	2.303027194167216e-5	7	15	3	0.2	0.42857142857142855	REAC:R-HSA-2660826	REAC	Constitutive Signaling by NOTCH1 t(7;9)(NOTCH1:M1580_K2555) Translocation Mutant	10916	407		0.7777777777777778	0.8214285714285714	7	10909	3	12	4	10897	10916	0.2921257058626122
M1	cpdb	0	network_modules	220	TRUE	2.7612940396308014e-5	95	15	5	0.3333333333333333	0.05263157894736842	KEGG:01522	KEGG	Endocrine resistance	8484	196		0.4	0.5	95	8389	5	10	90	8379	8484	0.12884046837471932
M1	cpdb	0	network_modules	220	TRUE	3.944740176541806e-5	330	15	7	0.4666666666666667	0.021212121212121213	KEGG:05165	KEGG	Human papillomavirus infection	8484	446		0.6	0.6666666666666666	330	8154	7	8	323	8146	8484	0.09311038915849174
M1	cpdb	0	network_modules	220	TRUE	8.294549331645199e-5	7	20	3	0.15	0.42857142857142855	GO:0002315	GO:BP	marginal zone B cell differentiation	16175	847		0.5	0.6	7	16168	3	17	4	16151	16175	0.2530259686439337
M1	cpdb	0	network_modules	220	TRUE	1.4416569993232393e-4	12	15	3	0.2	0.25	REAC:R-HSA-2197563	REAC	NOTCH2 intracellular domain regulates transcription	10916	1534		0.8518518518518519	0.8571428571428571	12	10904	3	12	9	10892	10916	0.22265309968803057
M1	cpdb	0	network_modules	220	TRUE	2.381353664577551e-4	14	15	3	0.2	0.21428571428571427	REAC:R-HSA-8941856	REAC	RUNX3 regulates NOTCH signaling	10916	1934		0.8888888888888888	0.8928571428571429	14	10902	3	12	11	10890	10916	0.2059657220886868
M1	cpdb	0	network_modules	220	TRUE	2.4170866819423728e-4	147	15	5	0.3333333333333333	0.034013605442176874	KEGG:05224	KEGG	Breast cancer	8484	475		0.8	0.8333333333333334	147	8337	5	10	142	8327	8484	0.10192079649668818
M1	cpdb	0	network_modules	220	TRUE	7.421248353656359e-4	20	15	3	0.2	0.15	REAC:R-HSA-9013695	REAC	NOTCH4 Intracellular Domain Regulates Transcription	10916	1538		0.9259259259259259	0.9285714285714286	20	10896	3	12	17	10884	10916	0.17189394896130689
M1	cpdb	0	network_modules	220	TRUE	0.0018891285117967026	92	15	4	0.26666666666666666	0.043478260869565216	REAC:R-HSA-1912408	REAC	Pre-NOTCH Transcription and Translation	10916	1786		0.9629629629629629	0.9642857142857143	92	10824	4	11	88	10813	10916	0.10478749521557035
M1	cpdb	0	network_modules	220	TRUE	0.0019171105564017897	18	20	3	0.15	0.16666666666666666	GO:0002313	GO:BP	mature B cell differentiation involved in immune response	16175	845		0.75	0.8	18	16157	3	17	15	16140	16175	0.15712542687316935
M1	cpdb	0	network_modules	220	TRUE	0.002274774027430532	19	20	3	0.15	0.15789473684210525	GO:0002335	GO:BP	mature B cell differentiation	16175	867		1	1	19	16156	3	17	16	16139	16175	0.15287588680262662
M1	cpdb	0	network_modules	220	TRUE	0.0035670916251905895	418	15	6	0.4	0.014354066985645933	REAC:R-HSA-5663202	REAC	Diseases of signal transduction by growth factor receptors and second messengers	10916	773		1	1	418	10498	6	9	412	10489	10916	0.0699185121180224
M1	cpdb	0	network_modules	220	TRUE	0.004391125280632847	47	15	3	0.2	0.06382978723404255	KEGG:00514	KEGG	Other types of O-glycan biosynthesis	8484	67		1	1	47	8437	3	12	44	8425	8484	0.11025997986649207
M1	cpdb	0	network_modules	221	TRUE	2.754004473639774e-9	96	8	6	0.75	0.0625	KEGG:03015	KEGG	mRNA surveillance pathway	8484	210		NA	1	96	8388	6	2	90	8386	8484	0.21455783919309335
M1	cpdb	0	network_modules	221	TRUE	1.4874070233022496e-6	19	13	4	0.3076923076923077	0.21052631578947367	REAC:R-HSA-77595	REAC	Processing of Intronless Pre-mRNAs	10916	1799		0	0.16666666666666666	19	10897	4	9	15	10888	10916	0.25344565688490506
M1	cpdb	0	network_modules	221	TRUE	7.810659455603646e-6	28	13	4	0.3076923076923077	0.14285714285714285	REAC:R-HSA-75067	REAC	Processing of Capped Intronless Pre-mRNA	10916	1797		0.2	0.3333333333333333	28	10888	4	9	24	10879	10916	0.20830041844774547
M1	cpdb	0	network_modules	221	TRUE	9.994016860281507e-5	33	20	4	0.2	0.12121212121212122	GO:0031124	GO:BP	mRNA 3'-end processing	16175	7049		0	0.2	33	16142	4	16	29	16126	16175	0.15436441905689488
M1	cpdb	0	network_modules	221	TRUE	1.2780110709581866e-4	55	13	4	0.3076923076923077	0.07272727272727272	REAC:R-HSA-6784531	REAC	tRNA processing in the nucleus	10916	2745		0.4	0.5	55	10861	4	9	51	10852	10916	0.14760195936312717
M1	cpdb	0	network_modules	221	TRUE	1.3754092267537522e-4	56	13	4	0.3076923076923077	0.07142857142857142	REAC:R-HSA-72187	REAC	mRNA 3'-end processing	10916	2701		0.6	0.6666666666666666	56	10860	4	9	52	10851	10916	0.14624060462138475
M1	cpdb	0	network_modules	221	TRUE	2.5202883698357404e-4	65	13	4	0.3076923076923077	0.06153846153846154	REAC:R-HSA-73856	REAC	RNA Polymerase II Transcription Termination	10916	1895		0.8	0.8333333333333334	65	10851	4	9	61	10842	10916	0.13542544715975635
M1	cpdb	0	network_modules	221	TRUE	5.193197032739663e-4	12	20	3	0.15	0.25	GO:0006388	GO:BP	tRNA splicing, via endonucleolytic cleavage and ligation	16175	2152		0.25	0.4	12	16163	3	17	9	16146	16175	0.1928821983633001
M1	cpdb	0	network_modules	221	TRUE	6.745833686919226e-4	13	20	3	0.15	0.23076923076923078	GO:0000394	GO:BP	RNA splicing, via endonucleolytic cleavage and ligation	16175	119		0.5	0.6	13	16162	3	17	10	16145	16175	0.18524419362516745
M1	cpdb	0	network_modules	221	TRUE	0.001604901634062212	103	13	4	0.3076923076923077	0.038834951456310676	REAC:R-HSA-72306	REAC	tRNA processing	10916	2743		1	1	103	10813	4	9	99	10804	10916	0.10652721440356532
M1	cpdb	0	network_modules	221	TRUE	0.0037214917260370846	80	20	4	0.2	0.05	GO:0031123	GO:BP	RNA 3'-end processing	16175	7048		0.75	0.8	80	16095	4	16	76	16079	16175	0.09782962667482041
M1	cpdb	0	network_modules	221	TRUE	0.006403418026022153	3	20	2	0.1	0.6666666666666666	GO:0000379	GO:BP	tRNA-type intron splice site recognition and cleavage	16175	111		1	1	3	16172	2	18	1	16154	16175	0.25790340281345747
M1	cpdb	0	network_modules	223	TRUE	4.589586002857719e-5	14	12	3	0.25	0.21428571428571427	KEGG:00533	KEGG	Glycosaminoglycan biosynthesis - keratan sulfate	8484	77		NA	1	14	8470	3	9	11	8461	8484	0.23028012794392982
M1	cpdb	0	network_modules	223	TRUE	5.602300635992506e-4	265	19	6	0.3157894736842105	0.022641509433962263	GO:0009101	GO:BP	glycoprotein biosynthetic process	16175	3273		0	0.125	265	15910	6	13	259	15897	16175	0.08088293105577081
M1	cpdb	0	network_modules	223	TRUE	9.189883125243907e-4	61	19	4	0.21052631578947367	0.06557377049180328	GO:1903510	GO:BP	mucopolysaccharide metabolic process	16175	23060		0.14285714285714285	0.25	61	16114	4	15	57	16099	16175	0.1156761233052934
M1	cpdb	0	network_modules	223	TRUE	0.0012644824188297813	66	19	4	0.21052631578947367	0.06060606060606061	GO:0006024	GO:BP	glycosaminoglycan biosynthetic process	16175	1897		0.2857142857142857	0.375	66	16109	4	15	62	16094	16175	0.1110591296397128
M1	cpdb	0	network_modules	223	TRUE	0.001343767847849446	67	19	4	0.21052631578947367	0.05970149253731343	GO:0006023	GO:BP	aminoglycan biosynthetic process	16175	1896		0.42857142857142855	0.5	67	16108	4	15	63	16093	16175	0.11019762531858675
M1	cpdb	0	network_modules	223	TRUE	0.0015346222299949946	514	19	7	0.3684210526315789	0.013618677042801557	GO:1901137	GO:BP	carbohydrate derivative biosynthetic process	16175	21245		0.5714285714285714	0.625	514	15661	7	12	507	15649	16175	0.06581626748791648
M1	cpdb	0	network_modules	223	TRUE	0.0015401692443012052	315	19	6	0.3157894736842105	0.01904761904761905	GO:0009100	GO:BP	glycoprotein metabolic process	16175	3272		0.7142857142857143	0.75	315	15860	6	13	309	15847	16175	0.07353615207675142
M1	cpdb	0	network_modules	223	TRUE	0.0030323917349067858	82	19	4	0.21052631578947367	0.04878048780487805	GO:0030203	GO:BP	glycosaminoglycan metabolic process	16175	6712		0.8571428571428571	0.875	82	16093	4	15	78	16078	16175	0.09920856762685983
M1	cpdb	0	network_modules	223	TRUE	0.0034669397614021415	125	13	4	0.3076923076923077	0.032	REAC:R-HSA-1630316	REAC	Glycosaminoglycan metabolism	10916	1076		0	0.5	125	10791	4	9	121	10782	10916	0.09614392364361116
M1	cpdb	0	network_modules	223	TRUE	0.004188003377386938	5	13	2	0.15384615384615385	0.4	REAC:R-HSA-446205	REAC	Synthesis of GDP-mannose	10916	2378		1	1	5	10911	2	11	3	10900	10916	0.24753500040008916
M1	cpdb	0	network_modules	223	TRUE	0.004403726754551432	90	19	4	0.21052631578947367	0.044444444444444446	GO:0006022	GO:BP	aminoglycan metabolic process	16175	1895		1	1	90	16085	4	15	86	16070	16175	0.09449222997869211
M1	cpdb	0	network_modules	224	TRUE	0.0016764303207580484	5	9	2	0.2222222222222222	0.4	REAC:R-HSA-2161517	REAC	Abacavir transmembrane transport	10916	45		0	0.2	5	10911	2	7	3	10904	10916	0.2977187878175293
M1	cpdb	0	network_modules	224	TRUE	0.004101533137935027	3	17	2	0.11764705882352941	0.6666666666666666	GO:0015847	GO:BP	putrescine transport	16175	4956		NA	1	3	16172	2	15	1	16157	16175	0.27978750803920066
M1	cpdb	0	network_modules	224	TRUE	0.006024832901546089	9	9	2	0.2222222222222222	0.2222222222222222	REAC:R-HSA-2161522	REAC	Abacavir ADME	10916	43		0.25	0.4	9	10907	2	7	7	10900	10916	0.22158043254586762
M1	cpdb	0	network_modules	224	TRUE	0.007527820621271228	10	9	2	0.2222222222222222	0.2	REAC:R-HSA-549127	REAC	Organic cation transport	10916	1649		0.5	0.8	10	10906	2	7	8	10899	10916	0.21013230935567795
M1	cpdb	0	network_modules	224	TRUE	0.007527820621271228	10	9	2	0.2222222222222222	0.2	REAC:R-HSA-112311	REAC	Neurotransmitter clearance	10916	1593		0.5	0.8	10	10906	2	7	8	10899	10916	0.21013230935567795
M1	cpdb	0	network_modules	224	TRUE	0.009920683106087872	84	9	3	0.3333333333333333	0.03571428571428571	REAC:R-HSA-425366	REAC	Transport of bile salts and organic acids, metal ions and amine compounds	10916	2590		1	1	84	10832	3	6	81	10826	10916	0.10704675609618654
M1	cpdb	0	network_modules	225	TRUE	3.7356599809763624e-5	156	10	5	0.5	0.03205128205128205	REAC:R-HSA-418555	REAC	G alpha (s) signalling events	10916	989		NA	1	156	10760	5	5	151	10755	10916	0.12391918312129133
M1	cpdb	0	network_modules	225	TRUE	0.002725735821267419	165	21	5	0.23809523809523808	0.030303030303030304	GO:0003341	GO:BP	cilium movement	16175	1761		0	0.5	165	16010	5	16	160	15994	16175	0.08177296455955049
M1	cpdb	0	network_modules	225	TRUE	0.007077170072321803	3	21	2	0.09523809523809523	0.6666666666666666	GO:0009214	GO:BP	cyclic nucleotide catabolic process	16175	3380		1	1	3	16172	2	19	1	16153	16175	0.25167235521278336
M1	cpdb	0	network_modules	226	TRUE	5.129458878107337e-20	29	22	10	0.45454545454545453	0.3448275862068966	GO:0001990	GO:BP	regulation of systemic arterial blood pressure by hormone	16175	594		0	0.019230769230769232	29	16146	10	12	19	16134	16175	0.3949648788570566
M1	cpdb	0	network_modules	226	TRUE	8.872239279831899e-19	37	22	10	0.45454545454545453	0.2702702702702703	GO:0003044	GO:BP	regulation of systemic arterial blood pressure mediated by a chemical signal	16175	1495		0.0196078431372549	0.038461538461538464	37	16138	10	12	27	16126	16175	0.34937316834305926
M1	cpdb	0	network_modules	226	TRUE	9.480367939358175e-19	62	22	11	0.5	0.1774193548387097	GO:0003073	GO:BP	regulation of systemic arterial blood pressure	16175	1524		0.0392156862745098	0.057692307692307696	62	16113	11	11	51	16102	16175	0.2963280715083424
M1	cpdb	0	network_modules	226	TRUE	6.826801456421713e-18	114	22	12	0.5454545454545454	0.10526315789473684	GO:0008217	GO:BP	regulation of blood pressure	16175	3144		0.058823529411764705	0.07692307692307693	114	16061	12	10	102	16051	16175	0.23752029135542724
M1	cpdb	0	network_modules	226	TRUE	1.0851268948767416e-16	57	22	10	0.45454545454545453	0.17543859649122806	GO:0050886	GO:BP	endocrine process	16175	13330		0.0784313725490196	0.09615384615384616	57	16118	10	12	47	16106	16175	0.28088805610494094
M1	cpdb	0	network_modules	226	TRUE	1.383907327051631e-13	358	22	13	0.5909090909090909	0.036312849162011177	GO:0008015	GO:BP	blood circulation	16175	3096		0.09803921568627451	0.11538461538461539	358	15817	13	9	345	15808	16175	0.14268123338048896
M1	cpdb	0	network_modules	226	TRUE	2.296692522351759e-13	71	22	9	0.4090909090909091	0.1267605633802817	GO:0035296	GO:BP	regulation of tube diameter	16175	8954		0.11764705882352941	0.17307692307692307	71	16104	9	13	62	16091	16175	0.22592677614771206
M1	cpdb	0	network_modules	226	TRUE	2.296692522351759e-13	71	22	9	0.4090909090909091	0.1267605633802817	GO:0035150	GO:BP	regulation of tube size	16175	8847		0.11764705882352941	0.17307692307692307	71	16104	9	13	62	16091	16175	0.22592677614771206
M1	cpdb	0	network_modules	226	TRUE	2.296692522351759e-13	71	22	9	0.4090909090909091	0.1267605633802817	GO:0097746	GO:BP	blood vessel diameter maintenance	16175	18758		0.11764705882352941	0.17307692307692307	71	16104	9	13	62	16091	16175	0.22592677614771206
M1	cpdb	0	network_modules	226	TRUE	6.421238676866686e-13	44	22	8	0.36363636363636365	0.18181818181818182	GO:0042310	GO:BP	vasoconstriction	16175	10083		0.17647058823529413	0.19230769230769232	44	16131	8	14	36	16117	16175	0.25572802516188115
M1	cpdb	0	network_modules	226	TRUE	1.9584599338302008e-12	439	22	13	0.5909090909090909	0.029612756264236904	GO:0003013	GO:BP	circulatory system process	16175	1464		0.19607843137254902	0.21153846153846154	439	15736	13	9	426	15727	16175	0.12804138442133786
M1	cpdb	0	network_modules	226	TRUE	4.974829487307316e-11	17	22	6	0.2727272727272727	0.35294117647058826	GO:0003081	GO:BP	regulation of systemic arterial blood pressure by renin-angiotensin	16175	1526		0.21568627450980393	0.23076923076923078	17	16158	6	16	11	16142	16175	0.3094300400265976
M1	cpdb	0	network_modules	226	TRUE	1.45110079450303e-10	23	17	6	0.35294117647058826	0.2608695652173913	KEGG:04614	KEGG	Renin-angiotensin system	8484	324		0	0.25	23	8461	6	11	17	8450	8484	0.3018138436571529
M1	cpdb	0	network_modules	226	TRUE	1.884976762645323e-9	188	22	9	0.4090909090909091	0.047872340425531915	GO:0003018	GO:BP	vascular process in circulatory system	16175	1469		0.23529411764705882	0.25	188	15987	9	13	179	15974	16175	0.13685757111718724
M1	cpdb	0	network_modules	226	TRUE	2.0746073268724277e-9	190	22	9	0.4090909090909091	0.04736842105263158	GO:1903522	GO:BP	regulation of blood circulation	16175	23072		0.2549019607843137	0.2692307692307692	190	15985	9	13	181	15972	16175	0.13610152596201947
M1	cpdb	0	network_modules	226	TRUE	3.596555200535257e-9	32	22	6	0.2727272727272727	0.1875	GO:0016486	GO:BP	peptide hormone processing	16175	5234		0.27450980392156865	0.28846153846153844	32	16143	6	16	26	16127	16175	0.22486850846262976
M1	cpdb	0	network_modules	226	TRUE	5.328684957720505e-9	34	22	6	0.2727272727272727	0.17647058823529413	GO:0140448	GO:BP	signaling receptor ligand precursor processing	16175	19778		0.29411764705882354	0.3076923076923077	34	16141	6	16	28	16125	16175	0.21806837756289454
M1	cpdb	0	network_modules	226	TRUE	7.665689470108025e-9	14	22	5	0.22727272727272727	0.35714285714285715	GO:0001991	GO:BP	regulation of systemic arterial blood pressure by circulatory renin-angiotensin	16175	595		0.3137254901960784	0.3269230769230769	14	16161	5	17	9	16144	16175	0.28413263740160094
M1	cpdb	0	network_modules	226	TRUE	1.7320519161450034e-8	5	22	4	0.18181818181818182	0.8	GO:0003100	GO:BP	regulation of systemic arterial blood pressure by endothelin	16175	1544		0.3333333333333333	0.34615384615384615	5	16170	4	18	1	16152	16175	0.38105471123905893
M1	cpdb	0	network_modules	226	TRUE	1.7332663663385526e-8	18	18	5	0.2777777777777778	0.2777777777777778	REAC:R-HSA-2022377	REAC	Metabolism of Angiotensinogen to Angiotensins	10916	1418		0	0.16666666666666666	18	10898	5	13	13	10885	10916	0.2765848983503599
M1	cpdb	0	network_modules	226	TRUE	1.8655952776519462e-8	361	22	10	0.45454545454545453	0.027700831024930747	GO:0010817	GO:BP	regulation of hormone levels	16175	4429		0.35294117647058826	0.36538461538461536	361	15814	10	12	351	15802	16175	0.10798576762278769
M1	cpdb	0	network_modules	226	TRUE	1.6369730815972245e-7	69	17	6	0.35294117647058826	0.08695652173913043	KEGG:04924	KEGG	Renin secretion	8484	381		0.3333333333333333	0.5	69	8415	6	11	63	8404	8484	0.1720229321904294
M1	cpdb	0	network_modules	226	TRUE	2.0744861965129304e-7	133	17	7	0.4117647058823529	0.05263157894736842	KEGG:04270	KEGG	Vascular smooth muscle contraction	8484	298		0.6666666666666666	0.75	133	8351	7	10	126	8341	8484	0.142875286729693
M1	cpdb	0	network_modules	226	TRUE	2.8462811175525556e-7	329	22	9	0.4090909090909091	0.02735562310030395	GO:0090066	GO:BP	regulation of anatomical structure size	16175	17992		0.37254901960784315	0.38461538461538464	329	15846	9	13	320	15833	16175	0.10163484789392888
M1	cpdb	0	network_modules	226	TRUE	4.349244009363439e-7	9	22	4	0.18181818181818182	0.4444444444444444	GO:0002003	GO:BP	angiotensin maturation	16175	607		0.39215686274509803	0.4230769230769231	9	16166	4	18	5	16148	16175	0.2836695384320191
M1	cpdb	0	network_modules	226	TRUE	4.349244009363439e-7	9	22	4	0.18181818181818182	0.4444444444444444	GO:0002002	GO:BP	regulation of angiotensin levels in blood	16175	606		0.39215686274509803	0.4230769230769231	9	16166	4	18	5	16148	16175	0.2836695384320191
M1	cpdb	0	network_modules	226	TRUE	1.0418407029636778e-6	381	22	9	0.4090909090909091	0.023622047244094488	GO:0044057	GO:BP	regulation of system process	16175	10893		0.43137254901960786	0.4423076923076923	381	15794	9	13	372	15781	16175	0.09381784680109116
M1	cpdb	0	network_modules	226	TRUE	1.0469227652986356e-6	34	22	5	0.22727272727272727	0.14705882352941177	GO:0019229	GO:BP	regulation of vasoconstriction	16175	5603		0.45098039215686275	0.46153846153846156	34	16141	5	17	29	16124	16175	0.18144135001331282
M1	cpdb	0	network_modules	226	TRUE	1.2244647971143018e-6	88	18	6	0.3333333333333333	0.06818181818181818	REAC:R-HSA-2980736	REAC	Peptide hormone metabolism	10916	1725		0.2	0.3333333333333333	88	10828	6	12	82	10816	10916	0.14782820182237008
M1	cpdb	0	network_modules	226	TRUE	1.3319120028823585e-6	82	22	6	0.2727272727272727	0.07317073170731707	GO:0002027	GO:BP	regulation of heart rate	16175	629		0.47058823529411764	0.4807692307692308	82	16093	6	16	76	16077	16175	0.13908598710862016
M1	cpdb	0	network_modules	226	TRUE	1.8821766786219967e-6	163	22	7	0.3181818181818182	0.04294478527607362	GO:0008016	GO:BP	regulation of heart contraction	16175	3097		0.49019607843137253	0.5	163	16012	7	15	156	15997	16175	0.11384410203888141
M1	cpdb	0	network_modules	226	TRUE	3.6204984457703164e-6	179	22	7	0.3181818181818182	0.03910614525139665	GO:0042445	GO:BP	hormone metabolic process	16175	10185		0.5098039215686274	0.5192307692307693	179	15996	7	15	172	15981	16175	0.10834237566251768
M1	cpdb	0	network_modules	226	TRUE	4.335291130315399e-6	195	18	7	0.3888888888888889	0.035897435897435895	REAC:R-HSA-375276	REAC	Peptide ligand-binding receptors	10916	1726		0.4	0.5	195	10721	7	11	188	10710	10916	0.11383998633164337
M1	cpdb	0	network_modules	226	TRUE	4.555755290685502e-6	185	22	7	0.3181818181818182	0.03783783783783784	GO:0060047	GO:BP	heart contraction	16175	14310		0.5294117647058824	0.5384615384615384	185	15990	7	15	178	15975	16175	0.10646224032497512
M1	cpdb	0	network_modules	226	TRUE	5.689116980302259e-6	191	22	7	0.3181818181818182	0.03664921465968586	GO:0003015	GO:BP	heart process	16175	1466		0.5490196078431373	0.5576923076923077	191	15984	7	15	184	15969	16175	0.10466965010323115
M1	cpdb	0	network_modules	226	TRUE	1.0478088653443934e-5	18	22	4	0.18181818181818182	0.2222222222222222	GO:0010460	GO:BP	positive regulation of heart rate	16175	4156		0.5686274509803921	0.5769230769230769	18	16157	4	18	14	16139	16175	0.20002461209437336
M1	cpdb	0	network_modules	226	TRUE	1.179410744041361e-5	4	22	3	0.13636363636363635	0.75	GO:0014826	GO:BP	vein smooth muscle contraction	16175	4705		0.5882352941176471	0.5961538461538461	4	16171	3	19	1	16152	16175	0.31947793278252273
M1	cpdb	0	network_modules	226	TRUE	5.082832841291347e-5	26	22	4	0.18181818181818182	0.15384615384615385	GO:0045823	GO:BP	positive regulation of heart contraction	16175	11643		0.6078431372549019	0.6346153846153846	26	16149	4	18	22	16131	16175	0.16601612293014273
M1	cpdb	0	network_modules	226	TRUE	5.082832841291347e-5	26	22	4	0.18181818181818182	0.15384615384615385	GO:1903524	GO:BP	positive regulation of blood circulation	16175	23074		0.6078431372549019	0.6346153846153846	26	16149	4	18	22	16131	16175	0.16601612293014273
M1	cpdb	0	network_modules	226	TRUE	8.707983947704106e-5	460	18	8	0.4444444444444444	0.017391304347826087	REAC:R-HSA-500792	REAC	GPCR ligand binding	10916	1019		0.6	0.6666666666666666	460	10456	8	10	452	10446	10916	0.08138034540757895
M1	cpdb	0	network_modules	226	TRUE	1.5322619298846666e-4	328	18	7	0.3888888888888889	0.021341463414634148	REAC:R-HSA-373076	REAC	Class A/1 (Rhodopsin-like receptors)	10916	365		0.8	0.8333333333333334	328	10588	7	11	321	10577	10916	0.0854249736152502
M1	cpdb	0	network_modules	226	TRUE	2.109937000592242e-4	365	17	7	0.4117647058823529	0.019178082191780823	KEGG:04080	KEGG	Neuroactive ligand-receptor interaction	8484	263		1	1	365	8119	7	10	358	8109	8484	0.0814302725321973
M1	cpdb	0	network_modules	226	TRUE	2.671161683344019e-4	198	22	6	0.2727272727272727	0.030303030303030304	GO:0016485	GO:BP	protein processing	16175	5233		0.6470588235294118	0.6538461538461539	198	15977	6	16	192	15961	16175	0.08742456375695752
M1	cpdb	0	network_modules	226	TRUE	3.397343719265837e-4	41	22	4	0.18181818181818182	0.0975609756097561	GO:0051353	GO:BP	positive regulation of oxidoreductase activity	16175	13680		0.6666666666666666	0.6730769230769231	41	16134	4	18	37	16116	16175	0.13158493571978835
M1	cpdb	0	network_modules	226	TRUE	5.951762488648863e-4	47	22	4	0.18181818181818182	0.0851063829787234	GO:0006518	GO:BP	peptide metabolic process	16175	2240		0.6862745098039216	0.6923076923076923	47	16128	4	18	43	16110	16175	0.12266776192006816
M1	cpdb	0	network_modules	226	TRUE	6.441175188545482e-4	12	22	3	0.13636363636363635	0.25	GO:0014829	GO:BP	vascular associated smooth muscle contraction	16175	4708		0.7058823529411765	0.7307692307692307	12	16163	3	19	9	16144	16175	0.183825929278777
M1	cpdb	0	network_modules	226	TRUE	6.441175188545482e-4	12	22	3	0.13636363636363635	0.25	GO:0014821	GO:BP	phasic smooth muscle contraction	16175	4700		0.7058823529411765	0.7307692307692307	12	16163	3	19	9	16144	16175	0.183825929278777
M1	cpdb	0	network_modules	226	TRUE	0.0012157957158887651	56	22	4	0.18181818181818182	0.07142857142857142	GO:0006939	GO:BP	smooth muscle contraction	16175	2577		0.7450980392156863	0.75	56	16119	4	18	52	16101	16175	0.11206082487634876
M1	cpdb	0	network_modules	226	TRUE	0.0020882604306510684	64	22	4	0.18181818181818182	0.0625	GO:0051341	GO:BP	regulation of oxidoreductase activity	16175	13668		0.7647058823529411	0.7692307692307693	64	16111	4	18	60	16093	16175	0.10455857281213124
M1	cpdb	0	network_modules	226	TRUE	0.002376488672544942	18	22	3	0.13636363636363635	0.16666666666666666	GO:0043171	GO:BP	peptide catabolic process	16175	10567		0.7843137254901961	0.7884615384615384	18	16157	3	19	15	16138	16175	0.14971050876290892
M1	cpdb	0	network_modules	226	TRUE	0.0023864290536104726	2	22	2	0.09090909090909091	1	GO:0051387	GO:BP	negative regulation of neurotrophin TRK receptor signaling pathway	16175	13691		0.803921568627451	0.8846153846153846	2	16173	2	20	0	16153	16175	0.30132485807762605
M1	cpdb	0	network_modules	226	TRUE	0.0023864290536104726	2	22	2	0.09090909090909091	1	GO:0060584	GO:BP	regulation of prostaglandin-endoperoxide synthase activity	16175	14766		0.803921568627451	0.8846153846153846	2	16173	2	20	0	16153	16175	0.30132485807762605
M1	cpdb	0	network_modules	226	TRUE	0.0023864290536104726	2	22	2	0.09090909090909091	1	GO:0007199	GO:BP	G protein-coupled receptor signaling pathway coupled to cGMP nucleotide second messenger	16175	2757		0.803921568627451	0.8846153846153846	2	16173	2	20	0	16153	16175	0.30132485807762605
M1	cpdb	0	network_modules	226	TRUE	0.0023864290536104726	2	22	2	0.09090909090909091	1	GO:0002019	GO:BP	regulation of renal output by angiotensin	16175	622		0.803921568627451	0.8846153846153846	2	16173	2	20	0	16153	16175	0.30132485807762605
M1	cpdb	0	network_modules	226	TRUE	0.0023864290536104726	2	22	2	0.09090909090909091	1	GO:0060585	GO:BP	positive regulation of prostaglandin-endoperoxide synthase activity	16175	14767		0.803921568627451	0.8846153846153846	2	16173	2	20	0	16153	16175	0.30132485807762605
M1	cpdb	0	network_modules	226	TRUE	0.0025591496651027707	686	22	8	0.36363636363636365	0.011661807580174927	GO:0008284	GO:BP	positive regulation of cell population proliferation	16175	3151		0.9019607843137255	0.9038461538461539	686	15489	8	14	678	15475	16175	0.05882540711044352
M1	cpdb	0	network_modules	226	TRUE	0.002819593969043836	19	22	3	0.13636363636363635	0.15789473684210525	GO:0001974	GO:BP	blood vessel remodeling	16175	579		0.9215686274509803	0.9230769230769231	19	16156	3	19	16	16137	16175	0.14565540832766186
M1	cpdb	0	network_modules	226	TRUE	0.003164869747472773	483	22	7	0.3181818181818182	0.014492753623188406	GO:0051604	GO:BP	protein maturation	16175	13821		0.9411764705882353	0.9423076923076923	483	15692	7	15	476	15677	16175	0.06251618617028447
M1	cpdb	0	network_modules	226	TRUE	0.00580203923566447	213	18	5	0.2777777777777778	0.023474178403755867	REAC:R-HSA-416476	REAC	G alpha (q) signalling events	10916	988		1	1	213	10703	5	13	208	10690	10916	0.07588389184178447
M1	cpdb	0	network_modules	226	TRUE	0.006295604389031324	774	22	8	0.36363636363636365	0.0103359173126615	GO:0007186	GO:BP	G protein-coupled receptor signaling pathway	16175	2744		0.9607843137254902	0.9615384615384616	774	15401	8	14	766	15387	16175	0.05459781125050775
M1	cpdb	0	network_modules	226	TRUE	0.007153384906324254	3	22	2	0.09090909090909091	0.6666666666666666	GO:0014824	GO:BP	artery smooth muscle contraction	16175	4703		0.9803921568627451	1	3	16172	2	20	1	16152	16175	0.2458707737811223
M1	cpdb	0	network_modules	226	TRUE	0.007153384906324254	3	22	2	0.09090909090909091	0.6666666666666666	GO:0010814	GO:BP	substance P catabolic process	16175	4426		0.9803921568627451	1	3	16172	2	20	1	16152	16175	0.2458707737811223
M1	cpdb	0	network_modules	229	TRUE	2.602197487477907e-20	35	15	10	0.6666666666666666	0.2857142857142857	REAC:R-HSA-2172127	REAC	DAP12 interactions	10916	432		0	0.25	35	10881	10	5	25	10876	10916	0.4353339546187485
M1	cpdb	0	network_modules	229	TRUE	1.1218616637146793e-10	181	15	9	0.6	0.049723756906077346	REAC:R-HSA-198933	REAC	Immunoregulatory interactions between a Lymphoid and a non-Lymphoid cell	10916	1171		0.3333333333333333	0.5	181	10735	9	6	172	10729	10916	0.16947908881230744
M1	cpdb	0	network_modules	229	TRUE	3.0489654554020116e-8	421	15	9	0.6	0.021377672209026127	GO:0002694	GO:BP	regulation of leukocyte activation	16175	1212		0	0.017857142857142856	421	15754	9	6	412	15748	16175	0.10983066536499966
M1	cpdb	0	network_modules	229	TRUE	7.309859198955358e-8	699	15	10	0.6666666666666666	0.01430615164520744	GO:0045321	GO:BP	leukocyte activation	16175	11356		0.01818181818181818	0.03571428571428571	699	15476	10	5	689	15471	16175	0.09341232799406211
M1	cpdb	0	network_modules	229	TRUE	7.845572172073105e-8	468	15	9	0.6	0.019230769230769232	GO:0050865	GO:BP	regulation of cell activation	16175	13313		0.03636363636363636	0.05357142857142857	468	15707	9	6	459	15701	16175	0.10379736927176503
M1	cpdb	0	network_modules	229	TRUE	9.363755748384106e-7	50	15	5	0.3333333333333333	0.1	GO:0006968	GO:BP	cellular defense response	16175	2596		0.05454545454545454	0.07142857142857142	50	16125	5	10	45	16115	16175	0.18124534906425374
M1	cpdb	0	network_modules	229	TRUE	1.2782215200395694e-6	243	15	7	0.4666666666666667	0.02880658436213992	GO:0002758	GO:BP	innate immune response-activating signaling pathway	16175	1269		0.07272727272727272	0.08928571428571429	243	15932	7	8	236	15924	16175	0.11311669372227579
M1	cpdb	0	network_modules	229	TRUE	1.3665567664091856e-6	416	15	8	0.5333333333333333	0.019230769230769232	GO:0002757	GO:BP	immune response-activating signaling pathway	16175	1268		0.09090909090909091	0.10714285714285714	416	15759	8	7	408	15752	16175	0.09769950861337236
M1	cpdb	0	network_modules	229	TRUE	1.8585439237590047e-6	124	8	5	0.625	0.04032258064516129	KEGG:04650	KEGG	Natural killer cell mediated cytotoxicity	8484	334		0	0.5	124	8360	5	3	119	8357	8484	0.156257013235278
M1	cpdb	0	network_modules	229	TRUE	2.016355545094668e-6	437	15	8	0.5333333333333333	0.018306636155606407	GO:0002764	GO:BP	immune response-regulating signaling pathway	16175	1275		0.10909090909090909	0.125	437	15738	8	7	429	15731	16175	0.09514274733793156
M1	cpdb	0	network_modules	229	TRUE	2.2189639546583404e-6	263	15	7	0.4666666666666667	0.026615969581749048	GO:0002218	GO:BP	activation of innate immune response	16175	753		0.12727272727272726	0.14285714285714285	263	15912	7	8	256	15904	16175	0.10850109453852662
M1	cpdb	0	network_modules	229	TRUE	2.339194814025323e-6	265	15	7	0.4666666666666667	0.026415094339622643	GO:0002429	GO:BP	immune response-activating cell surface receptor signaling pathway	16175	952		0.14545454545454545	0.16071428571428573	265	15910	7	8	258	15902	16175	0.10806799925130717
M1	cpdb	0	network_modules	229	TRUE	3.8905861608531335e-6	475	15	8	0.5333333333333333	0.016842105263157894	GO:0002253	GO:BP	activation of immune response	16175	785		0.16363636363636364	0.17857142857142858	475	15700	8	7	467	15693	16175	0.09094414256764495
M1	cpdb	0	network_modules	229	TRUE	3.9431179601295074e-6	21	15	4	0.26666666666666666	0.19047619047619047	GO:1990840	GO:BP	response to lectin	16175	25313		0.18181818181818182	0.23214285714285715	21	16154	4	11	17	16143	16175	0.22452706826232097
M1	cpdb	0	network_modules	229	TRUE	3.9431179601295074e-6	21	15	4	0.26666666666666666	0.19047619047619047	GO:1990858	GO:BP	cellular response to lectin	16175	25318		0.18181818181818182	0.23214285714285715	21	16154	4	11	17	16143	16175	0.22452706826232097
M1	cpdb	0	network_modules	229	TRUE	3.9431179601295074e-6	21	15	4	0.26666666666666666	0.19047619047619047	GO:0002223	GO:BP	stimulatory C-type lectin receptor signaling pathway	16175	757		0.18181818181818182	0.23214285714285715	21	16154	4	11	17	16143	16175	0.22452706826232097
M1	cpdb	0	network_modules	229	TRUE	4.073872174325724e-6	287	15	7	0.4666666666666667	0.024390243902439025	GO:0002768	GO:BP	immune response-regulating cell surface receptor signaling pathway	16175	1279		0.23636363636363636	0.25	287	15888	7	8	280	15880	16175	0.1036014326252575
M1	cpdb	0	network_modules	229	TRUE	8.316106340538119e-6	25	15	4	0.26666666666666666	0.16	GO:0032814	GO:BP	regulation of natural killer cell activation	16175	7838		0.2545454545454545	0.26785714285714285	25	16150	4	11	21	16139	16175	0.2056161482942495
M1	cpdb	0	network_modules	229	TRUE	8.48200142518637e-6	319	15	7	0.4666666666666667	0.0219435736677116	GO:0045089	GO:BP	positive regulation of innate immune response	16175	11272		0.2727272727272727	0.2857142857142857	319	15856	7	8	312	15848	16175	0.09793344705917965
M1	cpdb	0	network_modules	229	TRUE	9.028816577550182e-6	25	15	4	0.26666666666666666	0.16	REAC:R-HSA-2424491	REAC	DAP12 signaling	10916	433		0.6666666666666666	0.75	25	10891	4	11	21	10880	10916	0.20516103001246017
M1	cpdb	0	network_modules	229	TRUE	1.0103753067830869e-5	177	15	6	0.4	0.03389830508474576	GO:0002703	GO:BP	regulation of leukocyte mediated immunity	16175	1221		0.2909090909090909	0.30357142857142855	177	15998	6	9	171	15989	16175	0.11393658640635283
M1	cpdb	0	network_modules	229	TRUE	1.2919641292948479e-5	339	15	7	0.4666666666666667	0.02064896755162242	GO:0002833	GO:BP	positive regulation of response to biotic stimulus	16175	1343		0.3090909090909091	0.32142857142857145	339	15836	7	8	332	15828	16175	0.09479762607327161
M1	cpdb	0	network_modules	229	TRUE	1.3171256017775866e-5	185	15	6	0.4	0.032432432432432434	GO:0006909	GO:BP	phagocytosis	16175	2559		0.32727272727272727	0.3392857142857143	185	15990	6	9	179	15981	16175	0.11133203238402432
M1	cpdb	0	network_modules	229	TRUE	1.4236657168226948e-5	85	15	5	0.3333333333333333	0.058823529411764705	GO:0002220	GO:BP	innate immune response activating cell surface receptor signaling pathway	16175	754		0.34545454545454546	0.35714285714285715	85	16090	5	10	80	16080	16175	0.13824813302725267
M1	cpdb	0	network_modules	229	TRUE	1.6453225567205007e-5	192	15	6	0.4	0.03125	GO:0002699	GO:BP	positive regulation of immune effector process	16175	1217		0.36363636363636365	0.375	192	15983	6	9	186	15974	16175	0.10918588499835133
M1	cpdb	0	network_modules	229	TRUE	2.3201400492277932e-5	369	15	7	0.4666666666666667	0.018970189701897018	GO:0051249	GO:BP	regulation of lymphocyte activation	16175	13596		0.38181818181818183	0.39285714285714285	369	15806	7	8	362	15798	16175	0.09057011044355573
M1	cpdb	0	network_modules	229	TRUE	3.1643686159610706e-5	386	15	7	0.4666666666666667	0.018134715025906734	GO:0045088	GO:BP	regulation of innate immune response	16175	11271		0.4	0.4107142857142857	386	15789	7	8	379	15781	16175	0.08839109534354242
M1	cpdb	0	network_modules	229	TRUE	3.4256334593628254e-5	627	15	8	0.5333333333333333	0.012759170653907496	GO:0050778	GO:BP	positive regulation of immune response	16175	13252		0.41818181818181815	0.42857142857142855	627	15548	8	7	619	15541	16175	0.07805950733116808
M1	cpdb	0	network_modules	229	TRUE	5.2438329885388695e-5	110	15	5	0.3333333333333333	0.045454545454545456	GO:0002705	GO:BP	positive regulation of leukocyte mediated immunity	16175	1223		0.43636363636363634	0.44642857142857145	110	16065	5	10	105	16055	16175	0.12104844995224914
M1	cpdb	0	network_modules	229	TRUE	5.936824200315964e-5	423	15	7	0.4666666666666667	0.016548463356973995	GO:0031349	GO:BP	positive regulation of defense response	16175	7140		0.45454545454545453	0.4642857142857143	423	15752	7	8	416	15744	16175	0.08409924600503511
M1	cpdb	0	network_modules	229	TRUE	9.212614630788302e-5	451	15	7	0.4666666666666667	0.015521064301552107	GO:0002831	GO:BP	regulation of response to biotic stimulus	16175	1341		0.4727272727272727	0.48214285714285715	451	15724	7	8	444	15716	16175	0.08119894107205249
M1	cpdb	0	network_modules	229	TRUE	1.0147692875686019e-4	721	15	8	0.5333333333333333	0.011095700416088766	GO:0045087	GO:BP	innate immune response	16175	11270		0.4909090909090909	0.5	721	15454	8	7	713	15447	16175	0.07215648414369334
M1	cpdb	0	network_modules	229	TRUE	1.4282675475226956e-4	276	15	6	0.4	0.021739130434782608	GO:0002697	GO:BP	regulation of immune effector process	16175	1215		0.509090909090909	0.5178571428571429	276	15899	6	9	270	15890	16175	0.09008587612847316
M1	cpdb	0	network_modules	229	TRUE	1.4647717833462978e-4	756	15	8	0.5333333333333333	0.010582010582010581	GO:0050776	GO:BP	regulation of immune response	16175	13250		0.5272727272727272	0.5357142857142857	756	15419	8	7	748	15412	16175	0.07023401065778431
M1	cpdb	0	network_modules	229	TRUE	2.5519069543090256e-4	57	15	4	0.26666666666666666	0.07017543859649122	GO:0001912	GO:BP	positive regulation of leukocyte mediated cytotoxicity	16175	529		0.5454545454545454	0.5535714285714286	57	16118	4	11	53	16107	16175	0.13529058665625468
M1	cpdb	0	network_modules	229	TRUE	2.808541342504682e-4	531	15	7	0.4666666666666667	0.013182674199623353	GO:0032103	GO:BP	positive regulation of response to external stimulus	16175	7367		0.5636363636363636	0.5714285714285714	531	15644	7	8	524	15636	16175	0.07417813222164192
M1	cpdb	0	network_modules	229	TRUE	3.8356428429046056e-4	63	15	4	0.26666666666666666	0.06349206349206349	GO:0031343	GO:BP	positive regulation of cell killing	16175	7134		0.5818181818181818	0.5892857142857143	63	16112	4	11	59	16101	16175	0.12852953638209216
M1	cpdb	0	network_modules	229	TRUE	4.2386776150290964e-4	167	15	5	0.3333333333333333	0.029940119760479042	GO:0002274	GO:BP	myeloid leukocyte activation	16175	806		0.6	0.6071428571428571	167	16008	5	10	162	15998	16175	0.09735466476181356
M1	cpdb	0	network_modules	229	TRUE	4.403547164677476e-4	334	15	6	0.4	0.017964071856287425	GO:0002443	GO:BP	leukocyte mediated immunity	16175	966		0.6181818181818182	0.625	334	15841	6	9	328	15832	16175	0.08127290284922377
M1	cpdb	0	network_modules	229	TRUE	4.4918395874712013e-4	569	15	7	0.4666666666666667	0.012302284710017574	GO:0046649	GO:BP	lymphocyte activation	16175	12286		0.6363636363636364	0.6428571428571429	569	15606	7	8	562	15598	16175	0.0713570615294609
M1	cpdb	0	network_modules	229	TRUE	7.775549866404554e-4	75	15	4	0.26666666666666666	0.05333333333333334	GO:0030101	GO:BP	natural killer cell activation	16175	6679		0.6545454545454545	0.6607142857142857	75	16100	4	11	71	16089	16175	0.117510450544019
M1	cpdb	0	network_modules	229	TRUE	9.110291772197921e-4	78	15	4	0.26666666666666666	0.05128205128205128	GO:0001910	GO:BP	regulation of leukocyte mediated cytotoxicity	16175	527		0.6727272727272727	0.6785714285714286	78	16097	4	11	74	16086	16175	0.11515764482498843
M1	cpdb	0	network_modules	229	TRUE	0.001060859996325265	81	15	4	0.26666666666666666	0.04938271604938271	GO:0050764	GO:BP	regulation of phagocytosis	16175	13238		0.6909090909090909	0.6964285714285714	81	16094	4	11	77	16083	16175	0.1129354556075793
M1	cpdb	0	network_modules	229	TRUE	0.0011148721588836801	2	15	2	0.13333333333333333	1	GO:0034125	GO:BP	negative regulation of MyD88-dependent toll-like receptor signaling pathway	16175	8433		0.7090909090909091	0.7142857142857143	2	16173	2	13	0	16160	16175	0.36500158742720296
M1	cpdb	0	network_modules	229	TRUE	0.0011516480653487925	654	15	7	0.4666666666666667	0.010703363914373088	GO:0031347	GO:BP	regulation of defense response	16175	7138		0.7272727272727273	0.7321428571428571	654	15521	7	8	647	15513	16175	0.06592778804918081
M1	cpdb	0	network_modules	229	TRUE	0.0015646453314275182	69	8	3	0.375	0.043478260869565216	KEGG:04612	KEGG	Antigen processing and presentation	8484	322		1	1	69	8415	3	5	66	8410	8484	0.1254894668151578
M1	cpdb	0	network_modules	229	TRUE	0.001569497534929302	23	15	3	0.2	0.13043478260869565	GO:0045954	GO:BP	positive regulation of natural killer cell mediated cytotoxicity	16175	11746		0.7454545454545455	0.75	23	16152	3	12	20	16140	16175	0.16055484548270105
M1	cpdb	0	network_modules	229	TRUE	0.001694916923573971	91	15	4	0.26666666666666666	0.04395604395604396	GO:0031341	GO:BP	regulation of cell killing	16175	7132		0.7636363636363637	0.7678571428571429	91	16084	4	11	87	16073	16175	0.1063309609490873
M1	cpdb	0	network_modules	229	TRUE	0.0017709919224916954	92	15	4	0.26666666666666666	0.043478260869565216	GO:0002708	GO:BP	positive regulation of lymphocyte mediated immunity	16175	1226		0.7818181818181819	0.7857142857142857	92	16083	4	11	88	16072	16175	0.10572973745916639
M1	cpdb	0	network_modules	229	TRUE	0.0025864295500052786	27	15	3	0.2	0.1111111111111111	GO:0002717	GO:BP	positive regulation of natural killer cell mediated immunity	16175	1235		0.8	0.8035714285714286	27	16148	3	12	24	16136	16175	0.14801920198550775
M1	cpdb	0	network_modules	229	TRUE	0.0031246544138254007	106	15	4	0.26666666666666666	0.03773584905660377	GO:0001909	GO:BP	leukocyte mediated cytotoxicity	16175	526		0.8181818181818182	0.8214285714285714	106	16069	4	11	102	16058	16175	0.09821651372173489
M1	cpdb	0	network_modules	229	TRUE	0.006682065795610729	4	15	2	0.13333333333333333	0.5	GO:0034239	GO:BP	regulation of macrophage fusion	16175	8515		0.8363636363636363	0.8928571428571429	4	16171	2	13	2	16158	16175	0.25787147420379075
M1	cpdb	0	network_modules	229	TRUE	0.006682065795610729	4	15	2	0.13333333333333333	0.5	GO:0002282	GO:BP	microglial cell activation involved in immune response	16175	814		0.8363636363636363	0.8928571428571429	4	16171	2	13	2	16158	16175	0.25787147420379075
M1	cpdb	0	network_modules	229	TRUE	0.006682065795610729	4	15	2	0.13333333333333333	0.5	GO:0034124	GO:BP	regulation of MyD88-dependent toll-like receptor signaling pathway	16175	8432		0.8363636363636363	0.8928571428571429	4	16171	2	13	2	16158	16175	0.25787147420379075
M1	cpdb	0	network_modules	229	TRUE	0.006682065795610729	4	15	2	0.13333333333333333	0.5	GO:0034241	GO:BP	positive regulation of macrophage fusion	16175	8517		0.8363636363636363	0.8928571428571429	4	16171	2	13	2	16158	16175	0.25787147420379075
M1	cpdb	0	network_modules	229	TRUE	0.006714370532797673	533	15	6	0.4	0.01125703564727955	GO:0006897	GO:BP	endocytosis	16175	2551		0.9090909090909091	0.9107142857142857	533	15642	6	9	527	15633	16175	0.06264440013973312
M1	cpdb	0	network_modules	229	TRUE	0.006832464161850994	37	15	3	0.2	0.08108108108108109	GO:0043277	GO:BP	apoptotic cell clearance	16175	10598		0.9272727272727272	0.9285714285714286	37	16138	3	12	34	16126	16175	0.12608914305468685
M1	cpdb	0	network_modules	229	TRUE	0.006935267581397705	536	15	6	0.4	0.011194029850746268	GO:0002252	GO:BP	immune effector process	16175	784		0.9454545454545454	0.9464285714285714	536	15639	6	9	530	15630	16175	0.06244326578767309
M1	cpdb	0	network_modules	229	TRUE	0.007413973931031235	38	15	3	0.2	0.07894736842105263	GO:0042269	GO:BP	regulation of natural killer cell mediated cytotoxicity	16175	10067		0.9636363636363636	0.9642857142857143	38	16137	3	12	35	16125	16175	0.1243839630022159
M1	cpdb	0	network_modules	229	TRUE	0.0074898659937152594	476	15	6	0.4	0.012605042016806723	REAC:R-HSA-6798695	REAC	Neutrophil degranulation	10916	1597		1	1	476	10440	6	9	470	10431	10916	0.06473706273038897
M1	cpdb	0	network_modules	229	TRUE	0.00843625477389265	136	15	4	0.26666666666666666	0.029411764705882353	GO:0002706	GO:BP	regulation of lymphocyte mediated immunity	16175	1224		0.9818181818181818	0.9821428571428571	136	16039	4	11	132	16028	16175	0.08617196272603161
M1	cpdb	0	network_modules	229	TRUE	0.008673366523155073	40	15	3	0.2	0.075	GO:0002715	GO:BP	regulation of natural killer cell mediated immunity	16175	1233		1	1	40	16135	3	12	37	16123	16175	0.12116615688344903
M1	cpdb	0	network_modules	230	TRUE	1.2507635286591846e-11	11	9	5	0.5555555555555556	0.45454545454545453	REAC:R-HSA-112308	REAC	Presynaptic depolarization and calcium channel opening	10916	1790		0	0.1	11	10905	5	4	6	10901	10916	0.5020673523135573
M1	cpdb	0	network_modules	230	TRUE	2.2812540098110694e-8	42	9	5	0.5555555555555556	0.11904761904761904	REAC:R-HSA-419037	REAC	NCAM1 interactions	10916	1512		0.1111111111111111	0.2	42	10874	5	4	37	10870	10916	0.2559894640226186
M1	cpdb	0	network_modules	230	TRUE	1.3355953647577345e-7	59	9	5	0.5555555555555556	0.0847457627118644	REAC:R-HSA-375165	REAC	NCAM signaling for neurite out-growth	10916	1511		0.2222222222222222	0.3	59	10857	5	4	54	10853	10916	0.215542456010556
M1	cpdb	0	network_modules	230	TRUE	2.578907383867618e-7	84	8	5	0.625	0.05952380952380952	KEGG:05412	KEGG	Arrhythmogenic right ventricular cardiomyopathy	8484	490		0	0.14285714285714285	84	8400	5	3	79	8397	8484	0.1908604402308546
M1	cpdb	0	network_modules	230	TRUE	3.0838726974767563e-7	87	8	5	0.625	0.05747126436781609	KEGG:04260	KEGG	Cardiac muscle contraction	8484	296		0.16666666666666666	0.2857142857142857	87	8397	5	3	82	8394	8484	0.1874665410633985
M1	cpdb	0	network_modules	230	TRUE	5.362765124466343e-7	97	8	5	0.625	0.05154639175257732	KEGG:05410	KEGG	Hypertrophic cardiomyopathy	8484	489		0.3333333333333333	0.42857142857142855	97	8387	5	3	92	8384	8484	0.1773057343681076
M1	cpdb	0	network_modules	230	TRUE	6.920671722586116e-7	102	8	5	0.625	0.049019607843137254	KEGG:05414	KEGG	Dilated cardiomyopathy	8484	491		0.5	0.5714285714285714	102	8382	5	3	97	8379	8484	0.17279083608297832
M1	cpdb	0	network_modules	230	TRUE	2.487328647766252e-6	15	19	4	0.21052631578947367	0.26666666666666666	GO:0061577	GO:BP	calcium ion transmembrane transport via high voltage-gated calcium channel	16175	15567		0	0.05	15	16160	4	15	11	16145	16175	0.23614403548177731
M1	cpdb	0	network_modules	230	TRUE	2.797690526922211e-6	301	8	6	0.75	0.019933554817275746	KEGG:04010	KEGG	MAPK signaling pathway	8484	243		0.6666666666666666	0.7142857142857143	301	8183	6	2	295	8181	8484	0.11866589746276725
M1	cpdb	0	network_modules	230	TRUE	5.3524026025123945e-6	153	8	5	0.625	0.032679738562091505	KEGG:04261	KEGG	Adrenergic signaling in cardiomyocytes	8484	297		0.8333333333333334	0.8571428571428571	153	8331	5	3	148	8328	8484	0.14012650797981122
M1	cpdb	0	network_modules	230	TRUE	5.530359679784503e-6	154	8	5	0.625	0.032467532467532464	KEGG:04921	KEGG	Oxytocin signaling pathway	8484	378		1	1	154	8330	5	3	149	8327	8484	0.1396520693555006
M1	cpdb	0	network_modules	230	TRUE	6.374389400076091e-6	125	19	6	0.3157894736842105	0.048	GO:1903169	GO:BP	regulation of calcium ion transmembrane transport	16175	22802		0.05263157894736842	0.1	125	16050	6	13	119	16037	16175	0.12064214941828154
M1	cpdb	0	network_modules	230	TRUE	1.095339832431033e-5	249	19	7	0.3684210526315789	0.028112449799196786	GO:0070588	GO:BP	calcium ion transmembrane transport	16175	16193		0.10526315789473684	0.15	249	15926	7	12	242	15914	16175	0.0983351918153885
M1	cpdb	0	network_modules	230	TRUE	1.604017671524277e-5	23	19	4	0.21052631578947367	0.17391304347826086	GO:1901385	GO:BP	regulation of voltage-gated calcium channel activity	16175	21435		0.15789473684210525	0.2	23	16152	4	15	19	16137	16175	0.19030061956360644
M1	cpdb	0	network_modules	230	TRUE	4.8743672086835835e-5	15	9	3	0.3333333333333333	0.2	REAC:R-HSA-5576893	REAC	Phase 2 - plateau phase	10916	1734		0.3333333333333333	0.4	15	10901	3	6	12	10895	10916	0.25741748318742463
M1	cpdb	0	network_modules	230	TRUE	4.9384720259247596e-5	30	19	4	0.21052631578947367	0.13333333333333333	GO:0007528	GO:BP	neuromuscular junction development	16175	3010		0.21052631578947367	0.25	30	16145	4	15	26	16130	16175	0.16631746816702525
M1	cpdb	0	network_modules	230	TRUE	5.4949108442874484e-5	179	19	6	0.3157894736842105	0.0335195530726257	GO:0051924	GO:BP	regulation of calcium ion transport	16175	13997		0.2631578947368421	0.3	179	15996	6	13	173	15983	16175	0.09989119492809706
M1	cpdb	0	network_modules	230	TRUE	6.716675326931803e-5	324	19	7	0.3684210526315789	0.021604938271604937	GO:0006816	GO:BP	calcium ion transport	16175	2495		0.3157894736842105	0.35	324	15851	7	12	317	15839	16175	0.08527450079153397
M1	cpdb	0	network_modules	230	TRUE	8.216817739719134e-5	78	9	4	0.4444444444444444	0.05128205128205128	REAC:R-HSA-422356	REAC	Regulation of insulin secretion	10916	2040		0.4444444444444444	0.5	78	10838	4	5	74	10833	10916	0.14913813395113001
M1	cpdb	0	network_modules	230	TRUE	1.2308023537328891e-4	354	19	7	0.3684210526315789	0.01977401129943503	GO:0034762	GO:BP	regulation of transmembrane transport	16175	8731		0.3684210526315789	0.4	354	15821	7	12	347	15809	16175	0.08122378261912673
M1	cpdb	0	network_modules	230	TRUE	2.3430140408369648e-4	259	9	5	0.5555555555555556	0.019305019305019305	REAC:R-HSA-112315	REAC	Transmission across Chemical Synapses	10916	2580		0.5555555555555556	0.6	259	10657	5	4	254	10653	10916	0.10037757666036637
M1	cpdb	0	network_modules	230	TRUE	2.3706213190736165e-4	229	19	6	0.3157894736842105	0.026200873362445413	GO:1904062	GO:BP	regulation of monoatomic cation transmembrane transport	16175	23501		0.42105263157894735	0.45	229	15946	6	13	223	15933	16175	0.08755636144130548
M1	cpdb	0	network_modules	230	TRUE	2.941123253754728e-4	107	9	4	0.4444444444444444	0.037383177570093455	REAC:R-HSA-163685	REAC	Integration of energy metabolism	10916	1213		0.6666666666666666	0.7	107	10809	4	5	103	10804	10916	0.12673001526625996
M1	cpdb	0	network_modules	230	TRUE	3.4907622460499425e-4	28	9	3	0.3333333333333333	0.10714285714285714	REAC:R-HSA-400042	REAC	Adrenaline,noradrenaline inhibits insulin secretion	10916	124		0.7777777777777778	0.8	28	10888	3	6	25	10882	10916	0.18784642015723546
M1	cpdb	0	network_modules	230	TRUE	5.239873698770351e-4	262	19	6	0.3157894736842105	0.022900763358778626	GO:0034765	GO:BP	regulation of monoatomic ion transmembrane transport	16175	8734		0.47368421052631576	0.5	262	15913	6	13	256	15900	16175	0.08138740047592385
M1	cpdb	0	network_modules	230	TRUE	5.276436394598256e-4	32	9	3	0.3333333333333333	0.09375	REAC:R-HSA-5576892	REAC	Phase 0 - rapid depolarisation	10916	1732		0.8888888888888888	0.9	32	10884	3	6	29	10878	10916	0.17555182493114818
M1	cpdb	0	network_modules	230	TRUE	8.40850968759108e-4	284	19	6	0.3157894736842105	0.02112676056338028	GO:0010959	GO:BP	regulation of metal ion transport	16175	4536		0.5263157894736842	0.55	284	15891	6	13	278	15878	16175	0.07787049166462424
M1	cpdb	0	network_modules	230	TRUE	0.0011887303359032397	65	19	4	0.21052631578947367	0.06153846153846154	GO:1901019	GO:BP	regulation of calcium ion transmembrane transporter activity	16175	21141		0.5789473684210527	0.6	65	16110	4	15	61	16095	16175	0.11194020892310803
M1	cpdb	0	network_modules	230	TRUE	0.0019971074791512457	400	9	5	0.5555555555555556	0.0125	REAC:R-HSA-112316	REAC	Neuronal System	10916	1590		1	1	400	10516	5	4	395	10512	10916	0.07933606124083564
M1	cpdb	0	network_modules	230	TRUE	0.002443106239156069	341	19	6	0.3157894736842105	0.017595307917888565	GO:0043269	GO:BP	regulation of monoatomic ion transport	16175	10593		0.631578947368421	0.65	341	15834	6	13	335	15821	16175	0.07035143012317967
M1	cpdb	0	network_modules	230	TRUE	0.0032449236558690455	575	19	7	0.3684210526315789	0.01217391304347826	GO:0098662	GO:BP	inorganic cation transmembrane transport	16175	18818		0.6842105263157895	0.7	575	15600	7	12	568	15588	16175	0.06165037029376955
M1	cpdb	0	network_modules	230	TRUE	0.003320755442282172	577	19	7	0.3684210526315789	0.012131715771230503	GO:0098655	GO:BP	monoatomic cation transmembrane transport	16175	18811		0.7368421052631579	0.75	577	15598	7	12	570	15586	16175	0.061524514447418764
M1	cpdb	0	network_modules	230	TRUE	0.005296018232941796	3	19	2	0.10526315789473684	0.6666666666666666	GO:0098912	GO:BP	membrane depolarization during atrial cardiac muscle cell action potential	16175	18945		0.7894736842105263	0.8	3	16172	2	17	1	16155	16175	0.26461970208734953
M1	cpdb	0	network_modules	230	TRUE	0.00546629799971281	95	19	4	0.21052631578947367	0.042105263157894736	GO:2001257	GO:BP	regulation of cation channel activity	16175	26443		0.8421052631578947	0.85	95	16080	4	15	91	16065	16175	0.09184754952083014
M1	cpdb	0	network_modules	230	TRUE	0.005948033005627046	630	19	7	0.3684210526315789	0.011111111111111112	GO:0098660	GO:BP	inorganic ion transmembrane transport	16175	18816		0.8947368421052632	0.9	630	15545	7	12	623	15533	16175	0.05839922951924849
M1	cpdb	0	network_modules	230	TRUE	0.009016408905621028	671	19	7	0.3684210526315789	0.010432190760059613	GO:0034220	GO:BP	monoatomic ion transmembrane transport	16175	8508		0.9473684210526315	0.95	671	15504	7	12	664	15492	16175	0.056225778139885926
M1	cpdb	0	network_modules	230	TRUE	0.009560354601717901	677	19	7	0.3684210526315789	0.0103397341211226	GO:0030001	GO:BP	metal ion transport	16175	6646		1	1	677	15498	7	12	670	15486	16175	0.05592338125210335
M1	cpdb	0	network_modules	233	TRUE	4.809397563400832e-9	48	14	6	0.42857142857142855	0.125	REAC:R-HSA-72165	REAC	mRNA Splicing - Minor Pathway	10916	2708		0	0.3333333333333333	48	10868	6	8	42	10860	10916	0.22973294802266445
M1	cpdb	0	network_modules	233	TRUE	7.942582618059577e-8	397	17	9	0.5294117647058824	0.022670025188916875	GO:0008380	GO:BP	RNA splicing	16175	3186		0	0.16666666666666666	397	15778	9	8	388	15770	16175	0.10583548849191972
M1	cpdb	0	network_modules	233	TRUE	8.218764070365937e-7	209	14	7	0.5	0.03349282296650718	REAC:R-HSA-72172	REAC	mRNA Splicing	10916	2706		0.5	0.6666666666666666	209	10707	7	7	202	10700	10916	0.12574202709772475
M1	cpdb	0	network_modules	233	TRUE	5.679519716350584e-6	276	14	7	0.5	0.025362318840579712	REAC:R-HSA-72203	REAC	Processing of Capped Intron-Containing Pre-mRNA	10916	1796		1	1	276	10640	7	7	269	10633	10916	0.1083634897440936
M1	cpdb	0	network_modules	233	TRUE	4.0921125480460145e-4	287	17	6	0.35294117647058826	0.020905923344947737	GO:0000377	GO:BP	RNA splicing, via transesterification reactions with bulged adenosine as nucleophile	16175	109		0.2	0.5	287	15888	6	11	281	15877	16175	0.08235699137813232
M1	cpdb	0	network_modules	233	TRUE	4.0921125480460145e-4	287	17	6	0.35294117647058826	0.020905923344947737	GO:0000398	GO:BP	mRNA splicing, via spliceosome	16175	121		0.2	0.5	287	15888	6	11	281	15877	16175	0.08235699137813232
M1	cpdb	0	network_modules	233	TRUE	4.4392008723630655e-4	291	17	6	0.35294117647058826	0.020618556701030927	GO:0000375	GO:BP	RNA splicing, via transesterification reactions	16175	107		0.6	0.6666666666666666	291	15884	6	11	285	15873	16175	0.0817389548046227
M1	cpdb	0	network_modules	233	TRUE	0.0013535358427021196	352	17	6	0.35294117647058826	0.017045454545454544	GO:0006397	GO:BP	mRNA processing	16175	2158		0.8	0.8333333333333334	352	15823	6	11	346	15812	16175	0.07362448206051646
M1	cpdb	0	network_modules	233	TRUE	0.0015425139921284997	590	17	7	0.4117647058823529	0.011864406779661017	GO:0016071	GO:BP	mRNA metabolic process	16175	5098		1	1	590	15585	7	10	583	15575	16175	0.06493232947739286
M1	cpdb	0	network_modules	234	TRUE	2.024174466486726e-35	111	23	19	0.8260869565217391	0.17117117117117117	GO:0006413	GO:BP	translational initiation	16175	2171		0	0.047619047619047616	111	16064	19	4	92	16060	16175	0.3744636420168621
M1	cpdb	0	network_modules	234	TRUE	1.941582576928959e-33	59	22	17	0.7727272727272727	0.288135593220339	REAC:R-HSA-72702	REAC	Ribosomal scanning and start codon recognition	10916	2106		0	0.1111111111111111	59	10857	17	5	42	10852	10916	0.4703033935475129
M1	cpdb	0	network_modules	234	TRUE	1.941582576928959e-33	59	22	17	0.7727272727272727	0.288135593220339	REAC:R-HSA-72649	REAC	Translation initiation complex formation	10916	2566		0	0.1111111111111111	59	10857	17	5	42	10852	10916	0.4703033935475129
M1	cpdb	0	network_modules	234	TRUE	2.7080069453271667e-33	60	22	17	0.7727272727272727	0.2833333333333333	REAC:R-HSA-72662	REAC	Activation of the mRNA upon binding of the cap-binding complex and eIFs, and subsequent binding to 43S	10916	105		0.11764705882352941	0.16666666666666666	60	10856	17	5	43	10851	10916	0.4663335293215647
M1	cpdb	0	network_modules	234	TRUE	1.0775629206239407e-31	43	23	15	0.6521739130434783	0.3488372093023256	GO:0002183	GO:BP	cytoplasmic translational initiation	16175	731		0.05	0.09523809523809523	43	16132	15	8	28	16124	16175	0.475999210560045
M1	cpdb	0	network_modules	234	TRUE	1.3951741129512179e-30	15	23	12	0.5217391304347826	0.8	GO:0001732	GO:BP	formation of cytoplasmic translation initiation complex	16175	411		0.1	0.14285714285714285	15	16160	12	11	3	16149	16175	0.6456684119240502
M1	cpdb	0	network_modules	234	TRUE	3.6739756387049077e-28	112	22	17	0.7727272727272727	0.15178571428571427	REAC:R-HSA-156827	REAC	L13a-mediated translational silencing of Ceruloplasmin expression	10916	1293		0.17647058823529413	0.2222222222222222	112	10804	17	5	95	10799	10916	0.340017284100254
M1	cpdb	0	network_modules	234	TRUE	4.322686421300155e-28	113	22	17	0.7727272727272727	0.1504424778761062	REAC:R-HSA-72706	REAC	GTP hydrolysis and joining of the 60S ribosomal subunit	10916	1027		0.23529411764705882	0.2777777777777778	113	10803	17	5	96	10798	10916	0.3384844335056419
M1	cpdb	0	network_modules	234	TRUE	1.2938680827237009e-27	120	22	17	0.7727272727272727	0.14166666666666666	REAC:R-HSA-72613	REAC	Eukaryotic Translation Initiation	10916	871		0.29411764705882354	0.3888888888888889	120	10796	17	5	103	10791	10916	0.3282937355813395
M1	cpdb	0	network_modules	234	TRUE	1.2938680827237009e-27	120	22	17	0.7727272727272727	0.14166666666666666	REAC:R-HSA-72737	REAC	Cap-dependent Translation Initiation	10916	304		0.29411764705882354	0.3888888888888889	120	10796	17	5	103	10791	10916	0.3282937355813395
M1	cpdb	0	network_modules	234	TRUE	2.4781401381951754e-22	158	23	15	0.6521739130434783	0.0949367088607595	GO:0002181	GO:BP	cytoplasmic translation	16175	729		0.15	0.19047619047619047	158	16017	15	8	143	16009	16175	0.24648207658697888
M1	cpdb	0	network_modules	234	TRUE	1.897816411600447e-21	566	23	19	0.8260869565217391	0.03356890459363958	GO:0006412	GO:BP	translation	16175	2170		0.2	0.23809523809523808	566	15609	19	4	547	15605	16175	0.1624530108789895
M1	cpdb	0	network_modules	234	TRUE	7.238986323183275e-21	52	22	12	0.5454545454545454	0.23076923076923078	REAC:R-HSA-72695	REAC	Formation of the ternary complex, and subsequently, the 43S complex	10916	973		0.4117647058823529	0.4444444444444444	52	10864	12	10	40	10854	10916	0.35288539837463234
M1	cpdb	0	network_modules	234	TRUE	9.008831724219736e-21	292	22	17	0.7727272727272727	0.05821917808219178	REAC:R-HSA-72766	REAC	Translation	10916	2565		0.47058823529411764	0.5	292	10624	17	5	275	10619	10916	0.20776456616331057
M1	cpdb	0	network_modules	234	TRUE	4.54127648923904e-17	102	22	12	0.5454545454545454	0.11764705882352941	REAC:R-HSA-72689	REAC	Formation of a pool of free 40S subunits	10916	953		0.5294117647058824	0.5555555555555556	102	10814	12	10	90	10804	10916	0.25040453902112125
M1	cpdb	0	network_modules	234	TRUE	3.999614710417973e-15	178	23	12	0.5217391304347826	0.06741573033707865	GO:0022618	GO:BP	protein-RNA complex assembly	16175	6625		0.25	0.2857142857142857	178	15997	12	11	166	15986	16175	0.18474001339019733
M1	cpdb	0	network_modules	234	TRUE	7.817363855882302e-15	188	23	12	0.5217391304347826	0.06382978723404255	GO:0071826	GO:BP	protein-RNA complex organization	16175	16929		0.3	0.3333333333333333	188	15987	12	11	176	15976	16175	0.179598127953604
M1	cpdb	0	network_modules	234	TRUE	1.0641088196413195e-12	390	23	13	0.5652173913043478	0.03333333333333333	GO:0022613	GO:BP	ribonucleoprotein complex biogenesis	16175	6620		0.35	0.38095238095238093	390	15785	13	10	377	15775	16175	0.13311374267630247
M1	cpdb	0	network_modules	234	TRUE	5.529126780122121e-12	5	23	5	0.21739130434782608	1	GO:0075525	GO:BP	viral translational termination-reinitiation	16175	17758		0.4	0.42857142857142855	5	16170	5	18	0	16152	16175	0.46599282217327354
M1	cpdb	0	network_modules	234	TRUE	8.620962555299463e-11	290	23	11	0.4782608695652174	0.03793103448275862	GO:0006417	GO:BP	regulation of translation	16175	2174		0.45	0.47619047619047616	290	15885	11	12	279	15873	16175	0.13091022840747532
M1	cpdb	0	network_modules	234	TRUE	1.022226598295182e-10	75	23	8	0.34782608695652173	0.10666666666666667	GO:0006446	GO:BP	regulation of translational initiation	16175	2196		0.5	0.5238095238095238	75	16100	8	15	67	16085	16175	0.19062735669637612
M1	cpdb	0	network_modules	234	TRUE	3.295004221351479e-10	21	23	6	0.2608695652173913	0.2857142857142857	GO:0019081	GO:BP	viral translation	16175	5571		0.55	0.5714285714285714	21	16154	6	17	15	16137	16175	0.27202071761252855
M1	cpdb	0	network_modules	234	TRUE	4.705868903229198e-9	4	23	4	0.17391304347826086	1	GO:1902416	GO:BP	positive regulation of mRNA binding	16175	22267		0.6	0.6666666666666666	4	16171	4	19	0	16152	16175	0.41678376359954594
M1	cpdb	0	network_modules	234	TRUE	4.705868903229198e-9	4	23	4	0.17391304347826086	1	GO:1902415	GO:BP	regulation of mRNA binding	16175	22266		0.6	0.6666666666666666	4	16171	4	19	0	16152	16175	0.41678376359954594
M1	cpdb	0	network_modules	234	TRUE	5.338657418693173e-9	12	22	5	0.22727272727272727	0.4166666666666667	REAC:R-HSA-9820865	REAC	Z-decay: degradation of maternal mRNAs by zygotically expressed factors	10916	2679		0.5882352941176471	0.6111111111111112	12	10904	5	17	7	10887	10916	0.3067179616285706
M1	cpdb	0	network_modules	234	TRUE	7.0160021262441045e-9	434	23	11	0.4782608695652174	0.02534562211981567	GO:0010608	GO:BP	post-transcriptional regulation of gene expression	16175	4255		0.7	0.7142857142857143	434	15741	11	12	423	15729	16175	0.10542019412765534
M1	cpdb	0	network_modules	234	TRUE	2.350722800902543e-8	5	23	4	0.17391304347826086	0.8	GO:1905216	GO:BP	positive regulation of RNA binding	16175	24451		0.75	0.7619047619047619	5	16170	4	19	1	16151	16175	0.3726615455678662
M1	cpdb	0	network_modules	234	TRUE	1.6424139567511498e-7	7	23	4	0.17391304347826086	0.5714285714285714	GO:1905214	GO:BP	regulation of RNA binding	16175	24449		0.8	0.8095238095238095	7	16168	4	19	3	16149	16175	0.31475163206046586
M1	cpdb	0	network_modules	234	TRUE	3.5213365081434634e-7	25	22	5	0.22727272727272727	0.2	REAC:R-HSA-429947	REAC	Deadenylation of mRNA	10916	453		0.6470588235294118	0.7222222222222222	25	10891	5	17	20	10874	10916	0.21150763945684406
M1	cpdb	0	network_modules	234	TRUE	3.5213365081434634e-7	25	22	5	0.22727272727272727	0.2	REAC:R-HSA-9820841	REAC	M-decay: degradation of maternal mRNAs by maternally stored factors	10916	1344		0.6470588235294118	0.7222222222222222	25	10891	5	17	20	10874	10916	0.21150763945684406
M1	cpdb	0	network_modules	234	TRUE	1.5427473046121714e-6	11	23	4	0.17391304347826086	0.36363636363636365	GO:0075522	GO:BP	IRES-dependent viral translational initiation	16175	17755		0.85	0.8571428571428571	11	16164	4	19	7	16145	16175	0.25075804274801294
M1	cpdb	0	network_modules	234	TRUE	7.599557800104754e-6	102	23	6	0.2608695652173913	0.058823529411764705	GO:0019080	GO:BP	viral gene expression	16175	5570		0.9	0.9047619047619048	102	16073	6	17	96	16056	16175	0.12135081387926988
M1	cpdb	0	network_modules	234	TRUE	2.4316063403413e-5	56	22	5	0.22727272727272727	0.08928571428571429	REAC:R-HSA-429914	REAC	Deadenylation-dependent mRNA decay	10916	454		0.7647058823529411	0.7777777777777778	56	10860	5	17	51	10843	10916	0.13973467542579274
M1	cpdb	0	network_modules	234	TRUE	8.127835475895418e-5	71	22	5	0.22727272727272727	0.07042253521126761	REAC:R-HSA-1169408	REAC	ISG15 antiviral mechanism	10916	1166		0.8235294117647058	0.8333333333333334	71	10845	5	17	66	10828	10916	0.12341682293908147
M1	cpdb	0	network_modules	234	TRUE	5.765757720549884e-4	350	23	7	0.30434782608695654	0.02	GO:0016032	GO:BP	viral process	16175	5071		0.95	0.9523809523809523	350	15825	7	16	343	15809	16175	0.07332120068059267
M1	cpdb	0	network_modules	234	TRUE	8.709464014221777e-4	118	23	5	0.21739130434782608	0.0423728813559322	GO:0045727	GO:BP	positive regulation of translation	16175	11569		1	1	118	16057	5	18	113	16039	16175	0.09316221997339118
M1	cpdb	0	network_modules	234	TRUE	0.0010709605741957553	119	22	5	0.22727272727272727	0.04201680672268908	REAC:R-HSA-9816359	REAC	Maternal to zygotic transition (MZT)	10916	1394		0.8823529411764706	0.8888888888888888	119	10797	5	17	114	10780	10916	0.09363879176805931
M1	cpdb	0	network_modules	234	TRUE	0.003018970202928277	147	22	5	0.22727272727272727	0.034013605442176874	REAC:R-HSA-1169410	REAC	Antiviral mechanism by IFN-stimulated genes	10916	157		0.9411764705882353	0.9444444444444444	147	10769	5	17	142	10752	10916	0.08335952566695592
M1	cpdb	0	network_modules	234	TRUE	0.004664176146263619	24	22	3	0.13636363636363635	0.125	REAC:R-HSA-166208	REAC	mTORC1-mediated signalling	10916	2711		1	1	24	10892	3	19	21	10873	10916	0.12872445833395138
M1	cpdb	0	network_modules	235	TRUE	8.521187764943848e-5	9	16	3	0.1875	0.3333333333333333	GO:0070383	GO:BP	DNA cytosine deamination	16175	16090		0	0.07692307692307693	9	16166	3	13	6	16153	16175	0.24945089525338424
M1	cpdb	0	network_modules	235	TRUE	2.2277053192107846e-4	12	16	3	0.1875	0.25	GO:0016554	GO:BP	cytidine to uridine editing	16175	5245		0.08333333333333333	0.15384615384615385	12	16163	3	13	9	16150	16175	0.2158365105379345
M1	cpdb	0	network_modules	235	TRUE	2.894270779451282e-4	13	16	3	0.1875	0.23076923076923078	GO:0045006	GO:BP	DNA deamination	16175	11224		0.16666666666666666	0.23076923076923078	13	16162	3	13	10	16149	16175	0.20730677807359252
M1	cpdb	0	network_modules	235	TRUE	4.5989707565052026e-4	15	16	3	0.1875	0.2	GO:0045869	GO:BP	negative regulation of single stranded viral RNA replication via double stranded DNA intermediate	16175	11677		0.25	0.3076923076923077	15	16160	3	13	12	16147	16175	0.19287622447182098
M1	cpdb	0	network_modules	235	TRUE	8.232914002026105e-4	18	16	3	0.1875	0.16666666666666666	GO:0045091	GO:BP	regulation of single stranded viral RNA replication via double stranded DNA intermediate	16175	11273		0.3333333333333333	0.38461538461538464	18	16157	3	13	15	16144	16175	0.17591239566271397
M1	cpdb	0	network_modules	235	TRUE	9.77069032285153e-4	19	16	3	0.1875	0.15789473684210525	GO:0039692	GO:BP	single stranded viral RNA replication via double stranded DNA intermediate	16175	9869		0.4166666666666667	0.5384615384615384	19	16156	3	13	16	16143	16175	0.17116905694947215
M1	cpdb	0	network_modules	235	TRUE	9.77069032285153e-4	19	16	3	0.1875	0.15789473684210525	GO:0016553	GO:BP	base conversion or substitution editing	16175	5244		0.4166666666666667	0.5384615384615384	19	16156	3	13	16	16143	16175	0.17116905694947215
M1	cpdb	0	network_modules	235	TRUE	0.0016357216196144922	62	9	3	0.3333333333333333	0.04838709677419355	KEGG:03250	KEGG	Viral life cycle - HIV-1	8484	223		0	0.5	62	8422	3	6	59	8416	8484	0.12473838409971215
M1	cpdb	0	network_modules	235	TRUE	0.002253978923787456	210	9	4	0.4444444444444444	0.01904761904761905	KEGG:05170	KEGG	Human immunodeficiency virus 1 infection	8484	451		1	1	210	8274	4	5	206	8269	8484	0.08802688110088136
M1	cpdb	0	network_modules	235	TRUE	0.0029351592455293322	27	16	3	0.1875	0.1111111111111111	GO:0006304	GO:BP	DNA modification	16175	2111		0.5833333333333334	0.6153846153846154	27	16148	3	13	24	16135	16175	0.14324299225971948
M1	cpdb	0	network_modules	235	TRUE	0.0036622703357273682	29	16	3	0.1875	0.10344827586206896	GO:0039694	GO:BP	viral RNA genome replication	16175	9871		0.6666666666666666	0.6923076923076923	29	16146	3	13	26	16133	16175	0.1381319357800513
M1	cpdb	0	network_modules	235	TRUE	0.004962238135252073	32	16	3	0.1875	0.09375	GO:0010526	GO:BP	transposable element silencing	16175	4199		0.75	0.7692307692307693	32	16143	3	13	29	16130	16175	0.1313785603442454
M1	cpdb	0	network_modules	235	TRUE	0.005455170206931775	33	16	3	0.1875	0.09090909090909091	GO:0032197	GO:BP	retrotransposition	16175	7391		0.8333333333333334	0.8461538461538461	33	16142	3	13	30	16129	16175	0.12933355639244704
M1	cpdb	0	network_modules	235	TRUE	0.006536114093843217	35	16	3	0.1875	0.08571428571428572	GO:0032196	GO:BP	transposition	16175	7390		0.9166666666666666	0.9230769230769231	35	16140	3	13	32	16127	16175	0.1255080059505054
M1	cpdb	0	network_modules	235	TRUE	0.007048630844640989	4	16	2	0.125	0.5	GO:0032202	GO:BP	telomere assembly	16175	7394		1	1	4	16171	2	14	2	16157	16175	0.24965977593568692
M1	cpdb	0	network_modules	237	TRUE	0.004188003377386938	5	13	2	0.15384615384615385	0.4	REAC:R-HSA-391906	REAC	Leukotriene receptors	10916	1313		NA	1	5	10911	2	11	3	10900	10916	0.24753500040008916
M1	cpdb	0	network_modules	238	TRUE	2.1636703894117987e-4	36	8	3	0.375	0.08333333333333333	KEGG:03030	KEGG	DNA replication	8484	214		0	0.16666666666666666	36	8448	3	5	33	8443	8484	0.17523102688877076
M1	cpdb	0	network_modules	238	TRUE	3.308903694711226e-4	10	21	3	0.14285714285714285	0.3	GO:0046385	GO:BP	deoxyribose phosphate biosynthetic process	16175	12113		0	0.3333333333333333	10	16165	3	18	7	16147	16175	0.20632147919649532
M1	cpdb	0	network_modules	238	TRUE	3.308903694711226e-4	10	21	3	0.14285714285714285	0.3	GO:0009265	GO:BP	2'-deoxyribonucleotide biosynthetic process	16175	3430		0	0.3333333333333333	10	16165	3	18	7	16147	16175	0.20632147919649532
M1	cpdb	0	network_modules	238	TRUE	3.308903694711226e-4	10	21	3	0.14285714285714285	0.3	GO:0009263	GO:BP	deoxyribonucleotide biosynthetic process	16175	3428		0	0.3333333333333333	10	16165	3	18	7	16147	16175	0.20632147919649532
M1	cpdb	0	network_modules	238	TRUE	6.50187366693047e-4	27	11	3	0.2727272727272727	0.1111111111111111	REAC:R-HSA-499943	REAC	Interconversion of nucleotide di- and triphosphates	10916	1225		NA	1	27	10889	3	8	24	10881	10916	0.17279971661140084
M1	cpdb	0	network_modules	238	TRUE	8.325955364364987e-4	56	8	3	0.375	0.05357142857142857	KEGG:00480	KEGG	Glutathione metabolism	8484	61		0.2	0.3333333333333333	56	8428	3	5	53	8423	8484	0.13976960755062678
M1	cpdb	0	network_modules	238	TRUE	8.784609108647747e-4	57	8	3	0.375	0.05263157894736842	KEGG:00240	KEGG	Pyrimidine metabolism	8484	24		0.4	0.5	57	8427	3	5	54	8422	8484	0.13850202517098192
M1	cpdb	0	network_modules	238	TRUE	0.0023510724389835375	79	8	3	0.375	0.0379746835443038	KEGG:00983	KEGG	Drug metabolism - other enzymes	8484	157		0.6	0.6666666666666666	79	8405	3	5	76	8400	8484	0.11697118916859395
M1	cpdb	0	network_modules	238	TRUE	0.0025266934995087907	69	21	4	0.19047619047619047	0.057971014492753624	GO:1901992	GO:BP	positive regulation of mitotic cell cycle phase transition	16175	21925		0.375	0.4444444444444444	69	16106	4	17	65	16089	16175	0.10301472718470382
M1	cpdb	0	network_modules	238	TRUE	0.0028265690450960308	84	8	3	0.375	0.03571428571428571	KEGG:01232	KEGG	Nucleotide metabolism	8484	189		0.8	0.8333333333333334	84	8400	3	5	81	8395	8484	0.1132873840404469
M1	cpdb	0	network_modules	238	TRUE	0.006118309952301811	86	21	4	0.19047619047619047	0.046511627906976744	GO:1901989	GO:BP	positive regulation of cell cycle phase transition	16175	21922		0.5	0.5555555555555556	86	16089	4	17	82	16072	16175	0.09180065464393276
M1	cpdb	0	network_modules	238	TRUE	0.008362769168120454	93	21	4	0.19047619047619047	0.043010752688172046	GO:0045931	GO:BP	positive regulation of mitotic cell cycle	16175	11725		0.625	0.6666666666666666	93	16082	4	17	89	16065	16175	0.08809104800883613
M1	cpdb	0	network_modules	238	TRUE	0.009476989773658911	126	8	3	0.375	0.023809523809523808	KEGG:00230	KEGG	Purine metabolism	8484	22		1	1	126	8358	3	5	123	8353	8484	0.09147351158378104
M1	cpdb	0	network_modules	238	TRUE	0.00991701611104576	29	21	3	0.14285714285714285	0.10344827586206896	GO:0006298	GO:BP	mismatch repair	16175	2107		0.75	1	29	16146	3	18	26	16128	16175	0.12022627641589377
M1	cpdb	0	network_modules	238	TRUE	0.00991701611104576	29	21	3	0.14285714285714285	0.10344827586206896	GO:0009394	GO:BP	2'-deoxyribonucleotide metabolic process	16175	3463		0.75	1	29	16146	3	18	26	16128	16175	0.12022627641589377
M1	cpdb	0	network_modules	238	TRUE	0.00991701611104576	29	21	3	0.14285714285714285	0.10344827586206896	GO:0019692	GO:BP	deoxyribose phosphate metabolic process	16175	6009		0.75	1	29	16146	3	18	26	16128	16175	0.12022627641589377
M1	cpdb	0	network_modules	241	TRUE	2.8371246326474507e-4	10	20	3	0.15	0.3	GO:0035871	GO:BP	protein K11-linked deubiquitination	16175	9300		0	0.125	10	16165	3	17	7	16148	16175	0.21145381705734298
M1	cpdb	0	network_modules	241	TRUE	0.002136057581726714	2	20	2	0.1	1	GO:0042441	GO:BP	eye pigment metabolic process	16175	10181		0.14285714285714285	0.5	2	16173	2	18	0	16155	16175	0.316051741641375
M1	cpdb	0	network_modules	241	TRUE	0.002136057581726714	2	20	2	0.1	1	GO:0043324	GO:BP	pigment metabolic process involved in developmental pigmentation	16175	10632		0.14285714285714285	0.5	2	16173	2	18	0	16155	16175	0.316051741641375
M1	cpdb	0	network_modules	241	TRUE	0.002136057581726714	2	20	2	0.1	1	GO:0006726	GO:BP	eye pigment biosynthetic process	16175	2430		0.14285714285714285	0.5	2	16173	2	18	0	16155	16175	0.316051741641375
M1	cpdb	0	network_modules	241	TRUE	0.0022969051566533666	749	20	8	0.4	0.010680907877169559	GO:0070647	GO:BP	protein modification by small protein conjugation or removal	16175	16231		0.5714285714285714	0.625	749	15426	8	12	741	15414	16175	0.05921965760393884
M1	cpdb	0	network_modules	241	TRUE	0.0036961442208468913	798	20	8	0.4	0.010025062656641603	GO:0043687	GO:BP	post-translational protein modification	16175	10838		0.7142857142857143	0.75	798	15377	8	12	790	15365	16175	0.05697187148764716
M1	cpdb	0	network_modules	241	TRUE	0.0037708250233749697	39	13	3	0.23076923076923078	0.07692307692307693	REAC:R-HSA-5689896	REAC	Ovarian tumor domain proteases	10916	1653		0	0.5	39	10877	3	10	36	10867	10916	0.1314852249217517
M1	cpdb	0	network_modules	241	TRUE	0.004188003377386938	5	13	2	0.15384615384615385	0.4	REAC:R-HSA-5662702	REAC	Melanin biosynthesis	10916	1413		1	1	5	10911	2	11	3	10900	10916	0.24753500040008916
M1	cpdb	0	network_modules	241	TRUE	0.005964926348183441	90	20	4	0.2	0.044444444444444446	GO:0016579	GO:BP	protein deubiquitination	16175	5255		0.8571428571428571	0.875	90	16085	4	16	86	16069	16175	0.09197088786869284
M1	cpdb	0	network_modules	241	TRUE	0.006403418026022153	3	20	2	0.1	0.6666666666666666	GO:0043474	GO:BP	pigment metabolic process involved in pigmentation	16175	10720		1	1	3	16172	2	18	1	16154	16175	0.25790340281345747
M1	cpdb	0	network_modules	243	TRUE	8.198323680992301e-5	32	7	3	0.42857142857142855	0.09375	KEGG:00052	KEGG	Galactose metabolism	8484	7		0	0.5	32	8452	3	4	29	8448	8484	0.1991397590817774
M1	cpdb	0	network_modules	243	TRUE	0.009846216659474495	27	7	2	0.2857142857142857	0.07407407407407407	KEGG:00790	KEGG	Folate biosynthesis	8484	125		1	1	27	8457	2	5	25	8452	8484	0.14414710184470317
M1	cpdb	0	network_modules	246	TRUE	3.614046334002599e-4	12	18	3	0.16666666666666666	0.25	GO:0006388	GO:BP	tRNA splicing, via endonucleolytic cleavage and ligation	16175	2152		0	0.5	12	16163	3	15	9	16148	16175	0.20340415639299522
M1	cpdb	0	network_modules	246	TRUE	4.694991816370838e-4	13	18	3	0.16666666666666666	0.23076923076923078	GO:0000394	GO:BP	RNA splicing, via endonucleolytic cleavage and ligation	16175	119		1	1	13	16162	3	15	10	16147	16175	0.19535762029137801
M1	cpdb	0	network_modules	248	TRUE	0.003380824976026732	16	7	2	0.2857142857142857	0.125	KEGG:00360	KEGG	Phenylalanine metabolism	8484	42		NA	1	16	8468	2	5	14	8463	8484	0.18798967411231668
M1	cpdb	0	network_modules	250	TRUE	8.900652619184917e-5	131	7	4	0.5714285714285714	0.030534351145038167	KEGG:04728	KEGG	Dopaminergic synapse	8484	358		0	0.125	131	8353	4	3	127	8350	8484	0.1295796838886166
M1	cpdb	0	network_modules	250	TRUE	6.808822427170902e-4	64	7	3	0.42857142857142855	0.046875	KEGG:04929	KEGG	GnRH secretion	8484	386		0.14285714285714285	0.25	64	8420	3	4	61	8416	8484	0.13982774244206753
M1	cpdb	0	network_modules	250	TRUE	0.0010862825865104932	29	12	3	0.25	0.10344827586206896	REAC:R-HSA-1296041	REAC	Activation of G protein gated Potassium channels	10916	82		0	0.42857142857142855	29	10887	3	9	26	10878	10916	0.15940735486820992
M1	cpdb	0	network_modules	250	TRUE	0.0010862825865104932	29	12	3	0.25	0.10344827586206896	REAC:R-HSA-1296059	REAC	G protein gated Potassium channels	10916	995		0	0.42857142857142855	29	10887	3	9	26	10878	10916	0.15940735486820992
M1	cpdb	0	network_modules	250	TRUE	0.0010862825865104932	29	12	3	0.25	0.10344827586206896	REAC:R-HSA-997272	REAC	Inhibition  of voltage gated Ca2+ channels via Gbeta/gamma subunits	10916	1188		0	0.42857142857142855	29	10887	3	9	26	10878	10916	0.15940735486820992
M1	cpdb	0	network_modules	250	TRUE	0.0018394608812429397	89	7	3	0.42857142857142855	0.033707865168539325	KEGG:05032	KEGG	Morphine addiction	8484	420		0.2857142857142857	0.375	89	8395	3	4	86	8391	8484	0.11791899342930567
M1	cpdb	0	network_modules	250	TRUE	0.0019385197041217415	35	12	3	0.25	0.08571428571428572	REAC:R-HSA-1296065	REAC	Inwardly rectifying K+ channels	10916	1271		0.5	0.5714285714285714	35	10881	3	9	32	10872	10916	0.1448194406305537
M1	cpdb	0	network_modules	250	TRUE	0.002381377134528591	97	7	3	0.42857142857142855	0.030927835051546393	KEGG:04713	KEGG	Circadian entrainment	8484	348		0.42857142857142855	0.5	97	8387	3	4	94	8383	8484	0.11275071443411114
M1	cpdb	0	network_modules	250	TRUE	0.003637130098314877	43	12	3	0.25	0.06976744186046512	REAC:R-HSA-977444	REAC	GABA B receptor activation	10916	1010		0.6666666666666666	0.8571428571428571	43	10873	3	9	40	10864	10916	0.13031511395583956
M1	cpdb	0	network_modules	250	TRUE	0.003637130098314877	43	12	3	0.25	0.06976744186046512	REAC:R-HSA-991365	REAC	Activation of GABAB receptors	10916	83		0.6666666666666666	0.8571428571428571	43	10873	3	9	40	10864	10916	0.13031511395583956
M1	cpdb	0	network_modules	250	TRUE	0.0036616260994795833	112	7	3	0.42857142857142855	0.026785714285714284	KEGG:04726	KEGG	Serotonergic synapse	8484	356		0.5714285714285714	0.625	112	8372	3	4	109	8368	8484	0.10457796992018836
M1	cpdb	0	network_modules	250	TRUE	0.0065312840960437026	136	7	3	0.42857142857142855	0.022058823529411766	KEGG:04915	KEGG	Estrogen signaling pathway	8484	372		0.7142857142857143	0.75	136	8348	3	4	133	8344	8484	0.09439202396791643
M1	cpdb	0	network_modules	250	TRUE	0.00839635959471317	148	7	3	0.42857142857142855	0.02027027027027027	KEGG:04723	KEGG	Retrograde endocannabinoid signaling	8484	353		0.8571428571428571	0.875	148	8336	3	4	145	8332	8484	0.09023908728170854
M1	cpdb	0	network_modules	250	TRUE	0.009446768709636778	154	7	3	0.42857142857142855	0.01948051948051948	KEGG:04921	KEGG	Oxytocin signaling pathway	8484	378		1	1	154	8330	3	4	151	8326	8484	0.08834334396003647
M1	cpdb	0	network_modules	250	TRUE	0.009979608420164321	60	12	3	0.25	0.05	REAC:R-HSA-977443	REAC	GABA receptor activation	10916	1011		1	1	60	10856	3	9	57	10847	10916	0.10970735205984036
M1	cpdb	0	network_modules	251	TRUE	2.694742864173625e-6	184	11	6	0.5454545454545454	0.03260869565217391	REAC:R-HSA-9013149	REAC	RAC1 GTPase cycle	10916	1836		0	0.5	184	10732	6	5	178	10727	10916	0.13041386381513273
M1	cpdb	0	network_modules	251	TRUE	5.370734921147032e-4	449	11	6	0.5454545454545454	0.013363028953229399	REAC:R-HSA-9012999	REAC	RHO GTPase cycle	10916	1847		1	1	449	10467	6	5	443	10462	10916	0.08065306791426419
M1	cpdb	0	network_modules	251	TRUE	0.00523503180992032	389	19	6	0.3157894736842105	0.015424164524421594	GO:0007264	GO:BP	small GTPase-mediated signal transduction	16175	2792		0	0.5	389	15786	6	13	383	15773	16175	0.06530393001808024
M1	cpdb	0	network_modules	251	TRUE	0.009522870052197537	242	19	5	0.2631578947368421	0.02066115702479339	GO:0051056	GO:BP	regulation of small GTPase mediated signal transduction	16175	13466		1	1	242	15933	5	14	237	15919	16175	0.07011217178673257
M1	cpdb	0	network_modules	252	TRUE	2.0022244167200589e-7	9	18	4	0.2222222222222222	0.4444444444444444	REAC:R-HSA-390696	REAC	Adrenoceptors	10916	125		0	0.2	9	10907	4	14	5	10893	10916	0.31349141955609944
M1	cpdb	0	network_modules	252	TRUE	1.6802705654506858e-6	42	18	5	0.2777777777777778	0.11904761904761904	REAC:R-HSA-375280	REAC	Amine ligand-binding receptors	10916	139		0.25	0.4	42	10874	5	13	37	10861	10916	0.17982373170722019
M1	cpdb	0	network_modules	252	TRUE	1.4756966507089364e-5	21	20	4	0.2	0.19047619047619047	GO:0071880	GO:BP	adenylate cyclase-activating adrenergic receptor signaling pathway	16175	16961		0	0.14285714285714285	21	16154	4	16	17	16138	16175	0.19415907864427537
M1	cpdb	0	network_modules	252	TRUE	2.373612443413537e-5	5	20	3	0.15	0.6	GO:0150099	GO:BP	neuron-glial cell signaling	16175	20139		0.16666666666666666	0.2857142857142857	5	16170	3	17	2	16153	16175	0.2996133346554642
M1	cpdb	0	network_modules	252	TRUE	3.671588814620674e-5	26	20	4	0.2	0.15384615384615385	GO:0071875	GO:BP	adrenergic receptor signaling pathway	16175	16957		0.3333333333333333	0.42857142857142855	26	16149	4	16	22	16133	16175	0.17424958101181034
M1	cpdb	0	network_modules	252	TRUE	1.5322619298846666e-4	328	18	7	0.3888888888888889	0.021341463414634148	REAC:R-HSA-373076	REAC	Class A/1 (Rhodopsin-like receptors)	10916	365		0.5	0.6	328	10588	7	11	321	10577	10916	0.0854249736152502
M1	cpdb	0	network_modules	252	TRUE	4.3954104822835165e-4	365	13	6	0.46153846153846156	0.01643835616438356	KEGG:04080	KEGG	Neuroactive ligand-receptor interaction	8484	263		0	0.25	365	8119	6	7	359	8112	8484	0.08080154624037729
M1	cpdb	0	network_modules	252	TRUE	6.182171672423656e-4	129	20	5	0.25	0.03875968992248062	GO:0007204	GO:BP	positive regulation of cytosolic calcium ion concentration	16175	2759		0.5	0.5714285714285714	129	16046	5	15	124	16031	16175	0.09573865024338378
M1	cpdb	0	network_modules	252	TRUE	8.578837838984587e-4	14	20	3	0.15	0.21428571428571427	GO:0045907	GO:BP	positive regulation of vasoconstriction	16175	11703		0.6666666666666666	0.7142857142857143	14	16161	3	17	11	16144	16175	0.17843732284698927
M1	cpdb	0	network_modules	252	TRUE	0.0012556129432355885	251	13	5	0.38461538461538464	0.0199203187250996	KEGG:04020	KEGG	Calcium signaling pathway	8484	250		0.3333333333333333	0.5	251	8233	5	8	246	8225	8484	0.08208323716141826
M1	cpdb	0	network_modules	252	TRUE	0.0014779194282623345	460	18	7	0.3888888888888889	0.015217391304347827	REAC:R-HSA-500792	REAC	GPCR ligand binding	10916	1019		0.75	0.8	460	10456	7	11	453	10445	10916	0.07014226410926487
M1	cpdb	0	network_modules	252	TRUE	0.0020124572447596818	133	13	4	0.3076923076923077	0.03007518796992481	KEGG:04270	KEGG	Vascular smooth muscle contraction	8484	298		0.6666666666666666	0.75	133	8351	4	9	129	8342	8484	0.09209078901444029
M1	cpdb	0	network_modules	252	TRUE	0.0029397921398406452	774	20	8	0.4	0.0103359173126615	GO:0007186	GO:BP	G protein-coupled receptor signaling pathway	16175	2744		0.8333333333333334	0.8571428571428571	774	15401	8	12	766	15389	16175	0.0580479058319915
M1	cpdb	0	network_modules	252	TRUE	0.004570040065192732	164	13	4	0.3076923076923077	0.024390243902439025	KEGG:04022	KEGG	cGMP-PKG signaling pathway	8484	251		1	1	164	8320	4	9	160	8311	8484	0.0820463264330681
M1	cpdb	0	network_modules	252	TRUE	0.00580203923566447	213	18	5	0.2777777777777778	0.023474178403755867	REAC:R-HSA-416476	REAC	G alpha (q) signalling events	10916	988		1	1	213	10703	5	13	208	10690	10916	0.07588389184178447
M1	cpdb	0	network_modules	252	TRUE	0.007718085544745787	96	20	4	0.2	0.041666666666666664	GO:0007200	GO:BP	phospholipase C-activating G protein-coupled receptor signaling pathway	16175	2758		1	1	96	16079	4	16	92	16063	16175	0.08889712140644761
M1	cpdb	0	network_modules	253	TRUE	8.247231294875977e-17	15	21	8	0.38095238095238093	0.5333333333333333	REAC:R-HSA-111447	REAC	Activation of BAD and translocation to mitochondria 	10916	76		0	0.03225806451612903	15	10901	8	13	7	10888	10916	0.4498648678844078
M1	cpdb	0	network_modules	253	TRUE	7.923636419653978e-15	12	21	7	0.3333333333333333	0.5833333333333334	REAC:R-HSA-9755779	REAC	SARS-CoV-2 targets host intracellular signalling and regulatory pathways	10916	2127		0.03333333333333333	0.06451612903225806	12	10904	7	14	5	10890	10916	0.4401696823666938
M1	cpdb	0	network_modules	253	TRUE	1.714859451722882e-14	13	21	7	0.3333333333333333	0.5384615384615384	REAC:R-HSA-75035	REAC	Chk1/Chk2(Cds1) mediated inactivation of Cyclin B:Cdk1 complex	10916	347		0.06666666666666667	0.0967741935483871	13	10903	7	14	6	10889	10916	0.42280413077625795
M1	cpdb	0	network_modules	253	TRUE	6.416282633177856e-14	15	21	7	0.3333333333333333	0.4666666666666667	REAC:R-HSA-9735871	REAC	SARS-CoV-1 targets host intracellular signalling and regulatory pathways	10916	2118		0.1	0.12903225806451613	15	10901	7	14	8	10887	10916	0.3934281871835218
M1	cpdb	0	network_modules	253	TRUE	7.382799532385735e-14	30	21	8	0.38095238095238093	0.26666666666666666	REAC:R-HSA-114452	REAC	Activation of BH3-only proteins	10916	77		0.13333333333333333	0.16129032258064516	30	10886	8	13	22	10873	10916	0.31716921114221674
M1	cpdb	0	network_modules	253	TRUE	7.825849103862532e-14	54	21	9	0.42857142857142855	0.16666666666666666	REAC:R-HSA-109606	REAC	Intrinsic Pathway for Apoptosis	10916	1268		0.16666666666666666	0.1935483870967742	54	10862	9	12	45	10850	10916	0.2650872930395762
M1	cpdb	0	network_modules	253	TRUE	6.71385317615002e-12	12	21	6	0.2857142857142857	0.5	REAC:R-HSA-9614399	REAC	Regulation of localization of FOXO transcription factors	10916	2042		0.2	0.22580645161290322	12	10904	6	15	6	10889	10916	0.37708023577117344
M1	cpdb	0	network_modules	253	TRUE	5.192126295043461e-10	84	21	8	0.38095238095238093	0.09523809523809523	REAC:R-HSA-5628897	REAC	TP53 Regulates Metabolic Genes	10916	2452		0.23333333333333334	0.25806451612903225	84	10832	8	13	76	10819	10916	0.1875313351702039
M1	cpdb	0	network_modules	253	TRUE	4.725435429299893e-9	176	21	9	0.42857142857142855	0.05113636363636364	REAC:R-HSA-109581	REAC	Apoptosis	10916	158		0.26666666666666666	0.2903225806451613	176	10740	9	12	167	10728	10916	0.1437707728348007
M1	cpdb	0	network_modules	253	TRUE	5.432711745629132e-9	157	22	9	0.4090909090909091	0.05732484076433121	KEGG:04110	KEGG	Cell cycle	8484	264		0	0.125	157	8327	9	13	148	8314	8484	0.14777381435024195
M1	cpdb	0	network_modules	253	TRUE	7.3319076365127145e-9	66	21	7	0.3333333333333333	0.10606060606060606	REAC:R-HSA-9614085	REAC	FOXO-mediated transcription	10916	923		0.3	0.3225806451612903	66	10850	7	14	59	10836	10916	0.1853538841327829
M1	cpdb	0	network_modules	253	TRUE	1.3775038424909565e-8	72	21	7	0.3333333333333333	0.09722222222222222	REAC:R-HSA-1445148	REAC	Translocation of SLC2A4 (GLUT4) to the plasma membrane	10916	2578		0.3333333333333333	0.3548387096774194	72	10844	7	14	65	10830	10916	0.17721380494011735
M1	cpdb	0	network_modules	253	TRUE	2.1258401744177945e-8	208	21	9	0.42857142857142855	0.04326923076923077	REAC:R-HSA-5357801	REAC	Programmed Cell Death	10916	1803		0.36666666666666664	0.3870967741935484	208	10708	9	12	199	10696	10916	0.13150596814662288
M1	cpdb	0	network_modules	253	TRUE	4.9703812487550675e-8	201	22	9	0.4090909090909091	0.04477611940298507	KEGG:05203	KEGG	Viral carcinogenesis	8484	455		0.14285714285714285	0.25	201	8283	9	13	192	8270	8484	0.12920951617869722
M1	cpdb	0	network_modules	253	TRUE	8.651228141675552e-8	93	21	7	0.3333333333333333	0.07526881720430108	REAC:R-HSA-5625740	REAC	RHO GTPases activate PKNs	10916	1857		0.4	0.41935483870967744	93	10823	7	14	86	10809	10916	0.15515959277412691
M1	cpdb	0	network_modules	253	TRUE	9.336750119995249e-8	94	21	7	0.3333333333333333	0.07446808510638298	REAC:R-HSA-69473	REAC	G2/M DNA damage checkpoint	10916	1006		0.43333333333333335	0.45161290322580644	94	10822	7	14	87	10808	10916	0.15429567039428993
M1	cpdb	0	network_modules	253	TRUE	1.0068064934218164e-7	95	21	7	0.3333333333333333	0.07368421052631578	REAC:R-HSA-9692914	REAC	SARS-CoV-1-host interactions	10916	2119		0.4666666666666667	0.4838709677419355	95	10821	7	14	88	10807	10916	0.1534452299463375
M1	cpdb	0	network_modules	253	TRUE	1.0568069112664888e-7	359	21	10	0.47619047619047616	0.027855153203342618	REAC:R-HSA-3700989	REAC	Transcriptional Regulation by TP53	10916	2546		0.5	0.5161290322580645	359	10557	10	11	349	10546	10916	0.10912963798899307
M1	cpdb	0	network_modules	253	TRUE	1.3793346090426246e-7	167	21	8	0.38095238095238093	0.04790419161676647	REAC:R-HSA-69481	REAC	G2/M Checkpoints	10916	1005		0.5333333333333333	0.5483870967741935	167	10749	8	13	159	10736	10916	0.13079384469001393
M1	cpdb	0	network_modules	253	TRUE	2.0595225011291955e-7	158	22	8	0.36363636363636365	0.05063291139240506	KEGG:05160	KEGG	Hepatitis C	8484	441		0.2857142857142857	0.375	158	8326	8	14	150	8312	8484	0.13012606412744396
M1	cpdb	0	network_modules	253	TRUE	3.973255172798002e-7	289	21	9	0.42857142857142855	0.031141868512110725	REAC:R-HSA-69620	REAC	Cell Cycle Checkpoints	10916	321		0.5666666666666667	0.5806451612903226	289	10627	9	12	280	10615	10916	0.10996022503268874
M1	cpdb	0	network_modules	253	TRUE	4.0811849203799436e-7	356	22	10	0.45454545454545453	0.028089887640449437	KEGG:04151	KEGG	PI3K-Akt signaling pathway	8484	285		0.42857142857142855	0.5	356	8128	10	12	346	8116	8484	0.10492310807776968
M1	cpdb	0	network_modules	253	TRUE	9.229692442885927e-7	318	21	9	0.42857142857142855	0.02830188679245283	REAC:R-HSA-195258	REAC	RHO GTPase Effectors	10916	1846		0.6	0.6129032258064516	318	10598	9	12	309	10586	10916	0.10427626341925185
M1	cpdb	0	network_modules	253	TRUE	1.5550982092737377e-6	140	21	7	0.3333333333333333	0.05	REAC:R-HSA-9678108	REAC	SARS-CoV-1 Infection	10916	2114		0.6333333333333333	0.6451612903225806	140	10776	7	14	133	10762	10916	0.12505636132985432
M1	cpdb	0	network_modules	253	TRUE	1.1336966651983942e-5	292	21	8	0.38095238095238093	0.0273972602739726	REAC:R-HSA-9694516	REAC	SARS-CoV-2 Infection	10916	2122		0.6666666666666666	0.6774193548387096	292	10624	8	13	284	10611	10916	0.0963775569983645
M1	cpdb	0	network_modules	253	TRUE	1.6649039331347938e-5	197	21	7	0.3333333333333333	0.03553299492385787	REAC:R-HSA-9705683	REAC	SARS-CoV-2-host interactions	10916	2128		0.7	0.7096774193548387	197	10719	7	14	190	10705	10916	0.1039811430215395
M1	cpdb	0	network_modules	253	TRUE	4.6590310299835156e-5	26	21	4	0.19047619047619047	0.15384615384615385	REAC:R-HSA-5674400	REAC	Constitutive Signaling by AKT1 E17K in Cancer	10916	400		0.7333333333333333	0.7419354838709677	26	10890	4	17	22	10873	10916	0.1694083176691205
M1	cpdb	0	network_modules	253	TRUE	4.880919456275994e-5	131	22	6	0.2727272727272727	0.04580152671755725	KEGG:04114	KEGG	Oocyte meiosis	8484	268		0.5714285714285714	0.625	131	8353	6	16	125	8337	8484	0.10639849966392512
M1	cpdb	0	network_modules	253	TRUE	1.1516146115758978e-4	477	21	8	0.38095238095238093	0.016771488469601678	GO:0009896	GO:BP	positive regulation of catabolic process	16175	3756		0	0.07142857142857142	477	15698	8	13	469	15685	16175	0.07490511060531363
M1	cpdb	0	network_modules	253	TRUE	1.4134188349947927e-4	157	22	6	0.2727272727272727	0.03821656050955414	KEGG:04390	KEGG	Hippo signaling pathway	8484	310		0.7142857142857143	0.75	157	8327	6	16	151	8311	8484	0.09618210050367591
M1	cpdb	0	network_modules	253	TRUE	1.522174539546113e-4	187	21	6	0.2857142857142857	0.03208556149732621	GO:0031669	GO:BP	cellular response to nutrient levels	16175	7272		0.07692307692307693	0.14285714285714285	187	15988	6	15	181	15973	16175	0.0924675602230754
M1	cpdb	0	network_modules	253	TRUE	3.651293621310471e-4	459	21	8	0.38095238095238093	0.017429193899782137	REAC:R-HSA-9679506	REAC	SARS-CoV Infections	10916	2112		0.7666666666666667	0.7741935483870968	459	10457	8	13	451	10444	10916	0.07413552542060288
M1	cpdb	0	network_modules	253	TRUE	4.8273867431114704e-4	575	21	8	0.38095238095238093	0.01391304347826087	GO:0044092	GO:BP	negative regulation of molecular function	16175	10914		0.15384615384615385	0.21428571428571427	575	15600	8	13	567	15587	16175	0.06725810931113665
M1	cpdb	0	network_modules	253	TRUE	6.973212180514702e-4	14	21	3	0.14285714285714285	0.21428571428571427	REAC:R-HSA-198323	REAC	AKT phosphorylates targets in the cytosol	10916	14		0.8	0.8064516129032258	14	10902	3	18	11	10884	10916	0.1736712221464502
M1	cpdb	0	network_modules	253	TRUE	0.0011097973496928186	262	21	6	0.2857142857142857	0.022900763358778626	GO:0031667	GO:BP	response to nutrient levels	16175	7271		0.23076923076923078	0.2857142857142857	262	15913	6	15	256	15898	16175	0.07697904115512313
M1	cpdb	0	network_modules	253	TRUE	0.001126986087868993	138	21	5	0.23809523809523808	0.036231884057971016	GO:0009267	GO:BP	cellular response to starvation	16175	3432		0.3076923076923077	0.35714285714285715	138	16037	5	16	133	16021	16175	0.08999445021758748
M1	cpdb	0	network_modules	253	TRUE	0.0013518286301709163	443	21	7	0.3333333333333333	0.01580135440180587	GO:0043549	GO:BP	regulation of kinase activity	16175	10763		0.38461538461538464	0.42857142857142855	443	15732	7	14	436	15718	16175	0.06758712572481745
M1	cpdb	0	network_modules	253	TRUE	0.0015411361155947157	147	21	5	0.23809523809523808	0.034013605442176874	GO:0006469	GO:BP	negative regulation of protein kinase activity	16175	2208		0.46153846153846156	0.5	147	16028	5	16	142	16012	16175	0.08700908160548788
M1	cpdb	0	network_modules	253	TRUE	0.002060723290809081	72	22	4	0.18181818181818182	0.05555555555555555	KEGG:05223	KEGG	Non-small cell lung cancer	8484	474		0.8571428571428571	0.875	72	8412	4	18	68	8394	8484	0.09634682394237812
M1	cpdb	0	network_modules	253	TRUE	0.0020671801565988208	156	21	5	0.23809523809523808	0.03205128205128205	GO:0033673	GO:BP	negative regulation of kinase activity	16175	8345		0.5384615384615384	0.5714285714285714	156	16019	5	16	151	16003	16175	0.08428037089165577
M1	cpdb	0	network_modules	253	TRUE	0.0022708943946427853	159	21	5	0.23809523809523808	0.031446540880503145	GO:0042594	GO:BP	response to starvation	16175	10254		0.6153846153846154	0.6428571428571429	159	16016	5	16	154	16000	16175	0.08342152285260179
M1	cpdb	0	network_modules	253	TRUE	0.0025259257797974324	21	21	3	0.14285714285714285	0.14285714285714285	REAC:R-HSA-8863678	REAC	Neurodegenerative Diseases	10916	1588		0.8333333333333334	0.8709677419354839	21	10895	3	18	18	10877	10916	0.14120500885071788
M1	cpdb	0	network_modules	253	TRUE	0.0025259257797974324	21	21	3	0.14285714285714285	0.14285714285714285	REAC:R-HSA-8862803	REAC	Deregulated CDK5 triggers multiple neurodegenerative pathways in Alzheimer's disease models	10916	733		0.8333333333333334	0.8709677419354839	21	10895	3	18	18	10877	10916	0.14120500885071788
M1	cpdb	0	network_modules	253	TRUE	0.0026505348913639995	418	21	7	0.3333333333333333	0.01674641148325359	REAC:R-HSA-5663202	REAC	Diseases of signal transduction by growth factor receptors and second messengers	10916	773		0.9	0.9032258064516129	418	10498	7	14	411	10484	10916	0.06749947320193353
M1	cpdb	0	network_modules	253	TRUE	0.002675795293136965	721	21	8	0.38095238095238093	0.011095700416088766	GO:0045087	GO:BP	innate immune response	16175	11270		0.6923076923076923	0.7142857142857143	721	15454	8	13	713	15441	16175	0.05876958795771448
M1	cpdb	0	network_modules	253	TRUE	0.003203746144110078	162	22	5	0.22727272727272727	0.030864197530864196	KEGG:05161	KEGG	Hepatitis B	8484	442		1	1	162	8322	5	17	157	8305	8484	0.0775601921882149
M1	cpdb	0	network_modules	253	TRUE	0.0035531339489023	512	21	7	0.3333333333333333	0.013671875	GO:0051338	GO:BP	regulation of transferase activity	16175	13665		0.7692307692307693	0.7857142857142857	512	15663	7	14	505	15649	16175	0.06212799091674003
M1	cpdb	0	network_modules	253	TRUE	0.0038297198916125894	24	21	3	0.14285714285714285	0.125	REAC:R-HSA-9734009	REAC	Defective Intrinsic Pathway for Apoptosis	10916	572		0.9333333333333333	0.9354838709677419	24	10892	3	18	21	10874	10916	0.1318457729520745
M1	cpdb	0	network_modules	253	TRUE	0.003957682493091346	178	21	5	0.23809523809523808	0.028089887640449437	GO:0051348	GO:BP	negative regulation of transferase activity	16175	13675		0.8461538461538461	0.8571428571428571	178	15997	5	16	173	15981	16175	0.07848447981114878
M1	cpdb	0	network_modules	253	TRUE	0.004342450032801739	293	21	6	0.2857142857142857	0.020477815699658702	REAC:R-HSA-9006925	REAC	Intracellular signaling by second messengers	10916	1266		0.9666666666666667	0.967741935483871	293	10623	6	15	287	10608	10916	0.07032161434350401
M1	cpdb	0	network_modules	253	TRUE	0.00800982601651334	92	21	4	0.19047619047619047	0.043478260869565216	GO:1903432	GO:BP	regulation of TORC1 signaling	16175	23003		0.9230769230769231	0.9285714285714286	92	16083	4	17	88	16066	16175	0.08859539718877721
M1	cpdb	0	network_modules	253	TRUE	0.008018852988316118	92	21	4	0.19047619047619047	0.043478260869565216	REAC:R-HSA-2219528	REAC	PI3K/AKT Signaling in Cancer	10916	1674		1	1	92	10824	4	17	88	10807	10916	0.0874295269504491
M1	cpdb	0	network_modules	253	TRUE	0.009890679751213686	97	21	4	0.19047619047619047	0.041237113402061855	GO:0038202	GO:BP	TORC1 signaling	16175	9766		1	1	97	16078	4	17	93	16061	16175	0.08615085997457718
M1	cpdb	0	network_modules	254	TRUE	9.411289041480387e-10	11	18	5	0.2777777777777778	0.45454545454545453	REAC:R-HSA-1362409	REAC	Mitochondrial iron-sulfur cluster biogenesis	10916	1466		0	0.16666666666666666	11	10905	5	13	6	10892	10916	0.35451641072039625
M1	cpdb	0	network_modules	254	TRUE	1.4919517172708578e-9	11	21	5	0.23809523809523808	0.45454545454545453	GO:0044571	GO:BP	[2Fe-2S] cluster assembly	16175	11083		0	0.14285714285714285	11	16164	5	16	6	16148	16175	0.3283610311802352
M1	cpdb	0	network_modules	254	TRUE	3.7784472179691345e-7	29	21	5	0.23809523809523808	0.1724137931034483	GO:0016226	GO:BP	iron-sulfur cluster assembly	16175	5177		0.16666666666666666	0.42857142857142855	29	16146	5	16	24	16130	16175	0.20139582400029488
M1	cpdb	0	network_modules	254	TRUE	3.7784472179691345e-7	29	21	5	0.23809523809523808	0.1724137931034483	GO:0031163	GO:BP	metallo-sulfur cluster assembly	16175	7078		0.16666666666666666	0.42857142857142855	29	16146	5	16	24	16130	16175	0.20139582400029488
M1	cpdb	0	network_modules	254	TRUE	2.768957475494408e-5	5	21	3	0.14285714285714285	0.6	GO:0044572	GO:BP	[4Fe-4S] cluster assembly	16175	11084		0.5	0.5714285714285714	5	16170	3	18	2	16152	16175	0.2923715339746765
M1	cpdb	0	network_modules	254	TRUE	4.888247341492835e-5	31	18	4	0.2222222222222222	0.12903225806451613	REAC:R-HSA-389661	REAC	Glyoxylate metabolism and glycine degradation	10916	1081		0.2	0.3333333333333333	31	10885	4	14	27	10871	10916	0.16754559210936695
M1	cpdb	0	network_modules	254	TRUE	0.0023756679785927656	3	18	2	0.1111111111111111	0.6666666666666666	REAC:R-HSA-2395516	REAC	Electron transport from NADPH to Ferredoxin	10916	838		0.4	0.5	3	10913	2	16	1	10897	10916	0.27175380533553956
M1	cpdb	0	network_modules	254	TRUE	0.0033184637457854952	742	21	8	0.38095238095238093	0.01078167115902965	GO:0019752	GO:BP	carboxylic acid metabolic process	16175	6036		0.6666666666666666	0.7142857142857143	742	15433	8	13	734	15420	16175	0.05774762566228121
M1	cpdb	0	network_modules	254	TRUE	0.004009462615362956	761	21	8	0.38095238095238093	0.010512483574244415	GO:0043436	GO:BP	oxoacid metabolic process	16175	10693		0.8333333333333334	0.8571428571428571	761	15414	8	13	753	15401	16175	0.05685728548530429
M1	cpdb	0	network_modules	254	TRUE	0.004251747015380059	767	21	8	0.38095238095238093	0.010430247718383311	GO:0006082	GO:BP	organic acid metabolic process	16175	1947		1	1	767	15408	8	13	759	15395	16175	0.05658255751756182
M1	cpdb	0	network_modules	254	TRUE	0.004746692544996373	4	18	2	0.1111111111111111	0.5	REAC:R-HSA-5579026	REAC	Defective CYP11A1 causes AICSR	10916	514		0.6	0.6666666666666666	4	10912	2	16	2	10896	10916	0.23516195519816133
M1	cpdb	0	network_modules	254	TRUE	0.005270314638698235	10	13	2	0.15384615384615385	0.2	KEGG:00920	KEGG	Sulfur metabolism	8484	140		NA	1	10	8474	2	11	8	8463	8484	0.1743039617649687
M1	cpdb	0	network_modules	254	TRUE	0.005903485660749808	370	18	6	0.3333333333333333	0.016216216216216217	REAC:R-HSA-71291	REAC	Metabolism of amino acids and derivatives	10916	1421		0.8	0.8333333333333334	370	10546	6	12	364	10534	10916	0.06724945040535148
M1	cpdb	0	network_modules	254	TRUE	0.008717968689634708	37	18	3	0.16666666666666666	0.08108108108108109	REAC:R-HSA-77289	REAC	Mitochondrial Fatty Acid Beta-Oxidation	10916	1461		1	1	37	10879	3	15	34	10864	10916	0.1141711642451983
M1	cpdb	0	network_modules	255	TRUE	2.7807704486164514e-18	158	22	13	0.5909090909090909	0.08227848101265822	GO:0050851	GO:BP	antigen receptor-mediated signaling pathway	16175	13299		0	0.016129032258064516	158	16017	13	9	145	16008	16175	0.21806771160692717
M1	cpdb	0	network_modules	255	TRUE	6.826801456421713e-18	114	22	12	0.5454545454545454	0.10526315789473684	GO:0050852	GO:BP	T cell receptor signaling pathway	16175	13300		0.01639344262295082	0.03225806451612903	114	16061	12	10	102	16051	16175	0.23752029135542724
M1	cpdb	0	network_modules	255	TRUE	8.500617035649679e-17	287	22	14	0.6363636363636364	0.04878048780487805	GO:0002768	GO:BP	immune response-regulating cell surface receptor signaling pathway	16175	1279		0.03278688524590164	0.04838709677419355	287	15888	14	8	273	15880	16175	0.17293287829560083
M1	cpdb	0	network_modules	255	TRUE	3.7098832637967147e-16	569	22	16	0.7272727272727273	0.028119507908611598	GO:0046649	GO:BP	lymphocyte activation	16175	12286		0.04918032786885246	0.06451612903225806	569	15606	16	6	553	15600	16175	0.13864135692726692
M1	cpdb	0	network_modules	255	TRUE	2.6910247250810046e-15	265	22	13	0.5909090909090909	0.04905660377358491	GO:0002429	GO:BP	immune response-activating cell surface receptor signaling pathway	16175	952		0.06557377049180328	0.08064516129032258	265	15910	13	9	252	15901	16175	0.16702463446820728
M1	cpdb	0	network_modules	255	TRUE	9.909742924085617e-15	699	22	16	0.7272727272727273	0.022889842632331903	GO:0045321	GO:BP	leukocyte activation	16175	11356		0.08196721311475409	0.0967741935483871	699	15476	16	6	683	15470	16175	0.12415206314325275
M1	cpdb	0	network_modules	255	TRUE	3.189147289675486e-14	437	22	14	0.6363636363636364	0.032036613272311214	GO:0002764	GO:BP	immune response-regulating signaling pathway	16175	1275		0.09836065573770492	0.11290322580645161	437	15738	14	8	423	15730	16175	0.13870047911960923
M1	cpdb	0	network_modules	255	TRUE	5.476019045899858e-13	20	20	7	0.35	0.35	REAC:R-HSA-202430	REAC	Translocation of ZAP-70 to Immunological synapse	10916	2579		0	0.05	20	10896	7	13	13	10883	10916	0.3488069016152716
M1	cpdb	0	network_modules	255	TRUE	7.110481636372838e-13	406	22	13	0.5909090909090909	0.03201970443349754	GO:0042110	GO:BP	T cell activation	16175	9970		0.11475409836065574	0.12903225806451613	406	15769	13	9	393	15760	16175	0.13348531939084682
M1	cpdb	0	network_modules	255	TRUE	9.750450554459489e-13	416	22	13	0.5909090909090909	0.03125	GO:0002757	GO:BP	immune response-activating signaling pathway	16175	1268		0.13114754098360656	0.14516129032258066	416	15759	13	9	403	15750	16175	0.13176886599593302
M1	cpdb	0	network_modules	255	TRUE	1.0305334627173678e-12	119	19	10	0.5263157894736842	0.08403361344537816	KEGG:04660	KEGG	T cell receptor signaling pathway	8484	338		0	0.1	119	8365	10	9	109	8356	8484	0.20638250733795704
M1	cpdb	0	network_modules	255	TRUE	4.479892601930013e-12	468	22	13	0.5909090909090909	0.027777777777777776	GO:0050865	GO:BP	regulation of cell activation	16175	13313		0.14754098360655737	0.16129032258064516	468	15707	13	9	455	15698	16175	0.12373053961952561
M1	cpdb	0	network_modules	255	TRUE	5.4270189678506415e-12	475	22	13	0.5909090909090909	0.02736842105263158	GO:0002253	GO:BP	activation of immune response	16175	785		0.16393442622950818	0.1774193548387097	475	15700	13	9	462	15691	16175	0.12274823431289013
M1	cpdb	0	network_modules	255	TRUE	1.1842960725874663e-11	369	22	12	0.5454545454545454	0.032520325203252036	GO:0051249	GO:BP	regulation of lymphocyte activation	16175	13596		0.18032786885245902	0.1935483870967742	369	15806	12	10	357	15796	16175	0.12918402294200967
M1	cpdb	0	network_modules	255	TRUE	5.252752100546056e-11	67	20	8	0.4	0.11940298507462686	REAC:R-HSA-388841	REAC	Regulation of T cell activation by CD28 family	10916	2007		0.05263157894736842	0.1	67	10849	8	12	59	10837	10916	0.21605138102666493
M1	cpdb	0	network_modules	255	TRUE	5.716652498922703e-11	421	22	12	0.5454545454545454	0.028503562945368172	GO:0002694	GO:BP	regulation of leukocyte activation	16175	1212		0.19672131147540983	0.20967741935483872	421	15754	12	10	409	15744	16175	0.12039732982916228
M1	cpdb	0	network_modules	255	TRUE	6.439552353940545e-11	756	22	14	0.6363636363636364	0.018518518518518517	GO:0050776	GO:BP	regulation of immune response	16175	13250		0.21311475409836064	0.22580645161290322	756	15419	14	8	742	15411	16175	0.10308982539894661
M1	cpdb	0	network_modules	255	TRUE	6.898542333301189e-11	206	22	10	0.45454545454545453	0.04854368932038835	GO:0030217	GO:BP	T cell differentiation	16175	6725		0.22950819672131148	0.24193548387096775	206	15969	10	12	196	15957	16175	0.1454091914854893
M1	cpdb	0	network_modules	255	TRUE	1.9248594250264397e-10	627	22	13	0.5909090909090909	0.02073365231259968	GO:0050778	GO:BP	positive regulation of immune response	16175	13252		0.2459016393442623	0.25806451612903225	627	15548	13	9	614	15539	16175	0.10556296658517772
M1	cpdb	0	network_modules	255	TRUE	4.5212522422259353e-10	89	19	8	0.42105263157894735	0.0898876404494382	KEGG:05235	KEGG	PD-L1 expression and PD-1 checkpoint pathway in cancer	8484	480		0.1111111111111111	0.2	89	8395	8	11	81	8384	8484	0.19091396168200403
M1	cpdb	0	network_modules	255	TRUE	5.528468804440124e-10	23	20	6	0.3	0.2608695652173913	REAC:R-HSA-202427	REAC	Phosphorylation of CD3 and TCR zeta chains	10916	1749		0.10526315789473684	0.15	23	10893	6	14	17	10879	10916	0.27833486292877846
M1	cpdb	0	network_modules	255	TRUE	1.2514286993669077e-9	275	22	10	0.45454545454545453	0.03636363636363636	GO:0002696	GO:BP	positive regulation of leukocyte activation	16175	1214		0.26229508196721313	0.27419354838709675	275	15900	10	12	265	15888	16175	0.12490670919608238
M1	cpdb	0	network_modules	255	TRUE	1.7254076132745058e-9	284	22	10	0.45454545454545453	0.035211267605633804	GO:0050863	GO:BP	regulation of T cell activation	16175	13311		0.2786885245901639	0.2903225806451613	284	15891	10	12	274	15879	16175	0.12279007321255324
M1	cpdb	0	network_modules	255	TRUE	2.1250052150248524e-9	290	22	10	0.45454545454545453	0.034482758620689655	GO:0050867	GO:BP	positive regulation of cell activation	16175	13315		0.29508196721311475	0.3064516129032258	290	15885	10	12	280	15873	16175	0.12143297088496394
M1	cpdb	0	network_modules	255	TRUE	2.6945462896341634e-9	297	22	10	0.45454545454545453	0.03367003367003367	GO:0030098	GO:BP	lymphocyte differentiation	16175	6676		0.3114754098360656	0.3225806451612903	297	15878	10	12	287	15866	16175	0.11990089553282543
M1	cpdb	0	network_modules	255	TRUE	6.423063958796121e-9	120	20	8	0.4	0.06666666666666667	REAC:R-HSA-202403	REAC	TCR signaling	10916	2422		0.15789473684210525	0.2	120	10796	8	12	112	10784	10916	0.15983809349454095
M1	cpdb	0	network_modules	255	TRUE	6.766163624271229e-9	124	19	8	0.42105263157894735	0.06451612903225806	KEGG:04650	KEGG	Natural killer cell mediated cytotoxicity	8484	334		0.2222222222222222	0.3	124	8360	8	11	116	8349	8484	0.16045125236845129
M1	cpdb	0	network_modules	255	TRUE	8.772634259679463e-9	35	20	6	0.3	0.17142857142857143	REAC:R-HSA-202433	REAC	Generation of second messenger molecules	10916	1044		0.21052631578947367	0.25	35	10881	6	14	29	10867	10916	0.2249216311046814
M1	cpdb	0	network_modules	255	TRUE	1.6711060623576503e-8	357	22	10	0.45454545454545453	0.028011204481792718	GO:1903131	GO:BP	mononuclear cell differentiation	16175	22787		0.32786885245901637	0.3387096774193548	357	15818	10	12	347	15806	16175	0.10863743457189444
M1	cpdb	0	network_modules	255	TRUE	2.3726317934074955e-8	249	22	9	0.4090909090909091	0.03614457831325301	GO:0051251	GO:BP	positive regulation of lymphocyte activation	16175	13598		0.3442622950819672	0.3548387096774194	249	15926	9	13	240	15913	16175	0.1180151789691525
M1	cpdb	0	network_modules	255	TRUE	3.090712390368621e-8	89	19	7	0.3684210526315789	0.07865168539325842	KEGG:04658	KEGG	Th1 and Th2 cell differentiation	8484	336		0.3333333333333333	0.4	89	8395	7	12	82	8383	8484	0.16643995780007234
M1	cpdb	0	network_modules	255	TRUE	3.91496377041713e-8	92	19	7	0.3684210526315789	0.07608695652173914	KEGG:04640	KEGG	Hematopoietic cell lineage	8484	333		0.4444444444444444	0.5	92	8392	7	12	85	8380	8484	0.16357127509785055
M1	cpdb	0	network_modules	255	TRUE	1.00076074566e-7	105	19	7	0.3684210526315789	0.06666666666666667	KEGG:04659	KEGG	Th17 cell differentiation	8484	337		0.5555555555555556	0.6	105	8379	7	12	98	8367	8484	0.15257307527101263
M1	cpdb	0	network_modules	255	TRUE	1.1430495367862369e-7	434	22	10	0.45454545454545453	0.02304147465437788	GO:0002521	GO:BP	leukocyte differentiation	16175	1043		0.36065573770491804	0.3709677419354839	434	15741	10	12	424	15729	16175	0.0976835418671556
M1	cpdb	0	network_modules	255	TRUE	1.688032313462538e-7	24	20	5	0.25	0.20833333333333334	REAC:R-HSA-389948	REAC	Co-inhibition by PD-1	10916	377		0.2631578947368421	0.3	24	10892	5	15	19	10877	10916	0.2266675146899578
M1	cpdb	0	network_modules	255	TRUE	2.1184347819792528e-7	638	22	11	0.5	0.017241379310344827	GO:0030097	GO:BP	hemopoiesis	16175	6675		0.3770491803278688	0.3870967741935484	638	15537	11	11	627	15526	16175	0.08732084830322207
M1	cpdb	0	network_modules	255	TRUE	2.418400339960156e-7	8	22	4	0.18181818181818182	0.5	GO:0045059	GO:BP	positive thymic T cell selection	16175	11257		0.39344262295081966	0.4032258064516129	8	16167	4	18	4	16149	16175	0.30097029428723465
M1	cpdb	0	network_modules	255	TRUE	8.182956390996998e-7	37	19	5	0.2631578947368421	0.13513513513513514	KEGG:05340	KEGG	Primary immunodeficiency	8484	488		0.6666666666666666	0.7	37	8447	5	14	32	8433	8484	0.186067566871792
M1	cpdb	0	network_modules	255	TRUE	1.13705978347731e-6	11	22	4	0.18181818181818182	0.36363636363636365	GO:0045061	GO:BP	thymic T cell selection	16175	11259		0.4098360655737705	0.41935483870967744	11	16164	4	18	7	16146	16175	0.2564295827528656
M1	cpdb	0	network_modules	255	TRUE	1.1686932346363133e-6	386	22	9	0.4090909090909091	0.023316062176165803	GO:0022407	GO:BP	regulation of cell-cell adhesion	16175	6598		0.4262295081967213	0.43548387096774194	386	15789	9	13	377	15776	16175	0.09314824966598659
M1	cpdb	0	network_modules	255	TRUE	1.6357279096118625e-6	37	22	5	0.22727272727272727	0.13513513513513514	GO:0045058	GO:BP	T cell selection	16175	11256		0.4426229508196721	0.45161290322580644	37	16138	5	17	32	16121	16175	0.1738030349375756
M1	cpdb	0	network_modules	255	TRUE	3.104634308588128e-6	287	22	8	0.36363636363636365	0.027874564459930314	GO:1903037	GO:BP	regulation of leukocyte cell-cell adhesion	16175	22717		0.45901639344262296	0.46774193548387094	287	15888	8	14	279	15874	16175	0.09669302730081551
M1	cpdb	0	network_modules	255	TRUE	5.306712741395362e-6	98	20	6	0.3	0.061224489795918366	REAC:R-HSA-202424	REAC	Downstream TCR signaling	10916	789		0.3157894736842105	0.35	98	10818	6	14	92	10804	10916	0.13218579830706342
M1	cpdb	0	network_modules	255	TRUE	6.571035200514217e-6	195	22	7	0.3181818181818182	0.035897435897435895	GO:0050870	GO:BP	positive regulation of T cell activation	16175	13318		0.47540983606557374	0.4838709677419355	195	15980	7	15	188	15965	16175	0.10351989137775676
M1	cpdb	0	network_modules	255	TRUE	8.048052930960916e-6	324	22	8	0.36363636363636365	0.024691358024691357	GO:0007159	GO:BP	leukocyte cell-cell adhesion	16175	2723		0.4918032786885246	0.5	324	15851	8	14	316	15837	16175	0.09050826525295672
M1	cpdb	0	network_modules	255	TRUE	1.2935797337278171e-5	215	22	7	0.3181818181818182	0.03255813953488372	GO:1903039	GO:BP	positive regulation of leukocyte cell-cell adhesion	16175	22719		0.5081967213114754	0.5161290322580645	215	15960	7	15	208	15945	16175	0.09825080417782064
M1	cpdb	0	network_modules	255	TRUE	2.1369975276894127e-5	745	22	10	0.45454545454545453	0.013422818791946308	GO:0098609	GO:BP	cell-cell adhesion	16175	18805		0.5245901639344263	0.532258064516129	745	15430	10	12	735	15418	16175	0.0719193705865606
M1	cpdb	0	network_modules	255	TRUE	4.429587241396958e-5	257	22	7	0.3181818181818182	0.027237354085603113	GO:0022409	GO:BP	positive regulation of cell-cell adhesion	16175	6600		0.5409836065573771	0.5483870967741935	257	15918	7	15	250	15903	16175	0.08921676201251112
M1	cpdb	0	network_modules	255	TRUE	4.728763860183331e-5	27	20	4	0.2	0.14814814814814814	REAC:R-HSA-164952	REAC	The role of Nef in HIV-1 replication and disease pathogenesis	10916	2504		0.3684210526315789	0.4	27	10889	4	16	23	10873	10916	0.1703705836778622
M1	cpdb	0	network_modules	255	TRUE	5.961488765409162e-5	27	22	4	0.18181818181818182	0.14814814814814814	GO:0038094	GO:BP	Fc-gamma receptor signaling pathway	16175	9694		0.5573770491803278	0.5645161290322581	27	16148	4	18	23	16130	16175	0.1628618972634233
M1	cpdb	0	network_modules	255	TRUE	7.448177130949252e-5	622	22	9	0.4090909090909091	0.014469453376205787	GO:0030155	GO:BP	regulation of cell adhesion	16175	6688		0.5737704918032787	0.5806451612903226	622	15553	9	13	613	15540	16175	0.07113362577173511
M1	cpdb	0	network_modules	255	TRUE	1.0447755032851969e-4	169	22	6	0.2727272727272727	0.03550295857988166	GO:0050670	GO:BP	regulation of lymphocyte proliferation	16175	13204		0.5901639344262295	0.5967741935483871	169	16006	6	16	163	15990	16175	0.09519362755296165
M1	cpdb	0	network_modules	255	TRUE	1.065018588761503e-4	31	22	4	0.18181818181818182	0.12903225806451613	GO:0043368	GO:BP	positive T cell selection	16175	10645		0.6065573770491803	0.6129032258064516	31	16144	4	18	27	16126	16175	0.1518020875138737
M1	cpdb	0	network_modules	255	TRUE	1.120466338330727e-4	171	22	6	0.2727272727272727	0.03508771929824561	GO:0032944	GO:BP	regulation of mononuclear cell proliferation	16175	7929		0.6229508196721312	0.6290322580645161	171	16004	6	16	165	15988	16175	0.0945965981740787
M1	cpdb	0	network_modules	255	TRUE	1.7659599310929251e-4	35	22	4	0.18181818181818182	0.11428571428571428	GO:0050856	GO:BP	regulation of T cell receptor signaling pathway	16175	13304		0.639344262295082	0.6451612903225806	35	16140	4	18	31	16122	16175	0.1426858741080568
M1	cpdb	0	network_modules	255	TRUE	2.0930844509749224e-4	190	22	6	0.2727272727272727	0.031578947368421054	GO:0070663	GO:BP	regulation of leukocyte proliferation	16175	16244		0.6557377049180327	0.6612903225806451	190	15985	6	16	184	15969	16175	0.08939318021212028
M1	cpdb	0	network_modules	255	TRUE	2.482930659434507e-4	38	22	4	0.18181818181818182	0.10526315789473684	GO:0033077	GO:BP	T cell differentiation in thymus	16175	8025		0.6721311475409836	0.6774193548387096	38	16137	4	18	34	16119	16175	0.13680909861740284
M1	cpdb	0	network_modules	255	TRUE	2.9047958422388765e-4	11	20	3	0.15	0.2727272727272727	REAC:R-HSA-389359	REAC	CD28 dependent Vav1 pathway	10916	268		0.42105263157894735	0.45	11	10905	3	17	8	10888	10916	0.2011868721154232
M1	cpdb	0	network_modules	255	TRUE	3.068629509315656e-4	40	22	4	0.18181818181818182	0.1	GO:0031295	GO:BP	T cell costimulation	16175	7117		0.6885245901639344	0.6935483870967742	40	16135	4	18	36	16117	16175	0.13326140333432707
M1	cpdb	0	network_modules	255	TRUE	3.253779344339741e-4	104	22	5	0.22727272727272727	0.04807692307692308	GO:0050671	GO:BP	positive regulation of lymphocyte proliferation	16175	13205		0.7049180327868853	0.7096774193548387	104	16071	5	17	99	16054	16175	0.1019705244800511
M1	cpdb	0	network_modules	255	TRUE	3.4134669179829093e-4	105	22	5	0.22727272727272727	0.047619047619047616	GO:0032946	GO:BP	positive regulation of mononuclear cell proliferation	16175	7931		0.7213114754098361	0.7258064516129032	105	16070	5	17	100	16053	16175	0.10145853567767715
M1	cpdb	0	network_modules	255	TRUE	3.5726344855237783e-4	208	22	6	0.2727272727272727	0.028846153846153848	GO:0046651	GO:BP	lymphocyte proliferation	16175	12287		0.7377049180327869	0.7419354838709677	208	15967	6	16	202	15951	16175	0.08512132525559848
M1	cpdb	0	network_modules	255	TRUE	3.7516133664147993e-4	42	22	4	0.18181818181818182	0.09523809523809523	GO:0031294	GO:BP	lymphocyte costimulation	16175	7116		0.7540983606557377	0.7580645161290323	42	16133	4	18	38	16115	16175	0.12996820711395535
M1	cpdb	0	network_modules	255	TRUE	3.887253570917178e-4	211	22	6	0.2727272727272727	0.02843601895734597	GO:0032943	GO:BP	mononuclear cell proliferation	16175	7928		0.7704918032786885	0.7741935483870968	211	15964	6	16	205	15948	16175	0.08446164715383887
M1	cpdb	0	network_modules	255	TRUE	5.023221767054319e-4	13	20	3	0.15	0.23076923076923078	REAC:R-HSA-1433559	REAC	Regulation of KIT signaling	10916	1982		0.47368421052631576	0.5	13	10903	3	17	10	10886	10916	0.18485438162727327
M1	cpdb	0	network_modules	255	TRUE	5.604615607508168e-4	373	22	7	0.3181818181818182	0.01876675603217158	GO:0045785	GO:BP	positive regulation of cell adhesion	16175	11617		0.7868852459016393	0.7903225806451613	373	15802	7	15	366	15787	16175	0.07256371300664459
M1	cpdb	0	network_modules	255	TRUE	5.951762488648863e-4	47	22	4	0.18181818181818182	0.0851063829787234	GO:0038093	GO:BP	Fc receptor signaling pathway	16175	9693		0.8032786885245902	0.8064516129032258	47	16128	4	18	43	16110	16175	0.12266776192006816
M1	cpdb	0	network_modules	255	TRUE	6.377347380959853e-4	119	22	5	0.22727272727272727	0.04201680672268908	GO:0070665	GO:BP	positive regulation of leukocyte proliferation	16175	16246		0.819672131147541	0.8225806451612904	119	16056	5	17	114	16039	16175	0.09497145633506716
M1	cpdb	0	network_modules	255	TRUE	7.506892511434849e-4	236	22	6	0.2727272727272727	0.025423728813559324	GO:0070661	GO:BP	leukocyte proliferation	16175	16242		0.8360655737704918	0.8387096774193549	236	15939	6	16	230	15923	16175	0.0794497457343211
M1	cpdb	0	network_modules	255	TRUE	7.664228723126352e-4	50	22	4	0.18181818181818182	0.08	GO:0050854	GO:BP	regulation of antigen receptor-mediated signaling pathway	16175	13302		0.8524590163934426	0.8548387096774194	50	16125	4	18	46	16107	16175	0.1188185682514684
M1	cpdb	0	network_modules	255	TRUE	8.146295128616782e-4	125	22	5	0.22727272727272727	0.04	GO:0046631	GO:BP	alpha-beta T cell activation	16175	12268		0.8688524590163934	0.8709677419354839	125	16050	5	17	120	16033	16175	0.09252510114675234
M1	cpdb	0	network_modules	255	TRUE	0.001063844581604754	14	22	3	0.13636363636363635	0.21428571428571427	GO:0046629	GO:BP	gamma-delta T cell activation	16175	12266		0.8852459016393442	0.8870967741935484	14	16161	3	19	11	16142	16175	0.17004509759073805
M1	cpdb	0	network_modules	255	TRUE	0.0011299600984570283	55	22	4	0.18181818181818182	0.07272727272727272	GO:0050853	GO:BP	B cell receptor signaling pathway	16175	13301		0.9016393442622951	0.9032258064516129	55	16120	4	18	51	16102	16175	0.11311065743351187
M1	cpdb	0	network_modules	255	TRUE	0.0017445892058575066	65	20	4	0.2	0.06153846153846154	REAC:R-HSA-2219530	REAC	Constitutive Signaling by Aberrant PI3K in Cancer	10916	401		0.5263157894736842	0.55	65	10851	4	16	61	10835	10916	0.10805798235495745
M1	cpdb	0	network_modules	255	TRUE	0.00198594639828663	20	20	3	0.15	0.15	REAC:R-HSA-389513	REAC	Co-inhibition by CTLA4	10916	376		0.5789473684210527	0.6	20	10896	3	17	17	10879	10916	0.1484397944199706
M1	cpdb	0	network_modules	255	TRUE	0.002314230743942589	21	20	3	0.15	0.14285714285714285	REAC:R-HSA-164938	REAC	Nef-mediates down modulation of cell surface receptors by recruiting them to clathrin adapters	10916	1565		0.631578947368421	0.65	21	10895	3	17	18	10878	10916	0.14477948506952504
M1	cpdb	0	network_modules	255	TRUE	0.0026765051786323546	22	20	3	0.15	0.13636363636363635	REAC:R-HSA-389357	REAC	CD28 dependent PI3K/Akt signaling	10916	267		0.6842105263157895	0.7	22	10894	3	17	19	10877	10916	0.14136975430520027
M1	cpdb	0	network_modules	255	TRUE	0.003946307489659289	101	19	4	0.21052631578947367	0.039603960396039604	KEGG:05142	KEGG	Chagas disease	8484	434		0.7777777777777778	0.8	101	8383	4	15	97	8368	8484	0.08676207585635877
M1	cpdb	0	network_modules	255	TRUE	0.003955770857752258	75	22	4	0.18181818181818182	0.05333333333333334	GO:0030101	GO:BP	natural killer cell activation	16175	6679		0.9180327868852459	0.9193548387096774	75	16100	4	18	71	16082	16175	0.0962506307588126
M1	cpdb	0	network_modules	255	TRUE	0.004539483543550539	510	22	7	0.3181818181818182	0.013725490196078431	GO:0007169	GO:BP	cell surface receptor protein tyrosine kinase signaling pathway	16175	2733		0.9344262295081968	0.9354838709677419	510	15665	7	15	503	15650	16175	0.06053872019024066
M1	cpdb	0	network_modules	255	TRUE	0.004790904566345262	210	19	5	0.2631578947368421	0.023809523809523808	KEGG:05170	KEGG	Human immunodeficiency virus 1 infection	8484	451		0.8888888888888888	0.9	210	8274	5	14	205	8260	8484	0.07269636525555273
M1	cpdb	0	network_modules	255	TRUE	0.005075337126239994	181	20	5	0.25	0.027624309392265192	REAC:R-HSA-198933	REAC	Immunoregulatory interactions between a Lymphoid and a non-Lymphoid cell	10916	1171		0.7368421052631579	0.75	181	10735	5	15	176	10720	10916	0.07831420839101258
M1	cpdb	0	network_modules	255	TRUE	0.005651932666686849	334	22	6	0.2727272727272727	0.017964071856287425	GO:0002250	GO:BP	adaptive immune response	16175	782		0.9508196721311475	0.9516129032258065	334	15841	6	16	328	15825	16175	0.06541836097119946
M1	cpdb	0	network_modules	255	TRUE	0.005721752794323996	218	19	5	0.2631578947368421	0.022935779816513763	KEGG:05166	KEGG	Human T-cell leukemia virus 1 infection	8484	447		1	1	218	8266	5	14	213	8252	8484	0.07110219517341952
M1	cpdb	0	network_modules	255	TRUE	0.0065841094537715285	191	20	5	0.25	0.02617801047120419	REAC:R-HSA-202733	REAC	Cell surface interactions at the vascular wall	10916	327		0.7894736842105263	0.8	191	10725	5	15	186	10710	10916	0.07597273028948087
M1	cpdb	0	network_modules	255	TRUE	0.006974921103044978	92	20	4	0.2	0.043478260869565216	REAC:R-HSA-2219528	REAC	PI3K/AKT Signaling in Cancer	10916	1674		0.8421052631578947	0.9	92	10824	4	16	88	10808	10916	0.08978198753849509
M1	cpdb	0	network_modules	255	TRUE	0.006974921103044978	92	20	4	0.2	0.043478260869565216	REAC:R-HSA-6811558	REAC	PI5P, PP2A and IER3 Regulate PI3K/AKT Signaling	10916	1677		0.8421052631578947	0.9	92	10824	4	16	88	10808	10916	0.08978198753849509
M1	cpdb	0	network_modules	255	TRUE	0.007153384906324254	3	22	2	0.09090909090909091	0.6666666666666666	GO:0071661	GO:BP	regulation of granzyme B production	16175	16838		0.9672131147540983	1	3	16172	2	20	1	16152	16175	0.2458707737811223
M1	cpdb	0	network_modules	255	TRUE	0.007153384906324254	3	22	2	0.09090909090909091	0.6666666666666666	GO:0071663	GO:BP	positive regulation of granzyme B production	16175	16840		0.9672131147540983	1	3	16172	2	20	1	16152	16175	0.2458707737811223
M1	cpdb	0	network_modules	255	TRUE	0.007153384906324254	3	22	2	0.09090909090909091	0.6666666666666666	GO:0071613	GO:BP	granzyme B production	16175	16799		0.9672131147540983	1	3	16172	2	20	1	16152	16175	0.2458707737811223
M1	cpdb	0	network_modules	255	TRUE	0.007730513319576933	31	20	3	0.15	0.0967741935483871	REAC:R-HSA-389356	REAC	Co-stimulation by CD28	10916	378		0.9473684210526315	0.95	31	10885	3	17	28	10868	10916	0.11847864602131258
M1	cpdb	0	network_modules	255	TRUE	0.009319766633021967	99	20	4	0.2	0.04040404040404041	REAC:R-HSA-199418	REAC	Negative regulation of the PI3K/AKT network	10916	1580		1	1	99	10817	4	16	95	10801	10916	0.08628788615561417
M1	cpdb	0	network_modules	256	TRUE	1.4266777853267833e-13	144	21	11	0.5238095238095238	0.0763888888888889	REAC:R-HSA-8856828	REAC	Clathrin-mediated endocytosis	10916	372		0	0.08333333333333333	144	10772	11	10	133	10762	10916	0.19648353160387164
M1	cpdb	0	network_modules	256	TRUE	4.0525697268994845e-13	104	21	10	0.47619047619047616	0.09615384615384616	REAC:R-HSA-8856825	REAC	Cargo recognition for clathrin-mediated endocytosis	10916	309		0.09090909090909091	0.16666666666666666	104	10812	10	11	94	10801	10916	0.2109081693480603
M1	cpdb	0	network_modules	256	TRUE	2.0168146518277517e-12	221	22	11	0.5	0.049773755656108594	GO:0006898	GO:BP	receptor-mediated endocytosis	16175	2552		0	0.06666666666666667	221	15954	11	11	210	15943	16175	0.15460920967836875
M1	cpdb	0	network_modules	256	TRUE	2.3960737911032143e-11	533	22	13	0.5909090909090909	0.024390243902439025	GO:0006897	GO:BP	endocytosis	16175	2551		0.07142857142857142	0.13333333333333333	533	15642	13	9	520	15633	16175	0.11535064355035955
M1	cpdb	0	network_modules	256	TRUE	1.4930053306032143e-10	44	22	7	0.3181818181818182	0.1590909090909091	GO:0072583	GO:BP	clathrin-dependent endocytosis	16175	17454		0.14285714285714285	0.2	44	16131	7	15	37	16116	16175	0.22352109225580302
M1	cpdb	0	network_modules	256	TRUE	1.5919622306826107e-9	740	22	13	0.5909090909090909	0.01756756756756757	GO:0098657	GO:BP	import into cell	16175	18813		0.21428571428571427	0.26666666666666666	740	15435	13	9	727	15426	16175	0.09629049580273519
M1	cpdb	0	network_modules	256	TRUE	1.4141382471300449e-5	121	22	6	0.2727272727272727	0.049586776859504134	GO:0099003	GO:BP	vesicle-mediated transport in synapse	16175	18999		0.2857142857142857	0.3333333333333333	121	16054	6	16	115	16038	16175	0.11360423785027167
M1	cpdb	0	network_modules	256	TRUE	2.2216108079828885e-5	119	21	6	0.2857142857142857	0.05042016806722689	REAC:R-HSA-373760	REAC	L1CAM interactions	10916	1294		0.18181818181818182	0.25	119	10797	6	15	113	10782	10916	0.11619075459831099
M1	cpdb	0	network_modules	256	TRUE	1.645363116300115e-4	8	22	3	0.13636363636363635	0.375	GO:0140239	GO:BP	postsynaptic endocytosis	16175	19710		0.35714285714285715	0.4666666666666667	8	16167	3	19	5	16148	16175	0.2255224840135997
M1	cpdb	0	network_modules	256	TRUE	1.645363116300115e-4	8	22	3	0.13636363636363635	0.375	GO:0098884	GO:BP	postsynaptic neurotransmitter receptor internalization	16175	18929		0.35714285714285715	0.4666666666666667	8	16167	3	19	5	16148	16175	0.2255224840135997
M1	cpdb	0	network_modules	256	TRUE	1.9762822118645282e-4	90	21	5	0.23809523809523808	0.05555555555555555	REAC:R-HSA-2682334	REAC	EPH-Ephrin signaling	10916	818		0.2727272727272727	0.3333333333333333	90	10826	5	16	85	10810	10916	0.1115962671365758
M1	cpdb	0	network_modules	256	TRUE	2.3100494796252959e-4	248	16	6	0.375	0.024193548387096774	KEGG:04144	KEGG	Endocytosis	8484	280		0	0.3333333333333333	248	8236	6	10	242	8226	8484	0.08922193747652923
M1	cpdb	0	network_modules	256	TRUE	5.105165646836895e-4	221	22	6	0.2727272727272727	0.027149321266968326	GO:0030100	GO:BP	regulation of endocytosis	16175	6678		0.5	0.5333333333333333	221	15954	6	16	215	15938	16175	0.08235794954340013
M1	cpdb	0	network_modules	256	TRUE	5.485737953394275e-4	13	21	3	0.14285714285714285	0.23076923076923078	REAC:R-HSA-5140745	REAC	WNT5A-dependent internalization of FZD2, FZD5 and ROR2	10916	2671		0.36363636363636365	0.4166666666666667	13	10903	3	18	10	10885	10916	0.18033549359669784
M1	cpdb	0	network_modules	256	TRUE	5.899671262984014e-4	48	21	4	0.19047619047619047	0.08333333333333333	REAC:R-HSA-437239	REAC	Recycling pathway of L1	10916	1954		0.45454545454545453	0.5	48	10868	4	17	44	10851	10916	0.12346999470348081
M1	cpdb	0	network_modules	256	TRUE	6.416071517546456e-4	49	21	4	0.19047619047619047	0.08163265306122448	REAC:R-HSA-3928665	REAC	EPH-ephrin mediated repulsion of cells	10916	819		0.5454545454545454	0.5833333333333334	49	10867	4	17	45	10850	10916	0.12214905997590525
M1	cpdb	0	network_modules	256	TRUE	7.057378897902688e-4	49	22	4	0.18181818181818182	0.08163265306122448	GO:0140238	GO:BP	presynaptic endocytosis	16175	19709		0.5714285714285714	0.6666666666666666	49	16126	4	18	45	16108	16175	0.1200626742832935
M1	cpdb	0	network_modules	256	TRUE	7.057378897902688e-4	49	22	4	0.18181818181818182	0.08163265306122448	GO:0048488	GO:BP	synaptic vesicle endocytosis	16175	12781		0.5714285714285714	0.6666666666666666	49	16126	4	18	45	16108	16175	0.1200626742832935
M1	cpdb	0	network_modules	256	TRUE	7.721623225093057e-4	507	21	8	0.38095238095238093	0.015779092702169626	REAC:R-HSA-9006934	REAC	Signaling by Receptor Tyrosine Kinases	10916	2302		0.6363636363636364	0.6666666666666666	507	10409	8	13	499	10396	10916	0.06978402568272132
M1	cpdb	0	network_modules	256	TRUE	8.705733528521941e-4	15	21	3	0.14285714285714285	0.2	REAC:R-HSA-5099900	REAC	WNT5A-dependent internalization of FZD4	10916	2672		0.7272727272727273	0.75	15	10901	3	18	12	10883	10916	0.1676814643799777
M1	cpdb	0	network_modules	256	TRUE	0.001063844581604754	14	22	3	0.13636363636363635	0.21428571428571427	GO:0099590	GO:BP	neurotransmitter receptor internalization	16175	19154		0.7142857142857143	0.7333333333333333	14	16161	3	19	11	16142	16175	0.17004509759073805
M1	cpdb	0	network_modules	256	TRUE	0.0011749518642782415	89	16	4	0.25	0.0449438202247191	KEGG:04512	KEGG	ECM-receptor interaction	8484	314		0.5	0.6666666666666666	89	8395	4	12	85	8383	8484	0.1021851805703158
M1	cpdb	0	network_modules	256	TRUE	0.0015025245312678631	59	22	4	0.18181818181818182	0.06779661016949153	GO:0036465	GO:BP	synaptic vesicle recycling	16175	9613		0.7857142857142857	0.8	59	16116	4	18	55	16098	16175	0.10907127394133746
M1	cpdb	0	network_modules	256	TRUE	0.0016338012189123403	16	22	3	0.13636363636363635	0.1875	GO:0048268	GO:BP	clathrin coat assembly	16175	12619		0.8571428571428571	0.8666666666666667	16	16159	3	19	13	16140	16175	0.15892730697675234
M1	cpdb	0	network_modules	256	TRUE	0.002167760443693061	20	21	3	0.14285714285714285	0.15	REAC:R-HSA-445144	REAC	Signal transduction by L1	10916	2216		0.8181818181818182	0.8333333333333334	20	10896	3	18	17	10878	10916	0.14477948506952504
M1	cpdb	0	network_modules	256	TRUE	0.0051351155261784714	23	22	3	0.13636363636363635	0.13043478260869565	GO:0035313	GO:BP	wound healing, spreading of epidermal cells	16175	8963		0.9285714285714286	0.9333333333333333	23	16152	3	19	20	16133	16175	0.13215941380754104
M1	cpdb	0	network_modules	256	TRUE	0.005514040857390643	27	21	3	0.14285714285714285	0.1111111111111111	REAC:R-HSA-3000170	REAC	Syndecan interactions	10916	2367		0.9090909090909091	0.9166666666666666	27	10889	3	18	24	10871	10916	0.12407960141264007
M1	cpdb	0	network_modules	256	TRUE	0.005593042916745453	84	21	4	0.19047619047619047	0.047619047619047616	REAC:R-HSA-216083	REAC	Integrin cell surface interactions	10916	1216		1	1	84	10832	4	17	80	10815	10916	0.09183258080070524
M1	cpdb	0	network_modules	256	TRUE	0.006229500898807303	84	22	4	0.18181818181818182	0.047619047619047616	GO:0048259	GO:BP	regulation of receptor-mediated endocytosis	16175	12611		1	1	84	16091	4	18	80	16073	16175	0.090688037629785
M1	cpdb	0	network_modules	256	TRUE	0.007646405720044567	53	16	3	0.1875	0.05660377358490566	KEGG:04961	KEGG	Endocrine and other factor-regulated calcium reabsorption	8484	397		1	1	53	8431	3	13	50	8418	8484	0.09999489366414151
M1	cpdb	0	network_modules	257	TRUE	1.4801460467269921e-44	18	22	16	0.7272727272727273	0.8888888888888888	GO:0035720	GO:BP	intraciliary anterograde transport	16175	9190		0	0.07142857142857142	18	16157	16	6	2	16151	16175	0.8037938520719466
M1	cpdb	0	network_modules	257	TRUE	1.8965807934241484e-41	45	22	18	0.8181818181818182	0.4	GO:0042073	GO:BP	intraciliary transport	16175	9956		0.07692307692307693	0.14285714285714285	45	16130	18	4	27	16126	16175	0.5713157081823919
M1	cpdb	0	network_modules	257	TRUE	2.0710553257693373e-36	54	19	17	0.8947368421052632	0.3148148148148148	REAC:R-HSA-5620924	REAC	Intraflagellar transport	10916	1267		0	0.3333333333333333	54	10862	17	2	37	10860	10916	0.5295690328570177
M1	cpdb	0	network_modules	257	TRUE	1.5191681538715991e-31	137	22	18	0.8181818181818182	0.13138686131386862	GO:0031503	GO:BP	protein-containing complex localization	16175	7188		0.15384615384615385	0.21428571428571427	137	16038	18	4	119	16034	16175	0.32608002660573915
M1	cpdb	0	network_modules	257	TRUE	3.946224224583148e-31	144	22	18	0.8181818181818182	0.125	GO:0010970	GO:BP	transport along microtubule	16175	4546		0.23076923076923078	0.2857142857142857	144	16031	18	4	126	16027	16175	0.3179551424582847
M1	cpdb	0	network_modules	257	TRUE	5.2700433494735585e-30	165	22	18	0.8181818181818182	0.10909090909090909	GO:0099111	GO:BP	microtubule-based transport	16175	19044		0.3076923076923077	0.35714285714285715	165	16010	18	4	147	16006	16175	0.2967512006315741
M1	cpdb	0	network_modules	257	TRUE	4.5795691872220463e-29	185	22	18	0.8181818181818182	0.0972972972972973	GO:0030705	GO:BP	cytoskeleton-dependent intracellular transport	16175	6886		0.38461538461538464	0.42857142857142855	185	15990	18	4	167	15986	16175	0.27999798408221205
M1	cpdb	0	network_modules	257	TRUE	2.5240911607761643e-26	348	22	19	0.8636363636363636	0.05459770114942529	GO:0007018	GO:BP	microtubule-based movement	16175	2626		0.46153846153846156	0.5	348	15827	19	3	329	15824	16175	0.21419777660767245
M1	cpdb	0	network_modules	257	TRUE	7.475817235441321e-26	368	22	19	0.8636363636363636	0.051630434782608696	GO:0044782	GO:BP	cilium organization	16175	11155		0.5384615384615384	0.5714285714285714	368	15807	19	3	349	15804	16175	0.2081215771226956
M1	cpdb	0	network_modules	257	TRUE	7.838477028919675e-26	200	19	17	0.8947368421052632	0.085	REAC:R-HSA-5617833	REAC	Cilium Assembly	10916	361		0.5	0.6666666666666666	200	10716	17	2	183	10714	10916	0.27287601206700474
M1	cpdb	0	network_modules	257	TRUE	6.00847038773755e-23	292	19	17	0.8947368421052632	0.05821917808219178	REAC:R-HSA-1852241	REAC	Organelle biogenesis and maintenance	10916	1646		1	1	292	10624	17	2	275	10622	10916	0.22462840559511071
M1	cpdb	0	network_modules	257	TRUE	7.722906840673951e-22	343	22	17	0.7727272727272727	0.04956268221574344	GO:0060271	GO:BP	cilium assembly	16175	14488		0.6153846153846154	0.6428571428571429	343	15832	17	5	326	15827	16175	0.19251102785571186
M1	cpdb	0	network_modules	257	TRUE	5.622607839225819e-19	503	22	17	0.7727272727272727	0.033797216699801194	GO:0120031	GO:BP	plasma membrane bounded cell projection assembly	16175	19467		0.6923076923076923	0.7142857142857143	503	15672	17	5	486	15667	16175	0.15767762147453418
M1	cpdb	0	network_modules	257	TRUE	8.143041805242295e-19	514	22	17	0.7727272727272727	0.033073929961089495	GO:0030031	GO:BP	cell projection assembly	16175	6655		0.7692307692307693	0.7857142857142857	514	15661	17	5	497	15656	16175	0.15589297197204824
M1	cpdb	0	network_modules	257	TRUE	1.0292588478150545e-4	7	22	3	0.13636363636363635	0.42857142857142855	GO:0035735	GO:BP	intraciliary transport involved in cilium assembly	16175	9201		0.8461538461538461	0.8571428571428571	7	16168	3	19	4	16149	16175	0.24119592085972666
M1	cpdb	0	network_modules	257	TRUE	0.0018812816291664013	148	22	5	0.22727272727272727	0.033783783783783786	GO:0001822	GO:BP	kidney development	16175	479		0.9230769230769231	0.9285714285714286	148	16027	5	17	143	16010	16175	0.08454211922379777
M1	cpdb	0	network_modules	257	TRUE	0.002216511703493244	153	22	5	0.22727272727272727	0.032679738562091505	GO:0072001	GO:BP	renal system development	16175	17037		1	1	153	16022	5	17	148	16005	16175	0.08304435526957657
M1	cpdb	0	network_modules	258	TRUE	3.657550569889424e-5	83	18	5	0.2777777777777778	0.060240963855421686	GO:0007224	GO:BP	smoothened signaling pathway	16175	2777		0	0.5	83	16092	5	13	78	16079	16175	0.1273666987716181
M1	cpdb	0	network_modules	258	TRUE	1.3230789574116212e-4	56	5	3	0.6	0.05357142857142857	KEGG:04340	KEGG	Hedgehog signaling pathway	8484	302		0	0.5	56	8428	3	2	53	8426	8484	0.17795251337893936
M1	cpdb	0	network_modules	258	TRUE	1.893054568522725e-4	63	5	3	0.6	0.047619047619047616	KEGG:05217	KEGG	Basal cell carcinoma	8484	468		1	1	63	8421	3	2	60	8419	8484	0.1676115788172982
M1	cpdb	0	network_modules	258	TRUE	5.43215452468625e-4	56	18	4	0.2222222222222222	0.07142857142857142	GO:0008589	GO:BP	regulation of smoothened signaling pathway	16175	3199		1	1	56	16119	4	14	52	16105	16175	0.12430975492336149
M1	cpdb	0	network_modules	258	TRUE	6.362301136670386e-4	3	10	2	0.2	0.6666666666666666	REAC:R-HSA-5635851	REAC	GLI proteins bind promoters of Hh responsive genes to promote transcription	10916	1015		NA	1	3	10913	2	8	1	10905	10916	0.36486388967634376
M1	cpdb	0	network_modules	260	TRUE	6.969513497480825e-8	56	9	5	0.5555555555555556	0.08928571428571429	KEGG:00480	KEGG	Glutathione metabolism	8484	61		0	0.1	56	8428	5	4	51	8424	8484	0.22091868352439592
M1	cpdb	0	network_modules	260	TRUE	1.3306862037211455e-7	34	14	5	0.35714285714285715	0.14705882352941177	REAC:R-HSA-156590	REAC	Glutathione conjugation	10916	1058		0	0.3333333333333333	34	10882	5	9	29	10873	10916	0.22767662681933715
M1	cpdb	0	network_modules	260	TRUE	1.7544599585066873e-7	67	9	5	0.5555555555555556	0.07462686567164178	KEGG:05204	KEGG	Chemical carcinogenesis - DNA adducts	8484	456		0.1111111111111111	0.2	67	8417	5	4	62	8413	8484	0.20162561250563282
M1	cpdb	0	network_modules	260	TRUE	1.8929541771782472e-7	68	9	5	0.5555555555555556	0.07352941176470588	KEGG:00982	KEGG	Drug metabolism - cytochrome P450	8484	156		0.2222222222222222	0.3	68	8416	5	4	63	8412	8484	0.20010639335388433
M1	cpdb	0	network_modules	260	TRUE	2.536757546252647e-7	72	9	5	0.5555555555555556	0.06944444444444445	KEGG:01524	KEGG	Platinum drug resistance	8484	198		0.3333333333333333	0.4	72	8412	5	4	67	8408	8484	0.1943471968269035
M1	cpdb	0	network_modules	260	TRUE	2.918313342707318e-7	74	9	5	0.5555555555555556	0.06756756756756757	KEGG:00980	KEGG	Metabolism of xenobiotics by cytochrome P450	8484	154		0.4444444444444444	0.5	74	8410	5	4	69	8406	8484	0.19164307070338668
M1	cpdb	0	network_modules	260	TRUE	3.265609031089727e-7	36	17	5	0.29411764705882354	0.1388888888888889	GO:0006749	GO:BP	glutathione metabolic process	16175	2447		0	0.09090909090909091	36	16139	5	12	31	16127	16175	0.20091278076238275
M1	cpdb	0	network_modules	260	TRUE	4.074894953337563e-7	79	9	5	0.5555555555555556	0.06329113924050633	KEGG:00983	KEGG	Drug metabolism - other enzymes	8484	157		0.5555555555555556	0.6	79	8405	5	4	74	8401	8484	0.18533449746940528
M1	cpdb	0	network_modules	260	TRUE	1.2424475903011651e-6	221	9	6	0.6666666666666666	0.027149321266968326	KEGG:05208	KEGG	Chemical carcinogenesis - reactive oxygen species	8484	460		0.6666666666666666	0.7	221	8263	6	3	215	8260	8484	0.1310647599707522
M1	cpdb	0	network_modules	260	TRUE	1.2688031732769387e-6	3	17	3	0.17647058823529413	1	GO:0018916	GO:BP	nitrobenzene metabolic process	16175	5478		0.1	0.18181818181818182	3	16172	3	14	0	16158	16175	0.4199021537723215
M1	cpdb	0	network_modules	260	TRUE	5.267216548526685e-6	20	17	4	0.23529411764705882	0.2	GO:0042178	GO:BP	xenobiotic catabolic process	16175	10006		0.2	0.2727272727272727	20	16155	4	13	16	16142	16175	0.21603757505308577
M1	cpdb	0	network_modules	260	TRUE	6.735866360109768e-6	144	17	6	0.35294117647058826	0.041666666666666664	GO:0006575	GO:BP	modified amino acid metabolic process	16175	2294		0.3	0.36363636363636365	144	16031	6	11	138	16020	16175	0.11880111106299233
M1	cpdb	0	network_modules	260	TRUE	6.84600144726797e-6	138	9	5	0.5555555555555556	0.036231884057971016	KEGG:05418	KEGG	Fluid shear stress and atherosclerosis	8484	495		0.7777777777777778	0.8	138	8346	5	4	133	8342	8484	0.138929799108931
M1	cpdb	0	network_modules	260	TRUE	1.2671561105371586e-5	5	17	3	0.17647058823529413	0.6	GO:0070458	GO:BP	cellular detoxification of nitrogen compound	16175	16129		0.4	0.5454545454545454	5	16170	3	14	2	16156	16175	0.3250467737153748
M1	cpdb	0	network_modules	260	TRUE	1.2671561105371586e-5	5	17	3	0.17647058823529413	0.6	GO:0051410	GO:BP	detoxification of nitrogen compound	16175	13698		0.4	0.5454545454545454	5	16170	3	14	2	16156	16175	0.3250467737153748
M1	cpdb	0	network_modules	260	TRUE	1.7264468134172004e-5	166	9	5	0.5555555555555556	0.030120481927710843	KEGG:05225	KEGG	Hepatocellular carcinoma	8484	476		0.8888888888888888	0.9	166	8318	5	4	161	8314	8484	0.12610859574459274
M1	cpdb	0	network_modules	260	TRUE	4.507601713503655e-5	215	14	6	0.42857142857142855	0.027906976744186046	REAC:R-HSA-211859	REAC	Biological oxidations	10916	227		0.5	0.6666666666666666	215	10701	6	8	209	10693	10916	0.10544699450619598
M1	cpdb	0	network_modules	260	TRUE	4.61139969829263e-5	106	14	5	0.35714285714285715	0.04716981132075472	REAC:R-HSA-156580	REAC	Phase II - Conjugation of compounds	10916	1738		1	1	106	10810	5	9	101	10801	10916	0.1269635094257013
M1	cpdb	0	network_modules	260	TRUE	5.700116047751169e-5	211	9	5	0.5555555555555556	0.023696682464454975	KEGG:05207	KEGG	Chemical carcinogenesis - receptor activation	8484	459		1	1	211	8273	5	4	206	8269	8484	0.11104942306843252
M1	cpdb	0	network_modules	260	TRUE	8.549763206954346e-4	17	17	3	0.17647058823529413	0.17647058823529413	GO:0042537	GO:BP	benzene-containing compound metabolic process	16175	10229		0.6	0.6363636363636364	17	16158	3	14	14	16144	16175	0.17560414436847888
M1	cpdb	0	network_modules	260	TRUE	0.002421991334807326	389	17	6	0.35294117647058826	0.015424164524421594	GO:0043603	GO:BP	amide metabolic process	16175	10795		0.7	0.7272727272727273	389	15786	6	11	383	15775	16175	0.06963330922453134
M1	cpdb	0	network_modules	260	TRUE	0.0028768435353760946	25	17	3	0.17647058823529413	0.12	GO:0042759	GO:BP	long-chain fatty acid biosynthetic process	16175	10351		0.8	0.8181818181818182	25	16150	3	14	22	16136	16175	0.14443436822943198
M1	cpdb	0	network_modules	260	TRUE	0.007317310453705712	116	17	4	0.23529411764705882	0.034482758620689655	GO:0006805	GO:BP	xenobiotic metabolic process	16175	2487		0.9	0.9090909090909091	116	16059	4	13	112	16046	16175	0.08769098221853983
M1	cpdb	0	network_modules	260	TRUE	0.008197994358362042	4	17	2	0.11764705882352941	0.5	GO:0046416	GO:BP	D-amino acid metabolic process	16175	12133		1	1	4	16171	2	15	2	16156	16175	0.2421830455760906
M1	cpdb	0	network_modules	261	TRUE	3.2832429056757715e-7	58	11	5	0.45454545454545453	0.08620689655172414	KEGG:04923	KEGG	Regulation of lipolysis in adipocytes	8484	380		0	0.5	58	8426	5	6	53	8420	8484	0.19577153893670726
M1	cpdb	0	network_modules	261	TRUE	1.7366083289747e-6	24	11	4	0.36363636363636365	0.16666666666666666	REAC:R-HSA-163560	REAC	Triglyceride catabolism	10916	2606		0	0.5	24	10892	4	7	20	10885	10916	0.24508747344262508
M1	cpdb	0	network_modules	261	TRUE	3.38165648637638e-6	15	20	4	0.2	0.26666666666666666	GO:0010889	GO:BP	regulation of sequestering of triglyceride	16175	4475		0	0.07142857142857142	15	16160	4	16	11	16144	16175	0.2301182595134178
M1	cpdb	0	network_modules	261	TRUE	7.562864898629685e-6	18	20	4	0.2	0.2222222222222222	GO:0030730	GO:BP	sequestering of triglyceride	16175	6909		0.07692307692307693	0.14285714285714285	18	16157	4	16	14	16141	16175	0.20989203706051524
M1	cpdb	0	network_modules	261	TRUE	1.1977082594162264e-5	38	11	4	0.36363636363636365	0.10526315789473684	REAC:R-HSA-8979227	REAC	Triglyceride metabolism	10916	2607		1	1	38	10878	4	7	34	10871	10916	0.19420948691862297
M1	cpdb	0	network_modules	261	TRUE	1.4756966507089364e-5	21	20	4	0.2	0.19047619047619047	GO:0019433	GO:BP	triglyceride catabolic process	16175	5785		0.15384615384615385	0.21428571428571427	21	16154	4	16	17	16138	16175	0.19415907864427537
M1	cpdb	0	network_modules	261	TRUE	8.789581770407138e-5	32	20	4	0.2	0.125	GO:0046464	GO:BP	acylglycerol catabolic process	16175	12172		0.23076923076923078	0.35714285714285715	32	16143	4	16	28	16127	16175	0.15680190792955565
M1	cpdb	0	network_modules	261	TRUE	8.789581770407138e-5	32	20	4	0.2	0.125	GO:0046461	GO:BP	neutral lipid catabolic process	16175	12169		0.23076923076923078	0.35714285714285715	32	16143	4	16	28	16127	16175	0.15680190792955565
M1	cpdb	0	network_modules	261	TRUE	1.0386257309091651e-4	75	11	4	0.36363636363636365	0.05333333333333334	KEGG:03320	KEGG	PPAR signaling pathway	8484	236		1	1	75	8409	4	7	71	8402	8484	0.13656975916581526
M1	cpdb	0	network_modules	261	TRUE	3.897970854867728e-4	11	20	3	0.15	0.2727272727272727	GO:0010896	GO:BP	regulation of triglyceride catabolic process	16175	4482		0.38461538461538464	0.42857142857142855	11	16164	3	17	8	16147	16175	0.20153609715055812
M1	cpdb	0	network_modules	261	TRUE	3.9446742306873116e-4	46	20	4	0.2	0.08695652173913043	GO:0010883	GO:BP	regulation of lipid storage	16175	4469		0.46153846153846156	0.5	46	16129	4	16	42	16113	16175	0.13026669629403015
M1	cpdb	0	network_modules	261	TRUE	9.465702813341494e-4	57	20	4	0.2	0.07017543859649122	GO:0046503	GO:BP	glycerolipid catabolic process	16175	12206		0.5384615384615384	0.5714285714285714	57	16118	4	16	53	16102	16175	0.11666011654823957
M1	cpdb	0	network_modules	261	TRUE	0.002274774027430532	19	20	3	0.15	0.15789473684210525	GO:0090208	GO:BP	positive regulation of triglyceride metabolic process	16175	18108		0.6153846153846154	0.6428571428571429	19	16156	3	17	16	16139	16175	0.15287588680262662
M1	cpdb	0	network_modules	261	TRUE	0.002302651031789135	71	20	4	0.2	0.056338028169014086	GO:0019915	GO:BP	lipid storage	16175	6067		0.6923076923076923	0.7142857142857143	71	16104	4	16	67	16088	16175	0.10411227491687333
M1	cpdb	0	network_modules	261	TRUE	0.003361735675362324	78	20	4	0.2	0.05128205128205128	GO:0006641	GO:BP	triglyceride metabolic process	16175	2352		0.7692307692307693	0.7857142857142857	78	16097	4	16	74	16081	16175	0.09913256082814248
M1	cpdb	0	network_modules	261	TRUE	0.004058777946424487	346	20	6	0.3	0.017341040462427744	GO:0010876	GO:BP	lipid localization	16175	4462		0.8461538461538461	0.8571428571428571	346	15829	6	14	340	15815	16175	0.06775418148930393
M1	cpdb	0	network_modules	261	TRUE	0.004144412674470078	23	20	3	0.15	0.13043478260869565	GO:0050996	GO:BP	positive regulation of lipid catabolic process	16175	13431		0.9230769230769231	0.9285714285714286	23	16152	3	17	20	16135	16175	0.13873415606930908
M1	cpdb	0	network_modules	261	TRUE	0.008725187209678053	99	20	4	0.2	0.04040404040404041	GO:0045834	GO:BP	positive regulation of lipid metabolic process	16175	11650		1	1	99	16076	4	16	95	16060	16175	0.08746433018737845
M1	cpdb	0	network_modules	262	TRUE	2.596465443584217e-34	25	17	14	0.8235294117647058	0.56	REAC:R-HSA-8854691	REAC	Interleukin-20 family signaling	10916	1242		0	0.3333333333333333	25	10891	14	3	11	10888	10916	0.6785165527494063
M1	cpdb	0	network_modules	262	TRUE	4.548065428778668e-22	162	15	14	0.9333333333333333	0.08641975308641975	KEGG:04630	KEGG	JAK-STAT signaling pathway	8484	332		0	0.3333333333333333	162	8322	14	1	148	8321	8484	0.2811372534976179
M1	cpdb	0	network_modules	262	TRUE	4.379612593926696e-16	291	15	13	0.8666666666666667	0.044673539518900345	KEGG:04060	KEGG	Cytokine-cytokine receptor interaction	8484	253		0.5	0.6666666666666666	291	8193	13	2	278	8191	8484	0.19247618617894277
M1	cpdb	0	network_modules	262	TRUE	1.3324731894569499e-14	472	17	14	0.8235294117647058	0.029661016949152543	REAC:R-HSA-449147	REAC	Signaling by Interleukins	10916	2261		0.5	0.6666666666666666	472	10444	14	3	458	10441	10916	0.1515117603093275
M1	cpdb	0	network_modules	262	TRUE	4.2789260397859436e-10	10	19	5	0.2631578947368421	0.5	GO:0038196	GO:BP	type III interferon-mediated signaling pathway	16175	9765		0	0.18181818181818182	10	16165	5	14	5	16151	16175	0.3622106587635051
M1	cpdb	0	network_modules	262	TRUE	4.2789260397859436e-10	10	19	5	0.2631578947368421	0.5	GO:0071358	GO:BP	cellular response to type III interferon	16175	16610		0	0.18181818181818182	10	16165	5	14	5	16151	16175	0.3622106587635051
M1	cpdb	0	network_modules	262	TRUE	7.839036868502383e-10	11	19	5	0.2631578947368421	0.45454545454545453	GO:0034342	GO:BP	response to type III interferon	16175	8580		0.2	0.2727272727272727	11	16164	5	14	6	16150	16175	0.34528366739818006
M1	cpdb	0	network_modules	262	TRUE	8.365088214865348e-9	98	15	7	0.4666666666666667	0.07142857142857142	KEGG:04061	KEGG	Viral protein interaction with cytokine and cytokine receptor	8484	254		1	1	98	8386	7	8	91	8378	8484	0.17925092015831276
M1	cpdb	0	network_modules	262	TRUE	4.784822503581284e-7	419	19	9	0.47368421052631576	0.021479713603818614	GO:0019221	GO:BP	cytokine-mediated signaling pathway	16175	5598		0.3	0.36363636363636365	419	15756	9	10	410	15746	16175	0.09666937223345036
M1	cpdb	0	network_modules	262	TRUE	5.677114285747538e-6	555	19	9	0.47368421052631576	0.016216216216216217	GO:0071345	GO:BP	cellular response to cytokine stimulus	16175	16597		0.4	0.45454545454545453	555	15620	9	10	546	15610	16175	0.08277506655187068
M1	cpdb	0	network_modules	262	TRUE	1.2450946952817683e-5	64	19	5	0.2631578947368421	0.078125	GO:0098586	GO:BP	cellular response to virus	16175	18801		0.5	0.5454545454545454	64	16111	5	14	59	16097	16175	0.14159238321198583
M1	cpdb	0	network_modules	262	TRUE	1.6001393200162566e-5	625	19	9	0.47368421052631576	0.0144	GO:1901652	GO:BP	response to peptide	16175	21619		0.6	0.7272727272727273	625	15550	9	10	616	15540	16175	0.07740739978439452
M1	cpdb	0	network_modules	262	TRUE	1.6001393200162566e-5	625	19	9	0.47368421052631576	0.0144	GO:0034097	GO:BP	response to cytokine	16175	8408		0.6	0.7272727272727273	625	15550	9	10	616	15540	16175	0.07740739978439452
M1	cpdb	0	network_modules	262	TRUE	9.753215398485811e-5	96	19	5	0.2631578947368421	0.052083333333333336	GO:0140888	GO:BP	interferon-mediated signaling pathway	16175	19923		0.8	0.8181818181818182	96	16079	5	14	91	16065	16175	0.11484140874830924
M1	cpdb	0	network_modules	262	TRUE	6.915315463335833e-4	142	19	5	0.2631578947368421	0.035211267605633804	GO:0007259	GO:BP	cell surface receptor signaling pathway via JAK-STAT	16175	2789		0.9	0.9090909090909091	142	16033	5	14	137	16019	16175	0.09351552350334655
M1	cpdb	0	network_modules	262	TRUE	8.781419272798952e-4	149	19	5	0.2631578947368421	0.03355704697986577	GO:0097696	GO:BP	cell surface receptor signaling pathway via STAT	16175	18727		1	1	149	16026	5	14	144	16012	16175	0.091157014716391
M1	cpdb	0	network_modules	262	TRUE	0.002074427015322858	24	17	3	0.17647058823529413	0.125	REAC:R-HSA-449836	REAC	Other interleukin signaling	10916	1651		1	1	24	10892	3	14	21	10878	10916	0.1469476994723703
M1	cpdb	0	network_modules	263	TRUE	0.0073436993999453784	76	9	3	0.3333333333333333	0.039473684210526314	REAC:R-HSA-3000178	REAC	ECM proteoglycans	10916	812		NA	1	76	10840	3	6	73	10834	10916	0.11275150598603523
M1	cpdb	0	network_modules	264	TRUE	1.6397212818871033e-15	7	13	6	0.46153846153846156	0.8571428571428571	REAC:R-HSA-5576894	REAC	Phase 1 - inactivation of fast Na+ channels	10916	1733		0	0.3333333333333333	7	10909	6	7	1	10902	10916	0.628672953785146
M1	cpdb	0	network_modules	264	TRUE	2.1146769386258184e-8	183	19	8	0.42105263157894735	0.04371584699453552	GO:0071805	GO:BP	potassium ion transmembrane transport	16175	16918		0	0.06666666666666667	183	15992	8	11	175	15981	16175	0.13285698840714355
M1	cpdb	0	network_modules	264	TRUE	3.9824599068322533e-8	198	19	8	0.42105263157894735	0.04040404040404041	GO:0006813	GO:BP	potassium ion transport	16175	2493		0.07142857142857142	0.13333333333333333	198	15977	8	11	190	15966	16175	0.12749615244291057
M1	cpdb	0	network_modules	264	TRUE	1.1700623661462163e-7	65	19	6	0.3157894736842105	0.09230769230769231	GO:1901379	GO:BP	regulation of potassium ion transmembrane transport	16175	21429		0.14285714285714285	0.2	65	16110	6	13	59	16097	16175	0.16899946613042774
M1	cpdb	0	network_modules	264	TRUE	2.607915945780778e-7	74	19	6	0.3157894736842105	0.08108108108108109	GO:0043266	GO:BP	regulation of potassium ion transport	16175	10590		0.21428571428571427	0.26666666666666666	74	16101	6	13	68	16088	16175	0.15815092019584975
M1	cpdb	0	network_modules	264	TRUE	3.4716748818764215e-7	203	13	7	0.5384615384615384	0.034482758620689655	REAC:R-HSA-397014	REAC	Muscle contraction	10916	1496		0.5	0.6666666666666666	203	10713	7	6	196	10707	10916	0.1328768092480363
M1	cpdb	0	network_modules	264	TRUE	1.3051347883357702e-6	130	13	6	0.46153846153846156	0.046153846153846156	REAC:R-HSA-5576891	REAC	Cardiac conduction	10916	306		1	1	130	10786	6	7	124	10779	10916	0.14312481990756828
M1	cpdb	0	network_modules	264	TRUE	7.7359744243511e-6	575	19	9	0.47368421052631576	0.01565217391304348	GO:0098662	GO:BP	inorganic cation transmembrane transport	16175	18818		0.2857142857142857	0.3333333333333333	575	15600	9	10	566	15590	16175	0.08114586862224897
M1	cpdb	0	network_modules	264	TRUE	7.9741431967105e-6	577	19	9	0.47368421052631576	0.01559792027729636	GO:0098655	GO:BP	monoatomic cation transmembrane transport	16175	18811		0.35714285714285715	0.4	577	15598	9	10	568	15588	16175	0.08098744341784764
M1	cpdb	0	network_modules	264	TRUE	1.7149634985965418e-5	630	19	9	0.47368421052631576	0.014285714285714285	GO:0098660	GO:BP	inorganic ion transmembrane transport	16175	18816		0.42857142857142855	0.4666666666666667	630	15545	9	10	621	15535	16175	0.07705722245735218
M1	cpdb	0	network_modules	264	TRUE	2.964668733589977e-5	671	19	9	0.47368421052631576	0.013412816691505217	GO:0034220	GO:BP	monoatomic ion transmembrane transport	16175	8508		0.5	0.5333333333333333	671	15504	9	10	662	15494	16175	0.07432864770899009
M1	cpdb	0	network_modules	264	TRUE	3.202421591264842e-5	677	19	9	0.47368421052631576	0.013293943870014771	GO:0030001	GO:BP	metal ion transport	16175	6646		0.5714285714285714	0.6	677	15498	9	10	668	15488	16175	0.07394934111246429
M1	cpdb	0	network_modules	264	TRUE	7.580611818913609e-5	748	19	9	0.47368421052631576	0.012032085561497326	GO:0006812	GO:BP	monoatomic cation transport	16175	2492		0.6428571428571429	0.6666666666666666	748	15427	9	10	739	15417	16175	0.0697971672051952
M1	cpdb	0	network_modules	264	TRUE	2.3706213190736165e-4	229	19	6	0.3157894736842105	0.026200873362445413	GO:1904062	GO:BP	regulation of monoatomic cation transmembrane transport	16175	23501		0.7142857142857143	0.7333333333333333	229	15946	6	13	223	15933	16175	0.08755636144130548
M1	cpdb	0	network_modules	264	TRUE	5.239873698770351e-4	262	19	6	0.3157894736842105	0.022900763358778626	GO:0034765	GO:BP	regulation of monoatomic ion transmembrane transport	16175	8734		0.7857142857142857	0.8	262	15913	6	13	256	15900	16175	0.08138740047592385
M1	cpdb	0	network_modules	264	TRUE	8.40850968759108e-4	284	19	6	0.3157894736842105	0.02112676056338028	GO:0010959	GO:BP	regulation of metal ion transport	16175	4536		0.8571428571428571	0.8666666666666667	284	15891	6	13	278	15878	16175	0.07787049166462424
M1	cpdb	0	network_modules	264	TRUE	0.002443106239156069	341	19	6	0.3157894736842105	0.017595307917888565	GO:0043269	GO:BP	regulation of monoatomic ion transport	16175	10593		0.9285714285714286	0.9333333333333333	341	15834	6	13	335	15821	16175	0.07035143012317967
M1	cpdb	0	network_modules	264	TRUE	0.00303528735592283	354	19	6	0.3157894736842105	0.01694915254237288	GO:0034762	GO:BP	regulation of transmembrane transport	16175	8731		1	1	354	15821	6	13	348	15808	16175	0.06888756646813587
M1	cpdb	0	network_modules	266	TRUE	3.190281991658231e-8	25	16	5	0.3125	0.2	GO:0014059	GO:BP	regulation of dopamine secretion	16175	4629		0	0.05	25	16150	5	11	20	16139	16175	0.24907921360072902
M1	cpdb	0	network_modules	266	TRUE	5.891352757089736e-8	28	16	5	0.3125	0.17857142857142858	GO:0014046	GO:BP	dopamine secretion	16175	4616		0.05263157894736842	0.1	28	16147	5	11	23	16136	16175	0.2352392029948965
M1	cpdb	0	network_modules	266	TRUE	1.2044024433266893e-7	32	16	5	0.3125	0.15625	GO:0017158	GO:BP	regulation of calcium ion-dependent exocytosis	16175	5288		0.10526315789473684	0.15	32	16143	5	11	27	16132	16175	0.2198982618237684
M1	cpdb	0	network_modules	266	TRUE	2.599651556011618e-7	37	16	5	0.3125	0.13513513513513514	GO:0050433	GO:BP	regulation of catecholamine secretion	16175	13187		0.15789473684210525	0.2	37	16138	5	11	32	16127	16175	0.20432929819881998
M1	cpdb	0	network_modules	266	TRUE	3.917623825885772e-7	40	16	5	0.3125	0.125	GO:0050432	GO:BP	catecholamine secretion	16175	13186		0.21052631578947367	0.25	40	16135	5	11	35	16124	16175	0.1964183889658297
M1	cpdb	0	network_modules	266	TRUE	4.459205659305095e-7	41	16	5	0.3125	0.12195121951219512	GO:0015872	GO:BP	dopamine transport	16175	4980		0.2631578947368421	0.3	41	16134	5	11	36	16123	16175	0.1939755792145928
M1	cpdb	0	network_modules	266	TRUE	1.254316280713259e-6	50	16	5	0.3125	0.1	GO:0017156	GO:BP	calcium-ion regulated exocytosis	16175	5286		0.3157894736842105	0.35	50	16125	5	11	45	16114	16175	0.17538597108144552
M1	cpdb	0	network_modules	266	TRUE	1.8679723439533202e-6	54	16	5	0.3125	0.09259259259259259	GO:0051937	GO:BP	catecholamine transport	16175	14007		0.3684210526315789	0.4	54	16121	5	11	49	16110	16175	0.16865126291530805
M1	cpdb	0	network_modules	266	TRUE	2.948690651124168e-6	59	16	5	0.3125	0.0847457627118644	GO:0051952	GO:BP	regulation of amine transport	16175	14022		0.42105263157894735	0.45	59	16116	5	11	54	16105	16175	0.16121052020432936
M1	cpdb	0	network_modules	266	TRUE	4.477989328831186e-6	64	16	5	0.3125	0.078125	GO:0015844	GO:BP	monoamine transport	16175	4954		0.47368421052631576	0.5	64	16111	5	11	59	16100	16175	0.15465426157338966
M1	cpdb	0	network_modules	266	TRUE	6.108343774614105e-6	68	16	5	0.3125	0.07352941176470588	GO:0015837	GO:BP	amine transport	16175	4947		0.5263157894736842	0.55	68	16107	5	11	63	16096	16175	0.14993503258008856
M1	cpdb	0	network_modules	266	TRUE	8.77665522890773e-6	73	16	5	0.3125	0.0684931506849315	GO:0071277	GO:BP	cellular response to calcium ion	16175	16534		0.5789473684210527	0.6	73	16102	5	11	68	16091	16175	0.1445865484774316
M1	cpdb	0	network_modules	266	TRUE	2.1419286637719375e-5	87	16	5	0.3125	0.05747126436781609	GO:1903305	GO:BP	regulation of regulated secretory pathway	16175	22892		0.631578947368421	0.65	87	16088	5	11	82	16077	16175	0.1321284571527126
M1	cpdb	0	network_modules	266	TRUE	7.00261140199362e-5	110	16	5	0.3125	0.045454545454545456	GO:0051592	GO:BP	response to calcium ion	16175	13809		0.6842105263157895	0.7	110	16065	5	11	105	16054	16175	0.11704554632299653
M1	cpdb	0	network_modules	266	TRUE	2.3452455733191793e-4	140	16	5	0.3125	0.03571428571428571	GO:0071248	GO:BP	cellular response to metal ion	16175	16509		0.7368421052631579	0.75	140	16035	5	11	135	16024	16175	0.10321674503051433
M1	cpdb	0	network_modules	266	TRUE	3.09449045852693e-4	148	16	5	0.3125	0.033783783783783786	GO:0017157	GO:BP	regulation of exocytosis	16175	5287		0.7894736842105263	0.8	148	16027	5	11	143	16016	16175	0.1002499521386601
M1	cpdb	0	network_modules	266	TRUE	3.220148668554075e-4	9	4	2	0.5	0.2222222222222222	KEGG:03266	KEGG	Virion - Herpesvirus	8484	232		NA	1	9	8475	2	2	7	8473	8484	0.3328811704756827
M1	cpdb	0	network_modules	266	TRUE	4.7055180607513886e-4	161	16	5	0.3125	0.031055900621118012	GO:0045055	GO:BP	regulated exocytosis	16175	11253		0.8421052631578947	0.85	161	16014	5	11	156	16003	16175	0.0959016619789956
M1	cpdb	0	network_modules	266	TRUE	0.0018800952519759887	213	16	5	0.3125	0.023474178403755867	GO:0010038	GO:BP	response to metal ion	16175	3847		0.8947368421052632	0.9	213	15962	5	11	208	15951	16175	0.08262587106544214
M1	cpdb	0	network_modules	266	TRUE	0.0021076462613114056	218	16	5	0.3125	0.022935779816513763	GO:0015850	GO:BP	organic hydroxy compound transport	16175	4959		0.9473684210526315	0.95	218	15957	5	11	213	15946	16175	0.08160126849174575
M1	cpdb	0	network_modules	266	TRUE	0.005291373842911343	263	16	5	0.3125	0.019011406844106463	GO:0006887	GO:BP	exocytosis	16175	2543		1	1	263	15912	5	11	258	15901	16175	0.07370568358571686
M1	cpdb	0	network_modules	266	TRUE	0.008104074220396579	56	12	3	0.25	0.05357142857142857	REAC:R-HSA-6794361	REAC	Neurexins and neuroligins	10916	1587		NA	1	56	10860	3	9	53	10851	10916	0.1137071394993144
M1	cpdb	0	network_modules	267	TRUE	2.3076783747451852e-4	192	12	5	0.4166666666666667	0.026041666666666668	KEGG:05202	KEGG	Transcriptional misregulation in cancer	8484	454		NA	1	192	8292	5	7	187	8285	8484	0.09971345511338325
M1	cpdb	0	network_modules	268	TRUE	8.081041594928929e-4	107	11	4	0.36363636363636365	0.037383177570093455	REAC:R-HSA-8957275	REAC	Post-translational protein phosphorylation	10916	1777		0	0.5	107	10809	4	7	103	10802	10916	0.11406758368697001
M1	cpdb	0	network_modules	268	TRUE	0.0011148721588836801	2	15	2	0.13333333333333333	1	GO:0016256	GO:BP	N-glycan processing to lysosome	16175	5187		NA	1	2	16173	2	13	0	16160	16175	0.36500158742720296
M1	cpdb	0	network_modules	268	TRUE	0.0014561764225585131	124	11	4	0.36363636363636365	0.03225806451612903	REAC:R-HSA-381426	REAC	Regulation of Insulin-like Growth Factor (IGF) transport and uptake by Insulin-like Growth Factor Binding Proteins (IGFBPs)	10916	1981		1	1	124	10792	4	7	120	10785	10916	0.10557701499550448
M1	cpdb	0	network_modules	269	TRUE	2.763711037884475e-13	44	20	8	0.4	0.18181818181818182	GO:0016339	GO:BP	calcium-dependent cell-cell adhesion via plasma membrane cell adhesion molecules	16175	5214		0	0.1	44	16131	8	12	36	16119	16175	0.2683769753569458
M1	cpdb	0	network_modules	269	TRUE	3.359048692145635e-13	45	20	8	0.4	0.17777777777777778	GO:0034332	GO:BP	adherens junction organization	16175	8574		0.1111111111111111	0.2	45	16130	8	12	37	16118	16175	0.2653451830588171
M1	cpdb	0	network_modules	269	TRUE	4.0635293166964503e-13	46	20	8	0.4	0.17391304347826086	GO:0044331	GO:BP	cell-cell adhesion mediated by cadherin	16175	10957		0.2222222222222222	0.3	46	16129	8	12	38	16117	16175	0.26241243555749444
M1	cpdb	0	network_modules	269	TRUE	9.765829906948215e-13	55	16	8	0.5	0.14545454545454545	REAC:R-HSA-418990	REAC	Adherens junctions interactions	10916	121		0	0.25	55	10861	8	8	47	10853	10916	0.2678338463877958
M1	cpdb	0	network_modules	269	TRUE	4.589587398264344e-11	87	16	8	0.5	0.09195402298850575	REAC:R-HSA-421270	REAC	Cell-cell junction organization	10916	329		0.3333333333333333	0.5	87	10829	8	8	79	10821	10916	0.2120059704461693
M1	cpdb	0	network_modules	269	TRUE	5.817750312663433e-11	143	20	9	0.45	0.06293706293706294	GO:0007043	GO:BP	cell-cell junction assembly	16175	2647		0.3333333333333333	0.4	143	16032	9	11	134	16021	16175	0.16582090154645246
M1	cpdb	0	network_modules	269	TRUE	4.246609483200624e-10	114	16	8	0.5	0.07017543859649122	REAC:R-HSA-446728	REAC	Cell junction organization	10916	324		0.6666666666666666	0.75	114	10802	8	8	106	10794	10916	0.18450522934942357
M1	cpdb	0	network_modules	269	TRUE	4.524418507938547e-10	179	20	9	0.45	0.05027932960893855	GO:0045216	GO:BP	cell-cell junction organization	16175	11328		0.4444444444444444	0.5	179	15996	9	11	170	15985	16175	0.1476292317830119
M1	cpdb	0	network_modules	269	TRUE	3.9616592053447025e-9	150	16	8	0.5	0.05333333333333334	REAC:R-HSA-1500931	REAC	Cell-Cell communication	10916	328		1	1	150	10766	8	8	142	10758	10916	0.16003126539086304
M1	cpdb	0	network_modules	269	TRUE	8.47999537629265e-9	533	20	11	0.55	0.020637898686679174	GO:0034330	GO:BP	cell junction organization	16175	8572		0.5555555555555556	0.6	533	15642	11	9	522	15633	16175	0.10191235808599318
M1	cpdb	0	network_modules	269	TRUE	5.822588278079155e-8	193	20	8	0.4	0.04145077720207254	GO:0098742	GO:BP	cell-cell adhesion via plasma-membrane adhesion molecules	16175	18867		0.6666666666666666	0.7	193	15982	8	12	185	15970	16175	0.12575331073272614
M1	cpdb	0	network_modules	269	TRUE	7.32840021760883e-8	651	20	11	0.55	0.016897081413210446	GO:0000902	GO:BP	cell morphogenesis	16175	240		0.7777777777777778	0.8	651	15524	11	9	640	15515	16175	0.09125843852946336
M1	cpdb	0	network_modules	269	TRUE	1.697352208002116e-7	346	20	9	0.45	0.02601156069364162	GO:0034329	GO:BP	cell junction assembly	16175	8571		0.8888888888888888	0.9	346	15829	9	11	337	15818	16175	0.10423228707865789
M1	cpdb	0	network_modules	269	TRUE	1.3897195920767756e-4	745	20	9	0.45	0.012080536912751677	GO:0098609	GO:BP	cell-cell adhesion	16175	18805		1	1	745	15430	9	11	736	15419	16175	0.06780518892185447
M1	cpdb	0	network_modules	270	TRUE	3.446005355080658e-6	36	9	4	0.4444444444444444	0.1111111111111111	REAC:R-HSA-390522	REAC	Striated Muscle Contraction	10916	2356		0	0.5	36	10880	4	5	32	10875	10916	0.2210290197552615
M1	cpdb	0	network_modules	270	TRUE	3.8965720089637187e-4	144	17	5	0.29411764705882354	0.034722222222222224	GO:0006941	GO:BP	striated muscle contraction	16175	2579		0	0.16666666666666666	144	16031	5	12	139	16019	16175	0.09848855983316737
M1	cpdb	0	network_modules	270	TRUE	4.181443356172001e-4	193	7	4	0.5714285714285714	0.02072538860103627	KEGG:04814	KEGG	Motor proteins	8484	366		0	0.2	193	8291	4	3	189	8288	8484	0.10574637817526407
M1	cpdb	0	network_modules	270	TRUE	0.0017180840247532476	87	7	3	0.42857142857142855	0.034482758620689655	KEGG:04260	KEGG	Cardiac muscle contraction	8484	296		0.25	0.4	87	8397	3	4	84	8393	8484	0.1193197198114901
M1	cpdb	0	network_modules	270	TRUE	0.002381377134528591	97	7	3	0.42857142857142855	0.030927835051546393	KEGG:05410	KEGG	Hypertrophic cardiomyopathy	8484	489		0.5	0.6	97	8387	3	4	94	8383	8484	0.11275071443411114
M1	cpdb	0	network_modules	270	TRUE	0.002768277736780933	102	7	3	0.42857142857142855	0.029411764705882353	KEGG:05414	KEGG	Dilated cardiomyopathy	8484	491		0.75	0.8	102	8382	3	4	99	8378	8484	0.10982989274011107
M1	cpdb	0	network_modules	270	TRUE	0.0037778707869986594	203	9	4	0.4444444444444444	0.019704433497536946	REAC:R-HSA-397014	REAC	Muscle contraction	10916	1496		1	1	203	10713	4	5	199	10708	10916	0.0905488736388339
M1	cpdb	0	network_modules	270	TRUE	0.006140149913639657	111	17	4	0.23529411764705882	0.036036036036036036	GO:0060048	GO:BP	cardiac muscle contraction	16175	14311		0.2	0.3333333333333333	111	16064	4	13	107	16051	16175	0.0897517523020989
M1	cpdb	0	network_modules	270	TRUE	0.006913167149696444	258	17	5	0.29411764705882354	0.01937984496124031	GO:0006936	GO:BP	muscle contraction	16175	2575		0.4	0.5	258	15917	5	12	253	15905	16175	0.0720178678192392
M1	cpdb	0	network_modules	270	TRUE	0.007317310453705712	116	17	4	0.23529411764705882	0.034482758620689655	GO:0006937	GO:BP	regulation of muscle contraction	16175	2576		0.6	0.6666666666666666	116	16059	4	13	112	16046	16175	0.08769098221853983
M1	cpdb	0	network_modules	270	TRUE	0.008133490203624773	35	17	3	0.17647058823529413	0.08571428571428572	GO:0055010	GO:BP	ventricular cardiac muscle tissue morphogenesis	16175	14199		0.8	0.8333333333333334	35	16140	3	14	32	16126	16175	0.1216755670934157
M1	cpdb	0	network_modules	270	TRUE	0.008867136394876922	36	17	3	0.17647058823529413	0.08333333333333333	GO:0003009	GO:BP	skeletal muscle contraction	16175	1460		1	1	36	16139	3	14	33	16125	16175	0.11993488985794258
M1	cpdb	0	network_modules	270	TRUE	0.009266053425802822	153	7	3	0.42857142857142855	0.0196078431372549	KEGG:04261	KEGG	Adrenergic signaling in cardiomyocytes	8484	297		1	1	153	8331	3	4	150	8327	8484	0.08865171063950138
M1	cpdb	0	network_modules	271	TRUE	1.3197067489088401e-12	92	11	8	0.7272727272727273	0.08695652173913043	KEGG:04657	KEGG	IL-17 signaling pathway	8484	335		0	0.3333333333333333	92	8392	8	3	84	8389	8484	0.24924403603063183
M1	cpdb	0	network_modules	271	TRUE	8.184119831702937e-10	4	16	4	0.25	1	GO:0097400	GO:BP	interleukin-17-mediated signaling pathway	16175	18647		0	0.42857142857142855	4	16171	4	12	0	16159	16175	0.4998144482865347
M1	cpdb	0	network_modules	271	TRUE	8.184119831702937e-10	4	16	4	0.25	1	GO:0097398	GO:BP	cellular response to interleukin-17	16175	18645		0	0.42857142857142855	4	16171	4	12	0	16159	16175	0.4998144482865347
M1	cpdb	0	network_modules	271	TRUE	8.184119831702937e-10	4	16	4	0.25	1	GO:0097396	GO:BP	response to interleukin-17	16175	18643		0	0.42857142857142855	4	16171	4	12	0	16159	16175	0.4998144482865347
M1	cpdb	0	network_modules	271	TRUE	8.131248135569794e-9	71	11	6	0.5454545454545454	0.08450704225352113	REAC:R-HSA-448424	REAC	Interleukin-17 signaling	10916	1238		0	0.5	71	10845	6	5	65	10840	10916	0.2129373404181591
M1	cpdb	0	network_modules	271	TRUE	1.5394830138323774e-8	291	11	8	0.7272727272727273	0.027491408934707903	KEGG:04060	KEGG	Cytokine-cytokine receptor interaction	8484	253		0.5	0.6666666666666666	291	8193	8	3	283	8190	8484	0.13719132758452368
M1	cpdb	0	network_modules	271	TRUE	4.069962792305868e-6	4	16	3	0.1875	0.75	GO:2000338	GO:BP	regulation of chemokine (C-X-C motif) ligand 1 production	16175	25657		0.5	0.8571428571428571	4	16171	3	13	1	16158	16175	0.3747371121111108
M1	cpdb	0	network_modules	271	TRUE	4.069962792305868e-6	4	16	3	0.1875	0.75	GO:0072566	GO:BP	chemokine (C-X-C motif) ligand 1 production	16175	17444		0.5	0.8571428571428571	4	16171	3	13	1	16158	16175	0.3747371121111108
M1	cpdb	0	network_modules	271	TRUE	4.069962792305868e-6	4	16	3	0.1875	0.75	GO:2000340	GO:BP	positive regulation of chemokine (C-X-C motif) ligand 1 production	16175	25659		0.5	0.8571428571428571	4	16171	3	13	1	16158	16175	0.3747371121111108
M1	cpdb	0	network_modules	271	TRUE	2.03252834613607e-5	6	16	3	0.1875	0.5	GO:0038173	GO:BP	interleukin-17A-mediated signaling pathway	16175	9749		1	1	6	16169	3	13	3	16156	16175	0.3057884404350395
M1	cpdb	0	network_modules	271	TRUE	2.2708770262952383e-5	472	11	7	0.6363636363636364	0.014830508474576272	REAC:R-HSA-449147	REAC	Signaling by Interleukins	10916	2261		1	1	472	10444	7	4	465	10440	10916	0.0926164991544566
M1	cpdb	0	network_modules	271	TRUE	0.003443989024760321	62	11	3	0.2727272727272727	0.04838709677419355	KEGG:05321	KEGG	Inflammatory bowel disease	8484	483		1	1	62	8422	3	8	59	8414	8484	0.1122813427185093
M1	cpdb	0	network_modules	273	TRUE	1.1376903051232427e-6	57	14	5	0.35714285714285715	0.08771929824561403	GO:0001912	GO:BP	positive regulation of leukocyte mediated cytotoxicity	16175	529		0	0.03333333333333333	57	16118	5	9	52	16109	16175	0.17563726182835673
M1	cpdb	0	network_modules	273	TRUE	1.9045074624405343e-6	63	14	5	0.35714285714285715	0.07936507936507936	GO:0031343	GO:BP	positive regulation of cell killing	16175	7134		0.034482758620689655	0.06666666666666667	63	16112	5	9	58	16103	16175	0.16692018226498273
M1	cpdb	0	network_modules	273	TRUE	5.6804036849243595e-6	78	14	5	0.35714285714285715	0.0641025641025641	GO:0001910	GO:BP	regulation of leukocyte mediated cytotoxicity	16175	527		0.06896551724137931	0.1	78	16097	5	9	73	16088	16175	0.14968988553014193
M1	cpdb	0	network_modules	273	TRUE	1.2437572662986313e-5	91	14	5	0.35714285714285715	0.054945054945054944	GO:0031341	GO:BP	regulation of cell killing	16175	7132		0.10344827586206896	0.13333333333333333	91	16084	5	9	86	16075	16175	0.13832563173401907
M1	cpdb	0	network_modules	273	TRUE	1.3146254458917115e-5	92	14	5	0.35714285714285715	0.05434782608695652	GO:0002708	GO:BP	positive regulation of lymphocyte mediated immunity	16175	1226		0.13793103448275862	0.16666666666666666	92	16083	5	9	87	16074	16175	0.137551888336392
M1	cpdb	0	network_modules	273	TRUE	2.6914869773588574e-5	106	14	5	0.35714285714285715	0.04716981132075472	GO:0001909	GO:BP	leukocyte mediated cytotoxicity	16175	526		0.1724137931034483	0.2	106	16069	5	9	101	16060	16175	0.12788681790141848
M1	cpdb	0	network_modules	273	TRUE	3.244514718300553e-5	110	14	5	0.35714285714285715	0.045454545454545456	GO:0002705	GO:BP	positive regulation of leukocyte mediated immunity	16175	1223		0.20689655172413793	0.23333333333333334	110	16065	5	9	105	16056	16175	0.12546713628351666
M1	cpdb	0	network_modules	273	TRUE	7.140839601670586e-5	124	7	4	0.5714285714285714	0.03225806451612903	KEGG:04650	KEGG	Natural killer cell mediated cytotoxicity	8484	334		NA	1	124	8360	4	3	120	8357	8484	0.133328758777287
M1	cpdb	0	network_modules	273	TRUE	9.426645644115668e-5	136	14	5	0.35714285714285715	0.03676470588235294	GO:0002706	GO:BP	regulation of lymphocyte mediated immunity	16175	1224		0.2413793103448276	0.26666666666666666	136	16039	5	9	131	16030	16175	0.11241167176696068
M1	cpdb	0	network_modules	273	TRUE	1.9935940654397757e-4	59	14	4	0.2857142857142857	0.06779661016949153	GO:0042267	GO:BP	natural killer cell mediated cytotoxicity	16175	10065		0.27586206896551724	0.3	59	16116	4	10	55	16106	16175	0.13771186053785367
M1	cpdb	0	network_modules	273	TRUE	2.134935145501994e-4	60	14	4	0.2857142857142857	0.06666666666666667	GO:0002228	GO:BP	natural killer cell mediated immunity	16175	761		0.3103448275862069	0.3333333333333333	60	16115	4	10	56	16105	16175	0.13653374450080233
M1	cpdb	0	network_modules	273	TRUE	2.395351351615083e-4	14	14	3	0.21428571428571427	0.21428571428571427	GO:0002484	GO:BP	antigen processing and presentation of endogenous peptide antigen via MHC class I via ER pathway	16175	1007		0.3448275862068966	0.4	14	16161	3	11	11	16150	16175	0.21360506333589682
M1	cpdb	0	network_modules	273	TRUE	2.395351351615083e-4	14	14	3	0.21428571428571427	0.21428571428571427	GO:0002486	GO:BP	antigen processing and presentation of endogenous peptide antigen via MHC class I via ER pathway, TAP-independent	16175	1009		0.3448275862068966	0.4	14	16161	3	11	11	16150	16175	0.21360506333589682
M1	cpdb	0	network_modules	273	TRUE	2.565930774692965e-4	91	10	4	0.4	0.04395604395604396	REAC:R-HSA-163125	REAC	Post-translational modification: synthesis of GPI-anchored proteins	10916	1775		NA	1	91	10825	4	6	87	10819	10916	0.13043956972694914
M1	cpdb	0	network_modules	273	TRUE	2.7097594315349623e-4	168	14	5	0.35714285714285715	0.02976190476190476	GO:0001906	GO:BP	cell killing	16175	524		0.41379310344827586	0.43333333333333335	168	16007	5	9	163	15998	16175	0.1006674661449051
M1	cpdb	0	network_modules	273	TRUE	2.992661472144097e-4	15	14	3	0.21428571428571427	0.2	GO:0002428	GO:BP	antigen processing and presentation of peptide antigen via MHC class Ib	16175	951		0.4482758620689655	0.5	15	16160	3	11	12	16149	16175	0.20630870032228973
M1	cpdb	0	network_modules	273	TRUE	2.992661472144097e-4	15	14	3	0.21428571428571427	0.2	GO:0002476	GO:BP	antigen processing and presentation of endogenous peptide antigen via MHC class Ib	16175	999		0.4482758620689655	0.5	15	16160	3	11	12	16149	16175	0.20630870032228973
M1	cpdb	0	network_modules	273	TRUE	3.513686745808724e-4	177	14	5	0.35714285714285715	0.02824858757062147	GO:0002703	GO:BP	regulation of leukocyte mediated immunity	16175	1221		0.5172413793103449	0.5333333333333333	177	15998	5	9	172	15989	16175	0.09794490099467448
M1	cpdb	0	network_modules	273	TRUE	5.263901829525189e-4	192	14	5	0.35714285714285715	0.026041666666666668	GO:0002699	GO:BP	positive regulation of immune effector process	16175	1217		0.5517241379310345	0.5666666666666667	192	15983	5	9	187	15974	16175	0.09383322708544661
M1	cpdb	0	network_modules	273	TRUE	7.478986833986569e-4	20	14	3	0.21428571428571427	0.15	GO:0002475	GO:BP	antigen processing and presentation via MHC class Ib	16175	998		0.5862068965517241	0.6333333333333333	20	16155	3	11	17	16144	16175	0.17843732284698927
M1	cpdb	0	network_modules	273	TRUE	7.478986833986569e-4	20	14	3	0.21428571428571427	0.15	GO:0019885	GO:BP	antigen processing and presentation of endogenous peptide antigen via MHC class I	16175	6063		0.5862068965517241	0.6333333333333333	20	16155	3	11	17	16144	16175	0.17843732284698927
M1	cpdb	0	network_modules	273	TRUE	0.0010092884492147647	22	14	3	0.21428571428571427	0.13636363636363635	GO:0002483	GO:BP	antigen processing and presentation of endogenous peptide antigen	16175	1006		0.6551724137931034	0.6666666666666666	22	16153	3	11	19	16142	16175	0.17004509759073805
M1	cpdb	0	network_modules	273	TRUE	0.0019121064006808203	27	14	3	0.21428571428571427	0.1111111111111111	GO:0002717	GO:BP	positive regulation of natural killer cell mediated immunity	16175	1235		0.6896551724137931	0.7	27	16148	3	11	24	16137	16175	0.15329565532848902
M1	cpdb	0	network_modules	273	TRUE	0.002140466269098076	28	14	3	0.21428571428571427	0.10714285714285714	GO:0019883	GO:BP	antigen processing and presentation of endogenous antigen	16175	6061		0.7241379310344828	0.7333333333333333	28	16147	3	11	25	16136	16175	0.15049423360121347
M1	cpdb	0	network_modules	273	TRUE	0.002782739694109481	269	14	5	0.35714285714285715	0.01858736059479554	GO:0002449	GO:BP	lymphocyte mediated immunity	16175	972		0.7586206896551724	0.7666666666666667	269	15906	5	9	264	15897	16175	0.07837008339609194
M1	cpdb	0	network_modules	273	TRUE	0.00315678674231531	276	14	5	0.35714285714285715	0.018115942028985508	GO:0002697	GO:BP	regulation of immune effector process	16175	1215		0.7931034482758621	0.8	276	15899	5	9	271	15890	16175	0.0772885543600313
M1	cpdb	0	network_modules	273	TRUE	0.003555742953386264	33	14	3	0.21428571428571427	0.09090909090909091	GO:0002474	GO:BP	antigen processing and presentation of peptide antigen via MHC class I	16175	997		0.8275862068965517	0.8333333333333334	33	16142	3	11	30	16131	16175	0.13844494424757176
M1	cpdb	0	network_modules	273	TRUE	0.0038978567232688917	34	14	3	0.21428571428571427	0.08823529411764706	GO:0001916	GO:BP	positive regulation of T cell mediated cytotoxicity	16175	533		0.8620689655172413	0.8666666666666667	34	16141	3	11	31	16130	16175	0.13635828904223973
M1	cpdb	0	network_modules	273	TRUE	0.006415948967409174	40	14	3	0.21428571428571427	0.075	GO:0002715	GO:BP	regulation of natural killer cell mediated immunity	16175	1233		0.896551724137931	0.9	40	16135	3	11	37	16124	16175	0.12551968344240563
M1	cpdb	0	network_modules	273	TRUE	0.007447360449651994	42	14	3	0.21428571428571427	0.07142857142857142	GO:0001914	GO:BP	regulation of T cell mediated cytotoxicity	16175	531		0.9310344827586207	0.9333333333333333	42	16133	3	11	39	16122	16175	0.12243074899806905
M1	cpdb	0	network_modules	273	TRUE	0.008023550331795257	334	14	5	0.35714285714285715	0.014970059880239521	GO:0002443	GO:BP	leukocyte mediated immunity	16175	966		0.9655172413793104	0.9666666666666667	334	15841	5	9	329	15832	16175	0.06964446532042617
M1	cpdb	0	network_modules	273	TRUE	0.009191315010336237	45	14	3	0.21428571428571427	0.06666666666666667	GO:0001913	GO:BP	T cell mediated cytotoxicity	16175	530		1	1	45	16130	3	11	42	16119	16175	0.118186699336023
M1	cpdb	0	network_modules	274	TRUE	1.5242050471419373e-6	14	18	4	0.2222222222222222	0.2857142857142857	GO:2001034	GO:BP	positive regulation of double-strand break repair via nonhomologous end joining	16175	26280		0	0.027777777777777776	14	16161	4	14	10	16147	16175	0.25124342000409594
M1	cpdb	0	network_modules	274	TRUE	3.616457480744536e-6	17	18	4	0.2222222222222222	0.23529411764705882	GO:0045830	GO:BP	positive regulation of isotype switching	16175	11648		0.02857142857142857	0.05555555555555555	17	16158	4	14	13	16144	16175	0.2278297982764335
M1	cpdb	0	network_modules	274	TRUE	9.0691499766316e-6	21	18	4	0.2222222222222222	0.19047619047619047	GO:0045191	GO:BP	regulation of isotype switching	16175	11319		0.05714285714285714	0.08333333333333333	21	16154	4	14	17	16140	16175	0.20478268740351066
M1	cpdb	0	network_modules	274	TRUE	1.3399511487058091e-5	23	18	4	0.2222222222222222	0.17391304347826086	GO:0002714	GO:BP	positive regulation of B cell mediated immunity	16175	1232		0.08571428571428572	0.1388888888888889	23	16152	4	14	19	16138	16175	0.1955792236812224
M1	cpdb	0	network_modules	274	TRUE	1.3399511487058091e-5	23	18	4	0.2222222222222222	0.17391304347826086	GO:0002891	GO:BP	positive regulation of immunoglobulin mediated immune response	16175	1401		0.08571428571428572	0.1388888888888889	23	16152	4	14	19	16138	16175	0.1955792236812224
M1	cpdb	0	network_modules	274	TRUE	1.6068272436947536e-5	24	18	4	0.2222222222222222	0.16666666666666666	GO:2001032	GO:BP	regulation of double-strand break repair via nonhomologous end joining	16175	26278		0.14285714285714285	0.16666666666666666	24	16151	4	14	20	16137	16175	0.19141362170433107
M1	cpdb	0	network_modules	274	TRUE	6.149297035093716e-5	33	18	4	0.2222222222222222	0.12121212121212122	GO:0045190	GO:BP	isotype switching	16175	11318		0.17142857142857143	0.25	33	16142	4	14	29	16128	16175	0.16287199751623763
M1	cpdb	0	network_modules	274	TRUE	6.149297035093716e-5	33	18	4	0.2222222222222222	0.12121212121212122	GO:0002208	GO:BP	somatic diversification of immunoglobulins involved in immune response	16175	746		0.17142857142857143	0.25	33	16142	4	14	29	16128	16175	0.16287199751623763
M1	cpdb	0	network_modules	274	TRUE	6.149297035093716e-5	33	18	4	0.2222222222222222	0.12121212121212122	GO:0002204	GO:BP	somatic recombination of immunoglobulin genes involved in immune response	16175	742		0.17142857142857143	0.25	33	16142	4	14	29	16128	16175	0.16287199751623763
M1	cpdb	0	network_modules	274	TRUE	7.857552522406033e-5	35	18	4	0.2222222222222222	0.11428571428571428	GO:0002381	GO:BP	immunoglobulin production involved in immunoglobulin-mediated immune response	16175	908		0.2571428571428571	0.2777777777777778	35	16140	4	14	31	16126	16175	0.1580710439740319
M1	cpdb	0	network_modules	274	TRUE	9.897497037185883e-5	37	18	4	0.2222222222222222	0.10810810810810811	GO:0002889	GO:BP	regulation of immunoglobulin mediated immune response	16175	1399		0.2857142857142857	0.3055555555555556	37	16138	4	14	33	16124	16175	0.15366264308356842
M1	cpdb	0	network_modules	274	TRUE	1.1054241299375433e-4	38	18	4	0.2222222222222222	0.10526315789473684	GO:0002639	GO:BP	positive regulation of immunoglobulin production	16175	1160		0.3142857142857143	0.3611111111111111	38	16137	4	14	34	16123	16175	0.15158936062305448
M1	cpdb	0	network_modules	274	TRUE	1.1054241299375433e-4	38	18	4	0.2222222222222222	0.10526315789473684	GO:0002712	GO:BP	regulation of B cell mediated immunity	16175	1230		0.3142857142857143	0.3611111111111111	38	16137	4	14	34	16123	16175	0.15158936062305448
M1	cpdb	0	network_modules	274	TRUE	1.2309045492211234e-4	39	18	4	0.2222222222222222	0.10256410256410256	GO:0016447	GO:BP	somatic recombination of immunoglobulin gene segments	16175	5226		0.37142857142857144	0.3888888888888889	39	16136	4	14	35	16122	16175	0.14959584833251832
M1	cpdb	0	network_modules	274	TRUE	2.0245126493902672e-4	44	18	4	0.2222222222222222	0.09090909090909091	GO:0002562	GO:BP	somatic diversification of immune receptors via germline recombination within a single locus	16175	1083		0.4	0.4444444444444444	44	16131	4	14	40	16117	16175	0.14066356745926445
M1	cpdb	0	network_modules	274	TRUE	2.0245126493902672e-4	44	18	4	0.2222222222222222	0.09090909090909091	GO:0016444	GO:BP	somatic cell DNA recombination	16175	5223		0.4	0.4444444444444444	44	16131	4	14	40	16117	16175	0.14066356745926445
M1	cpdb	0	network_modules	274	TRUE	2.2204857217069754e-4	45	18	4	0.2222222222222222	0.08888888888888889	GO:0002637	GO:BP	regulation of immunoglobulin production	16175	1158		0.45714285714285713	0.4722222222222222	45	16130	4	14	41	16116	16175	0.13905699256470916
M1	cpdb	0	network_modules	274	TRUE	2.6545051651232014e-4	47	18	4	0.2222222222222222	0.0851063829787234	GO:0016445	GO:BP	somatic diversification of immunoglobulins	16175	5224		0.4857142857142857	0.5	47	16128	4	14	43	16114	16175	0.1359979326383652
M1	cpdb	0	network_modules	274	TRUE	4.01509935589984e-4	52	18	4	0.2222222222222222	0.07692307692307693	GO:0002200	GO:BP	somatic diversification of immune receptors	16175	738		0.5142857142857142	0.5277777777777778	52	16123	4	14	48	16109	16175	0.12913213731521145
M1	cpdb	0	network_modules	274	TRUE	4.6837897693966944e-4	54	18	4	0.2222222222222222	0.07407407407407407	GO:0002312	GO:BP	B cell activation involved in immune response	16175	844		0.5428571428571428	0.5555555555555556	54	16121	4	14	50	16107	16175	0.12665455259829936
M1	cpdb	0	network_modules	274	TRUE	5.838077475141273e-4	57	18	4	0.2222222222222222	0.07017543859649122	GO:0050871	GO:BP	positive regulation of B cell activation	16175	13319		0.5714285714285714	0.6111111111111112	57	16118	4	14	53	16104	16175	0.12318349291091629
M1	cpdb	0	network_modules	274	TRUE	5.838077475141273e-4	57	18	4	0.2222222222222222	0.07017543859649122	GO:0045911	GO:BP	positive regulation of DNA recombination	16175	11705		0.5714285714285714	0.6111111111111112	57	16118	4	14	53	16104	16175	0.12318349291091629
M1	cpdb	0	network_modules	274	TRUE	8.216161556195216e-4	62	18	4	0.2222222222222222	0.06451612903225806	GO:0006303	GO:BP	double-strand break repair via nonhomologous end joining	16175	2110		0.6285714285714286	0.6388888888888888	62	16113	4	14	58	16099	16175	0.11796337299537553
M1	cpdb	0	network_modules	274	TRUE	0.0014221543852677076	71	18	4	0.2222222222222222	0.056338028169014086	GO:0002377	GO:BP	immunoglobulin production	16175	907		0.6571428571428571	0.6666666666666666	71	16104	4	14	67	16090	16175	0.10998343082722997
M1	cpdb	0	network_modules	274	TRUE	0.0025122880252617915	22	18	3	0.16666666666666666	0.13636363636363635	GO:2000042	GO:BP	negative regulation of double-strand break repair via homologous recombination	16175	25403		0.6857142857142857	0.6944444444444444	22	16153	3	15	19	16138	16175	0.14971050876290892
M1	cpdb	0	network_modules	274	TRUE	0.0027987915700981767	84	18	4	0.2222222222222222	0.047619047619047616	GO:2000781	GO:BP	positive regulation of double-strand break repair	16175	26037		0.7142857142857143	0.7222222222222222	84	16091	4	14	80	16077	16175	0.1007828960739263
M1	cpdb	0	network_modules	274	TRUE	0.0035293721121839967	89	18	4	0.2222222222222222	0.0449438202247191	GO:0002824	GO:BP	positive regulation of adaptive immune response based on somatic recombination of immune receptors built from immunoglobulin superfamily domains	16175	1334		0.7428571428571429	0.75	89	16086	4	14	85	16072	16175	0.09778673443368215
M1	cpdb	0	network_modules	274	TRUE	0.003857986511573289	91	18	4	0.2222222222222222	0.04395604395604396	GO:0050864	GO:BP	regulation of B cell activation	16175	13312		0.7714285714285715	0.7777777777777778	91	16084	4	14	87	16070	16175	0.09665701896786216
M1	cpdb	0	network_modules	274	TRUE	0.004030550610001014	92	18	4	0.2222222222222222	0.043478260869565216	GO:0002708	GO:BP	positive regulation of lymphocyte mediated immunity	16175	1226		0.8	0.8055555555555556	92	16083	4	14	88	16069	16175	0.09610582267766261
M1	cpdb	0	network_modules	274	TRUE	0.004582689092251573	95	18	4	0.2222222222222222	0.042105263157894736	GO:0002702	GO:BP	positive regulation of production of molecular mediator of immune response	16175	1220		0.8285714285714286	0.8333333333333334	95	16080	4	14	91	16066	16175	0.094503995104565
M1	cpdb	0	network_modules	274	TRUE	0.004778617748471889	96	18	4	0.2222222222222222	0.041666666666666664	GO:0002821	GO:BP	positive regulation of adaptive immune response	16175	1331		0.8571428571428571	0.8611111111111112	96	16079	4	14	92	16065	16175	0.09398655639090372
M1	cpdb	0	network_modules	274	TRUE	0.0059320058446771335	29	18	3	0.16666666666666666	0.10344827586206896	GO:0043247	GO:BP	telomere maintenance in response to DNA damage	16175	10583		0.8857142857142857	0.8888888888888888	29	16146	3	15	26	16131	16175	0.13008292443451058
M1	cpdb	0	network_modules	274	TRUE	0.0063291396843234505	103	18	4	0.2222222222222222	0.038834951456310676	GO:0002520	GO:BP	immune system development	16175	1042		0.9142857142857143	0.9166666666666666	103	16072	4	14	99	16058	16175	0.09057481419911778
M1	cpdb	0	network_modules	274	TRUE	0.00822434956937094	110	18	4	0.2222222222222222	0.03636363636363636	GO:0002705	GO:BP	positive regulation of leukocyte mediated immunity	16175	1223		0.9428571428571428	0.9444444444444444	110	16065	4	14	106	16051	16175	0.08748885385618589
M1	cpdb	0	network_modules	274	TRUE	0.00915339351934804	113	18	4	0.2222222222222222	0.035398230088495575	GO:0000018	GO:BP	regulation of DNA recombination	16175	6		0.9714285714285714	0.9722222222222222	113	16062	4	14	109	16048	16175	0.08625342053093527
M1	cpdb	0	network_modules	274	TRUE	0.009680847687859267	34	18	3	0.16666666666666666	0.08823529411764706	GO:2000780	GO:BP	negative regulation of double-strand break repair	16175	26036		1	1	34	16141	3	15	31	16126	16175	0.11993117043636657
M1	cpdb	0	network_modules	275	TRUE	6.874687582539725e-15	108	18	10	0.5555555555555556	0.09259259259259259	GO:0061640	GO:BP	cytoskeleton-dependent cytokinesis	16175	15599		0	0.3333333333333333	108	16067	10	8	98	16059	16175	0.22495579817622338
M1	cpdb	0	network_modules	275	TRUE	9.839312768118476e-13	175	18	10	0.5555555555555556	0.05714285714285714	GO:0000910	GO:BP	cytokinesis	16175	243		0.5	0.6666666666666666	175	16000	10	8	165	15992	16175	0.17575494467542438
M1	cpdb	0	network_modules	275	TRUE	6.551854054333483e-11	265	18	10	0.5555555555555556	0.03773584905660377	GO:0051301	GO:BP	cell division	16175	13632		1	1	265	15910	10	8	255	15902	16175	0.14176521566758285
M1	cpdb	0	network_modules	275	TRUE	5.740298072086818e-9	77	10	6	0.6	0.07792207792207792	KEGG:05100	KEGG	Bacterial invasion of epithelial cells	8484	423		0	0.5	77	8407	6	4	71	8403	8484	0.21405345424264527
M1	cpdb	0	network_modules	275	TRUE	2.7017474956171454e-4	246	10	5	0.5	0.02032520325203252	KEGG:05131	KEGG	Shigellosis	8484	428		1	1	246	8238	5	5	241	8233	8484	0.09642792076672879
M1	cpdb	0	network_modules	276	TRUE	5.820451742440614e-7	13	16	4	0.25	0.3076923076923077	GO:0006474	GO:BP	N-terminal protein amino acid acetylation	16175	2211		0	0.25	13	16162	4	12	9	16150	16175	0.2767065159575745
M1	cpdb	0	network_modules	276	TRUE	1.0224573530433693e-5	25	16	4	0.25	0.16	GO:0031365	GO:BP	N-terminal protein amino acid modification	16175	7143		0.3333333333333333	0.5	25	16150	4	12	21	16138	16175	0.19901576184562753
M1	cpdb	0	network_modules	276	TRUE	1.8339837639447153e-4	50	16	4	0.25	0.08	GO:0006473	GO:BP	protein acetylation	16175	2210		0.6666666666666666	0.75	50	16125	4	12	46	16113	16175	0.1399583334636824
M1	cpdb	0	network_modules	276	TRUE	0.0014349361205705073	83	16	4	0.25	0.04819277108433735	GO:0043543	GO:BP	protein acylation	16175	10760		1	1	83	16092	4	12	79	16080	16175	0.1078415505642068
M1	cpdb	0	network_modules	277	TRUE	2.967108920065073e-6	83	11	5	0.45454545454545453	0.060240963855421686	REAC:R-HSA-1483255	REAC	PI Metabolism	10916	1665		0	0.16666666666666666	83	10833	5	6	78	10827	10916	0.16341229278741934
M1	cpdb	0	network_modules	277	TRUE	4.361207303889695e-5	52	11	4	0.36363636363636365	0.07692307692307693	REAC:R-HSA-1660499	REAC	Synthesis of PIPs at the plasma membrane	10916	2395		0.2	0.3333333333333333	52	10864	4	7	48	10857	10916	0.1655354155377982
M1	cpdb	0	network_modules	277	TRUE	3.126007508868102e-4	210	11	5	0.45454545454545453	0.023809523809523808	REAC:R-HSA-1483257	REAC	Phospholipid metabolism	10916	1748		0.4	0.5	210	10706	5	6	205	10700	10916	0.10065145460942972
M1	cpdb	0	network_modules	277	TRUE	3.68749823220425e-4	88	11	4	0.36363636363636365	0.045454545454545456	REAC:R-HSA-8876198	REAC	RAB GEFs exchange GTP for GDP on RABs	10916	1834		0.6	0.6666666666666666	88	10828	4	7	84	10821	10916	0.12628813584891097
M1	cpdb	0	network_modules	277	TRUE	0.0010131745359318542	73	7	3	0.42857142857142855	0.0410958904109589	KEGG:00562	KEGG	Inositol phosphate metabolism	8484	86		0	0.5	73	8411	3	4	70	8407	8484	0.13066476876458163
M1	cpdb	0	network_modules	277	TRUE	0.0012777196819737618	120	11	4	0.36363636363636365	0.03333333333333333	REAC:R-HSA-9007101	REAC	Rab regulation of trafficking	10916	1939		0.8	0.8333333333333334	120	10796	4	7	116	10789	10916	0.10741393887565012
M1	cpdb	0	network_modules	277	TRUE	0.002381377134528591	97	7	3	0.42857142857142855	0.030927835051546393	KEGG:04070	KEGG	Phosphatidylinositol signaling system	8484	259		1	1	97	8387	3	4	94	8383	8484	0.11275071443411114
M1	cpdb	0	network_modules	277	TRUE	0.002726919122012445	5	11	2	0.18181818181818182	0.4	REAC:R-HSA-1483248	REAC	Synthesis of PIPs at the ER membrane	10916	2391		1	1	5	10911	2	9	3	10902	10916	0.2691978540546046
M1	cpdb	0	network_modules	279	TRUE	4.698908537214749e-16	265	20	13	0.65	0.04905660377358491	GO:0002429	GO:BP	immune response-activating cell surface receptor signaling pathway	16175	952		0	0.037037037037037035	265	15910	13	7	252	15903	16175	0.17562016841076453
M1	cpdb	0	network_modules	279	TRUE	1.344220540537763e-15	287	20	13	0.65	0.04529616724738676	GO:0002768	GO:BP	immune response-regulating cell surface receptor signaling pathway	16175	1279		0.038461538461538464	0.07407407407407407	287	15888	13	7	274	15881	16175	0.16850919044721496
M1	cpdb	0	network_modules	279	TRUE	2.210836338250979e-15	416	20	14	0.7	0.03365384615384615	GO:0002757	GO:BP	immune response-activating signaling pathway	16175	1268		0.07692307692307693	0.1111111111111111	416	15759	14	6	402	15753	16175	0.14987732294542075
M1	cpdb	0	network_modules	279	TRUE	4.419957404643282e-15	437	20	14	0.7	0.032036613272311214	GO:0002764	GO:BP	immune response-regulating signaling pathway	16175	1275		0.11538461538461539	0.14814814814814814	437	15738	14	6	423	15732	16175	0.14604759502717593
M1	cpdb	0	network_modules	279	TRUE	7.326969820112332e-15	55	20	9	0.45	0.16363636363636364	GO:0050853	GO:BP	B cell receptor signaling pathway	16175	13301		0.15384615384615385	0.18518518518518517	55	16120	9	11	46	16109	16175	0.2699357218990265
M1	cpdb	0	network_modules	279	TRUE	1.2438021027866306e-14	158	20	11	0.55	0.06962025316455696	GO:0050851	GO:BP	antigen receptor-mediated signaling pathway	16175	13299		0.19230769230769232	0.2222222222222222	158	16017	11	9	147	16008	16175	0.19327107000423996
M1	cpdb	0	network_modules	279	TRUE	1.4252925901788704e-14	475	20	14	0.7	0.029473684210526315	GO:0002253	GO:BP	activation of immune response	16175	785		0.23076923076923078	0.25925925925925924	475	15700	14	6	461	15694	16175	0.13976374992165908
M1	cpdb	0	network_modules	279	TRUE	6.900156454113549e-13	627	20	14	0.7	0.022328548644338118	GO:0050778	GO:BP	positive regulation of immune response	16175	13252		0.2692307692307692	0.2962962962962963	627	15548	14	6	613	15542	16175	0.12052900526626917
M1	cpdb	0	network_modules	279	TRUE	1.5047052722698874e-12	83	19	9	0.47368421052631576	0.10843373493975904	REAC:R-HSA-2871809	REAC	FCERI mediated Ca+2 mobilization	10916	894		0	0.047619047619047616	83	10833	9	10	74	10823	10916	0.22404463415003537
M1	cpdb	0	network_modules	279	TRUE	9.27106939529769e-12	756	20	14	0.7	0.018518518518518517	GO:0050776	GO:BP	regulation of immune response	16175	13250		0.3076923076923077	0.3333333333333333	756	15419	14	6	742	15413	16175	0.10889393005242748
M1	cpdb	0	network_modules	279	TRUE	3.062018648146789e-11	124	17	9	0.5294117647058824	0.07258064516129033	KEGG:04650	KEGG	Natural killer cell mediated cytotoxicity	8484	334		0	0.06666666666666667	124	8360	9	8	115	8352	8484	0.19221246035125836
M1	cpdb	0	network_modules	279	TRUE	3.3478999698008884e-11	182	19	10	0.5263157894736842	0.054945054945054944	REAC:R-HSA-2454202	REAC	Fc epsilon receptor (FCERI) signaling	10916	938		0.05	0.09523809523809523	182	10734	10	9	172	10725	10916	0.16620207414532093
M1	cpdb	0	network_modules	279	TRUE	6.730015151376766e-11	81	17	8	0.47058823529411764	0.09876543209876543	KEGG:04662	KEGG	B cell receptor signaling pathway	8484	339		0.07142857142857142	0.13333333333333333	81	8403	8	9	73	8394	8484	0.21244184210191475
M1	cpdb	0	network_modules	279	TRUE	2.2864131894977684e-10	23	20	6	0.3	0.2608695652173913	GO:0038095	GO:BP	Fc-epsilon receptor signaling pathway	16175	9695		0.34615384615384615	0.37037037037037035	23	16152	6	14	17	16138	16175	0.278796049822835
M1	cpdb	0	network_modules	279	TRUE	6.395616907785283e-10	25	19	6	0.3157894736842105	0.24	REAC:R-HSA-2424491	REAC	DAP12 signaling	10916	433		0.1	0.14285714285714285	25	10891	6	13	19	10878	10916	0.2738542500019207
M1	cpdb	0	network_modules	279	TRUE	1.5534115323783042e-9	67	17	7	0.4117647058823529	0.1044776119402985	KEGG:04664	KEGG	Fc epsilon RI signaling pathway	8484	340		0.14285714285714285	0.2	67	8417	7	10	60	8407	8484	0.20444814215484924
M1	cpdb	0	network_modules	279	TRUE	5.802045927420617e-9	35	19	6	0.3157894736842105	0.17142857142857143	REAC:R-HSA-2172127	REAC	DAP12 interactions	10916	432		0.15	0.19047619047619047	35	10881	6	13	29	10868	10916	0.2308787791495822
M1	cpdb	0	network_modules	279	TRUE	2.3890236062300716e-8	47	20	6	0.3	0.1276595744680851	GO:0038093	GO:BP	Fc receptor signaling pathway	16175	9693		0.38461538461538464	0.4074074074074074	47	16128	6	14	41	16114	16175	0.1942052257486599
M1	cpdb	0	network_modules	279	TRUE	9.479083432402598e-8	119	17	7	0.4117647058823529	0.058823529411764705	KEGG:04660	KEGG	T cell receptor signaling pathway	8484	338		0.21428571428571427	0.26666666666666666	119	8365	7	10	112	8355	8484	0.15154838199962536
M1	cpdb	0	network_modules	279	TRUE	1.2519668172100968e-7	205	17	8	0.47058823529411764	0.03902439024390244	KEGG:05205	KEGG	Proteoglycans in cancer	8484	457		0.2857142857142857	0.3333333333333333	205	8279	8	9	197	8270	8484	0.13026959950452907
M1	cpdb	0	network_modules	279	TRUE	9.021523869338925e-7	35	19	5	0.2631578947368421	0.14285714285714285	REAC:R-HSA-114604	REAC	GPVI-mediated activation cascade	10916	1021		0.2	0.23809523809523808	35	10881	5	14	30	10867	10916	0.1920042784755707
M1	cpdb	0	network_modules	279	TRUE	1.2844231965593547e-6	83	19	6	0.3157894736842105	0.07228915662650602	REAC:R-HSA-2871796	REAC	FCERI mediated MAPK activation	10916	895		0.25	0.2857142857142857	83	10833	6	13	77	10820	10916	0.1481447543653585
M1	cpdb	0	network_modules	279	TRUE	1.3818058271881113e-6	84	19	6	0.3157894736842105	0.07142857142857142	REAC:R-HSA-983695	REAC	Antigen activates B Cell Receptor (BCR) leading to generation of second messengers	10916	152		0.3	0.3333333333333333	84	10832	6	13	78	10819	10916	0.14722332215216039
M1	cpdb	0	network_modules	279	TRUE	3.462741612095304e-6	114	17	6	0.35294117647058826	0.05263157894736842	KEGG:04670	KEGG	Leukocyte transendothelial migration	8484	343		0.35714285714285715	0.4	114	8370	6	11	108	8359	8484	0.13212659194418072
M1	cpdb	0	network_modules	279	TRUE	5.644952976873306e-6	114	20	6	0.3	0.05263157894736842	GO:0050852	GO:BP	T cell receptor signaling pathway	16175	13300		0.4230769230769231	0.4444444444444444	114	16061	6	14	108	16047	16175	0.12321502937156874
M1	cpdb	0	network_modules	279	TRUE	1.3532000798979721e-5	569	20	9	0.45	0.015817223198594025	GO:0046649	GO:BP	lymphocyte activation	16175	12286		0.46153846153846156	0.48148148148148145	569	15606	9	11	560	15595	16175	0.07922567009571324
M1	cpdb	0	network_modules	279	TRUE	1.8103258105250513e-5	23	19	4	0.21052631578947367	0.17391304347826086	REAC:R-HSA-9006335	REAC	Signaling by Erythropoietin	10916	2238		0.35	0.38095238095238093	23	10893	4	15	19	10878	10916	0.1897960415212133
M1	cpdb	0	network_modules	279	TRUE	3.0108015217344397e-5	140	19	6	0.3157894736842105	0.04285714285714286	REAC:R-HSA-2029480	REAC	Fcgamma receptor (FCGR) dependent phagocytosis	10916	939		0.4	0.42857142857142855	140	10776	6	13	134	10763	10916	0.11243083754128472
M1	cpdb	0	network_modules	279	TRUE	3.5721745542971e-5	27	19	4	0.21052631578947367	0.14814814814814814	REAC:R-HSA-5218920	REAC	VEGFR2 mediated vascular permeability	10916	2636		0.45	0.47619047619047616	27	10889	4	15	23	10874	10916	0.17489794544861367
M1	cpdb	0	network_modules	279	TRUE	5.680958392176938e-5	96	17	5	0.29411764705882354	0.052083333333333336	KEGG:04666	KEGG	Fc gamma R-mediated phagocytosis	8484	341		0.42857142857142855	0.4666666666666667	96	8388	5	12	91	8376	8484	0.11980593769760338
M1	cpdb	0	network_modules	279	TRUE	7.191497172100851e-5	190	17	6	0.35294117647058826	0.031578947368421054	KEGG:04062	KEGG	Chemokine signaling pathway	8484	255		0.5	0.5333333333333333	190	8294	6	11	184	8283	8484	0.10009987509759861
M1	cpdb	0	network_modules	279	TRUE	7.438327363721434e-5	163	19	6	0.3157894736842105	0.03680981595092025	REAC:R-HSA-983705	REAC	Signaling by the B Cell Receptor (BCR)	10916	2328		0.5	0.5238095238095238	163	10753	6	13	157	10740	10916	0.10358305813113723
M1	cpdb	0	network_modules	279	TRUE	8.037294857877827e-5	699	20	9	0.45	0.012875536480686695	GO:0045321	GO:BP	leukocyte activation	16175	11356		0.5	0.5185185185185185	699	15476	9	11	690	15465	16175	0.07038870270027224
M1	cpdb	0	network_modules	279	TRUE	8.464308903186514e-5	179	20	6	0.3	0.0335195530726257	GO:0007596	GO:BP	blood coagulation	16175	3055		0.5384615384615384	0.5555555555555556	179	15996	6	14	173	15982	16175	0.09717880414632996
M1	cpdb	0	network_modules	279	TRUE	9.653691184833487e-5	183	20	6	0.3	0.03278688524590164	GO:0050817	GO:BP	coagulation	16175	13279		0.5769230769230769	0.5925925925925926	183	15992	6	14	177	15978	16175	0.09604062131509196
M1	cpdb	0	network_modules	279	TRUE	1.0298183615382632e-4	185	20	6	0.3	0.032432432432432434	GO:0007599	GO:BP	hemostasis	16175	3058		0.6153846153846154	0.6296296296296297	185	15990	6	14	179	15976	16175	0.09548513076729083
M1	cpdb	0	network_modules	279	TRUE	1.0564020782475484e-4	35	19	4	0.21052631578947367	0.11428571428571428	REAC:R-HSA-202433	REAC	Generation of second messenger molecules	10916	1044		0.55	0.5714285714285714	35	10881	4	15	31	10866	10916	0.1531297778015592
M1	cpdb	0	network_modules	279	TRUE	1.431857989984313e-4	94	19	5	0.2631578947368421	0.05319148936170213	REAC:R-HSA-4420097	REAC	VEGFA-VEGFR2 Pathway	10916	2634		0.6	0.6190476190476191	94	10822	5	14	89	10808	10916	0.11503674919672074
M1	cpdb	0	network_modules	279	TRUE	1.4956084874726626e-4	197	20	6	0.3	0.030456852791878174	GO:0042113	GO:BP	B cell activation	16175	9971		0.6538461538461539	0.6666666666666666	197	15978	6	14	191	15964	16175	0.09232802086154407
M1	cpdb	0	network_modules	279	TRUE	2.3732451643327927e-4	104	19	5	0.2631578947368421	0.04807692307692308	REAC:R-HSA-194138	REAC	Signaling by VEGF	10916	2313		0.65	0.6666666666666666	104	10812	5	14	99	10798	10916	0.10902316985353157
M1	cpdb	0	network_modules	279	TRUE	2.754431785266267e-4	132	17	5	0.29411764705882354	0.03787878787878788	KEGG:04380	KEGG	Osteoclast differentiation	8484	309		0.5714285714285714	0.6	132	8352	5	12	127	8340	8484	0.100854492037262
M1	cpdb	0	network_modules	279	TRUE	3.134736693018641e-4	507	19	8	0.42105263157894735	0.015779092702169626	REAC:R-HSA-9006934	REAC	Signaling by Receptor Tyrosine Kinases	10916	2302		0.7	0.7142857142857143	507	10409	8	11	499	10398	10916	0.07432831903422295
M1	cpdb	0	network_modules	279	TRUE	3.1899152381197255e-4	136	17	5	0.29411764705882354	0.03676470588235294	KEGG:05135	KEGG	Yersinia infection	8484	432		0.6428571428571429	0.6666666666666666	136	8348	5	12	131	8336	8484	0.09921585774446039
M1	cpdb	0	network_modules	279	TRUE	3.484961785969585e-4	115	20	5	0.25	0.043478260869565216	GO:0030168	GO:BP	platelet activation	16175	6695		0.6923076923076923	0.7037037037037037	115	16060	5	15	110	16045	16175	0.10171715861921422
M1	cpdb	0	network_modules	279	TRUE	3.7976672754086514e-4	215	19	6	0.3157894736842105	0.027906976744186046	REAC:R-HSA-9658195	REAC	Leishmania infection	10916	1310		0.75	0.8095238095238095	215	10701	6	13	209	10688	10916	0.08897837734338891
M1	cpdb	0	network_modules	279	TRUE	3.7976672754086514e-4	215	19	6	0.3157894736842105	0.027906976744186046	REAC:R-HSA-9824443	REAC	Parasitic Infection Pathways	10916	1717		0.75	0.8095238095238095	215	10701	6	13	209	10688	10916	0.08897837734338891
M1	cpdb	0	network_modules	279	TRUE	5.961191306441686e-4	249	20	6	0.3	0.024096385542168676	GO:0050878	GO:BP	regulation of body fluid levels	16175	13323		0.7307692307692307	0.7407407407407407	249	15926	6	14	243	15912	16175	0.08133858910792344
M1	cpdb	0	network_modules	279	TRUE	0.001983724585444591	198	17	5	0.29411764705882354	0.025252525252525252	KEGG:05169	KEGG	Epstein-Barr virus infection	8484	450		0.7142857142857143	0.7333333333333333	198	8286	5	12	193	8274	8484	0.08036579065455218
M1	cpdb	0	network_modules	279	TRUE	0.002223818131626729	74	19	4	0.21052631578947367	0.05405405405405406	REAC:R-HSA-9013408	REAC	RHOG GTPase cycle	10916	1868		0.85	0.8571428571428571	74	10842	4	15	70	10827	10916	0.10368313053710122
M1	cpdb	0	network_modules	279	TRUE	0.002372174264565043	510	20	7	0.35	0.013725490196078431	GO:0007169	GO:BP	cell surface receptor protein tyrosine kinase signaling pathway	16175	2733		0.7692307692307693	0.7777777777777778	510	15665	7	13	503	15652	16175	0.0641244800278472
M1	cpdb	0	network_modules	279	TRUE	0.0024668142038995512	23	19	3	0.15789473684210525	0.13043478260869565	REAC:R-HSA-9748787	REAC	Azathioprine ADME	10916	197		0.9	0.9047619047619048	23	10893	3	16	20	10877	10916	0.14186734905480192
M1	cpdb	0	network_modules	279	TRUE	0.0025435433231281997	102	17	4	0.23529411764705882	0.0392156862745098	KEGG:04064	KEGG	NF-kappa B signaling pathway	8484	256		0.7857142857142857	0.8	102	8382	4	13	98	8369	8484	0.09179514051447409
M1	cpdb	0	network_modules	279	TRUE	0.0026320397719901533	210	17	5	0.29411764705882354	0.023809523809523808	KEGG:04015	KEGG	Rap1 signaling pathway	8484	248		0.8571428571428571	0.8666666666666667	210	8274	5	12	205	8262	8484	0.07768450037171827
M1	cpdb	0	network_modules	279	TRUE	0.002881234960137462	214	17	5	0.29411764705882354	0.02336448598130841	KEGG:05417	KEGG	Lipid and atherosclerosis	8484	494		0.9285714285714286	0.9333333333333333	214	8270	5	12	209	8258	8484	0.07683893202019539
M1	cpdb	0	network_modules	279	TRUE	0.00303656708068837	80	19	4	0.21052631578947367	0.05	REAC:R-HSA-416482	REAC	G alpha (12/13) signalling events	10916	986		0.95	0.9523809523809523	80	10836	4	15	76	10821	10916	0.0994777573062636
M1	cpdb	0	network_modules	279	TRUE	0.0030470865827980234	37	17	3	0.17647058823529413	0.08108108108108109	KEGG:05340	KEGG	Primary immunodeficiency	8484	488		1	1	37	8447	3	14	34	8433	8484	0.11703423416121439
M1	cpdb	0	network_modules	279	TRUE	0.003427422881356627	790	20	8	0.4	0.010126582278481013	GO:0007167	GO:BP	enzyme-linked receptor protein signaling pathway	16175	2731		0.8076923076923077	0.8148148148148148	790	15385	8	12	782	15373	16175	0.05732546106639679
M1	cpdb	0	network_modules	279	TRUE	0.0036060368472063827	339	20	6	0.3	0.017699115044247787	GO:0042060	GO:BP	wound healing	16175	9947		0.8461538461538461	0.8518518518518519	339	15836	6	14	333	15822	16175	0.06854130481651126
M1	cpdb	0	network_modules	279	TRUE	0.0036066804358527516	22	20	3	0.15	0.13636363636363635	GO:0002433	GO:BP	immune response-regulating cell surface receptor signaling pathway involved in phagocytosis	16175	956		0.8846153846153846	0.9259259259259259	22	16153	3	17	19	16136	16175	0.14190679921914243
M1	cpdb	0	network_modules	279	TRUE	0.0036066804358527516	22	20	3	0.15	0.13636363636363635	GO:0038096	GO:BP	Fc-gamma receptor signaling pathway involved in phagocytosis	16175	9696		0.8846153846153846	0.9259259259259259	22	16153	3	17	19	16136	16175	0.14190679921914243
M1	cpdb	0	network_modules	279	TRUE	0.004437801127258732	88	19	4	0.21052631578947367	0.045454545454545456	REAC:R-HSA-9013404	REAC	RAC2 GTPase cycle	10916	1837		1	1	88	10828	4	15	84	10813	10916	0.09454113768904
M1	cpdb	0	network_modules	279	TRUE	0.006823391175913291	27	20	3	0.15	0.1111111111111111	GO:0038094	GO:BP	Fc-gamma receptor signaling pathway	16175	9694		0.9615384615384616	0.9629629629629629	27	16148	3	17	24	16131	16175	0.1278485384785232
M1	cpdb	0	network_modules	279	TRUE	0.0094487187219463	30	20	3	0.15	0.1	GO:0002431	GO:BP	Fc receptor mediated stimulatory signaling pathway	16175	954		1	1	30	16145	3	17	27	16128	16175	0.12114737001952819
M1	cpdb	0	network_modules	280	TRUE	6.34013498209882e-5	630	16	8	0.5	0.012698412698412698	GO:0010564	GO:BP	regulation of cell cycle process	16175	4217		0	0.5	630	15545	8	8	622	15537	16175	0.07498603236548965
M1	cpdb	0	network_modules	280	TRUE	0.0017814441654766503	23	16	3	0.1875	0.13043478260869565	GO:0046599	GO:BP	regulation of centriole replication	16175	12249		1	1	23	16152	3	13	20	16139	16175	0.15538715721260482
M1	cpdb	0	network_modules	281	TRUE	3.1697228304611318e-9	16	15	5	0.3333333333333333	0.3125	REAC:R-HSA-9671793	REAC	Diseases of hemostasis	10916	766		0	0.18181818181818182	16	10900	5	10	11	10890	10916	0.32178633282007474
M1	cpdb	0	network_modules	281	TRUE	3.1697228304611318e-9	16	15	5	0.3333333333333333	0.3125	REAC:R-HSA-9651496	REAC	Defects of contact activation system (CAS) and kallikrein/kinin system (KKS)	10916	716		0	0.18181818181818182	16	10900	5	10	11	10890	10916	0.32178633282007474
M1	cpdb	0	network_modules	281	TRUE	8.555561573993482e-8	28	17	5	0.29411764705882354	0.17857142857142858	GO:0050901	GO:BP	leukocyte tethering or rolling	16175	13343		0	0.04	28	16147	5	12	23	16135	16175	0.22814315658622358
M1	cpdb	0	network_modules	281	TRUE	5.409142158374745e-7	12	17	4	0.23529411764705882	0.3333333333333333	GO:0010572	GO:BP	positive regulation of platelet activation	16175	4225		0.041666666666666664	0.08	12	16163	4	13	8	16150	16175	0.27942348745437384
M1	cpdb	0	network_modules	281	TRUE	7.341389433662744e-7	42	17	5	0.29411764705882354	0.11904761904761904	GO:0061756	GO:BP	leukocyte adhesion to vascular endothelial cell	16175	15650		0.08333333333333333	0.12	42	16133	5	12	37	16121	16175	0.18580724826821435
M1	cpdb	0	network_modules	281	TRUE	4.275313466181464e-6	59	17	5	0.29411764705882354	0.0847457627118644	GO:0045123	GO:BP	cellular extravasation	16175	11289		0.125	0.16	59	16116	5	12	54	16104	16175	0.15628657060689474
M1	cpdb	0	network_modules	281	TRUE	1.3171018187626472e-5	6	15	3	0.2	0.5	REAC:R-HSA-9673221	REAC	Defective F9 activation	10916	546		0.2	0.2727272727272727	6	10910	3	12	3	10898	10916	0.3156623496336617
M1	cpdb	0	network_modules	281	TRUE	2.039471451839308e-5	745	17	9	0.5294117647058824	0.012080536912751677	GO:0098609	GO:BP	cell-cell adhesion	16175	18805		0.16666666666666666	0.2	745	15430	9	8	736	15422	16175	0.07479598675112267
M1	cpdb	0	network_modules	281	TRUE	2.6128524401996214e-5	324	17	7	0.4117647058823529	0.021604938271604937	GO:0007159	GO:BP	leukocyte cell-cell adhesion	16175	2723		0.20833333333333334	0.24	324	15851	7	10	317	15841	16175	0.09069120008475882
M1	cpdb	0	network_modules	281	TRUE	4.429289079978373e-5	7	17	3	0.17647058823529413	0.42857142857142855	GO:1903238	GO:BP	positive regulation of leukocyte tethering or rolling	16175	22850		0.25	0.28	7	16168	3	14	4	16154	16175	0.2745388205800411
M1	cpdb	0	network_modules	281	TRUE	5.518151557000285e-5	9	15	3	0.2	0.3333333333333333	REAC:R-HSA-9668250	REAC	Defective factor IX causes hemophilia B	10916	692		0.3	0.36363636363636365	9	10907	3	12	6	10895	10916	0.25741748318742463
M1	cpdb	0	network_modules	281	TRUE	7.082261125472893e-5	8	17	3	0.17647058823529413	0.375	GO:0007597	GO:BP	blood coagulation, intrinsic pathway	16175	3056		0.2916666666666667	0.32	8	16167	3	14	5	16153	16175	0.25672530110168773
M1	cpdb	0	network_modules	281	TRUE	1.0821353212881183e-4	11	15	3	0.2	0.2727272727272727	REAC:R-HSA-430116	REAC	GP1b-IX-V activation signalling	10916	1017		0.4	0.45454545454545453	11	10905	3	12	8	10893	10916	0.232650018567167
M1	cpdb	0	network_modules	281	TRUE	1.1134766492954413e-4	153	13	5	0.38461538461538464	0.032679738562091505	KEGG:04514	KEGG	Cell adhesion molecules	8484	315		0	0.5	153	8331	5	8	148	8323	8484	0.10791484304619164
M1	cpdb	0	network_modules	281	TRUE	2.082675571861061e-4	11	17	3	0.17647058823529413	0.2727272727272727	GO:0035855	GO:BP	megakaryocyte development	16175	9292		0.3333333333333333	0.36	11	16164	3	14	8	16150	16175	0.2187256175143531
M1	cpdb	0	network_modules	281	TRUE	2.1342907537597966e-4	257	17	6	0.35294117647058826	0.023346303501945526	GO:0022409	GO:BP	positive regulation of cell-cell adhesion	16175	6600		0.375	0.4	257	15918	6	11	251	15907	16175	0.08743023316855063
M1	cpdb	0	network_modules	281	TRUE	2.4558008587283604e-4	50	17	4	0.23529411764705882	0.08	GO:0010543	GO:BP	regulation of platelet activation	16175	4202		0.4166666666666667	0.44	50	16125	4	13	46	16112	16175	0.13567748204749863
M1	cpdb	0	network_modules	281	TRUE	2.775097715095278e-4	12	17	3	0.17647058823529413	0.25	GO:1903236	GO:BP	regulation of leukocyte tethering or rolling	16175	22848		0.4583333333333333	0.48	12	16163	3	14	9	16149	16175	0.20934666238654798
M1	cpdb	0	network_modules	281	TRUE	2.9742366987012964e-4	15	15	3	0.2	0.2	REAC:R-HSA-75892	REAC	Platelet Adhesion to exposed collagen	10916	1760		0.5	0.5454545454545454	15	10901	3	12	12	10889	10916	0.19889918356114117
M1	cpdb	0	network_modules	281	TRUE	4.35023803090365e-4	290	17	6	0.35294117647058826	0.020689655172413793	GO:0050867	GO:BP	positive regulation of cell activation	16175	13315		0.5	0.52	290	15885	6	11	284	15874	16175	0.081892298008513
M1	cpdb	0	network_modules	281	TRUE	4.674931485298466e-4	92	13	4	0.3076923076923077	0.043478260869565216	KEGG:04640	KEGG	Hematopoietic cell lineage	8484	333		1	1	92	8392	4	9	88	8383	8484	0.11228274122665362
M1	cpdb	0	network_modules	281	TRUE	5.72823393491153e-4	15	17	3	0.17647058823529413	0.2	GO:0072378	GO:BP	blood coagulation, fibrin clot formation	16175	17375		0.5416666666666666	0.56	15	16160	3	14	12	16146	16175	0.1870650819268692
M1	cpdb	0	network_modules	281	TRUE	5.738839586904858e-4	304	17	6	0.35294117647058826	0.019736842105263157	GO:0050900	GO:BP	leukocyte migration	16175	13342		0.5833333333333334	0.6	304	15871	6	11	298	15860	16175	0.0798129272991941
M1	cpdb	0	network_modules	281	TRUE	7.045556296662869e-4	16	17	3	0.17647058823529413	0.1875	GO:0072376	GO:BP	protein activation cascade	16175	17373		0.625	0.64	16	16159	3	14	13	16145	16175	0.18106679952472396
M1	cpdb	0	network_modules	281	TRUE	0.001025305395298596	18	17	3	0.17647058823529413	0.16666666666666666	GO:1904996	GO:BP	positive regulation of leukocyte adhesion to vascular endothelial cell	16175	24281		0.6666666666666666	0.68	18	16157	3	14	15	16143	16175	0.170601687161713
M1	cpdb	0	network_modules	281	TRUE	0.0011500464662575801	23	15	3	0.2	0.13043478260869565	REAC:R-HSA-140837	REAC	Intrinsic Pathway of Fibrin Clot Formation	10916	1269		0.6	0.6363636363636364	23	10893	3	12	20	10881	10916	0.16009167612828332
M1	cpdb	0	network_modules	281	TRUE	0.0012747176296718497	191	15	5	0.3333333333333333	0.02617801047120419	REAC:R-HSA-202733	REAC	Cell surface interactions at the vascular wall	10916	327		0.7	0.7272727272727273	191	10725	5	10	186	10715	10916	0.08935572762149349
M1	cpdb	0	network_modules	281	TRUE	0.001661426593849282	3	15	2	0.13333333333333333	0.6666666666666666	REAC:R-HSA-9674519	REAC	Defective F8 sulfation at Y1699	10916	545		0.8	0.8181818181818182	3	10913	2	13	1	10900	10916	0.29777342010998115
M1	cpdb	0	network_modules	281	TRUE	0.0018972291112455946	373	17	6	0.35294117647058826	0.0160857908847185	GO:0045785	GO:BP	positive regulation of cell adhesion	16175	11617		0.7083333333333334	0.72	373	15802	6	11	367	15791	16175	0.07128886034911652
M1	cpdb	0	network_modules	281	TRUE	0.00219716642514791	622	17	7	0.4117647058823529	0.011254019292604502	GO:0030155	GO:BP	regulation of cell adhesion	16175	6688		0.75	0.76	622	15553	7	10	615	15543	16175	0.06297129774840757
M1	cpdb	0	network_modules	281	TRUE	0.0023154722543566146	386	17	6	0.35294117647058826	0.015544041450777202	GO:0022407	GO:BP	regulation of cell-cell adhesion	16175	6598		0.7916666666666666	0.8	386	15789	6	11	380	15778	16175	0.06993615667647454
M1	cpdb	0	network_modules	281	TRUE	0.0028314368528363928	215	17	5	0.29411764705882354	0.023255813953488372	GO:1903039	GO:BP	positive regulation of leukocyte cell-cell adhesion	16175	22719		0.8333333333333334	0.84	215	15960	5	12	210	15948	16175	0.07953821883356842
M1	cpdb	0	network_modules	281	TRUE	0.0028768435353760946	25	17	3	0.17647058823529413	0.12	GO:1904994	GO:BP	regulation of leukocyte adhesion to vascular endothelial cell	16175	24279		0.875	0.88	25	16150	3	14	22	16136	16175	0.14443436822943198
M1	cpdb	0	network_modules	281	TRUE	0.005061787463033288	30	17	3	0.17647058823529413	0.1	GO:0002691	GO:BP	regulation of cellular extravasation	16175	1209		0.9166666666666666	0.92	30	16145	3	14	27	16131	16175	0.13163731595409278
M1	cpdb	0	network_modules	281	TRUE	0.005410732919762994	38	15	3	0.2	0.07894736842105263	REAC:R-HSA-76009	REAC	Platelet Aggregation (Plug Formation)	10916	1761		0.9	0.9090909090909091	38	10878	3	12	35	10866	10916	0.12376958149364892
M1	cpdb	0	network_modules	281	TRUE	0.0058567901838209565	39	15	3	0.2	0.07692307692307693	REAC:R-HSA-140877	REAC	Formation of Fibrin Clot (Clotting Cascade)	10916	945		1	1	39	10877	3	12	36	10865	10916	0.12212114951031841
M1	cpdb	0	network_modules	281	TRUE	0.007053958461006348	468	17	6	0.35294117647058826	0.01282051282051282	GO:0050865	GO:BP	regulation of cell activation	16175	13313		0.9583333333333334	0.96	468	15707	6	11	462	15696	16175	0.06269900467920193
M1	cpdb	0	network_modules	281	TRUE	0.0070695483387887255	115	17	4	0.23529411764705882	0.034782608695652174	GO:0030168	GO:BP	platelet activation	16175	6695		1	1	115	16060	4	13	111	16047	16175	0.08809254772516162
M1	cpdb	0	network_modules	282	TRUE	7.920063501889868e-10	36	16	6	0.375	0.16666666666666666	GO:0034381	GO:BP	plasma lipoprotein particle clearance	16175	8606		0	0.030303030303030304	36	16139	6	10	30	16129	16175	0.24891638929263551
M1	cpdb	0	network_modules	282	TRUE	3.936787069926006e-8	36	11	5	0.45454545454545453	0.1388888888888889	REAC:R-HSA-8964043	REAC	Plasma lipoprotein clearance	10916	1757		0	0.14285714285714285	36	10880	5	6	31	10874	10916	0.24997477548877714
M1	cpdb	0	network_modules	282	TRUE	3.991582856086289e-8	67	16	6	0.375	0.08955223880597014	GO:0097006	GO:BP	regulation of plasma lipoprotein particle levels	16175	18441		0.03125	0.06060606060606061	67	16108	6	10	61	16098	16175	0.18169637054485446
M1	cpdb	0	network_modules	282	TRUE	4.2944906490069846e-8	51	9	5	0.5555555555555556	0.09803921568627451	KEGG:04979	KEGG	Cholesterol metabolism	8484	410		NA	1	51	8433	5	4	46	8429	8484	0.23167468608403424
M1	cpdb	0	network_modules	282	TRUE	6.350845632036756e-7	19	11	4	0.36363636363636365	0.21052631578947367	REAC:R-HSA-8964038	REAC	LDL clearance	10916	1295		0.16666666666666666	0.2857142857142857	19	10897	4	7	15	10890	10916	0.27574033621591576
M1	cpdb	0	network_modules	282	TRUE	1.3379152685754537e-6	71	11	5	0.45454545454545453	0.07042253521126761	REAC:R-HSA-174824	REAC	Plasma lipoprotein assembly, remodeling, and clearance	10916	1756		0.3333333333333333	0.42857142857142855	71	10845	5	6	66	10839	10916	0.17701948508315754
M1	cpdb	0	network_modules	282	TRUE	1.932839209194357e-6	17	16	4	0.25	0.23529411764705882	GO:0010984	GO:BP	regulation of lipoprotein particle clearance	16175	4559		0.0625	0.09090909090909091	17	16158	4	12	13	16146	16175	0.2417626211795933
M1	cpdb	0	network_modules	282	TRUE	7.16571130440333e-6	23	16	4	0.25	0.17391304347826086	GO:0034383	GO:BP	low-density lipoprotein particle clearance	16175	8608		0.09375	0.12121212121212122	23	16152	4	12	19	16140	16175	0.20757868218122585
M1	cpdb	0	network_modules	282	TRUE	9.407295427204337e-6	74	16	5	0.3125	0.06756756756756757	GO:0042632	GO:BP	cholesterol homeostasis	16175	10265		0.125	0.15151515151515152	74	16101	5	11	69	16090	16175	0.14358192113367205
M1	cpdb	0	network_modules	282	TRUE	1.0073516743097527e-5	75	16	5	0.3125	0.06666666666666667	GO:0055092	GO:BP	sterol homeostasis	16175	14242		0.15625	0.18181818181818182	75	16100	5	11	70	16089	16175	0.1425972895458544
M1	cpdb	0	network_modules	282	TRUE	2.03252834613607e-5	6	16	3	0.1875	0.5	GO:0090118	GO:BP	receptor-mediated endocytosis involved in cholesterol transport	16175	18033		0.1875	0.21212121212121213	6	16169	3	13	3	16156	16175	0.3057884404350395
M1	cpdb	0	network_modules	282	TRUE	2.8426294794565046e-5	92	16	5	0.3125	0.05434782608695652	GO:0030301	GO:BP	cholesterol transport	16175	6760		0.21875	0.24242424242424243	92	16083	5	11	87	16072	16175	0.12837848160953882
M1	cpdb	0	network_modules	282	TRUE	3.169306612537502e-5	94	16	5	0.3125	0.05319148936170213	GO:0008203	GO:BP	cholesterol metabolic process	16175	3130		0.25	0.2727272727272727	94	16081	5	11	89	16070	16175	0.1269621205443012
M1	cpdb	0	network_modules	282	TRUE	3.5251778689988655e-5	96	16	5	0.3125	0.052083333333333336	GO:0015918	GO:BP	sterol transport	16175	5013		0.28125	0.30303030303030304	96	16079	5	11	91	16068	16175	0.12558979638687456
M1	cpdb	0	network_modules	282	TRUE	3.5547800982188e-5	7	16	3	0.1875	0.42857142857142855	GO:0010985	GO:BP	negative regulation of lipoprotein particle clearance	16175	4560		0.3125	0.3333333333333333	7	16168	3	13	4	16155	16175	0.28302030409478557
M1	cpdb	0	network_modules	282	TRUE	4.117883963364177e-5	99	16	5	0.3125	0.050505050505050504	GO:0045834	GO:BP	positive regulation of lipid metabolic process	16175	11650		0.34375	0.36363636363636365	99	16076	5	11	94	16065	16175	0.12360899267436655
M1	cpdb	0	network_modules	282	TRUE	5.028653281153892e-5	103	16	5	0.3125	0.04854368932038835	GO:1902652	GO:BP	secondary alcohol metabolic process	16175	22418		0.375	0.3939393939393939	103	16072	5	11	98	16061	16175	0.12110230385883153
M1	cpdb	0	network_modules	282	TRUE	6.092822906032803e-5	107	16	5	0.3125	0.04672897196261682	GO:0016125	GO:BP	sterol metabolic process	16175	5143		0.40625	0.42424242424242425	107	16068	5	11	102	16057	16175	0.11873594468143833
M1	cpdb	0	network_modules	282	TRUE	1.6717869738099942e-4	11	16	3	0.1875	0.2727272727272727	GO:0010988	GO:BP	regulation of low-density lipoprotein particle clearance	16175	4563		0.4375	0.45454545454545453	11	16164	3	13	8	16151	16175	0.22550153409960236
M1	cpdb	0	network_modules	282	TRUE	1.7477317941406322e-4	132	16	5	0.3125	0.03787878787878788	GO:0055088	GO:BP	lipid homeostasis	16175	14238		0.46875	0.48484848484848486	132	16043	5	11	127	16032	16175	0.10644499856390341
M1	cpdb	0	network_modules	282	TRUE	2.2277053192107846e-4	12	16	3	0.1875	0.25	GO:0032933	GO:BP	SREBP signaling pathway	16175	7923		0.5	0.5454545454545454	12	16163	3	13	9	16150	16175	0.2158365105379345
M1	cpdb	0	network_modules	282	TRUE	2.2277053192107846e-4	12	16	3	0.1875	0.25	GO:0090205	GO:BP	positive regulation of cholesterol metabolic process	16175	18105		0.5	0.5454545454545454	12	16163	3	13	9	16150	16175	0.2158365105379345
M1	cpdb	0	network_modules	282	TRUE	2.894270779451282e-4	13	16	3	0.1875	0.23076923076923078	GO:0071501	GO:BP	cellular response to sterol depletion	16175	16734		0.5625	0.5757575757575758	13	16162	3	13	10	16149	16175	0.20730677807359252
M1	cpdb	0	network_modules	282	TRUE	3.6813963209937937e-4	14	16	3	0.1875	0.21428571428571427	GO:0006991	GO:BP	response to sterol depletion	16175	2609		0.59375	0.6060606060606061	14	16161	3	13	11	16148	16175	0.1997058364840359
M1	cpdb	0	network_modules	282	TRUE	8.08622802072501e-4	72	16	4	0.25	0.05555555555555555	GO:0046889	GO:BP	positive regulation of lipid biosynthetic process	16175	12424		0.625	0.6363636363636364	72	16103	4	12	68	16091	16175	0.1160686706368337
M1	cpdb	0	network_modules	282	TRUE	0.0015500165410193961	22	16	3	0.1875	0.13636363636363635	GO:0045940	GO:BP	positive regulation of steroid metabolic process	16175	11734		0.65625	0.6666666666666666	22	16153	3	13	19	16140	16175	0.15892730697675234
M1	cpdb	0	network_modules	282	TRUE	0.0021076462613114056	218	16	5	0.3125	0.022935779816513763	GO:0015850	GO:BP	organic hydroxy compound transport	16175	4959		0.6875	0.696969696969697	218	15957	5	11	213	15946	16175	0.08160126849174575
M1	cpdb	0	network_modules	282	TRUE	0.002254271363620597	221	16	5	0.3125	0.02262443438914027	GO:0006898	GO:BP	receptor-mediated endocytosis	16175	2552		0.71875	0.7272727272727273	221	15954	5	11	216	15943	16175	0.08100286687297077
M1	cpdb	0	network_modules	282	TRUE	0.002726919122012445	5	11	2	0.18181818181818182	0.4	REAC:R-HSA-8964026	REAC	Chylomicron clearance	10916	359		0.5	0.7142857142857143	5	10911	2	9	3	10902	10916	0.2691978540546046
M1	cpdb	0	network_modules	282	TRUE	0.002726919122012445	5	11	2	0.18181818181818182	0.4	REAC:R-HSA-8866376	REAC	Reelin signalling pathway	10916	1956		0.5	0.7142857142857143	5	10911	2	9	3	10902	10916	0.2691978540546046
M1	cpdb	0	network_modules	282	TRUE	0.0029351592455293322	27	16	3	0.1875	0.1111111111111111	GO:0032367	GO:BP	intracellular cholesterol transport	16175	7521		0.75	0.7575757575757576	27	16148	3	13	24	16135	16175	0.14324299225971948
M1	cpdb	0	network_modules	282	TRUE	0.0032700318191073207	152	11	4	0.36363636363636365	0.02631578947368421	REAC:R-HSA-8957322	REAC	Metabolism of steroids	10916	1438		0.8333333333333334	0.8571428571428571	152	10764	4	7	148	10757	10916	0.0947869924923662
M1	cpdb	0	network_modules	282	TRUE	0.003520747172716835	242	16	5	0.3125	0.02066115702479339	GO:0008202	GO:BP	steroid metabolic process	16175	3129		0.78125	0.7878787878787878	242	15933	5	11	237	15922	16175	0.0771230067025843
M1	cpdb	0	network_modules	282	TRUE	0.003592656899323013	243	16	5	0.3125	0.0205761316872428	GO:0019216	GO:BP	regulation of lipid metabolic process	16175	5593		0.8125	0.8181818181818182	243	15932	5	11	238	15921	16175	0.07695057671806389
M1	cpdb	0	network_modules	282	TRUE	0.0036622703357273682	29	16	3	0.1875	0.10344827586206896	GO:0090181	GO:BP	regulation of cholesterol metabolic process	16175	18087		0.84375	0.8484848484848485	29	16146	3	13	26	16133	16175	0.1381319357800513
M1	cpdb	0	network_modules	282	TRUE	0.0040667353911232025	30	16	3	0.1875	0.1	GO:0032366	GO:BP	intracellular sterol transport	16175	7520		0.875	0.8787878787878788	30	16145	3	13	27	16132	16175	0.1357692171589587
M1	cpdb	0	network_modules	282	TRUE	0.004726685560451098	257	16	5	0.3125	0.019455252918287938	GO:0006066	GO:BP	alcohol metabolic process	16175	1933		0.90625	0.9090909090909091	257	15918	5	11	252	15907	16175	0.07464038924265136
M1	cpdb	0	network_modules	282	TRUE	0.0051332524842268405	53	11	3	0.2727272727272727	0.05660377358490566	REAC:R-HSA-1655829	REAC	Regulation of cholesterol biosynthesis by SREBP (SREBF)	10916	2023		1	1	53	10863	3	8	50	10855	10916	0.12239440167920843
M1	cpdb	0	network_modules	282	TRUE	0.007048630844640989	4	16	2	0.125	0.5	GO:0010989	GO:BP	negative regulation of low-density lipoprotein particle clearance	16175	4564		0.9375	0.9696969696969697	4	16171	2	14	2	16157	16175	0.24965977593568692
M1	cpdb	0	network_modules	282	TRUE	0.007048630844640989	4	16	2	0.125	0.5	GO:1905600	GO:BP	regulation of receptor-mediated endocytosis involved in cholesterol transport	16175	24758		0.9375	0.9696969696969697	4	16171	2	14	2	16157	16175	0.24965977593568692
M1	cpdb	0	network_modules	282	TRUE	0.00964096021214287	533	16	6	0.375	0.01125703564727955	GO:0006897	GO:BP	endocytosis	16175	2551		1	1	533	15642	6	10	527	15632	16175	0.060294019962829216
M1	cpdb	0	network_modules	286	TRUE	1.233589815843206e-5	49	9	4	0.4444444444444444	0.08163265306122448	REAC:R-HSA-6811440	REAC	Retrograde transport at the Trans-Golgi-Network	10916	2096		0	0.3333333333333333	49	10867	4	5	45	10862	10916	0.1890549800938644
M1	cpdb	0	network_modules	286	TRUE	0.0016764303207580484	5	9	2	0.2222222222222222	0.4	REAC:R-HSA-446205	REAC	Synthesis of GDP-mannose	10916	2378		0.5	0.6666666666666666	5	10911	2	7	3	10904	10916	0.2977187878175293
M1	cpdb	0	network_modules	286	TRUE	0.003704804602453574	202	9	4	0.4444444444444444	0.019801980198019802	REAC:R-HSA-6811442	REAC	Intra-Golgi and retrograde Golgi-to-ER traffic	10916	1262		1	1	202	10714	4	5	198	10709	10916	0.0907880177077085
M1	cpdb	0	network_modules	286	TRUE	0.004998356014637327	34	4	2	0.5	0.058823529411764705	KEGG:00051	KEGG	Fructose and mannose metabolism	8484	6		0	0.5	34	8450	2	2	32	8448	8484	0.1705061262363346
M1	cpdb	0	network_modules	286	TRUE	0.005931072934697145	37	4	2	0.5	0.05405405405405406	KEGG:01250	KEGG	Biosynthesis of nucleotide sugars	8484	191		1	1	37	8447	2	2	35	8445	8484	0.16336008869697982
M1	cpdb	0	network_modules	288	TRUE	2.6895553730607785e-7	11	16	4	0.25	0.36363636363636365	GO:0050665	GO:BP	hydrogen peroxide biosynthetic process	16175	13199		0	0.1111111111111111	11	16164	4	12	7	16152	16175	0.30094233564795014
M1	cpdb	0	network_modules	288	TRUE	2.6925045489335406e-5	10	11	3	0.2727272727272727	0.3	REAC:R-HSA-209968	REAC	Thyroxine biosynthesis	10916	2508		0	0.3333333333333333	10	10906	3	8	7	10898	10916	0.28535245537118925
M1	cpdb	0	network_modules	288	TRUE	6.972366342641025e-5	75	10	4	0.4	0.05333333333333334	KEGG:04918	KEGG	Thyroid hormone synthesis	8484	375		NA	1	75	8409	4	6	71	8403	8484	0.14355154501728623
M1	cpdb	0	network_modules	288	TRUE	7.321195306775899e-5	40	16	4	0.25	0.1	GO:1903409	GO:BP	reactive oxygen species biosynthetic process	16175	22985		0.125	0.2222222222222222	40	16135	4	12	36	16123	16175	0.15682136221288778
M1	cpdb	0	network_modules	288	TRUE	9.868683245956502e-5	43	16	4	0.25	0.09302325581395349	GO:0042743	GO:BP	hydrogen peroxide metabolic process	16175	10336		0.25	0.3333333333333333	43	16132	4	12	39	16120	16175	0.15115267251782938
M1	cpdb	0	network_modules	288	TRUE	1.822862402658396e-4	18	11	3	0.2727272727272727	0.16666666666666666	REAC:R-HSA-209776	REAC	Metabolism of amine-derived hormones	10916	1420		0.5	0.6666666666666666	18	10898	3	8	15	10890	10916	0.21219354140982122
M1	cpdb	0	network_modules	288	TRUE	4.5989707565052026e-4	15	16	3	0.1875	0.2	GO:0006590	GO:BP	thyroid hormone generation	16175	2308		0.375	0.4444444444444444	15	16160	3	13	12	16147	16175	0.19287622447182098
M1	cpdb	0	network_modules	288	TRUE	9.033097460269115e-4	74	16	4	0.25	0.05405405405405406	GO:0018958	GO:BP	phenol-containing compound metabolic process	16175	5514		0.5	0.5555555555555556	74	16101	4	12	70	16089	16175	0.11443888648311998
M1	cpdb	0	network_modules	288	TRUE	0.0011761288709102563	2	16	2	0.125	1	GO:0042335	GO:BP	cuticle development	16175	10101		0.625	0.6666666666666666	2	16173	2	14	0	16159	16175	0.3534003324374783
M1	cpdb	0	network_modules	288	TRUE	0.0013394583334122192	21	16	3	0.1875	0.14285714285714285	GO:0042403	GO:BP	thyroid hormone metabolic process	16175	10150		0.75	0.7777777777777778	21	16154	3	13	18	16141	16175	0.16271627577867978
M1	cpdb	0	network_modules	288	TRUE	0.0035263504037166406	3	16	2	0.125	0.6666666666666666	GO:0010729	GO:BP	positive regulation of hydrogen peroxide biosynthetic process	16175	4354		0.875	0.8888888888888888	3	16172	2	14	1	16158	16175	0.2884162244125957
M1	cpdb	0	network_modules	288	TRUE	0.00502915994493836	370	11	5	0.45454545454545453	0.013513513513513514	REAC:R-HSA-71291	REAC	Metabolism of amino acids and derivatives	10916	1421		1	1	370	10546	5	6	365	10540	10916	0.07382839811249457
M1	cpdb	0	network_modules	288	TRUE	0.007048630844640989	4	16	2	0.125	0.5	GO:0010726	GO:BP	positive regulation of hydrogen peroxide metabolic process	16175	4351		1	1	4	16171	2	14	2	16157	16175	0.24965977593568692
M1	cpdb	0	network_modules	289	TRUE	1.77054748911943e-5	11	9	3	0.3333333333333333	0.2727272727272727	REAC:R-HSA-211999	REAC	CYP2E1 reactions	10916	293		0	0.25	11	10905	3	6	8	10899	10916	0.3008754792622259
M1	cpdb	0	network_modules	289	TRUE	1.789297451922571e-5	6	15	3	0.2	0.5	GO:0009698	GO:BP	phenylpropanoid metabolic process	16175	3601		0	0.6666666666666666	6	16169	3	12	3	16157	16175	0.3158462977623385
M1	cpdb	0	network_modules	289	TRUE	1.789297451922571e-5	6	15	3	0.2	0.5	GO:0009804	GO:BP	coumarin metabolic process	16175	3688		0	0.6666666666666666	6	16169	3	12	3	16157	16175	0.3158462977623385
M1	cpdb	0	network_modules	289	TRUE	1.8909995995251678e-4	23	9	3	0.3333333333333333	0.13043478260869565	REAC:R-HSA-211981	REAC	Xenobiotics	10916	2677		0.3333333333333333	0.5	23	10893	3	6	20	10887	10916	0.20750057941995623
M1	cpdb	0	network_modules	289	TRUE	3.891935156524451e-4	29	9	3	0.3333333333333333	0.10344827586206896	REAC:R-HSA-5669034	REAC	TNFs bind their physiological receptors	10916	2451		0.6666666666666666	0.75	29	10887	3	6	26	10881	10916	0.18453663061859446
M1	cpdb	0	network_modules	289	TRUE	7.251724331179435e-4	18	15	3	0.2	0.16666666666666666	GO:0019373	GO:BP	epoxygenase P450 pathway	16175	5734		1	1	18	16157	3	12	15	16145	16175	0.18174371332799277
M1	cpdb	0	network_modules	289	TRUE	8.093676472393202e-4	6	9	2	0.2222222222222222	0.3333333333333333	KEGG:00232	KEGG	Caffeine metabolism	8484	23		0	0.25	6	8478	2	7	4	8471	8484	0.27153942047707635
M1	cpdb	0	network_modules	289	TRUE	0.002066389044840941	67	9	3	0.3333333333333333	0.04477611940298507	KEGG:05204	KEGG	Chemical carcinogenesis - DNA adducts	8484	456		0.3333333333333333	0.5	67	8417	3	6	64	8411	8484	0.11981239316910515
M1	cpdb	0	network_modules	289	TRUE	0.002160609500934691	68	9	3	0.3333333333333333	0.04411764705882353	KEGG:00830	KEGG	Retinol metabolism	8484	127		0.6666666666666666	0.75	68	8416	3	6	65	8410	8484	0.11889214530497721
M1	cpdb	0	network_modules	289	TRUE	0.0027857826588014384	74	9	3	0.3333333333333333	0.04054054054054054	KEGG:00980	KEGG	Metabolism of xenobiotics by cytochrome P450	8484	154		1	1	74	8410	3	6	71	8404	8484	0.11376311611951291
M1	cpdb	0	network_modules	289	TRUE	0.004373977062258564	64	9	3	0.3333333333333333	0.046875	REAC:R-HSA-211897	REAC	Cytochrome P450 - arranged by substrate type	10916	423		1	1	64	10852	3	6	61	10846	10916	0.12321377658826171
M1	cpdb	0	network_modules	290	TRUE	2.5623582168693623e-9	244	11	8	0.7272727272727273	0.03278688524590164	REAC:R-HSA-8951664	REAC	Neddylation	10916	1559		0	0.3333333333333333	244	10672	8	3	236	10669	10916	0.15144996577566594
M1	cpdb	0	network_modules	290	TRUE	1.6654576213450582e-8	308	11	8	0.7272727272727273	0.025974025974025976	REAC:R-HSA-983168	REAC	Antigen processing: Ubiquitination & Proteasome degradation	10916	154		0.5	0.6666666666666666	308	10608	8	3	300	10605	10916	0.1340811337476353
M1	cpdb	0	network_modules	290	TRUE	8.935822881737436e-8	380	11	8	0.7272727272727273	0.021052631578947368	REAC:R-HSA-983169	REAC	Class I MHC mediated antigen processing & presentation	10916	368		1	1	380	10536	8	3	372	10533	10916	0.11998113074289028
M1	cpdb	0	network_modules	290	TRUE	2.1390553475236873e-4	590	19	8	0.42105263157894735	0.013559322033898305	GO:0016567	GO:BP	protein ubiquitination	16175	5254		0	0.25	590	15585	8	11	582	15574	16175	0.07034894693539374
M1	cpdb	0	network_modules	290	TRUE	5.469707602822787e-4	667	19	8	0.42105263157894735	0.01199400299850075	GO:0032446	GO:BP	protein modification by small protein conjugation	16175	7568		0.3333333333333333	0.5	667	15508	8	11	659	15497	16175	0.06550686083225513
M1	cpdb	0	network_modules	290	TRUE	0.0013198831429166722	749	19	8	0.42105263157894735	0.010680907877169559	GO:0070647	GO:BP	protein modification by small protein conjugation or removal	16175	16231		0.6666666666666666	0.75	749	15426	8	11	741	15415	16175	0.06115392000739955
M1	cpdb	0	network_modules	290	TRUE	0.002129841519561455	798	19	8	0.42105263157894735	0.010025062656641603	GO:0043687	GO:BP	post-translational protein modification	16175	10838		1	1	798	15377	8	11	790	15366	16175	0.058861268281064125
M1	cpdb	0	network_modules	292	TRUE	4.837465318546203e-8	128	15	7	0.4666666666666667	0.0546875	REAC:R-HSA-6809371	REAC	Formation of the cornified envelope	10916	969		0	0.25	128	10788	7	8	121	10780	10916	0.1567672649749619
M1	cpdb	0	network_modules	292	TRUE	1.8463498663567286e-6	215	15	7	0.4666666666666667	0.03255813953488372	REAC:R-HSA-6805567	REAC	Keratinization	10916	1288		0.3333333333333333	0.5	215	10701	7	8	208	10693	10916	0.11932288193401129
M1	cpdb	0	network_modules	292	TRUE	3.5825814060783034e-6	4	15	3	0.2	0.75	GO:0002803	GO:BP	positive regulation of antibacterial peptide production	16175	1314		0	0.26666666666666666	4	16171	3	12	1	16159	16175	0.3870467945892449
M1	cpdb	0	network_modules	292	TRUE	3.5825814060783034e-6	4	15	3	0.2	0.75	GO:0002784	GO:BP	regulation of antimicrobial peptide production	16175	1295		0	0.26666666666666666	4	16171	3	12	1	16159	16175	0.3870467945892449
M1	cpdb	0	network_modules	292	TRUE	3.5825814060783034e-6	4	15	3	0.2	0.75	GO:0002786	GO:BP	regulation of antibacterial peptide production	16175	1297		0	0.26666666666666666	4	16171	3	12	1	16159	16175	0.3870467945892449
M1	cpdb	0	network_modules	292	TRUE	3.5825814060783034e-6	4	15	3	0.2	0.75	GO:0002225	GO:BP	positive regulation of antimicrobial peptide production	16175	759		0	0.26666666666666666	4	16171	3	12	1	16159	16175	0.3870467945892449
M1	cpdb	0	network_modules	292	TRUE	8.95146903112692e-6	5	15	3	0.2	0.6	GO:0002775	GO:BP	antimicrobial peptide production	16175	1286		0.2857142857142857	0.4666666666666667	5	16170	3	12	2	16158	16175	0.3460887334407331
M1	cpdb	0	network_modules	292	TRUE	8.95146903112692e-6	5	15	3	0.2	0.6	GO:0002760	GO:BP	positive regulation of antimicrobial humoral response	16175	1271		0.2857142857142857	0.4666666666666667	5	16170	3	12	2	16158	16175	0.3460887334407331
M1	cpdb	0	network_modules	292	TRUE	8.95146903112692e-6	5	15	3	0.2	0.6	GO:0002778	GO:BP	antibacterial peptide production	16175	1289		0.2857142857142857	0.4666666666666667	5	16170	3	12	2	16158	16175	0.3460887334407331
M1	cpdb	0	network_modules	292	TRUE	1.789297451922571e-5	6	15	3	0.2	0.5	GO:0002759	GO:BP	regulation of antimicrobial humoral response	16175	1270		0.5	0.5333333333333333	6	16169	3	12	3	16157	16175	0.3158462977623385
M1	cpdb	0	network_modules	292	TRUE	1.472067141840827e-4	11	15	3	0.2	0.2727272727272727	GO:1900426	GO:BP	positive regulation of defense response to bacterium	16175	20649		0.5714285714285714	0.6	11	16164	3	12	8	16152	16175	0.23294276220709734
M1	cpdb	0	network_modules	292	TRUE	2.548743538256362e-4	13	15	3	0.2	0.23076923076923078	GO:1900424	GO:BP	regulation of defense response to bacterium	16175	20647		0.6428571428571429	0.7333333333333333	13	16162	3	12	10	16150	16175	0.21415649977466114
M1	cpdb	0	network_modules	292	TRUE	2.548743538256362e-4	13	15	3	0.2	0.23076923076923078	GO:0002922	GO:BP	positive regulation of humoral immune response	16175	1432		0.6428571428571429	0.7333333333333333	13	16162	3	12	10	16150	16175	0.21415649977466114
M1	cpdb	0	network_modules	292	TRUE	4.0891221407681513e-4	64	15	4	0.26666666666666666	0.0625	GO:0019731	GO:BP	antibacterial humoral response	16175	6022		0.7857142857142857	0.8	64	16111	4	11	60	16100	16175	0.1274953999264633
M1	cpdb	0	network_modules	292	TRUE	9.110291772197921e-4	78	15	4	0.26666666666666666	0.05128205128205128	GO:0061844	GO:BP	antimicrobial humoral immune response mediated by antimicrobial peptide	16175	15685		0.8571428571428571	0.8666666666666667	78	16097	4	11	74	16086	16175	0.11515764482498843
M1	cpdb	0	network_modules	292	TRUE	0.002053641964772146	182	4	3	0.75	0.016483516483516484	KEGG:04621	KEGG	NOD-like receptor signaling pathway	8484	326		NA	1	182	8302	3	1	179	8301	8484	0.10921033885227414
M1	cpdb	0	network_modules	292	TRUE	0.004373682735449354	32	15	3	0.2	0.09375	GO:0002920	GO:BP	regulation of humoral immune response	16175	1430		0.9285714285714286	0.9333333333333333	32	16143	3	12	29	16131	16175	0.135773426201086
M1	cpdb	0	network_modules	292	TRUE	0.0055292970928870625	5	15	2	0.13333333333333333	0.4	REAC:R-HSA-112307	REAC	Transmission across Electrical Synapses 	10916	2581		0.6666666666666666	1	5	10911	2	13	3	10898	10916	0.23035780537119116
M1	cpdb	0	network_modules	292	TRUE	0.0055292970928870625	5	15	2	0.13333333333333333	0.4	REAC:R-HSA-112303	REAC	Electric Transmission Across Gap Junctions	10916	837		0.6666666666666666	1	5	10911	2	13	3	10898	10916	0.23035780537119116
M1	cpdb	0	network_modules	292	TRUE	0.005657653416473533	123	15	4	0.26666666666666666	0.032520325203252036	GO:0019730	GO:BP	antimicrobial humoral response	16175	6021		1	1	123	16052	4	11	119	16041	16175	0.09085658136882174
M1	cpdb	0	network_modules	293	TRUE	4.2763712454593006e-10	71	8	6	0.75	0.08450704225352113	KEGG:04622	KEGG	RIG-I-like receptor signaling pathway	8484	327		NA	1	71	8413	6	2	65	8411	8484	0.250111473382199
M1	cpdb	0	network_modules	293	TRUE	8.593762268659344e-9	82	10	6	0.6	0.07317073170731707	REAC:R-HSA-168928	REAC	DDX58/IFIH1-mediated induction of interferon-alpha/beta	10916	436		0	0.14285714285714285	82	10834	6	4	76	10830	10916	0.20778254619709616
M1	cpdb	0	network_modules	293	TRUE	1.3415216980798345e-8	110	17	7	0.4117647058823529	0.06363636363636363	GO:0032606	GO:BP	type I interferon production	16175	7654		0	0.05555555555555555	110	16065	7	10	103	16055	16175	0.15982869451667298
M1	cpdb	0	network_modules	293	TRUE	1.3415216980798345e-8	110	17	7	0.4117647058823529	0.06363636363636363	GO:0032479	GO:BP	regulation of type I interferon production	16175	7590		0	0.05555555555555555	110	16065	7	10	103	16055	16175	0.15982869451667298
M1	cpdb	0	network_modules	293	TRUE	1.7604436564946567e-8	35	10	5	0.5	0.14285714285714285	REAC:R-HSA-936440	REAC	Negative regulators of DDX58/IFIH1 signaling	10916	1581		0.16666666666666666	0.2857142857142857	35	10881	5	5	30	10876	10916	0.2660960516037948
M1	cpdb	0	network_modules	293	TRUE	3.9533964898226484e-8	228	17	8	0.47058823529411764	0.03508771929824561	GO:0051607	GO:BP	defense response to virus	16175	13823		0.05714285714285714	0.08333333333333333	228	15947	8	9	220	15938	16175	0.1256034553511991
M1	cpdb	0	network_modules	293	TRUE	5.733436112801854e-8	26	17	5	0.29411764705882354	0.19230769230769232	GO:0039529	GO:BP	RIG-I signaling pathway	16175	9802		0.08571428571428572	0.1111111111111111	26	16149	5	12	21	16137	16175	0.23684079681706469
M1	cpdb	0	network_modules	293	TRUE	5.610617328370779e-7	721	17	10	0.5882352941176471	0.013869625520110958	GO:0045087	GO:BP	innate immune response	16175	11270		0.11428571428571428	0.1388888888888889	721	15454	10	7	711	15447	16175	0.085450480354897565
M1	cpdb	0	network_modules	293	TRUE	8.272040878196644e-7	334	17	8	0.47058823529411764	0.023952095808383235	GO:0009615	GO:BP	response to virus	16175	3541		0.14285714285714285	0.16666666666666666	334	15841	8	9	326	15832	16175	0.10262759198435513
M1	cpdb	0	network_modules	293	TRUE	7.5988428414341136e-6	66	17	5	0.29411764705882354	0.07575757575757576	GO:0032481	GO:BP	positive regulation of type I interferon production	16175	7592		0.17142857142857143	0.19444444444444445	66	16109	5	12	61	16097	16175	0.14757830140621456
M1	cpdb	0	network_modules	293	TRUE	8.272165983644506e-6	149	17	6	0.35294117647058826	0.040268456375838924	GO:0002753	GO:BP	cytoplasmic pattern recognition receptor signaling pathway	16175	1264		0.2	0.2222222222222222	149	16026	6	11	143	16015	16175	0.11670405936137696
M1	cpdb	0	network_modules	293	TRUE	2.3473623743489324e-5	319	17	7	0.4117647058823529	0.0219435736677116	GO:0045089	GO:BP	positive regulation of innate immune response	16175	11272		0.22857142857142856	0.25	319	15856	7	10	312	15846	16175	0.09145688293055708
M1	cpdb	0	network_modules	293	TRUE	2.532666747095084e-5	6	17	3	0.17647058823529413	0.5	GO:0009597	GO:BP	detection of virus	16175	3527		0.2571428571428571	0.2777777777777778	6	16169	3	14	3	16155	16175	0.29663078695383466
M1	cpdb	0	network_modules	293	TRUE	3.567629326558115e-5	339	17	7	0.4117647058823529	0.02064896755162242	GO:0002833	GO:BP	positive regulation of response to biotic stimulus	16175	1343		0.2857142857142857	0.3055555555555556	339	15836	7	10	332	15826	16175	0.08849404784974223
M1	cpdb	0	network_modules	293	TRUE	4.426771765199478e-5	13	10	3	0.3	0.23076923076923078	REAC:R-HSA-933543	REAC	NF-kB activation through FADD/RIP-1 pathway mediated by caspase-8 and -10	10916	1515		0.3333333333333333	0.42857142857142855	13	10903	3	7	10	10896	10916	0.26234929381831623
M1	cpdb	0	network_modules	293	TRUE	7.035814078762383e-5	15	10	3	0.3	0.2	REAC:R-HSA-918233	REAC	TRAF3-dependent IRF activation pathway	10916	2464		0.5	0.5714285714285714	15	10901	3	7	12	10894	10916	0.244106536843253
M1	cpdb	0	network_modules	293	TRUE	8.693106237882496e-5	386	17	7	0.4117647058823529	0.018134715025906734	GO:0045088	GO:BP	regulation of innate immune response	16175	11271		0.3142857142857143	0.3333333333333333	386	15789	7	10	379	15779	16175	0.08243745335937146
M1	cpdb	0	network_modules	293	TRUE	1.0234890905762073e-4	227	17	6	0.35294117647058826	0.02643171806167401	GO:0002221	GO:BP	pattern recognition receptor signaling pathway	16175	755		0.34285714285714286	0.3611111111111111	227	15948	6	11	221	15937	16175	0.09345222960608919
M1	cpdb	0	network_modules	293	TRUE	1.532474254679822e-4	243	17	6	0.35294117647058826	0.024691358024691357	GO:0002758	GO:BP	innate immune response-activating signaling pathway	16175	1269		0.37142857142857144	0.3888888888888889	243	15932	6	11	237	15921	16175	0.09010481078182529
M1	cpdb	0	network_modules	293	TRUE	1.6243318936910863e-4	423	17	7	0.4117647058823529	0.016548463356973995	GO:0031349	GO:BP	positive regulation of defense response	16175	7140		0.4	0.4166666666666667	423	15752	7	10	416	15742	16175	0.07837703806483118
M1	cpdb	0	network_modules	293	TRUE	2.260792374916158e-4	49	17	4	0.23529411764705882	0.08163265306122448	GO:0140374	GO:BP	antiviral innate immune response	16175	19754		0.42857142857142855	0.4444444444444444	49	16126	4	13	45	16113	16175	0.13708719377619358
M1	cpdb	0	network_modules	293	TRUE	2.445905890405591e-4	263	17	6	0.35294117647058826	0.022813688212927757	GO:0002218	GO:BP	activation of innate immune response	16175	753		0.45714285714285713	0.4722222222222222	263	15912	6	11	257	15901	16175	0.08634833415563824
M1	cpdb	0	network_modules	293	TRUE	2.512837280320662e-4	451	17	7	0.4117647058823529	0.015521064301552107	GO:0002831	GO:BP	regulation of response to biotic stimulus	16175	1341		0.4857142857142857	0.5	451	15724	7	10	444	15714	16175	0.07563156759253592
M1	cpdb	0	network_modules	293	TRUE	3.5394809353927e-4	25	10	3	0.3	0.12	REAC:R-HSA-933542	REAC	TRAF6 mediated NF-kB activation	10916	2467		0.6666666666666666	0.7142857142857143	25	10891	3	7	22	10884	10916	0.18859058353770547
M1	cpdb	0	network_modules	293	TRUE	5.520692522523107e-4	302	17	6	0.35294117647058826	0.019867549668874173	GO:0030522	GO:BP	intracellular receptor signaling pathway	16175	6836		0.5142857142857142	0.5277777777777778	302	15873	6	11	296	15862	16175	0.08010135713467574
M1	cpdb	0	network_modules	293	TRUE	5.72823393491153e-4	15	17	3	0.17647058823529413	0.2	GO:0071360	GO:BP	cellular response to exogenous dsRNA	16175	16612		0.5428571428571428	0.5555555555555556	15	16160	3	14	12	16146	16175	0.1870650819268692
M1	cpdb	0	network_modules	293	TRUE	6.232924183653007e-4	30	10	3	0.3	0.1	REAC:R-HSA-933541	REAC	TRAF6 mediated IRF7 activation	10916	2465		0.8333333333333334	0.8571428571428571	30	10886	3	7	27	10879	10916	0.1719334565383422
M1	cpdb	0	network_modules	293	TRUE	7.593259997522172e-4	531	17	7	0.4117647058823529	0.013182674199623353	GO:0032103	GO:BP	positive regulation of response to external stimulus	16175	7367		0.5714285714285714	0.5833333333333334	531	15644	7	10	524	15634	16175	0.06897948638552841
M1	cpdb	0	network_modules	293	TRUE	0.001025305395298596	18	17	3	0.17647058823529413	0.16666666666666666	GO:0071359	GO:BP	cellular response to dsRNA	16175	16611		0.6	0.6111111111111112	18	16157	3	14	15	16143	16175	0.170601687161713
M1	cpdb	0	network_modules	293	TRUE	0.0013969513165221496	39	10	3	0.3	0.07692307692307693	REAC:R-HSA-5689896	REAC	Ovarian tumor domain proteases	10916	1653		1	1	39	10877	3	7	36	10870	10916	0.15043956057946922
M1	cpdb	0	network_modules	293	TRUE	0.0014305523333107764	20	17	3	0.17647058823529413	0.15	GO:0039535	GO:BP	regulation of RIG-I signaling pathway	16175	9808		0.6285714285714286	0.6388888888888888	20	16155	3	14	17	16141	16175	0.16174286131033155
M1	cpdb	0	network_modules	293	TRUE	0.002269004907964229	625	17	7	0.4117647058823529	0.0112	GO:1901652	GO:BP	response to peptide	16175	21619		0.6571428571428571	0.6944444444444444	625	15550	7	10	618	15540	16175	0.0627948305486136
M1	cpdb	0	network_modules	293	TRUE	0.002269004907964229	625	17	7	0.4117647058823529	0.0112	GO:0034097	GO:BP	response to cytokine	16175	8408		0.6571428571428571	0.6944444444444444	625	15550	7	10	618	15540	16175	0.0627948305486136
M1	cpdb	0	network_modules	293	TRUE	0.00231798720090911	627	17	7	0.4117647058823529	0.011164274322169059	GO:0050778	GO:BP	positive regulation of immune response	16175	13252		0.7142857142857143	0.7222222222222222	627	15548	7	10	620	15538	16175	0.06267785418237198
M1	cpdb	0	network_modules	293	TRUE	0.0024964945886298893	634	17	7	0.4117647058823529	0.011041009463722398	GO:0001817	GO:BP	regulation of cytokine production	16175	474		0.7428571428571429	0.75	634	15541	7	10	627	15531	16175	0.06227258205011703
M1	cpdb	0	network_modules	293	TRUE	0.0026035927694318746	638	17	7	0.4117647058823529	0.0109717868338558	GO:0001816	GO:BP	cytokine production	16175	473		0.7714285714285715	0.7777777777777778	638	15537	7	10	631	15527	16175	0.06204384416952066
M1	cpdb	0	network_modules	293	TRUE	0.003071492911302371	654	17	7	0.4117647058823529	0.010703363914373088	GO:0031347	GO:BP	regulation of defense response	16175	7138		0.8	0.8055555555555556	654	15521	7	10	647	15511	16175	0.06114888327571939
M1	cpdb	0	network_modules	293	TRUE	0.003574192732182665	416	17	6	0.35294117647058826	0.014423076923076924	GO:0002757	GO:BP	immune response-activating signaling pathway	16175	1268		0.8285714285714286	0.8333333333333334	416	15759	6	11	410	15748	16175	0.06705128108639417
M1	cpdb	0	network_modules	293	TRUE	0.004751728838461038	437	17	6	0.35294117647058826	0.013729977116704805	GO:0002764	GO:BP	immune response-regulating signaling pathway	16175	1275		0.8571428571428571	0.8611111111111112	437	15738	6	11	431	15727	16175	0.06520426952757617
M1	cpdb	0	network_modules	293	TRUE	0.007682775189271737	475	17	6	0.35294117647058826	0.01263157894736842	GO:0002253	GO:BP	activation of immune response	16175	785		0.8857142857142857	0.8888888888888888	475	15700	6	11	469	15689	16175	0.06216602562044189
M1	cpdb	0	network_modules	293	TRUE	0.00803672324036974	756	17	7	0.4117647058823529	0.009259259259259259	GO:0050776	GO:BP	regulation of immune response	16175	13250		0.9142857142857143	0.9166666666666666	756	15419	7	10	749	15409	16175	0.05609312559065015
M1	cpdb	0	network_modules	293	TRUE	0.008197994358362042	4	17	2	0.11764705882352941	0.5	GO:0034343	GO:BP	type III interferon production	16175	8581		0.9428571428571428	0.9722222222222222	4	16171	2	15	2	16156	16175	0.2421830455760906
M1	cpdb	0	network_modules	293	TRUE	0.008197994358362042	4	17	2	0.11764705882352941	0.5	GO:0034344	GO:BP	regulation of type III interferon production	16175	8582		0.9428571428571428	0.9722222222222222	4	16171	2	15	2	16156	16175	0.2421830455760906
M1	cpdb	0	network_modules	293	TRUE	0.009643264396870422	37	17	3	0.17647058823529413	0.08108108108108109	GO:0043330	GO:BP	response to exogenous dsRNA	16175	10636		1	1	37	16138	3	14	34	16124	16175	0.1182647355350957
M1	cpdb	0	network_modules	294	TRUE	2.730513072323077e-4	27	11	3	0.2727272727272727	0.1111111111111111	KEGG:00790	KEGG	Folate biosynthesis	8484	125		NA	1	27	8457	3	8	24	8449	8484	0.17243258086599866
M1	cpdb	0	network_modules	294	TRUE	0.00173392044766401	6	8	2	0.25	0.3333333333333333	REAC:R-HSA-8964208	REAC	Phenylalanine metabolism	10916	1740		0	0.5	6	10910	2	6	4	10904	10916	0.2882252799722374
M1	cpdb	0	network_modules	294	TRUE	0.006346064693349163	11	8	2	0.25	0.18181818181818182	REAC:R-HSA-8963691	REAC	Phenylalanine and tyrosine metabolism	10916	1739		1	1	11	10905	2	6	9	10899	10916	0.21252631092836188
M1	cpdb	0	network_modules	295	TRUE	1.3750419843646888e-9	116	11	7	0.6363636363636364	0.0603448275862069	KEGG:03082	KEGG	ATP-dependent chromatin remodeling	8484	219		0	0.3333333333333333	116	8368	7	4	109	8364	8484	0.1932017457555009
M1	cpdb	0	network_modules	295	TRUE	2.8149788178840338e-9	36	19	6	0.3157894736842105	0.16666666666666666	GO:0045023	GO:BP	G0 to G1 transition	16175	11235		0	0.02857142857142857	36	16139	6	13	30	16126	16175	0.22818681605152685
M1	cpdb	0	network_modules	295	TRUE	1.3540608534289557e-7	27	19	5	0.2631578947368421	0.18518518518518517	GO:2000819	GO:BP	regulation of nucleotide-excision repair	16175	26073		0.029411764705882353	0.05714285714285714	27	16148	5	14	22	16134	16175	0.2196674767675112
M1	cpdb	0	network_modules	295	TRUE	4.6435678447316657e-7	34	19	5	0.2631578947368421	0.14705882352941177	GO:0070316	GO:BP	regulation of G0 to G1 transition	16175	16055		0.058823529411764705	0.08571428571428572	34	16141	5	14	29	16127	16175	0.19547128998938765
M1	cpdb	0	network_modules	295	TRUE	1.2442948920924553e-6	41	19	5	0.2631578947368421	0.12195121951219512	GO:0045663	GO:BP	positive regulation of myoblast differentiation	16175	11514		0.08823529411764706	0.11428571428571428	41	16134	5	14	36	16120	16175	0.17774776578627005
M1	cpdb	0	network_modules	295	TRUE	8.205117060267641e-6	59	19	5	0.2631578947368421	0.0847457627118644	GO:0045661	GO:BP	regulation of myoblast differentiation	16175	11512		0.11764705882352941	0.14285714285714285	59	16116	5	14	54	16102	16175	0.1476230303354876
M1	cpdb	0	network_modules	295	TRUE	2.8199965020371243e-5	454	19	8	0.42105263157894735	0.01762114537444934	GO:0006338	GO:BP	chromatin remodeling	16175	2126		0.14705882352941177	0.17142857142857143	454	15721	8	11	446	15710	16175	0.08159465627256814
M1	cpdb	0	network_modules	295	TRUE	3.640696588066852e-5	79	19	5	0.2631578947368421	0.06329113924050633	GO:0006289	GO:BP	nucleotide-excision repair	16175	2102		0.17647058823529413	0.2	79	16096	5	14	74	16082	16175	0.1270462986171147
M1	cpdb	0	network_modules	295	TRUE	3.880601121562424e-5	80	19	5	0.2631578947368421	0.0625	GO:0045445	GO:BP	myoblast differentiation	16175	11378		0.20588235294117646	0.22857142857142856	80	16095	5	14	75	16081	16175	0.12622346246901994
M1	cpdb	0	network_modules	295	TRUE	4.9690380261034175e-5	84	19	5	0.2631578947368421	0.05952380952380952	GO:2000781	GO:BP	positive regulation of double-strand break repair	16175	26037		0.23529411764705882	0.2571428571428571	84	16091	5	14	79	16077	16175	0.1230788076504062
M1	cpdb	0	network_modules	295	TRUE	5.597397756992595e-5	86	19	5	0.2631578947368421	0.05813953488372093	GO:0030071	GO:BP	regulation of mitotic metaphase/anaphase transition	16175	6671		0.2647058823529412	0.2857142857142857	86	16089	5	14	81	16075	16175	0.12158849234422883
M1	cpdb	0	network_modules	295	TRUE	6.287349279000114e-5	88	19	5	0.2631578947368421	0.056818181818181816	GO:1902099	GO:BP	regulation of metaphase/anaphase transition of cell cycle	16175	22013		0.29411764705882354	0.3142857142857143	88	16087	5	14	83	16073	16175	0.12014869059003228
M1	cpdb	0	network_modules	295	TRUE	6.641669861407299e-5	166	11	5	0.45454545454545453	0.030120481927710843	KEGG:05225	KEGG	Hepatocellular carcinoma	8484	476		0.5	0.6666666666666666	166	8318	5	6	161	8312	8484	0.11315751448353865
M1	cpdb	0	network_modules	295	TRUE	7.043253002132923e-5	90	19	5	0.2631578947368421	0.05555555555555555	GO:0007091	GO:BP	metaphase/anaphase transition of mitotic cell cycle	16175	2675		0.3235294117647059	0.34285714285714286	90	16085	5	14	85	16071	16175	0.11875658654172346
M1	cpdb	0	network_modules	295	TRUE	7.129662730961417e-5	187	19	6	0.3157894736842105	0.03208556149732621	GO:0000082	GO:BP	G1/S transition of mitotic cell cycle	16175	31		0.35294117647058826	0.37142857142857144	187	15988	6	13	181	15975	16175	0.09759691281402103
M1	cpdb	0	network_modules	295	TRUE	7.869663488885065e-5	92	19	5	0.2631578947368421	0.05434782608695652	GO:0044784	GO:BP	metaphase/anaphase transition of cell cycle	16175	11156		0.38235294117647056	0.4	92	16083	5	14	87	16069	16175	0.11740957958267959
M1	cpdb	0	network_modules	295	TRUE	9.228115345597498e-5	529	19	8	0.42105263157894735	0.015122873345935728	GO:0006325	GO:BP	chromatin organization	16175	2122		0.4117647058823529	0.42857142857142855	529	15646	8	11	521	15635	16175	0.07487650467195617
M1	cpdb	0	network_modules	295	TRUE	1.1387778999142644e-4	99	19	5	0.2631578947368421	0.050505050505050504	GO:0033045	GO:BP	regulation of sister chromatid segregation	16175	8000		0.4411764705882353	0.45714285714285713	99	16076	5	14	94	16062	16175	0.11301700311116739
M1	cpdb	0	network_modules	295	TRUE	1.587938316034847e-4	214	19	6	0.3157894736842105	0.028037383177570093	GO:0044843	GO:BP	cell cycle G1/S phase transition	16175	11189		0.47058823529411764	0.4857142857142857	214	15961	6	13	208	15948	16175	0.0908087226143971
M1	cpdb	0	network_modules	295	TRUE	1.8100684263130126e-4	41	19	4	0.21052631578947367	0.0975609756097561	GO:1902459	GO:BP	positive regulation of stem cell population maintenance	16175	22297		0.5	0.5142857142857142	41	16134	4	15	37	16119	16175	0.14185246375379754
M1	cpdb	0	network_modules	295	TRUE	2.720527866253793e-4	36	7	3	0.42857142857142855	0.08333333333333333	REAC:R-HSA-8939243	REAC	RUNX1 interacts with co-factors whose precise effect on RUNX1 targets is not known	10916	1916		0	0.5	36	10880	3	4	33	10876	10916	0.18789824213294584
M1	cpdb	0	network_modules	295	TRUE	3.520474815329389e-4	124	19	5	0.2631578947368421	0.04032258064516129	GO:0051983	GO:BP	regulation of chromosome segregation	16175	14045		0.5294117647058824	0.5428571428571428	124	16051	5	14	119	16037	16175	0.10045444237268353
M1	cpdb	0	network_modules	295	TRUE	3.9665695108722634e-4	127	19	5	0.2631578947368421	0.03937007874015748	GO:0045739	GO:BP	positive regulation of DNA repair	16175	11579		0.5588235294117647	0.5714285714285714	127	16048	5	14	122	16034	16175	0.0991980952365146
M1	cpdb	0	network_modules	295	TRUE	4.124822259232057e-4	128	19	5	0.2631578947368421	0.0390625	GO:2000779	GO:BP	regulation of double-strand break repair	16175	26035		0.5882352941176471	0.6	128	16047	5	14	123	16033	16175	0.09878899351416183
M1	cpdb	0	network_modules	295	TRUE	6.676656725511835e-4	141	19	5	0.2631578947368421	0.03546099290780142	GO:2000045	GO:BP	regulation of G1/S transition of mitotic cell cycle	16175	25406		0.6176470588235294	0.6285714285714286	141	16034	5	14	136	16020	16175	0.0938664339978616
M1	cpdb	0	network_modules	295	TRUE	8.026705095605384e-4	59	19	4	0.21052631578947367	0.06779661016949153	GO:2000036	GO:BP	regulation of stem cell population maintenance	16175	25399		0.6470588235294118	0.6571428571428571	59	16116	4	15	55	16101	16175	0.11768343463274526
M1	cpdb	0	network_modules	295	TRUE	8.761173216782927e-4	286	19	6	0.3157894736842105	0.02097902097902098	GO:1901990	GO:BP	regulation of mitotic cell cycle phase transition	16175	21923		0.6764705882352942	0.6857142857142857	286	15889	6	13	280	15876	16175	0.07757044886772237
M1	cpdb	0	network_modules	295	TRUE	0.0014992091619502204	166	19	5	0.2631578947368421	0.030120481927710843	GO:1902806	GO:BP	regulation of cell cycle G1/S phase transition	16175	22525		0.7058823529411765	0.7142857142857143	166	16009	5	14	161	15995	16175	0.08605151301255107
M1	cpdb	0	network_modules	295	TRUE	0.002865318251050871	78	7	3	0.42857142857142855	0.038461538461538464	REAC:R-HSA-3214858	REAC	RMTs methylate histone arginines	10916	1878		1	1	78	10838	3	4	75	10834	10916	0.12674168600267308
M1	cpdb	0	network_modules	295	TRUE	0.0036707300376271216	86	19	4	0.21052631578947367	0.046511627906976744	GO:0045582	GO:BP	positive regulation of T cell differentiation	16175	11433		0.7352941176470589	0.7428571428571429	86	16089	4	15	82	16074	16175	0.09676934741082438
M1	cpdb	0	network_modules	295	TRUE	0.003920455405650977	370	19	6	0.3157894736842105	0.016216216216216217	GO:0044772	GO:BP	mitotic cell cycle phase transition	16175	11148		0.7647058823529411	0.7714285714285715	370	15805	6	13	364	15792	16175	0.06718884473352442
M1	cpdb	0	network_modules	295	TRUE	0.004302436391015743	376	19	6	0.3157894736842105	0.015957446808510637	GO:1901987	GO:BP	regulation of cell cycle phase transition	16175	21920		0.7941176470588235	0.8	376	15799	6	13	370	15786	16175	0.06657884107431708
M1	cpdb	0	network_modules	295	TRUE	0.004336979288329104	192	11	4	0.36363636363636365	0.020833333333333332	KEGG:05202	KEGG	Transcriptional misregulation in cancer	8484	454		1	1	192	8292	4	7	188	8285	8484	0.08261512397900198
M1	cpdb	0	network_modules	295	TRUE	0.004441349528872015	207	19	5	0.2631578947368421	0.024154589371980676	GO:0006282	GO:BP	regulation of DNA repair	16175	2096		0.8235294117647058	0.8285714285714286	207	15968	5	14	202	15954	16175	0.0763852164433891
M1	cpdb	0	network_modules	295	TRUE	0.005594835484355932	217	19	5	0.2631578947368421	0.02304147465437788	GO:0000819	GO:BP	sister chromatid segregation	16175	237		0.8529411764705882	0.8571428571428571	217	15958	5	14	212	15944	16175	0.07444351672698095
M1	cpdb	0	network_modules	295	TRUE	0.006444412158040995	99	19	4	0.21052631578947367	0.04040404040404041	GO:0045621	GO:BP	positive regulation of lymphocyte differentiation	16175	11472		0.8823529411764706	0.9142857142857143	99	16076	4	15	95	16061	16175	0.08987537178064695
M1	cpdb	0	network_modules	295	TRUE	0.006444412158040995	99	19	4	0.21052631578947367	0.04040404040404041	GO:0019827	GO:BP	stem cell population maintenance	16175	6046		0.8823529411764706	0.9142857142857143	99	16076	4	15	95	16061	16175	0.08987537178064695
M1	cpdb	0	network_modules	295	TRUE	0.006707938305935475	100	19	4	0.21052631578947367	0.04	GO:0098727	GO:BP	maintenance of cell number	16175	18856		0.9411764705882353	0.9428571428571428	100	16075	4	15	96	16060	16175	0.08940059932057837
M1	cpdb	0	network_modules	295	TRUE	0.007276816863231142	229	19	5	0.2631578947368421	0.021834061135371178	GO:0033044	GO:BP	regulation of chromosome organization	16175	7999		0.9705882352941176	0.9714285714285714	229	15946	5	14	224	15932	16175	0.0722786977522353
M1	cpdb	0	network_modules	295	TRUE	0.008948172769931994	427	19	6	0.3157894736842105	0.01405152224824356	GO:0007346	GO:BP	regulation of mitotic cell cycle	16175	2855		1	1	427	15748	6	13	421	15735	16175	0.06190305927334734
M1	cpdb	0	network_modules	296	TRUE	3.0993977379778486e-21	27	19	10	0.5263157894736842	0.37037037037037035	GO:2000819	GO:BP	regulation of nucleotide-excision repair	16175	26073		0	0.011363636363636364	27	16148	10	9	17	16139	16175	0.4407372259471292
M1	cpdb	0	network_modules	296	TRUE	4.8004422984593615e-20	34	19	10	0.5263157894736842	0.29411764705882354	GO:0070316	GO:BP	regulation of G0 to G1 transition	16175	16055		0.011494252873563218	0.022727272727272728	34	16141	10	9	24	16132	16175	0.3925165052842527
M1	cpdb	0	network_modules	296	TRUE	9.296043207763079e-20	36	19	10	0.5263157894736842	0.2777777777777778	GO:0045023	GO:BP	G0 to G1 transition	16175	11235		0.022988505747126436	0.03409090909090909	36	16139	10	9	26	16130	16175	0.38139113083613746
M1	cpdb	0	network_modules	296	TRUE	1.4592213315393148e-19	116	18	13	0.7222222222222222	0.11206896551724138	KEGG:03082	KEGG	ATP-dependent chromatin remodeling	8484	219		0	0.3333333333333333	116	8368	13	5	103	8363	8484	0.28133780886127685
M1	cpdb	0	network_modules	296	TRUE	2.4186743245632526e-17	36	15	9	0.6	0.25	REAC:R-HSA-8939243	REAC	RUNX1 interacts with co-factors whose precise effect on RUNX1 targets is not known	10916	1916		0	0.2	36	10880	9	6	27	10874	10916	0.38607159219884485
M1	cpdb	0	network_modules	296	TRUE	2.0616593515941456e-16	41	19	9	0.47368421052631576	0.21951219512195122	GO:0045663	GO:BP	positive regulation of myoblast differentiation	16175	11514		0.034482758620689655	0.045454545454545456	41	16134	9	10	32	16124	16175	0.32132897391616005
M1	cpdb	0	network_modules	296	TRUE	5.155074035011001e-16	79	19	10	0.5263157894736842	0.12658227848101267	GO:0006289	GO:BP	nucleotide-excision repair	16175	2102		0.04597701149425287	0.056818181818181816	79	16096	10	9	69	16087	16175	0.2564951030198051
M1	cpdb	0	network_modules	296	TRUE	5.88852039506802e-16	80	19	10	0.5263157894736842	0.125	GO:0045445	GO:BP	myoblast differentiation	16175	11378		0.05747126436781609	0.06818181818181818	80	16095	10	9	70	16086	16175	0.2548646637440749
M1	cpdb	0	network_modules	296	TRUE	9.854491318794369e-16	84	19	10	0.5263157894736842	0.11904761904761904	GO:2000781	GO:BP	positive regulation of double-strand break repair	16175	26037		0.06896551724137931	0.07954545454545454	84	16091	10	9	74	16082	16175	0.24863536826200072
M1	cpdb	0	network_modules	296	TRUE	1.2625112720000058e-15	86	19	10	0.5263157894736842	0.11627906976744186	GO:0030071	GO:BP	regulation of mitotic metaphase/anaphase transition	16175	6671		0.08045977011494253	0.09090909090909091	86	16089	10	9	76	16080	16175	0.24568421701125104
M1	cpdb	0	network_modules	296	TRUE	1.5702399447931519e-15	217	19	12	0.631578947368421	0.055299539170506916	GO:0000819	GO:BP	sister chromatid segregation	16175	237		0.09195402298850575	0.10227272727272728	217	15958	12	7	205	15951	16175	0.18426302867992575
M1	cpdb	0	network_modules	296	TRUE	1.6077197484540271e-15	88	19	10	0.5263157894736842	0.11363636363636363	GO:1902099	GO:BP	regulation of metaphase/anaphase transition of cell cycle	16175	22013		0.10344827586206896	0.11363636363636363	88	16087	10	9	78	16078	16175	0.24283375746210606
M1	cpdb	0	network_modules	296	TRUE	2.0355614758932245e-15	90	19	10	0.5263157894736842	0.1111111111111111	GO:0007091	GO:BP	metaphase/anaphase transition of mitotic cell cycle	16175	2675		0.11494252873563218	0.125	90	16085	10	9	80	16076	16175	0.2400783693568802
M1	cpdb	0	network_modules	296	TRUE	2.563143750356582e-15	92	19	10	0.5263157894736842	0.10869565217391304	GO:0044784	GO:BP	metaphase/anaphase transition of cell cycle	16175	11156		0.12643678160919541	0.13636363636363635	92	16083	10	9	82	16074	16175	0.237412862264308
M1	cpdb	0	network_modules	296	TRUE	5.51821895096238e-15	99	19	10	0.5263157894736842	0.10101010101010101	GO:0033045	GO:BP	regulation of sister chromatid segregation	16175	8000		0.13793103448275862	0.14772727272727273	99	16076	10	9	89	16067	16175	0.22872515976376964
M1	cpdb	0	network_modules	296	TRUE	7.32059239633443e-15	59	19	9	0.47368421052631576	0.15254237288135594	GO:0045661	GO:BP	regulation of myoblast differentiation	16175	11512		0.14942528735632185	0.1590909090909091	59	16116	9	10	50	16106	16175	0.2673814131464569
M1	cpdb	0	network_modules	296	TRUE	8.941344669091243e-15	361	19	13	0.6842105263157895	0.036011080332409975	GO:0007059	GO:BP	chromosome segregation	16175	2658		0.16091954022988506	0.17045454545454544	361	15814	13	6	348	15808	16175	0.15366215484649293
M1	cpdb	0	network_modules	296	TRUE	1.8296596246879418e-14	529	19	14	0.7368421052631579	0.026465028355387523	GO:0006325	GO:BP	chromatin organization	16175	2122		0.1724137931034483	0.18181818181818182	529	15646	14	5	515	15641	16175	0.1357631880829051
M1	cpdb	0	network_modules	296	TRUE	3.070415053099535e-14	277	19	12	0.631578947368421	0.04332129963898917	GO:0098813	GO:BP	nuclear chromosome segregation	16175	18900		0.1839080459770115	0.19318181818181818	277	15898	12	7	265	15891	16175	0.1624172821046681
M1	cpdb	0	network_modules	296	TRUE	4.588407585035718e-14	78	15	9	0.6	0.11538461538461539	REAC:R-HSA-3214858	REAC	RMTs methylate histone arginines	10916	1878		0.25	0.4	78	10838	9	6	69	10832	10916	0.26109722216857006
M1	cpdb	0	network_modules	296	TRUE	5.706717768629844e-14	124	19	10	0.5263157894736842	0.08064516129032258	GO:0051983	GO:BP	regulation of chromosome segregation	16175	14045		0.19540229885057472	0.20454545454545456	124	16051	10	9	114	16042	16175	0.20392306814339864
M1	cpdb	0	network_modules	296	TRUE	7.30239574243921e-14	127	19	10	0.5263157894736842	0.07874015748031496	GO:0045739	GO:BP	positive regulation of DNA repair	16175	11579		0.20689655172413793	0.2159090909090909	127	16048	10	9	117	16039	16175	0.2014469029683226
M1	cpdb	0	network_modules	296	TRUE	7.917208795705956e-14	128	19	10	0.5263157894736842	0.078125	GO:2000779	GO:BP	regulation of double-strand break repair	16175	26035		0.21839080459770116	0.22727272727272727	128	16047	10	9	118	16038	16175	0.2006407820798444
M1	cpdb	0	network_modules	296	TRUE	1.7820735920833757e-13	454	19	13	0.6842105263157895	0.028634361233480177	GO:0006338	GO:BP	chromatin remodeling	16175	2126		0.22988505747126436	0.23863636363636365	454	15721	13	6	441	15715	16175	0.13623363342033132
M1	cpdb	0	network_modules	296	TRUE	2.140746556863764e-13	141	19	10	0.5263157894736842	0.07092198581560284	GO:2000045	GO:BP	regulation of G1/S transition of mitotic cell cycle	16175	25406		0.2413793103448276	0.25	141	16034	10	9	131	16025	16175	0.19094873807450308
M1	cpdb	0	network_modules	296	TRUE	2.6389550451610024e-13	86	19	9	0.47368421052631576	0.10465116279069768	GO:0045582	GO:BP	positive regulation of T cell differentiation	16175	11433		0.25287356321839083	0.26136363636363635	86	16089	9	10	77	16079	16175	0.22086507207784659
M1	cpdb	0	network_modules	296	TRUE	3.329757331558085e-13	229	19	11	0.5789473684210527	0.048034934497816595	GO:0033044	GO:BP	regulation of chromosome organization	16175	7999		0.26436781609195403	0.2727272727272727	229	15946	11	8	218	15938	16175	0.16394467988665637
M1	cpdb	0	network_modules	296	TRUE	9.861824073797927e-13	99	19	9	0.47368421052631576	0.09090909090909091	GO:0045621	GO:BP	positive regulation of lymphocyte differentiation	16175	11472		0.27586206896551724	0.2840909090909091	99	16076	9	10	90	16066	16175	0.2055835284332492
M1	cpdb	0	network_modules	296	TRUE	1.1368430348358368e-12	166	19	10	0.5263157894736842	0.060240963855421686	GO:1902806	GO:BP	regulation of cell cycle G1/S phase transition	16175	22525		0.28735632183908044	0.29545454545454547	166	16009	10	9	156	16000	16175	0.17559508701301513
M1	cpdb	0	network_modules	296	TRUE	3.820279446107381e-12	187	19	10	0.5263157894736842	0.053475935828877004	GO:0000082	GO:BP	G1/S transition of mitotic cell cycle	16175	31		0.2988505747126437	0.3068181818181818	187	15988	10	9	177	15979	16175	0.16513405581397994
M1	cpdb	0	network_modules	296	TRUE	5.963570559126053e-12	297	19	11	0.5789473684210527	0.037037037037037035	GO:0030098	GO:BP	lymphocyte differentiation	16175	6676		0.3103448275862069	0.3181818181818182	297	15878	11	8	286	15870	16175	0.1431924298026651
M1	cpdb	0	network_modules	296	TRUE	6.189286241576184e-12	298	19	11	0.5789473684210527	0.03691275167785235	GO:0006302	GO:BP	double-strand break repair	16175	2109		0.3218390804597701	0.32954545454545453	298	15877	11	8	287	15869	16175	0.14294070808365286
M1	cpdb	0	network_modules	296	TRUE	1.0699830722110166e-11	207	19	10	0.5263157894736842	0.04830917874396135	GO:0006282	GO:BP	regulation of DNA repair	16175	2096		0.3333333333333333	0.3409090909090909	207	15968	10	9	197	15959	16175	0.15667497210166537
M1	cpdb	0	network_modules	296	TRUE	1.1480249093121633e-11	129	19	9	0.47368421052631576	0.06976744186046512	GO:0045580	GO:BP	regulation of T cell differentiation	16175	11431		0.3448275862068966	0.3522727272727273	129	16046	9	10	120	16036	16175	0.1795521018989735
M1	cpdb	0	network_modules	296	TRUE	1.497753048432767e-11	214	19	10	0.5263157894736842	0.04672897196261682	GO:0044843	GO:BP	cell cycle G1/S phase transition	16175	11189		0.3563218390804598	0.36363636363636365	214	15961	10	9	204	15952	16175	0.15399512407219085
M1	cpdb	0	network_modules	296	TRUE	2.2827078712670828e-11	139	19	9	0.47368421052631576	0.06474820143884892	GO:1903708	GO:BP	positive regulation of hemopoiesis	16175	23222		0.367816091954023	0.38636363636363635	139	16036	9	10	130	16026	16175	0.17279708065153754
M1	cpdb	0	network_modules	296	TRUE	2.2827078712670828e-11	139	19	9	0.47368421052631576	0.06474820143884892	GO:1902107	GO:BP	positive regulation of leukocyte differentiation	16175	22021		0.367816091954023	0.38636363636363635	139	16036	9	10	130	16026	16175	0.17279708065153754
M1	cpdb	0	network_modules	296	TRUE	2.608638628412692e-11	41	19	7	0.3684210526315789	0.17073170731707318	GO:1902459	GO:BP	positive regulation of stem cell population maintenance	16175	22297		0.39080459770114945	0.3977272727272727	41	16134	7	12	34	16122	16175	0.24953836985121505
M1	cpdb	0	network_modules	296	TRUE	3.967421660016224e-11	19	19	6	0.3157894736842105	0.3157894736842105	GO:0006337	GO:BP	nucleosome disassembly	16175	2125		0.40229885057471265	0.4090909090909091	19	16156	6	13	13	16143	16175	0.3149848190667309
M1	cpdb	0	network_modules	296	TRUE	4.5323413532702095e-11	357	19	11	0.5789473684210527	0.03081232492997199	GO:1903131	GO:BP	mononuclear cell differentiation	16175	22787		0.41379310344827586	0.42045454545454547	357	15818	11	8	346	15810	16175	0.1299879176354096
M1	cpdb	0	network_modules	296	TRUE	5.185088730620167e-11	152	19	9	0.47368421052631576	0.05921052631578947	GO:0045619	GO:BP	regulation of lymphocyte differentiation	16175	11470		0.42528735632183906	0.4318181818181818	152	16023	9	10	143	16013	16175	0.16502394840797058
M1	cpdb	0	network_modules	296	TRUE	6.105968162839054e-11	246	19	10	0.5263157894736842	0.04065040650406504	GO:0051054	GO:BP	positive regulation of DNA metabolic process	16175	13464		0.4367816091954023	0.4431818181818182	246	15929	10	9	236	15920	16175	0.14322020824222303
M1	cpdb	0	network_modules	296	TRUE	6.386297149868027e-11	271	15	10	0.6666666666666666	0.03690036900369004	REAC:R-HSA-4839726	REAC	Chromatin organization	10916	356		0.5	0.8	271	10645	10	5	261	10640	10916	0.15301914706179504
M1	cpdb	0	network_modules	296	TRUE	6.386297149868027e-11	271	15	10	0.6666666666666666	0.03690036900369004	REAC:R-HSA-3247509	REAC	Chromatin modifying enzymes	10916	355		0.5	0.8	271	10645	10	5	261	10640	10916	0.15301914706179504
M1	cpdb	0	network_modules	296	TRUE	7.923904638841512e-11	21	19	6	0.3157894736842105	0.2857142857142857	GO:0032986	GO:BP	protein-DNA complex disassembly	16175	7966		0.4482758620689655	0.45454545454545453	21	16154	6	13	15	16141	16175	0.2995111140022997
M1	cpdb	0	network_modules	296	TRUE	1.0437290325213967e-10	545	19	12	0.631578947368421	0.022018348623853212	GO:0051276	GO:BP	chromosome organization	16175	13613		0.45977011494252873	0.4659090909090909	545	15630	12	7	533	15623	16175	0.11363027747439831
M1	cpdb	0	network_modules	296	TRUE	2.7703463013111e-10	286	19	10	0.5263157894736842	0.03496503496503497	GO:1901990	GO:BP	regulation of mitotic cell cycle phase transition	16175	21923		0.47126436781609193	0.4772727272727273	286	15889	10	9	276	15880	16175	0.13235136095449365
M1	cpdb	0	network_modules	296	TRUE	3.854350035882376e-10	434	19	11	0.5789473684210527	0.02534562211981567	GO:0002521	GO:BP	leukocyte differentiation	16175	1043		0.4827586206896552	0.48863636363636365	434	15741	11	8	423	15733	16175	0.11717186675844048
M1	cpdb	0	network_modules	296	TRUE	3.912341075033017e-10	59	19	7	0.3684210526315789	0.11864406779661017	GO:2000036	GO:BP	regulation of stem cell population maintenance	16175	25399		0.4942528735632184	0.5	59	16116	7	12	52	16104	16175	0.20750222174097224
M1	cpdb	0	network_modules	296	TRUE	3.952509143082446e-10	435	19	11	0.5789473684210527	0.02528735632183908	GO:0051052	GO:BP	regulation of DNA metabolic process	16175	13462		0.5057471264367817	0.5113636363636364	435	15740	11	8	424	15732	16175	0.11702772094512903
M1	cpdb	0	network_modules	296	TRUE	5.028661313369419e-10	195	19	9	0.47368421052631576	0.046153846153846156	GO:0050870	GO:BP	positive regulation of T cell activation	16175	13318		0.5172413793103449	0.5227272727272727	195	15980	9	10	186	15970	16175	0.14505782215601118
M1	cpdb	0	network_modules	296	TRUE	6.772747345313886e-10	638	19	12	0.631578947368421	0.018808777429467086	GO:0030097	GO:BP	hemopoiesis	16175	6675		0.5287356321839081	0.5340909090909091	638	15537	12	7	626	15530	16175	0.10432328230226869
M1	cpdb	0	network_modules	296	TRUE	8.273056418696985e-10	206	19	9	0.47368421052631576	0.043689320388349516	GO:0030217	GO:BP	T cell differentiation	16175	6725		0.5402298850574713	0.5454545454545454	206	15969	9	10	197	15959	16175	0.14097240530671398
M1	cpdb	0	network_modules	296	TRUE	8.701041201265755e-10	166	18	9	0.5	0.05421686746987952	KEGG:05225	KEGG	Hepatocellular carcinoma	8484	476		0.5	0.6666666666666666	166	8318	9	9	157	8309	8484	0.1599439413698455
M1	cpdb	0	network_modules	296	TRUE	1.1543085117326775e-9	234	15	9	0.6	0.038461538461538464	REAC:R-HSA-8878171	REAC	Transcriptional regulation by RUNX1	10916	2552		1	1	234	10682	9	6	225	10676	10916	0.1481811156513572
M1	cpdb	0	network_modules	296	TRUE	1.218634441171764e-9	215	19	9	0.47368421052631576	0.04186046511627907	GO:1903039	GO:BP	positive regulation of leukocyte cell-cell adhesion	16175	22719		0.5517241379310345	0.5568181818181818	215	15960	9	10	206	15950	16175	0.13786256369928174
M1	cpdb	0	network_modules	296	TRUE	2.072136811010244e-9	228	19	9	0.47368421052631576	0.039473684210526314	GO:1902105	GO:BP	regulation of leukocyte differentiation	16175	22019		0.5632183908045977	0.5681818181818182	228	15947	9	10	219	15937	16175	0.13369534616538944
M1	cpdb	0	network_modules	296	TRUE	3.261942995038127e-9	528	19	11	0.5789473684210527	0.020833333333333332	GO:0006281	GO:BP	DNA repair	16175	2095		0.5747126436781609	0.5795454545454546	528	15647	11	8	517	15639	16175	0.10542809618098858
M1	cpdb	0	network_modules	296	TRUE	3.6135514325285958e-9	370	19	10	0.5263157894736842	0.02702702702702703	GO:0044772	GO:BP	mitotic cell cycle phase transition	16175	11148		0.5862068965517241	0.5909090909090909	370	15805	10	9	360	15796	16175	0.11547942742913683
M1	cpdb	0	network_modules	296	TRUE	4.239436615874948e-9	376	19	10	0.5263157894736842	0.026595744680851064	GO:1901987	GO:BP	regulation of cell cycle phase transition	16175	21920		0.5977011494252874	0.6022727272727273	376	15799	10	9	366	15790	16175	0.11449167244828895
M1	cpdb	0	network_modules	296	TRUE	4.587598092174881e-9	249	19	9	0.47368421052631576	0.03614457831325301	GO:0051251	GO:BP	positive regulation of lymphocyte activation	16175	13598		0.6091954022988506	0.6136363636363636	249	15926	9	10	240	15916	16175	0.1276561077667574
M1	cpdb	0	network_modules	296	TRUE	6.098596813215089e-9	257	19	9	0.47368421052631576	0.03501945525291829	GO:0022409	GO:BP	positive regulation of cell-cell adhesion	16175	6600		0.6206896551724138	0.625	257	15918	9	10	248	15908	16175	0.1255494656910733
M1	cpdb	0	network_modules	296	TRUE	7.340397136752466e-9	569	19	11	0.5789473684210527	0.019332161687170474	GO:0046649	GO:BP	lymphocyte activation	16175	12286		0.632183908045977	0.6363636363636364	569	15606	11	8	558	15598	16175	0.10122019678301937
M1	cpdb	0	network_modules	296	TRUE	9.487509904141306e-9	798	19	12	0.631578947368421	0.015037593984962405	GO:0006974	GO:BP	DNA damage response	16175	2601		0.6436781609195402	0.6477272727272727	798	15377	12	7	786	15370	16175	0.09219802188130966
M1	cpdb	0	network_modules	296	TRUE	1.1009185795912906e-8	414	19	10	0.5263157894736842	0.024154589371980676	GO:0061061	GO:BP	muscle structure development	16175	15177		0.6551724137931034	0.6590909090909091	414	15761	10	9	404	15752	16175	0.10873207821514819
M1	cpdb	0	network_modules	296	TRUE	1.1206876362418827e-8	275	19	9	0.47368421052631576	0.03272727272727273	GO:0002696	GO:BP	positive regulation of leukocyte activation	16175	1214		0.6666666666666666	0.6704545454545454	275	15900	9	10	266	15890	16175	0.12114452325301737
M1	cpdb	0	network_modules	296	TRUE	1.4495971830193782e-8	283	19	9	0.47368421052631576	0.03180212014134275	GO:0010720	GO:BP	positive regulation of cell development	16175	4346		0.6781609195402298	0.6818181818181818	283	15892	9	10	274	15882	16175	0.11932064698671149
M1	cpdb	0	network_modules	296	TRUE	1.4947505233411453e-8	427	19	10	0.5263157894736842	0.0234192037470726	GO:0007346	GO:BP	regulation of mitotic cell cycle	16175	2855		0.6896551724137931	0.6931818181818182	427	15748	10	9	417	15739	16175	0.1069363742601984
M1	cpdb	0	network_modules	296	TRUE	1.4961934204299024e-8	284	19	9	0.47368421052631576	0.03169014084507042	GO:0050863	GO:BP	regulation of T cell activation	16175	13311		0.7011494252873564	0.7045454545454546	284	15891	9	10	275	15881	16175	0.11909799518903008
M1	cpdb	0	network_modules	296	TRUE	1.644035087882297e-8	287	19	9	0.47368421052631576	0.0313588850174216	GO:1903037	GO:BP	regulation of leukocyte cell-cell adhesion	16175	22717		0.7126436781609196	0.7159090909090909	287	15888	9	10	278	15878	16175	0.11843690253733974
M1	cpdb	0	network_modules	296	TRUE	1.663330711214545e-8	99	19	7	0.3684210526315789	0.0707070707070707	GO:0019827	GO:BP	stem cell population maintenance	16175	6046		0.7241379310344828	0.7272727272727273	99	16076	7	12	92	16064	16175	0.1593002657722083
M1	cpdb	0	network_modules	296	TRUE	1.787361339497987e-8	100	19	7	0.3684210526315789	0.07	GO:0098727	GO:BP	maintenance of cell number	16175	18856		0.735632183908046	0.7386363636363636	100	16075	7	12	93	16063	16175	0.15847964521279279
M1	cpdb	0	network_modules	296	TRUE	1.8046581296177926e-8	290	19	9	0.47368421052631576	0.03103448275862069	GO:0050867	GO:BP	positive regulation of cell activation	16175	13315		0.7471264367816092	0.75	290	15885	9	10	281	15875	16175	0.11778589718696697
M1	cpdb	0	network_modules	296	TRUE	1.87896616280623e-8	437	19	10	0.5263157894736842	0.02288329519450801	GO:0080135	GO:BP	regulation of cellular response to stress	16175	17817		0.7586206896551724	0.7613636363636364	437	15738	10	9	427	15729	16175	0.10560857688508425
M1	cpdb	0	network_modules	296	TRUE	2.207644310463815e-8	630	19	11	0.5789473684210527	0.01746031746031746	GO:0010564	GO:BP	regulation of cell cycle process	16175	4217		0.7701149425287356	0.7727272727272727	630	15545	11	8	619	15537	16175	0.09571521539545585
M1	cpdb	0	network_modules	296	TRUE	3.185334317961709e-8	309	19	9	0.47368421052631576	0.02912621359223301	GO:1903706	GO:BP	regulation of hemopoiesis	16175	23220		0.7816091954022989	0.7840909090909091	309	15866	9	10	300	15856	16175	0.11388123115049636
M1	cpdb	0	network_modules	296	TRUE	3.41460436886682e-8	656	19	11	0.5789473684210527	0.01676829268292683	GO:1903047	GO:BP	mitotic cell cycle process	16175	22727		0.7931034482758621	0.7954545454545454	656	15519	11	8	645	15511	16175	0.09359833770202733
M1	cpdb	0	network_modules	296	TRUE	3.467877678626756e-8	465	19	10	0.5263157894736842	0.021505376344086023	GO:0044770	GO:BP	cell cycle phase transition	16175	11146		0.8045977011494253	0.8068181818181818	465	15710	10	9	455	15701	16175	0.10211553037754621
M1	cpdb	0	network_modules	296	TRUE	4.8655759813097044e-8	324	19	9	0.47368421052631576	0.027777777777777776	GO:0007159	GO:BP	leukocyte cell-cell adhesion	16175	2723		0.8160919540229885	0.8181818181818182	324	15851	9	10	315	15841	16175	0.11103947571990842
M1	cpdb	0	network_modules	296	TRUE	6.762718748058831e-8	699	19	11	0.5789473684210527	0.015736766809728183	GO:0045321	GO:BP	leukocyte activation	16175	11356		0.8275862068965517	0.8295454545454546	699	15476	11	8	688	15468	16175	0.09035126501701625
M1	cpdb	0	network_modules	296	TRUE	1.5501659484918994e-7	369	19	9	0.47368421052631576	0.024390243902439025	GO:0051249	GO:BP	regulation of lymphocyte activation	16175	13596		0.8390804597701149	0.8409090909090909	369	15806	9	10	360	15796	16175	0.10355772885168978
M1	cpdb	0	network_modules	296	TRUE	1.7060684467038592e-7	373	19	9	0.47368421052631576	0.024128686327077747	GO:0045785	GO:BP	positive regulation of cell adhesion	16175	11617		0.8505747126436781	0.8522727272727273	373	15802	9	10	364	15792	16175	0.10295749702780115
M1	cpdb	0	network_modules	296	TRUE	2.312767575619382e-7	386	19	9	0.47368421052631576	0.023316062176165803	GO:0022407	GO:BP	regulation of cell-cell adhesion	16175	6598		0.8620689655172413	0.8636363636363636	386	15789	9	10	377	15779	16175	0.10106997989064474
M1	cpdb	0	network_modules	296	TRUE	2.581184322502401e-7	792	19	11	0.5789473684210527	0.013888888888888888	GO:0000278	GO:BP	mitotic cell cycle	16175	76		0.8735632183908046	0.875	792	15383	11	8	781	15375	16175	0.08422343075856192
M1	cpdb	0	network_modules	296	TRUE	3.619692869724059e-7	406	19	9	0.47368421052631576	0.022167487684729065	GO:0042110	GO:BP	T cell activation	16175	9970		0.8850574712643678	0.8863636363636364	406	15769	9	10	397	15759	16175	0.09834054443326586
M1	cpdb	0	network_modules	296	TRUE	4.990732112220164e-7	421	19	9	0.47368421052631576	0.021377672209026127	GO:0002694	GO:BP	regulation of leukocyte activation	16175	1212		0.896551724137931	0.8977272727272727	421	15754	9	10	412	15744	16175	0.09641896983214299
M1	cpdb	0	network_modules	296	TRUE	5.892985008479695e-7	232	18	8	0.4444444444444444	0.034482758620689655	KEGG:04714	KEGG	Thermogenesis	8484	349		1	1	232	8252	8	10	224	8242	8484	0.11792697910880041
M1	cpdb	0	network_modules	296	TRUE	1.2705572772449408e-6	468	19	9	0.47368421052631576	0.019230769230769232	GO:0050865	GO:BP	regulation of cell activation	16175	13313		0.9080459770114943	0.9090909090909091	468	15707	9	10	459	15697	16175	0.09099158523019826
M1	cpdb	0	network_modules	296	TRUE	2.348960966741257e-6	106	19	6	0.3157894736842105	0.05660377358490566	GO:0034728	GO:BP	nucleosome organization	16175	8723		0.9195402298850575	0.9204545454545454	106	16069	6	13	100	16056	16175	0.13143077480252083
M1	cpdb	0	network_modules	296	TRUE	7.278345295466321e-6	571	19	9	0.47368421052631576	0.01576182136602452	GO:0060284	GO:BP	regulation of cell development	16175	14500		0.9310344827586207	0.9318181818181818	571	15604	9	10	562	15594	16175	0.08146511373031824
M1	cpdb	0	network_modules	296	TRUE	1.3905874632519537e-5	615	19	9	0.47368421052631576	0.014634146341463415	GO:0045597	GO:BP	positive regulation of cell differentiation	16175	11448		0.9425287356321839	0.9431818181818182	615	15560	9	10	606	15550	16175	0.07811996942155391
M1	cpdb	0	network_modules	296	TRUE	1.534539312280139e-5	622	19	9	0.47368421052631576	0.014469453376205787	GO:0030155	GO:BP	regulation of cell adhesion	16175	6688		0.9540229885057471	0.9545454545454546	622	15553	9	10	613	15543	16175	0.07761944238473399
M1	cpdb	0	network_modules	296	TRUE	7.322594225955115e-5	745	19	9	0.47368421052631576	0.012080536912751677	GO:0098609	GO:BP	cell-cell adhesion	16175	18805		0.9655172413793104	0.9659090909090909	745	15430	9	10	736	15420	16175	0.06996110184302087
M1	cpdb	0	network_modules	296	TRUE	1.2669679149021696e-4	206	19	6	0.3157894736842105	0.02912621359223301	GO:0071824	GO:BP	protein-DNA complex organization	16175	16927		0.9770114942528736	0.9772727272727273	206	15969	6	13	200	15956	16175	0.09268327867688433
M1	cpdb	0	network_modules	296	TRUE	1.6323900156224743e-4	215	19	6	0.3157894736842105	0.027906976744186046	GO:0032984	GO:BP	protein-containing complex disassembly	16175	7964		0.9885057471264368	0.9886363636363636	215	15960	6	13	209	15947	16175	0.09058161873138544
M1	cpdb	0	network_modules	296	TRUE	0.004171872185112543	374	19	6	0.3157894736842105	0.016042780748663103	GO:0022411	GO:BP	cellular component disassembly	16175	6602		1	1	374	15801	6	13	368	15788	16175	0.06678061085203091
M1	cpdb	0	network_modules	297	TRUE	2.843362927601591e-12	71	17	8	0.47058823529411764	0.11267605633802817	GO:0045109	GO:BP	intermediate filament organization	16175	11280		0	0.08333333333333333	71	16104	8	9	63	16095	16175	0.22874414851075478
M1	cpdb	0	network_modules	297	TRUE	1.0791512545760192e-11	128	16	9	0.5625	0.0703125	REAC:R-HSA-6809371	REAC	Formation of the cornified envelope	10916	969		0	0.5	128	10788	9	7	119	10781	10916	0.19602358142998985
M1	cpdb	0	network_modules	297	TRUE	1.2772411710297825e-11	85	17	8	0.47058823529411764	0.09411764705882353	GO:0045104	GO:BP	intermediate filament cytoskeleton organization	16175	11275		0.09090909090909091	0.16666666666666666	85	16090	8	9	77	16081	16175	0.20876203114234426
M1	cpdb	0	network_modules	297	TRUE	1.407540755769989e-11	86	17	8	0.47058823529411764	0.09302325581395349	GO:0045103	GO:BP	intermediate filament-based process	16175	11274		0.18181818181818182	0.25	86	16089	8	9	78	16080	16175	0.20752362415430314
M1	cpdb	0	network_modules	297	TRUE	6.125225184089135e-10	231	17	9	0.5294117647058824	0.03896103896103896	GO:0008544	GO:BP	epidermis development	16175	3192		0.2727272727272727	0.3333333333333333	231	15944	9	8	222	15936	16175	0.14082752653540748
M1	cpdb	0	network_modules	297	TRUE	1.228220414591244e-9	215	16	9	0.5625	0.04186046511627907	REAC:R-HSA-6805567	REAC	Keratinization	10916	1288		1	1	215	10701	9	7	206	10694	10916	0.14966560628926576
M1	cpdb	0	network_modules	297	TRUE	3.3839974127450288e-9	168	17	8	0.47058823529411764	0.047619047619047616	GO:0043588	GO:BP	skin development	16175	10792		0.36363636363636365	0.4166666666666667	168	16007	8	9	160	15998	16175	0.1472358887790649
M1	cpdb	0	network_modules	297	TRUE	7.942234446340139e-6	22	17	4	0.23529411764705882	0.18181818181818182	GO:0018149	GO:BP	peptide cross-linking	16175	5337		0.45454545454545453	0.5	22	16153	4	13	18	16140	16175	0.2058876738254677
M1	cpdb	0	network_modules	297	TRUE	9.279900062996465e-6	454	17	8	0.47058823529411764	0.01762114537444934	GO:0030855	GO:BP	epithelial cell differentiation	16175	6938		0.5454545454545454	0.5833333333333334	454	15721	8	9	446	15712	16175	0.08690406001064936
M1	cpdb	0	network_modules	297	TRUE	1.1997285199409505e-5	701	17	9	0.5294117647058824	0.012838801711840228	GO:0060429	GO:BP	epithelium development	16175	14627		0.6363636363636364	0.6666666666666666	701	15474	9	8	692	15466	16175	0.07743127141699015
M1	cpdb	0	network_modules	297	TRUE	3.731969852635454e-5	86	8	4	0.5	0.046511627906976744	KEGG:05150	KEGG	Staphylococcus aureus infection	8484	439		0	0.5	86	8398	4	4	82	8394	8484	0.15024080350644717
M1	cpdb	0	network_modules	297	TRUE	6.925674921805332e-5	102	17	5	0.29411764705882354	0.049019607843137254	GO:0030216	GO:BP	keratinocyte differentiation	16175	6724		0.7272727272727273	0.75	102	16073	5	12	97	16061	16175	0.11793282794818509
M1	cpdb	0	network_modules	297	TRUE	2.350845799422614e-4	136	8	4	0.5	0.029411764705882353	KEGG:04915	KEGG	Estrogen signaling pathway	8484	372		1	1	136	8348	4	4	132	8344	8484	0.11838802897879427
M1	cpdb	0	network_modules	297	TRUE	3.6342767339753396e-4	142	17	5	0.29411764705882354	0.035211267605633804	GO:0009913	GO:BP	epidermal cell differentiation	16175	3769		0.8181818181818182	0.8333333333333334	142	16033	5	12	137	16021	16175	0.099216524056516
M1	cpdb	0	network_modules	297	TRUE	4.4446335336173373e-4	748	17	8	0.47058823529411764	0.0106951871657754	GO:0097435	GO:BP	supramolecular fiber organization	16175	18657		0.9090909090909091	0.9166666666666666	748	15427	8	9	740	15418	16175	0.06553925605055536
M1	cpdb	0	network_modules	297	TRUE	0.006789001328837138	33	17	3	0.17647058823529413	0.09090909090909091	GO:0031424	GO:BP	keratinization	16175	7162		1	1	33	16142	3	14	30	16128	16175	0.12538959230205957
M1	cpdb	0	network_modules	298	TRUE	4.462287220508816e-27	10	19	10	0.5263157894736842	1	REAC:R-HSA-2470946	REAC	Cohesin Loading onto Chromatin	10916	383		0	0.05555555555555555	10	10906	10	9	0	10897	10916	0.7251768445601289
M1	cpdb	0	network_modules	298	TRUE	1.2733437805857747e-24	13	19	10	0.5263157894736842	0.7692307692307693	REAC:R-HSA-68884	REAC	Mitotic Telophase/Cytokinesis	10916	1487		0.058823529411764705	0.1111111111111111	13	10903	10	9	3	10894	10916	0.635776926740808
M1	cpdb	0	network_modules	298	TRUE	2.672443162020253e-22	11	19	9	0.47368421052631576	0.8181818181818182	REAC:R-HSA-2468052	REAC	Establishment of Sister Chromatid Cohesion	10916	864		0.11764705882352941	0.16666666666666666	11	10905	9	10	2	10895	10916	0.6220734981228236
M1	cpdb	0	network_modules	298	TRUE	7.351349797801751e-21	29	19	10	0.5263157894736842	0.3448275862068966	GO:0007064	GO:BP	mitotic sister chromatid cohesion	16175	2662		0	0.05	29	16146	10	9	19	16137	16175	0.4251940196806911
M1	cpdb	0	network_modules	298	TRUE	1.5428943502599526e-20	53	19	11	0.5789473684210527	0.20754716981132076	GO:0007062	GO:BP	sister chromatid cohesion	16175	2660		0.05263157894736842	0.1	53	16122	11	8	42	16114	16175	0.3454465862103827
M1	cpdb	0	network_modules	298	TRUE	1.420740080486745e-16	10	19	7	0.3684210526315789	0.7	GO:0034085	GO:BP	establishment of sister chromatid cohesion	16175	8396		0.10526315789473684	0.15	10	16165	7	12	3	16153	16175	0.5074361010514074
M1	cpdb	0	network_modules	298	TRUE	1.2267703304005173e-15	157	14	11	0.7857142857142857	0.07006369426751592	KEGG:04110	KEGG	Cell cycle	8484	264		NA	1	157	8327	11	3	146	8324	8484	0.2314421609836895
M1	cpdb	0	network_modules	298	TRUE	1.03209169592889e-14	7	19	6	0.3157894736842105	0.8571428571428571	GO:0034087	GO:BP	establishment of mitotic sister chromatid cohesion	16175	8398		0.15789473684210525	0.2	7	16168	6	13	1	16155	16175	0.5199709361923531
M1	cpdb	0	network_modules	298	TRUE	6.147655416391372e-13	123	19	10	0.5263157894736842	0.08130081300813008	REAC:R-HSA-2500257	REAC	Resolution of Sister Chromatid Cohesion	10916	2079		0.17647058823529413	0.2222222222222222	123	10793	10	9	113	10784	10916	0.203756208320074
M1	cpdb	0	network_modules	298	TRUE	4.647331883507292e-11	188	19	10	0.5263157894736842	0.05319148936170213	REAC:R-HSA-2467813	REAC	Separation of Sister Chromatids	10916	2204		0.23529411764705882	0.2777777777777778	188	10728	10	9	178	10719	10916	0.1633977156876276
M1	cpdb	0	network_modules	298	TRUE	7.571973114713218e-11	406	19	12	0.631578947368421	0.029556650246305417	REAC:R-HSA-68886	REAC	M Phase	10916	1343		0.29411764705882354	0.3333333333333333	406	10510	12	7	394	10503	10916	0.13115683538719036
M1	cpdb	0	network_modules	298	TRUE	8.250125673166454e-11	199	19	10	0.5263157894736842	0.05025125628140704	REAC:R-HSA-68877	REAC	Mitotic Prometaphase	10916	1484		0.35294117647058826	0.3888888888888889	199	10717	10	9	189	10708	10916	0.1585844657706742
M1	cpdb	0	network_modules	298	TRUE	1.0437290325213967e-10	545	19	12	0.631578947368421	0.022018348623853212	GO:0051276	GO:BP	chromosome organization	16175	13613		0.21052631578947367	0.25	545	15630	12	7	533	15623	16175	0.11363027747439831
M1	cpdb	0	network_modules	298	TRUE	3.2400460859402155e-10	228	19	10	0.5263157894736842	0.043859649122807015	REAC:R-HSA-68882	REAC	Mitotic Anaphase	10916	1479		0.4117647058823529	0.4444444444444444	228	10688	10	9	218	10679	10916	0.1475813157806478
M1	cpdb	0	network_modules	298	TRUE	3.3854079258626896e-10	229	19	10	0.5263157894736842	0.043668122270742356	REAC:R-HSA-2555396	REAC	Mitotic Metaphase and Anaphase	10916	1482		0.47058823529411764	0.5	229	10687	10	9	219	10678	10916	0.1472389309537947
M1	cpdb	0	network_modules	298	TRUE	7.239771252900151e-10	162	19	9	0.47368421052631576	0.05555555555555555	REAC:R-HSA-69242	REAC	S Phase	10916	2111		0.5294117647058824	0.5555555555555556	162	10754	9	10	153	10744	10916	0.15845611955289807
M1	cpdb	0	network_modules	298	TRUE	3.41460436886682e-8	656	19	11	0.5789473684210527	0.01676829268292683	GO:1903047	GO:BP	mitotic cell cycle process	16175	22727		0.2631578947368421	0.3	656	15519	11	8	645	15511	16175	0.09359833770202733
M1	cpdb	0	network_modules	298	TRUE	2.581184322502401e-7	792	19	11	0.5789473684210527	0.013888888888888888	GO:0000278	GO:BP	mitotic cell cycle	16175	76		0.3157894736842105	0.35	792	15383	11	8	781	15375	16175	0.08422343075856192
M1	cpdb	0	network_modules	298	TRUE	7.4221308769939816e-6	4	19	3	0.15789473684210525	0.75	GO:0034089	GO:BP	establishment of meiotic sister chromatid cohesion	16175	8400		0.3684210526315789	0.4	4	16171	3	16	1	16155	16175	0.3438291238544239
M1	cpdb	0	network_modules	298	TRUE	3.7370058439696126e-5	72	19	5	0.2631578947368421	0.06944444444444445	REAC:R-HSA-3108214	REAC	SUMOylation of DNA damage response and repair proteins	10916	2168		0.5882352941176471	0.6111111111111112	72	10844	5	14	67	10830	10916	0.13234828068194476
M1	cpdb	0	network_modules	298	TRUE	4.913311012742477e-5	76	19	5	0.2631578947368421	0.06578947368421052	REAC:R-HSA-1221632	REAC	Meiotic synapsis	10916	1412		0.6470588235294118	0.6666666666666666	76	10840	5	14	71	10826	10916	0.1286581034245885
M1	cpdb	0	network_modules	298	TRUE	5.314411343353835e-5	178	19	6	0.3157894736842105	0.033707865168539325	GO:0000070	GO:BP	mitotic sister chromatid segregation	16175	24		0.42105263157894735	0.45	178	15997	6	13	172	15984	16175	0.10018858685417749
M1	cpdb	0	network_modules	298	TRUE	1.724375663009829e-4	217	19	6	0.3157894736842105	0.027649769585253458	GO:0000819	GO:BP	sister chromatid segregation	16175	237		0.47368421052631576	0.5	217	15958	6	13	211	15945	16175	0.09013201843454449
M1	cpdb	0	network_modules	298	TRUE	1.9597127057798523e-4	379	19	7	0.3684210526315789	0.018469656992084433	GO:0000280	GO:BP	nuclear division	16175	78		0.5263157894736842	0.55	379	15796	7	12	372	15784	16175	0.07821090202144873
M1	cpdb	0	network_modules	298	TRUE	3.045761748918472e-4	11	19	3	0.15789473684210525	0.2727272727272727	GO:0051177	GO:BP	meiotic sister chromatid cohesion	16175	13557		0.5789473684210527	0.6	11	16164	3	16	8	16148	16175	0.20681235804441112
M1	cpdb	0	network_modules	298	TRUE	3.520474815329389e-4	124	19	5	0.2631578947368421	0.04032258064516129	GO:0007052	GO:BP	mitotic spindle organization	16175	2651		0.631578947368421	0.65	124	16051	5	14	119	16037	16175	0.10045444237268353
M1	cpdb	0	network_modules	298	TRUE	4.086057143973213e-4	116	19	5	0.2631578947368421	0.04310344827586207	REAC:R-HSA-1500620	REAC	Meiosis	10916	1410		0.7058823529411765	0.7222222222222222	116	10800	5	14	111	10786	10916	0.10283978964350182
M1	cpdb	0	network_modules	298	TRUE	4.168109365572251e-4	252	19	6	0.3157894736842105	0.023809523809523808	GO:0140014	GO:BP	mitotic nuclear division	16175	19633		0.6842105263157895	0.7	252	15923	6	13	246	15910	16175	0.08313165451744875
M1	cpdb	0	network_modules	298	TRUE	4.197004938106139e-4	424	19	7	0.3684210526315789	0.01650943396226415	GO:0048285	GO:BP	organelle fission	16175	12627		0.7368421052631579	0.75	424	15751	7	12	417	15739	16175	0.07345257540226117
M1	cpdb	0	network_modules	298	TRUE	7.264719443467358e-4	277	19	6	0.3157894736842105	0.021660649819494584	GO:0098813	GO:BP	nuclear chromosome segregation	16175	18900		0.7894736842105263	0.8	277	15898	6	13	271	15885	16175	0.07894530771268964
M1	cpdb	0	network_modules	298	TRUE	0.0010014017254061241	153	19	5	0.2631578947368421	0.032679738562091505	GO:1902850	GO:BP	microtubule cytoskeleton organization involved in mitosis	16175	22560		0.8421052631578947	0.85	153	16022	5	14	148	16008	16175	0.08988114415628441
M1	cpdb	0	network_modules	298	TRUE	0.0013158138545920892	147	19	5	0.2631578947368421	0.034013605442176874	REAC:R-HSA-9018519	REAC	Estrogen-dependent gene expression	10916	866		0.7647058823529411	0.7777777777777778	147	10769	5	14	142	10755	10916	0.09045740431526995
M1	cpdb	0	network_modules	298	TRUE	0.0014266924887667155	68	19	4	0.21052631578947367	0.058823529411764705	GO:0090307	GO:BP	mitotic spindle assembly	16175	18189		0.8947368421052632	0.9	68	16107	4	15	64	16092	16175	0.10935497523542277
M1	cpdb	0	network_modules	298	TRUE	0.001653129729540794	154	19	5	0.2631578947368421	0.032467532467532464	REAC:R-HSA-1474165	REAC	Reproduction	10916	2064		0.8235294117647058	0.8333333333333334	154	10762	5	14	149	10748	10916	0.0881793367685457
M1	cpdb	0	network_modules	298	TRUE	0.0020009996225951814	176	19	5	0.2631578947368421	0.028409090909090908	GO:0007051	GO:BP	spindle organization	16175	2650		0.9473684210526315	0.95	176	15999	5	14	171	15985	16175	0.0833928679287903
M1	cpdb	0	network_modules	298	TRUE	0.0027579290447909063	171	19	5	0.2631578947368421	0.029239766081871343	REAC:R-HSA-3108232	REAC	SUMO E3 ligases SUMOylate target proteins	10916	2163		0.8823529411764706	0.8888888888888888	171	10745	5	14	166	10731	10916	0.08322392305956053
M1	cpdb	0	network_modules	298	TRUE	0.003262382971923662	177	19	5	0.2631578947368421	0.02824858757062147	REAC:R-HSA-2990846	REAC	SUMOylation	10916	2167		0.9411764705882353	0.9444444444444444	177	10739	5	14	172	10725	10916	0.081642314112084
M1	cpdb	0	network_modules	298	TRUE	0.0033998439641377003	361	19	6	0.3157894736842105	0.01662049861495845	GO:0007059	GO:BP	chromosome segregation	16175	2658		1	1	361	15814	6	13	355	15801	16175	0.06813103889448247
M1	cpdb	0	network_modules	298	TRUE	0.008553681733534822	216	19	5	0.2631578947368421	0.023148148148148147	REAC:R-HSA-8939211	REAC	ESR-mediated signaling	10916	830		1	1	216	10700	5	14	211	10686	10916	0.07296857942209546
M1	cpdb	0	network_modules	300	TRUE	2.1533443013064645e-4	52	16	4	0.25	0.07692307692307693	GO:0007157	GO:BP	heterophilic cell-cell adhesion via plasma membrane cell adhesion molecules	16175	2721		NA	1	52	16123	4	12	48	16111	16175	0.13718021715500833
M1	cpdb	0	network_modules	301	TRUE	1.1881218600181833e-8	26	12	5	0.4166666666666667	0.19230769230769232	REAC:R-HSA-1187000	REAC	Fertilization	10916	940		0	0.25	26	10890	5	7	21	10883	10916	0.281941923313311
M1	cpdb	0	network_modules	301	TRUE	8.373082022114999e-7	110	16	6	0.375	0.05454545454545454	GO:0007338	GO:BP	single fertilization	16175	2848		0	0.14285714285714285	110	16065	6	10	104	16055	16175	0.14097541691358578
M1	cpdb	0	network_modules	301	TRUE	2.201264914972194e-6	129	16	6	0.375	0.046511627906976744	GO:0009566	GO:BP	fertilization	16175	3514		0.16666666666666666	0.2857142857142857	129	16046	6	10	123	16036	16175	0.12984167769087512
M1	cpdb	0	network_modules	301	TRUE	4.207010335911474e-5	35	16	4	0.25	0.11428571428571428	GO:0035036	GO:BP	sperm-egg recognition	16175	8773		0.3333333333333333	0.42857142857142855	35	16140	4	12	31	16128	16175	0.16783245078005662
M1	cpdb	0	network_modules	301	TRUE	4.9601805843328286e-5	11	12	3	0.25	0.2727272727272727	REAC:R-HSA-2534343	REAC	Interaction With Cumulus Cells And The Zona Pellucida	10916	1218		0.3333333333333333	0.5	11	10905	3	9	8	10896	10916	0.2603382471740858
M1	cpdb	0	network_modules	301	TRUE	1.1397837538043698e-4	154	12	5	0.4166666666666667	0.032467532467532464	REAC:R-HSA-1474165	REAC	Reproduction	10916	2064		0.6666666666666666	0.75	154	10762	5	7	149	10755	10916	0.11323582398993073
M1	cpdb	0	network_modules	301	TRUE	1.8339837639447153e-4	50	16	4	0.25	0.08	GO:0009988	GO:BP	cell-cell recognition	16175	3812		0.5	0.5714285714285714	50	16125	4	12	46	16113	16175	0.1399583334636824
M1	cpdb	0	network_modules	301	TRUE	0.0017814441654766503	23	16	3	0.1875	0.13043478260869565	GO:0007339	GO:BP	binding of sperm to zona pellucida	16175	2849		0.6666666666666666	0.7142857142857143	23	16152	3	13	20	16139	16175	0.15538715721260482
M1	cpdb	0	network_modules	301	TRUE	0.004599309531320816	111	16	4	0.25	0.036036036036036036	GO:0008037	GO:BP	cell recognition	16175	3099		0.8333333333333334	0.8571428571428571	111	16064	4	12	107	16052	16175	0.09267460709403337
M1	cpdb	0	network_modules	301	TRUE	0.004933750718707183	6	12	2	0.16666666666666666	0.3333333333333333	REAC:R-HSA-1300645	REAC	Acrosome Reaction and Sperm:Oocyte Membrane Binding	10916	57		1	1	6	10910	2	10	4	10900	10916	0.23511879436218117
M1	cpdb	0	network_modules	301	TRUE	0.009266053425802822	153	7	3	0.42857142857142855	0.0196078431372549	KEGG:04514	KEGG	Cell adhesion molecules	8484	315		NA	1	153	8331	3	4	150	8327	8484	0.08865171063950138
M1	cpdb	0	network_modules	301	TRUE	0.009836870451338051	40	16	3	0.1875	0.075	GO:2000242	GO:BP	negative regulation of reproductive process	16175	25570		1	1	40	16135	3	13	37	16122	16175	0.11722433545994584
M1	cpdb	0	network_modules	303	TRUE	1.1576432035175585e-4	2	8	2	0.25	1	REAC:R-HSA-4755609	REAC	Defective DHDDS causes RP59	10916	530		0	0.5	2	10914	2	6	0	10908	10916	0.4998625429527289
M1	cpdb	0	network_modules	303	TRUE	0.00173392044766401	6	8	2	0.25	0.3333333333333333	REAC:R-HSA-446199	REAC	Synthesis of Dolichyl-phosphate	10916	2377		1	1	6	10910	2	6	4	10904	10916	0.2882252799722374
M1	cpdb	0	network_modules	303	TRUE	0.0035263504037166406	3	16	2	0.125	0.6666666666666666	GO:0016094	GO:BP	polyprenol biosynthetic process	16175	5114		0	0.5	3	16172	2	14	1	16158	16175	0.2884162244125957
M1	cpdb	0	network_modules	303	TRUE	0.004690514352712668	22	6	2	0.3333333333333333	0.09090909090909091	KEGG:00900	KEGG	Terpenoid backbone biosynthesis	8484	129		NA	1	22	8462	2	4	20	8458	8484	0.17300901552186726
M1	cpdb	0	network_modules	303	TRUE	0.007826265480685669	514	16	6	0.375	0.011673151750972763	GO:1901137	GO:BP	carbohydrate derivative biosynthetic process	16175	21245		1	1	514	15661	6	10	508	15651	16175	0.06157176021355297
M1	cpdb	0	network_modules	304	TRUE	2.2047890683947137e-6	89	10	5	0.5	0.056179775280898875	REAC:R-HSA-442755	REAC	Activation of NMDA receptors and postsynaptic events	10916	89		0	0.06666666666666667	89	10827	5	5	84	10822	10916	0.16561954438524906
M1	cpdb	0	network_modules	304	TRUE	3.1060919847630945e-6	6	10	3	0.3	0.5	REAC:R-HSA-9619229	REAC	Activation of RAC1 downstream of NMDARs	10916	95		0.07142857142857142	0.13333333333333333	6	10910	3	7	3	10903	10916	0.38687227034848537
M1	cpdb	0	network_modules	304	TRUE	8.688690444397245e-6	8	10	3	0.3	0.375	REAC:R-HSA-442729	REAC	CREB1 phosphorylation through the activation of CaMKII/CaMKK/CaMKIV cascasde	10916	285		0.14285714285714285	0.2	8	10908	3	7	5	10901	10916	0.3348669157237706
M1	cpdb	0	network_modules	304	TRUE	1.1863604283971806e-5	154	9	5	0.5555555555555556	0.032467532467532464	KEGG:04921	KEGG	Oxytocin signaling pathway	8484	378		0	0.25	154	8330	5	4	149	8326	8484	0.13118068211980244
M1	cpdb	0	network_modules	304	TRUE	1.8600708627092628e-5	10	10	3	0.3	0.3	REAC:R-HSA-111932	REAC	CaMK IV-mediated phosphorylation of CREB	10916	298		0.21428571428571427	0.26666666666666666	10	10906	3	7	7	10899	10916	0.2993581514762516
M1	cpdb	0	network_modules	304	TRUE	3.710764308748953e-5	75	9	4	0.4444444444444444	0.05333333333333334	KEGG:05214	KEGG	Glioma	8484	465		0.3333333333333333	0.5	75	8409	4	5	71	8404	8484	0.15164964086455868
M1	cpdb	0	network_modules	304	TRUE	1.0908483343332444e-4	98	9	4	0.4444444444444444	0.04081632653061224	KEGG:04925	KEGG	Aldosterone synthesis and secretion	8484	382		0.6666666666666666	0.75	98	8386	4	5	94	8381	8484	0.13202082663647208
M1	cpdb	0	network_modules	304	TRUE	1.1670617918492466e-4	196	10	5	0.5	0.025510204081632654	REAC:R-HSA-112314	REAC	Neurotransmitter receptors and postsynaptic signal transmission	10916	1594		0.2857142857142857	0.3333333333333333	196	10720	5	5	191	10715	10916	0.10992403676902482
M1	cpdb	0	network_modules	304	TRUE	1.2399300062009063e-4	76	10	4	0.4	0.05263157894736842	REAC:R-HSA-438064	REAC	Post NMDA receptor activation events	10916	1772		0.35714285714285715	0.4	76	10840	4	6	72	10834	10916	0.14313426098180046
M1	cpdb	0	network_modules	304	TRUE	1.7585807244068614e-4	20	10	3	0.3	0.15	REAC:R-HSA-9617324	REAC	Negative regulation of NMDA receptor-mediated neuronal transmission	10916	1575		0.42857142857142855	0.4666666666666667	20	10896	3	7	17	10889	10916	0.2111266299882095
M1	cpdb	0	network_modules	304	TRUE	4.6469330333854267e-4	259	10	5	0.5	0.019305019305019305	REAC:R-HSA-112315	REAC	Transmission across Chemical Synapses	10916	2580		0.5	0.5333333333333333	259	10657	5	5	254	10652	10916	0.09475883349917018
M1	cpdb	0	network_modules	304	TRUE	0.0010023728984243062	35	10	3	0.3	0.08571428571428572	REAC:R-HSA-111933	REAC	Calmodulin induced events	10916	301		0.5714285714285714	0.6666666666666666	35	10881	3	7	32	10874	10916	0.1589706782197998
M1	cpdb	0	network_modules	304	TRUE	0.0010023728984243062	35	10	3	0.3	0.08571428571428572	REAC:R-HSA-111997	REAC	CaM pathway	10916	297		0.5714285714285714	0.6666666666666666	35	10881	3	7	32	10874	10916	0.1589706782197998
M1	cpdb	0	network_modules	304	TRUE	0.0011888365959049961	37	10	3	0.3	0.08108108108108109	REAC:R-HSA-111996	REAC	Ca-dependent events	10916	294		0.7142857142857143	0.7333333333333333	37	10879	3	7	34	10872	10916	0.1545332440460732
M1	cpdb	0	network_modules	304	TRUE	0.0016278755923912168	41	10	3	0.3	0.07317073170731707	REAC:R-HSA-1489509	REAC	DAG and IP3 signaling	10916	431		0.7857142857142857	0.8	41	10875	3	7	38	10868	10916	0.14664722486386597
M1	cpdb	0	network_modules	304	TRUE	0.0028026782316071955	49	10	3	0.3	0.061224489795918366	REAC:R-HSA-112043	REAC	PLC beta mediated events	10916	1693		0.8571428571428571	0.8666666666666667	49	10867	3	7	46	10860	10916	0.13386030720369857
M1	cpdb	0	network_modules	304	TRUE	0.00376412534650542	54	10	3	0.3	0.05555555555555555	REAC:R-HSA-112040	REAC	G-protein mediated events	10916	998		0.9285714285714286	0.9333333333333333	54	10862	3	7	51	10855	10916	0.1273442182650852
M1	cpdb	0	network_modules	304	TRUE	0.003917640481764774	400	10	5	0.5	0.0125	REAC:R-HSA-112316	REAC	Neuronal System	10916	1590		1	1	400	10516	5	5	395	10511	10916	0.07467767598064688
M1	cpdb	0	network_modules	304	TRUE	0.004531722494916724	251	9	4	0.4444444444444444	0.01593625498007968	KEGG:04020	KEGG	Calcium signaling pathway	8484	250		1	1	251	8233	4	5	247	8228	8484	0.07978789693319173
M1	cpdb	0	network_modules	306	TRUE	0.005927909201264734	250	17	5	0.29411764705882354	0.02	GO:0042692	GO:BP	muscle cell differentiation	16175	10302		NA	1	250	15925	5	12	245	15913	16175	0.07327275147567673
M1	cpdb	0	network_modules	309	TRUE	3.564516842201354e-18	8	17	7	0.4117647058823529	0.875	GO:0097646	GO:BP	calcitonin family receptor signaling pathway	16175	18719		0	0.058823529411764705	8	16167	7	10	1	16157	16175	0.5999877570581902
M1	cpdb	0	network_modules	309	TRUE	6.626555299314965e-17	10	15	7	0.4666666666666667	0.7	REAC:R-HSA-419812	REAC	Calcitonin-like ligand receptors	10916	300		0	0.16666666666666666	10	10906	7	8	3	10898	10916	0.5710795972986122
M1	cpdb	0	network_modules	309	TRUE	1.0983950300443444e-9	4	17	4	0.23529411764705882	1	GO:0097647	GO:BP	amylin receptor signaling pathway	16175	18720		0.0625	0.11764705882352941	4	16171	4	13	0	16158	16175	0.484876234485902
M1	cpdb	0	network_modules	309	TRUE	4.959209004518585e-9	93	15	7	0.4666666666666667	0.07526881720430108	REAC:R-HSA-373080	REAC	Class B/2 (Secretin family receptors)	10916	366		0.2	0.3333333333333333	93	10823	7	8	86	10815	10916	0.18491221013590478
M1	cpdb	0	network_modules	309	TRUE	8.418748570723476e-9	19	15	5	0.3333333333333333	0.2631578947368421	REAC:R-HSA-210745	REAC	Regulation of gene expression in beta cells	10916	2034		0.4	0.5	19	10897	5	10	14	10887	10916	0.29508746545026604
M1	cpdb	0	network_modules	309	TRUE	2.0376141222708813e-8	26	14	5	0.35714285714285715	0.19230769230769232	KEGG:04950	KEGG	Maturity onset diabetes of the young	8484	395		0	0.3333333333333333	26	8458	5	9	21	8449	8484	0.26043642586449706
M1	cpdb	0	network_modules	309	TRUE	1.9558539352072588e-7	156	15	7	0.4666666666666667	0.04487179487179487	REAC:R-HSA-418555	REAC	G alpha (s) signalling events	10916	989		0.6	0.6666666666666666	156	10760	7	8	149	10752	10916	0.14138613966856858
M1	cpdb	0	network_modules	309	TRUE	4.105220282655152e-7	39	15	5	0.3333333333333333	0.1282051282051282	REAC:R-HSA-186712	REAC	Regulation of beta-cell development	10916	2022		0.8	0.8333333333333334	39	10877	5	10	34	10867	10916	0.20501605782450774
M1	cpdb	0	network_modules	309	TRUE	1.2688031732769387e-6	3	17	3	0.17647058823529413	1	GO:1990408	GO:BP	calcitonin gene-related peptide receptor signaling pathway	16175	25157		0.125	0.17647058823529413	3	16172	3	14	0	16158	16175	0.4199021537723215
M1	cpdb	0	network_modules	309	TRUE	5.071917508017591e-6	4	17	3	0.17647058823529413	0.75	GO:1990410	GO:BP	adrenomedullin receptor signaling pathway	16175	25158		0.1875	0.23529411764705882	4	16171	3	14	1	16157	16175	0.3635296400309963
M1	cpdb	0	network_modules	309	TRUE	5.684324579038084e-6	140	17	6	0.35294117647058826	0.04285714285714286	GO:0007189	GO:BP	adenylate cyclase-activating G protein-coupled receptor signaling pathway	16175	2747		0.25	0.29411764705882354	140	16035	6	11	134	16024	16175	0.12055788339134214
M1	cpdb	0	network_modules	309	TRUE	7.274508726603753e-5	103	17	5	0.29411764705882354	0.04854368932038835	GO:0031623	GO:BP	receptor internalization	16175	7240		0.3125	0.35294117647058826	103	16072	5	12	98	16060	16175	0.11733738290249662
M1	cpdb	0	network_modules	309	TRUE	7.832455379065346e-5	217	17	6	0.35294117647058826	0.027649769585253458	GO:0007188	GO:BP	adenylate cyclase-modulating G protein-coupled receptor signaling pathway	16175	2746		0.375	0.4117647058823529	217	15958	6	11	211	15947	16175	0.09572560833382342
M1	cpdb	0	network_modules	309	TRUE	9.051559542080172e-5	133	14	5	0.35714285714285715	0.03759398496240601	KEGG:04270	KEGG	Vascular smooth muscle contraction	8484	298		0.5	0.6666666666666666	133	8351	5	9	128	8342	8484	0.11175726002482932
M1	cpdb	0	network_modules	309	TRUE	2.775097715095278e-4	12	17	3	0.17647058823529413	0.25	GO:0010739	GO:BP	positive regulation of protein kinase A signaling	16175	4362		0.4375	0.5294117647058824	12	16163	3	14	9	16149	16175	0.20934666238654798
M1	cpdb	0	network_modules	309	TRUE	2.775097715095278e-4	12	17	3	0.17647058823529413	0.25	GO:0043950	GO:BP	positive regulation of cAMP-mediated signaling	16175	10877		0.4375	0.5294117647058824	12	16163	3	14	9	16149	16175	0.20934666238654798
M1	cpdb	0	network_modules	309	TRUE	3.4005373858409215e-4	460	15	7	0.4666666666666667	0.015217391304347827	REAC:R-HSA-500792	REAC	GPCR ligand binding	10916	1019		1	1	460	10456	7	8	453	10448	10916	0.07838253079160425
M1	cpdb	0	network_modules	309	TRUE	0.00121675956579644	19	17	3	0.17647058823529413	0.15789473684210525	GO:0010738	GO:BP	regulation of protein kinase A signaling	16175	4361		0.5625	0.5882352941176471	19	16156	3	14	16	16142	16175	0.16599808314375786
M1	cpdb	0	network_modules	309	TRUE	0.0013680235814271934	2	17	2	0.11764705882352941	1	GO:0038041	GO:BP	cross-receptor inhibition within G protein-coupled receptor heterodimer	16175	9676		0.625	0.6470588235294118	2	16173	2	15	0	16158	16175	0.342838073300585
M1	cpdb	0	network_modules	309	TRUE	0.0019299916390394345	22	17	3	0.17647058823529413	0.13636363636363635	GO:0007263	GO:BP	nitric oxide mediated signal transduction	16175	2791		0.6875	0.7058823529411765	22	16153	3	14	19	16139	16175	0.15411649072490274
M1	cpdb	0	network_modules	309	TRUE	0.002533267294692851	24	17	3	0.17647058823529413	0.125	GO:0043949	GO:BP	regulation of cAMP-mediated signaling	16175	10876		0.75	0.7647058823529411	24	16151	3	14	21	16137	16175	0.1474602446488705
M1	cpdb	0	network_modules	309	TRUE	0.003003592246816513	46	14	3	0.21428571428571427	0.06521739130434782	KEGG:04930	KEGG	Type II diabetes mellitus	8484	387		1	1	46	8438	3	11	43	8427	8484	0.11563448056478245
M1	cpdb	0	network_modules	309	TRUE	0.003241216146307949	221	17	5	0.29411764705882354	0.02262443438914027	GO:0006898	GO:BP	receptor-mediated endocytosis	16175	2552		0.8125	0.8235294117647058	221	15954	5	12	216	15942	16175	0.0783621899733218
M1	cpdb	0	network_modules	309	TRUE	0.004213049833406921	101	17	4	0.23529411764705882	0.039603960396039604	GO:0009743	GO:BP	response to carbohydrate	16175	3640		0.875	0.8823529411764706	101	16074	4	13	97	16061	16175	0.09431535670186014
M1	cpdb	0	network_modules	309	TRUE	0.008133490203624773	35	17	3	0.17647058823529413	0.08571428571428572	GO:0010737	GO:BP	protein kinase A signaling	16175	4360		0.9375	0.9411764705882353	35	16140	3	14	32	16126	16175	0.1216755670934157
M1	cpdb	0	network_modules	309	TRUE	0.009386669307410127	774	17	7	0.4117647058823529	0.00904392764857881	GO:0007186	GO:BP	G protein-coupled receptor signaling pathway	16175	2744		1	1	774	15401	7	10	767	15391	16175	0.05530032408948904
M1	cpdb	0	network_modules	311	TRUE	3.4716567758044436e-4	3	8	2	0.25	0.6666666666666666	REAC:R-HSA-5619099	REAC	Defective AVP does not bind AVPR1A,B and causes neurohypophyseal diabetes insipidus (NDI)	10916	488		0	0.3333333333333333	3	10913	2	6	1	10907	10916	0.40800508465050417
M1	cpdb	0	network_modules	311	TRUE	0.00173392044766401	6	8	2	0.25	0.3333333333333333	REAC:R-HSA-388479	REAC	Vasopressin-like receptors	10916	2644		0.5	0.6666666666666666	6	10910	2	6	4	10904	10916	0.2882252799722374
M1	cpdb	0	network_modules	311	TRUE	0.007612486045548108	12	8	2	0.25	0.16666666666666666	REAC:R-HSA-196108	REAC	Pregnenolone biosynthesis	10916	1789		1	1	12	10904	2	6	10	10898	10916	0.20341291469682457
M1	cpdb	0	network_modules	312	TRUE	0.0062777842567969975	6	13	2	0.15384615384615385	0.3333333333333333	REAC:R-HSA-9014826	REAC	Interleukin-36 pathway	10916	1249		NA	1	6	10910	2	11	4	10899	10916	0.22584289982209305
M1	cpdb	0	network_modules	314	TRUE	0.0021980362693385757	51	9	3	0.3333333333333333	0.058823529411764705	REAC:R-HSA-9754678	REAC	SARS-CoV-2 modulates host translation machinery	10916	2125		0	1	51	10865	3	6	48	10859	10916	0.13844610129703283
M1	cpdb	0	network_modules	314	TRUE	0.0021980362693385757	51	9	3	0.3333333333333333	0.058823529411764705	REAC:R-HSA-194441	REAC	Metabolism of non-coding RNA	10916	1431		0	1	51	10865	3	6	48	10859	10916	0.13844610129703283
M1	cpdb	0	network_modules	314	TRUE	0.0021980362693385757	51	9	3	0.3333333333333333	0.058823529411764705	REAC:R-HSA-191859	REAC	snRNP Assembly	10916	2736		0	1	51	10865	3	6	48	10859	10916	0.13844610129703283
M1	cpdb	0	network_modules	314	TRUE	0.0080273333449819	39	15	3	0.2	0.07692307692307693	GO:0000387	GO:BP	spliceosomal snRNP assembly	16175	114		NA	1	39	16136	3	12	36	16124	16175	0.12274434022930093
M1	cpdb	0	network_modules	315	TRUE	8.449837175905525e-8	54	9	5	0.5555555555555556	0.09259259259259259	REAC:R-HSA-5620924	REAC	Intraflagellar transport	10916	1267		0	0.3333333333333333	54	10862	5	4	49	10858	10916	0.22543607074437771
M1	cpdb	0	network_modules	315	TRUE	6.476883193227908e-5	200	9	5	0.5555555555555556	0.025	REAC:R-HSA-5617833	REAC	Cilium Assembly	10916	361		0.5	0.6666666666666666	200	10716	5	4	195	10712	10916	0.11507053288641508
M1	cpdb	0	network_modules	315	TRUE	4.24270995941696e-4	292	9	5	0.5555555555555556	0.017123287671232876	REAC:R-HSA-1852241	REAC	Organelle biogenesis and maintenance	10916	1646		1	1	292	10624	5	4	287	10620	10916	0.09414405561286013
M1	cpdb	0	network_modules	315	TRUE	4.5855646184380256e-4	14	17	3	0.17647058823529413	0.21428571428571427	GO:0035721	GO:BP	intraciliary retrograde transport	16175	9191		NA	1	14	16161	3	14	11	16147	16175	0.19369295667569836
M1	cpdb	0	network_modules	315	TRUE	0.0024488641563113994	193	4	3	0.75	0.015544041450777202	KEGG:04814	KEGG	Motor proteins	8484	366		NA	1	193	8291	3	1	190	8290	8484	0.10593393907282753
M1	cpdb	0	network_modules	317	TRUE	1.5818128398420324e-5	59	3	3	1	0.05084745762711865	KEGG:04730	KEGG	Long-term depression	8484	359		0	0.1	59	8425	3	0	56	8425	8484	0.2247481081615847
M1	cpdb	0	network_modules	317	TRUE	2.5493710028202487e-5	69	3	3	1	0.043478260869565216	KEGG:04924	KEGG	Renin secretion	8484	381		0.1111111111111111	0.2	69	8415	3	0	66	8415	8484	0.20770148926981566
M1	cpdb	0	network_modules	317	TRUE	2.6127815099934484e-5	21	6	3	0.5	0.14285714285714285	REAC:R-HSA-392154	REAC	Nitric oxide stimulates guanylate cyclase	10916	1601		0	0.3333333333333333	21	10895	3	3	18	10892	10916	0.2665626628941163
M1	cpdb	0	network_modules	317	TRUE	5.339500255095685e-5	88	3	3	1	0.03409090909090909	KEGG:04540	KEGG	Gap junction	8484	318		0.2222222222222222	0.3	88	8396	3	0	85	8396	8484	0.1837096520619767
M1	cpdb	0	network_modules	317	TRUE	5.911179453327065e-5	91	3	3	1	0.03296703296703297	KEGG:04970	KEGG	Salivary secretion	8484	401		0.3333333333333333	0.4	91	8393	3	0	88	8393	8484	0.18062381511321282
M1	cpdb	0	network_modules	317	TRUE	7.174089793789693e-5	97	3	3	1	0.030927835051546393	KEGG:04713	KEGG	Circadian entrainment	8484	348		0.4444444444444444	0.5	97	8387	3	0	94	8387	8484	0.17488580085664768
M1	cpdb	0	network_modules	317	TRUE	1.5089917411891196e-4	124	3	3	1	0.024193548387096774	KEGG:04611	KEGG	Platelet activation	8484	321		0.5555555555555556	0.6	124	8360	3	0	121	8360	8484	0.15442918942025863
M1	cpdb	0	network_modules	317	TRUE	1.583807805126524e-4	126	3	3	1	0.023809523809523808	KEGG:00230	KEGG	Purine metabolism	8484	22		0.6666666666666666	0.7	126	8358	3	0	123	8358	8484	0.1531803320459018
M1	cpdb	0	network_modules	317	TRUE	1.8650784471638281e-4	133	3	3	1	0.022556390977443608	KEGG:04270	KEGG	Vascular smooth muscle contraction	8484	298		0.7777777777777778	0.8	133	8351	3	0	130	8351	8484	0.14903233884157802
M1	cpdb	0	network_modules	317	TRUE	2.4133946622674216e-4	43	6	3	0.5	0.06976744186046512	REAC:R-HSA-445355	REAC	Smooth Muscle Contraction	10916	2336		0.5	0.6666666666666666	43	10873	3	3	40	10870	10916	0.1857174829762424
M1	cpdb	0	network_modules	317	TRUE	2.9043969711558957e-4	154	3	3	1	0.01948051948051948	KEGG:04921	KEGG	Oxytocin signaling pathway	8484	378		0.8888888888888888	0.9	154	8330	3	0	151	8330	8484	0.13832454044704606
M1	cpdb	0	network_modules	317	TRUE	3.511936886818243e-4	164	3	3	1	0.018292682926829267	KEGG:04022	KEGG	cGMP-PKG signaling pathway	8484	251		1	1	164	8320	3	0	161	8320	8484	0.13396052314226534
M1	cpdb	0	network_modules	317	TRUE	0.0011799873375105887	21	15	3	0.2	0.14285714285714285	GO:0019934	GO:BP	cGMP-mediated signaling	16175	6071		0	0.3333333333333333	21	16154	3	12	18	16142	16175	0.16812067967580172
M1	cpdb	0	network_modules	317	TRUE	0.0013655405893561465	22	15	3	0.2	0.13636363636363635	GO:0007263	GO:BP	nitric oxide mediated signal transduction	16175	2791		0.5	0.6666666666666666	22	16153	3	12	19	16141	16175	0.16420929627491795
M1	cpdb	0	network_modules	317	TRUE	0.0019148216972107392	85	6	3	0.5	0.03529411764705882	REAC:R-HSA-418346	REAC	Platelet homeostasis	10916	1765		1	1	85	10831	3	3	82	10828	10916	0.13132165570810064
M1	cpdb	0	network_modules	317	TRUE	0.006682065795610729	4	15	2	0.13333333333333333	0.5	GO:0038060	GO:BP	nitric oxide-cGMP-mediated signaling	16175	9679		1	1	4	16171	2	13	2	16158	16175	0.25787147420379075
M1	cpdb	0	network_modules	318	TRUE	2.057927900411013e-12	15	16	6	0.375	0.4	GO:1904507	GO:BP	positive regulation of telomere maintenance in response to DNA damage	16175	23869		0	0.041666666666666664	15	16160	6	10	9	16150	16175	0.3867111378506159
M1	cpdb	0	network_modules	318	TRUE	5.083298482283036e-12	17	16	6	0.375	0.35294117647058826	GO:0060382	GO:BP	regulation of DNA strand elongation	16175	14590		0.043478260869565216	0.08333333333333333	17	16158	6	10	11	16148	16175	0.36315426448933197
M1	cpdb	0	network_modules	318	TRUE	7.620903709515107e-12	18	16	6	0.375	0.3333333333333333	GO:1904505	GO:BP	regulation of telomere maintenance in response to DNA damage	16175	23867		0.08695652173913043	0.125	18	16157	6	10	12	16147	16175	0.35287507989956934
M1	cpdb	0	network_modules	318	TRUE	6.870061996949062e-11	38	10	6	0.6	0.15789473684210525	REAC:R-HSA-5696394	REAC	DNA Damage Recognition in GG-NER	10916	439		0	0.16666666666666666	38	10878	6	4	32	10874	10916	0.3066822510165128
M1	cpdb	0	network_modules	318	TRUE	1.9387052967793214e-10	29	16	6	0.375	0.20689655172413793	GO:0043247	GO:BP	telomere maintenance in response to DNA damage	16175	10583		0.13043478260869565	0.16666666666666666	29	16146	6	10	23	16136	16175	0.2775974521806046
M1	cpdb	0	network_modules	318	TRUE	9.44796137517385e-10	37	16	6	0.375	0.16216216216216217	GO:0022616	GO:BP	DNA strand elongation	16175	6623		0.17391304347826086	0.20833333333333334	37	16138	6	10	31	16128	16175	0.24549649920483513
M1	cpdb	0	network_modules	318	TRUE	8.778815782768034e-9	116	8	6	0.75	0.05172413793103448	KEGG:03082	KEGG	ATP-dependent chromatin remodeling	8484	219		NA	1	116	8368	6	2	110	8366	8484	0.19479652045650928
M1	cpdb	0	network_modules	318	TRUE	9.969671176349418e-9	84	10	6	0.6	0.07142857142857142	REAC:R-HSA-5696399	REAC	Global Genome Nucleotide Excision Repair (GG-NER)	10916	1047		0.2	0.3333333333333333	84	10832	6	4	78	10828	10916	0.20524950467695957
M1	cpdb	0	network_modules	318	TRUE	3.283894995358303e-8	102	10	6	0.6	0.058823529411764705	REAC:R-HSA-5689603	REAC	UCH proteinases	10916	2615		0.4	0.5	102	10814	6	4	96	10810	10916	0.1858968674103288
M1	cpdb	0	network_modules	318	TRUE	4.7897088782169107e-8	69	16	6	0.375	0.08695652173913043	GO:0045995	GO:BP	regulation of embryonic development	16175	11787		0.21739130434782608	0.2916666666666667	69	16106	6	10	63	16096	16175	0.17899514401899036
M1	cpdb	0	network_modules	318	TRUE	4.7897088782169107e-8	69	16	6	0.375	0.08695652173913043	GO:0032206	GO:BP	positive regulation of telomere maintenance	16175	7398		0.21739130434782608	0.2916666666666667	69	16106	6	10	63	16096	16175	0.17899514401899036
M1	cpdb	0	network_modules	318	TRUE	4.927591680481276e-8	109	10	6	0.6	0.05504587155963303	REAC:R-HSA-5696398	REAC	Nucleotide Excision Repair	10916	1622		0.6	0.6666666666666666	109	10807	6	4	103	10803	10916	0.1796915919691805
M1	cpdb	0	network_modules	318	TRUE	4.1413504942458026e-7	98	16	6	0.375	0.061224489795918366	GO:2001252	GO:BP	positive regulation of chromosome organization	16175	26441		0.30434782608695654	0.3333333333333333	98	16077	6	10	92	16067	16175	0.14960245891275467
M1	cpdb	0	network_modules	318	TRUE	5.950842889381211e-7	104	16	6	0.375	0.057692307692307696	GO:0032204	GO:BP	regulation of telomere maintenance	16175	7396		0.34782608695652173	0.375	104	16071	6	10	98	16061	16175	0.14510396676669632
M1	cpdb	0	network_modules	318	TRUE	9.342616696326889e-7	112	16	6	0.375	0.05357142857142857	GO:0006275	GO:BP	regulation of DNA replication	16175	2090		0.391304347826087	0.4166666666666667	112	16063	6	10	106	16053	16175	0.13967281502070042
M1	cpdb	0	network_modules	318	TRUE	1.4546762000444714e-6	231	16	7	0.4375	0.030303030303030304	GO:0006260	GO:BP	DNA replication	16175	2077		0.43478260869565216	0.4583333333333333	231	15944	7	9	224	15935	16175	0.11224248106254966
M1	cpdb	0	network_modules	318	TRUE	2.0026292908013527e-6	127	16	6	0.375	0.047244094488188976	GO:0045739	GO:BP	positive regulation of DNA repair	16175	11579		0.4782608695652174	0.5	127	16048	6	10	121	16038	16175	0.13089598777348208
M1	cpdb	0	network_modules	318	TRUE	5.925384367907196e-6	152	16	6	0.375	0.039473684210526314	GO:0000723	GO:BP	telomere maintenance	16175	202		0.5217391304347826	0.5416666666666666	152	16023	6	10	146	16013	16175	0.11923748900143377
M1	cpdb	0	network_modules	318	TRUE	1.7472363700214698e-5	182	16	6	0.375	0.03296703296703297	GO:0032200	GO:BP	telomere organization	16175	7392		0.5652173913043478	0.5833333333333334	182	15993	6	10	176	15983	16175	0.10851682356589133
M1	cpdb	0	network_modules	318	TRUE	2.118335733372746e-5	298	10	6	0.6	0.020134228187919462	REAC:R-HSA-5688426	REAC	Deubiquitination	10916	736		0.8	0.8333333333333334	298	10618	6	4	292	10614	10916	0.1064213939740033
M1	cpdb	0	network_modules	318	TRUE	3.770057119884648e-5	207	16	6	0.375	0.028985507246376812	GO:0006282	GO:BP	regulation of DNA repair	16175	2096		0.6086956521739131	0.625	207	15968	6	10	201	15958	16175	0.10140001439380106
M1	cpdb	0	network_modules	318	TRUE	3.816168848131291e-5	329	10	6	0.6	0.0182370820668693	REAC:R-HSA-73894	REAC	DNA Repair	10916	444		1	1	329	10587	6	4	323	10583	10916	0.10092880328356556
M1	cpdb	0	network_modules	318	TRUE	6.878621845336415e-5	229	16	6	0.375	0.026200873362445413	GO:0033044	GO:BP	regulation of chromosome organization	16175	7999		0.6521739130434783	0.6666666666666666	229	15946	6	10	223	15936	16175	0.0961105186379505
M1	cpdb	0	network_modules	318	TRUE	1.0523058099956043e-4	246	16	6	0.375	0.024390243902439025	GO:0051054	GO:BP	positive regulation of DNA metabolic process	16175	13464		0.6956521739130435	0.7083333333333334	246	15929	6	10	240	15919	16175	0.0925094165763379
M1	cpdb	0	network_modules	318	TRUE	0.0024349629131757387	420	16	6	0.375	0.014285714285714285	GO:0010638	GO:BP	positive regulation of organelle organization	16175	4284		0.7391304347826086	0.75	420	15755	6	10	414	15745	16175	0.06906069259404257
M1	cpdb	0	network_modules	318	TRUE	0.002985067770046222	435	16	6	0.375	0.013793103448275862	GO:0051052	GO:BP	regulation of DNA metabolic process	16175	13462		0.782608695652174	0.7916666666666666	435	15740	6	10	429	15730	16175	0.06771148875573132
M1	cpdb	0	network_modules	318	TRUE	0.0030655417383463647	437	16	6	0.375	0.013729977116704805	GO:0080135	GO:BP	regulation of cellular response to stress	16175	17817		0.8260869565217391	0.8333333333333334	437	15738	6	10	431	15728	16175	0.06753665972407395
M1	cpdb	0	network_modules	318	TRUE	0.003824080778608327	454	16	6	0.375	0.013215859030837005	GO:0006338	GO:BP	chromatin remodeling	16175	2126		0.8695652173913043	0.875	454	15721	6	10	448	15711	16175	0.06609572670927892
M1	cpdb	0	network_modules	318	TRUE	0.0076527315413135065	512	16	6	0.375	0.01171875	GO:0009790	GO:BP	embryo development	16175	3677		0.9130434782608695	0.9166666666666666	512	15663	6	10	506	15653	16175	0.061710184908478384
M1	cpdb	0	network_modules	318	TRUE	0.009133173261564603	528	16	6	0.375	0.011363636363636364	GO:0006281	GO:BP	DNA repair	16175	2095		0.9565217391304348	0.9583333333333334	528	15647	6	10	522	15637	16175	0.06062388874278859
M1	cpdb	0	network_modules	318	TRUE	0.009232943238055529	529	16	6	0.375	0.011342155009451797	GO:0006325	GO:BP	chromatin organization	16175	2122		1	1	529	15646	6	10	523	15636	16175	0.060557559042677414
M1	cpdb	0	network_modules	320	TRUE	0.0012854533846714546	79	7	3	0.42857142857142855	0.0379746835443038	KEGG:03018	KEGG	RNA degradation	8484	211		NA	1	79	8405	3	4	76	8401	8484	0.12543807744566282
M1	cpdb	0	network_modules	320	TRUE	0.003342824188508391	3	15	2	0.13333333333333333	0.6666666666666666	GO:0060212	GO:BP	negative regulation of nuclear-transcribed mRNA poly(A) tail shortening	16175	14436		0	0.5	3	16172	2	13	1	16159	16175	0.29789344298100395
M1	cpdb	0	network_modules	320	TRUE	0.006682065795610729	4	15	2	0.13333333333333333	0.5	GO:0071076	GO:BP	RNA 3' uridylation	16175	16452		1	1	4	16171	2	13	2	16158	16175	0.25787147420379075
M1	cpdb	0	network_modules	322	TRUE	8.232914002026105e-4	18	16	3	0.1875	0.16666666666666666	GO:0018022	GO:BP	peptidyl-lysine methylation	16175	5308		NA	1	18	16157	3	13	15	16144	16175	0.17591239566271397
M1	cpdb	0	network_modules	324	TRUE	6.609482381936516e-5	12	12	3	0.25	0.25	REAC:R-HSA-8851680	REAC	Butyrophilin (BTN) family interactions	10916	260		0	0.3333333333333333	12	10904	3	9	9	10895	10916	0.24917461482024944
M1	cpdb	0	network_modules	324	TRUE	8.521187764943848e-5	9	16	3	0.1875	0.3333333333333333	GO:0019371	GO:BP	cyclooxygenase pathway	16175	5732		0	0.16666666666666666	9	16166	3	13	6	16153	16175	0.24945089525338424
M1	cpdb	0	network_modules	324	TRUE	1.3644253743594958e-4	15	12	3	0.25	0.2	REAC:R-HSA-2162123	REAC	Synthesis of Prostaglandins (PG) and Thromboxanes (TX)	10916	2398		0.5	0.6666666666666666	15	10901	3	9	12	10892	10916	0.22265309968803057
M1	cpdb	0	network_modules	324	TRUE	0.0010785962604088464	61	8	3	0.375	0.04918032786885246	KEGG:00590	KEGG	Arachidonic acid metabolism	8484	92		NA	1	61	8423	3	5	58	8418	8484	0.1337443327957323
M1	cpdb	0	network_modules	324	TRUE	0.0017814441654766503	23	16	3	0.1875	0.13043478260869565	GO:0046457	GO:BP	prostanoid biosynthetic process	16175	12165		0.2	0.5	23	16152	3	13	20	16139	16175	0.15538715721260482
M1	cpdb	0	network_modules	324	TRUE	0.0017814441654766503	23	16	3	0.1875	0.13043478260869565	GO:0001516	GO:BP	prostaglandin biosynthetic process	16175	326		0.2	0.5	23	16152	3	13	20	16139	16175	0.15538715721260482
M1	cpdb	0	network_modules	324	TRUE	0.006536114093843217	35	16	3	0.1875	0.08571428571428572	GO:0006636	GO:BP	unsaturated fatty acid biosynthetic process	16175	2347		0.6	0.6666666666666666	35	16140	3	13	32	16127	16175	0.1255080059505054
M1	cpdb	0	network_modules	324	TRUE	0.008409314053970213	38	16	3	0.1875	0.07894736842105263	GO:0006693	GO:BP	prostaglandin metabolic process	16175	2401		0.8	0.8333333333333334	38	16137	3	13	35	16124	16175	0.12034254458480281
M1	cpdb	0	network_modules	324	TRUE	0.009104596063967779	39	16	3	0.1875	0.07692307692307693	GO:0006692	GO:BP	prostanoid metabolic process	16175	2400		1	1	39	16136	3	13	36	16123	16175	0.11875368695823141
M1	cpdb	0	network_modules	324	TRUE	0.009486506111647216	59	12	3	0.25	0.05084745762711865	REAC:R-HSA-2142753	REAC	Arachidonate metabolism	10916	165		1	1	59	10857	3	9	56	10848	10916	0.11066952303953095
M1	cpdb	0	network_modules	325	TRUE	3.413259112289848e-12	9	9	5	0.5555555555555556	0.5555555555555556	REAC:R-HSA-428542	REAC	Regulation of commissural axon pathfinding by SLIT and ROBO	10916	2024		0	0.125	9	10907	5	4	4	10903	10916	0.5551888185976387
M1	cpdb	0	network_modules	325	TRUE	7.87018083121702e-10	181	8	7	0.875	0.03867403314917127	KEGG:04360	KEGG	Axon guidance	8484	305		NA	1	181	8303	7	1	174	8302	8484	0.18150191724955392
M1	cpdb	0	network_modules	325	TRUE	1.0343803417005337e-7	36	14	5	0.35714285714285715	0.1388888888888889	GO:0050919	GO:BP	negative chemotaxis	16175	13361		0	0.016666666666666666	36	16139	5	9	31	16130	16175	0.2216724278248346
M1	cpdb	0	network_modules	325	TRUE	4.3046484678401556e-7	4	9	3	0.3333333333333333	0.75	REAC:R-HSA-8985801	REAC	Regulation of cortical dendrite branching	10916	2025		0.14285714285714285	0.25	4	10912	3	6	1	10906	10916	0.4997479392411747
M1	cpdb	0	network_modules	325	TRUE	6.617679295914984e-7	3	14	3	0.21428571428571427	1	GO:0061364	GO:BP	apoptotic process involved in luteolysis	16175	15436		0.01694915254237288	0.06666666666666667	3	16172	3	11	0	16161	16175	0.46275259018047415
M1	cpdb	0	network_modules	325	TRUE	6.617679295914984e-7	3	14	3	0.21428571428571427	1	GO:0050923	GO:BP	regulation of negative chemotaxis	16175	13365		0.01694915254237288	0.06666666666666667	3	16172	3	11	0	16161	16175	0.46275259018047415
M1	cpdb	0	network_modules	325	TRUE	6.617679295914984e-7	3	14	3	0.21428571428571427	1	GO:0001554	GO:BP	luteolysis	16175	345		0.01694915254237288	0.06666666666666667	3	16172	3	11	0	16161	16175	0.46275259018047415
M1	cpdb	0	network_modules	325	TRUE	1.2790881637753438e-6	217	9	6	0.6666666666666666	0.027649769585253458	REAC:R-HSA-376176	REAC	Signaling by ROBO receptors	10916	2301		0.2857142857142857	0.375	217	10699	6	3	211	10696	10916	0.13310437881860923
M1	cpdb	0	network_modules	325	TRUE	2.5846734419124045e-6	297	14	7	0.5	0.02356902356902357	GO:0007409	GO:BP	axonogenesis	16175	2905		0.06779661016949153	0.08333333333333333	297	15878	7	7	290	15871	16175	0.10558910559424825
M1	cpdb	0	network_modules	325	TRUE	2.645721338593774e-6	4	14	3	0.21428571428571427	0.75	GO:0021891	GO:BP	olfactory bulb interneuron development	16175	6455		0.0847457627118644	0.1	4	16171	3	11	1	16160	16175	0.4006521636101715
M1	cpdb	0	network_modules	325	TRUE	3.701501919337957e-6	165	14	6	0.42857142857142855	0.03636363636363636	GO:0007411	GO:BP	axon guidance	16175	2906		0.1016949152542373	0.13333333333333333	165	16010	6	8	159	16002	16175	0.12254556806651545
M1	cpdb	0	network_modules	325	TRUE	3.701501919337957e-6	165	14	6	0.42857142857142855	0.03636363636363636	GO:0097485	GO:BP	neuron projection guidance	16175	18673		0.1016949152542373	0.13333333333333333	165	16010	6	8	159	16002	16175	0.12254556806651545
M1	cpdb	0	network_modules	325	TRUE	6.016572688740139e-6	8	9	3	0.3333333333333333	0.375	REAC:R-HSA-428543	REAC	Inactivation of CDC42 and RAC1	10916	1177		0.42857142857142855	0.5	8	10908	3	6	5	10902	10916	0.3530509772530739
M1	cpdb	0	network_modules	325	TRUE	6.476613599382806e-6	339	14	7	0.5	0.02064896755162242	GO:0061564	GO:BP	axon development	16175	15561		0.13559322033898305	0.15	339	15836	7	7	332	15829	16175	0.09842942417619155
M1	cpdb	0	network_modules	325	TRUE	6.610929067179114e-6	5	14	3	0.21428571428571427	0.6	GO:0035385	GO:BP	Roundabout signaling pathway	16175	9014		0.15254237288135594	0.16666666666666666	5	16170	3	11	2	16159	16175	0.35826175812200534
M1	cpdb	0	network_modules	325	TRUE	1.055946639235188e-5	29	14	4	0.2857142857142857	0.13793103448275862	GO:0060412	GO:BP	ventricular septum morphogenesis	16175	14613		0.1694915254237288	0.18333333333333332	29	16146	4	10	25	16136	16175	0.19753353685849726
M1	cpdb	0	network_modules	325	TRUE	1.233589815843206e-5	49	9	4	0.4444444444444444	0.08163265306122448	REAC:R-HSA-373752	REAC	Netrin-1 signaling	10916	1586		0.5714285714285714	0.625	49	10867	4	5	45	10862	10916	0.1890549800938644
M1	cpdb	0	network_modules	325	TRUE	1.3215112914448817e-5	6	14	3	0.21428571428571427	0.5	GO:0021889	GO:BP	olfactory bulb interneuron differentiation	16175	6453		0.1864406779661017	0.21666666666666667	6	16169	3	11	3	16158	16175	0.326962361414992
M1	cpdb	0	network_modules	325	TRUE	1.3215112914448817e-5	6	14	3	0.21428571428571427	0.5	GO:0070100	GO:BP	negative regulation of chemokine-mediated signaling pathway	16175	15912		0.1864406779661017	0.21666666666666667	6	16169	3	11	3	16158	16175	0.326962361414992
M1	cpdb	0	network_modules	325	TRUE	1.4015274563511148e-5	379	14	7	0.5	0.018469656992084433	GO:0048667	GO:BP	cell morphogenesis involved in neuron differentiation	16175	12925		0.22033898305084745	0.23333333333333334	379	15796	7	7	372	15789	16175	0.0927270859739369
M1	cpdb	0	network_modules	325	TRUE	3.267148140323413e-5	38	14	4	0.2857142857142857	0.10526315789473684	GO:0003180	GO:BP	aortic valve morphogenesis	16175	1610		0.23728813559322035	0.25	38	16137	4	10	34	16127	16175	0.17227298249408687
M1	cpdb	0	network_modules	325	TRUE	3.982995867453266e-5	441	14	7	0.5	0.015873015873015872	GO:0048812	GO:BP	neuron projection morphogenesis	16175	13058		0.2542372881355932	0.26666666666666666	441	15734	7	7	434	15727	16175	0.08543852220184713
M1	cpdb	0	network_modules	325	TRUE	4.041035018098207e-5	40	14	4	0.2857142857142857	0.1	GO:0003281	GO:BP	ventricular septum development	16175	1704		0.2711864406779661	0.2833333333333333	40	16135	4	10	36	16125	16175	0.16784806621486287
M1	cpdb	0	network_modules	325	TRUE	5.012541058985202e-5	456	14	7	0.5	0.015350877192982455	GO:0120039	GO:BP	plasma membrane bounded cell projection morphogenesis	16175	19473		0.288135593220339	0.3	456	15719	7	7	449	15712	16175	0.08389671050289682
M1	cpdb	0	network_modules	325	TRUE	5.322448041943472e-5	460	14	7	0.5	0.015217391304347827	GO:0048858	GO:BP	cell projection morphogenesis	16175	13102		0.3050847457627119	0.31666666666666665	460	15715	7	7	453	15708	16175	0.08349798796582822
M1	cpdb	0	network_modules	325	TRUE	5.448774563355754e-5	43	14	4	0.2857142857142857	0.09302325581395349	GO:0003176	GO:BP	aortic valve development	16175	1606		0.3220338983050847	0.3333333333333333	43	16132	4	10	39	16122	16175	0.1617960859769255
M1	cpdb	0	network_modules	325	TRUE	5.541856854006838e-5	9	14	3	0.21428571428571427	0.3333333333333333	GO:0070099	GO:BP	regulation of chemokine-mediated signaling pathway	16175	15911		0.3389830508474576	0.35	9	16166	3	11	6	16155	16175	0.26675693181223653
M1	cpdb	0	network_modules	325	TRUE	7.859545531966686e-5	47	14	4	0.2857142857142857	0.0851063829787234	GO:1905314	GO:BP	semi-lunar valve development	16175	24530		0.3559322033898305	0.36666666666666664	47	16128	4	10	43	16118	16175	0.15464203885113992
M1	cpdb	0	network_modules	325	TRUE	8.569802350911466e-5	48	14	4	0.2857142857142857	0.08333333333333333	GO:0060411	GO:BP	cardiac septum morphogenesis	16175	14612		0.3728813559322034	0.38333333333333336	48	16127	4	10	44	16117	16175	0.15299399728976718
M1	cpdb	0	network_modules	325	TRUE	1.4968921681117304e-4	55	14	4	0.2857142857142857	0.07272727272727272	GO:0003179	GO:BP	heart valve morphogenesis	16175	1609		0.3898305084745763	0.4	55	16120	4	10	51	16110	16175	0.14273901910429512
M1	cpdb	0	network_modules	325	TRUE	1.8830225312062814e-4	13	14	3	0.21428571428571427	0.23076923076923078	GO:0021772	GO:BP	olfactory bulb development	16175	6352		0.4067796610169492	0.4166666666666667	13	16162	3	11	10	16151	16175	0.22172580349903687
M1	cpdb	0	network_modules	325	TRUE	2.395351351615083e-4	14	14	3	0.21428571428571427	0.21428571428571427	GO:0021988	GO:BP	olfactory lobe development	16175	6543		0.423728813559322	0.43333333333333335	14	16161	3	11	11	16150	16175	0.21360506333589682
M1	cpdb	0	network_modules	325	TRUE	2.4399043672082126e-4	62	14	4	0.2857142857142857	0.06451612903225806	GO:0003279	GO:BP	cardiac septum development	16175	1703		0.4406779661016949	0.45	62	16113	4	10	58	16103	16175	0.13426297646553773
M1	cpdb	0	network_modules	325	TRUE	3.1460428888177664e-4	66	14	4	0.2857142857142857	0.06060606060606061	GO:0003170	GO:BP	heart valve development	16175	1600		0.4576271186440678	0.4666666666666667	66	16109	4	10	62	16099	16175	0.13003279137581597
M1	cpdb	0	network_modules	325	TRUE	5.358847493524973e-4	18	14	3	0.21428571428571427	0.16666666666666666	GO:0022602	GO:BP	ovulation cycle process	16175	6610		0.4745762711864407	0.48333333333333334	18	16157	3	11	15	16146	16175	0.18818696645136737
M1	cpdb	0	network_modules	325	TRUE	5.572663373110551e-4	76	14	4	0.2857142857142857	0.05263157894736842	GO:0003231	GO:BP	cardiac ventricle development	16175	1661		0.4915254237288136	0.5	76	16099	4	10	72	16089	16175	0.12094794502917824
M1	cpdb	0	network_modules	325	TRUE	5.694358798662802e-4	651	14	7	0.5	0.010752688172043012	GO:0000902	GO:BP	cell morphogenesis	16175	240		0.5084745762711864	0.5166666666666667	651	15524	7	7	644	15517	16175	0.06885035338212095
M1	cpdb	0	network_modules	325	TRUE	6.360384300162065e-4	19	14	3	0.21428571428571427	0.15789473684210525	GO:0003184	GO:BP	pulmonary valve morphogenesis	16175	1614		0.5254237288135594	0.5333333333333333	19	16156	3	11	16	16145	16175	0.1831202880115945
M1	cpdb	0	network_modules	325	TRUE	7.954126925432526e-4	83	14	4	0.2857142857142857	0.04819277108433735	GO:0003206	GO:BP	cardiac chamber morphogenesis	16175	1636		0.5423728813559322	0.55	83	16092	4	10	79	16082	16175	0.11558230448823109
M1	cpdb	0	network_modules	325	TRUE	7.958666656058374e-4	684	14	7	0.5	0.01023391812865497	GO:0031175	GO:BP	neuron projection development	16175	7086		0.559322033898305	0.5666666666666667	684	15491	7	7	677	15484	16175	0.06694208048178173
M1	cpdb	0	network_modules	325	TRUE	8.721032248619976e-4	21	14	3	0.21428571428571427	0.14285714285714285	GO:1902742	GO:BP	apoptotic process involved in development	16175	22468		0.576271186440678	0.5833333333333334	21	16154	3	11	18	16143	16175	0.17409185260561777
M1	cpdb	0	network_modules	325	TRUE	8.918977271069437e-4	2	14	2	0.14285714285714285	1	GO:0021836	GO:BP	chemorepulsion involved in postnatal olfactory bulb interneuron migration	16175	6410		0.5932203389830508	0.6666666666666666	2	16173	2	12	0	16161	16175	0.377824226446696
M1	cpdb	0	network_modules	325	TRUE	8.918977271069437e-4	2	14	2	0.14285714285714285	1	GO:0021827	GO:BP	postnatal olfactory bulb interneuron migration	16175	6401		0.5932203389830508	0.6666666666666666	2	16173	2	12	0	16161	16175	0.377824226446696
M1	cpdb	0	network_modules	325	TRUE	8.918977271069437e-4	2	14	2	0.14285714285714285	1	GO:0021823	GO:BP	cerebral cortex tangential migration using cell-cell interactions	16175	6397		0.5932203389830508	0.6666666666666666	2	16173	2	12	0	16161	16175	0.377824226446696
M1	cpdb	0	network_modules	325	TRUE	8.918977271069437e-4	2	14	2	0.14285714285714285	1	GO:0021825	GO:BP	substrate-dependent cerebral cortex tangential migration	16175	6399		0.5932203389830508	0.6666666666666666	2	16173	2	12	0	16161	16175	0.377824226446696
M1	cpdb	0	network_modules	325	TRUE	8.918977271069437e-4	2	14	2	0.14285714285714285	1	GO:0050925	GO:BP	negative regulation of negative chemotaxis	16175	13367		0.5932203389830508	0.6666666666666666	2	16173	2	12	0	16161	16175	0.377824226446696
M1	cpdb	0	network_modules	325	TRUE	0.0010062884797903415	4	9	2	0.2222222222222222	0.5	REAC:R-HSA-8985586	REAC	SLIT2:ROBO1 increases RHOA activity	10916	2148		0.7142857142857143	0.75	4	10912	2	7	2	10905	10916	0.33298196636404515
M1	cpdb	0	network_modules	325	TRUE	0.0010092884492147647	22	14	3	0.21428571428571427	0.13636363636363635	GO:0042698	GO:BP	ovulation cycle	16175	10308		0.6779661016949152	0.6833333333333333	22	16153	3	11	19	16142	16175	0.17004509759073805
M1	cpdb	0	network_modules	325	TRUE	0.0011600894323542772	23	14	3	0.21428571428571427	0.13043478260869565	GO:0003177	GO:BP	pulmonary valve development	16175	1607		0.6949152542372882	0.7	23	16152	3	11	20	16141	16175	0.16626424487184172
M1	cpdb	0	network_modules	325	TRUE	0.0015519799563313667	98	14	4	0.2857142857142857	0.04081632653061224	GO:0003205	GO:BP	cardiac chamber development	16175	1635		0.711864406779661	0.7166666666666667	98	16077	4	10	94	16067	16175	0.10606744214943258
M1	cpdb	0	network_modules	325	TRUE	0.0016344437281080378	761	14	7	0.5	0.009198423127463863	GO:0048666	GO:BP	neuron development	16175	12924		0.7288135593220338	0.7333333333333333	761	15414	7	7	754	15407	16175	0.06296170076047938
M1	cpdb	0	network_modules	325	TRUE	0.0019141112475101834	171	9	4	0.4444444444444444	0.023391812865497075	REAC:R-HSA-9010553	REAC	Regulation of expression of SLITs and ROBOs	10916	2031		0.8571428571428571	0.875	171	10745	4	5	167	10740	10916	0.0991892799285218
M1	cpdb	0	network_modules	325	TRUE	0.0019459210357498865	781	14	7	0.5	0.008962868117797696	GO:0030334	GO:BP	regulation of cell migration	16175	6780		0.7457627118644068	0.75	781	15394	7	7	774	15387	16175	0.06202089559950842
M1	cpdb	0	network_modules	325	TRUE	0.002386224746333355	29	14	3	0.21428571428571427	0.10344827586206896	GO:0048846	GO:BP	axon extension involved in axon guidance	16175	13090		0.7627118644067796	0.7833333333333333	29	16146	3	11	26	16135	16175	0.1478383093304823
M1	cpdb	0	network_modules	325	TRUE	0.002386224746333355	29	14	3	0.21428571428571427	0.10344827586206896	GO:1902284	GO:BP	neuron projection extension involved in neuron projection guidance	16175	22177		0.7627118644067796	0.7833333333333333	29	16146	3	11	26	16135	16175	0.1478383093304823
M1	cpdb	0	network_modules	325	TRUE	0.0026743696454616496	3	14	2	0.14285714285714285	0.6666666666666666	GO:0022028	GO:BP	tangential migration from the subventricular zone to the olfactory bulb	16175	6580		0.7966101694915254	0.8166666666666667	3	16172	2	12	1	16160	16175	0.30836810188211866
M1	cpdb	0	network_modules	325	TRUE	0.0026743696454616496	3	14	2	0.14285714285714285	0.6666666666666666	GO:0051414	GO:BP	response to cortisol	16175	13701		0.7966101694915254	0.8166666666666667	3	16172	2	12	1	16160	16175	0.30836810188211866
M1	cpdb	0	network_modules	325	TRUE	0.003555742953386264	33	14	3	0.21428571428571427	0.09090909090909091	GO:0008038	GO:BP	neuron recognition	16175	3100		0.8305084745762712	0.8333333333333334	33	16142	3	11	30	16131	16175	0.13844494424757176
M1	cpdb	0	network_modules	325	TRUE	0.0035694366234760005	283	14	5	0.35714285714285715	0.0176678445229682	GO:0040013	GO:BP	negative regulation of locomotion	16175	9901		0.847457627118644	0.85	283	15892	5	9	278	15883	16175	0.0762463612572787
M1	cpdb	0	network_modules	325	TRUE	0.004646105512558419	36	14	3	0.21428571428571427	0.08333333333333333	GO:0008585	GO:BP	female gonad development	16175	3196		0.864406779661017	0.8666666666666667	36	16139	3	11	33	16128	16175	0.13244742079327596
M1	cpdb	0	network_modules	325	TRUE	0.0046879858427047475	8	9	2	0.2222222222222222	0.25	REAC:R-HSA-428890	REAC	Role of ABL in ROBO-SLIT signaling	10916	2107		1	1	8	10908	2	7	6	10901	10916	0.23510800786592262
M1	cpdb	0	network_modules	325	TRUE	0.005053475393522414	37	14	3	0.21428571428571427	0.08108108108108109	GO:0046545	GO:BP	development of primary female sexual characteristics	16175	12230		0.8813559322033898	0.8833333333333333	37	16138	3	11	34	16127	16175	0.13061128938503644
M1	cpdb	0	network_modules	325	TRUE	0.005346093569584706	4	14	2	0.14285714285714285	0.5	GO:0016199	GO:BP	axon midline choice point recognition	16175	5171		0.8983050847457628	0.9166666666666666	4	16171	2	12	2	16159	16175	0.26694714088648164
M1	cpdb	0	network_modules	325	TRUE	0.005346093569584706	4	14	2	0.14285714285714285	0.5	GO:0021800	GO:BP	cerebral cortex tangential migration	16175	6378		0.8983050847457628	0.9166666666666666	4	16171	2	12	2	16159	16175	0.26694714088648164
M1	cpdb	0	network_modules	325	TRUE	0.007447360449651994	42	14	3	0.21428571428571427	0.07142857142857142	GO:0046660	GO:BP	female sex differentiation	16175	12293		0.9322033898305084	0.95	42	16133	3	11	39	16122	16175	0.12243074899806905
M1	cpdb	0	network_modules	325	TRUE	0.007447360449651994	42	14	3	0.21428571428571427	0.07142857142857142	GO:0021954	GO:BP	central nervous system neuron development	16175	6509		0.9322033898305084	0.95	42	16133	3	11	39	16122	16175	0.12243074899806905
M1	cpdb	0	network_modules	325	TRUE	0.008905748663263038	5	14	2	0.14285714285714285	0.4	GO:0016198	GO:BP	axon choice point recognition	16175	5170		0.9661016949152542	0.9833333333333333	5	16170	2	12	3	16158	16175	0.2386686524028136
M1	cpdb	0	network_modules	325	TRUE	0.008905748663263038	5	14	2	0.14285714285714285	0.4	GO:0051964	GO:BP	negative regulation of synapse assembly	16175	14033		0.9661016949152542	0.9833333333333333	5	16170	2	12	3	16158	16175	0.2386686524028136
M1	cpdb	0	network_modules	325	TRUE	0.009827550328461129	46	14	3	0.21428571428571427	0.06521739130434782	GO:0050772	GO:BP	positive regulation of axonogenesis	16175	13246		1	1	46	16129	3	11	43	16118	16175	0.11686445615212243
M1	cpdb	0	network_modules	326	TRUE	1.0825527492355937e-18	41	17	10	0.5882352941176471	0.24390243902439024	REAC:R-HSA-9917777	REAC	Epigenetic regulation by WDR5-containing histone modifying complexes	10916	850		0	0.14285714285714285	41	10875	10	7	31	10868	10916	0.37736121743404133
M1	cpdb	0	network_modules	326	TRUE	1.0825527492355937e-18	41	17	10	0.5882352941176471	0.24390243902439024	REAC:R-HSA-9772755	REAC	Formation of WDR5-containing histone-modifying complexes	10916	952		0	0.14285714285714285	41	10875	10	7	31	10868	10916	0.37736121743404133
M1	cpdb	0	network_modules	326	TRUE	9.285748193955018e-14	185	17	11	0.6470588235294118	0.05945945945945946	REAC:R-HSA-212165	REAC	Epigenetic regulation of gene expression	10916	852		0.15384615384615385	0.21428571428571427	185	10731	11	6	174	10725	10916	0.19279950528609166
M1	cpdb	0	network_modules	326	TRUE	9.618526740625746e-11	234	17	10	0.5882352941176471	0.042735042735042736	REAC:R-HSA-8878171	REAC	Transcriptional regulation by RUNX1	10916	2552		0.23076923076923078	0.2857142857142857	234	10682	10	7	224	10675	10916	0.15455726429689057
M1	cpdb	0	network_modules	326	TRUE	4.1954618521050953e-10	271	17	10	0.5882352941176471	0.03690036900369004	REAC:R-HSA-4839726	REAC	Chromatin organization	10916	356		0.3076923076923077	0.42857142857142855	271	10645	10	7	261	10638	10916	0.14300829652802266
M1	cpdb	0	network_modules	326	TRUE	4.1954618521050953e-10	271	17	10	0.5882352941176471	0.03690036900369004	REAC:R-HSA-3247509	REAC	Chromatin modifying enzymes	10916	355		0.3076923076923077	0.42857142857142855	271	10645	10	7	261	10638	10916	0.14300829652802266
M1	cpdb	0	network_modules	326	TRUE	5.471389060469463e-9	42	18	6	0.3333333333333333	0.14285714285714285	GO:0141137	GO:BP	positive regulation of gene expression, epigenetic	16175	20039		0	0.2222222222222222	42	16133	6	12	36	16121	16175	0.21692040184407232
M1	cpdb	0	network_modules	326	TRUE	5.471389060469463e-9	42	18	6	0.3333333333333333	0.14285714285714285	GO:0045815	GO:BP	transcription initiation-coupled chromatin remodeling	16175	11637		0	0.2222222222222222	42	16133	6	12	36	16121	16175	0.21692040184407232
M1	cpdb	0	network_modules	326	TRUE	1.8246615706823502e-8	95	17	7	0.4117647058823529	0.07368421052631578	REAC:R-HSA-8936459	REAC	RUNX1 regulates genes involved in megakaryocyte differentiation and platelet function	10916	1919		0.46153846153846156	0.5	95	10821	7	10	88	10811	10916	0.1713842432308736
M1	cpdb	0	network_modules	326	TRUE	6.357244779332856e-8	529	18	10	0.5555555555555556	0.01890359168241966	GO:0006325	GO:BP	chromatin organization	16175	2122		0.25	0.3333333333333333	529	15646	10	8	519	15638	16175	0.09811794135663716
M1	cpdb	0	network_modules	326	TRUE	2.1806436512177987e-7	70	17	6	0.35294117647058826	0.08571428571428572	REAC:R-HSA-3214841	REAC	PKMTs methylate histone lysines	10916	1691		0.5384615384615384	0.5714285714285714	70	10846	6	11	64	10835	10916	0.17145489519795185
M1	cpdb	0	network_modules	326	TRUE	5.54575310112563e-7	454	18	9	0.5	0.019823788546255508	GO:0006338	GO:BP	chromatin remodeling	16175	2126		0.375	0.4444444444444444	454	15721	9	9	445	15712	16175	0.09536995763489577
M1	cpdb	0	network_modules	326	TRUE	9.395264329162466e-6	231	17	7	0.4117647058823529	0.030303030303030304	REAC:R-HSA-201681	REAC	TCF dependent signaling in response to WNT	10916	2421		0.6153846153846154	0.6428571428571429	231	10685	7	10	224	10675	10916	0.10718576281518079
M1	cpdb	0	network_modules	326	TRUE	1.0442621198638027e-5	143	18	6	0.3333333333333333	0.04195804195804196	GO:0006367	GO:BP	transcription initiation at RNA polymerase II promoter	16175	2142		0.5	0.5555555555555556	143	16032	6	12	137	16020	16175	0.1157025715879115
M1	cpdb	0	network_modules	326	TRUE	3.2720318784611635e-5	173	18	6	0.3333333333333333	0.03468208092485549	GO:0006352	GO:BP	DNA-templated transcription initiation	16175	2129		0.625	0.6666666666666666	173	16002	6	12	167	15990	16175	0.10469001532812665
M1	cpdb	0	network_modules	326	TRUE	1.0092741543121195e-4	209	18	6	0.3333333333333333	0.028708133971291867	GO:0040029	GO:BP	epigenetic regulation of gene expression	16175	9916		0.75	0.7777777777777778	209	15966	6	12	203	15954	16175	0.09469737962271575
M1	cpdb	0	network_modules	326	TRUE	1.0166062470936952e-4	327	17	7	0.4117647058823529	0.021406727828746176	REAC:R-HSA-195721	REAC	Signaling by WNT	10916	2314		0.6923076923076923	0.7142857142857143	327	10589	7	10	320	10579	10916	0.08845840535531672
M1	cpdb	0	network_modules	326	TRUE	1.4482752461368308e-4	42	17	4	0.23529411764705882	0.09523809523809523	REAC:R-HSA-3769402	REAC	Deactivation of the beta-catenin transactivating complex	10916	452		0.7692307692307693	0.7857142857142857	42	10874	4	13	38	10861	10916	0.14764749111371728
M1	cpdb	0	network_modules	326	TRUE	2.7405148382537536e-4	120	17	5	0.29411764705882354	0.041666666666666664	REAC:R-HSA-5619507	REAC	Activation of HOX genes during differentiation	10916	84		0.8461538461538461	0.9285714285714286	120	10796	5	12	115	10784	10916	0.10723837403099336
M1	cpdb	0	network_modules	326	TRUE	2.7405148382537536e-4	120	17	5	0.29411764705882354	0.041666666666666664	REAC:R-HSA-5617472	REAC	Activation of anterior HOX genes in hindbrain development during early embryogenesis	10916	99		0.8461538461538461	0.9285714285714286	120	10796	5	12	115	10784	10916	0.10723837403099336
M1	cpdb	0	network_modules	326	TRUE	2.942765826887972e-4	153	15	5	0.3333333333333333	0.032679738562091505	KEGG:04934	KEGG	Cushing syndrome	8484	391		0	0.5	153	8331	5	10	148	8321	8484	0.09971467240821394
M1	cpdb	0	network_modules	326	TRUE	4.694991816370838e-4	13	18	3	0.16666666666666666	0.23076923076923078	GO:0045064	GO:BP	T-helper 2 cell differentiation	16175	11262		0.875	0.8888888888888888	13	16162	3	15	10	16147	16175	0.19535762029137801
M1	cpdb	0	network_modules	326	TRUE	7.128299603135175e-4	84	15	4	0.26666666666666666	0.047619047619047616	KEGG:03083	KEGG	Polycomb repressive complex	8484	220		1	1	84	8400	4	11	80	8389	8484	0.10914099414294849
M1	cpdb	0	network_modules	326	TRUE	0.00315795548890815	90	17	4	0.23529411764705882	0.044444444444444446	REAC:R-HSA-201722	REAC	Formation of the beta-catenin:TCF transactivating complex	10916	968		1	1	90	10826	4	13	86	10813	10916	0.09916527894147638
M1	cpdb	0	network_modules	326	TRUE	0.0059320058446771335	29	18	3	0.16666666666666666	0.10344827586206896	GO:0042092	GO:BP	type 2 immune response	16175	9963		1	1	29	16146	3	15	26	16131	16175	0.13008292443451058
M1	cpdb	0	network_modules	327	TRUE	7.276998834909895e-12	14	18	6	0.3333333333333333	0.42857142857142855	REAC:R-HSA-177504	REAC	Retrograde neurotrophin signalling	10916	2095		0	0.034482758620689655	14	10902	6	12	8	10890	10916	0.37706291272368736
M1	cpdb	0	network_modules	327	TRUE	1.211689152253981e-11	15	18	6	0.3333333333333333	0.4	REAC:R-HSA-5099900	REAC	WNT5A-dependent internalization of FZD4	10916	2672		0.03571428571428571	0.06896551724137931	15	10901	6	12	9	10889	10916	0.3641935855788142
M1	cpdb	0	network_modules	327	TRUE	1.2759640105520837e-10	144	18	9	0.5	0.0625	REAC:R-HSA-8856828	REAC	Clathrin-mediated endocytosis	10916	372		0.07142857142857142	0.10344827586206896	144	10772	9	9	135	10763	10916	0.17340235142021526
M1	cpdb	0	network_modules	327	TRUE	6.448187717362011e-10	104	18	8	0.4444444444444444	0.07692307692307693	REAC:R-HSA-8856825	REAC	Cargo recognition for clathrin-mediated endocytosis	10916	309		0.10714285714285714	0.13793103448275862	104	10812	8	10	96	10802	10916	0.18195467484955974
M1	cpdb	0	network_modules	327	TRUE	1.6117614741712871e-9	12	18	5	0.2777777777777778	0.4166666666666667	REAC:R-HSA-190873	REAC	Gap junction degradation	10916	1034		0.14285714285714285	0.1724137931034483	12	10904	5	13	7	10891	10916	0.3393268339790649
M1	cpdb	0	network_modules	327	TRUE	2.6165110138067144e-9	13	18	5	0.2777777777777778	0.38461538461538464	REAC:R-HSA-5140745	REAC	WNT5A-dependent internalization of FZD2, FZD5 and ROR2	10916	2671		0.17857142857142858	0.20689655172413793	13	10903	5	13	8	10890	10916	0.32592167822666973
M1	cpdb	0	network_modules	327	TRUE	7.353259053243242e-9	44	18	6	0.3333333333333333	0.13636363636363635	GO:0072583	GO:BP	clathrin-dependent endocytosis	16175	17454		0	0.0625	44	16131	6	12	38	16119	16175	0.21186695995014515
M1	cpdb	0	network_modules	327	TRUE	7.402493433227078e-9	53	14	6	0.42857142857142855	0.11320754716981132	KEGG:04961	KEGG	Endocrine and other factor-regulated calcium reabsorption	8484	397		0	0.25	53	8431	6	8	47	8423	8484	0.2179172658998068
M1	cpdb	0	network_modules	327	TRUE	8.853842942859323e-9	16	18	5	0.2777777777777778	0.3125	REAC:R-HSA-8866427	REAC	VLDLR internalisation and degradation	10916	2639		0.21428571428571427	0.2413793103448276	16	10900	5	13	11	10887	10916	0.29353030496506693
M1	cpdb	0	network_modules	327	TRUE	2.3499530007239846e-8	19	18	5	0.2777777777777778	0.2631578947368421	REAC:R-HSA-8964038	REAC	LDL clearance	10916	1295		0.25	0.27586206896551724	19	10897	5	13	14	10884	10916	0.2691310070674166
M1	cpdb	0	network_modules	327	TRUE	3.278413099615361e-8	49	18	6	0.3333333333333333	0.12244897959183673	REAC:R-HSA-3928665	REAC	EPH-ephrin mediated repulsion of cells	10916	819		0.2857142857142857	0.3103448275862069	49	10867	6	12	43	10855	10916	0.19992361656672564
M1	cpdb	0	network_modules	327	TRUE	8.115326538757834e-8	78	14	6	0.42857142857142855	0.07692307692307693	KEGG:04721	KEGG	Synaptic vesicle cycle	8484	351		0.3333333333333333	0.5	78	8406	6	8	72	8398	8484	0.1786431064932331
M1	cpdb	0	network_modules	327	TRUE	1.7210988687568265e-7	123	18	7	0.3888888888888889	0.056910569105691054	REAC:R-HSA-2132295	REAC	MHC class II antigen presentation	10916	1371		0.32142857142857145	0.3448275862068966	123	10793	7	11	116	10782	10916	0.14539815661282446
M1	cpdb	0	network_modules	327	TRUE	5.233159986258283e-7	11	18	4	0.2222222222222222	0.36363636363636365	REAC:R-HSA-196025	REAC	Formation of annular gap junctions	10916	954		0.35714285714285715	0.3793103448275862	11	10905	4	14	7	10891	10916	0.28335497606510873
M1	cpdb	0	network_modules	327	TRUE	7.491074323255705e-7	36	18	5	0.2777777777777778	0.1388888888888889	REAC:R-HSA-8964043	REAC	Plasma lipoprotein clearance	10916	1757		0.39285714285714285	0.41379310344827586	36	10880	5	13	31	10867	10916	0.19456789190387858
M1	cpdb	0	network_modules	327	TRUE	1.4041001038543698e-6	90	18	6	0.3333333333333333	0.06666666666666667	REAC:R-HSA-2682334	REAC	EPH-Ephrin signaling	10916	818		0.42857142857142855	0.4482758620689655	90	10826	6	12	84	10814	10916	0.14610759488784666
M1	cpdb	0	network_modules	327	TRUE	1.6050421606471918e-6	92	18	6	0.3333333333333333	0.06521739130434782	REAC:R-HSA-4086400	REAC	PCP/CE pathway	10916	1659		0.4642857142857143	0.4827586206896552	92	10824	6	12	86	10812	10916	0.1444426403479196
M1	cpdb	0	network_modules	327	TRUE	2.283161810503677e-6	533	18	9	0.5	0.016885553470919325	GO:0006897	GO:BP	endocytosis	16175	2551		0.06666666666666667	0.125	533	15642	9	9	524	15633	16175	0.08732766948877817
M1	cpdb	0	network_modules	327	TRUE	3.234183099105533e-6	221	18	7	0.3888888888888889	0.03167420814479638	GO:0006898	GO:BP	receptor-mediated endocytosis	16175	2552		0.13333333333333333	0.1875	221	15954	7	11	214	15943	16175	0.10788522559170316
M1	cpdb	0	network_modules	327	TRUE	3.3620670476991494e-6	48	18	5	0.2777777777777778	0.10416666666666667	REAC:R-HSA-437239	REAC	Recycling pathway of L1	10916	1954		0.5	0.5172413793103449	48	10868	5	13	43	10855	10916	0.1679185120547368
M1	cpdb	0	network_modules	327	TRUE	3.7403946518699477e-6	49	18	5	0.2777777777777778	0.10204081632653061	REAC:R-HSA-190828	REAC	Gap junction trafficking	10916	1035		0.5357142857142857	0.5517241379310345	49	10867	5	13	44	10854	10916	0.16614817783143024
M1	cpdb	0	network_modules	327	TRUE	4.151858559864203e-6	50	18	5	0.2777777777777778	0.1	REAC:R-HSA-157858	REAC	Gap junction trafficking and regulation	10916	1036		0.5714285714285714	0.5862068965517241	50	10866	5	13	45	10853	10916	0.16443073584433804
M1	cpdb	0	network_modules	327	TRUE	5.283848308638425e-6	112	18	6	0.3333333333333333	0.05357142857142857	REAC:R-HSA-187037	REAC	Signaling by NTRK1 (TRKA)	10916	2284		0.6071428571428571	0.6206896551724138	112	10804	6	12	106	10792	10916	0.13029446430492986
M1	cpdb	0	network_modules	327	TRUE	1.3556071673501287e-5	131	18	6	0.3333333333333333	0.04580152671755725	REAC:R-HSA-166520	REAC	Signaling by NTRKs	10916	2287		0.6428571428571429	0.6551724137931034	131	10785	6	12	125	10773	10916	0.11993210157285872
M1	cpdb	0	network_modules	327	TRUE	2.2901089453863892e-5	143	18	6	0.3333333333333333	0.04195804195804196	REAC:R-HSA-3858494	REAC	Beta-catenin independent WNT signaling	10916	216		0.6785714285714286	0.6896551724137931	143	10773	6	12	137	10761	10916	0.11446073105457591
M1	cpdb	0	network_modules	327	TRUE	2.4985269256275505e-5	71	18	5	0.2777777777777778	0.07042253521126761	REAC:R-HSA-174824	REAC	Plasma lipoprotein assembly, remodeling, and clearance	10916	1756		0.7142857142857143	0.7241379310344828	71	10845	5	13	66	10832	10916	0.13714813241783394
M1	cpdb	0	network_modules	327	TRUE	2.682309490775459e-5	72	18	5	0.2777777777777778	0.06944444444444445	REAC:R-HSA-199992	REAC	trans-Golgi Network Vesicle Budding	10916	2749		0.75	0.7586206896551724	72	10844	5	13	67	10831	10916	0.13615267006339715
M1	cpdb	0	network_modules	327	TRUE	4.006978283366466e-5	740	18	9	0.5	0.012162162162162163	GO:0098657	GO:BP	import into cell	16175	18813		0.2	0.25	740	15435	9	9	731	15426	16175	0.07256485103112428
M1	cpdb	0	network_modules	327	TRUE	4.0504331429798743e-5	7	18	3	0.16666666666666666	0.42857142857142855	REAC:R-HSA-182218	REAC	Nef Mediated CD8 Down-regulation	10916	1561		0.7857142857142857	0.7931034482758621	7	10909	3	15	4	10894	10916	0.26653818629699677
M1	cpdb	0	network_modules	327	TRUE	8.355697432990752e-5	248	14	6	0.42857142857142855	0.024193548387096774	KEGG:04144	KEGG	Endocytosis	8484	280		0.6666666666666666	0.75	248	8236	6	8	242	8228	8484	0.09637884222968837
M1	cpdb	0	network_modules	327	TRUE	9.225033858072778e-5	8	18	3	0.16666666666666666	0.375	GO:0098884	GO:BP	postsynaptic neurotransmitter receptor internalization	16175	18929		0.26666666666666666	0.375	8	16167	3	15	5	16152	16175	0.24945861854572904
M1	cpdb	0	network_modules	327	TRUE	9.225033858072778e-5	8	18	3	0.16666666666666666	0.375	GO:0140239	GO:BP	postsynaptic endocytosis	16175	19710		0.26666666666666666	0.375	8	16167	3	15	5	16152	16175	0.24945861854572904
M1	cpdb	0	network_modules	327	TRUE	9.701007011701141e-5	9	18	3	0.16666666666666666	0.3333333333333333	REAC:R-HSA-167590	REAC	Nef Mediated CD4 Down-regulation	10916	1560		0.8214285714285714	0.8275862068965517	9	10907	3	15	6	10892	10916	0.23482670676417305
M1	cpdb	0	network_modules	327	TRUE	1.0880575641449971e-4	103	18	5	0.2777777777777778	0.04854368932038835	GO:0031623	GO:BP	receptor internalization	16175	7240		0.4	0.4375	103	16072	5	13	98	16059	16175	0.11388652249671398
M1	cpdb	0	network_modules	327	TRUE	1.5009143980505716e-4	327	18	7	0.3888888888888889	0.021406727828746176	REAC:R-HSA-195721	REAC	Signaling by WNT	10916	2314		0.8571428571428571	0.8620689655172413	327	10589	7	11	320	10578	10916	0.08557329365331955
M1	cpdb	0	network_modules	327	TRUE	2.7896076220608766e-4	305	14	6	0.42857142857142855	0.019672131147540985	KEGG:05016	KEGG	Huntington disease	8484	414		1	1	305	8179	6	8	299	8171	8484	0.08574265389293483
M1	cpdb	0	network_modules	327	TRUE	3.340910865771053e-4	119	18	5	0.2777777777777778	0.04201680672268908	REAC:R-HSA-373760	REAC	L1CAM interactions	10916	1294		0.8928571428571429	0.896551724137931	119	10797	5	13	114	10784	10916	0.10445071891674482
M1	cpdb	0	network_modules	327	TRUE	5.971287207070677e-4	14	18	3	0.16666666666666666	0.21428571428571427	GO:0099590	GO:BP	neurotransmitter receptor internalization	16175	19154		0.4666666666666667	0.5	14	16161	3	15	11	16146	16175	0.18818696645136737
M1	cpdb	0	network_modules	327	TRUE	7.926640268529954e-4	2	18	2	0.1111111111111111	1	REAC:R-HSA-168275	REAC	Entry of Influenza Virion into Host Cell via Endocytosis	10916	846		0.9285714285714286	0.9310344827586207	2	10914	2	16	0	10898	10916	0.3330889092246938
M1	cpdb	0	network_modules	327	TRUE	9.173818459400518e-4	16	18	3	0.16666666666666666	0.1875	GO:0048268	GO:BP	clathrin coat assembly	16175	12619		0.5333333333333333	0.5625	16	16159	3	15	13	16144	16175	0.17591239566271397
M1	cpdb	0	network_modules	327	TRUE	0.0015170981055791966	21	18	3	0.16666666666666666	0.14285714285714285	REAC:R-HSA-164938	REAC	Nef-mediates down modulation of cell surface receptors by recruiting them to clathrin adapters	10916	1565		0.9642857142857143	0.9655172413793104	21	10895	3	15	18	10880	10916	0.1527952243258098
M1	cpdb	0	network_modules	327	TRUE	0.0016806361988642071	74	18	4	0.2222222222222222	0.05405405405405406	GO:0006900	GO:BP	vesicle budding from membrane	16175	2553		0.6	0.625	74	16101	4	14	70	16087	16175	0.10764927279493108
M1	cpdb	0	network_modules	327	TRUE	0.0033158894576206213	27	18	3	0.16666666666666666	0.1111111111111111	REAC:R-HSA-164952	REAC	The role of Nef in HIV-1 replication and disease pathogenesis	10916	2504		1	1	27	10889	3	15	24	10874	10916	0.13434012607631576
M1	cpdb	0	network_modules	327	TRUE	0.003744293020718923	25	18	3	0.16666666666666666	0.12	GO:1903077	GO:BP	negative regulation of protein localization to plasma membrane	16175	22752		0.6666666666666666	0.6875	25	16150	3	15	22	16135	16175	0.14029636220631622
M1	cpdb	0	network_modules	327	TRUE	0.00475514081022092	27	18	3	0.16666666666666666	0.1111111111111111	GO:1904376	GO:BP	negative regulation of protein localization to cell periphery	16175	23763		0.7333333333333333	0.75	27	16148	3	15	24	16133	16175	0.13490749891953285
M1	cpdb	0	network_modules	327	TRUE	0.005009523127675268	3	18	2	0.1111111111111111	0.6666666666666666	GO:1900126	GO:BP	negative regulation of hyaluronan biosynthetic process	16175	20412		0.8	0.8125	3	16172	2	16	1	16156	16175	0.27188774182133574
M1	cpdb	0	network_modules	327	TRUE	0.008832800280071943	33	18	3	0.16666666666666666	0.09090909090909091	GO:1905476	GO:BP	negative regulation of protein localization to membrane	16175	24662		0.8666666666666667	0.875	33	16142	3	15	30	16127	16175	0.12177670909042501
M1	cpdb	0	network_modules	327	TRUE	0.009680847687859267	34	18	3	0.16666666666666666	0.08823529411764706	GO:0035459	GO:BP	vesicle cargo loading	16175	9047		0.9333333333333333	1	34	16141	3	15	31	16126	16175	0.11993117043636657
M1	cpdb	0	network_modules	327	TRUE	0.009680847687859267	34	18	3	0.16666666666666666	0.08823529411764706	GO:0099072	GO:BP	regulation of postsynaptic membrane neurotransmitter receptor levels	16175	19029		0.9333333333333333	1	34	16141	3	15	31	16126	16175	0.11993117043636657
M1	cpdb	0	network_modules	328	TRUE	9.82328442804633e-13	12	18	6	0.3333333333333333	0.5	GO:0000727	GO:BP	double-strand break repair via break-induced replication	16175	205		0	0.034482758620689655	12	16163	6	12	6	16151	16175	0.4077177768150717
M1	cpdb	0	network_modules	328	TRUE	1.0058687228799449e-12	12	16	6	0.375	0.5	REAC:R-HSA-176974	REAC	Unwinding of DNA	10916	2625		0	0.06666666666666667	12	10904	6	10	6	10894	10916	0.4322977735003722
M1	cpdb	0	network_modules	328	TRUE	1.8231634445906024e-12	13	18	6	0.3333333333333333	0.46153846153846156	GO:0030174	GO:BP	regulation of DNA-templated DNA replication initiation	16175	6696		0.03571428571428571	0.06896551724137931	13	16162	6	12	7	16150	16175	0.3916618700405884
M1	cpdb	0	network_modules	328	TRUE	5.7359889154159825e-11	21	18	6	0.3333333333333333	0.2857142857142857	GO:0006268	GO:BP	DNA unwinding involved in DNA replication	16175	2083		0.07142857142857142	0.10344827586206896	21	16154	6	12	15	16142	16175	0.30777575256789563
M1	cpdb	0	network_modules	328	TRUE	3.4433018970999943e-10	36	13	6	0.46153846153846156	0.16666666666666666	KEGG:03030	KEGG	DNA replication	8484	214		0	0.5	36	8448	6	7	30	8441	8484	0.2755963211746822
M1	cpdb	0	network_modules	328	TRUE	3.4660053963173914e-10	187	16	9	0.5625	0.0481283422459893	REAC:R-HSA-69306	REAC	DNA Replication	10916	445		0.07142857142857142	0.13333333333333333	187	10729	9	7	178	10722	10916	0.1610276433628228
M1	cpdb	0	network_modules	328	TRUE	9.512053584364707e-10	32	18	6	0.3333333333333333	0.1875	GO:0006270	GO:BP	DNA replication initiation	16175	2085		0.10714285714285714	0.13793103448275862	32	16143	6	12	26	16131	16175	0.24890095217273667
M1	cpdb	0	network_modules	328	TRUE	9.710823419781208e-10	32	16	6	0.375	0.1875	REAC:R-HSA-69190	REAC	DNA strand elongation	10916	449		0.14285714285714285	0.2	32	10884	6	10	26	10874	10916	0.2636719579912441
M1	cpdb	0	network_modules	328	TRUE	1.1859444000271736e-9	33	16	6	0.375	0.18181818181818182	REAC:R-HSA-68962	REAC	Activation of the pre-replicative complex	10916	107		0.21428571428571427	0.26666666666666666	33	10883	6	10	27	10873	10916	0.25959419263245
M1	cpdb	0	network_modules	328	TRUE	1.272895319432751e-9	71	16	7	0.4375	0.09859154929577464	REAC:R-HSA-68949	REAC	Orc1 removal from chromatin	10916	1644		0.2857142857142857	0.3333333333333333	71	10845	7	9	64	10836	10916	0.20541839932215294
M1	cpdb	0	network_modules	328	TRUE	2.4814681349887063e-9	37	16	6	0.375	0.16216216216216217	REAC:R-HSA-176187	REAC	Activation of ATR in response to replication stress	10916	75		0.35714285714285715	0.4	37	10879	6	10	31	10869	10916	0.24496434253908855
M1	cpdb	0	network_modules	328	TRUE	2.5410480149100246e-9	142	16	8	0.5	0.056338028169014086	REAC:R-HSA-68867	REAC	Assembly of the pre-replicative complex	10916	181		0.42857142857142855	0.4666666666666667	142	10774	8	8	134	10766	10916	0.1646641500664363
M1	cpdb	0	network_modules	328	TRUE	6.345855383748346e-9	159	16	8	0.5	0.050314465408805034	REAC:R-HSA-69002	REAC	DNA Replication Pre-Initiation	10916	446		0.5	0.5333333333333333	159	10757	8	8	151	10749	10916	0.15523745542913175
M1	cpdb	0	network_modules	328	TRUE	6.354590417323483e-9	43	18	6	0.3333333333333333	0.13953488372093023	GO:0090329	GO:BP	regulation of DNA-templated DNA replication	16175	18209		0.14285714285714285	0.1724137931034483	43	16132	6	12	37	16120	16175	0.21434980302313636
M1	cpdb	0	network_modules	328	TRUE	7.353259053243242e-9	44	18	6	0.3333333333333333	0.13636363636363635	GO:0032508	GO:BP	DNA duplex unwinding	16175	7615		0.17857142857142858	0.20689655172413793	44	16131	6	12	38	16119	16175	0.21186695995014515
M1	cpdb	0	network_modules	328	TRUE	8.258249292752277e-9	92	16	7	0.4375	0.07608695652173914	REAC:R-HSA-69052	REAC	Switching of origins to a post-replicative state	10916	2365		0.5714285714285714	0.6	92	10824	7	9	85	10815	10916	0.17982606580760124
M1	cpdb	0	network_modules	328	TRUE	9.430464467759527e-9	167	16	8	0.5	0.04790419161676647	REAC:R-HSA-69481	REAC	G2/M Checkpoints	10916	1005		0.6428571428571429	0.6666666666666666	167	10749	8	8	159	10741	10916	0.15130115274522052
M1	cpdb	0	network_modules	328	TRUE	1.7601373882706325e-8	289	16	9	0.5625	0.031141868512110725	REAC:R-HSA-69620	REAC	Cell Cycle Checkpoints	10916	321		0.7142857142857143	0.7333333333333333	289	10627	9	7	280	10620	10916	0.1279207905914627
M1	cpdb	0	network_modules	328	TRUE	2.109915511197366e-8	52	18	6	0.3333333333333333	0.11538461538461539	GO:0032392	GO:BP	DNA geometric change	16175	7543		0.21428571428571427	0.2413793103448276	52	16123	6	12	46	16111	16175	0.194645979642341
M1	cpdb	0	network_modules	328	TRUE	5.162117036740418e-8	60	18	6	0.3333333333333333	0.1	GO:0071103	GO:BP	DNA conformation change	16175	16453		0.25	0.27586206896551724	60	16115	6	12	54	16103	16175	0.1809789647699435
M1	cpdb	0	network_modules	328	TRUE	5.530764223181527e-8	157	13	7	0.5384615384615384	0.044585987261146494	KEGG:04110	KEGG	Cell cycle	8484	264		1	1	157	8327	7	6	150	8321	8484	0.15113935969150874
M1	cpdb	0	network_modules	328	TRUE	5.827801307554734e-8	121	16	7	0.4375	0.05785123966942149	REAC:R-HSA-69239	REAC	Synthesis of DNA	10916	2376		0.7857142857142857	0.8	121	10795	7	9	114	10786	10916	0.1560411328011917
M1	cpdb	0	network_modules	328	TRUE	9.686578301052116e-8	130	16	7	0.4375	0.05384615384615385	REAC:R-HSA-69206	REAC	G1/S Transition	10916	1002		0.8571428571428571	0.8666666666666667	130	10786	7	9	123	10777	10916	0.15031443673954356
M1	cpdb	0	network_modules	328	TRUE	2.3056042517070943e-7	147	16	7	0.4375	0.047619047619047616	REAC:R-HSA-453279	REAC	Mitotic G1 phase and G1/S transition	10916	1480		0.9285714285714286	0.9333333333333333	147	10769	7	9	140	10760	10916	0.14094968562649987
M1	cpdb	0	network_modules	328	TRUE	4.5638020660969725e-7	162	16	7	0.4375	0.043209876543209874	REAC:R-HSA-69242	REAC	S Phase	10916	2111		1	1	162	10754	7	9	155	10745	10916	0.1339239583715057
M1	cpdb	0	network_modules	328	TRUE	1.0894726108473164e-6	13	18	4	0.2222222222222222	0.3076923076923077	GO:1902969	GO:BP	mitotic DNA replication	16175	22654		0.2857142857142857	0.3103448275862069	13	16162	4	14	9	16148	16175	0.26079237020778145
M1	cpdb	0	network_modules	328	TRUE	2.3862797262692627e-6	112	18	6	0.3333333333333333	0.05357142857142857	GO:0006275	GO:BP	regulation of DNA replication	16175	2090		0.32142857142857145	0.3448275862068966	112	16063	6	12	106	16051	16175	0.13138326585774493
M1	cpdb	0	network_modules	328	TRUE	1.232700227089432e-5	147	18	6	0.3333333333333333	0.04081632653061224	GO:0006261	GO:BP	DNA-templated DNA replication	16175	2078		0.35714285714285715	0.3793103448275862	147	16028	6	12	141	16016	16175	0.11404478923328663
M1	cpdb	0	network_modules	328	TRUE	1.6507701689426388e-5	5	18	3	0.16666666666666666	0.6	GO:1902975	GO:BP	mitotic DNA replication initiation	16175	22660		0.39285714285714285	0.4827586206896552	5	16170	3	15	2	16155	16175	0.3158658517749845
M1	cpdb	0	network_modules	328	TRUE	1.6507701689426388e-5	5	18	3	0.16666666666666666	0.6	GO:1902315	GO:BP	nuclear cell cycle DNA replication initiation	16175	22198		0.39285714285714285	0.4827586206896552	5	16170	3	15	2	16155	16175	0.3158658517749845
M1	cpdb	0	network_modules	328	TRUE	1.6507701689426388e-5	5	18	3	0.16666666666666666	0.6	GO:1902292	GO:BP	cell cycle DNA replication initiation	16175	22185		0.39285714285714285	0.4827586206896552	5	16170	3	15	2	16155	16175	0.3158658517749845
M1	cpdb	0	network_modules	328	TRUE	3.16057521403716e-5	172	18	6	0.3333333333333333	0.03488372093023256	GO:0000724	GO:BP	double-strand break repair via homologous recombination	16175	203		0.5	0.5172413793103449	172	16003	6	12	166	15991	16175	0.10501074349669322
M1	cpdb	0	network_modules	328	TRUE	3.626083564033024e-5	176	18	6	0.3333333333333333	0.03409090909090909	GO:0000725	GO:BP	recombinational repair	16175	204		0.5357142857142857	0.5517241379310345	176	15999	6	12	170	15987	16175	0.10374399425871476
M1	cpdb	0	network_modules	328	TRUE	5.729198946156724e-5	528	18	8	0.4444444444444444	0.015151515151515152	GO:0006281	GO:BP	DNA repair	16175	2095		0.5714285714285714	0.5862068965517241	528	15647	8	10	520	15637	16175	0.07734915555124085
M1	cpdb	0	network_modules	328	TRUE	7.857552522406033e-5	35	18	4	0.2222222222222222	0.11428571428571428	GO:0033260	GO:BP	nuclear DNA replication	16175	8103		0.6071428571428571	0.6206896551724138	35	16140	4	14	31	16126	16175	0.1580710439740319
M1	cpdb	0	network_modules	328	TRUE	1.2309045492211234e-4	39	18	4	0.2222222222222222	0.10256410256410256	GO:0044786	GO:BP	cell cycle DNA replication	16175	11158		0.6428571428571429	0.6551724137931034	39	16136	4	14	35	16122	16175	0.14959584833251832
M1	cpdb	0	network_modules	328	TRUE	1.8267931163589362e-4	231	18	6	0.3333333333333333	0.025974025974025976	GO:0006260	GO:BP	DNA replication	16175	2077		0.6785714285714286	0.6896551724137931	231	15944	6	12	225	15932	16175	0.08975467231030863
M1	cpdb	0	network_modules	328	TRUE	3.411081788047107e-4	435	18	7	0.3888888888888889	0.016091954022988506	GO:0051052	GO:BP	regulation of DNA metabolic process	16175	13462		0.7142857142857143	0.7241379310344828	435	15740	7	11	428	15729	16175	0.07468895801683431
M1	cpdb	0	network_modules	328	TRUE	5.799467062525852e-4	281	18	6	0.3333333333333333	0.021352313167259787	GO:0006310	GO:BP	DNA recombination	16175	2115		0.75	0.7586206896551724	281	15894	6	12	275	15882	16175	0.08071675271278402
M1	cpdb	0	network_modules	328	TRUE	7.458916454927434e-4	15	18	3	0.16666666666666666	0.2	GO:0006271	GO:BP	DNA strand elongation involved in DNA replication	16175	2086		0.7857142857142857	0.7931034482758621	15	16160	3	15	12	16145	16175	0.18174371332799277
M1	cpdb	0	network_modules	328	TRUE	8.18530287285041e-4	298	18	6	0.3333333333333333	0.020134228187919462	GO:0006302	GO:BP	double-strand break repair	16175	2109		0.8214285714285714	0.8275862068965517	298	15877	6	12	292	15865	16175	0.07816171080066697
M1	cpdb	0	network_modules	328	TRUE	0.0013623884608039095	798	18	8	0.4444444444444444	0.010025062656641603	GO:0006974	GO:BP	DNA damage response	16175	2601		0.8571428571428571	0.8620689655172413	798	15377	8	10	790	15367	16175	0.06089475734667062
M1	cpdb	0	network_modules	328	TRUE	0.0015840875911712722	19	18	3	0.16666666666666666	0.15789473684210525	GO:0006337	GO:BP	nucleosome disassembly	16175	2125		0.8928571428571429	0.896551724137931	19	16156	3	15	16	16141	16175	0.16126254114621588
M1	cpdb	0	network_modules	328	TRUE	0.0021712137722592595	21	18	3	0.16666666666666666	0.14285714285714285	GO:0032986	GO:BP	protein-DNA complex disassembly	16175	7966		0.9285714285714286	0.9310344827586207	21	16154	3	15	18	16139	16175	0.1532861548213182
M1	cpdb	0	network_modules	328	TRUE	0.003075998976787075	86	18	4	0.2222222222222222	0.046511627906976744	GO:0006334	GO:BP	nucleosome assembly	16175	2123		0.9642857142857143	0.9655172413793104	86	16089	4	14	82	16075	16175	0.09955354800887788
M1	cpdb	0	network_modules	328	TRUE	0.007096544593878963	106	18	4	0.2222222222222222	0.03773584905660377	GO:0034728	GO:BP	nucleosome organization	16175	8723		1	1	106	16069	4	14	102	16055	16175	0.08921550600589633
M1	cpdb	0	network_modules	330	TRUE	0.009653091233945903	200	11	4	0.36363636363636365	0.02	REAC:R-HSA-5617833	REAC	Cilium Assembly	10916	361		NA	1	200	10716	4	7	196	10709	10916	0.08177690465220319
M1	cpdb	0	network_modules	333	TRUE	1.6356727540971147e-5	37	4	3	0.75	0.08108108108108109	KEGG:05340	KEGG	Primary immunodeficiency	8484	488		0	0.3333333333333333	37	8447	3	1	34	8446	8484	0.24575883973771565
M1	cpdb	0	network_modules	333	TRUE	1.0998222640527579e-4	69	4	3	0.75	0.043478260869565216	KEGG:04612	KEGG	Antigen processing and presentation	8484	322		0.5	0.6666666666666666	69	8415	3	1	66	8414	8484	0.17939370631665968
M1	cpdb	0	network_modules	333	TRUE	1.472067141840827e-4	11	15	3	0.2	0.2727272727272727	GO:0045348	GO:BP	positive regulation of MHC class II biosynthetic process	16175	11371		0	0.3333333333333333	11	16164	3	12	8	16152	16175	0.23294276220709734
M1	cpdb	0	network_modules	333	TRUE	4.050306783481016e-4	15	15	3	0.2	0.2	GO:0045346	GO:BP	regulation of MHC class II biosynthetic process	16175	11369		0.5	0.6666666666666666	15	16160	3	12	12	16148	16175	0.19925742574257424
M1	cpdb	0	network_modules	333	TRUE	4.982218319547306e-4	16	15	3	0.2	0.1875	GO:0045342	GO:BP	MHC class II biosynthetic process	16175	11365		1	1	16	16159	3	12	13	16147	16175	0.19287622447182098
M1	cpdb	0	network_modules	333	TRUE	0.0018256130950379166	175	4	3	0.75	0.017142857142857144	KEGG:05152	KEGG	Tuberculosis	8484	440		1	1	175	8309	3	1	172	8308	8484	0.1114522834350581
M1	cpdb	0	network_modules	335	TRUE	1.386907197846704e-9	16	13	5	0.38461538461538464	0.3125	REAC:R-HSA-399956	REAC	CRMPs in Sema3A signaling	10916	287		0	0.5	16	10900	5	8	11	10892	10916	0.34582579638883537
M1	cpdb	0	network_modules	335	TRUE	2.3507636595431184e-6	64	13	5	0.38461538461538464	0.078125	REAC:R-HSA-373755	REAC	Semaphorin interactions	10916	2193		1	1	64	10852	5	8	59	10844	10916	0.17130606798071996
M1	cpdb	0	network_modules	336	TRUE	0.003247376984690485	58	9	3	0.3333333333333333	0.05172413793103448	REAC:R-HSA-8866654	REAC	E3 ubiquitin ligases ubiquitinate target proteins	10916	811		0	0.5	58	10858	3	6	55	10852	10916	0.12961151172049187
M1	cpdb	0	network_modules	336	TRUE	0.00794049895607631	78	9	3	0.3333333333333333	0.038461538461538464	REAC:R-HSA-8852135	REAC	Protein ubiquitination	10916	1818		1	1	78	10838	3	6	75	10832	10916	0.11124437038773598
M1	cpdb	0	network_modules	338	TRUE	3.66263747258867e-5	76	8	4	0.5	0.05263157894736842	REAC:R-HSA-909733	REAC	Interferon alpha/beta signaling	10916	1228		0	0.5	76	10840	4	4	72	10836	10916	0.16058119483681152
M1	cpdb	0	network_modules	338	TRUE	6.510034641154266e-5	49	13	4	0.3076923076923077	0.08163265306122448	GO:0140374	GO:BP	antiviral innate immune response	16175	19754		0	0.2	49	16126	4	9	45	16117	16175	0.15722683685621747
M1	cpdb	0	network_modules	338	TRUE	1.4072046537294623e-4	334	13	6	0.46153846153846156	0.017964071856287425	GO:0009615	GO:BP	response to virus	16175	3541		0.25	0.4	334	15841	6	7	328	15834	16175	0.08792926731344025
M1	cpdb	0	network_modules	338	TRUE	7.814746188648098e-4	228	13	5	0.38461538461538464	0.021929824561403508	GO:0051607	GO:BP	defense response to virus	16175	13823		0.5	0.6	228	15947	5	8	223	15939	16175	0.08914000018277231
M1	cpdb	0	network_modules	338	TRUE	0.003877433618986052	37	13	3	0.23076923076923078	0.08108108108108109	GO:0043330	GO:BP	response to exogenous dsRNA	16175	10636		0.75	0.8	37	16138	3	10	34	16128	16175	0.13564200894436634
M1	cpdb	0	network_modules	338	TRUE	0.005262126644945572	263	8	4	0.5	0.015209125475285171	REAC:R-HSA-913531	REAC	Interferon Signaling	10916	1227		1	1	263	10653	4	4	259	10649	10916	0.08405124349730685
M1	cpdb	0	network_modules	338	TRUE	0.005309751565146604	41	13	3	0.23076923076923078	0.07317073170731707	GO:0043331	GO:BP	response to dsRNA	16175	10637		1	1	41	16134	3	10	38	16124	16175	0.1287320445595764
M1	cpdb	0	network_modules	338	TRUE	0.0059630104934136965	158	6	3	0.5	0.0189873417721519	KEGG:05160	KEGG	Hepatitis C	8484	441		NA	1	158	8326	3	3	155	8323	8484	0.0947257179830611
M1	cpdb	0	network_modules	339	TRUE	1.3005685444489008e-15	8	12	6	0.5	0.75	GO:0097104	GO:BP	postsynaptic membrane assembly	16175	18497		0	0.011904761904761904	8	16167	6	6	2	16161	16175	0.6121451447043272
M1	cpdb	0	network_modules	339	TRUE	9.748059276291704e-15	10	12	6	0.5	0.6	GO:0097105	GO:BP	presynaptic membrane assembly	16175	18498		0.012048192771084338	0.023809523809523808	10	16165	6	6	4	16159	16175	0.5474175905363271
M1	cpdb	0	network_modules	339	TRUE	2.143890789065477e-14	11	12	6	0.5	0.5454545454545454	GO:0097090	GO:BP	presynaptic membrane organization	16175	18486		0.024096385542168676	0.03571428571428571	11	16164	6	6	5	16158	16175	0.5218937194291592
M1	cpdb	0	network_modules	339	TRUE	2.3195939306651305e-13	15	12	6	0.5	0.4	GO:0007158	GO:BP	neuron cell-cell adhesion	16175	2722		0.03614457831325301	0.047619047619047616	15	16160	6	6	9	16154	16175	0.44675701701237636
M1	cpdb	0	network_modules	339	TRUE	3.710169319033422e-13	16	12	6	0.5	0.375	GO:0099068	GO:BP	postsynapse assembly	16175	19027		0.04819277108433735	0.05952380952380952	16	16159	6	6	10	16153	16175	0.4325304189204738
M1	cpdb	0	network_modules	339	TRUE	3.450283090207498e-12	22	12	6	0.5	0.2727272727272727	GO:0001941	GO:BP	postsynaptic membrane organization	16175	553		0.060240963855421686	0.07142857142857142	22	16153	6	6	16	16147	16175	0.3686574333556228
M1	cpdb	0	network_modules	339	TRUE	3.394995639613358e-11	31	12	6	0.5	0.1935483870967742	GO:0099054	GO:BP	presynapse assembly	16175	19026		0.07228915662650602	0.08333333333333333	31	16144	6	6	25	16138	16175	0.3103056095582999
M1	cpdb	0	network_modules	339	TRUE	4.177125555307805e-11	32	12	6	0.5	0.1875	GO:0099172	GO:BP	presynapse organization	16175	19080		0.08433734939759036	0.09523809523809523	32	16143	6	6	26	16137	16175	0.3053901505015977
M1	cpdb	0	network_modules	339	TRUE	9.467227934362642e-11	56	8	6	0.75	0.10714285714285714	REAC:R-HSA-6794361	REAC	Neurexins and neuroligins	10916	1587		0	0.3333333333333333	56	10860	6	2	50	10858	10916	0.2823627895635195
M1	cpdb	0	network_modules	339	TRUE	1.182195493586316e-9	54	12	6	0.5	0.1111111111111111	GO:0071709	GO:BP	membrane assembly	16175	16873		0.0963855421686747	0.10714285714285714	54	16121	6	6	48	16115	16175	0.23460732390758415
M1	cpdb	0	network_modules	339	TRUE	1.3644103524548605e-9	86	8	6	0.75	0.06976744186046512	REAC:R-HSA-6794362	REAC	Protein-protein interactions at synapses	10916	1819		0.5	0.6666666666666666	86	10830	6	2	80	10828	10916	0.2273252132158461
M1	cpdb	0	network_modules	339	TRUE	1.850330592110583e-9	58	12	6	0.5	0.10344827586206896	GO:0044091	GO:BP	membrane biogenesis	16175	10913		0.10843373493975904	0.11904761904761904	58	16117	6	6	52	16111	16175	0.22628826845920583
M1	cpdb	0	network_modules	339	TRUE	1.8072100469211966e-8	31	12	5	0.4166666666666667	0.16129032258064516	GO:0098815	GO:BP	modulation of excitatory postsynaptic potential	16175	18902		0.12048192771084337	0.13095238095238096	31	16144	5	7	26	16137	16175	0.258389007698461
M1	cpdb	0	network_modules	339	TRUE	4.750993787986835e-8	98	12	6	0.5	0.061224489795918366	GO:0099173	GO:BP	postsynapse organization	16175	19081		0.13253012048192772	0.14285714285714285	98	16077	6	6	92	16071	16175	0.17343378169476556
M1	cpdb	0	network_modules	339	TRUE	1.149688726610089e-7	44	12	5	0.4166666666666667	0.11363636363636363	GO:0060079	GO:BP	excitatory postsynaptic potential	16175	14338		0.14457831325301204	0.15476190476190477	44	16131	5	7	39	16124	16175	0.21655143818718103
M1	cpdb	0	network_modules	339	TRUE	1.3546222408568314e-7	153	9	6	0.6666666666666666	0.0392156862745098	KEGG:04514	KEGG	Cell adhesion molecules	8484	315		NA	1	153	8331	6	3	147	8328	8484	0.1588388124592512
M1	cpdb	0	network_modules	339	TRUE	1.4030927686396075e-7	117	12	6	0.5	0.05128205128205128	GO:0099504	GO:BP	synaptic vesicle cycle	16175	19100		0.1566265060240964	0.16666666666666666	117	16058	6	6	111	16052	16175	0.15844427258550836
M1	cpdb	0	network_modules	339	TRUE	1.5462118513980467e-7	13	12	4	0.3333333333333333	0.3076923076923077	GO:0071625	GO:BP	vocalization behavior	16175	16805		0.1686746987951807	0.17857142857142858	13	16162	4	8	9	16154	16175	0.31973121621472905
M1	cpdb	0	network_modules	339	TRUE	1.7219764899982227e-7	121	12	6	0.5	0.049586776859504134	GO:0099003	GO:BP	vesicle-mediated transport in synapse	16175	18999		0.18072289156626506	0.19047619047619047	121	16054	6	6	115	16048	16175	0.15574455871805895
M1	cpdb	0	network_modules	339	TRUE	2.0150538153139942e-7	49	12	5	0.4166666666666667	0.10204081632653061	GO:0140238	GO:BP	presynaptic endocytosis	16175	19709		0.1927710843373494	0.21428571428571427	49	16126	5	7	44	16119	16175	0.20508422371061674
M1	cpdb	0	network_modules	339	TRUE	2.0150538153139942e-7	49	12	5	0.4166666666666667	0.10204081632653061	GO:0048488	GO:BP	synaptic vesicle endocytosis	16175	12781		0.1927710843373494	0.21428571428571427	49	16126	5	7	44	16119	16175	0.20508422371061674
M1	cpdb	0	network_modules	339	TRUE	2.0989173460227259e-7	125	12	6	0.5	0.048	GO:0007416	GO:BP	synapse assembly	16175	2911		0.21686746987951808	0.2261904761904762	125	16050	6	6	119	16044	16175	0.15317453021448152
M1	cpdb	0	network_modules	339	TRUE	2.4805185983686974e-7	51	12	5	0.4166666666666667	0.09803921568627451	GO:0099565	GO:BP	chemical synaptic transmission, postsynaptic	16175	19143		0.2289156626506024	0.23809523809523808	51	16124	5	7	46	16117	16175	0.20097511974710577
M1	cpdb	0	network_modules	339	TRUE	5.271284480309638e-7	59	12	5	0.4166666666666667	0.0847457627118644	GO:0036465	GO:BP	synaptic vesicle recycling	16175	9613		0.24096385542168675	0.25	59	16116	5	7	54	16109	16175	0.18667638713263404
M1	cpdb	0	network_modules	339	TRUE	6.2593998195473e-7	61	12	5	0.4166666666666667	0.08196721311475409	GO:0060078	GO:BP	regulation of postsynaptic membrane potential	16175	14337		0.25301204819277107	0.2619047619047619	61	16114	5	7	56	16107	16175	0.18354704150332327
M1	cpdb	0	network_modules	339	TRUE	8.362089656268597e-7	19	12	4	0.3333333333333333	0.21052631578947367	GO:2000311	GO:BP	regulation of AMPA receptor activity	16175	25633		0.26506024096385544	0.27380952380952384	19	16156	4	8	15	16148	16175	0.26422615838272073
M1	cpdb	0	network_modules	339	TRUE	1.5735198825448257e-6	73	12	5	0.4166666666666667	0.0684931506849315	GO:0031644	GO:BP	regulation of nervous system process	16175	7254		0.27710843373493976	0.2857142857142857	73	16102	5	7	68	16095	16175	0.16754505236740114
M1	cpdb	0	network_modules	339	TRUE	1.5762654197641968e-6	22	12	4	0.3333333333333333	0.18181818181818182	GO:2000463	GO:BP	positive regulation of excitatory postsynaptic potential	16175	25775		0.2891566265060241	0.2976190476190476	22	16153	4	8	18	16145	16175	0.2454364306377256
M1	cpdb	0	network_modules	339	TRUE	1.9073551217196344e-6	23	12	4	0.3333333333333333	0.17391304347826086	GO:0051968	GO:BP	positive regulation of synaptic transmission, glutamatergic	16175	14037		0.30120481927710846	0.30952380952380953	23	16152	4	8	19	16144	16175	0.24000429053172148
M1	cpdb	0	network_modules	339	TRUE	5.103788017567073e-6	29	12	4	0.3333333333333333	0.13793103448275862	GO:0035176	GO:BP	social behavior	16175	8870		0.3132530120481928	0.32142857142857145	29	16146	4	8	25	16138	16175	0.21353986626735771
M1	cpdb	0	network_modules	339	TRUE	6.756072906610621e-6	31	12	4	0.3333333333333333	0.12903225806451613	GO:0051703	GO:BP	biological process involved in intraspecies interaction between organisms	16175	13903		0.3253012048192771	0.3333333333333333	31	16144	4	8	27	16136	16175	0.20647240583862217
M1	cpdb	0	network_modules	339	TRUE	7.789645466872174e-6	6	12	3	0.25	0.5	GO:0097119	GO:BP	postsynaptic density protein 95 clustering	16175	18509		0.3373493975903614	0.34523809523809523	6	16169	3	9	3	16160	16175	0.353225343919119
M1	cpdb	0	network_modules	339	TRUE	8.779262922223325e-6	33	12	4	0.3333333333333333	0.12121212121212122	GO:0051965	GO:BP	positive regulation of synapse assembly	16175	14034		0.3493975903614458	0.35714285714285715	33	16142	4	8	29	16134	16175	0.20005561159994809
M1	cpdb	0	network_modules	339	TRUE	1.4147313608839617e-5	37	12	4	0.3333333333333333	0.10810810810810811	GO:0099601	GO:BP	regulation of neurotransmitter receptor activity	16175	19157		0.3614457831325301	0.36904761904761907	37	16138	4	8	33	16130	16175	0.18881494208293637
M1	cpdb	0	network_modules	339	TRUE	1.5119689315368988e-5	400	8	6	0.75	0.015	REAC:R-HSA-112316	REAC	Neuronal System	10916	1590		1	1	400	10516	6	2	394	10514	10916	0.10282230116923134
M1	cpdb	0	network_modules	339	TRUE	1.815945730977249e-5	262	12	6	0.5	0.022900763358778626	GO:0050804	GO:BP	modulation of chemical synaptic transmission	16175	13270		0.37349397590361444	0.38095238095238093	262	15913	6	6	256	15907	16175	0.10442754188506813
M1	cpdb	0	network_modules	339	TRUE	1.857743014064796e-5	263	12	6	0.5	0.022813688212927757	GO:0099177	GO:BP	regulation of trans-synaptic signaling	16175	19085		0.3855421686746988	0.39285714285714285	263	15912	6	6	257	15906	16175	0.10421877692686389
M1	cpdb	0	network_modules	339	TRUE	2.8770385520520937e-5	283	12	6	0.5	0.02120141342756184	GO:0050808	GO:BP	synapse organization	16175	13274		0.39759036144578314	0.40476190476190477	283	15892	6	6	277	15886	16175	0.10027489723068403
M1	cpdb	0	network_modules	339	TRUE	3.267555807267095e-5	9	12	3	0.25	0.3333333333333333	GO:0032230	GO:BP	positive regulation of synaptic transmission, GABAergic	16175	7419		0.40963855421686746	0.4166666666666667	9	16166	3	9	6	16157	16175	0.28821974185931526
M1	cpdb	0	network_modules	339	TRUE	6.232863960338218e-5	53	12	4	0.3333333333333333	0.07547169811320754	GO:0007612	GO:BP	learning	16175	3069		0.42168674698795183	0.42857142857142855	53	16122	4	8	49	16114	16175	0.157367501180561
M1	cpdb	0	network_modules	339	TRUE	7.25369834632334e-5	55	12	4	0.3333333333333333	0.07272727272727272	GO:0051966	GO:BP	regulation of synaptic transmission, glutamatergic	16175	14035		0.43373493975903615	0.44047619047619047	55	16120	4	8	51	16112	16175	0.1544314859499714
M1	cpdb	0	network_modules	339	TRUE	9.012820259323374e-5	58	12	4	0.3333333333333333	0.06896551724137931	GO:0051963	GO:BP	regulation of synapse assembly	16175	14032		0.4457831325301205	0.4523809523809524	58	16117	4	8	54	16109	16175	0.1503139914737635
M1	cpdb	0	network_modules	339	TRUE	9.508067602547963e-5	346	12	6	0.5	0.017341040462427744	GO:0034329	GO:BP	cell junction assembly	16175	8571		0.4578313253012048	0.4642857142857143	346	15829	6	6	340	15823	16175	0.09013427415499671
M1	cpdb	0	network_modules	339	TRUE	1.1106683966943732e-4	13	12	3	0.25	0.23076923076923078	GO:0097106	GO:BP	postsynaptic density organization	16175	18499		0.46987951807228917	0.47619047619047616	13	16162	3	9	10	16153	16175	0.23960521810067908
M1	cpdb	0	network_modules	339	TRUE	1.412987821356631e-4	14	12	3	0.25	0.21428571428571427	GO:0099084	GO:BP	postsynaptic specialization organization	16175	19035		0.4819277108433735	0.4880952380952381	14	16161	3	9	11	16152	16175	0.23083922498452286
M1	cpdb	0	network_modules	339	TRUE	1.7231595071206705e-4	68	12	4	0.3333333333333333	0.058823529411764705	GO:1901890	GO:BP	positive regulation of cell junction assembly	16175	21834		0.4939759036144578	0.5	68	16107	4	8	64	16099	16175	0.13860493892855064
M1	cpdb	0	network_modules	339	TRUE	2.7060470150397164e-4	76	12	4	0.3333333333333333	0.05263157894736842	GO:0035249	GO:BP	synaptic transmission, glutamatergic	16175	8924		0.5060240963855421	0.5119047619047619	76	16099	4	8	72	16091	16175	0.13094265116559323
M1	cpdb	0	network_modules	339	TRUE	3.162290542252277e-4	18	12	3	0.25	0.16666666666666666	GO:0032228	GO:BP	regulation of synaptic transmission, GABAergic	16175	7417		0.5180722891566265	0.5238095238095238	18	16157	3	9	15	16148	16175	0.20340415639299522
M1	cpdb	0	network_modules	339	TRUE	3.753652127114041e-4	19	12	3	0.25	0.15789473684210525	GO:1904861	GO:BP	excitatory synapse assembly	16175	24169		0.5301204819277109	0.5357142857142857	19	16156	3	9	16	16147	16175	0.1979360151912499
M1	cpdb	0	network_modules	339	TRUE	5.907882311357041e-4	806	12	7	0.5833333333333334	0.008684863523573201	GO:0050877	GO:BP	nervous system process	16175	13322		0.54216867469879515	0.5476190476190477	806	15369	7	5	799	15364	16175	0.06680681225723116
M1	cpdb	0	network_modules	339	TRUE	6.30699107025625e-4	2	12	2	0.16666666666666666	1	GO:0090125	GO:BP	cell-cell adhesion involved in synapse maturation	16175	18038		0.5542168674698795	0.5595238095238095	2	16173	2	10	0	16163	16175	0.40812205803437007
M1	cpdb	0	network_modules	339	TRUE	6.386203177911453e-4	94	12	4	0.3333333333333333	0.0425531914893617	GO:0010469	GO:BP	regulation of signaling receptor activity	16175	4162		0.5662650602409639	0.5714285714285714	94	16081	4	8	90	16073	16175	0.1174069517232492
M1	cpdb	0	network_modules	339	TRUE	7.152286442862406e-4	487	12	6	0.5	0.012320328542094456	GO:0098916	GO:BP	anterograde trans-synaptic signaling	16175	18949		0.5783132530120482	0.5952380952380952	487	15688	6	6	481	15682	16175	0.07492444402658435
M1	cpdb	0	network_modules	339	TRUE	7.152286442862406e-4	487	12	6	0.5	0.012320328542094456	GO:0007268	GO:BP	chemical synaptic transmission	16175	2796		0.5783132530120482	0.5952380952380952	487	15688	6	6	481	15682	16175	0.07492444402658435
M1	cpdb	0	network_modules	339	TRUE	7.247358546632796e-4	97	12	4	0.3333333333333333	0.041237113402061855	GO:0050806	GO:BP	positive regulation of synaptic transmission	16175	13272		0.6024096385542169	0.6071428571428571	97	16078	4	8	93	16070	16175	0.11552244736496152
M1	cpdb	0	network_modules	339	TRUE	7.594370593714061e-4	492	12	6	0.5	0.012195121951219513	GO:0099537	GO:BP	trans-synaptic signaling	16175	19116		0.6144578313253012	0.6190476190476191	492	15683	6	6	486	15677	16175	0.07450559408871041
M1	cpdb	0	network_modules	339	TRUE	8.46967566738749e-4	255	12	5	0.4166666666666667	0.0196078431372549	GO:0007610	GO:BP	behavior	16175	3067		0.6265060240963856	0.6309523809523809	255	15920	5	7	250	15913	16175	0.0876940424664904
M1	cpdb	0	network_modules	339	TRUE	0.0010042089953355338	516	12	6	0.5	0.011627906976744186	GO:0099536	GO:BP	synaptic signaling	16175	19115		0.6385542168674698	0.6428571428571429	516	15659	6	6	510	15653	16175	0.07257795053445774
M1	cpdb	0	network_modules	339	TRUE	0.001214191079210441	533	12	6	0.5	0.01125703564727955	GO:0034330	GO:BP	cell junction organization	16175	8572		0.6506024096385542	0.6666666666666666	533	15642	6	6	527	15636	16175	0.07128950789095553
M1	cpdb	0	network_modules	339	TRUE	0.001214191079210441	533	12	6	0.5	0.01125703564727955	GO:0006897	GO:BP	endocytosis	16175	2551		0.6506024096385542	0.6666666666666666	533	15642	6	6	527	15636	16175	0.07128950789095553
M1	cpdb	0	network_modules	339	TRUE	0.0012642753440735388	28	12	3	0.25	0.10714285714285714	GO:0034331	GO:BP	cell junction maintenance	16175	8573		0.6746987951807228	0.6785714285714286	28	16147	3	9	25	16138	16175	0.16273140207277706
M1	cpdb	0	network_modules	339	TRUE	0.0013924571178719023	282	12	5	0.4166666666666667	0.01773049645390071	GO:0042391	GO:BP	regulation of membrane potential	16175	10141		0.6867469879518072	0.6904761904761905	282	15893	5	7	277	15886	16175	0.0831136126679693
M1	cpdb	0	network_modules	339	TRUE	0.0014095643697723036	29	12	3	0.25	0.10344827586206896	GO:0021549	GO:BP	cerebellum development	16175	6133		0.6987951807228916	0.7142857142857143	29	16146	3	9	26	16137	16175	0.15986620675600594
M1	cpdb	0	network_modules	339	TRUE	0.0014095643697723036	29	12	3	0.25	0.10344827586206896	GO:0022037	GO:BP	metencephalon development	16175	6589		0.6987951807228916	0.7142857142857143	29	16146	3	9	26	16137	16175	0.15986620675600594
M1	cpdb	0	network_modules	339	TRUE	0.0015917900477091678	118	12	4	0.3333333333333333	0.03389830508474576	GO:0007611	GO:BP	learning or memory	16175	3068		0.7228915662650602	0.7261904761904762	118	16057	4	8	114	16049	16175	0.10439245356173579
M1	cpdb	0	network_modules	339	TRUE	0.0018913173803027153	3	12	2	0.16666666666666666	0.6666666666666666	GO:0097114	GO:BP	NMDA glutamate receptor clustering	16175	18504		0.7349397590361446	0.7738095238095238	3	16172	2	10	1	16162	16175	0.33311686255037765
M1	cpdb	0	network_modules	339	TRUE	0.0018913173803027153	3	12	2	0.16666666666666666	0.6666666666666666	GO:0072553	GO:BP	terminal button organization	16175	17439		0.7349397590361446	0.7738095238095238	3	16172	2	10	1	16162	16175	0.33311686255037765
M1	cpdb	0	network_modules	339	TRUE	0.0018913173803027153	3	12	2	0.16666666666666666	0.6666666666666666	GO:1900073	GO:BP	regulation of neuromuscular synaptic transmission	16175	20370		0.7349397590361446	0.7738095238095238	3	16172	2	10	1	16162	16175	0.33311686255037765
M1	cpdb	0	network_modules	339	TRUE	0.0018913173803027153	3	12	2	0.16666666666666666	0.6666666666666666	GO:1900075	GO:BP	positive regulation of neuromuscular synaptic transmission	16175	20372		0.7349397590361446	0.7738095238095238	3	16172	2	10	1	16162	16175	0.33311686255037765
M1	cpdb	0	network_modules	339	TRUE	0.0019413256226203462	124	12	4	0.3333333333333333	0.03225806451612903	GO:0050807	GO:BP	regulation of synapse organization	16175	13273		0.7831325301204819	0.7857142857142857	124	16051	4	8	120	16043	16175	0.1017386643923446
M1	cpdb	0	network_modules	339	TRUE	0.002273720557661187	129	12	4	0.3333333333333333	0.031007751937984496	GO:0050803	GO:BP	regulation of synapse structure or activity	16175	13269		0.7951807228915663	0.7976190476190477	129	16046	4	8	125	16038	16175	0.09966834583746793
M1	cpdb	0	network_modules	339	TRUE	0.0023035671238523627	34	12	3	0.25	0.08823529411764706	GO:0051932	GO:BP	synaptic transmission, GABAergic	16175	14002		0.8072289156626506	0.8095238095238095	34	16141	3	9	31	16132	16175	0.14748309922566566
M1	cpdb	0	network_modules	339	TRUE	0.003430178985733021	143	12	4	0.3333333333333333	0.027972027972027972	GO:1901888	GO:BP	regulation of cell junction assembly	16175	21832		0.8192771084337349	0.8214285714285714	143	16032	4	8	139	16024	16175	0.09445321784615132
M1	cpdb	0	network_modules	339	TRUE	0.003781075530133068	4	12	2	0.16666666666666666	0.5	GO:0097116	GO:BP	gephyrin clustering involved in postsynaptic density assembly	16175	18506		0.8313253012048193	0.8333333333333334	4	16171	2	10	2	16161	16175	0.2883894502100615
M1	cpdb	0	network_modules	339	TRUE	0.0037938276959636366	40	12	3	0.25	0.075	GO:0030534	GO:BP	adult behavior	16175	6837		0.8433734939759037	0.8452380952380952	40	16135	3	9	37	16126	16175	0.1357944772851887
M1	cpdb	0	network_modules	339	TRUE	0.00411164778900481	657	12	6	0.5	0.0091324200913242	GO:0061024	GO:BP	membrane organization	16175	15141		0.8554216867469879	0.8571428571428571	657	15518	6	6	651	15512	16175	0.06340844699326126
M1	cpdb	0	network_modules	339	TRUE	0.004404530672923121	42	12	3	0.25	0.07142857142857142	GO:0035418	GO:BP	protein localization to synapse	16175	9025		0.8674698795180723	0.8690476190476191	42	16133	3	9	39	16124	16175	0.13246385140552264
M1	cpdb	0	network_modules	339	TRUE	0.004489734816222663	153	12	4	0.3333333333333333	0.026143790849673203	GO:0051962	GO:BP	positive regulation of nervous system development	16175	14031		0.8795180722891566	0.8809523809523809	153	16022	4	8	149	16014	16175	0.09116881771518923
M1	cpdb	0	network_modules	339	TRUE	0.005077079919351514	44	12	3	0.25	0.06818181818181818	GO:0051489	GO:BP	regulation of filopodium assembly	16175	13744		0.891566265060241	0.8928571428571429	44	16131	3	9	41	16122	16175	0.12936163613663396
M1	cpdb	0	network_modules	339	TRUE	0.0052318943645953365	159	12	4	0.3333333333333333	0.025157232704402517	GO:0050890	GO:BP	cognition	16175	13334		0.9036144578313253	0.9047619047619048	159	16016	4	8	155	16008	16175	0.0893464115255987
M1	cpdb	0	network_modules	339	TRUE	0.005437456002151992	45	12	3	0.25	0.06666666666666667	GO:0030902	GO:BP	hindbrain development	16175	6958		0.9156626506024096	0.9166666666666666	45	16130	3	9	42	16121	16175	0.12788819242126215
M1	cpdb	0	network_modules	339	TRUE	0.005814383332977358	46	12	3	0.25	0.06521739130434782	GO:0043954	GO:BP	cellular component maintenance	16175	10881		0.927710843373494	0.9285714285714286	46	16129	3	9	43	16120	16175	0.12646275296011072
M1	cpdb	0	network_modules	339	TRUE	0.006101958994365122	381	12	5	0.4166666666666667	0.013123359580052493	GO:0044057	GO:BP	regulation of system process	16175	10893		0.9397590361445783	0.9404761904761905	381	15794	5	7	376	15787	16175	0.07062873847821133
M1	cpdb	0	network_modules	339	TRUE	0.006299194917464988	5	12	2	0.16666666666666666	0.4	GO:0002087	GO:BP	regulation of respiratory gaseous exchange by nervous system process	16175	673		0.9518072289156626	0.9523809523809523	5	16170	2	10	3	16160	16175	0.2578555143451957
M1	cpdb	0	network_modules	339	TRUE	0.008189887429279579	740	12	6	0.5	0.008108108108108109	GO:0098657	GO:BP	import into cell	16175	18813		0.963855421686747	0.9642857142857143	740	15435	6	6	734	15429	16175	0.05923795459644216
M1	cpdb	0	network_modules	339	TRUE	0.008514693126001484	745	12	6	0.5	0.008053691275167786	GO:0098609	GO:BP	cell-cell adhesion	16175	18805		0.9759036144578314	0.9761904761904762	745	15430	6	6	739	15424	16175	0.05900821702837093
M1	cpdb	0	network_modules	339	TRUE	0.008938304171535178	412	12	5	0.4166666666666667	0.012135922330097087	GO:0044089	GO:BP	positive regulation of cellular component biogenesis	16175	10911		0.9879518072289156	0.9880952380952381	412	15763	5	7	407	15756	16175	0.06765493236703313
M1	cpdb	0	network_modules	339	TRUE	0.008942912521105734	182	12	4	0.3333333333333333	0.02197802197802198	GO:0032412	GO:BP	regulation of monoatomic ion transmembrane transporter activity	16175	7550		1	1	182	15993	4	8	178	15985	16175	0.08320298558026205
M1	cpdb	0	network_modules	344	TRUE	3.621740547159627e-7	34	7	4	0.5714285714285714	0.11764705882352941	KEGG:05330	KEGG	Allograft rejection	8484	486		0	0.09090909090909091	34	8450	4	3	30	8447	8484	0.2580870427606974
M1	cpdb	0	network_modules	344	TRUE	5.153404217509371e-7	37	7	4	0.5714285714285714	0.10810810810810811	KEGG:05332	KEGG	Graft-versus-host disease	8484	487		0.1	0.18181818181818182	37	8447	4	3	33	8444	8484	0.24729263160640969
M1	cpdb	0	network_modules	344	TRUE	7.124970348685349e-7	40	7	4	0.5714285714285714	0.1	KEGG:04940	KEGG	Type I diabetes mellitus	8484	394		0.2	0.2727272727272727	40	8444	4	3	36	8441	8484	0.23773234782579408
M1	cpdb	0	network_modules	344	TRUE	1.057143876343688e-6	44	7	4	0.5714285714285714	0.09090909090909091	KEGG:04672	KEGG	Intestinal immune network for IgA production	8484	344		0.3	0.36363636363636365	44	8440	4	3	40	8437	8484	0.2265339854153799
M1	cpdb	0	network_modules	344	TRUE	1.6476157384082009e-6	49	7	4	0.5714285714285714	0.08163265306122448	KEGG:05320	KEGG	Autoimmune thyroid disease	8484	482		0.4	0.45454545454545453	49	8435	4	3	45	8432	8484	0.21450533342656977
M1	cpdb	0	network_modules	344	TRUE	4.613680544518439e-6	63	7	4	0.5714285714285714	0.06349206349206349	KEGG:05416	KEGG	Viral myocarditis	8484	493		0.5	0.5454545454545454	63	8421	4	3	59	8418	8484	0.1887807739023806
M1	cpdb	0	network_modules	344	TRUE	1.793334277155677e-5	88	7	4	0.5714285714285714	0.045454545454545456	KEGG:05323	KEGG	Rheumatoid arthritis	8484	485		0.6	0.6363636363636364	88	8396	4	3	84	8393	8484	0.1591319300198453
M1	cpdb	0	network_modules	344	TRUE	3.3265022228884675e-5	216	15	6	0.4	0.027777777777777776	GO:0002366	GO:BP	leukocyte activation involved in immune response	16175	898		0	0.06666666666666667	216	15959	6	9	210	15950	16175	0.102624987038383
M1	cpdb	0	network_modules	344	TRUE	3.81300119362369e-5	221	15	6	0.4	0.027149321266968326	GO:0002263	GO:BP	cell activation involved in immune response	16175	795		0.07142857142857142	0.13333333333333333	221	15954	6	9	215	15945	16175	0.10139219972714737
M1	cpdb	0	network_modules	344	TRUE	7.437144654334131e-5	67	10	4	0.4	0.05970149253731343	REAC:R-HSA-388841	REAC	Regulation of T cell activation by CD28 family	10916	2007		NA	1	67	10849	4	6	63	10843	10916	0.15270134047777878
M1	cpdb	0	network_modules	344	TRUE	7.502508893395722e-5	9	15	3	0.2	0.3333333333333333	GO:0043312	GO:BP	neutrophil degranulation	16175	10620		0.14285714285714285	0.2	9	16166	3	12	6	16154	16175	0.25767172946612876
M1	cpdb	0	network_modules	344	TRUE	9.176171433282414e-5	132	7	4	0.5714285714285714	0.030303030303030304	KEGG:05322	KEGG	Systemic lupus erythematosus	8484	484		0.7	0.7272727272727273	132	8352	4	3	128	8349	8484	0.12906827817397673
M1	cpdb	0	network_modules	344	TRUE	1.6568140415759223e-4	153	7	4	0.5714285714285714	0.026143790849673203	KEGG:04514	KEGG	Cell adhesion molecules	8484	315		0.8	0.8181818181818182	153	8331	4	3	149	8328	8484	0.119500367916296
M1	cpdb	0	network_modules	344	TRUE	1.6984070105078127e-4	4	7	2	0.2857142857142857	0.5	KEGG:03267	KEGG	Virion - Adenovirus	8484	233		0.9	0.9090909090909091	4	8480	2	5	2	8475	8484	0.37758555599332905
M1	cpdb	0	network_modules	344	TRUE	3.2420499281561084e-4	14	15	3	0.2	0.21428571428571427	GO:0002283	GO:BP	neutrophil activation involved in immune response	16175	815		0.21428571428571427	0.26666666666666666	14	16161	3	12	11	16149	16175	0.20630870032228973
M1	cpdb	0	network_modules	344	TRUE	0.0018020920667734732	699	15	7	0.4666666666666667	0.010014306151645207	GO:0045321	GO:BP	leukocyte activation	16175	11356		0.2857142857142857	0.3333333333333333	699	15476	7	8	692	15468	16175	0.06344615461679795
M1	cpdb	0	network_modules	344	TRUE	0.0023003290226343157	26	15	3	0.2	0.11538461538461539	GO:0002446	GO:BP	neutrophil mediated immunity	16175	969		0.35714285714285715	0.4	26	16149	3	12	23	16137	16175	0.15088121656469844
M1	cpdb	0	network_modules	344	TRUE	0.0025864295500052786	27	15	3	0.2	0.1111111111111111	GO:0043372	GO:BP	positive regulation of CD4-positive, alpha-beta T cell differentiation	16175	10649		0.42857142857142855	0.4666666666666667	27	16148	3	12	24	16136	16175	0.14801920198550775
M1	cpdb	0	network_modules	344	TRUE	0.0032274510309279613	29	15	3	0.2	0.10344827586206896	GO:0002495	GO:BP	antigen processing and presentation of peptide antigen via MHC class II	16175	1018		0.5	0.5333333333333333	29	16146	3	12	26	16134	16175	0.14274371530670452
M1	cpdb	0	network_modules	344	TRUE	0.003965857803360063	31	15	3	0.2	0.0967741935483871	GO:0002504	GO:BP	antigen processing and presentation of peptide or polysaccharide antigen via MHC class II	16175	1027		0.5714285714285714	0.6	31	16144	3	12	28	16132	16175	0.13798473293683836
M1	cpdb	0	network_modules	344	TRUE	0.004808372626516765	33	15	3	0.2	0.09090909090909091	GO:0042119	GO:BP	neutrophil activation	16175	9975		0.6428571428571429	0.8	33	16142	3	12	30	16130	16175	0.13366282550790537
M1	cpdb	0	network_modules	344	TRUE	0.004808372626516765	33	15	3	0.2	0.09090909090909091	GO:2000516	GO:BP	positive regulation of CD4-positive, alpha-beta T cell activation	16175	25819		0.6428571428571429	0.8	33	16142	3	12	30	16130	16175	0.13366282550790537
M1	cpdb	0	network_modules	344	TRUE	0.004808372626516765	33	15	3	0.2	0.09090909090909091	GO:0045622	GO:BP	regulation of T-helper cell differentiation	16175	11473		0.6428571428571429	0.8	33	16142	3	12	30	16130	16175	0.13366282550790537
M1	cpdb	0	network_modules	344	TRUE	0.006832464161850994	37	15	3	0.2	0.08108108108108109	GO:0046638	GO:BP	positive regulation of alpha-beta T cell differentiation	16175	12275		0.8571428571428571	0.8666666666666667	37	16138	3	12	34	16126	16175	0.12608914305468685
M1	cpdb	0	network_modules	344	TRUE	0.006935267581397705	536	15	6	0.4	0.011194029850746268	GO:0002252	GO:BP	immune effector process	16175	784		0.9285714285714286	0.9333333333333333	536	15639	6	9	530	15630	16175	0.06244326578767309
M1	cpdb	0	network_modules	344	TRUE	0.009352895688694907	41	15	3	0.2	0.07317073170731707	GO:0036230	GO:BP	granulocyte activation	16175	9504		1	1	41	16134	3	12	38	16122	16175	0.11964564862587004
M1	cpdb	0	network_modules	344	TRUE	0.009846216659474495	27	7	2	0.2857142857142857	0.07407407407407407	KEGG:05310	KEGG	Asthma	8484	481		1	1	27	8457	2	5	25	8452	8484	0.14414710184470317
M1	cpdb	0	network_modules	346	TRUE	5.622328155015332e-9	21	14	5	0.35714285714285715	0.23809523809523808	GO:0015701	GO:BP	bicarbonate transport	16175	4821		0	0.2	21	16154	5	9	16	16145	16175	0.29086055803971067
M1	cpdb	0	network_modules	346	TRUE	4.86725903796712e-8	9	13	4	0.3076923076923077	0.4444444444444444	REAC:R-HSA-1247673	REAC	Erythrocytes take up oxygen and release carbon dioxide	10916	856		0	0.25	9	10907	4	9	5	10898	10916	0.36918126014476216
M1	cpdb	0	network_modules	346	TRUE	2.75469158704386e-7	13	13	4	0.3076923076923077	0.3076923076923077	REAC:R-HSA-1480926	REAC	O2/CO2 exchange in erythrocytes	10916	1633		0.3333333333333333	0.75	13	10903	4	9	9	10894	10916	0.3068668468099817
M1	cpdb	0	network_modules	346	TRUE	2.75469158704386e-7	13	13	4	0.3076923076923077	0.3076923076923077	REAC:R-HSA-1237044	REAC	Erythrocytes take up carbon dioxide and release oxygen	10916	855		0.3333333333333333	0.75	13	10903	4	9	9	10894	10916	0.3068668468099817
M1	cpdb	0	network_modules	346	TRUE	5.051060091060946e-5	10	13	3	0.23076923076923078	0.3	REAC:R-HSA-425381	REAC	Bicarbonate transporters	10916	221		1	1	10	10906	3	10	7	10896	10916	0.26234929381831623
M1	cpdb	0	network_modules	346	TRUE	5.397747952356066e-5	23	8	3	0.375	0.13043478260869565	KEGG:04964	KEGG	Proximal tubule bicarbonate reclamation	8484	399		0	0.5	23	8461	3	5	20	8456	8484	0.2199660393927143
M1	cpdb	0	network_modules	346	TRUE	6.856053775428322e-4	80	14	4	0.2857142857142857	0.05	GO:0051453	GO:BP	regulation of intracellular pH	16175	13714		0.25	0.4	80	16095	4	10	76	16085	16175	0.11779636975963245
M1	cpdb	0	network_modules	346	TRUE	7.574551742917172e-4	82	14	4	0.2857142857142857	0.04878048780487805	GO:0030641	GO:BP	regulation of cellular pH	16175	6868		0.5	0.6	82	16093	4	10	78	16083	16175	0.11630694748558497
M1	cpdb	0	network_modules	346	TRUE	8.755578800406271e-4	85	14	4	0.2857142857142857	0.047058823529411764	GO:0006885	GO:BP	regulation of pH	16175	2541		0.75	0.8	85	16090	4	10	81	16080	16175	0.11417118136541317
M1	cpdb	0	network_modules	346	TRUE	0.005870164979646431	17	8	2	0.25	0.11764705882352941	KEGG:00910	KEGG	Nitrogen metabolism	8484	139		1	1	17	8467	2	6	15	8461	8484	0.17037505709601436
M1	cpdb	0	network_modules	346	TRUE	0.00712907102691969	326	14	5	0.35714285714285715	0.015337423312883436	GO:0015711	GO:BP	organic anion transport	16175	4831		1	1	326	15849	5	9	321	15840	16175	0.07057961401976601
M1	cpdb	0	network_modules	347	TRUE	0.007805229866644828	244	9	4	0.4444444444444444	0.01639344262295082	REAC:R-HSA-8951664	REAC	Neddylation	10916	1559		NA	1	244	10672	4	5	240	10667	10916	0.08202030069443753
M1	cpdb	0	network_modules	348	TRUE	2.578907383867618e-7	84	8	5	0.625	0.05952380952380952	KEGG:03083	KEGG	Polycomb repressive complex	8484	220		NA	1	84	8400	5	3	79	8397	8484	0.1908604402308546
M1	cpdb	0	network_modules	348	TRUE	8.437590573006882e-6	102	11	5	0.45454545454545453	0.049019607843137254	REAC:R-HSA-5689603	REAC	UCH proteinases	10916	2615		0	0.2	102	10814	5	6	97	10808	10916	0.14696376201689024
M1	cpdb	0	network_modules	348	TRUE	3.129527869739496e-5	7	15	3	0.2	0.42857142857142855	GO:0003162	GO:BP	atrioventricular node development	16175	1592		0	0.09090909090909091	7	16168	3	12	4	16156	16175	0.29233533147126006
M1	cpdb	0	network_modules	348	TRUE	8.149311483080551e-5	14	11	3	0.2727272727272727	0.21428571428571427	REAC:R-HSA-2032785	REAC	YAP1- and WWTR1 (TAZ)-stimulated gene expression	10916	2678		0.25	0.6	14	10902	3	8	11	10894	10916	0.24088589845447983
M1	cpdb	0	network_modules	348	TRUE	8.149311483080551e-5	14	11	3	0.2727272727272727	0.21428571428571427	REAC:R-HSA-5578768	REAC	Physiological factors	10916	1754		0.25	0.6	14	10902	3	8	11	10894	10916	0.24088589845447983
M1	cpdb	0	network_modules	348	TRUE	3.2695288221598097e-4	543	15	7	0.4666666666666667	0.01289134438305709	GO:0009887	GO:BP	animal organ morphogenesis	16175	3747		0.1	0.18181818181818182	543	15632	7	8	536	15624	16175	0.07325656797642909
M1	cpdb	0	network_modules	348	TRUE	3.59406906031334e-4	62	15	4	0.26666666666666666	0.06451612903225806	GO:0003279	GO:BP	cardiac septum development	16175	1703		0.2	0.2727272727272727	62	16113	4	11	58	16102	16175	0.129588380063352
M1	cpdb	0	network_modules	348	TRUE	6.50187366693047e-4	27	11	3	0.2727272727272727	0.1111111111111111	REAC:R-HSA-9733709	REAC	Cardiogenesis	10916	307		0.75	0.8	27	10889	3	8	24	10881	10916	0.17279971661140084
M1	cpdb	0	network_modules	348	TRUE	0.0011148721588836801	2	15	2	0.13333333333333333	1	GO:0003285	GO:BP	septum secundum development	16175	1708		0.3	0.36363636363636365	2	16173	2	13	0	16160	16175	0.36500158742720296
M1	cpdb	0	network_modules	348	TRUE	0.001170454323893178	83	15	4	0.26666666666666666	0.04819277108433735	GO:0003206	GO:BP	cardiac chamber morphogenesis	16175	1636		0.4	0.45454545454545453	83	16092	4	11	79	16081	16175	0.11152069891948674
M1	cpdb	0	network_modules	348	TRUE	0.001751263692096332	298	11	5	0.45454545454545453	0.016778523489932886	REAC:R-HSA-5688426	REAC	Deubiquitination	10916	736		1	1	298	10618	5	6	293	10612	10916	0.0832713539767559
M1	cpdb	0	network_modules	348	TRUE	0.0022820513135916177	98	15	4	0.26666666666666666	0.04081632653061224	GO:0003205	GO:BP	cardiac chamber development	16175	1635		0.5	0.5454545454545454	98	16077	4	11	94	16066	16175	0.10231547630348198
M1	cpdb	0	network_modules	348	TRUE	0.0047095565729577465	272	15	5	0.3333333333333333	0.01838235294117647	GO:0048589	GO:BP	developmental growth	16175	12860		0.6	0.6363636363636364	272	15903	5	10	267	15893	16175	0.0749967865986629
M1	cpdb	0	network_modules	348	TRUE	0.004808372626516765	33	15	3	0.2	0.09090909090909091	GO:0003161	GO:BP	cardiac conduction system development	16175	1591		0.7	0.7272727272727273	33	16142	3	12	30	16130	16175	0.13366282550790537
M1	cpdb	0	network_modules	348	TRUE	0.006682065795610729	4	15	2	0.13333333333333333	0.5	GO:0051891	GO:BP	positive regulation of cardioblast differentiation	16175	13975		0.8	0.8181818181818182	4	16171	2	13	2	16158	16175	0.25787147420379075
M1	cpdb	0	network_modules	348	TRUE	0.008673366523155073	40	15	3	0.2	0.075	GO:0003281	GO:BP	ventricular septum development	16175	1704		0.9	0.9090909090909091	40	16135	3	12	37	16123	16175	0.12116615688344903
M1	cpdb	0	network_modules	348	TRUE	0.009464852362174073	140	15	4	0.26666666666666666	0.02857142857142857	GO:0048738	GO:BP	cardiac muscle tissue development	16175	12995		1	1	140	16035	4	11	136	16024	16175	0.08486126971360514
M1	cpdb	0	network_modules	349	TRUE	2.6447466967396255e-28	24	16	12	0.75	0.5	REAC:R-HSA-379716	REAC	Cytosolic tRNA aminoacylation	10916	430		0	0.16666666666666666	24	10892	12	4	12	10888	10916	0.6116980579323201
M1	cpdb	0	network_modules	349	TRUE	1.0749331520897849e-24	42	16	12	0.75	0.2857142857142857	REAC:R-HSA-379724	REAC	tRNA Aminoacylation	10916	2740		0.2	0.3333333333333333	42	10874	12	4	30	10870	10916	0.4617623519571997
M1	cpdb	0	network_modules	349	TRUE	5.385308179421819e-18	38	15	9	0.6	0.23684210526315788	GO:0006418	GO:BP	tRNA aminoacylation for protein translation	16175	2175		0	0.08333333333333333	38	16137	9	6	29	16131	16175	0.3761087802134567
M1	cpdb	0	network_modules	349	TRUE	1.1562456650296729e-17	41	15	9	0.6	0.21951219512195122	GO:0043038	GO:BP	amino acid activation	16175	10488		0.09090909090909091	0.25	41	16134	9	6	32	16128	16175	0.36200862502204384
M1	cpdb	0	network_modules	349	TRUE	1.1562456650296729e-17	41	15	9	0.6	0.21951219512195122	GO:0043039	GO:BP	tRNA aminoacylation	16175	10489		0.09090909090909091	0.25	41	16134	9	6	32	16128	16175	0.36200862502204384
M1	cpdb	0	network_modules	349	TRUE	4.348057432702251e-17	44	13	9	0.6923076923076923	0.20454545454545456	KEGG:00970	KEGG	Aminoacyl-tRNA biosynthesis	8484	153		NA	1	44	8440	9	4	35	8436	8484	0.37474939959631415
M1	cpdb	0	network_modules	349	TRUE	1.7769484417853086e-16	117	16	11	0.6875	0.09401709401709402	REAC:R-HSA-2408522	REAC	Selenoamino acid metabolism	10916	2187		0.4	0.5	117	10799	11	5	106	10794	10916	0.25181072966762547
M1	cpdb	0	network_modules	349	TRUE	4.605282456283143e-16	292	16	13	0.8125	0.04452054794520548	REAC:R-HSA-72766	REAC	Translation	10916	2565		0.6	0.6666666666666666	292	10624	13	3	279	10621	10916	0.1865775363681641
M1	cpdb	0	network_modules	349	TRUE	9.96469857486874e-13	370	16	12	0.75	0.032432432432432434	REAC:R-HSA-71291	REAC	Metabolism of amino acids and derivatives	10916	1421		0.8	0.8333333333333334	370	10546	12	4	358	10542	10916	0.15161497853810849
M1	cpdb	0	network_modules	349	TRUE	2.242164510353407e-12	247	15	10	0.6666666666666666	0.04048582995951417	GO:0006520	GO:BP	amino acid metabolic process	16175	2241		0.2727272727272727	0.3333333333333333	247	15928	10	5	237	15923	16175	0.16183980739966733
M1	cpdb	0	network_modules	349	TRUE	1.8962129302783262e-11	186	15	9	0.6	0.04838709677419355	GO:0006399	GO:BP	tRNA metabolic process	16175	2160		0.36363636363636365	0.4166666666666667	186	15989	9	6	177	15983	16175	0.16817024417680082
M1	cpdb	0	network_modules	349	TRUE	9.067266404489993e-9	566	15	10	0.6666666666666666	0.0176678445229682	GO:0006412	GO:BP	translation	16175	2170		0.45454545454545453	0.5	566	15609	10	5	556	15604	16175	0.10472895197758303
M1	cpdb	0	network_modules	349	TRUE	0.0010838694383180627	21	16	3	0.1875	0.14285714285714285	REAC:R-HSA-379726	REAC	Mitochondrial tRNA aminoacylation	10916	1470		1	1	21	10895	3	13	18	10882	10916	0.16225919808324704
M1	cpdb	0	network_modules	349	TRUE	0.0011148721588836801	2	15	2	0.13333333333333333	1	GO:0006425	GO:BP	glutaminyl-tRNA aminoacylation	16175	2182		0.5454545454545454	1	2	16173	2	13	0	16160	16175	0.36500158742720296
M1	cpdb	0	network_modules	349	TRUE	0.0011148721588836801	2	15	2	0.13333333333333333	1	GO:0009785	GO:BP	blue light signaling pathway	16175	3672		0.5454545454545454	1	2	16173	2	13	0	16160	16175	0.36500158742720296
M1	cpdb	0	network_modules	349	TRUE	0.0011148721588836801	2	15	2	0.13333333333333333	1	GO:0071483	GO:BP	cellular response to blue light	16175	16716		0.5454545454545454	1	2	16173	2	13	0	16160	16175	0.36500158742720296
M1	cpdb	0	network_modules	349	TRUE	0.0011148721588836801	2	15	2	0.13333333333333333	1	GO:0015966	GO:BP	diadenosine tetraphosphate biosynthetic process	16175	5047		0.5454545454545454	1	2	16173	2	13	0	16160	16175	0.36500158742720296
M1	cpdb	0	network_modules	349	TRUE	0.0011148721588836801	2	15	2	0.13333333333333333	1	GO:0015960	GO:BP	diadenosine polyphosphate biosynthetic process	16175	5041		0.5454545454545454	1	2	16173	2	13	0	16160	16175	0.36500158742720296
M1	cpdb	0	network_modules	349	TRUE	0.0011148721588836801	2	15	2	0.13333333333333333	1	GO:0015965	GO:BP	diadenosine tetraphosphate metabolic process	16175	5046		0.5454545454545454	1	2	16173	2	13	0	16160	16175	0.36500158742720296
M1	cpdb	0	network_modules	350	TRUE	3.395468612332479e-5	790	17	9	0.5294117647058824	0.01139240506329114	GO:0007167	GO:BP	enzyme-linked receptor protein signaling pathway	16175	2731		0	0.125	790	15385	9	8	781	15377	16175	0.07232195821820352
M1	cpdb	0	network_modules	350	TRUE	4.418389921243977e-5	301	11	6	0.5454545454545454	0.019933554817275746	KEGG:04010	KEGG	MAPK signaling pathway	8484	243		0	0.5	301	8183	6	5	295	8178	8484	0.0993318701233904
M1	cpdb	0	network_modules	350	TRUE	7.630322185844723e-5	595	17	8	0.47058823529411764	0.013445378151260505	GO:0000165	GO:BP	MAPK cascade	16175	55		0.14285714285714285	0.25	595	15580	8	9	587	15571	16175	0.07475243822883779
M1	cpdb	0	network_modules	350	TRUE	5.782305963754384e-4	510	17	7	0.4117647058823529	0.013725490196078431	GO:0007169	GO:BP	cell surface receptor protein tyrosine kinase signaling pathway	16175	2733		0.2857142857142857	0.375	510	15665	7	10	503	15655	16175	0.07057912275644322
M1	cpdb	0	network_modules	350	TRUE	7.497317950811155e-4	530	17	7	0.4117647058823529	0.013207547169811321	GO:0043408	GO:BP	regulation of MAPK cascade	16175	10676		0.42857142857142855	0.5	530	15645	7	10	523	15635	16175	0.06905358838904563
M1	cpdb	0	network_modules	350	TRUE	0.002212528031284492	86	17	4	0.23529411764705882	0.046511627906976744	GO:0090263	GO:BP	positive regulation of canonical Wnt signaling pathway	16175	18152		0.5714285714285714	0.625	86	16089	4	13	82	16076	16175	0.10257608329245277
M1	cpdb	0	network_modules	350	TRUE	0.004213049833406921	101	17	4	0.23529411764705882	0.039603960396039604	GO:0010976	GO:BP	positive regulation of neuron projection development	16175	4552		0.7142857142857143	0.75	101	16074	4	13	97	16061	16175	0.09431535670186014
M1	cpdb	0	network_modules	350	TRUE	0.004919870936671431	105	17	4	0.23529411764705882	0.0380952380952381	GO:0006470	GO:BP	protein dephosphorylation	16175	2209		0.8571428571428571	0.875	105	16070	4	13	101	16057	16175	0.09241305989507302
M1	cpdb	0	network_modules	350	TRUE	0.004956544238623312	70	11	3	0.2727272727272727	0.04285714285714286	KEGG:05230	KEGG	Central carbon metabolism in cancer	8484	478		1	1	70	8414	3	8	67	8406	8484	0.10534529129174183
M1	cpdb	0	network_modules	350	TRUE	0.0070695483387887255	115	17	4	0.23529411764705882	0.034782608695652174	GO:0030177	GO:BP	positive regulation of Wnt signaling pathway	16175	6697		1	1	115	16060	4	13	111	16047	16175	0.08809254772516162
M1	cpdb	0	network_modules	351	TRUE	1.3062727636714792e-8	56	16	6	0.375	0.10714285714285714	GO:0043299	GO:BP	leukocyte degranulation	16175	10607		0	0.014925373134328358	56	16119	6	10	50	16109	16175	0.19903848741618244
M1	cpdb	0	network_modules	351	TRUE	6.232581531710537e-8	72	16	6	0.375	0.08333333333333333	GO:0002444	GO:BP	myeloid leukocyte mediated immunity	16175	967		0.015151515151515152	0.029850746268656716	72	16103	6	10	66	16093	16175	0.17515505408086923
M1	cpdb	0	network_modules	351	TRUE	1.6623230239295903e-7	34	16	5	0.3125	0.14705882352941177	GO:0043300	GO:BP	regulation of leukocyte degranulation	16175	10608		0.030303030303030304	0.04477611940298507	34	16141	5	11	29	16130	16175	0.2132609130386173
M1	cpdb	0	network_modules	351	TRUE	2.9918391404697514e-7	38	16	5	0.3125	0.13157894736842105	GO:0002886	GO:BP	regulation of myeloid leukocyte mediated immunity	16175	1396		0.045454545454545456	0.05970149253731343	38	16137	5	11	33	16126	16175	0.20158889384119139
M1	cpdb	0	network_modules	351	TRUE	1.932839209194357e-6	17	16	4	0.25	0.23529411764705882	GO:0002862	GO:BP	negative regulation of inflammatory response to antigenic stimulus	16175	1372		0.06060606060606061	0.07462686567164178	17	16158	4	12	13	16146	16175	0.2417626211795933
M1	cpdb	0	network_modules	351	TRUE	4.130492957045695e-6	63	16	5	0.3125	0.07936507936507936	GO:0002275	GO:BP	myeloid cell activation involved in immune response	16175	807		0.07575757575757576	0.08955223880597014	63	16112	5	11	58	16101	16175	0.15590323913782483
M1	cpdb	0	network_modules	351	TRUE	8.374863205755876e-6	161	16	6	0.375	0.037267080745341616	GO:0045055	GO:BP	regulated exocytosis	16175	11253		0.09090909090909091	0.1044776119402985	161	16014	6	10	155	16004	16175	0.11571301822250132
M1	cpdb	0	network_modules	351	TRUE	1.0224573530433693e-5	25	16	4	0.25	0.16	GO:0002861	GO:BP	regulation of inflammatory response to antigenic stimulus	16175	1371		0.10606060606060606	0.11940298507462686	25	16150	4	12	21	16138	16175	0.19901576184562753
M1	cpdb	0	network_modules	351	TRUE	1.0433193142133297e-5	167	16	6	0.375	0.03592814371257485	GO:0002274	GO:BP	myeloid leukocyte activation	16175	806		0.12121212121212122	0.13432835820895522	167	16008	6	10	161	15998	16175	0.11352114545774054
M1	cpdb	0	network_modules	351	TRUE	1.4168233501448468e-5	27	16	4	0.25	0.14814814814814814	GO:0038094	GO:BP	Fc-gamma receptor signaling pathway	16175	9694		0.13636363636363635	0.14925373134328357	27	16148	4	12	23	16136	16175	0.1914195543332221
M1	cpdb	0	network_modules	351	TRUE	1.9036195904770947e-5	85	16	5	0.3125	0.058823529411764705	GO:0034109	GO:BP	homotypic cell-cell adhesion	16175	8417		0.15151515151515152	0.16417910447761194	85	16090	5	11	80	16079	16175	0.13371937762522546
M1	cpdb	0	network_modules	351	TRUE	2.1419286637719375e-5	87	16	5	0.3125	0.05747126436781609	GO:1903305	GO:BP	regulation of regulated secretory pathway	16175	22892		0.16666666666666666	0.1791044776119403	87	16088	5	11	82	16077	16175	0.1321284571527126
M1	cpdb	0	network_modules	351	TRUE	2.724719115808117e-5	35	14	4	0.2857142857142857	0.11428571428571428	REAC:R-HSA-114604	REAC	GPVI-mediated activation cascade	10916	1021		0	0.16666666666666666	35	10881	4	10	31	10871	10916	0.17907573946245858
M1	cpdb	0	network_modules	351	TRUE	2.8944624324977434e-5	32	16	4	0.25	0.125	GO:0043303	GO:BP	mast cell degranulation	16175	10611		0.18181818181818182	0.19402985074626866	32	16143	4	12	28	16131	16175	0.17563841108400688
M1	cpdb	0	network_modules	351	TRUE	2.9101317185639192e-5	96	15	5	0.3333333333333333	0.052083333333333336	KEGG:04666	KEGG	Fc gamma R-mediated phagocytosis	8484	341		0	0.3333333333333333	96	8388	5	10	91	8378	8484	0.12812840818642487
M1	cpdb	0	network_modules	351	TRUE	3.291741845506789e-5	33	16	4	0.25	0.12121212121212122	GO:0002279	GO:BP	mast cell activation involved in immune response	16175	811		0.19696969696969696	0.23880597014925373	33	16142	4	12	29	16130	16175	0.17291899453749424
M1	cpdb	0	network_modules	351	TRUE	3.291741845506789e-5	33	16	4	0.25	0.12121212121212122	GO:0002448	GO:BP	mast cell mediated immunity	16175	971		0.19696969696969696	0.23880597014925373	33	16142	4	12	29	16130	16175	0.17291899453749424
M1	cpdb	0	network_modules	351	TRUE	3.291741845506789e-5	33	16	4	0.25	0.12121212121212122	GO:0034110	GO:BP	regulation of homotypic cell-cell adhesion	16175	8418		0.19696969696969696	0.23880597014925373	33	16142	4	12	29	16130	16175	0.17291899453749424
M1	cpdb	0	network_modules	351	TRUE	4.85838443093705e-5	216	16	6	0.375	0.027777777777777776	GO:0002366	GO:BP	leukocyte activation involved in immune response	16175	898		0.24242424242424243	0.2537313432835821	216	15959	6	10	210	15949	16175	0.09914049060432167
M1	cpdb	0	network_modules	351	TRUE	5.0865396708534554e-5	386	16	7	0.4375	0.018134715025906734	GO:0022407	GO:BP	regulation of cell-cell adhesion	16175	6598		0.25757575757575757	0.26865671641791045	386	15789	7	9	379	15780	16175	0.08527945538320779
M1	cpdb	0	network_modules	351	TRUE	5.567433367768495e-5	221	16	6	0.375	0.027149321266968326	GO:0002263	GO:BP	cell activation involved in immune response	16175	795		0.2727272727272727	0.2835820895522388	221	15954	6	10	215	15944	16175	0.09794414322345762
M1	cpdb	0	network_modules	351	TRUE	5.7414829201546344e-5	622	16	8	0.5	0.012861736334405145	GO:0030155	GO:BP	regulation of cell adhesion	16175	6688		0.2878787878787879	0.29850746268656714	622	15553	8	8	614	15545	16175	0.07552824133202342
M1	cpdb	0	network_modules	351	TRUE	8.107855117606482e-5	41	16	4	0.25	0.0975609756097561	GO:0045576	GO:BP	mast cell activation	16175	11427		0.30303030303030304	0.31343283582089554	41	16134	4	12	37	16122	16175	0.15486321189767238
M1	cpdb	0	network_modules	351	TRUE	1.0426150086752779e-4	124	15	5	0.3333333333333333	0.04032258064516129	KEGG:04611	KEGG	Platelet activation	8484	321		0.5	0.6666666666666666	124	8360	5	10	119	8350	8484	0.1117692325893546
M1	cpdb	0	network_modules	351	TRUE	1.0849100405017331e-4	44	16	4	0.25	0.09090909090909091	GO:0002437	GO:BP	inflammatory response to antigenic stimulus	16175	960		0.3181818181818182	0.3283582089552239	44	16131	4	12	40	16119	16175	0.1493924377677733
M1	cpdb	0	network_modules	351	TRUE	1.1307151252108856e-4	249	16	6	0.375	0.024096385542168676	GO:0050878	GO:BP	regulation of body fluid levels	16175	13323		0.3333333333333333	0.34328358208955223	249	15926	6	10	243	15916	16175	0.09191169752148953
M1	cpdb	0	network_modules	351	TRUE	1.4173645884769324e-4	699	16	8	0.5	0.011444921316165951	GO:0045321	GO:BP	leukocyte activation	16175	11356		0.3484848484848485	0.3582089552238806	699	15476	8	8	691	15468	16175	0.070687248993102
M1	cpdb	0	network_modules	351	TRUE	1.4229373819446727e-4	47	16	4	0.25	0.0851063829787234	GO:0038093	GO:BP	Fc receptor signaling pathway	16175	9693		0.36363636363636365	0.373134328358209	47	16128	4	12	43	16116	16175	0.14445099847913112
M1	cpdb	0	network_modules	351	TRUE	1.56331227141445e-4	263	16	6	0.375	0.022813688212927757	GO:0006887	GO:BP	exocytosis	16175	2543		0.3787878787878788	0.3880597014925373	263	15912	6	10	257	15902	16175	0.08925591291514112
M1	cpdb	0	network_modules	351	TRUE	2.0793171606837336e-4	276	16	6	0.375	0.021739130434782608	GO:0002697	GO:BP	regulation of immune effector process	16175	1215		0.3939393939393939	0.40298507462686567	276	15899	6	10	270	15889	16175	0.08696885254378389
M1	cpdb	0	network_modules	351	TRUE	2.3167685478300582e-4	745	16	8	0.5	0.010738255033557046	GO:0098609	GO:BP	cell-cell adhesion	16175	18805		0.4090909090909091	0.417910447761194	745	15430	8	8	737	15422	16175	0.06814525274624086
M1	cpdb	0	network_modules	351	TRUE	2.707913758718162e-4	55	16	4	0.25	0.07272727272727272	GO:0050853	GO:BP	B cell receptor signaling pathway	16175	13301		0.42424242424242425	0.43283582089552236	55	16120	4	12	51	16108	16175	0.13329863573175535
M1	cpdb	0	network_modules	351	TRUE	3.09449045852693e-4	148	16	5	0.3125	0.033783783783783786	GO:0017157	GO:BP	regulation of exocytosis	16175	5287		0.4393939393939394	0.44776119402985076	148	16027	5	11	143	16016	16175	0.1002499521386601
M1	cpdb	0	network_modules	351	TRUE	3.8959090396959237e-4	67	14	4	0.2857142857142857	0.05970149253731343	REAC:R-HSA-2029481	REAC	FCGR activation	10916	897		0.2	0.3333333333333333	67	10849	4	10	63	10839	10916	0.12827525111623939
M1	cpdb	0	network_modules	351	TRUE	4.4107868209761143e-4	62	16	4	0.25	0.06451612903225806	GO:0070527	GO:BP	platelet aggregation	16175	16166		0.45454545454545453	0.4626865671641791	62	16113	4	12	58	16101	16175	0.12535529731946696
M1	cpdb	0	network_modules	351	TRUE	4.772141142649534e-4	536	16	7	0.4375	0.013059701492537313	GO:0002252	GO:BP	immune effector process	16175	784		0.4696969696969697	0.47761194029850745	536	15639	7	9	529	15630	16175	0.07108549078687301
M1	cpdb	0	network_modules	351	TRUE	5.017839080618548e-4	64	16	4	0.25	0.0625	GO:0032418	GO:BP	lysosome localization	16175	7556		0.48484848484848486	0.5074626865671642	64	16111	4	12	60	16099	16175	0.12332675558161024
M1	cpdb	0	network_modules	351	TRUE	5.017839080618548e-4	64	16	4	0.25	0.0625	GO:1990849	GO:BP	vacuolar localization	16175	25315		0.48484848484848486	0.5074626865671642	64	16111	4	12	60	16099	16175	0.12332675558161024
M1	cpdb	0	network_modules	351	TRUE	6.165735643359924e-4	81	15	4	0.26666666666666666	0.04938271604938271	KEGG:04662	KEGG	B cell receptor signaling pathway	8484	339		1	1	81	8403	4	11	77	8392	8484	0.11127694158373609
M1	cpdb	0	network_modules	351	TRUE	6.390941219541913e-4	334	16	6	0.375	0.017964071856287425	GO:0002443	GO:BP	leukocyte mediated immunity	16175	966		0.5151515151515151	0.5223880597014925	334	15841	6	10	328	15831	16175	0.07840901330708076
M1	cpdb	0	network_modules	351	TRUE	6.864901007004839e-4	17	16	3	0.1875	0.17647058823529413	GO:0050855	GO:BP	regulation of B cell receptor signaling pathway	16175	13303		0.5303030303030303	0.5373134328358209	17	16158	3	13	14	16145	16175	0.18106679952472396
M1	cpdb	0	network_modules	351	TRUE	7.531180951990942e-4	177	16	5	0.3125	0.02824858757062147	GO:0002703	GO:BP	regulation of leukocyte mediated immunity	16175	1221		0.5454545454545454	0.5522388059701493	177	15998	5	11	172	15987	16175	0.09121100568843107
M1	cpdb	0	network_modules	351	TRUE	7.962420423640123e-4	179	16	5	0.3125	0.027932960893854747	GO:0007596	GO:BP	blood coagulation	16175	3055		0.5606060606060606	0.5671641791044776	179	15996	5	11	174	15985	16175	0.09066849354714797
M1	cpdb	0	network_modules	351	TRUE	8.883482484244853e-4	183	16	5	0.3125	0.0273224043715847	GO:0050817	GO:BP	coagulation	16175	13279		0.5757575757575758	0.582089552238806	183	15992	5	11	178	15981	16175	0.089609744209101
M1	cpdb	0	network_modules	351	TRUE	9.374573056887324e-4	185	16	5	0.3125	0.02702702702702703	GO:0006909	GO:BP	phagocytosis	16175	2559		0.5909090909090909	0.6119402985074627	185	15990	5	11	180	15979	16175	0.08909303366148665
M1	cpdb	0	network_modules	351	TRUE	9.374573056887324e-4	185	16	5	0.3125	0.02702702702702703	GO:0007599	GO:BP	hemostasis	16175	3058		0.5909090909090909	0.6119402985074627	185	15990	5	11	180	15979	16175	0.08909303366148665
M1	cpdb	0	network_modules	351	TRUE	9.77069032285153e-4	19	16	3	0.1875	0.15789473684210525	GO:0043304	GO:BP	regulation of mast cell degranulation	16175	10612		0.6212121212121212	0.6417910447761194	19	16156	3	13	16	16143	16175	0.17116905694947215
M1	cpdb	0	network_modules	351	TRUE	9.77069032285153e-4	19	16	3	0.1875	0.15789473684210525	GO:0043302	GO:BP	positive regulation of leukocyte degranulation	16175	10610		0.6212121212121212	0.6417910447761194	19	16156	3	13	16	16143	16175	0.17116905694947215
M1	cpdb	0	network_modules	351	TRUE	0.0014234546870866096	383	16	6	0.375	0.015665796344647518	GO:0002683	GO:BP	negative regulation of immune system process	16175	1201		0.6515151515151515	0.6567164179104478	383	15792	6	10	377	15782	16175	0.07270826707756352
M1	cpdb	0	network_modules	351	TRUE	0.0014559334231873514	93	14	4	0.2857142857142857	0.043010752688172046	REAC:R-HSA-9664323	REAC	FCGR3A-mediated IL10 synthesis	10916	898		0.4	0.5	93	10823	4	10	89	10813	10916	0.10807967888833317
M1	cpdb	0	network_modules	351	TRUE	0.001544760372826278	638	16	7	0.4375	0.0109717868338558	GO:0018193	GO:BP	peptidyl-amino acid modification	16175	5353		0.6666666666666666	0.6716417910447762	638	15537	7	9	631	15528	16175	0.0643498804540299
M1	cpdb	0	network_modules	351	TRUE	0.0015500165410193961	22	16	3	0.1875	0.13636363636363635	GO:0002433	GO:BP	immune response-regulating cell surface receptor signaling pathway involved in phagocytosis	16175	956		0.6818181818181818	0.7014925373134329	22	16153	3	13	19	16140	16175	0.15892730697675234
M1	cpdb	0	network_modules	351	TRUE	0.0015500165410193961	22	16	3	0.1875	0.13636363636363635	GO:0038096	GO:BP	Fc-gamma receptor signaling pathway involved in phagocytosis	16175	9696		0.6818181818181818	0.7014925373134329	22	16153	3	13	19	16140	16175	0.15892730697675234
M1	cpdb	0	network_modules	351	TRUE	0.0016724066944096433	208	16	5	0.3125	0.02403846153846154	GO:0046651	GO:BP	lymphocyte proliferation	16175	12287		0.7121212121212122	0.7164179104477612	208	15967	5	11	203	15956	16175	0.08368631395075025
M1	cpdb	0	network_modules	351	TRUE	0.0017947102457131316	211	16	5	0.3125	0.023696682464454975	GO:0032943	GO:BP	mononuclear cell proliferation	16175	7928		0.7272727272727273	0.7313432835820896	211	15964	5	11	206	15953	16175	0.08304562915422639
M1	cpdb	0	network_modules	351	TRUE	0.0019239739592797694	214	16	5	0.3125	0.02336448598130841	GO:0018108	GO:BP	peptidyl-tyrosine phosphorylation	16175	5327		0.7424242424242424	0.746268656716418	214	15961	5	11	209	15950	16175	0.08241815005694401
M1	cpdb	0	network_modules	351	TRUE	0.001968657635156401	215	16	5	0.3125	0.023255813953488372	GO:0018212	GO:BP	peptidyl-tyrosine modification	16175	5371		0.7575757575757576	0.7611940298507462	215	15960	5	11	210	15949	16175	0.08221184550340069
M1	cpdb	0	network_modules	351	TRUE	0.0020770860371649665	91	16	4	0.25	0.04395604395604396	GO:0050864	GO:BP	regulation of B cell activation	16175	13312		0.7727272727272727	0.7761194029850746	91	16084	4	12	87	16072	16175	0.10280976579749565
M1	cpdb	0	network_modules	351	TRUE	0.0020868613095653206	409	16	6	0.375	0.014669926650366748	GO:0060627	GO:BP	regulation of vesicle-mediated transport	16175	14803		0.7878787878787878	0.7910447761194029	409	15766	6	10	403	15756	16175	0.0700951104387701
M1	cpdb	0	network_modules	351	TRUE	0.002610604688637331	26	16	3	0.1875	0.11538461538461539	GO:0090330	GO:BP	regulation of platelet aggregation	16175	18210		0.803030303030303	0.8059701492537313	26	16149	3	13	23	16136	16175	0.14601571742775804
M1	cpdb	0	network_modules	351	TRUE	0.0031127643333393133	236	16	5	0.3125	0.0211864406779661	GO:0070661	GO:BP	leukocyte proliferation	16175	16242		0.8181818181818182	0.8208955223880597	236	15939	5	11	231	15928	16175	0.07817987586884018
M1	cpdb	0	network_modules	351	TRUE	0.0040667353911232025	30	16	3	0.1875	0.1	GO:0002431	GO:BP	Fc receptor mediated stimulatory signaling pathway	16175	954		0.8333333333333334	0.835820895522388	30	16145	3	13	27	16132	16175	0.1357692171589587
M1	cpdb	0	network_modules	351	TRUE	0.004163215220383718	740	16	7	0.4375	0.00945945945945946	GO:0098657	GO:BP	import into cell	16175	18813		0.8484848484848485	0.8507462686567164	740	15435	7	9	733	15426	16175	0.058998001002103166
M1	cpdb	0	network_modules	351	TRUE	0.004558396343465647	468	16	6	0.375	0.01282051282051282	GO:0050865	GO:BP	regulation of cell activation	16175	13313		0.8636363636363636	0.8656716417910447	468	15707	6	10	462	15697	16175	0.06496613092201732
M1	cpdb	0	network_modules	351	TRUE	0.004726685560451098	257	16	5	0.3125	0.019455252918287938	GO:0022409	GO:BP	positive regulation of cell-cell adhesion	16175	6600		0.8787878787878788	0.8805970149253731	257	15918	5	11	252	15907	16175	0.07464038924265136
M1	cpdb	0	network_modules	351	TRUE	0.004799710162944082	756	16	7	0.4375	0.009259259259259259	GO:0050776	GO:BP	regulation of immune response	16175	13250		0.8939393939393939	0.8955223880597015	756	15419	7	9	749	15410	16175	0.058253158653416806
M1	cpdb	0	network_modules	351	TRUE	0.005296528527515366	115	16	4	0.25	0.034782608695652174	GO:0030168	GO:BP	platelet activation	16175	6695		0.9090909090909091	0.9104477611940298	115	16060	4	12	111	16048	16175	0.09096733133974085
M1	cpdb	0	network_modules	351	TRUE	0.005455170206931775	33	16	3	0.1875	0.09090909090909091	GO:0042119	GO:BP	neutrophil activation	16175	9975		0.9242424242424242	0.9253731343283582	33	16142	3	13	30	16129	16175	0.12933355639244704
M1	cpdb	0	network_modules	351	TRUE	0.005490955490164928	265	16	5	0.3125	0.018867924528301886	GO:0002429	GO:BP	immune response-activating cell surface receptor signaling pathway	16175	952		0.9393939393939394	0.9402985074626866	265	15910	5	11	260	15899	16175	0.07340098756911871
M1	cpdb	0	network_modules	351	TRUE	0.005854394335646112	132	14	4	0.2857142857142857	0.030303030303030304	REAC:R-HSA-9664433	REAC	Leishmania parasite growth and survival	10916	1311		0.6	0.8333333333333334	132	10784	4	10	128	10774	10916	0.08971157373485793
M1	cpdb	0	network_modules	351	TRUE	0.005854394335646112	132	14	4	0.2857142857142857	0.030303030303030304	REAC:R-HSA-9662851	REAC	Anti-inflammatory response favouring Leishmania parasite infection	10916	150		0.6	0.8333333333333334	132	10784	4	10	128	10774	10916	0.08971157373485793
M1	cpdb	0	network_modules	351	TRUE	0.006069184024569219	119	16	4	0.25	0.03361344537815126	GO:0050728	GO:BP	negative regulation of inflammatory response	16175	13227		0.9545454545454546	0.9552238805970149	119	16056	4	12	115	16044	16175	0.08934548044615391
M1	cpdb	0	network_modules	351	TRUE	0.006536114093843217	35	16	3	0.1875	0.08571428571428572	GO:1903307	GO:BP	positive regulation of regulated secretory pathway	16175	22894		0.9696969696969697	0.9701492537313433	35	16140	3	13	32	16127	16175	0.1255080059505054
M1	cpdb	0	network_modules	351	TRUE	0.0073838491839969015	140	14	4	0.2857142857142857	0.02857142857142857	REAC:R-HSA-2029480	REAC	Fcgamma receptor (FCGR) dependent phagocytosis	10916	939		1	1	140	10776	4	10	136	10766	10916	0.08690960899376432
M1	cpdb	0	network_modules	351	TRUE	0.008102637962305745	287	16	5	0.3125	0.017421602787456445	GO:0002768	GO:BP	immune response-regulating cell surface receptor signaling pathway	16175	1279		0.9848484848484849	0.9850746268656716	287	15888	5	11	282	15877	16175	0.07025625055190057
M1	cpdb	0	network_modules	351	TRUE	0.00964096021214287	533	16	6	0.375	0.01125703564727955	GO:0006897	GO:BP	endocytosis	16175	2551		1	1	533	15642	6	10	527	15632	16175	0.060294019962829216
M1	cpdb	0	network_modules	352	TRUE	6.312756034463011e-13	157	11	9	0.8181818181818182	0.05732484076433121	KEGG:04390	KEGG	Hippo signaling pathway	8484	310		0	0.5	157	8327	9	2	148	8325	8484	0.21379550398275193
M1	cpdb	0	network_modules	352	TRUE	1.674448262924688e-11	44	17	7	0.4117647058823529	0.1590909090909091	GO:0035329	GO:BP	hippo signaling	16175	8973		0	0.09090909090909091	44	16131	7	10	37	16121	16175	0.2547349165497445
M1	cpdb	0	network_modules	352	TRUE	2.4564430355634257e-11	29	11	6	0.5454545454545454	0.20689655172413793	KEGG:04392	KEGG	Hippo signaling pathway - multiple species	8484	312		1	1	29	8455	6	5	23	8450	8484	0.33461931330512373
M1	cpdb	0	network_modules	352	TRUE	1.4874070233022496e-6	19	13	4	0.3076923076923077	0.21052631578947367	REAC:R-HSA-2028269	REAC	Signaling by Hippo	10916	2259		0	0.5	19	10897	4	9	15	10888	10916	0.25344565688490506
M1	cpdb	0	network_modules	352	TRUE	1.440434059618664e-4	118	17	5	0.29411764705882354	0.0423728813559322	GO:0090090	GO:BP	negative regulation of canonical Wnt signaling pathway	16175	18011		0.1	0.18181818181818182	118	16057	5	12	113	16045	16175	0.10932383660747842
M1	cpdb	0	network_modules	352	TRUE	4.173654051099397e-4	146	17	5	0.29411764705882354	0.03424657534246575	GO:0030178	GO:BP	negative regulation of Wnt signaling pathway	16175	6698		0.2	0.2727272727272727	146	16029	5	12	141	16017	16175	0.09777535010978024
M1	cpdb	0	network_modules	352	TRUE	0.001025305395298596	18	17	3	0.17647058823529413	0.16666666666666666	GO:0035278	GO:BP	miRNA-mediated gene silencing by inhibition of translation	16175	8938		0.3	0.36363636363636365	18	16157	3	14	15	16143	16175	0.170601687161713
M1	cpdb	0	network_modules	352	TRUE	0.0016323252356463024	595	17	7	0.4117647058823529	0.011764705882352941	GO:0051248	GO:BP	negative regulation of protein metabolic process	16175	13595		0.4	0.45454545454545453	595	15580	7	10	588	15570	16175	0.06461603643186875
M1	cpdb	0	network_modules	352	TRUE	0.002280831717693737	385	17	6	0.35294117647058826	0.015584415584415584	GO:0043065	GO:BP	positive regulation of apoptotic process	16175	10511		0.5	0.5454545454545454	385	15790	6	11	379	15779	16175	0.07003786202860537
M1	cpdb	0	network_modules	352	TRUE	0.002642505182756184	212	17	5	0.29411764705882354	0.02358490566037736	GO:0060828	GO:BP	regulation of canonical Wnt signaling pathway	16175	14976		0.6	0.6363636363636364	212	15963	5	12	207	15951	16175	0.08014438171298156
M1	cpdb	0	network_modules	352	TRUE	0.002889065518584155	401	17	6	0.35294117647058826	0.014962593516209476	GO:0043068	GO:BP	positive regulation of programmed cell death	16175	10514		0.7	0.7272727272727273	401	15774	6	11	395	15763	16175	0.06845481948559072
M1	cpdb	0	network_modules	352	TRUE	0.004726971342761029	42	13	3	0.23076923076923078	0.07142857142857142	REAC:R-HSA-9696264	REAC	RND3 GTPase cycle	10916	1907		1	1	42	10874	3	10	39	10864	10916	0.12656652430947055
M1	cpdb	0	network_modules	352	TRUE	0.005922702159977847	110	17	4	0.23529411764705882	0.03636363636363636	GO:0017148	GO:BP	negative regulation of translation	16175	5285		0.8	0.8181818181818182	110	16065	4	13	106	16052	16175	0.09018038594120213
M1	cpdb	0	network_modules	352	TRUE	0.006783423250564995	257	17	5	0.29411764705882354	0.019455252918287938	GO:0060070	GO:BP	canonical Wnt signaling pathway	16175	14332		0.9	0.9090909090909091	257	15918	5	12	252	15906	16175	0.07217161466528345
M1	cpdb	0	network_modules	352	TRUE	0.009772226489356628	277	17	5	0.29411764705882354	0.018050541516245487	GO:0030111	GO:BP	regulation of Wnt signaling pathway	16175	6681		1	1	277	15898	5	12	272	15886	16175	0.06925190984309079
M1	cpdb	0	network_modules	353	TRUE	1.289569196335864e-27	43	15	13	0.8666666666666667	0.3023255813953488	KEGG:03022	KEGG	Basal transcription factors	8484	213		0	0.3333333333333333	43	8441	13	2	30	8439	8484	0.5106271232893494
M1	cpdb	0	network_modules	353	TRUE	3.6352044859556796e-27	46	16	13	0.8125	0.2826086956521739	REAC:R-HSA-73776	REAC	RNA Polymerase II Promoter Escape	10916	1889		0	0.13953488372093023	46	10870	13	3	33	10867	10916	0.4780591547517969
M1	cpdb	0	network_modules	353	TRUE	3.6352044859556796e-27	46	16	13	0.8125	0.2826086956521739	REAC:R-HSA-75953	REAC	RNA Polymerase II Transcription Initiation	10916	1892		0	0.13953488372093023	46	10870	13	3	33	10867	10916	0.4780591547517969
M1	cpdb	0	network_modules	353	TRUE	3.6352044859556796e-27	46	16	13	0.8125	0.2826086956521739	REAC:R-HSA-76042	REAC	RNA Polymerase II Transcription Initiation And Promoter Clearance	10916	1893		0	0.13953488372093023	46	10870	13	3	33	10867	10916	0.4780591547517969
M1	cpdb	0	network_modules	353	TRUE	3.6352044859556796e-27	46	16	13	0.8125	0.2826086956521739	REAC:R-HSA-73779	REAC	RNA Polymerase II Transcription Pre-Initiation And Promoter Opening	10916	1894		0	0.13953488372093023	46	10870	13	3	33	10867	10916	0.4780591547517969
M1	cpdb	0	network_modules	353	TRUE	3.6352044859556796e-27	46	16	13	0.8125	0.2826086956521739	REAC:R-HSA-167161	REAC	HIV Transcription Initiation	10916	1105		0	0.13953488372093023	46	10870	13	3	33	10867	10916	0.4780591547517969
M1	cpdb	0	network_modules	353	TRUE	3.6352044859556796e-27	46	16	13	0.8125	0.2826086956521739	REAC:R-HSA-167162	REAC	RNA Polymerase II HIV Promoter Escape	10916	1887		0	0.13953488372093023	46	10870	13	3	33	10867	10916	0.4780591547517969
M1	cpdb	0	network_modules	353	TRUE	1.372527763819846e-24	69	16	13	0.8125	0.18840579710144928	REAC:R-HSA-167172	REAC	Transcription of the HIV genome	10916	2540		0.14285714285714285	0.16279069767441862	69	10847	13	3	56	10844	10916	0.38972869816858086
M1	cpdb	0	network_modules	353	TRUE	1.115923855015122e-23	80	16	13	0.8125	0.1625	REAC:R-HSA-674695	REAC	RNA Polymerase II Pre-transcription Events	10916	1888		0.16666666666666666	0.18604651162790697	80	10836	13	3	67	10833	10916	0.3616754815145755
M1	cpdb	0	network_modules	353	TRUE	2.0513803415050177e-21	26	16	10	0.625	0.38461538461538464	REAC:R-HSA-167160	REAC	RNA Pol II CTD phosphorylation and interaction with CE during HIV infection	10916	1880		0.19047619047619047	0.23255813953488372	26	10890	10	6	16	10884	10916	0.48936336037822514
M1	cpdb	0	network_modules	353	TRUE	2.0513803415050177e-21	26	16	10	0.625	0.38461538461538464	REAC:R-HSA-77075	REAC	RNA Pol II CTD phosphorylation and interaction with CE	10916	1879		0.19047619047619047	0.23255813953488372	26	10890	10	6	16	10884	10916	0.48936336037822514
M1	cpdb	0	network_modules	353	TRUE	5.063041166423176e-21	28	16	10	0.625	0.35714285714285715	REAC:R-HSA-72086	REAC	mRNA Capping	10916	2702		0.23809523809523808	0.2558139534883721	28	10888	10	6	18	10882	10916	0.4714668627428296
M1	cpdb	0	network_modules	353	TRUE	1.125551794030068e-20	132	16	13	0.8125	0.09848484848484848	REAC:R-HSA-162599	REAC	Late Phase of HIV Life Cycle	10916	1304		0.2619047619047619	0.27906976744186046	132	10784	13	3	119	10781	10916	0.28057217548008473
M1	cpdb	0	network_modules	353	TRUE	2.4839703219963912e-20	32	16	10	0.625	0.3125	REAC:R-HSA-113418	REAC	Formation of the Early Elongation Complex	10916	963		0.2857142857142857	0.32558139534883723	32	10884	10	6	22	10878	10916	0.44083822005159257
M1	cpdb	0	network_modules	353	TRUE	2.4839703219963912e-20	32	16	10	0.625	0.3125	REAC:R-HSA-167158	REAC	Formation of the HIV-1 Early Elongation Complex	10916	965		0.2857142857142857	0.32558139534883723	32	10884	10	6	22	10878	10916	0.44083822005159257
M1	cpdb	0	network_modules	353	TRUE	4.024641877889049e-20	145	16	13	0.8125	0.0896551724137931	REAC:R-HSA-162587	REAC	HIV Life Cycle	10916	1103		0.3333333333333333	0.3488372093023256	145	10771	13	3	132	10768	10916	0.2674624573411113
M1	cpdb	0	network_modules	353	TRUE	5.637291281118938e-19	42	16	10	0.625	0.23809523809523808	REAC:R-HSA-167246	REAC	Tat-mediated elongation of the HIV-1 transcript	10916	2485		0.35714285714285715	0.4186046511627907	42	10874	10	6	32	10868	10916	0.38440511079751905
M1	cpdb	0	network_modules	353	TRUE	5.637291281118938e-19	42	16	10	0.625	0.23809523809523808	REAC:R-HSA-167169	REAC	HIV Transcription Elongation	10916	1104		0.35714285714285715	0.4186046511627907	42	10874	10	6	32	10868	10916	0.38440511079751905
M1	cpdb	0	network_modules	353	TRUE	5.637291281118938e-19	42	16	10	0.625	0.23809523809523808	REAC:R-HSA-167200	REAC	Formation of HIV-1 elongation complex containing HIV-1 Tat	10916	947		0.35714285714285715	0.4186046511627907	42	10874	10	6	32	10868	10916	0.38440511079751905
M1	cpdb	0	network_modules	353	TRUE	9.496489521500588e-19	44	16	10	0.625	0.22727272727272727	REAC:R-HSA-167152	REAC	Formation of HIV elongation complex in the absence of HIV Tat	10916	946		0.42857142857142855	0.4418604651162791	44	10872	10	6	34	10866	10916	0.37549078437957156
M1	cpdb	0	network_modules	353	TRUE	1.4572113482397883e-17	225	16	13	0.8125	0.057777777777777775	REAC:R-HSA-162906	REAC	HIV Infection	10916	1102		0.4523809523809524	0.46511627906976744	225	10691	13	3	212	10688	10916	0.21353724591514464
M1	cpdb	0	network_modules	353	TRUE	1.6419915520495945e-17	57	16	10	0.625	0.17543859649122806	REAC:R-HSA-112382	REAC	Formation of RNA Pol II elongation complex 	10916	949		0.47619047619047616	0.5116279069767442	57	10859	10	6	47	10853	10916	0.3294688016917271
M1	cpdb	0	network_modules	353	TRUE	1.6419915520495945e-17	57	16	10	0.625	0.17543859649122806	REAC:R-HSA-75955	REAC	RNA Polymerase II Transcription Elongation	10916	1891		0.47619047619047616	0.5116279069767442	57	10859	10	6	47	10853	10916	0.3294688016917271
M1	cpdb	0	network_modules	353	TRUE	3.422016337764779e-17	61	16	10	0.625	0.16393442622950818	REAC:R-HSA-6796648	REAC	TP53 Regulates Transcription of DNA Repair Genes	10916	2456		0.5238095238095238	0.5348837209302325	61	10855	10	6	51	10849	10916	0.31835374515539816
M1	cpdb	0	network_modules	353	TRUE	3.3540689703437197e-16	43	16	9	0.5625	0.20930232558139536	REAC:R-HSA-5696395	REAC	Formation of Incision Complex in GG-NER	10916	948		0.5476190476190477	0.5581395348837209	43	10873	9	7	34	10866	10916	0.3416424462910049
M1	cpdb	0	network_modules	353	TRUE	6.427439641236194e-15	31	16	8	0.5	0.25806451612903225	REAC:R-HSA-73863	REAC	RNA Polymerase I Transcription Termination	10916	1886		0.5714285714285714	0.5813953488372093	31	10885	8	8	23	10877	10916	0.3579410438943935
M1	cpdb	0	network_modules	353	TRUE	8.52531786703809e-15	61	15	9	0.6	0.14754098360655737	KEGG:03420	KEGG	Nucleotide excision repair	8484	238		0.5	0.6666666666666666	61	8423	9	6	52	8417	8484	0.2952891044468761
M1	cpdb	0	network_modules	353	TRUE	1.618223999507984e-14	64	16	9	0.5625	0.140625	REAC:R-HSA-6782135	REAC	Dual incision in TC-NER	10916	808		0.5952380952380952	0.6046511627906976	64	10852	9	7	55	10845	10916	0.279342809589648
M1	cpdb	0	network_modules	353	TRUE	9.40769137130849e-14	77	16	9	0.5625	0.11688311688311688	REAC:R-HSA-6781827	REAC	Transcription-Coupled Nucleotide Excision Repair (TC-NER)	10916	2541		0.6190476190476191	0.627906976744186	77	10839	9	7	68	10832	10916	0.25428002594287086
M1	cpdb	0	network_modules	353	TRUE	2.1381145878560191e-13	84	16	9	0.5625	0.10714285714285714	REAC:R-HSA-5696399	REAC	Global Genome Nucleotide Excision Repair (GG-NER)	10916	1047		0.6428571428571429	0.6511627906976745	84	10832	9	7	75	10825	10916	0.24325208309700252
M1	cpdb	0	network_modules	353	TRUE	2.5354285743617885e-13	47	16	8	0.5	0.1702127659574468	REAC:R-HSA-73762	REAC	RNA Polymerase I Transcription Initiation	10916	1885		0.6666666666666666	0.6744186046511628	47	10869	8	8	39	10861	10916	0.2900551313453041
M1	cpdb	0	network_modules	353	TRUE	6.047801673325311e-13	52	16	8	0.5	0.15384615384615385	REAC:R-HSA-6781823	REAC	Formation of TC-NER Pre-Incision Complex	10916	951		0.6904761904761905	0.6976744186046512	52	10864	8	8	44	10856	10916	0.2755663814689081
M1	cpdb	0	network_modules	353	TRUE	2.4404185596362387e-12	109	16	9	0.5625	0.08256880733944955	REAC:R-HSA-5696398	REAC	Nucleotide Excision Repair	10916	1622		0.7142857142857143	0.7209302325581395	109	10807	9	7	100	10800	10916	0.21290617044559534
M1	cpdb	0	network_modules	353	TRUE	3.0901384690161968e-12	63	16	8	0.5	0.12698412698412698	REAC:R-HSA-6782210	REAC	Gap-filling DNA repair synthesis and ligation in TC-NER	10916	1038		0.7380952380952381	0.7441860465116279	63	10853	8	8	55	10845	10916	0.24997294981468687
M1	cpdb	0	network_modules	353	TRUE	7.705197855024972e-12	143	17	9	0.5294117647058824	0.06293706293706294	GO:0006367	GO:BP	transcription initiation at RNA polymerase II promoter	16175	2142		0	0.16666666666666666	143	16032	9	8	134	16024	16175	0.18038192424928404
M1	cpdb	0	network_modules	353	TRUE	4.415706919525916e-11	173	17	9	0.5294117647058824	0.05202312138728324	GO:0006352	GO:BP	DNA-templated transcription initiation	16175	2129		0.2	0.3333333333333333	173	16002	9	8	164	15994	16175	0.16356659555896158
M1	cpdb	0	network_modules	353	TRUE	6.076384467600581e-11	90	16	8	0.5	0.08888888888888889	REAC:R-HSA-73772	REAC	RNA Polymerase I Promoter Escape	10916	1882		0.7619047619047619	0.7674418604651163	90	10826	8	8	82	10818	10916	0.20835502711546047
M1	cpdb	0	network_modules	353	TRUE	2.1642239870434436e-10	105	16	8	0.5	0.0761904761904762	REAC:R-HSA-427413	REAC	NoRC negatively regulates rRNA expression	10916	1602		0.7857142857142857	0.7906976744186046	105	10811	8	8	97	10803	10916	0.19249364778456668
M1	cpdb	0	network_modules	353	TRUE	2.7270836196829924e-10	108	16	8	0.5	0.07407407407407407	REAC:R-HSA-5250941	REAC	Negative epigenetic regulation of rRNA expression	10916	1566		0.8095238095238095	0.813953488372093	108	10808	8	8	100	10800	10916	0.18972125054197503
M1	cpdb	0	network_modules	353	TRUE	2.941157238224505e-10	109	16	8	0.5	0.07339449541284404	REAC:R-HSA-73854	REAC	RNA Polymerase I Promoter Clearance	10916	1881		0.8333333333333334	0.8372093023255814	109	10807	8	8	101	10799	10916	0.1888224009473143
M1	cpdb	0	network_modules	353	TRUE	3.169752837774759e-10	110	16	8	0.5	0.07272727272727272	REAC:R-HSA-73864	REAC	RNA Polymerase I Transcription	10916	1884		0.8571428571428571	0.8604651162790697	110	10806	8	8	102	10798	10916	0.1879357133558941
M1	cpdb	0	network_modules	353	TRUE	1.1811369049562443e-9	329	16	10	0.625	0.030395136778115502	REAC:R-HSA-73894	REAC	DNA Repair	10916	444		0.8809523809523809	0.8837209302325582	329	10587	10	6	319	10581	10916	0.1333033862368518
M1	cpdb	0	network_modules	353	TRUE	2.816094192806579e-9	359	16	10	0.625	0.027855153203342618	REAC:R-HSA-3700989	REAC	Transcriptional Regulation by TP53	10916	2546		0.9047619047619048	0.9069767441860465	359	10557	10	6	349	10551	10916	0.12720289937545323
M1	cpdb	0	network_modules	353	TRUE	4.7843362082477696e-9	41	16	6	0.375	0.14634146341463414	REAC:R-HSA-5696400	REAC	Dual Incision in GG-NER	10916	807		0.9285714285714286	0.9302325581395349	41	10875	6	10	35	10865	10916	0.23252154752794113
M1	cpdb	0	network_modules	353	TRUE	2.1493459795687527e-8	185	16	8	0.5	0.043243243243243246	REAC:R-HSA-212165	REAC	Epigenetic regulation of gene expression	10916	852		0.9523809523809523	0.9534883720930233	185	10731	8	8	177	10723	10916	0.14338329356194318
M1	cpdb	0	network_modules	353	TRUE	1.7454292922749668e-7	79	17	6	0.35294117647058826	0.0759493670886076	GO:0006289	GO:BP	nucleotide-excision repair	16175	2102		0.4	0.5	79	16096	6	11	73	16085	16175	0.16193954446416756
M1	cpdb	0	network_modules	353	TRUE	1.766188735172024e-7	73	16	6	0.375	0.0821917808219178	REAC:R-HSA-6807505	REAC	RNA polymerase II transcribes snRNA genes	10916	1904		0.9761904761904762	0.9767441860465116	73	10843	6	10	67	10833	10916	0.1731373036916388
M1	cpdb	0	network_modules	353	TRUE	3.0176349374322154e-5	528	17	8	0.47058823529411764	0.015151515151515152	GO:0006281	GO:BP	DNA repair	16175	2095		0.6	0.6666666666666666	528	15647	8	9	520	15638	16175	0.07993965755273866
M1	cpdb	0	network_modules	353	TRUE	1.061649402383564e-4	9	17	3	0.17647058823529413	0.3333333333333333	GO:0006283	GO:BP	transcription-coupled nucleotide-excision repair	16175	2097		0.8	0.8333333333333334	9	16166	3	14	6	16152	16175	0.24196538410195859
M1	cpdb	0	network_modules	353	TRUE	7.286260260216387e-4	798	17	8	0.47058823529411764	0.010025062656641603	GO:0006974	GO:BP	DNA damage response	16175	2601		1	1	798	15377	8	9	790	15368	16175	0.06309290705018611
M1	cpdb	0	network_modules	353	TRUE	0.0011153778871691254	201	15	5	0.3333333333333333	0.024875621890547265	KEGG:05203	KEGG	Viral carcinogenesis	8484	455		1	1	201	8283	5	10	196	8273	8484	0.08568361408345271
M1	cpdb	0	network_modules	353	TRUE	0.00186766946082892	25	16	3	0.1875	0.12	REAC:R-HSA-69273	REAC	Cyclin A/B1/B2 associated events during G2/M transition	10916	418		1	1	25	10891	3	13	22	10878	10916	0.14844661905822454
M1	cpdb	0	network_modules	355	TRUE	4.746160529059777e-5	60	10	4	0.4	0.06666666666666667	REAC:R-HSA-163841	REAC	Gamma carboxylation, hypusinylation, hydroxylation, and arylsulfatase activation	10916	1030		0	0.3333333333333333	60	10856	4	6	56	10850	10916	0.16157385152341414
M1	cpdb	0	network_modules	355	TRUE	0.0010929709573566963	36	10	3	0.3	0.08333333333333333	REAC:R-HSA-9840310	REAC	Glycosphingolipid catabolism	10916	1078		0.5	0.6666666666666666	36	10880	3	7	33	10873	10916	0.15670602190132005
M1	cpdb	0	network_modules	355	TRUE	0.002312539505700123	46	10	3	0.3	0.06521739130434782	REAC:R-HSA-1660662	REAC	Glycosphingolipid metabolism	10916	1079		1	1	46	10870	3	7	43	10863	10916	0.13826578064370965
M1	cpdb	0	network_modules	357	TRUE	0.0015818572601360014	504	13	6	0.46153846153846156	0.011904761904761904	GO:0072657	GO:BP	protein localization to membrane	16175	17478		0	0.16666666666666666	504	15671	6	7	498	15664	16175	0.07025158554914093
M1	cpdb	0	network_modules	357	TRUE	0.0018553900340378484	112	13	4	0.3076923076923077	0.03571428571428571	GO:1904375	GO:BP	regulation of protein localization to cell periphery	16175	23762		0.2	0.3333333333333333	112	16063	4	9	108	16054	16175	0.1028673996557232
M1	cpdb	0	network_modules	357	TRUE	0.0023496652549328395	285	13	5	0.38461538461538464	0.017543859649122806	GO:1990778	GO:BP	protein localization to cell periphery	16175	25286		0.4	0.5	285	15890	5	8	280	15882	16175	0.07911246094257908
M1	cpdb	0	network_modules	357	TRUE	0.004115243848962827	594	13	6	0.46153846153846156	0.010101010101010102	GO:0051668	GO:BP	localization within membrane	16175	13880		0.6	0.6666666666666666	594	15581	6	7	588	15574	16175	0.06405860795505437
M1	cpdb	0	network_modules	357	TRUE	0.005059024567550194	144	13	4	0.3076923076923077	0.027777777777777776	GO:1905475	GO:BP	regulation of protein localization to membrane	16175	24661		0.8	0.8333333333333334	144	16031	4	9	140	16022	16175	0.09021369156040307
M1	cpdb	0	network_modules	357	TRUE	0.007443582190847047	5	13	2	0.15384615384615385	0.4	GO:0098696	GO:BP	regulation of neurotransmitter receptor localization to postsynaptic specialization membrane	16175	18831		1	1	5	16170	2	11	3	16159	16175	0.24770886606428522
M1	cpdb	0	network_modules	357	TRUE	0.007945158045721153	292	8	4	0.5	0.0136986301369863	REAC:R-HSA-9694516	REAC	SARS-CoV-2 Infection	10916	2122		NA	1	292	10624	4	4	288	10620	10916	0.0794312457785953
M1	cpdb	0	network_modules	358	TRUE	2.110988401586919e-6	4	14	3	0.21428571428571427	0.75	REAC:R-HSA-1296025	REAC	ATP sensitive Potassium channels	10916	39		0	0.25	4	10912	3	11	1	10901	10916	0.40053660212126935
M1	cpdb	0	network_modules	358	TRUE	4.803491217111376e-4	2	14	2	0.14285714285714285	1	REAC:R-HSA-5678420	REAC	Defective ABCC9 causes CMD10, ATFB12 and Cantu syndrome	10916	468		0.3333333333333333	0.75	2	10914	2	12	0	10902	10916	0.37775662890607037
M1	cpdb	0	network_modules	358	TRUE	4.803491217111376e-4	2	14	2	0.14285714285714285	1	REAC:R-HSA-5683177	REAC	Defective ABCC8 can cause hypo- and hyper-glycemias	10916	467		0.3333333333333333	0.75	2	10914	2	12	0	10902	10916	0.37775662890607037
M1	cpdb	0	network_modules	358	TRUE	0.00337403912308671	35	14	3	0.21428571428571427	0.08571428571428572	REAC:R-HSA-1296065	REAC	Inwardly rectifying K+ channels	10916	1271		1	1	35	10881	3	11	32	10870	10916	0.13379870300597554
M1	cpdb	0	network_modules	358	TRUE	0.008001825902453373	43	14	3	0.21428571428571427	0.06976744186046512	GO:1990573	GO:BP	potassium ion import across plasma membrane	16175	25222		NA	1	43	16132	3	11	40	16121	16175	0.12096717258373428
M1	cpdb	0	network_modules	359	TRUE	5.284528373176585e-4	23	12	3	0.25	0.13043478260869565	REAC:R-HSA-2453902	REAC	The canonical retinoid cycle in rods (twilight vision)	10916	2499		NA	1	23	10893	3	9	20	10884	10916	0.1793444014860522
M1	cpdb	0	network_modules	359	TRUE	0.003342824188508391	3	15	2	0.13333333333333333	0.6666666666666666	GO:0048252	GO:BP	lauric acid metabolic process	16175	12608		0	0.5	3	16172	2	13	1	16159	16175	0.29789344298100395
M1	cpdb	0	network_modules	359	TRUE	0.006629990855450312	128	15	4	0.26666666666666666	0.03125	GO:0120254	GO:BP	olefinic compound metabolic process	16175	19583		1	1	128	16047	4	11	124	16036	16175	0.08897194659354639
M1	cpdb	0	network_modules	360	TRUE	1.463618484817214e-23	67	13	12	0.9230769230769231	0.1791044776119403	KEGG:05204	KEGG	Chemical carcinogenesis - DNA adducts	8484	456		0	0.07142857142857142	67	8417	12	1	55	8416	8484	0.40503757175162675
M1	cpdb	0	network_modules	360	TRUE	1.7770562073452154e-23	68	13	12	0.9230769230769231	0.17647058823529413	KEGG:00982	KEGG	Drug metabolism - cytochrome P450	8484	156		0.07692307692307693	0.14285714285714285	68	8416	12	1	56	8415	8484	0.4020204247977991
M1	cpdb	0	network_modules	360	TRUE	9.991477123846761e-23	43	14	11	0.7857142857142857	0.2558139534883721	REAC:R-HSA-9749641	REAC	Aspirin ADME	10916	171		0	0.07142857142857142	43	10873	11	3	32	10870	10916	0.44724693772880897
M1	cpdb	0	network_modules	360	TRUE	6.4026568943121635e-21	116	15	12	0.8	0.10344827586206896	GO:0006805	GO:BP	xenobiotic metabolic process	16175	2487		0	0.02	116	16059	12	3	104	16056	16175	0.28625970341907486
M1	cpdb	0	network_modules	360	TRUE	1.175006393357475e-20	107	14	12	0.8571428571428571	0.11214953271028037	REAC:R-HSA-9748784	REAC	Drug ADME	10916	796		0.07692307692307693	0.14285714285714285	107	10809	12	2	95	10807	10916	0.3082108280388378
M1	cpdb	0	network_modules	360	TRUE	1.5750694560754973e-20	68	13	11	0.8461538461538461	0.16176470588235295	KEGG:00830	KEGG	Retinol metabolism	8484	127		0.15384615384615385	0.21428571428571427	68	8416	11	2	57	8414	8484	0.36822527910416303
M1	cpdb	0	network_modules	360	TRUE	4.2887568824878404e-20	74	13	11	0.8461538461538461	0.14864864864864866	KEGG:00980	KEGG	Metabolism of xenobiotics by cytochrome P450	8484	154		0.23076923076923078	0.2857142857142857	74	8410	11	2	63	8408	8484	0.3528096486641082
M1	cpdb	0	network_modules	360	TRUE	9.59927195641956e-20	144	15	12	0.8	0.08333333333333333	GO:0071466	GO:BP	cellular response to xenobiotic stimulus	16175	16699		0.02040816326530612	0.04	144	16031	12	3	132	16028	16175	0.2565887609738791
M1	cpdb	0	network_modules	360	TRUE	2.0204110012256443e-19	215	14	13	0.9285714285714286	0.06046511627906977	REAC:R-HSA-211859	REAC	Biological oxidations	10916	227		0.15384615384615385	0.21428571428571427	215	10701	13	1	202	10700	10916	0.23439453066161392
M1	cpdb	0	network_modules	360	TRUE	3.1780200443083698e-18	191	15	12	0.8	0.06282722513089005	GO:0009410	GO:BP	response to xenobiotic stimulus	16175	3475		0.04081632653061224	0.06	191	15984	12	3	179	15981	16175	0.22230112132764066
M1	cpdb	0	network_modules	360	TRUE	1.559923290375308e-17	21	15	8	0.5333333333333333	0.38095238095238093	GO:0052695	GO:BP	cellular glucuronidation	16175	14152		0.061224489795918366	0.08	21	16154	8	7	13	16147	16175	0.45015262260839795
M1	cpdb	0	network_modules	360	TRUE	3.7557776653443885e-17	23	15	8	0.5333333333333333	0.34782608695652173	GO:0006063	GO:BP	uronic acid metabolic process	16175	1930		0.08163265306122448	0.12	23	16152	8	7	15	16145	16175	0.4300623823945617
M1	cpdb	0	network_modules	360	TRUE	3.7557776653443885e-17	23	15	8	0.5333333333333333	0.34782608695652173	GO:0019585	GO:BP	glucuronate metabolic process	16175	5912		0.08163265306122448	0.12	23	16152	8	7	15	16145	16175	0.4300623823945617
M1	cpdb	0	network_modules	360	TRUE	2.0309464686701866e-16	25	14	8	0.5714285714285714	0.32	REAC:R-HSA-156588	REAC	Glucuronidation	10916	1054		0.23076923076923078	0.2857142857142857	25	10891	8	6	17	10885	10916	0.42666638388936934
M1	cpdb	0	network_modules	360	TRUE	6.105742231111114e-16	30	13	8	0.6153846153846154	0.26666666666666666	KEGG:00053	KEGG	Ascorbate and aldarate metabolism	8484	8		0.3076923076923077	0.35714285714285715	30	8454	8	5	22	8449	8484	0.40379150631562505
M1	cpdb	0	network_modules	360	TRUE	1.2347084223829541e-15	62	13	9	0.6923076923076923	0.14516129032258066	KEGG:00140	KEGG	Steroid hormone biosynthesis	8484	17		0.38461538461538464	0.42857142857142855	62	8422	9	4	53	8418	8484	0.31505907119666726
M1	cpdb	0	network_modules	360	TRUE	3.0898972266242895e-15	504	15	13	0.8666666666666667	0.025793650793650792	GO:0032787	GO:BP	monocarboxylic acid metabolic process	16175	7822		0.12244897959183673	0.14	504	15671	13	2	491	15669	16175	0.1465061832842729
M1	cpdb	0	network_modules	360	TRUE	3.1468008359096485e-15	36	13	8	0.6153846153846154	0.2222222222222222	KEGG:00040	KEGG	Pentose and glucuronate interconversions	8484	5		0.46153846153846156	0.5	36	8448	8	5	28	8443	8484	0.36831418892176776
M1	cpdb	0	network_modules	360	TRUE	7.554110498793376e-15	80	15	9	0.6	0.1125	GO:0006721	GO:BP	terpenoid metabolic process	16175	2427		0.14285714285714285	0.16	80	16095	9	6	71	16089	16175	0.2584254049506746
M1	cpdb	0	network_modules	360	TRUE	1.2435646262331554e-14	79	13	9	0.6923076923076923	0.11392405063291139	KEGG:00983	KEGG	Drug metabolism - other enzymes	8484	157		0.5384615384615384	0.5714285714285714	79	8405	9	4	70	8401	8484	0.2785741285506697
M1	cpdb	0	network_modules	360	TRUE	1.5024136452300817e-14	43	13	8	0.6153846153846154	0.18604651162790697	KEGG:00860	KEGG	Porphyrin metabolism	8484	128		0.6153846153846154	0.6428571428571429	43	8441	8	5	35	8436	8484	0.33668886347542637
M1	cpdb	0	network_modules	360	TRUE	3.824210343739823e-14	89	13	9	0.6923076923076923	0.10112359550561797	KEGG:04976	KEGG	Bile secretion	8484	407		0.6923076923076923	0.7142857142857143	89	8395	9	4	80	8391	8484	0.2621607644597576
M1	cpdb	0	network_modules	360	TRUE	4.6289359747172894e-14	97	15	9	0.6	0.09278350515463918	GO:0006720	GO:BP	isoprenoid metabolic process	16175	2426		0.16326530612244897	0.18	97	16078	9	6	88	16072	16175	0.23439916831676008
M1	cpdb	0	network_modules	360	TRUE	4.821185835239913e-13	742	15	13	0.8666666666666667	0.01752021563342318	GO:0019752	GO:BP	carboxylic acid metabolic process	16175	6036		0.1836734693877551	0.2	742	15433	13	2	729	15431	16175	0.11952973823683195
M1	cpdb	0	network_modules	360	TRUE	6.699868832102633e-13	761	15	13	0.8666666666666667	0.017082785808147174	GO:0043436	GO:BP	oxoacid metabolic process	16175	10693		0.20408163265306123	0.22	761	15414	13	2	748	15412	16175	0.11793185278045519
M1	cpdb	0	network_modules	360	TRUE	7.4206969646427475e-13	767	15	13	0.8666666666666667	0.01694915254237288	GO:0006082	GO:BP	organic acid metabolic process	16175	1947		0.22448979591836735	0.24	767	15408	13	2	754	15406	16175	0.11743937007811504
M1	cpdb	0	network_modules	360	TRUE	2.7125548772123416e-12	6	15	5	0.3333333333333333	0.8333333333333334	GO:0051552	GO:BP	flavone metabolic process	16175	13783		0.24489795918367346	0.26	6	16169	5	10	1	16159	16175	0.5268017583303504
M1	cpdb	0	network_modules	360	TRUE	1.3353034312757601e-11	179	15	9	0.6	0.05027932960893855	GO:0042445	GO:BP	hormone metabolic process	16175	10185		0.2653061224489796	0.28	179	15996	9	6	170	15990	16175	0.17151547691778313
M1	cpdb	0	network_modules	360	TRUE	2.9576995712840483e-11	319	15	10	0.6666666666666666	0.03134796238244514	GO:0006631	GO:BP	fatty acid metabolic process	16175	2343		0.2857142857142857	0.3	319	15856	10	5	309	15851	16175	0.14175694870568178
M1	cpdb	0	network_modules	360	TRUE	5.442074956438787e-11	106	14	8	0.5714285714285714	0.07547169811320754	REAC:R-HSA-156580	REAC	Phase II - Conjugation of compounds	10916	1738		0.3076923076923077	0.35714285714285715	106	10810	8	6	98	10804	10916	0.20527074550135418
M1	cpdb	0	network_modules	360	TRUE	1.0968906750770049e-10	211	13	9	0.6923076923076923	0.04265402843601896	KEGG:05207	KEGG	Chemical carcinogenesis - receptor activation	8484	459		0.7692307692307693	0.7857142857142857	211	8273	9	4	202	8269	8484	0.16789693202044512
M1	cpdb	0	network_modules	360	TRUE	1.3142678978737728e-10	29	15	6	0.4	0.20689655172413793	GO:0042573	GO:BP	retinoic acid metabolic process	16175	10249		0.30612244897959184	0.32	29	16146	6	9	23	16137	16175	0.2867786245447548
M1	cpdb	0	network_modules	360	TRUE	1.8162345700072284e-10	70	15	7	0.4666666666666667	0.1	GO:0001523	GO:BP	retinoid metabolic process	16175	329		0.32653061224489793	0.34	70	16105	7	8	63	16097	16175	0.2145855066487396
M1	cpdb	0	network_modules	360	TRUE	2.0815489124443346e-10	242	15	9	0.6	0.0371900826446281	GO:0008202	GO:BP	steroid metabolic process	16175	3129		0.3469387755102041	0.36	242	15933	9	6	233	15927	16175	0.14682409423522116
M1	cpdb	0	network_modules	360	TRUE	2.0832901299258677e-10	11	15	5	0.3333333333333333	0.45454545454545453	GO:0009812	GO:BP	flavonoid metabolic process	16175	3696		0.3673469387755102	0.38	11	16164	5	10	6	16154	16175	0.3887677902757408
M1	cpdb	0	network_modules	360	TRUE	2.229934773378994e-10	72	15	7	0.4666666666666667	0.09722222222222222	GO:0016101	GO:BP	diterpenoid metabolic process	16175	5119		0.3877551020408163	0.4	72	16103	7	8	65	16095	16175	0.21154071252788786
M1	cpdb	0	network_modules	360	TRUE	3.058528241600222e-10	33	15	6	0.4	0.18181818181818182	GO:0008210	GO:BP	estrogen metabolic process	16175	3137		0.40816326530612246	0.42	33	16142	6	9	27	16133	16175	0.2687031879432813
M1	cpdb	0	network_modules	360	TRUE	6.043868472279445e-10	153	13	8	0.6153846153846154	0.05228758169934641	KEGG:01240	KEGG	Biosynthesis of cofactors	8484	190		0.8461538461538461	0.8571428571428571	153	8331	8	5	145	8326	8484	0.17584906641963455
M1	cpdb	0	network_modules	360	TRUE	3.3229893792733446e-9	5	15	4	0.26666666666666666	0.8	GO:0052696	GO:BP	flavonoid glucuronidation	16175	14153		0.42857142857142855	0.44	5	16170	4	11	1	16159	16175	0.4616302249454567
M1	cpdb	0	network_modules	360	TRUE	7.687748704486978e-9	361	15	9	0.6	0.024930747922437674	GO:0010817	GO:BP	regulation of hormone levels	16175	4429		0.4489795918367347	0.46	361	15814	9	6	352	15808	16175	0.11914705518898434
M1	cpdb	0	network_modules	360	TRUE	9.963543028065622e-9	6	15	4	0.26666666666666666	0.6666666666666666	GO:0016098	GO:BP	monoterpenoid metabolic process	16175	5116		0.46938775510204084	0.48	6	16169	4	11	2	16158	16175	0.42132402804634445
M1	cpdb	0	network_modules	360	TRUE	1.6214092200559484e-8	23	14	5	0.35714285714285715	0.21739130434782608	REAC:R-HSA-211981	REAC	Xenobiotics	10916	2677		0.38461538461538464	0.42857142857142855	23	10893	5	9	18	10884	10916	0.2774655089321353
M1	cpdb	0	network_modules	360	TRUE	2.2463203761251587e-8	65	15	6	0.4	0.09230769230769231	GO:0042440	GO:BP	pigment metabolic process	16175	10180		0.4897959183673469	0.5	65	16110	6	9	59	16101	16175	0.1906951452568246
M1	cpdb	0	network_modules	360	TRUE	2.3235615000010155e-8	7	15	4	0.26666666666666666	0.5714285714285714	GO:0052697	GO:BP	xenobiotic glucuronidation	16175	14154		0.5102040816326531	0.52	7	16168	4	11	3	16157	16175	0.38999175415915
M1	cpdb	0	network_modules	360	TRUE	8.96144071321821e-7	3	15	3	0.2	1	GO:2001030	GO:BP	negative regulation of cellular glucuronidation	16175	26276		0.5306122448979592	0.54	3	16172	3	12	0	16160	16175	0.44704764326633867
M1	cpdb	0	network_modules	360	TRUE	3.1937866815777024e-6	20	15	4	0.26666666666666666	0.2	GO:0042178	GO:BP	xenobiotic catabolic process	16175	10006		0.5510204081632653	0.56	20	16155	4	11	16	16144	16175	0.2301182595134178
M1	cpdb	0	network_modules	360	TRUE	3.5715880040579764e-6	64	14	5	0.35714285714285715	0.078125	REAC:R-HSA-211897	REAC	Cytochrome P450 - arranged by substrate type	10916	423		0.46153846153846156	0.5	64	10852	5	9	59	10843	10916	0.16488565790953247
M1	cpdb	0	network_modules	360	TRUE	3.5825814060783034e-6	4	15	3	0.2	0.75	GO:2001029	GO:BP	regulation of cellular glucuronidation	16175	26275		0.5714285714285714	0.58	4	16171	3	12	1	16159	16175	0.3870467945892449
M1	cpdb	0	network_modules	360	TRUE	1.0538988862205604e-5	6	14	3	0.21428571428571427	0.5	REAC:R-HSA-9027307	REAC	Biosynthesis of maresin-like SPMs	10916	245		0.5384615384615384	0.5714285714285714	6	10910	3	11	3	10899	10916	0.32678661498676614
M1	cpdb	0	network_modules	360	TRUE	1.0709726160366345e-5	28	14	4	0.2857142857142857	0.14285714285714285	REAC:R-HSA-9753281	REAC	Paracetamol ADME	10916	1714		0.6153846153846154	0.6428571428571429	28	10888	4	10	24	10878	10916	0.20060270734246272
M1	cpdb	0	network_modules	360	TRUE	1.557991892719329e-5	29	15	4	0.26666666666666666	0.13793103448275862	GO:0045922	GO:BP	negative regulation of fatty acid metabolic process	16175	11716		0.5918367346938775	0.6	29	16146	4	11	25	16135	16175	0.19075535171938793
M1	cpdb	0	network_modules	360	TRUE	1.789297451922571e-5	6	15	3	0.2	0.5	GO:0009804	GO:BP	coumarin metabolic process	16175	3688		0.6122448979591837	0.64	6	16169	3	12	3	16157	16175	0.3158462977623385
M1	cpdb	0	network_modules	360	TRUE	1.789297451922571e-5	6	15	3	0.2	0.5	GO:0009698	GO:BP	phenylpropanoid metabolic process	16175	3601		0.6122448979591837	0.64	6	16169	3	12	3	16157	16175	0.3158462977623385
M1	cpdb	0	network_modules	360	TRUE	2.9464565484904336e-5	8	14	3	0.21428571428571427	0.375	REAC:R-HSA-9018682	REAC	Biosynthesis of maresins	10916	246		0.6923076923076923	0.7142857142857143	8	10908	3	11	5	10897	10916	0.2827888355778489
M1	cpdb	0	network_modules	360	TRUE	3.081882442816269e-5	99	15	5	0.3333333333333333	0.050505050505050504	GO:0001676	GO:BP	long-chain fatty acid metabolic process	16175	380		0.6530612244897959	0.66	99	16076	5	10	94	16066	16175	0.12781825910839842
M1	cpdb	0	network_modules	360	TRUE	3.991737265144798e-5	103	14	5	0.35714285714285715	0.04854368932038835	REAC:R-HSA-211945	REAC	Phase I - Functionalization of compounds	10916	1737		0.7692307692307693	0.7857142857142857	103	10813	5	9	98	10804	10916	0.12888322179276276
M1	cpdb	0	network_modules	360	TRUE	8.66184679648183e-5	11	14	3	0.21428571428571427	0.2727272727272727	REAC:R-HSA-211999	REAC	CYP2E1 reactions	10916	293		0.8461538461538461	0.8571428571428571	11	10905	3	11	8	10894	10916	0.24088589845447983
M1	cpdb	0	network_modules	360	TRUE	8.832365985733448e-5	44	15	4	0.26666666666666666	0.09090909090909091	GO:0019748	GO:BP	secondary metabolic process	16175	6032		0.673469387755102	0.68	44	16131	4	11	40	16120	16175	0.15439315130996134
M1	cpdb	0	network_modules	360	TRUE	9.688778802643513e-5	45	15	4	0.26666666666666666	0.08888888888888889	GO:0001889	GO:BP	liver development	16175	515		0.6938775510204082	0.7	45	16130	4	11	41	16119	16175	0.15263700604406596
M1	cpdb	0	network_modules	360	TRUE	1.0605738208084092e-4	46	15	4	0.26666666666666666	0.08695652173913043	GO:0061008	GO:BP	hepaticobiliary system development	16175	15132		0.7142857142857143	0.72	46	16129	4	11	42	16118	16175	0.15093810133310476
M1	cpdb	0	network_modules	360	TRUE	1.0711904725386878e-4	10	15	3	0.2	0.3	GO:0070989	GO:BP	oxidative demethylation	16175	16419		0.7346938775510204	0.74	10	16165	3	12	7	16153	16175	0.2443806501153027
M1	cpdb	0	network_modules	360	TRUE	1.1230134234166539e-4	128	15	5	0.3333333333333333	0.0390625	GO:0120254	GO:BP	olefinic compound metabolic process	16175	19583		0.7551020408163265	0.76	128	16047	5	10	123	16037	16175	0.1118951902404182
M1	cpdb	0	network_modules	360	TRUE	2.2057417694512212e-4	55	15	4	0.26666666666666666	0.07272727272727272	GO:0019369	GO:BP	arachidonate metabolic process	16175	5730		0.7755102040816326	0.78	55	16120	4	11	51	16109	16175	0.13778461971517778
M1	cpdb	0	network_modules	360	TRUE	2.9286805157217947e-4	16	14	3	0.21428571428571427	0.1875	REAC:R-HSA-9018677	REAC	Biosynthesis of DHA-derived SPMs	10916	230		0.9230769230769231	0.9285714285714286	16	10900	3	11	13	10889	10916	0.199348790673656
M1	cpdb	0	network_modules	360	TRUE	4.050306783481016e-4	15	15	3	0.2	0.2	GO:0070988	GO:BP	demethylation	16175	16418		0.7959183673469388	0.8	15	16160	3	12	12	16148	16175	0.19925742574257424
M1	cpdb	0	network_modules	360	TRUE	4.2610540616486213e-4	18	14	3	0.21428571428571427	0.16666666666666666	REAC:R-HSA-9018678	REAC	Biosynthesis of specialized proresolving mediators (SPMs)	10916	249		1	1	18	10898	3	11	15	10887	10916	0.1878032679153477
M1	cpdb	0	network_modules	360	TRUE	6.062761457601388e-4	30	13	3	0.23076923076923078	0.1	KEGG:00591	KEGG	Linoleic acid metabolism	8484	93		0.9230769230769231	0.9285714285714286	30	8454	3	10	27	8444	8484	0.14996328993334807
M1	cpdb	0	network_modules	360	TRUE	6.229377169696622e-4	71	15	4	0.26666666666666666	0.056338028169014086	GO:0019217	GO:BP	regulation of fatty acid metabolic process	16175	5594		0.8163265306122449	0.82	71	16104	4	11	67	16093	16175	0.1208742202216575
M1	cpdb	0	network_modules	360	TRUE	7.251724331179435e-4	18	15	3	0.2	0.16666666666666666	GO:0019373	GO:BP	epoxygenase P450 pathway	16175	5734		0.8367346938775511	0.84	18	16157	3	12	15	16145	16175	0.18174371332799277
M1	cpdb	0	network_modules	360	TRUE	0.0010090221406192377	80	15	4	0.26666666666666666	0.05	GO:0045833	GO:BP	negative regulation of lipid metabolic process	16175	11649		0.8571428571428571	0.86	80	16095	4	11	76	16084	16175	0.11366242919042659
M1	cpdb	0	network_modules	360	TRUE	0.0010215289726539852	112	13	4	0.3076923076923077	0.03571428571428571	KEGG:04726	KEGG	Serotonergic synapse	8484	356		1	1	112	8372	4	9	108	8363	8484	0.10107724180305423
M1	cpdb	0	network_modules	360	TRUE	0.0011146548226333034	82	15	4	0.26666666666666666	0.04878048780487805	GO:0062014	GO:BP	negative regulation of small molecule metabolic process	16175	15783		0.8775510204081632	0.88	82	16093	4	11	78	16082	16175	0.1122216781313279
M1	cpdb	0	network_modules	360	TRUE	0.0011148721588836801	2	15	2	0.13333333333333333	1	GO:0006789	GO:BP	bilirubin conjugation	16175	2475		0.8979591836734694	0.9	2	16173	2	13	0	16160	16175	0.36500158742720296
M1	cpdb	0	network_modules	360	TRUE	0.0020360398401146227	25	15	3	0.2	0.12	GO:0042759	GO:BP	long-chain fatty acid biosynthetic process	16175	10351		0.9183673469387755	0.92	25	16150	3	12	22	16138	16175	0.15391243747171574
M1	cpdb	0	network_modules	360	TRUE	0.0022820513135916177	98	15	4	0.26666666666666666	0.04081632653061224	GO:0033559	GO:BP	unsaturated fatty acid metabolic process	16175	8288		0.9387755102040817	0.94	98	16077	4	11	94	16066	16175	0.10231547630348198
M1	cpdb	0	network_modules	360	TRUE	0.0025751602895445376	101	15	4	0.26666666666666666	0.039603960396039604	GO:0010565	GO:BP	regulation of ketone metabolic process	16175	4218		0.9591836734693877	0.96	101	16074	4	11	97	16063	16175	0.10072215593902667
M1	cpdb	0	network_modules	360	TRUE	0.003342824188508391	3	15	2	0.13333333333333333	0.6666666666666666	GO:0009822	GO:BP	alkaloid catabolic process	16175	3701		0.9795918367346939	0.98	3	16172	2	13	1	16159	16175	0.29789344298100395
M1	cpdb	0	network_modules	360	TRUE	0.0033671678775662075	108	15	4	0.26666666666666666	0.037037037037037035	GO:0006690	GO:BP	icosanoid metabolic process	16175	2398		1	1	108	16067	4	11	104	16056	16175	0.09726265094603517
M1	cpdb	0	network_modules	361	TRUE	1.2096609998023525e-9	14	16	5	0.3125	0.35714285714285715	GO:0046520	GO:BP	sphingoid biosynthetic process	16175	12218		0	0.08695652173913043	14	16161	5	11	9	16150	16175	0.3334604960202476
M1	cpdb	0	network_modules	361	TRUE	1.2096609998023525e-9	14	16	5	0.3125	0.35714285714285715	GO:0046512	GO:BP	sphingosine biosynthetic process	16175	12211		0	0.08695652173913043	14	16161	5	11	9	16150	16175	0.3334604960202476
M1	cpdb	0	network_modules	361	TRUE	7.006042828943609e-9	19	16	5	0.3125	0.2631578947368421	GO:0034312	GO:BP	diol biosynthetic process	16175	8566		0.09090909090909091	0.13043478260869565	19	16156	5	11	14	16145	16175	0.28600116313381974
M1	cpdb	0	network_modules	361	TRUE	9.336092137848998e-9	20	16	5	0.3125	0.25	GO:0006670	GO:BP	sphingosine metabolic process	16175	2379		0.13636363636363635	0.17391304347826086	20	16155	5	11	15	16144	16175	0.2787127209684931
M1	cpdb	0	network_modules	361	TRUE	1.5839642766120886e-8	22	16	5	0.3125	0.22727272727272727	GO:0046519	GO:BP	sphingoid metabolic process	16175	12217		0.18181818181818182	0.21739130434782608	22	16153	5	11	17	16142	16175	0.2656530326051736
M1	cpdb	0	network_modules	361	TRUE	3.625594779861988e-8	32	12	5	0.4166666666666667	0.15625	REAC:R-HSA-1660661	REAC	Sphingolipid de novo biosynthesis	10916	2348		0	0.2	32	10884	5	7	27	10877	10916	0.25387178345314304
M1	cpdb	0	network_modules	361	TRUE	4.842072640043791e-8	27	16	5	0.3125	0.18518518518518517	GO:0034311	GO:BP	diol metabolic process	16175	8565		0.22727272727272727	0.2608695652173913	27	16148	5	11	22	16137	16175	0.23959611640672476
M1	cpdb	0	network_modules	361	TRUE	9.096479767837352e-7	47	16	5	0.3125	0.10638297872340426	GO:0046173	GO:BP	polyol biosynthetic process	16175	11943		0.2727272727272727	0.30434782608695654	47	16128	5	11	42	16117	16175	0.18098841795120132
M1	cpdb	0	network_modules	361	TRUE	2.5296712646569364e-6	132	16	6	0.375	0.045454545454545456	GO:0007601	GO:BP	visual perception	16175	3060		0.3181818181818182	0.34782608695652173	132	16043	6	10	126	16033	16175	0.128304854737121
M1	cpdb	0	network_modules	361	TRUE	3.4565516248302595e-6	139	16	6	0.375	0.04316546762589928	GO:0050953	GO:BP	sensory perception of light stimulus	16175	13395		0.36363636363636365	0.391304347826087	139	16036	6	10	133	16026	16175	0.12491217647521033
M1	cpdb	0	network_modules	361	TRUE	4.130492957045695e-6	63	16	5	0.3125	0.07936507936507936	GO:0046513	GO:BP	ceramide biosynthetic process	16175	12212		0.4090909090909091	0.43478260869565216	63	16112	5	11	58	16101	16175	0.15590323913782483
M1	cpdb	0	network_modules	361	TRUE	7.247951477003657e-6	89	12	5	0.4166666666666667	0.056179775280898875	REAC:R-HSA-428157	REAC	Sphingolipid metabolism	10916	2349		0.25	0.4	89	10827	5	7	84	10820	10916	0.1507018441338485
M1	cpdb	0	network_modules	361	TRUE	1.316177786071357e-5	120	11	5	0.45454545454545453	0.041666666666666664	KEGG:04071	KEGG	Sphingolipid signaling pathway	8484	260		0	0.3333333333333333	120	8364	5	6	115	8358	8484	0.1343783304478209
M1	cpdb	0	network_modules	361	TRUE	1.6869141894057235e-5	83	16	5	0.3125	0.060240963855421686	GO:0019751	GO:BP	polyol metabolic process	16175	6035		0.45454545454545453	0.4782608695652174	83	16092	5	11	78	16081	16175	0.13536691003488857
M1	cpdb	0	network_modules	361	TRUE	3.5251778689988655e-5	96	16	5	0.3125	0.052083333333333336	GO:0006672	GO:BP	ceramide metabolic process	16175	2381		0.5	0.5217391304347826	96	16079	5	11	91	16068	16175	0.12558979638687456
M1	cpdb	0	network_modules	361	TRUE	4.117883963364177e-5	99	16	5	0.3125	0.050505050505050504	GO:0030148	GO:BP	sphingolipid biosynthetic process	16175	6682		0.5454545454545454	0.5652173913043478	99	16076	5	11	94	16065	16175	0.12360899267436655
M1	cpdb	0	network_modules	361	TRUE	4.9601805843328286e-5	11	12	3	0.25	0.2727272727272727	REAC:R-HSA-2485179	REAC	Activation of the phototransduction cascade	10916	106		0.5	0.6	11	10905	3	9	8	10896	10916	0.2603382471740858
M1	cpdb	0	network_modules	361	TRUE	7.00261140199362e-5	110	16	5	0.3125	0.045454545454545456	GO:0046165	GO:BP	alcohol biosynthetic process	16175	11935		0.5909090909090909	0.6086956521739131	110	16065	5	11	105	16054	16175	0.11704554632299653
M1	cpdb	0	network_modules	361	TRUE	1.6191930676782957e-4	130	16	5	0.3125	0.038461538461538464	GO:0046467	GO:BP	membrane lipid biosynthetic process	16175	12175		0.6363636363636364	0.6521739130434783	130	16045	5	11	125	16034	16175	0.10729757116278694
M1	cpdb	0	network_modules	361	TRUE	2.430082614676413e-4	141	16	5	0.3125	0.03546099290780142	GO:0006665	GO:BP	sphingolipid metabolic process	16175	2374		0.6818181818181818	0.6956521739130435	141	16034	5	11	136	16023	16175	0.10283235638977825
M1	cpdb	0	network_modules	361	TRUE	2.60705838939711e-4	143	16	5	0.3125	0.03496503496503497	GO:0043604	GO:BP	amide biosynthetic process	16175	10796		0.7272727272727273	0.7391304347826086	143	16032	5	11	138	16021	16175	0.102075521546842
M1	cpdb	0	network_modules	361	TRUE	3.406210725225762e-4	29	11	3	0.2727272727272727	0.10344827586206896	KEGG:04744	KEGG	Phototransduction	8484	362		0.5	0.6666666666666666	29	8455	3	8	26	8447	8484	0.16625456560833596
M1	cpdb	0	network_modules	361	TRUE	8.173210056986539e-4	97	12	4	0.3333333333333333	0.041237113402061855	REAC:R-HSA-2187338	REAC	Visual phototransduction	10916	2654		0.75	0.8	97	10819	4	8	93	10811	10916	0.11469010704487782
M1	cpdb	0	network_modules	361	TRUE	8.185245659626064e-4	180	16	5	0.3125	0.027777777777777776	GO:0006643	GO:BP	membrane lipid metabolic process	16175	2354		0.7727272727272727	0.782608695652174	180	15995	5	11	175	15984	16175	0.09040056729740181
M1	cpdb	0	network_modules	361	TRUE	0.0010696682901933773	190	16	5	0.3125	0.02631578947368421	GO:1901617	GO:BP	organic hydroxy compound biosynthetic process	16175	21599		0.8181818181818182	0.8260869565217391	190	15985	5	11	185	15974	16175	0.08783640998735463
M1	cpdb	0	network_modules	361	TRUE	0.0013346460423407458	31	12	3	0.25	0.0967741935483871	REAC:R-HSA-2514856	REAC	The phototransduction cascade	10916	2501		1	1	31	10885	3	9	28	10876	10916	0.15407940168216502
M1	cpdb	0	network_modules	361	TRUE	0.002271575016075114	54	11	3	0.2727272727272727	0.05555555555555555	KEGG:00600	KEGG	Sphingolipid metabolism	8484	95		1	1	54	8430	3	8	51	8422	8484	0.12068146418531805
M1	cpdb	0	network_modules	361	TRUE	0.004726685560451098	257	16	5	0.3125	0.019455252918287938	GO:0006066	GO:BP	alcohol metabolic process	16175	1933		0.8636363636363636	0.8695652173913043	257	15918	5	11	252	15907	16175	0.07464038924265136
M1	cpdb	0	network_modules	361	TRUE	0.007048630844640989	4	16	2	0.125	0.5	GO:1904502	GO:BP	regulation of lipophagy	16175	23864		0.9090909090909091	0.9565217391304348	4	16171	2	14	2	16157	16175	0.24965977593568692
M1	cpdb	0	network_modules	361	TRUE	0.007048630844640989	4	16	2	0.125	0.5	GO:1904504	GO:BP	positive regulation of lipophagy	16175	23866		0.9090909090909091	0.9565217391304348	4	16171	2	14	2	16157	16175	0.24965977593568692
M1	cpdb	0	network_modules	361	TRUE	0.009232943238055529	529	16	6	0.375	0.011342155009451797	GO:0007600	GO:BP	sensory perception	16175	3059		1	1	529	15646	6	10	523	15636	16175	0.060557559042677414
M1	cpdb	0	network_modules	364	TRUE	3.1301001970289675e-8	9	12	4	0.3333333333333333	0.4444444444444444	REAC:R-HSA-1296052	REAC	Ca2+ activated K+ channels	10916	295		0	0.16666666666666666	9	10907	4	8	5	10899	10916	0.3843178298824492
M1	cpdb	0	network_modules	364	TRUE	3.379021797956746e-7	15	12	4	0.3333333333333333	0.26666666666666666	REAC:R-HSA-418457	REAC	cGMP effects	10916	2691		0.2	0.3333333333333333	15	10901	4	8	11	10893	10916	0.29728099320911083
M1	cpdb	0	network_modules	364	TRUE	1.476361352067567e-6	21	12	4	0.3333333333333333	0.19047619047619047	REAC:R-HSA-392154	REAC	Nitric oxide stimulates guanylate cyclase	10916	1601		0.4	0.5	21	10895	4	8	17	10887	10916	0.25090134258013275
M1	cpdb	0	network_modules	364	TRUE	1.9780114985025418e-5	198	15	6	0.4	0.030303030303030304	GO:0006813	GO:BP	potassium ion transport	16175	2493		0	0.16666666666666666	198	15977	6	9	192	15968	16175	0.10743623692080036
M1	cpdb	0	network_modules	364	TRUE	3.2420499281561084e-4	14	15	3	0.2	0.21428571428571427	GO:0005513	GO:BP	detection of calcium ion	16175	1849		0.2	0.3333333333333333	14	16161	3	12	11	16149	16175	0.20630870032228973
M1	cpdb	0	network_modules	364	TRUE	4.810161195793127e-4	85	12	4	0.3333333333333333	0.047058823529411764	REAC:R-HSA-418346	REAC	Platelet homeostasis	10916	1765		0.6	0.6666666666666666	85	10831	4	8	81	10823	10916	0.1228656972205064
M1	cpdb	0	network_modules	364	TRUE	6.913591612898055e-4	133	10	4	0.4	0.03007518796992481	KEGG:04270	KEGG	Vascular smooth muscle contraction	8484	298		0	0.5	133	8351	4	6	129	8345	8484	0.10628163627953321
M1	cpdb	0	network_modules	364	TRUE	0.0010392515278206864	103	12	4	0.3333333333333333	0.038834951456310676	REAC:R-HSA-1296071	REAC	Potassium Channels	10916	1780		0.8	0.8333333333333334	103	10813	4	8	99	10805	10916	0.11114176820544837
M1	cpdb	0	network_modules	364	TRUE	0.0014154122406353673	213	15	5	0.3333333333333333	0.023474178403755867	GO:0010038	GO:BP	response to metal ion	16175	3847		0.4	0.5	213	15962	5	10	208	15952	16175	0.08556762031907132
M1	cpdb	0	network_modules	364	TRUE	0.0014534737304272806	677	15	7	0.4666666666666667	0.0103397341211226	GO:0030001	GO:BP	metal ion transport	16175	6646		0.6	0.6666666666666666	677	15498	7	8	670	15490	16175	0.06462994787795785
M1	cpdb	0	network_modules	364	TRUE	0.0028383531370630988	748	15	7	0.4666666666666667	0.009358288770053475	GO:0006812	GO:BP	monoatomic cation transport	16175	2492		0.8	0.8333333333333334	748	15427	7	8	741	15419	16175	0.0609906994229822
M1	cpdb	0	network_modules	364	TRUE	0.003291177469690408	5	12	2	0.16666666666666666	0.4	REAC:R-HSA-9667769	REAC	Acetylcholine inhibits contraction of outer hair cells	10916	55		1	1	5	10911	2	10	3	10901	10916	0.2576899618144285
M1	cpdb	0	network_modules	364	TRUE	0.003623385737065919	110	15	4	0.26666666666666666	0.03636363636363636	GO:0051592	GO:BP	response to calcium ion	16175	13809		1	1	110	16065	4	11	106	16054	16175	0.09633455057733428
M1	cpdb	0	network_modules	364	TRUE	0.006792388208783714	85	10	3	0.3	0.03529411764705882	KEGG:04911	KEGG	Insulin secretion	8484	368		1	1	85	8399	3	7	82	8392	8484	0.1000237035112913
M1	cpdb	0	network_modules	365	TRUE	1.8014104719016845e-4	86	11	4	0.36363636363636365	0.046511627906976744	KEGG:04610	KEGG	Complement and coagulation cascades	8484	320		0	0.5	86	8398	4	7	82	8391	8484	0.12715405336367297
M1	cpdb	0	network_modules	365	TRUE	1.8359469679261236e-4	14	13	3	0.23076923076923078	0.21428571428571427	GO:0045916	GO:BP	negative regulation of complement activation	16175	11710		0	0.16666666666666666	14	16161	3	10	11	16151	16175	0.22172580349903687
M1	cpdb	0	network_modules	365	TRUE	2.3608478677863425e-4	92	11	4	0.36363636363636365	0.043478260869565216	KEGG:04640	KEGG	Hematopoietic cell lineage	8484	333		1	1	92	8392	4	7	88	8385	8484	0.12273572602860489
M1	cpdb	0	network_modules	365	TRUE	2.821914009965001e-4	16	13	3	0.23076923076923078	0.1875	GO:0002921	GO:BP	negative regulation of humoral immune response	16175	1431		0.2	0.3333333333333333	16	16159	3	10	13	16149	16175	0.20730677807359252
M1	cpdb	0	network_modules	365	TRUE	4.8761268824471437e-4	19	13	3	0.23076923076923078	0.15789473684210525	GO:0030449	GO:BP	regulation of complement activation	16175	6807		0.4	0.5	19	16156	3	10	16	16146	16175	0.19010183994272611
M1	cpdb	0	network_modules	365	TRUE	0.0024809207458409864	32	13	3	0.23076923076923078	0.09375	GO:0002920	GO:BP	regulation of humoral immune response	16175	1430		0.6	0.6666666666666666	32	16143	3	10	29	16133	16175	0.14602929542180088
M1	cpdb	0	network_modules	365	TRUE	0.0027277465238705304	33	13	3	0.23076923076923078	0.09090909090909091	GO:0045494	GO:BP	photoreceptor cell maintenance	16175	11413		0.8	0.8333333333333334	33	16142	3	10	30	16132	16175	0.1437653050225394
M1	cpdb	0	network_modules	365	TRUE	0.0057155402409709045	42	13	3	0.23076923076923078	0.07142857142857142	GO:0001895	GO:BP	retina homeostasis	16175	520		1	1	42	16133	3	10	39	16123	16175	0.127159775498747
M1	cpdb	0	network_modules	367	TRUE	3.6597627100132995e-4	2	10	2	0.2	1	GO:1905551	GO:BP	negative regulation of protein localization to endoplasmic reticulum	16175	24719		0	0.5	2	16173	2	8	0	16165	16175	0.4471029743627762
M1	cpdb	0	network_modules	367	TRUE	0.00365614327046356	5	10	2	0.2	0.4	GO:1905550	GO:BP	regulation of protein localization to endoplasmic reticulum	16175	24718		1	1	5	16170	2	8	3	16162	16175	0.28253656168710733
M1	cpdb	0	network_modules	368	TRUE	7.738688763867622e-4	22	13	3	0.23076923076923078	0.13636363636363635	GO:0045880	GO:BP	positive regulation of smoothened signaling pathway	16175	11684		NA	1	22	16153	3	10	19	16143	16175	0.17653919094160347
M1	cpdb	0	network_modules	371	TRUE	0.0031764891873583357	6	10	2	0.2	0.3333333333333333	REAC:R-HSA-6793080	REAC	rRNA modification in the mitochondrion	10916	2730		0	0.5	6	10910	2	8	4	10902	10916	0.2576781409088113
M1	cpdb	0	network_modules	371	TRUE	0.009510853417146718	10	10	2	0.2	0.2	REAC:R-HSA-8868766	REAC	rRNA processing in the mitochondrion	10916	2733		1	1	10	10906	2	8	8	10898	10916	0.19926645883000182
M1	cpdb	0	network_modules	373	TRUE	8.918977271069437e-4	2	14	2	0.14285714285714285	1	GO:0099044	GO:BP	vesicle tethering to endoplasmic reticulum	16175	19017		NA	1	2	16173	2	12	0	16161	16175	0.377824226446696
M1	cpdb	0	network_modules	373	TRUE	0.0016764303207580484	5	9	2	0.2222222222222222	0.4	REAC:R-HSA-390648	REAC	Muscarinic acetylcholine receptors	10916	1495		NA	1	5	10911	2	7	3	10904	10916	0.2977187878175293
M1	cpdb	0	network_modules	374	TRUE	8.796765816453279e-24	13	14	9	0.6428571428571429	0.6923076923076923	GO:0001682	GO:BP	tRNA 5'-leader removal	16175	384		0	0.2	13	16162	9	5	4	16157	16175	0.6668469012708245
M1	cpdb	0	network_modules	374	TRUE	6.154307565190586e-23	15	14	9	0.6428571428571429	0.6	GO:0099116	GO:BP	tRNA 5'-end processing	16175	19047		0.25	0.4	15	16160	9	5	6	16155	16175	0.6207195326989474
M1	cpdb	0	network_modules	374	TRUE	8.633870710035436e-19	35	14	9	0.6428571428571429	0.2571428571428571	GO:0000966	GO:BP	RNA 5'-end processing	16175	274		0.5	0.6	35	16140	9	5	26	16135	16175	0.40582480974673574
M1	cpdb	0	network_modules	374	TRUE	1.1781120941304432e-14	55	11	8	0.7272727272727273	0.14545454545454545	REAC:R-HSA-6784531	REAC	tRNA processing in the nucleus	10916	2745		0	0.2	55	10861	8	3	47	10858	10916	0.32397303456575194
M1	cpdb	0	network_modules	374	TRUE	1.2486205747194714e-13	120	14	9	0.6428571428571429	0.075	GO:0008033	GO:BP	tRNA processing	16175	3098		0.75	0.8	120	16055	9	5	111	16050	16175	0.21794745023597903
M1	cpdb	0	network_modules	374	TRUE	2.3702433083010336e-13	139	8	8	1	0.05755395683453238	KEGG:03008	KEGG	Ribosome biogenesis in eukaryotes	8484	207		NA	1	139	8345	8	0	131	8345	8484	0.23804293144111893
M1	cpdb	0	network_modules	374	TRUE	2.273583415641016e-12	103	11	8	0.7272727272727273	0.07766990291262135	REAC:R-HSA-72306	REAC	tRNA processing	10916	2743		0.25	0.4	103	10813	8	3	95	10810	10916	0.23582029733573337
M1	cpdb	0	network_modules	374	TRUE	7.071064388491269e-12	186	14	9	0.6428571428571429	0.04838709677419355	GO:0006399	GO:BP	tRNA metabolic process	16175	2160		1	1	186	15989	9	5	177	15984	16175	0.17429410495960482
M1	cpdb	0	network_modules	374	TRUE	1.536961212507245e-4	182	11	5	0.45454545454545453	0.027472527472527472	REAC:R-HSA-6791226	REAC	Major pathway of rRNA processing in the nucleolus and cytosol	10916	1389		0.5	0.6	182	10734	5	6	177	10728	10916	0.10861214608423464
M1	cpdb	0	network_modules	374	TRUE	2.0047525826668794e-4	192	11	5	0.45454545454545453	0.026041666666666668	REAC:R-HSA-8868773	REAC	rRNA processing in the nucleus and cytosol	10916	2734		0.75	0.8	192	10724	5	6	187	10718	10916	0.10557383928192297
M1	cpdb	0	network_modules	374	TRUE	2.578890011069347e-4	202	11	5	0.45454545454545453	0.024752475247524754	REAC:R-HSA-72312	REAC	rRNA processing	10916	2732		1	1	202	10714	5	6	197	10708	10916	0.10275959063576609
M1	cpdb	0	network_modules	379	TRUE	6.413055620265931e-5	11	12	3	0.25	0.2727272727272727	GO:0006825	GO:BP	copper ion transport	16175	2500		0	0.16666666666666666	11	16164	3	9	8	16155	16175	0.2605914563273623
M1	cpdb	0	network_modules	379	TRUE	9.427775002358522e-5	96	8	4	0.5	0.041666666666666664	REAC:R-HSA-6803157	REAC	Antimicrobial peptides	10916	156		0	0.5	96	10820	4	4	92	10816	10916	0.14247871565112583
M1	cpdb	0	network_modules	379	TRUE	1.1106683966943732e-4	13	12	3	0.25	0.23076923076923078	GO:0006878	GO:BP	intracellular copper ion homeostasis	16175	2534		0.2	0.3333333333333333	13	16162	3	9	10	16153	16175	0.23960521810067908
M1	cpdb	0	network_modules	379	TRUE	2.1720126862305163e-4	16	12	3	0.25	0.1875	GO:0055070	GO:BP	copper ion homeostasis	16175	14228		0.4	0.5	16	16159	3	9	13	16150	16175	0.2158365105379345
M1	cpdb	0	network_modules	379	TRUE	6.30699107025625e-4	2	12	2	0.16666666666666666	1	GO:0060003	GO:BP	copper ion export	16175	14266		0.6	0.6666666666666666	2	16173	2	10	0	16163	16175	0.40812205803437007
M1	cpdb	0	network_modules	379	TRUE	6.940768756872857e-4	4	8	2	0.25	0.5	REAC:R-HSA-6803544	REAC	Ion influx/efflux at host-pathogen interface	10916	1274		1	1	4	10912	2	6	2	10906	10916	0.35322933292575615
M1	cpdb	0	network_modules	379	TRUE	0.0010260058841696342	60	8	3	0.375	0.05	KEGG:04978	KEGG	Mineral absorption	8484	409		NA	1	60	8424	3	5	57	8419	8484	0.13488947192424833
M1	cpdb	0	network_modules	379	TRUE	0.0018913173803027153	3	12	2	0.16666666666666666	0.6666666666666666	GO:0035434	GO:BP	copper ion transmembrane transport	16175	9033		0.8	0.8333333333333334	3	16172	2	10	1	16162	16175	0.33311686255037765
M1	cpdb	0	network_modules	379	TRUE	0.003781075530133068	4	12	2	0.16666666666666666	0.5	GO:0019388	GO:BP	galactose catabolic process	16175	5748		1	1	4	16171	2	10	2	16161	16175	0.2883894502100615
M1	cpdb	0	network_modules	381	TRUE	4.99505561920302e-5	48	14	4	0.2857142857142857	0.08333333333333333	KEGG:00280	KEGG	Valine, leucine and isoleucine degradation	8484	31		0	0.2	48	8436	4	10	44	8426	8484	0.15180282187201677
M1	cpdb	0	network_modules	381	TRUE	4.5635183165919694e-4	83	14	4	0.2857142857142857	0.04819277108433735	KEGG:04146	KEGG	Peroxisome	8484	282		0.25	0.4	83	8401	4	10	79	8391	8484	0.11397751600052407
M1	cpdb	0	network_modules	381	TRUE	0.0017947102457131316	211	16	5	0.3125	0.023696682464454975	GO:0046395	GO:BP	carboxylic acid catabolic process	16175	12121		0	0.6666666666666666	211	15964	5	11	206	15953	16175	0.08304562915422639
M1	cpdb	0	network_modules	381	TRUE	0.0017947102457131316	211	16	5	0.3125	0.023696682464454975	GO:0016054	GO:BP	organic acid catabolic process	16175	5086		0	0.6666666666666666	211	15964	5	11	206	15953	16175	0.08304562915422639
M1	cpdb	0	network_modules	381	TRUE	0.002449001606498958	43	14	3	0.21428571428571427	0.06976744186046512	KEGG:00071	KEGG	Fatty acid degradation	8484	11		0.5	0.6	43	8441	3	11	40	8430	8484	0.11978142960694002
M1	cpdb	0	network_modules	381	TRUE	0.005099790796476949	153	14	4	0.2857142857142857	0.026143790849673203	KEGG:01240	KEGG	Biosynthesis of cofactors	8484	190		0.75	0.8	153	8331	4	10	149	8321	8484	0.08177963431763084
M1	cpdb	0	network_modules	381	TRUE	0.005727798340945601	57	14	3	0.21428571428571427	0.05263157894736842	KEGG:01212	KEGG	Fatty acid metabolism	8484	186		1	1	57	8427	3	11	54	8416	8484	0.10330176546723593
M1	cpdb	0	network_modules	381	TRUE	0.006125479838998919	271	16	5	0.3125	0.01845018450184502	GO:0044248	GO:BP	cellular catabolic process	16175	10939		1	1	271	15904	5	11	266	15893	16175	0.0725066304613646
M1	cpdb	0	network_modules	381	TRUE	0.008746616493732132	158	13	4	0.3076923076923077	0.02531645569620253	REAC:R-HSA-9609507	REAC	Protein localization	10916	1815		NA	1	158	10758	4	9	154	10749	10916	0.08477322791866171
M1	cpdb	0	network_modules	382	TRUE	1.779199090926017e-5	96	14	5	0.35714285714285715	0.052083333333333336	KEGG:04666	KEGG	Fc gamma R-mediated phagocytosis	8484	341		0	0.2	96	8388	5	9	91	8379	8484	0.13292834410732707
M1	cpdb	0	network_modules	382	TRUE	1.973229503486384e-5	98	14	5	0.35714285714285715	0.05102040816326531	KEGG:05231	KEGG	Choline metabolism in cancer	8484	479		0.25	0.4	98	8386	5	9	93	8377	8484	0.1314909344598572
M1	cpdb	0	network_modules	382	TRUE	1.4852334495478583e-4	147	14	5	0.35714285714285715	0.034013605442176874	KEGG:04072	KEGG	Phospholipase D signaling pathway	8484	261		0.5	0.6	147	8337	5	9	142	8328	8484	0.10587742901616028
M1	cpdb	0	network_modules	382	TRUE	9.374573056887324e-4	185	16	5	0.3125	0.02702702702702703	GO:0006909	GO:BP	phagocytosis	16175	2559		0	0.14285714285714285	185	15990	5	11	180	15979	16175	0.08909303366148665
M1	cpdb	0	network_modules	382	TRUE	0.0015170346636575452	27	14	3	0.21428571428571427	0.1111111111111111	REAC:R-HSA-5218920	REAC	VEGFR2 mediated vascular permeability	10916	2636		0	0.25	27	10889	3	11	24	10878	10916	0.1528092737707221
M1	cpdb	0	network_modules	382	TRUE	0.0015196827231620273	204	16	5	0.3125	0.024509803921568627	GO:0051896	GO:BP	regulation of phosphatidylinositol 3-kinase/protein kinase B signal transduction	16175	13980		0.16666666666666666	0.2857142857142857	204	15971	5	11	199	15960	16175	0.08456193435466465
M1	cpdb	0	network_modules	382	TRUE	0.0018688395580364928	99	14	4	0.2857142857142857	0.04040404040404041	REAC:R-HSA-199418	REAC	Negative regulation of the PI3K/AKT network	10916	1580		0.3333333333333333	0.5	99	10817	4	10	95	10807	10916	0.10457462492437757
M1	cpdb	0	network_modules	382	TRUE	0.0019068404857137974	248	14	5	0.35714285714285715	0.020161290322580645	KEGG:04144	KEGG	Endocytosis	8484	280		0.75	0.8	248	8236	5	9	243	8227	8484	0.07913988756877009
M1	cpdb	0	network_modules	382	TRUE	0.0030485587387011396	235	16	5	0.3125	0.02127659574468085	GO:0043491	GO:BP	phosphatidylinositol 3-kinase/protein kinase B signal transduction	16175	10736		0.3333333333333333	0.42857142857142855	235	15940	5	11	230	15929	16175	0.07835984016247838
M1	cpdb	0	network_modules	382	TRUE	0.00321961216636867	136	14	4	0.2857142857142857	0.029411764705882353	KEGG:05135	KEGG	Yersinia infection	8484	432		1	1	136	8348	4	10	132	8338	8484	0.08730068641241687
M1	cpdb	0	network_modules	382	TRUE	0.0033379205058592606	449	14	6	0.42857142857142855	0.013363028953229399	REAC:R-HSA-9012999	REAC	RHO GTPase cycle	10916	1847		0.6666666666666666	0.75	449	10467	6	8	443	10459	10916	0.06991070340760051
M1	cpdb	0	network_modules	382	TRUE	0.0040667353911232025	30	16	3	0.1875	0.1	GO:0002431	GO:BP	Fc receptor mediated stimulatory signaling pathway	16175	954		0.5	0.5714285714285714	30	16145	3	13	27	16132	16175	0.1357692171589587
M1	cpdb	0	network_modules	382	TRUE	0.005490955490164928	265	16	5	0.3125	0.018867924528301886	GO:0002429	GO:BP	immune response-activating cell surface receptor signaling pathway	16175	952		0.6666666666666666	0.7142857142857143	265	15910	5	11	260	15899	16175	0.07340098756911871
M1	cpdb	0	network_modules	382	TRUE	0.0066891375406479625	507	14	6	0.42857142857142855	0.011834319526627219	REAC:R-HSA-9006934	REAC	Signaling by Receptor Tyrosine Kinases	10916	2302		1	1	507	10409	6	8	501	10401	10916	0.06506873791170388
M1	cpdb	0	network_modules	382	TRUE	0.008102637962305745	287	16	5	0.3125	0.017421602787456445	GO:0002768	GO:BP	immune response-regulating cell surface receptor signaling pathway	16175	1279		0.8333333333333334	0.8571428571428571	287	15888	5	11	282	15877	16175	0.07025625055190057
M1	cpdb	0	network_modules	382	TRUE	0.00964096021214287	533	16	6	0.375	0.01125703564727955	GO:0034330	GO:BP	cell junction organization	16175	8572		1	1	533	15642	6	10	527	15632	16175	0.060294019962829216
M1	cpdb	0	network_modules	384	TRUE	1.9043839254368367e-5	19	6	3	0.5	0.15789473684210525	REAC:R-HSA-77595	REAC	Processing of Intronless Pre-mRNAs	10916	1799		0	0.25	19	10897	3	3	16	10894	10916	0.28031867571142527
M1	cpdb	0	network_modules	384	TRUE	2.5489226042249184e-5	96	7	4	0.5714285714285714	0.041666666666666664	KEGG:03015	KEGG	mRNA surveillance pathway	8484	210		NA	1	96	8388	4	3	92	8385	8484	0.15217367640636337
M1	cpdb	0	network_modules	384	TRUE	6.426399328551993e-5	28	6	3	0.5	0.10714285714285714	REAC:R-HSA-75067	REAC	Processing of Capped Intronless Pre-mRNA	10916	1797		0.3333333333333333	0.5	28	10888	3	3	25	10885	10916	0.23062692458807935
M1	cpdb	0	network_modules	384	TRUE	5.406346414699237e-4	56	6	3	0.5	0.05357142857142857	REAC:R-HSA-72187	REAC	mRNA 3'-end processing	10916	2701		0.6666666666666666	0.75	56	10860	3	3	53	10857	10916	0.16244595574526155
M1	cpdb	0	network_modules	384	TRUE	8.503242733606294e-4	65	6	3	0.5	0.046153846153846156	REAC:R-HSA-73856	REAC	RNA Polymerase II Transcription Termination	10916	1895		1	1	65	10851	3	3	62	10848	10916	0.15059207245841444
M1	cpdb	0	network_modules	387	TRUE	8.080010545132378e-6	39	10	4	0.4	0.10256410256410256	REAC:R-HSA-420499	REAC	Class C/3 (Metabotropic glutamate/pheromone receptors)	10916	367		NA	1	39	10877	4	6	35	10871	10916	0.2011904797736557
M1	cpdb	0	network_modules	388	TRUE	1.4474482568941577e-18	18	14	8	0.5714285714285714	0.4444444444444444	GO:0051923	GO:BP	sulfation	16175	13996		0	0.037037037037037035	18	16157	8	6	10	16151	16175	0.5034692342150103
M1	cpdb	0	network_modules	388	TRUE	9.99716878557277e-13	23	9	6	0.6666666666666666	0.2608695652173913	REAC:R-HSA-156584	REAC	Cytosolic sulfonation of small molecules	10916	429		0	0.25	23	10893	6	3	17	10890	10916	0.4163211127423718
M1	cpdb	0	network_modules	388	TRUE	1.2354118762053637e-12	16	14	6	0.42857142857142855	0.375	GO:0050427	GO:BP	3'-phosphoadenosine 5'-phosphosulfate metabolic process	16175	13184		0.038461538461538464	0.2222222222222222	16	16159	6	8	10	16151	16175	0.4003378257883534
M1	cpdb	0	network_modules	388	TRUE	1.2354118762053637e-12	16	14	6	0.42857142857142855	0.375	GO:0034035	GO:BP	purine ribonucleoside bisphosphate metabolic process	16175	8379		0.038461538461538464	0.2222222222222222	16	16159	6	8	10	16151	16175	0.4003378257883534
M1	cpdb	0	network_modules	388	TRUE	1.2354118762053637e-12	16	14	6	0.42857142857142855	0.375	GO:0034032	GO:BP	purine nucleoside bisphosphate metabolic process	16175	8376		0.038461538461538464	0.2222222222222222	16	16159	6	8	10	16151	16175	0.4003378257883534
M1	cpdb	0	network_modules	388	TRUE	1.2354118762053637e-12	16	14	6	0.42857142857142855	0.375	GO:0033875	GO:BP	ribonucleoside bisphosphate metabolic process	16175	8366		0.038461538461538464	0.2222222222222222	16	16159	6	8	10	16151	16175	0.4003378257883534
M1	cpdb	0	network_modules	388	TRUE	1.2354118762053637e-12	16	14	6	0.42857142857142855	0.375	GO:0033865	GO:BP	nucleoside bisphosphate metabolic process	16175	8363		0.038461538461538464	0.2222222222222222	16	16159	6	8	10	16151	16175	0.4003378257883534
M1	cpdb	0	network_modules	388	TRUE	1.573105976594096e-8	7	14	4	0.2857142857142857	0.5714285714285714	GO:0006068	GO:BP	ethanol catabolic process	16175	1935		0.23076923076923078	0.2962962962962963	7	16168	4	10	3	16158	16175	0.40371107187287486
M1	cpdb	0	network_modules	388	TRUE	1.573105976594096e-8	7	14	4	0.2857142857142857	0.5714285714285714	GO:0006067	GO:BP	ethanol metabolic process	16175	1934		0.23076923076923078	0.2962962962962963	7	16168	4	10	3	16158	16175	0.40371107187287486
M1	cpdb	0	network_modules	388	TRUE	1.6565484443691358e-8	106	9	6	0.6666666666666666	0.05660377358490566	REAC:R-HSA-156580	REAC	Phase II - Conjugation of compounds	10916	1738		0.3333333333333333	0.5	106	10810	6	3	100	10807	10916	0.1924432701233329
M1	cpdb	0	network_modules	388	TRUE	3.3085432896148365e-8	289	14	8	0.5714285714285714	0.02768166089965398	GO:0006790	GO:BP	sulfur compound metabolic process	16175	2476		0.3076923076923077	0.3333333333333333	289	15886	8	6	281	15880	16175	0.12299398227411956
M1	cpdb	0	network_modules	388	TRUE	9.424632817904656e-8	10	14	4	0.2857142857142857	0.4	GO:0034310	GO:BP	primary alcohol catabolic process	16175	8564		0.34615384615384615	0.37037037037037035	10	16165	4	10	6	16155	16175	0.3375806416073335
M1	cpdb	0	network_modules	388	TRUE	1.2097531731727525e-6	215	9	6	0.6666666666666666	0.027906976744186046	REAC:R-HSA-211859	REAC	Biological oxidations	10916	227		0.6666666666666666	0.75	215	10701	6	3	209	10698	10916	0.13374741533145057
M1	cpdb	0	network_modules	388	TRUE	4.735928481423685e-6	24	14	4	0.2857142857142857	0.16666666666666666	GO:0046164	GO:BP	alcohol catabolic process	16175	11934		0.38461538461538464	0.4074074074074074	24	16151	4	10	20	16141	16175	0.2173399504793674
M1	cpdb	0	network_modules	388	TRUE	4.239945262032714e-5	116	14	5	0.35714285714285715	0.04310344827586207	GO:0006805	GO:BP	xenobiotic metabolic process	16175	2487		0.4230769230769231	0.4444444444444444	116	16059	5	9	111	16050	16175	0.1220726504969646
M1	cpdb	0	network_modules	388	TRUE	5.252470310448684e-5	257	14	6	0.42857142857142855	0.023346303501945526	GO:0006066	GO:BP	alcohol metabolic process	16175	1933		0.46153846153846156	0.48148148148148145	257	15918	6	8	251	15910	16175	0.0971358747388812
M1	cpdb	0	network_modules	388	TRUE	5.448774563355754e-5	43	14	4	0.2857142857142857	0.09302325581395349	GO:1901616	GO:BP	organic hydroxy compound catabolic process	16175	21598		0.5	0.5185185185185185	43	16132	4	10	39	16122	16175	0.1617960859769255
M1	cpdb	0	network_modules	388	TRUE	6.445361398334304e-5	266	14	6	0.42857142857142855	0.022556390977443608	GO:0009150	GO:BP	purine ribonucleotide metabolic process	16175	3317		0.5384615384615384	0.5555555555555556	266	15909	6	8	260	15901	16175	0.09537669297563026
M1	cpdb	0	network_modules	388	TRUE	8.02503679597246e-5	276	14	6	0.42857142857142855	0.021739130434782608	GO:0009259	GO:BP	ribonucleotide metabolic process	16175	3424		0.5769230769230769	0.5925925925925926	276	15899	6	8	270	15891	16175	0.09352185047063247
M1	cpdb	0	network_modules	388	TRUE	9.311017342332016e-5	283	14	6	0.42857142857142855	0.02120141342756184	GO:0019693	GO:BP	ribose phosphate metabolic process	16175	6010		0.6153846153846154	0.6296296296296297	283	15892	6	8	277	15884	16175	0.09228116542999959
M1	cpdb	0	network_modules	388	TRUE	1.0874685394023878e-4	11	14	3	0.21428571428571427	0.2727272727272727	GO:0009812	GO:BP	flavonoid metabolic process	16175	3696		0.6538461538461539	0.6666666666666666	11	16164	3	11	8	16153	16175	0.24116604956372267
M1	cpdb	0	network_modules	388	TRUE	1.2550691947094133e-4	144	14	5	0.35714285714285715	0.034722222222222224	GO:0071466	GO:BP	cellular response to xenobiotic stimulus	16175	16699		0.6923076923076923	0.7037037037037037	144	16031	5	9	139	16022	16175	0.10911678951023562
M1	cpdb	0	network_modules	388	TRUE	3.215922197856607e-4	349	14	6	0.42857142857142855	0.017191977077363897	GO:0006163	GO:BP	purine nucleotide metabolic process	16175	1998		0.7307692307692307	0.7407407407407407	349	15826	6	8	343	15818	16175	0.08244510740340523
M1	cpdb	0	network_modules	388	TRUE	3.4907622460499425e-4	28	9	3	0.3333333333333333	0.10714285714285714	REAC:R-HSA-9753281	REAC	Paracetamol ADME	10916	1714		1	1	28	10888	3	6	25	10882	10916	0.18784642015723546
M1	cpdb	0	network_modules	388	TRUE	3.551380403329199e-4	68	14	4	0.2857142857142857	0.058823529411764705	GO:0034308	GO:BP	primary alcohol metabolic process	16175	8562		0.7692307692307693	0.7777777777777778	68	16107	4	10	64	16097	16175	0.12805797951799935
M1	cpdb	0	network_modules	388	TRUE	5.12921771623058e-4	191	14	5	0.35714285714285715	0.02617801047120419	GO:0009410	GO:BP	response to xenobiotic stimulus	16175	3475		0.8076923076923077	0.8148148148148148	191	15984	5	9	186	15975	16175	0.09409244516642716
M1	cpdb	0	network_modules	388	TRUE	5.997011181268608e-4	388	14	6	0.42857142857142855	0.015463917525773196	GO:0009117	GO:BP	nucleotide metabolic process	16175	3286		0.8461538461538461	0.8518518518518519	388	15787	6	8	382	15779	16175	0.07782461963144209
M1	cpdb	0	network_modules	388	TRUE	6.860953434515368e-4	397	14	6	0.42857142857142855	0.015113350125944584	GO:1901615	GO:BP	organic hydroxy compound metabolic process	16175	21597		0.8846153846153846	0.8888888888888888	397	15778	6	8	391	15770	16175	0.07685351920282381
M1	cpdb	0	network_modules	388	TRUE	0.0018184276474719273	469	14	6	0.42857142857142855	0.01279317697228145	GO:0072521	GO:BP	purine-containing compound metabolic process	16175	17423		0.9230769230769231	0.9259259259259259	469	15706	6	8	463	15698	16175	0.0700897385840713
M1	cpdb	0	network_modules	388	TRUE	0.0033518735384496573	521	14	6	0.42857142857142855	0.011516314779270634	GO:0006753	GO:BP	nucleoside phosphate metabolic process	16175	2450		0.9615384615384616	0.9629629629629629	521	15654	6	8	515	15646	16175	0.06607449164961189
M1	cpdb	0	network_modules	388	TRUE	0.004987903239829679	558	14	6	0.42857142857142855	0.010752688172043012	GO:0055086	GO:BP	nucleobase-containing small molecule metabolic process	16175	14237		1	1	558	15617	6	8	552	15609	16175	0.06355296116540002
M1	cpdb	0	network_modules	390	TRUE	0.00505280484570442	102	8	3	0.375	0.029411764705882353	KEGG:04972	KEGG	Pancreatic secretion	8484	403		0	0.5	102	8382	3	5	99	8377	8484	0.10231888851409128
M1	cpdb	0	network_modules	390	TRUE	0.005194138758048245	10	8	2	0.25	0.2	REAC:R-HSA-9758881	REAC	Uptake of dietary cobalamins into enterocytes	10916	2629		0	0.5	10	10906	2	6	8	10900	10916	0.22297126089211025
M1	cpdb	0	network_modules	390	TRUE	0.005202073004669291	103	8	3	0.375	0.02912621359223301	KEGG:04974	KEGG	Protein digestion and absorption	8484	405		1	1	103	8381	3	5	100	8376	8484	0.1017939916561269
M1	cpdb	0	network_modules	390	TRUE	0.007612486045548108	12	8	2	0.25	0.16666666666666666	REAC:R-HSA-71384	REAC	Ethanol oxidation	10916	869		1	1	12	10904	2	6	10	10898	10916	0.20341291469682457
M1	cpdb	0	network_modules	391	TRUE	2.7685427317339144e-12	283	14	10	0.7142857142857143	0.0353356890459364	GO:0050808	GO:BP	synapse organization	16175	13274		0	0.25	283	15892	10	4	273	15888	16175	0.15642038212088322
M1	cpdb	0	network_modules	391	TRUE	1.2237811375433201e-9	19	11	5	0.45454545454545453	0.2631578947368421	REAC:R-HSA-388844	REAC	Receptor-type tyrosine-protein phosphatases	10916	1945		0	0.1111111111111111	19	10897	5	6	14	10891	10916	0.34500696859729735
M1	cpdb	0	network_modules	391	TRUE	1.5835981279097954e-9	533	14	10	0.7142857142857143	0.01876172607879925	GO:0034330	GO:BP	cell junction organization	16175	8572		0.3333333333333333	0.5	533	15642	10	4	523	15638	16175	0.1123373749237397
M1	cpdb	0	network_modules	391	TRUE	1.573105976594096e-8	7	14	4	0.2857142857142857	0.5714285714285714	GO:1990709	GO:BP	presynaptic active zone organization	16175	25263		0.6666666666666666	0.75	7	16168	4	10	3	16158	16175	0.40371107187287486
M1	cpdb	0	network_modules	391	TRUE	2.986678400596991e-7	16	11	4	0.36363636363636365	0.25	REAC:R-HSA-264642	REAC	Acetylcholine Neurotransmitter Release Cycle	10916	53		0.125	0.2222222222222222	16	10900	4	7	12	10893	10916	0.30066786740934015
M1	cpdb	0	network_modules	391	TRUE	3.903650678544573e-7	17	11	4	0.36363636363636365	0.23529411764705882	REAC:R-HSA-181430	REAC	Norepinephrine Neurotransmitter Release Cycle	10916	1609		0.25	0.4444444444444444	17	10899	4	7	13	10892	10916	0.2916302732299817
M1	cpdb	0	network_modules	391	TRUE	3.903650678544573e-7	17	11	4	0.36363636363636365	0.23529411764705882	REAC:R-HSA-181429	REAC	Serotonin Neurotransmitter Release Cycle	10916	2206		0.25	0.4444444444444444	17	10899	4	7	13	10892	10916	0.2916302732299817
M1	cpdb	0	network_modules	391	TRUE	1.1967204800144026e-6	22	11	4	0.36363636363636365	0.18181818181818182	REAC:R-HSA-212676	REAC	Dopamine Neurotransmitter Release Cycle	10916	781		0.5	0.5555555555555556	22	10894	4	7	18	10887	10916	0.2560917686948567
M1	cpdb	0	network_modules	391	TRUE	1.4479174498769326e-6	23	11	4	0.36363636363636365	0.17391304347826086	REAC:R-HSA-210500	REAC	Glutamate Neurotransmitter Release Cycle	10916	1055		0.625	0.6666666666666666	23	10893	4	7	19	10886	10916	0.2504107349353039
M1	cpdb	0	network_modules	391	TRUE	3.5540846530554062e-6	86	11	5	0.45454545454545453	0.05813953488372093	REAC:R-HSA-6794362	REAC	Protein-protein interactions at synapses	10916	1819		0.75	0.7777777777777778	86	10830	5	6	81	10824	10916	0.1604602838750455
M1	cpdb	0	network_modules	391	TRUE	3.7138068944568685e-5	50	11	4	0.36363636363636365	0.08	REAC:R-HSA-112310	REAC	Neurotransmitter release cycle	10916	1595		0.875	0.8888888888888888	50	10866	4	7	46	10859	10916	0.16888430358817116
M1	cpdb	0	network_modules	391	TRUE	0.0026743696454616496	3	14	2	0.14285714285714285	0.6666666666666666	GO:1904071	GO:BP	presynaptic active zone assembly	16175	23509		1	1	3	16172	2	12	1	16160	16175	0.30836810188211866
M1	cpdb	0	network_modules	391	TRUE	0.0073375525096203075	400	11	5	0.45454545454545453	0.0125	REAC:R-HSA-112316	REAC	Neuronal System	10916	1590		1	1	400	10516	5	6	395	10510	10916	0.07064252192204387
M1	cpdb	0	network_modules	394	TRUE	0.004603427647900035	11	7	2	0.2857142857142857	0.18181818181818182	REAC:R-HSA-1660517	REAC	Synthesis of PIPs at the late endosome membrane	10916	2394		NA	1	11	10905	2	5	9	10900	10916	0.22730470180250678
M1	cpdb	0	network_modules	396	TRUE	1.2354775515817951e-5	124	11	5	0.45454545454545453	0.04032258064516129	GO:0031109	GO:BP	microtubule polymerization or depolymerization	16175	7034		0	0.3333333333333333	124	16051	5	6	119	16045	16175	0.13365787809650975
M1	cpdb	0	network_modules	396	TRUE	9.908343685425167e-4	586	11	6	0.5454545454545454	0.010238907849829351	GO:0000226	GO:BP	microtubule cytoskeleton organization	16175	61		0.5	0.6666666666666666	586	15589	6	5	580	15584	16175	0.0710916626556133
M1	cpdb	0	network_modules	396	TRUE	0.0027946704556370914	41	11	3	0.2727272727272727	0.07317073170731707	GO:0007019	GO:BP	microtubule depolymerization	16175	2627		1	1	41	16134	3	8	38	16126	16175	0.14017692893089237
M1	cpdb	0	network_modules	400	TRUE	0.0015655285604750356	30	12	3	0.25	0.1	GO:0007528	GO:BP	neuromuscular junction development	16175	3010		NA	1	30	16145	3	9	27	16136	16175	0.15714490440022097
M1	cpdb	0	network_modules	401	TRUE	7.958666656058374e-4	684	14	7	0.5	0.01023391812865497	GO:0032880	GO:BP	regulation of protein localization	16175	7877		0	0.25	684	15491	7	7	677	15484	16175	0.06694208048178173
M1	cpdb	0	network_modules	401	TRUE	0.0018637136731700058	776	14	7	0.5	0.00902061855670103	GO:0060341	GO:BP	regulation of cellular localization	16175	14553		0.3333333333333333	0.5	776	15399	7	7	769	15392	16175	0.06225285404844185
M1	cpdb	0	network_modules	401	TRUE	0.008905748663263038	5	14	2	0.14285714285714285	0.4	GO:0048312	GO:BP	intracellular distribution of mitochondria	16175	12649		0.6666666666666666	1	5	16170	2	12	3	16158	16175	0.2386686524028136
M1	cpdb	0	network_modules	401	TRUE	0.008905748663263038	5	14	2	0.14285714285714285	0.4	GO:0022614	GO:BP	membrane to membrane docking	16175	6621		0.6666666666666666	1	5	16170	2	12	3	16158	16175	0.2386686524028136
M1	cpdb	0	network_modules	402	TRUE	2.3934148581746973e-20	19	15	9	0.6	0.47368421052631576	REAC:R-HSA-77595	REAC	Processing of Intronless Pre-mRNAs	10916	1799		0	0.125	19	10897	9	6	10	10891	10916	0.5323965932045789
M1	cpdb	0	network_modules	402	TRUE	1.7815369642376705e-18	28	15	9	0.6	0.32142857142857145	REAC:R-HSA-75067	REAC	Processing of Capped Intronless Pre-mRNA	10916	1797		0.14285714285714285	0.25	28	10888	9	6	19	10882	10916	0.43814064770144195
M1	cpdb	0	network_modules	402	TRUE	8.117291208068024e-17	96	12	10	0.8333333333333334	0.10416666666666667	KEGG:03015	KEGG	mRNA surveillance pathway	8484	210		0	0.5	96	8388	10	2	86	8386	8484	0.2924925205940337
M1	cpdb	0	network_modules	402	TRUE	1.9271365250266645e-15	56	15	9	0.6	0.16071428571428573	REAC:R-HSA-72187	REAC	mRNA 3'-end processing	10916	2701		0.2857142857142857	0.375	56	10860	9	6	47	10854	10916	0.3088794864406347
M1	cpdb	0	network_modules	402	TRUE	8.095234142960879e-15	65	15	9	0.6	0.13846153846153847	REAC:R-HSA-73856	REAC	RNA Polymerase II Transcription Termination	10916	1895		0.42857142857142855	0.5	65	10851	9	6	56	10845	10916	0.2864204954230899
M1	cpdb	0	network_modules	402	TRUE	1.5829908125240005e-13	33	13	7	0.5384615384615384	0.21212121212121213	GO:0031124	GO:BP	mRNA 3'-end processing	16175	7049		0	0.125	33	16142	7	6	26	16136	16175	0.33716216203680877
M1	cpdb	0	network_modules	402	TRUE	3.9409839531110705e-13	80	13	8	0.6153846153846154	0.1	GO:0031123	GO:BP	RNA 3'-end processing	16175	7048		0.14285714285714285	0.25	80	16095	8	5	72	16090	16175	0.24678570349835527
M1	cpdb	0	network_modules	402	TRUE	5.113895386017317e-9	276	15	9	0.6	0.03260869565217391	REAC:R-HSA-72203	REAC	Processing of Capped Intron-Containing Pre-mRNA	10916	1796		0.5714285714285714	0.625	276	10640	9	6	267	10634	10916	0.13580130070896917
M1	cpdb	0	network_modules	402	TRUE	3.58165061442878e-7	38	15	5	0.3333333333333333	0.13157894736842105	REAC:R-HSA-159231	REAC	Transport of Mature mRNA Derived from an Intronless Transcript	10916	2585		0.7142857142857143	0.75	38	10878	5	10	33	10868	10916	0.2077442692669519
M1	cpdb	0	network_modules	402	TRUE	4.105220282655152e-7	39	15	5	0.3333333333333333	0.1282051282051282	REAC:R-HSA-159234	REAC	Transport of Mature mRNAs Derived from Intronless Transcripts	10916	2587		0.8571428571428571	0.875	39	10877	5	10	34	10867	10916	0.20501605782450774
M1	cpdb	0	network_modules	402	TRUE	2.0269055697640066e-6	4	13	3	0.23076923076923078	0.75	GO:0110104	GO:BP	mRNA alternative polyadenylation	16175	19416		0.2857142857142857	0.375	4	16171	3	10	1	16161	16175	0.41579784822432503
M1	cpdb	0	network_modules	402	TRUE	4.175682779857518e-6	352	13	7	0.5384615384615384	0.019886363636363636	GO:0006397	GO:BP	mRNA processing	16175	2158		0.42857142857142855	0.5	352	15823	7	6	345	15817	16175	0.10043631273281864
M1	cpdb	0	network_modules	402	TRUE	1.6610611791005434e-05	80	15	5	0.3333333333333333	0.0625	REAC:R-HSA-72202	REAC	Transport of Mature Transcript to Cytoplasm	10916	2584		1	1	80	10836	5	10	75	10826	10916	0.1417817323437092
M1	cpdb	0	network_modules	402	TRUE	1.771075908220588e-5	7	13	3	0.23076923076923078	0.42857142857142855	GO:0180012	GO:BP	co-transcriptional RNA 3'-end processing, cleavage and polyadenylation pathway	16175	20297		0.5714285714285714	0.625	7	16168	3	10	4	16158	16175	0.3140898772418827
M1	cpdb	0	network_modules	402	TRUE	1.443199188968735e-4	13	13	3	0.23076923076923078	0.23076923076923078	GO:0051290	GO:BP	protein heterotetramerization	16175	13622		0.7142857142857143	0.75	13	16162	3	10	10	16152	16175	0.2301504954641943
M1	cpdb	0	network_modules	402	TRUE	1.4692252281031236e-4	590	13	7	0.5384615384615384	0.011864406779661017	GO:0016071	GO:BP	mRNA metabolic process	16175	5098		0.8571428571428571	0.875	590	15585	7	6	583	15579	16175	0.075941675298102
M1	cpdb	0	network_modules	402	TRUE	5.733958633881359e-4	20	13	3	0.23076923076923078	0.15	GO:0051291	GO:BP	protein heterooligomerization	16175	13623		1	1	20	16155	3	10	17	16145	16175	0.18524419362516745
M1	cpdb	0	network_modules	402	TRUE	0.004589572643912082	62	12	3	0.25	0.04838709677419355	KEGG:03250	KEGG	Viral life cycle - HIV-1	8484	223		1	1	62	8422	3	9	59	8413	8484	0.10723845114515887
M1	cpdb	0	network_modules	403	TRUE	1.2797259696266487e-16	590	15	14	0.9333333333333333	0.023728813559322035	GO:0016567	GO:BP	protein ubiquitination	16175	5254		0	0.047619047619047616	590	15585	14	1	576	15584	16175	0.14575154737419657
M1	cpdb	0	network_modules	403	TRUE	7.224270005565383e-16	667	15	14	0.9333333333333333	0.020989505247376312	GO:0032446	GO:BP	protein modification by small protein conjugation	16175	7568		0.05	0.09523809523809523	667	15508	14	1	653	15507	16175	0.13669116247902316
M1	cpdb	0	network_modules	403	TRUE	8.196382730227547e-16	673	15	14	0.9333333333333333	0.020802377414561663	GO:0051603	GO:BP	proteolysis involved in protein catabolic process	16175	13820		0.1	0.14285714285714285	673	15502	14	1	659	15501	16175	0.13605021427992253
M1	cpdb	0	network_modules	403	TRUE	3.700035982949268e-15	749	15	14	0.9333333333333333	0.018691588785046728	GO:0070647	GO:BP	protein modification by small protein conjugation or removal	16175	16231		0.15	0.19047619047619047	749	15426	14	1	735	15425	16175	0.12859931559612828
M1	cpdb	0	network_modules	403	TRUE	4.0889401568943395e-15	140	12	10	0.8333333333333334	0.07142857142857142	KEGG:04120	KEGG	Ubiquitin mediated proteolysis	8484	270		NA	1	140	8344	10	2	130	8342	8484	0.24131244419650372
M1	cpdb	0	network_modules	403	TRUE	9.02278627069848e-15	547	15	13	0.8666666666666667	0.02376599634369287	GO:0006511	GO:BP	ubiquitin-dependent protein catabolic process	16175	2235		0.2	0.23809523809523808	547	15628	13	2	534	15626	16175	0.14037512929160434
M1	cpdb	0	network_modules	403	TRUE	9.025967882302239e-15	798	15	14	0.9333333333333333	0.017543859649122806	GO:0043687	GO:BP	post-translational protein modification	16175	10838		0.25	0.2857142857142857	798	15377	14	1	784	15376	16175	0.12436072360693519
M1	cpdb	0	network_modules	403	TRUE	1.0909596812569774e-14	555	15	13	0.8666666666666667	0.023423423423423424	GO:0019941	GO:BP	modification-dependent protein catabolic process	16175	6072		0.3	0.3333333333333333	555	15620	13	2	542	15618	16175	0.13931264678932656
M1	cpdb	0	network_modules	403	TRUE	1.1983696267949315e-14	559	15	13	0.8666666666666667	0.023255813953488372	GO:0043632	GO:BP	modification-dependent macromolecule catabolic process	16175	10812		0.35	0.38095238095238093	559	15616	13	2	546	15614	16175	0.1387898467378994
M1	cpdb	0	network_modules	403	TRUE	2.3549998430925696e-11	308	13	10	0.7692307692307693	0.032467532467532464	REAC:R-HSA-983168	REAC	Antigen processing: Ubiquitination & Proteasome degradation	10916	154		0	0.0625	308	10608	10	3	298	10605	10916	0.15452446967065925
M1	cpdb	0	network_modules	403	TRUE	1.9432584723928823e-10	380	13	10	0.7692307692307693	0.02631578947368421	REAC:R-HSA-983169	REAC	Class I MHC mediated antigen processing & presentation	10916	368		0.06666666666666667	0.125	380	10536	10	3	370	10533	10916	0.13834921757162838
M1	cpdb	0	network_modules	403	TRUE	2.599154485728358e-10	248	15	9	0.6	0.036290322580645164	GO:0000209	GO:BP	protein polyubiquitination	16175	59		0.4	0.42857142857142855	248	15927	9	6	239	15921	16175	0.14497246050101334
M1	cpdb	0	network_modules	403	TRUE	6.4532212984595555e-6	78	13	5	0.38461538461538464	0.0641025641025641	REAC:R-HSA-8852135	REAC	Protein ubiquitination	10916	1818		0.13333333333333333	0.1875	78	10838	5	8	73	10830	10916	0.15474715028254704
M1	cpdb	0	network_modules	403	TRUE	9.05437971714205e-6	29	13	4	0.3076923076923077	0.13793103448275862	REAC:R-HSA-2173795	REAC	Downregulation of SMAD2/3:SMAD4 transcriptional activity	10916	787		0.2	0.25	29	10887	4	9	25	10878	10916	0.20462547263076947
M1	cpdb	0	network_modules	403	TRUE	9.812220718604914e-6	79	15	5	0.3333333333333333	0.06329113924050633	GO:0070936	GO:BP	protein K48-linked ubiquitination	16175	16380		0.45	0.47619047619047616	79	16096	5	10	74	16086	16175	0.14353737239518066
M1	cpdb	0	network_modules	403	TRUE	1.0440459378648765e-5	30	13	4	0.3076923076923077	0.13333333333333333	REAC:R-HSA-8866652	REAC	Synthesis of active ubiquitin: roles of E1 and E2 enzymes	10916	2400		0.26666666666666666	0.3125	30	10886	4	9	26	10877	10916	0.20113496126496025
M1	cpdb	0	network_modules	403	TRUE	1.1979274623326824e-5	31	13	4	0.3076923076923077	0.12903225806451613	REAC:R-HSA-201451	REAC	Signaling by BMP	10916	2224		0.3333333333333333	0.375	31	10885	4	9	27	10876	10916	0.1978139013611731
M1	cpdb	0	network_modules	403	TRUE	1.3406136593787335e-5	84	15	5	0.3333333333333333	0.05952380952380952	GO:0090288	GO:BP	negative regulation of cellular response to growth factor stimulus	16175	18172		0.5	0.5238095238095238	84	16091	5	10	79	16081	16175	0.13909048812521424
M1	cpdb	0	network_modules	403	TRUE	1.9881732084218552e-5	35	13	4	0.3076923076923077	0.11428571428571428	REAC:R-HSA-936440	REAC	Negative regulators of DDX58/IFIH1 signaling	10916	1581		0.4	0.4375	35	10881	4	9	31	10872	10916	0.18597779996168648
M1	cpdb	0	network_modules	403	TRUE	2.0721000770674256e-5	363	15	7	0.4666666666666667	0.01928374655647383	GO:0043161	GO:BP	proteasome-mediated ubiquitin-dependent protein catabolic process	16175	10561		0.55	0.5714285714285714	363	15812	7	8	356	15804	16175	0.09137453001118423
M1	cpdb	0	network_modules	403	TRUE	2.3604051444141078e-5	8	13	3	0.23076923076923078	0.375	REAC:R-HSA-1253288	REAC	Downregulation of ERBB4 signaling	10916	786		0.4666666666666667	0.5	8	10908	3	10	5	10898	10916	0.29352231826464087
M1	cpdb	0	network_modules	403	TRUE	8.658461958657269e-5	50	13	4	0.3076923076923077	0.08	REAC:R-HSA-2173793	REAC	Transcriptional activity of SMAD2/SMAD3:SMAD4 heterotrimer	10916	2550		0.5333333333333333	0.5625	50	10866	4	9	46	10857	10916	0.15500485317093463
M1	cpdb	0	network_modules	403	TRUE	8.832365985733448e-5	44	15	4	0.26666666666666666	0.09090909090909091	GO:0030514	GO:BP	negative regulation of BMP signaling pathway	16175	6830		0.6	0.6190476190476191	44	16131	4	11	40	16120	16175	0.15439315130996134
M1	cpdb	0	network_modules	403	TRUE	1.2218133264448413e-4	470	15	7	0.4666666666666667	0.014893617021276596	GO:0010498	GO:BP	proteasomal protein catabolic process	16175	4177		0.65	0.6666666666666666	470	15705	7	8	463	15697	16175	0.07937579034268928
M1	cpdb	0	network_modules	403	TRUE	1.5866837702513268e-4	58	13	4	0.3076923076923077	0.06896551724137931	REAC:R-HSA-8866654	REAC	E3 ubiquitin ligases ubiquitinate target proteins	10916	811		0.6	0.625	58	10858	4	9	54	10849	10916	0.14362330519319336
M1	cpdb	0	network_modules	403	TRUE	6.438002233704928e-4	82	13	4	0.3076923076923077	0.04878048780487805	REAC:R-HSA-168928	REAC	DDX58/IFIH1-mediated induction of interferon-alpha/beta	10916	436		0.6666666666666666	0.6875	82	10834	4	9	78	10825	10916	0.12004475378418276
M1	cpdb	0	network_modules	403	TRUE	9.110291772197921e-4	78	15	4	0.26666666666666666	0.05128205128205128	GO:0030510	GO:BP	regulation of BMP signaling pathway	16175	6826		0.7	0.7142857142857143	78	16097	4	11	74	16086	16175	0.11515764482498843
M1	cpdb	0	network_modules	403	TRUE	0.0010216893221190767	92	13	4	0.3076923076923077	0.043478260869565216	REAC:R-HSA-170834	REAC	Signaling by TGF-beta Receptor Complex	10916	2308		0.7333333333333333	0.75	92	10824	4	9	88	10815	10916	0.11303926396567023
M1	cpdb	0	network_modules	403	TRUE	0.0018649106768900455	31	13	3	0.23076923076923078	0.0967741935483871	REAC:R-HSA-5213460	REAC	RIPK1-mediated regulated necrosis	10916	1877		0.8	0.875	31	10885	3	10	28	10875	10916	0.14789973970844744
M1	cpdb	0	network_modules	403	TRUE	0.0018649106768900455	31	13	3	0.23076923076923078	0.0967741935483871	REAC:R-HSA-5675482	REAC	Regulation of necroptotic cell death	10916	2045		0.8	0.875	31	10885	3	10	28	10875	10916	0.14789973970844744
M1	cpdb	0	network_modules	403	TRUE	0.0031483862355998152	122	13	4	0.3076923076923077	0.03278688524590164	REAC:R-HSA-9006936	REAC	Signaling by TGFB family members	10916	2310		0.9333333333333333	0.9375	122	10794	4	9	118	10785	10916	0.09739558822654003
M1	cpdb	0	network_modules	403	TRUE	0.0034989952701483954	256	15	5	0.3333333333333333	0.01953125	GO:0090287	GO:BP	regulation of cellular response to growth factor stimulus	16175	18171		0.75	0.7619047619047619	256	15919	5	10	251	15909	16175	0.07750753143871365
M1	cpdb	0	network_modules	403	TRUE	0.003965857803360063	31	15	3	0.2	0.0967741935483871	GO:0070979	GO:BP	protein K11-linked ubiquitination	16175	16411		0.8	0.8095238095238095	31	16144	3	12	28	16132	16175	0.13798473293683836
M1	cpdb	0	network_modules	403	TRUE	0.004635263440329214	117	15	4	0.26666666666666666	0.03418803418803419	GO:0030509	GO:BP	BMP signaling pathway	16175	6825		0.85	0.8571428571428571	117	16058	4	11	113	16047	16175	0.093273070226945
M1	cpdb	0	network_modules	403	TRUE	0.005657653416473533	123	15	4	0.26666666666666666	0.032520325203252036	GO:0071772	GO:BP	response to BMP	16175	16901		0.9	0.9523809523809523	123	16052	4	11	119	16041	16175	0.09085658136882174
M1	cpdb	0	network_modules	403	TRUE	0.005657653416473533	123	15	4	0.26666666666666666	0.032520325203252036	GO:0071773	GO:BP	cellular response to BMP stimulus	16175	16902		0.9	0.9523809523809523	123	16052	4	11	119	16041	16175	0.09085658136882174
M1	cpdb	0	network_modules	403	TRUE	0.006227310142142131	126	15	4	0.26666666666666666	0.031746031746031744	GO:0090101	GO:BP	negative regulation of transmembrane receptor protein serine/threonine kinase signaling pathway	16175	18019		1	1	126	16049	4	11	122	16038	16175	0.0897125548098155
M1	cpdb	0	network_modules	403	TRUE	0.006233288734941423	46	13	3	0.23076923076923078	0.06521739130434782	REAC:R-HSA-5357905	REAC	Regulation of TNFR1 signaling	10916	2011		1	1	46	10870	3	10	43	10860	10916	0.12076542308180324
M1	cpdb	0	network_modules	404	TRUE	6.617679295914984e-7	3	14	3	0.21428571428571427	1	GO:0070681	GO:BP	glutaminyl-tRNAGln biosynthesis via transamidation	16175	16257		0	0.16666666666666666	3	16172	3	11	0	16161	16175	0.46275259018047415
M1	cpdb	0	network_modules	404	TRUE	1.1841135100906794e-5	44	11	4	0.36363636363636365	0.09090909090909091	KEGG:00970	KEGG	Aminoacyl-tRNA biosynthesis	8484	153		NA	1	44	8440	4	7	40	8433	8484	0.1798082361422202
M1	cpdb	0	network_modules	404	TRUE	4.475685930955379e-5	41	14	4	0.2857142857142857	0.0975609756097561	GO:0043039	GO:BP	tRNA aminoacylation	16175	10489		0.2	0.5	41	16134	4	10	37	16124	16175	0.16575745232515107
M1	cpdb	0	network_modules	404	TRUE	4.475685930955379e-5	41	14	4	0.2857142857142857	0.0975609756097561	GO:0043038	GO:BP	amino acid activation	16175	10488		0.2	0.5	41	16134	4	10	37	16124	16175	0.16575745232515107
M1	cpdb	0	network_modules	404	TRUE	4.496169045408404e-4	186	14	5	0.35714285714285715	0.026881720430107527	GO:0006399	GO:BP	tRNA metabolic process	16175	2160		0.6	0.6666666666666666	186	15989	5	9	181	15980	16175	0.09541916814803862
M1	cpdb	0	network_modules	404	TRUE	0.001829018883463814	247	14	5	0.35714285714285715	0.020242914979757085	GO:0006520	GO:BP	amino acid metabolic process	16175	2241		0.8	0.8333333333333334	247	15928	5	9	242	15919	16175	0.08205576614178654
M1	cpdb	0	network_modules	404	TRUE	0.004376696956153771	127	14	4	0.2857142857142857	0.031496062992125984	GO:0032543	GO:BP	mitochondrial translation	16175	7635		1	1	127	16048	4	10	123	16038	16175	0.09265995119080095
M1	cpdb	0	network_modules	409	TRUE	1.175560390235047e-10	27	14	6	0.42857142857142855	0.2222222222222222	REAC:R-HSA-3000170	REAC	Syndecan interactions	10916	2367		0	0.038461538461538464	27	10889	6	8	21	10881	10916	0.3074029746494248
M1	cpdb	0	network_modules	409	TRUE	1.7536641312237823e-8	59	14	6	0.42857142857142855	0.1016949152542373	REAC:R-HSA-3000171	REAC	Non-integrin membrane-ECM interactions	10916	1603		0.04	0.07692307692307693	59	10857	6	8	53	10849	10916	0.2068258555660606
M1	cpdb	0	network_modules	409	TRUE	2.3015886801578847e-7	298	14	8	0.5714285714285714	0.026845637583892617	REAC:R-HSA-1474244	REAC	Extracellular matrix organization	10916	889		0.08	0.11538461538461539	298	10618	8	6	290	10612	10916	0.1196594469738017
M1	cpdb	0	network_modules	409	TRUE	5.289944355365527e-7	14	14	4	0.2857142857142857	0.2857142857142857	REAC:R-HSA-3656253	REAC	Defective EXT1 causes exostoses 1, TRPS2 and CHDS	10916	538		0.12	0.19230769230769232	14	10902	4	10	10	10892	10916	0.28479702282674213
M1	cpdb	0	network_modules	409	TRUE	5.289944355365527e-7	14	14	4	0.2857142857142857	0.2857142857142857	REAC:R-HSA-3656237	REAC	Defective EXT2 causes exostoses 2	10916	539		0.12	0.19230769230769232	14	10902	4	10	10	10892	10916	0.28479702282674213
M1	cpdb	0	network_modules	409	TRUE	2.0408324320726745e-6	19	14	4	0.2857142857142857	0.21052631578947367	REAC:R-HSA-9694614	REAC	Attachment and Entry	10916	187		0.2	0.23076923076923078	19	10897	4	10	15	10887	10916	0.24413066429576183
M1	cpdb	0	network_modules	409	TRUE	2.5491689920785956e-6	20	14	4	0.2857142857142857	0.2	REAC:R-HSA-4420332	REAC	Defective B3GALT6 causes EDSP2 and SEMDJL1	10916	490		0.24	0.34615384615384615	20	10896	4	10	16	10886	10916	0.23788329182364235
M1	cpdb	0	network_modules	409	TRUE	2.5491689920785956e-6	20	14	4	0.2857142857142857	0.2	REAC:R-HSA-3560801	REAC	Defective B3GAT3 causes JDSSDHD	10916	492		0.24	0.34615384615384615	20	10896	4	10	16	10886	10916	0.23788329182364235
M1	cpdb	0	network_modules	409	TRUE	2.5491689920785956e-6	20	14	4	0.2857142857142857	0.2	REAC:R-HSA-3560783	REAC	Defective B4GALT7 causes EDS, progeroid type	10916	495		0.24	0.34615384615384615	20	10896	4	10	16	10886	10916	0.23788329182364235
M1	cpdb	0	network_modules	409	TRUE	2.623589398745162e-6	153	13	6	0.46153846153846156	0.0392156862745098	KEGG:04514	KEGG	Cell adhesion molecules	8484	315		0	0.25	153	8331	6	7	147	8324	8484	0.13055958417067262
M1	cpdb	0	network_modules	409	TRUE	5.574418610431008e-6	24	14	4	0.2857142857142857	0.16666666666666666	REAC:R-HSA-2024096	REAC	HS-GAG degradation	10916	1108		0.36	0.38461538461538464	24	10892	4	10	20	10882	10916	0.216916255470491
M1	cpdb	0	network_modules	409	TRUE	7.831290483706808e-6	26	14	4	0.2857142857142857	0.15384615384615385	REAC:R-HSA-1971475	REAC	A tetrasaccharide linker sequence is required for GAG synthesis	10916	6		0.4	0.4230769230769231	26	10890	4	10	22	10880	10916	0.208290842106808
M1	cpdb	0	network_modules	409	TRUE	1.6421981391729185e-5	31	14	4	0.2857142857142857	0.12903225806451613	REAC:R-HSA-2022928	REAC	HS-GAG biosynthesis	10916	1107		0.44	0.46153846153846156	31	10885	4	10	27	10875	10916	0.1904903874944984
M1	cpdb	0	network_modules	409	TRUE	2.95084987807928e-5	97	14	5	0.35714285714285715	0.05154639175257732	REAC:R-HSA-2187338	REAC	Visual phototransduction	10916	2654		0.48	0.5	97	10819	5	9	92	10810	10916	0.1329825499791644
M1	cpdb	0	network_modules	409	TRUE	3.431816820872463e-5	37	14	4	0.2857142857142857	0.10810810810810811	REAC:R-HSA-9772572	REAC	Early SARS-CoV-2 Infection Events	10916	832		0.52	0.5384615384615384	37	10879	4	10	33	10869	10916	0.17407166446454447
M1	cpdb	0	network_modules	409	TRUE	5.246732180395515e-5	41	14	4	0.2857142857142857	0.0975609756097561	REAC:R-HSA-3560782	REAC	Diseases associated with glycosaminoglycan metabolism	10916	750		0.56	0.5769230769230769	41	10875	4	10	37	10865	10916	0.1651782369208893
M1	cpdb	0	network_modules	409	TRUE	7.017685805671821e-5	44	14	4	0.2857142857142857	0.09090909090909091	REAC:R-HSA-975634	REAC	Retinoid metabolism and transport	10916	2093		0.6	0.6153846153846154	44	10872	4	10	40	10862	10916	0.15931431928277845
M1	cpdb	0	network_modules	409	TRUE	1.0029345834230252e-4	48	14	4	0.2857142857142857	0.08333333333333333	REAC:R-HSA-6806667	REAC	Metabolism of fat-soluble vitamins	10916	1424		0.64	0.6538461538461539	48	10868	4	10	44	10858	10916	0.15236145411252608
M1	cpdb	0	network_modules	409	TRUE	1.09128206637917e-4	49	14	4	0.2857142857142857	0.08163265306122448	REAC:R-HSA-1793185	REAC	Chondroitin sulfate/dermatan sulfate metabolism	10916	353		0.68	0.6923076923076923	49	10867	4	10	45	10857	10916	0.15075656078439986
M1	cpdb	0	network_modules	409	TRUE	1.8830225312062814e-4	13	14	3	0.21428571428571427	0.23076923076923078	GO:1905564	GO:BP	positive regulation of vascular endothelial cell proliferation	16175	24732		0	0.09090909090909091	13	16162	3	11	10	16151	16175	0.22172580349903687
M1	cpdb	0	network_modules	409	TRUE	2.0225980333593956e-4	57	14	4	0.2857142857142857	0.07017543859649122	REAC:R-HSA-1638091	REAC	Heparan sulfate/heparin (HS-GAG) metabolism	10916	1119		0.72	0.7307692307692307	57	10859	4	10	53	10849	10916	0.13946444681447945
M1	cpdb	0	network_modules	409	TRUE	2.0741580374075634e-4	324	14	6	0.42857142857142855	0.018518518518518517	GO:0007159	GO:BP	leukocyte cell-cell adhesion	16175	2723		0.1	0.18181818181818182	324	15851	6	8	318	15843	16175	0.08582394781432667
M1	cpdb	0	network_modules	409	TRUE	4.691504395728343e-4	205	13	5	0.38461538461538464	0.024390243902439025	KEGG:05205	KEGG	Proteoglycans in cancer	8484	457		0.3333333333333333	0.5	205	8279	5	8	200	8271	8484	0.09195743925657895
M1	cpdb	0	network_modules	409	TRUE	5.817754172393e-4	386	14	6	0.42857142857142855	0.015544041450777202	GO:0022407	GO:BP	regulation of cell-cell adhesion	16175	6598		0.2	0.2727272727272727	386	15789	6	8	380	15781	16175	0.07804487991715969
M1	cpdb	0	network_modules	409	TRUE	6.360384300162065e-4	19	14	3	0.21428571428571427	0.15789473684210525	GO:0101023	GO:BP	vascular endothelial cell proliferation	16175	19196		0.3	0.45454545454545453	19	16156	3	11	16	16145	16175	0.1831202880115945
M1	cpdb	0	network_modules	409	TRUE	6.360384300162065e-4	19	14	3	0.21428571428571427	0.15789473684210525	GO:1905562	GO:BP	regulation of vascular endothelial cell proliferation	16175	24730		0.3	0.45454545454545453	19	16156	3	11	16	16145	16175	0.1831202880115945
M1	cpdb	0	network_modules	409	TRUE	8.620201411627886e-4	191	14	5	0.35714285714285715	0.02617801047120419	REAC:R-HSA-202733	REAC	Cell surface interactions at the vascular wall	10916	327		0.76	0.7692307692307693	191	10725	5	9	186	10716	10916	0.09282930985213407
M1	cpdb	0	network_modules	409	TRUE	0.0014165906575962066	745	14	7	0.5	0.009395973154362415	GO:0098609	GO:BP	cell-cell adhesion	16175	18805		0.5	0.5454545454545454	745	15430	7	7	738	15423	16175	0.06374010264255806
M1	cpdb	0	network_modules	409	TRUE	0.0015170346636575452	27	14	3	0.21428571428571427	0.1111111111111111	REAC:R-HSA-114508	REAC	Effects of PIP2 hydrolysis	10916	833		0.8	0.8076923076923077	27	10889	3	11	24	10878	10916	0.1528092737707221
M1	cpdb	0	network_modules	409	TRUE	0.001795941974061176	468	14	6	0.42857142857142855	0.01282051282051282	GO:0050865	GO:BP	regulation of cell activation	16175	13313		0.6	0.6363636363636364	468	15707	6	8	462	15699	16175	0.07017320300744742
M1	cpdb	0	network_modules	409	TRUE	0.0023264791779495954	138	13	4	0.3076923076923077	0.028985507246376812	KEGG:05418	KEGG	Fluid shear stress and atherosclerosis	8484	495		0.6666666666666666	0.75	138	8346	4	9	134	8337	8484	0.09025164913321543
M1	cpdb	0	network_modules	409	TRUE	0.0027053211664397397	49	13	3	0.23076923076923078	0.061224489795918366	KEGG:05144	KEGG	Malaria	8484	436		1	1	49	8435	3	10	46	8425	8484	0.11631471985796052
M1	cpdb	0	network_modules	409	TRUE	0.0036317010988800857	284	14	5	0.35714285714285715	0.017605633802816902	GO:0050863	GO:BP	regulation of T cell activation	16175	13311		0.7	0.7272727272727273	284	15891	5	9	279	15882	16175	0.07610054647253396
M1	cpdb	0	network_modules	409	TRUE	0.003822362031294737	259	14	5	0.35714285714285715	0.019305019305019305	REAC:R-HSA-76002	REAC	Platelet activation, signaling and aggregation	10916	1762		0.84	0.8461538461538461	259	10657	5	9	254	10648	10916	0.0785043660970917
M1	cpdb	0	network_modules	409	TRUE	0.003823650910649754	287	14	5	0.35714285714285715	0.017421602787456445	GO:1903037	GO:BP	regulation of leukocyte cell-cell adhesion	16175	22717		0.8	0.8181818181818182	287	15888	5	9	282	15879	16175	0.07566756029644418
M1	cpdb	0	network_modules	409	TRUE	0.004720005480211883	125	14	4	0.2857142857142857	0.032	REAC:R-HSA-1630316	REAC	Glycosaminoglycan metabolism	10916	1076		0.88	0.8846153846153846	125	10791	4	10	121	10781	10916	0.09237536120920932
M1	cpdb	0	network_modules	409	TRUE	0.005346093569584706	4	14	2	0.14285714285714285	0.5	GO:1903553	GO:BP	positive regulation of extracellular exosome assembly	16175	23100		0.9	0.9090909090909091	4	16171	2	12	2	16159	16175	0.26694714088648164
M1	cpdb	0	network_modules	409	TRUE	0.006833625888015841	292	14	5	0.35714285714285715	0.017123287671232876	REAC:R-HSA-9694516	REAC	SARS-CoV-2 Infection	10916	2122		0.92	0.9230769230769231	292	10624	5	9	287	10615	10916	0.07337869944757598
M1	cpdb	0	network_modules	409	TRUE	0.0073838491839969015	140	14	4	0.2857142857142857	0.02857142857142857	REAC:R-HSA-3781865	REAC	Diseases of glycosylation	10916	765		0.96	0.9615384615384616	140	10776	4	10	136	10766	10916	0.08690960899376432
M1	cpdb	0	network_modules	409	TRUE	0.008829024774409803	48	14	3	0.21428571428571427	0.0625	REAC:R-HSA-418597	REAC	G alpha (z) signalling events	10916	990		1	1	48	10868	3	11	45	10857	10916	0.11367570715745688
M1	cpdb	0	network_modules	409	TRUE	0.009331618025918633	622	14	6	0.42857142857142855	0.00964630225080386	GO:0030155	GO:BP	regulation of cell adhesion	16175	6688		1	1	622	15553	6	8	616	15545	16175	0.05971271470188946
M1	cpdb	0	network_modules	410	TRUE	5.8079289273735965e-8	89	12	6	0.5	0.06741573033707865	KEGG:04512	KEGG	ECM-receptor interaction	8484	314		0	0.125	89	8395	6	6	83	8389	8484	0.18082323181301627
M1	cpdb	0	network_modules	410	TRUE	1.885754666355384e-7	101	14	6	0.42857142857142855	0.0594059405940594	GO:0007229	GO:BP	integrin-mediated signaling pathway	16175	2779		0	0.05263157894736842	101	16074	6	8	95	16066	16175	0.15779767554016086
M1	cpdb	0	network_modules	410	TRUE	5.897051831182115e-6	92	12	5	0.4166666666666667	0.05434782608695652	KEGG:04640	KEGG	Hematopoietic cell lineage	8484	333		0.14285714285714285	0.25	92	8392	5	7	87	8385	8484	0.14747147393294233
M1	cpdb	0	network_modules	410	TRUE	9.203187901212696e-6	192	14	6	0.42857142857142855	0.03125	GO:0007160	GO:BP	cell-matrix adhesion	16175	2724		0.05555555555555555	0.10526315789473684	192	15983	6	8	186	15975	16175	0.11324505319601613
M1	cpdb	0	network_modules	410	TRUE	9.40223082391015e-6	84	13	5	0.38461538461538464	0.05952380952380952	REAC:R-HSA-216083	REAC	Integrin cell surface interactions	10916	1216		0	0.1111111111111111	84	10832	5	8	79	10824	10916	0.14894218076236154
M1	cpdb	0	network_modules	410	TRUE	1.0440459378648765e-5	30	13	4	0.3076923076923077	0.13333333333333333	REAC:R-HSA-3000157	REAC	Laminin interactions	10916	1303		0.125	0.2222222222222222	30	10886	4	9	26	10877	10916	0.20113496126496025
M1	cpdb	0	network_modules	410	TRUE	5.8704827735246e-5	745	14	8	0.5714285714285714	0.010738255033557046	GO:0098609	GO:BP	cell-cell adhesion	16175	18805		0.1111111111111111	0.15789473684210525	745	15430	8	6	737	15424	16175	0.07376973599285112
M1	cpdb	0	network_modules	410	TRUE	8.556880406771235e-5	279	14	6	0.42857142857142855	0.021505376344086023	GO:0031589	GO:BP	cell-substrate adhesion	16175	7233		0.16666666666666666	0.21052631578947367	279	15896	6	8	273	15888	16175	0.09298453483147688
M1	cpdb	0	network_modules	410	TRUE	1.0788843241511082e-4	2	12	2	0.16666666666666666	1	KEGG:03271	KEGG	Virion - Rotavirus	8484	235		0.2857142857142857	0.375	2	8482	2	10	0	8472	8484	0.40800756381372977
M1	cpdb	0	network_modules	410	TRUE	1.4599249340557544e-4	533	14	7	0.5	0.013133208255159476	GO:0006897	GO:BP	endocytosis	16175	2551		0.2222222222222222	0.2631578947368421	533	15642	7	7	526	15635	16175	0.07700623369321971
M1	cpdb	0	network_modules	410	TRUE	1.730037663024109e-4	150	13	5	0.38461538461538464	0.03333333333333333	REAC:R-HSA-1500931	REAC	Cell-Cell communication	10916	328		0.25	0.3333333333333333	150	10766	5	8	145	10758	10916	0.11000587265470918
M1	cpdb	0	network_modules	410	TRUE	1.8425274185759124e-4	298	13	6	0.46153846153846156	0.020134228187919462	REAC:R-HSA-1474244	REAC	Extracellular matrix organization	10916	889		0.375	0.4444444444444444	298	10618	6	7	292	10611	10916	0.09201563232510589
M1	cpdb	0	network_modules	410	TRUE	2.451412614519666e-4	84	12	4	0.3333333333333333	0.047619047619047616	KEGG:05412	KEGG	Arrhythmogenic right ventricular cardiomyopathy	8484	490		0.42857142857142855	0.5	84	8400	4	8	80	8392	8484	0.12294262181751361
M1	cpdb	0	network_modules	410	TRUE	3.5284513510020973e-4	92	12	4	0.3333333333333333	0.043478260869565216	KEGG:05222	KEGG	Small cell lung cancer	8484	473		0.5714285714285714	0.625	92	8392	4	8	88	8384	8484	0.11718906554764165
M1	cpdb	0	network_modules	410	TRUE	4.3588056803774985e-4	97	12	4	0.3333333333333333	0.041237113402061855	KEGG:05410	KEGG	Hypertrophic cardiomyopathy	8484	489		0.7142857142857143	0.75	97	8387	4	8	93	8379	8484	0.11395415392624185
M1	cpdb	0	network_modules	410	TRUE	4.734686448985397e-4	73	14	4	0.2857142857142857	0.0547945205479452	GO:0033627	GO:BP	cell adhesion mediated by integrin	16175	8328		0.2777777777777778	0.3157894736842105	73	16102	4	10	69	16092	16175	0.1234781006269666
M1	cpdb	0	network_modules	410	TRUE	5.325739984975672e-4	102	12	4	0.3333333333333333	0.0392156862745098	KEGG:05414	KEGG	Dilated cardiomyopathy	8484	491		0.8571428571428571	0.875	102	8382	4	8	98	8374	8484	0.11095569212828767
M1	cpdb	0	network_modules	410	TRUE	5.729295827294633e-4	191	13	5	0.38461538461538464	0.02617801047120419	REAC:R-HSA-202733	REAC	Cell surface interactions at the vascular wall	10916	327		0.5	0.5555555555555556	191	10725	5	8	186	10717	10916	0.09668357463033556
M1	cpdb	0	network_modules	410	TRUE	6.360384300162065e-4	19	14	3	0.21428571428571427	0.15789473684210525	GO:0048333	GO:BP	mesodermal cell differentiation	16175	12670		0.3333333333333333	0.3684210526315789	19	16156	3	11	16	16145	16175	0.1831202880115945
M1	cpdb	0	network_modules	410	TRUE	9.581837748019396e-4	25	13	3	0.23076923076923078	0.12	REAC:R-HSA-210991	REAC	Basigin interactions	10916	207		0.625	0.6666666666666666	25	10891	3	10	22	10881	10916	0.16504585838752958
M1	cpdb	0	network_modules	410	TRUE	0.0012168844279940012	27	13	3	0.23076923076923078	0.1111111111111111	REAC:R-HSA-3000170	REAC	Syndecan interactions	10916	2367		0.75	0.7777777777777778	27	10889	3	10	24	10879	10916	0.15870266976772543
M1	cpdb	0	network_modules	410	TRUE	0.0013537628465700537	740	14	7	0.5	0.00945945945945946	GO:0098657	GO:BP	import into cell	16175	18813		0.3888888888888889	0.42105263157894735	740	15435	7	7	733	15428	16175	0.06398826293119499
M1	cpdb	0	network_modules	410	TRUE	0.001505072393870592	25	14	3	0.21428571428571427	0.12	GO:0071404	GO:BP	cellular response to low-density lipoprotein particle stimulus	16175	16656		0.4444444444444444	0.47368421052631576	25	16150	3	11	22	16139	16175	0.15939229457778828
M1	cpdb	0	network_modules	410	TRUE	0.0016855947347352036	30	13	3	0.23076923076923078	0.1	REAC:R-HSA-8874081	REAC	MET activates PTK2 signaling	10916	1362		0.875	0.8888888888888888	30	10886	3	10	27	10876	10916	0.15039804678586643
M1	cpdb	0	network_modules	410	TRUE	0.0017005179442463247	26	14	3	0.21428571428571427	0.11538461538461539	GO:0055094	GO:BP	response to lipoprotein particle	16175	14244		0.5	0.5263157894736842	26	16149	3	11	23	16138	16175	0.15625642062334155
M1	cpdb	0	network_modules	410	TRUE	0.0018948486701173754	103	14	4	0.2857142857142857	0.038834951456310676	GO:0031623	GO:BP	receptor internalization	16175	7240		0.5555555555555556	0.5789473684210527	103	16072	4	10	99	16062	16175	0.10336267725595569
M1	cpdb	0	network_modules	410	TRUE	0.0019121064006808203	27	14	3	0.21428571428571427	0.1111111111111111	GO:0071402	GO:BP	cellular response to lipoprotein particle stimulus	16175	16654		0.6111111111111112	0.631578947368421	27	16148	3	11	24	16137	16175	0.15329565532848902
M1	cpdb	0	network_modules	410	TRUE	0.003234144197223559	32	14	3	0.21428571428571427	0.09375	GO:0001707	GO:BP	mesoderm formation	16175	399		0.6666666666666666	0.6842105263157895	32	16143	3	11	29	16132	16175	0.14062810170400844
M1	cpdb	0	network_modules	410	TRUE	0.003555742953386264	33	14	3	0.21428571428571427	0.09090909090909091	GO:0048332	GO:BP	mesoderm morphogenesis	16175	12669		0.7222222222222222	0.7368421052631579	33	16142	3	11	30	16131	16175	0.13844494424757176
M1	cpdb	0	network_modules	410	TRUE	0.003978868845831635	124	14	4	0.2857142857142857	0.03225806451612903	GO:0045807	GO:BP	positive regulation of endocytosis	16175	11631		0.7777777777777778	0.7894736842105263	124	16051	4	10	120	16041	16175	0.09382796287089726
M1	cpdb	0	network_modules	410	TRUE	0.004073763210550607	40	13	3	0.23076923076923078	0.075	REAC:R-HSA-8875878	REAC	MET promotes cell motility	10916	1368		1	1	40	10876	3	10	37	10866	10916	0.12978487335244196
M1	cpdb	0	network_modules	410	TRUE	0.005067885379789255	304	14	5	0.35714285714285715	0.01644736842105263	GO:0050900	GO:BP	leukocyte migration	16175	13342		0.8333333333333334	0.8421052631578947	304	15871	5	9	299	15862	16175	0.0733329927085577
M1	cpdb	0	network_modules	410	TRUE	0.00781883048350152	202	12	4	0.3333333333333333	0.019801980198019802	KEGG:04510	KEGG	Focal adhesion	8484	313		1	1	202	8282	4	8	198	8274	8484	0.07640980184509015
M1	cpdb	0	network_modules	410	TRUE	0.008582941931915012	44	14	3	0.21428571428571427	0.06818181818181818	GO:0045428	GO:BP	regulation of nitric oxide biosynthetic process	16175	11372		0.8888888888888888	0.8947368421052632	44	16131	3	11	41	16120	16175	0.11955341584191301
M1	cpdb	0	network_modules	410	TRUE	0.008625922267011534	339	14	5	0.35714285714285715	0.014749262536873156	GO:0042060	GO:BP	wound healing	16175	9947		0.9444444444444444	0.9473684210526315	339	15836	5	9	334	15827	16175	0.06907635241022951
M1	cpdb	0	network_modules	410	TRUE	0.009827550328461129	46	14	3	0.21428571428571427	0.06521739130434782	GO:0080164	GO:BP	regulation of nitric oxide metabolic process	16175	17838		1	1	46	16129	3	11	43	16118	16175	0.11686445615212243
M1	cpdb	0	network_modules	411	TRUE	2.5268255441519824e-5	199	8	5	0.625	0.02512562814070352	REAC:R-HSA-68877	REAC	Mitotic Prometaphase	10916	1484		0	0.08333333333333333	199	10717	5	3	194	10714	10916	0.12282784038432532
M1	cpdb	0	network_modules	411	TRUE	7.939218495030757e-5	92	8	4	0.5	0.043478260869565216	REAC:R-HSA-141444	REAC	Amplification  of signal from unattached  kinetochores via a MAD2  inhibitory signal	10916	143		0.09090909090909091	0.25	92	10824	4	4	88	10820	10916	0.14562478317255856
M1	cpdb	0	network_modules	411	TRUE	7.939218495030757e-5	92	8	4	0.5	0.043478260869565216	REAC:R-HSA-141424	REAC	Amplification of signal from the kinetochores	10916	144		0.09090909090909091	0.25	92	10824	4	4	88	10820	10916	0.14562478317255856
M1	cpdb	0	network_modules	411	TRUE	1.5728130075760708e-4	109	8	4	0.5	0.03669724770642202	REAC:R-HSA-69618	REAC	Mitotic Spindle Checkpoint	10916	1486		0.2727272727272727	0.3333333333333333	109	10807	4	4	105	10803	10916	0.13346862981980934
M1	cpdb	0	network_modules	411	TRUE	1.951042760782847e-4	115	8	4	0.5	0.034782608695652174	REAC:R-HSA-9648025	REAC	EML4 and NUDC in mitotic spindle formation	10916	817		0.36363636363636365	0.4166666666666667	115	10801	4	4	111	10797	10916	0.1298304910873261
M1	cpdb	0	network_modules	411	TRUE	2.5560693813107984e-4	123	8	4	0.5	0.032520325203252036	REAC:R-HSA-2500257	REAC	Resolution of Sister Chromatid Cohesion	10916	2079		0.45454545454545453	0.5	123	10793	4	4	119	10789	10916	0.12539586290623964
M1	cpdb	0	network_modules	411	TRUE	3.823850656985968e-4	136	8	4	0.5	0.029411764705882353	REAC:R-HSA-5663220	REAC	RHO GTPases Activate Formins	10916	1848		0.5454545454545454	0.5833333333333334	136	10780	4	4	132	10776	10916	0.11903329742635485
M1	cpdb	0	network_modules	411	TRUE	3.92443605405667e-4	361	14	6	0.42857142857142855	0.01662049861495845	GO:0007059	GO:BP	chromosome segregation	16175	2658		0	0.2	361	15814	6	8	355	15806	16175	0.08094617720383208
M1	cpdb	0	network_modules	411	TRUE	8.732591146184423e-4	406	8	5	0.625	0.012315270935960592	REAC:R-HSA-68886	REAC	M Phase	10916	1343		0.6363636363636364	0.6666666666666666	406	10510	5	3	401	10507	10916	0.08412135366597516
M1	cpdb	0	network_modules	411	TRUE	0.0013920820370064277	188	8	4	0.5	0.02127659574468085	REAC:R-HSA-2467813	REAC	Separation of Sister Chromatids	10916	2204		0.7272727272727273	0.75	188	10728	4	4	184	10724	10916	0.10049506536812723
M1	cpdb	0	network_modules	411	TRUE	0.0018948486701173754	103	14	4	0.2857142857142857	0.038834951456310676	GO:0051303	GO:BP	establishment of chromosome localization	16175	13634		0.25	0.4	103	16072	4	10	99	16062	16175	0.10336267725595569
M1	cpdb	0	network_modules	411	TRUE	0.002291081797269228	108	14	4	0.2857142857142857	0.037037037037037035	GO:0050000	GO:BP	chromosome localization	16175	13183		0.5	0.6	108	16067	4	10	104	16057	16175	0.10084565751318594
M1	cpdb	0	network_modules	411	TRUE	0.0029927473211793206	228	8	4	0.5	0.017543859649122806	REAC:R-HSA-68882	REAC	Mitotic Anaphase	10916	1479		0.8181818181818182	0.8333333333333334	228	10688	4	4	224	10684	10916	0.09073157956419414
M1	cpdb	0	network_modules	411	TRUE	0.0030450454979980687	229	8	4	0.5	0.017467248908296942	REAC:R-HSA-2555396	REAC	Mitotic Metaphase and Anaphase	10916	1482		0.9090909090909091	0.9166666666666666	229	10687	4	4	225	10683	10916	0.09052018332333008
M1	cpdb	0	network_modules	411	TRUE	0.006618620905532137	586	14	6	0.42857142857142855	0.010238907849829351	GO:0000226	GO:BP	microtubule cytoskeleton organization	16175	61		0.75	0.8	586	15589	6	8	580	15581	16175	0.061799051622311314
M1	cpdb	0	network_modules	411	TRUE	0.007628837525293127	289	8	4	0.5	0.01384083044982699	REAC:R-HSA-69620	REAC	Cell Cycle Checkpoints	10916	321		1	1	289	10627	4	4	285	10623	10916	0.07987754330802299
M1	cpdb	0	network_modules	411	TRUE	0.009175567617022975	153	14	4	0.2857142857142857	0.026143790849673203	GO:1902850	GO:BP	microtubule cytoskeleton organization involved in mitosis	16175	22560		1	1	153	16022	4	10	149	16012	16175	0.08400026258204366
M1	cpdb	0	network_modules	412	TRUE	3.25286448155265e-10	147	15	8	0.5333333333333333	0.05442176870748299	GO:0070507	GO:BP	regulation of microtubule cytoskeleton organization	16175	16162		0	0.05	147	16028	8	7	139	16021	16175	0.16830824738489258
M1	cpdb	0	network_modules	412	TRUE	9.543274529579238e-10	88	15	7	0.4666666666666667	0.07954545454545454	GO:0031110	GO:BP	regulation of microtubule polymerization or depolymerization	16175	7035		0.05263157894736842	0.1	88	16087	7	8	81	16079	16175	0.19103120573509635
M1	cpdb	0	network_modules	412	TRUE	1.1140030096914336e-8	124	15	7	0.4666666666666667	0.056451612903225805	GO:0031109	GO:BP	microtubule polymerization or depolymerization	16175	7034		0.10526315789473684	0.15	124	16051	7	8	117	16043	16175	0.16033211579585083
M1	cpdb	0	network_modules	412	TRUE	1.2792625597208597e-8	586	15	10	0.6666666666666666	0.017064846416382253	GO:0000226	GO:BP	microtubule cytoskeleton organization	16175	61		0.15789473684210525	0.2	586	15589	10	5	576	15584	16175	0.10279065433331484
M1	cpdb	0	network_modules	412	TRUE	1.3015669432658779e-8	232	15	8	0.5333333333333333	0.034482758620689655	GO:0032886	GO:BP	regulation of microtubule-based process	16175	7882		0.21052631578947367	0.25	232	15943	8	7	224	15936	16175	0.13298399997004176
M1	cpdb	0	network_modules	412	TRUE	2.016694285998791e-6	58	15	5	0.3333333333333333	0.08620689655172414	GO:0031113	GO:BP	regulation of microtubule polymerization	16175	7038		0.2631578947368421	0.3	58	16117	5	10	53	16107	16175	0.16807174999990443
M1	cpdb	0	network_modules	412	TRUE	2.128218566574565e-6	440	15	8	0.5333333333333333	0.01818181818181818	GO:0051493	GO:BP	regulation of cytoskeleton organization	16175	13748		0.3157894736842105	0.35	440	15735	8	7	432	15728	16175	0.09479214421370309
M1	cpdb	0	network_modules	412	TRUE	1.6976874273871162e-5	88	15	5	0.3333333333333333	0.056818181818181816	GO:0046785	GO:BP	microtubule polymerization	16175	12369		0.3684210526315789	0.4	88	16087	5	10	83	16077	16175	0.13580704680090783
M1	cpdb	0	network_modules	412	TRUE	1.7967039783381114e-5	30	15	4	0.26666666666666666	0.13333333333333333	GO:0031116	GO:BP	positive regulation of microtubule polymerization	16175	7041		0.42105263157894735	0.45	30	16145	4	11	26	16134	16175	0.18751118232966826
M1	cpdb	0	network_modules	412	TRUE	2.6783824775235827e-5	33	15	4	0.26666666666666666	0.12121212121212122	GO:0031112	GO:BP	positive regulation of microtubule polymerization or depolymerization	16175	7037		0.47368421052631576	0.5	33	16142	4	11	29	16131	16175	0.17867627965303068
M1	cpdb	0	network_modules	412	TRUE	1.0605738208084092e-4	46	15	4	0.26666666666666666	0.08695652173913043	GO:0007020	GO:BP	microtubule nucleation	16175	2628		0.5263157894736842	0.55	46	16129	4	11	42	16118	16175	0.15093810133310476
M1	cpdb	0	network_modules	412	TRUE	3.29805018185827e-4	318	15	6	0.4	0.018867924528301886	GO:1902903	GO:BP	regulation of supramolecular fiber organization	16175	22602		0.5789473684210527	0.6	318	15857	6	9	312	15848	16175	0.08346746140987482
M1	cpdb	0	network_modules	412	TRUE	3.532983040474942e-4	161	15	5	0.3333333333333333	0.031055900621118012	GO:0032271	GO:BP	regulation of protein polymerization	16175	7452		0.631578947368421	0.65	161	16014	5	10	156	16004	16175	0.0992474017465455
M1	cpdb	0	network_modules	412	TRUE	8.556442765369511e-4	199	7	4	0.5714285714285714	0.020100502512562814	REAC:R-HSA-68877	REAC	Mitotic Prometaphase	10916	1484		0	0.16666666666666666	199	10717	4	3	195	10714	10916	0.10474610377636591
M1	cpdb	0	network_modules	412	TRUE	9.590940815665188e-4	79	15	4	0.26666666666666666	0.05063291139240506	GO:0032273	GO:BP	positive regulation of protein polymerization	16175	7454		0.6842105263157895	0.7	79	16096	4	11	75	16085	16175	0.11440301427631948
M1	cpdb	0	network_modules	412	TRUE	0.0013655405893561465	22	15	3	0.2	0.13636363636363635	GO:0007026	GO:BP	negative regulation of microtubule depolymerization	16175	2631		0.7368421052631579	0.75	22	16153	3	12	19	16141	16175	0.16420929627491795
M1	cpdb	0	network_modules	412	TRUE	0.0023003290226343157	26	15	3	0.2	0.11538461538461539	GO:0031114	GO:BP	regulation of microtubule depolymerization	16175	7039		0.7894736842105263	0.8	26	16149	3	12	23	16137	16175	0.15088121656469844
M1	cpdb	0	network_modules	412	TRUE	0.002345712237647435	8	7	2	0.2857142857142857	0.25	REAC:R-HSA-428890	REAC	Role of ABL in ROBO-SLIT signaling	10916	2107		0.2	0.3333333333333333	8	10908	2	5	6	10903	10916	0.26675898657003766
M1	cpdb	0	network_modules	412	TRUE	0.0024456621446254266	238	15	5	0.3333333333333333	0.02100840336134454	GO:0051258	GO:BP	protein polymerization	16175	13605		0.8421052631578947	0.85	238	15937	5	10	233	15927	16175	0.08062124711845947
M1	cpdb	0	network_modules	412	TRUE	0.004711579257946325	92	7	3	0.42857142857142855	0.03260869565217391	REAC:R-HSA-141444	REAC	Amplification  of signal from unattached  kinetochores via a MAD2  inhibitory signal	10916	143		0.4	0.6666666666666666	92	10824	3	4	89	10820	10916	0.11642060460659594
M1	cpdb	0	network_modules	412	TRUE	0.004711579257946325	92	7	3	0.42857142857142855	0.03260869565217391	REAC:R-HSA-141424	REAC	Amplification of signal from the kinetochores	10916	144		0.4	0.6666666666666666	92	10824	3	4	89	10820	10916	0.11642060460659594
M1	cpdb	0	network_modules	412	TRUE	0.005270763028865815	34	15	3	0.2	0.08823529411764706	GO:0031111	GO:BP	negative regulation of microtubule polymerization or depolymerization	16175	7036		0.8947368421052632	0.9	34	16141	3	12	31	16129	16175	0.13164547873328894
M1	cpdb	0	network_modules	412	TRUE	0.007413973931031235	38	15	3	0.2	0.07894736842105263	GO:0010634	GO:BP	positive regulation of epithelial cell migration	16175	4280		0.9473684210526315	0.95	38	16137	3	12	35	16125	16175	0.1243839630022159
M1	cpdb	0	network_modules	412	TRUE	0.007839494632886612	109	7	3	0.42857142857142855	0.027522935779816515	REAC:R-HSA-69618	REAC	Mitotic Spindle Checkpoint	10916	1486		0.8	0.8333333333333334	109	10807	3	4	106	10803	10916	0.10664464170333712
M1	cpdb	0	network_modules	412	TRUE	0.00920480209683797	115	7	3	0.42857142857142855	0.02608695652173913	REAC:R-HSA-9648025	REAC	EML4 and NUDC in mitotic spindle formation	10916	817		1	1	115	10801	3	4	112	10797	10916	0.10371780266984948
M1	cpdb	0	network_modules	412	TRUE	0.009352895688694907	41	15	3	0.2	0.07317073170731707	GO:0007019	GO:BP	microtubule depolymerization	16175	2627		1	1	41	16134	3	12	38	16122	16175	0.11964564862587004
M1	cpdb	0	network_modules	415	TRUE	5.591204597131556e-25	28	10	10	1	0.35714285714285715	REAC:R-HSA-3928663	REAC	EPHA-mediated growth cone collapse	10916	820		0	0.3333333333333333	28	10888	10	0	18	10888	10916	0.5971209294748977
M1	cpdb	0	network_modules	415	TRUE	3.5012681553149425e-22	49	10	10	1	0.20408163265306123	REAC:R-HSA-3928665	REAC	EPH-ephrin mediated repulsion of cells	10916	819		0.5	0.6666666666666666	49	10867	10	0	39	10867	10916	0.4509454889895816
M1	cpdb	0	network_modules	415	TRUE	2.6180783621777995e-21	44	13	10	0.7692307692307693	0.22727272727272727	GO:0048013	GO:BP	ephrin receptor signaling pathway	16175	12469		0	0.07142857142857142	44	16131	10	3	34	16128	16175	0.41737799768438666
M1	cpdb	0	network_modules	415	TRUE	2.437326161022539e-19	90	10	10	1	0.1111111111111111	REAC:R-HSA-2682334	REAC	EPH-Ephrin signaling	10916	818		1	1	90	10826	10	0	80	10826	10916	0.3321085144447048
M1	cpdb	0	network_modules	415	TRUE	3.2261876463036704e-15	165	13	10	0.7692307692307693	0.06060606060606061	GO:0007411	GO:BP	axon guidance	16175	2906		0.07692307692307693	0.21428571428571427	165	16010	10	3	155	16007	16175	0.21423460696024088
M1	cpdb	0	network_modules	415	TRUE	3.2261876463036704e-15	165	13	10	0.7692307692307693	0.06060606060606061	GO:0097485	GO:BP	neuron projection guidance	16175	18673		0.07692307692307693	0.21428571428571427	165	16010	10	3	155	16007	16175	0.21423460696024088
M1	cpdb	0	network_modules	415	TRUE	4.060777835911837e-14	181	9	9	1	0.049723756906077346	KEGG:04360	KEGG	Axon guidance	8484	305		0	0.25	181	8303	9	0	172	8303	8484	0.22071387358536673
M1	cpdb	0	network_modules	415	TRUE	1.2761215994206043e-12	297	13	10	0.7692307692307693	0.03367003367003367	GO:0007409	GO:BP	axonogenesis	16175	2905		0.23076923076923078	0.2857142857142857	297	15878	10	3	287	15875	16175	0.158619480540679
M1	cpdb	0	network_modules	415	TRUE	2.537310399527662e-12	510	13	11	0.8461538461538461	0.021568627450980392	GO:0007169	GO:BP	cell surface receptor protein tyrosine kinase signaling pathway	16175	2733		0.3076923076923077	0.35714285714285715	510	15665	11	2	499	15663	16175	0.13221330794992286
M1	cpdb	0	network_modules	415	TRUE	4.847445761892721e-12	339	13	10	0.7692307692307693	0.029498525073746312	GO:0061564	GO:BP	axon development	16175	15561		0.38461538461538464	0.42857142857142855	339	15836	10	3	329	15833	16175	0.14815134664843607
M1	cpdb	0	network_modules	415	TRUE	1.4897508171809547e-11	379	13	10	0.7692307692307693	0.026385224274406333	GO:0048667	GO:BP	cell morphogenesis involved in neuron differentiation	16175	12925		0.46153846153846156	0.5	379	15796	10	3	369	15793	16175	0.13982903571779498
M1	cpdb	0	network_modules	415	TRUE	6.820649911701313e-11	441	13	10	0.7692307692307693	0.022675736961451247	GO:0048812	GO:BP	neuron projection morphogenesis	16175	13058		0.5384615384615384	0.5714285714285714	441	15734	10	3	431	15731	16175	0.12921526652679585
M1	cpdb	0	network_modules	415	TRUE	9.537631188312339e-11	456	13	10	0.7692307692307693	0.021929824561403508	GO:0120039	GO:BP	plasma membrane bounded cell projection morphogenesis	16175	19473		0.6153846153846154	0.6428571428571429	456	15719	10	3	446	15716	16175	0.12697396124352947
M1	cpdb	0	network_modules	415	TRUE	1.0409929329891347e-10	460	13	10	0.7692307692307693	0.021739130434782608	GO:0048858	GO:BP	cell projection morphogenesis	16175	13102		0.6923076923076923	0.7142857142857143	460	15715	10	3	450	15712	16175	0.12639458957708966
M1	cpdb	0	network_modules	415	TRUE	3.1439953480377e-10	790	13	11	0.8461538461538461	0.013924050632911392	GO:0007167	GO:BP	enzyme-linked receptor protein signaling pathway	16175	2731		0.7692307692307693	0.7857142857142857	790	15385	11	2	779	15383	16175	0.10491437231927256
M1	cpdb	0	network_modules	415	TRUE	3.340887048942093e-9	651	13	10	0.7692307692307693	0.015360983102918587	GO:0000902	GO:BP	cell morphogenesis	16175	240		0.8461538461538461	0.8571428571428571	651	15524	10	3	641	15521	16175	0.10519468221368494
M1	cpdb	0	network_modules	415	TRUE	5.464694483811188e-9	684	13	10	0.7692307692307693	0.014619883040935672	GO:0031175	GO:BP	neuron projection development	16175	7086		0.9230769230769231	0.9285714285714286	684	15491	10	3	674	15488	16175	0.10244745349848813
M1	cpdb	0	network_modules	415	TRUE	1.5772283500774287e-8	761	13	10	0.7692307692307693	0.013140604467805518	GO:0048666	GO:BP	neuron development	16175	12924		1	1	761	15414	10	3	751	15411	16175	0.09673097892173899
M1	cpdb	0	network_modules	415	TRUE	0.002253978923787456	210	9	4	0.4444444444444444	0.01904761904761905	KEGG:04015	KEGG	Rap1 signaling pathway	8484	248		0.3333333333333333	0.5	210	8274	4	5	206	8269	8484	0.08802688110088136
M1	cpdb	0	network_modules	415	TRUE	0.003503215481853689	235	9	4	0.4444444444444444	0.01702127659574468	KEGG:04014	KEGG	Ras signaling pathway	8484	247		0.6666666666666666	0.75	235	8249	4	5	231	8244	8484	0.08275383564272067
M1	cpdb	0	network_modules	415	TRUE	0.009185586181021034	301	9	4	0.4444444444444444	0.013289036544850499	KEGG:04010	KEGG	MAPK signaling pathway	8484	243		1	1	301	8183	4	5	297	8178	8484	0.07204430094717251
M1	cpdb	0	network_modules	416	TRUE	4.886983032262333e-15	9	11	6	0.5454545454545454	0.6666666666666666	REAC:R-HSA-629597	REAC	Highly calcium permeable nicotinic acetylcholine receptors	10916	1124		0	0.1111111111111111	9	10907	6	5	3	10902	10916	0.6026632888392229
M1	cpdb	0	network_modules	416	TRUE	2.6857288515246776e-14	11	11	6	0.5454545454545454	0.5454545454545454	REAC:R-HSA-629594	REAC	Highly calcium permeable postsynaptic nicotinic acetylcholine receptors	10916	1125		0.125	0.2222222222222222	11	10905	6	5	5	10900	10916	0.5449960401817349
M1	cpdb	0	network_modules	416	TRUE	5.369346903380126e-14	12	11	6	0.5454545454545454	0.5	REAC:R-HSA-622323	REAC	Presynaptic nicotinic acetylcholine receptors	10916	1792		0.25	0.3333333333333333	12	10904	6	5	6	10899	10916	0.5217301075633721
M1	cpdb	0	network_modules	416	TRUE	1.7436663843019792e-13	14	11	6	0.5454545454545454	0.42857142857142855	REAC:R-HSA-622327	REAC	Postsynaptic nicotinic acetylcholine receptors	10916	1779		0.375	0.5555555555555556	14	10902	6	5	8	10897	10916	0.482909933632344
M1	cpdb	0	network_modules	416	TRUE	1.7436663843019792e-13	14	11	6	0.5454545454545454	0.42857142857142855	REAC:R-HSA-181431	REAC	Acetylcholine binding and downstream events	10916	54		0.375	0.5555555555555556	14	10902	6	5	8	10897	10916	0.482909933632344
M1	cpdb	0	network_modules	416	TRUE	8.658627379465802e-12	23	13	6	0.46153846153846156	0.2608695652173913	GO:0007271	GO:BP	synaptic transmission, cholinergic	16175	2799		0	0.1	23	16152	6	7	17	16145	16175	0.34630532067763964
M1	cpdb	0	network_modules	416	TRUE	6.927641464339759e-11	365	12	10	0.8333333333333334	0.0273972602739726	KEGG:04080	KEGG	Neuroactive ligand-receptor interaction	8484	263		0	0.5	365	8119	10	2	355	8117	8484	0.146588104372954
M1	cpdb	0	network_modules	416	TRUE	4.367777937326398e-10	196	11	8	0.7272727272727273	0.04081632653061224	REAC:R-HSA-112314	REAC	Neurotransmitter receptors and postsynaptic signal transmission	10916	1594		0.625	0.6666666666666666	196	10720	8	3	188	10717	10916	0.16965327180194614
M1	cpdb	0	network_modules	416	TRUE	1.4868514703875145e-9	18	13	5	0.38461538461538464	0.2777777777777778	GO:0035094	GO:BP	response to nicotine	16175	8806		0.1111111111111111	0.2	18	16157	5	8	13	16149	16175	0.3262271201241849
M1	cpdb	0	network_modules	416	TRUE	4.142288073778014e-9	259	11	8	0.7272727272727273	0.03088803088803089	REAC:R-HSA-112315	REAC	Transmission across Chemical Synapses	10916	2580		0.75	0.7777777777777778	259	10657	8	3	251	10654	10916	0.14681560594444779
M1	cpdb	0	network_modules	416	TRUE	1.5177955783829e-8	487	13	9	0.6923076923076923	0.018480492813141684	GO:0098916	GO:BP	anterograde trans-synaptic signaling	16175	18949		0.2222222222222222	0.4	487	15688	9	4	478	15684	16175	0.10990285950943669
M1	cpdb	0	network_modules	416	TRUE	1.5177955783829e-8	487	13	9	0.6923076923076923	0.018480492813141684	GO:0007268	GO:BP	chemical synaptic transmission	16175	2796		0.2222222222222222	0.4	487	15688	9	4	478	15684	16175	0.10990285950943669
M1	cpdb	0	network_modules	416	TRUE	1.6633060681031205e-8	492	13	9	0.6923076923076923	0.018292682926829267	GO:0099537	GO:BP	trans-synaptic signaling	16175	19116		0.4444444444444444	0.5	492	15683	9	4	483	15679	16175	0.1093093625789823
M1	cpdb	0	network_modules	416	TRUE	2.548258353758199e-8	516	13	9	0.6923076923076923	0.01744186046511628	GO:0099536	GO:BP	synaptic signaling	16175	19115		0.5555555555555556	0.6	516	15659	9	4	507	15655	16175	0.10657932444423683
M1	cpdb	0	network_modules	416	TRUE	1.345168071821608e-7	400	11	8	0.7272727272727273	0.02	REAC:R-HSA-112316	REAC	Neuronal System	10916	1590		0.875	0.8888888888888888	400	10516	8	3	392	10513	10916	0.11674458066861806
M1	cpdb	0	network_modules	416	TRUE	5.064913863581528e-6	5	13	3	0.23076923076923078	0.6	GO:0035095	GO:BP	behavioral response to nicotine	16175	8807		0.6666666666666666	0.7	5	16170	3	10	2	16160	16175	0.37181265756466664
M1	cpdb	0	network_modules	416	TRUE	7.866107937110044e-6	7	11	3	0.2727272727272727	0.42857142857142855	REAC:R-HSA-629587	REAC	Highly sodium permeable postsynaptic acetylcholine nicotinic receptors	10916	1126		1	1	7	10909	3	8	4	10901	10916	0.3413593156786807
M1	cpdb	0	network_modules	416	TRUE	1.2004740712537166e-5	40	12	4	0.3333333333333333	0.1	KEGG:05033	KEGG	Nicotine addiction	8484	421		1	1	40	8444	4	8	36	8436	8484	0.18054535141216266
M1	cpdb	0	network_modules	416	TRUE	0.0022351010928117155	3	13	2	0.15384615384615385	0.6666666666666666	GO:0060084	GO:BP	synaptic transmission involved in micturition	16175	14343		0.7777777777777778	0.8	3	16172	2	11	1	16161	16175	0.32002851642455643
M1	cpdb	0	network_modules	416	TRUE	0.004468175280053667	4	13	2	0.15384615384615385	0.5	GO:0060073	GO:BP	micturition	16175	14334		0.8888888888888888	0.9	4	16171	2	11	2	16160	16175	0.27704988141747466
M1	cpdb	0	network_modules	416	TRUE	0.004923518067838783	40	13	3	0.23076923076923078	0.075	GO:0030534	GO:BP	adult behavior	16175	6837		1	1	40	16135	3	10	37	16125	16175	0.13036252571258025
M1	cpdb	0	network_modules	417	TRUE	7.746371503309772e-12	14	7	5	0.7142857142857143	0.35714285714285715	REAC:R-HSA-193775	REAC	Synthesis of bile acids and bile salts via 24-hydroxycholesterol	10916	2402		0	0.1111111111111111	14	10902	5	2	9	10900	10916	0.5046548417463964
M1	cpdb	0	network_modules	417	TRUE	1.161778116951591e-11	15	7	5	0.7142857142857143	0.3333333333333333	REAC:R-HSA-193807	REAC	Synthesis of bile acids and bile salts via 27-hydroxycholesterol	10916	2403		0.125	0.2222222222222222	15	10901	5	2	10	10899	10916	0.48750261394068567
M1	cpdb	0	network_modules	417	TRUE	4.701515647999557e-11	4	9	4	0.4444444444444444	1	GO:0009753	GO:BP	response to jasmonic acid	16175	3650		0	0.0625	4	16171	4	5	0	16166	16175	0.666563593540822
M1	cpdb	0	network_modules	417	TRUE	4.701515647999557e-11	4	9	4	0.4444444444444444	1	GO:0071395	GO:BP	cellular response to jasmonic acid stimulus	16175	16647		0	0.0625	4	16171	4	5	0	16166	16175	0.666563593540822
M1	cpdb	0	network_modules	417	TRUE	1.3001957366959103e-10	23	7	5	0.7142857142857143	0.21739130434782608	REAC:R-HSA-193368	REAC	Synthesis of bile acids and bile salts via 7alpha-hydroxycholesterol	10916	2404		0.25	0.3333333333333333	23	10893	5	2	18	10891	10916	0.39343355422814863
M1	cpdb	0	network_modules	417	TRUE	9.156629558567912e-10	33	7	5	0.7142857142857143	0.15151515151515152	REAC:R-HSA-192105	REAC	Synthesis of bile acids and bile salts	10916	2401		0.375	0.4444444444444444	33	10883	5	2	28	10881	10916	0.32818504148848504
M1	cpdb	0	network_modules	417	TRUE	2.4567626462339022e-9	31	9	5	0.5555555555555556	0.16129032258064516	GO:0008207	GO:BP	C21-steroid hormone metabolic process	16175	3134		0.06451612903225806	0.09375	31	16144	5	4	26	16140	16175	0.298678887398768
M1	cpdb	0	network_modules	417	TRUE	4.182861409064158e-9	44	7	5	0.7142857142857143	0.11363636363636363	REAC:R-HSA-194068	REAC	Bile acid and bile salt metabolism	10916	222		0.5	0.5555555555555556	44	10872	5	2	39	10870	10916	0.28395745509412307
M1	cpdb	0	network_modules	417	TRUE	5.9165861523719674e-9	9	9	4	0.4444444444444444	0.4444444444444444	GO:0044597	GO:BP	daunorubicin metabolic process	16175	11097		0.0967741935483871	0.15625	9	16166	4	5	5	16161	16175	0.44413515333965653
M1	cpdb	0	network_modules	417	TRUE	5.9165861523719674e-9	9	9	4	0.4444444444444444	0.4444444444444444	GO:0030647	GO:BP	aminoglycoside antibiotic metabolic process	16175	6873		0.0967741935483871	0.15625	9	16166	4	5	5	16161	16175	0.44413515333965653
M1	cpdb	0	network_modules	417	TRUE	9.85853724226824e-9	10	9	4	0.4444444444444444	0.4	GO:0030638	GO:BP	polyketide metabolic process	16175	6865		0.16129032258064516	0.21875	10	16165	4	5	6	16160	16175	0.42129794876168336
M1	cpdb	0	network_modules	417	TRUE	9.85853724226824e-9	10	9	4	0.4444444444444444	0.4	GO:0044598	GO:BP	doxorubicin metabolic process	16175	11098		0.16129032258064516	0.21875	10	16165	4	5	6	16160	16175	0.42129794876168336
M1	cpdb	0	network_modules	417	TRUE	1.7829292460399833e-8	62	7	5	0.7142857142857143	0.08064516129032258	KEGG:00140	KEGG	Steroid hormone biosynthesis	8484	17		0	0.3333333333333333	62	8422	5	2	57	8420	8484	0.23852336443804945
M1	cpdb	0	network_modules	417	TRUE	3.354106274274072e-8	13	9	4	0.4444444444444444	0.3076923076923077	GO:0042448	GO:BP	progesterone metabolic process	16175	10188		0.22580645161290322	0.25	13	16162	4	5	9	16157	16175	0.36938260998762795
M1	cpdb	0	network_modules	417	TRUE	6.40012515644345e-8	15	9	4	0.4444444444444444	0.26666666666666666	GO:0016137	GO:BP	glycoside metabolic process	16175	5155		0.25806451612903225	0.28125	15	16160	4	5	11	16155	16175	0.34380192628602196
M1	cpdb	0	network_modules	417	TRUE	1.433688382369128e-7	18	9	4	0.4444444444444444	0.2222222222222222	GO:0071398	GO:BP	cellular response to fatty acid	16175	16650		0.2903225806451613	0.3125	18	16157	4	5	14	16152	16175	0.3137446621307518
M1	cpdb	0	network_modules	417	TRUE	3.4238729435414253e-7	22	9	4	0.4444444444444444	0.18181818181818182	GO:1902644	GO:BP	tertiary alcohol metabolic process	16175	22413		0.3225806451612903	0.34375	22	16153	4	5	18	16148	16175	0.2836695384320191
M1	cpdb	0	network_modules	417	TRUE	8.204323817206578e-7	27	9	4	0.4444444444444444	0.14814814814814814	GO:0070542	GO:BP	response to fatty acid	16175	16171		0.3548387096774194	0.375	27	16148	4	5	23	16143	16175	0.25592121801151496
M1	cpdb	0	network_modules	417	TRUE	2.396648186760478e-6	152	7	5	0.7142857142857143	0.03289473684210526	REAC:R-HSA-8957322	REAC	Metabolism of steroids	10916	1438		0.625	0.6666666666666666	152	10764	5	2	147	10762	10916	0.15140266358837307
M1	cpdb	0	network_modules	417	TRUE	3.4413362121310695e-6	38	9	4	0.4444444444444444	0.10526315789473684	GO:0006693	GO:BP	prostaglandin metabolic process	16175	2401		0.3870967741935484	0.40625	38	16137	4	5	34	16132	16175	0.21546503272793058
M1	cpdb	0	network_modules	417	TRUE	3.8336819279939385e-6	39	9	4	0.4444444444444444	0.10256410256410256	GO:0006692	GO:BP	prostanoid metabolic process	16175	2400		0.41935483870967744	0.4375	39	16136	4	5	35	16131	16175	0.21266156921336687
M1	cpdb	0	network_modules	417	TRUE	6.319459196804008e-6	44	9	4	0.4444444444444444	0.09090909090909091	GO:0019748	GO:BP	secondary metabolic process	16175	6032		0.45161290322580644	0.46875	44	16131	4	5	40	16126	16175	0.20010524080136688
M1	cpdb	0	network_modules	417	TRUE	2.0297554331470692e-5	179	9	5	0.5555555555555556	0.027932960893854747	GO:0042445	GO:BP	hormone metabolic process	16175	10185		0.4838709677419355	0.5	179	15996	5	4	174	15992	16175	0.12280646483364911
M1	cpdb	0	network_modules	417	TRUE	2.4191157379087074e-5	61	9	4	0.4444444444444444	0.06557377049180328	GO:1901657	GO:BP	glycosyl compound metabolic process	16175	21624		0.5161290322580645	0.53125	61	16114	4	5	57	16109	16175	0.16963454237752051
M1	cpdb	0	network_modules	417	TRUE	3.768622432600096e-5	68	9	4	0.4444444444444444	0.058823529411764705	GO:0034308	GO:BP	primary alcohol metabolic process	16175	8562		0.5483870967741935	0.5625	68	16107	4	5	64	16102	16175	0.16054337590677803
M1	cpdb	0	network_modules	417	TRUE	9.182680688819871e-5	242	9	5	0.5555555555555556	0.02066115702479339	GO:0008202	GO:BP	steroid metabolic process	16175	3129		0.5806451612903226	0.59375	242	15933	5	4	237	15929	16175	0.10507010686474097
M1	cpdb	0	network_modules	417	TRUE	1.2395379962747472e-4	257	9	5	0.5555555555555556	0.019455252918287938	GO:0006066	GO:BP	alcohol metabolic process	16175	1933		0.6129032258064516	0.625	257	15918	5	4	252	15914	16175	0.10183080505138847
M1	cpdb	0	network_modules	417	TRUE	1.659207309924997e-4	98	9	4	0.4444444444444444	0.04081632653061224	GO:0033559	GO:BP	unsaturated fatty acid metabolic process	16175	8288		0.6451612903225806	0.65625	98	16077	4	5	94	16072	16175	0.13329231291308055
M1	cpdb	0	network_modules	417	TRUE	2.455454772993959e-4	108	9	4	0.4444444444444444	0.037037037037037035	GO:0006690	GO:BP	icosanoid metabolic process	16175	2398		0.6774193548387096	0.6875	108	16067	4	5	104	16062	16175	0.12683189243509227
M1	cpdb	0	network_modules	417	TRUE	4.8636759251119015e-4	128	9	4	0.4444444444444444	0.03125	GO:0120254	GO:BP	olefinic compound metabolic process	16175	19583		0.7096774193548387	0.71875	128	16047	4	5	124	16042	16175	0.11624584366948895
M1	cpdb	0	network_modules	417	TRUE	5.035202984542067e-4	44	7	3	0.42857142857142855	0.06818181818181818	REAC:R-HSA-975634	REAC	Retinoid metabolism and transport	10916	2093		0.75	0.7777777777777778	44	10872	3	4	41	10868	10916	0.16972987623919059
M1	cpdb	0	network_modules	417	TRUE	6.568478028900891e-4	48	7	3	0.42857142857142855	0.0625	REAC:R-HSA-6806667	REAC	Metabolism of fat-soluble vitamins	10916	1424		0.875	0.8888888888888888	48	10868	3	4	45	10864	10916	0.16239359860749447
M1	cpdb	0	network_modules	417	TRUE	6.70812473390063e-4	361	9	5	0.5555555555555556	0.013850415512465374	GO:0010817	GO:BP	regulation of hormone levels	16175	4429		0.7419354838709677	0.75	361	15814	5	4	356	15810	16175	0.08517461865012182
M1	cpdb	0	network_modules	417	TRUE	7.159669637249812e-4	221	7	4	0.5714285714285714	0.01809954751131222	KEGG:05208	KEGG	Chemical carcinogenesis - reactive oxygen species	8484	460		0.5	0.6666666666666666	221	8263	4	3	217	8260	8484	0.09839259498442289
M1	cpdb	0	network_modules	417	TRUE	8.780896073663263e-4	3	9	2	0.2222222222222222	0.6666666666666666	GO:0071798	GO:BP	response to prostaglandin D	16175	16912		0.7741935483870968	0.8125	3	16172	2	7	1	16165	16175	0.38472164991098856
M1	cpdb	0	network_modules	417	TRUE	8.780896073663263e-4	3	9	2	0.2222222222222222	0.6666666666666666	GO:0071799	GO:BP	cellular response to prostaglandin D stimulus	16175	16913		0.7741935483870968	0.8125	3	16172	2	7	1	16165	16175	0.38472164991098856
M1	cpdb	0	network_modules	417	TRUE	0.001073584895185017	397	9	5	0.5555555555555556	0.012594458438287154	GO:1901615	GO:BP	organic hydroxy compound metabolic process	16175	21597		0.8387096774193549	0.84375	397	15778	5	4	392	15774	16175	0.08097425466099792
M1	cpdb	0	network_modules	417	TRUE	0.0014390498201594388	42	9	3	0.3333333333333333	0.07142857142857142	GO:0008206	GO:BP	bile acid metabolic process	16175	3133		0.8709677419354839	0.875	42	16133	3	6	39	16127	16175	0.1533431843759782
M1	cpdb	0	network_modules	417	TRUE	0.0014799930772704478	169	9	4	0.4444444444444444	0.023668639053254437	GO:0042180	GO:BP	ketone metabolic process	16175	10008		0.9032258064516129	0.90625	169	16006	4	5	165	16001	16175	0.10070834222827363
M1	cpdb	0	network_modules	417	TRUE	0.0034800848412278903	504	9	5	0.5555555555555556	0.00992063492063492	GO:0032787	GO:BP	monocarboxylic acid metabolic process	16175	7822		0.9354838709677419	0.9375	504	15671	5	4	499	15667	16175	0.07121316715629995
M1	cpdb	0	network_modules	417	TRUE	0.003830095035117686	17	7	2	0.2857142857142857	0.11764705882352941	KEGG:00120	KEGG	Primary bile acid biosynthesis	8484	14		1	1	17	8467	2	5	15	8462	8484	0.18231179964996866
M1	cpdb	0	network_modules	417	TRUE	0.005524097385964782	97	7	3	0.42857142857142855	0.030927835051546393	REAC:R-HSA-2187338	REAC	Visual phototransduction	10916	2654		1	1	97	10819	3	4	94	10815	10916	0.113282936768363
M1	cpdb	0	network_modules	417	TRUE	0.006808462970229872	70	9	3	0.3333333333333333	0.04285714285714286	GO:0001523	GO:BP	retinoid metabolic process	16175	329		0.967741935483871	0.96875	70	16105	3	6	67	16099	16175	0.11826010249410746
M1	cpdb	0	network_modules	417	TRUE	0.007413779946994887	72	9	3	0.3333333333333333	0.041666666666666664	GO:0016101	GO:BP	diterpenoid metabolic process	16175	5119		1	1	72	16103	3	6	69	16097	16175	0.1165694487750729
M1	cpdb	0	network_modules	418	TRUE	0.0018001927016410263	11	5	2	0.4	0.18181818181818182	REAC:R-HSA-2485179	REAC	Activation of the phototransduction cascade	10916	106		NA	1	11	10905	2	3	9	10902	10916	0.2691978540546046
M1	cpdb	0	network_modules	418	TRUE	0.0036201987426153965	29	4	2	0.5	0.06896551724137931	KEGG:04744	KEGG	Phototransduction	8484	362		NA	1	29	8455	2	2	27	8453	8484	0.18478542951225857
M1	cpdb	0	network_modules	419	TRUE	0.0010722015167172853	16	4	2	0.5	0.125	KEGG:00360	KEGG	Phenylalanine metabolism	8484	42		0	0.25	16	8468	2	2	14	8466	8484	0.24935101836885135
M1	cpdb	0	network_modules	419	TRUE	0.002062039776016747	22	4	2	0.5	0.09090909090909091	KEGG:00340	KEGG	Histidine metabolism	8484	40		0.3333333333333333	0.5	22	8462	2	2	20	8460	8484	0.21242061877326804
M1	cpdb	0	network_modules	419	TRUE	0.004144980814716432	31	4	2	0.5	0.06451612903225806	KEGG:00410	KEGG	beta-Alanine metabolism	8484	55		0.6666666666666666	0.75	31	8453	2	2	29	8451	8484	0.17866152207003594
M1	cpdb	0	network_modules	419	TRUE	0.005611358545121136	36	4	2	0.5	0.05555555555555555	KEGG:00350	KEGG	Tyrosine metabolism	8484	41		1	1	36	8448	2	2	34	8446	8484	0.1656430180766329
M1	cpdb	0	network_modules	422	TRUE	0.0026743696454616496	3	14	2	0.14285714285714285	0.6666666666666666	GO:0090292	GO:BP	nuclear matrix anchoring at nuclear membrane	16175	18176		0	1	3	16172	2	12	1	16160	16175	0.30836810188211866
M1	cpdb	0	network_modules	422	TRUE	0.0026743696454616496	3	14	2	0.14285714285714285	0.6666666666666666	GO:0043578	GO:BP	nuclear matrix organization	16175	10783		0	1	3	16172	2	12	1	16160	16175	0.30836810188211866
M1	cpdb	0	network_modules	425	TRUE	7.746825084090081e-11	32	13	6	0.46153846153846156	0.1875	GO:0007035	GO:BP	vacuolar acidification	16175	2640		0	0.041666666666666664	32	16143	6	7	26	16136	16175	0.29332131064437644
M1	cpdb	0	network_modules	425	TRUE	6.929457806628989e-10	45	13	6	0.46153846153846156	0.13333333333333333	GO:0051452	GO:BP	intracellular pH reduction	16175	13713		0.043478260869565216	0.08333333333333333	45	16130	6	7	39	16123	16175	0.24701714659881435
M1	cpdb	0	network_modules	425	TRUE	3.5269038398169826e-9	21	13	5	0.38461538461538464	0.23809523809523808	GO:0007042	GO:BP	lysosomal lumen acidification	16175	2646		0.08695652173913043	0.125	21	16154	5	8	16	16146	16175	0.3019095870959138
M1	cpdb	0	network_modules	425	TRUE	1.6984825093074267e-8	28	13	5	0.38461538461538464	0.17857142857142858	GO:0035751	GO:BP	regulation of lysosomal lumen pH	16175	9214		0.13043478260869565	0.16666666666666666	28	16147	5	8	23	16139	16175	0.2612227849363993
M1	cpdb	0	network_modules	425	TRUE	2.5234427935539102e-8	80	13	6	0.46153846153846156	0.075	GO:0051453	GO:BP	regulation of intracellular pH	16175	13714		0.17391304347826086	0.20833333333333334	80	16095	6	7	74	16088	16175	0.18458940006915775
M1	cpdb	0	network_modules	425	TRUE	2.9382854605764763e-8	82	13	6	0.46153846153846156	0.07317073170731707	GO:0030641	GO:BP	regulation of cellular pH	16175	6868		0.21739130434782608	0.25	82	16093	6	7	76	16086	16175	0.18228636529419304
M1	cpdb	0	network_modules	425	TRUE	3.665832143385961e-8	85	13	6	0.46153846153846156	0.07058823529411765	GO:0006885	GO:BP	regulation of pH	16175	2541		0.2608695652173913	0.2916666666666667	85	16090	6	7	79	16083	16175	0.17898458739949102
M1	cpdb	0	network_modules	425	TRUE	1.0312671698131571e-7	11	13	4	0.3076923076923077	0.36363636363636365	GO:0036295	GO:BP	cellular response to increased oxygen levels	16175	9546		0.30434782608695654	0.3333333333333333	11	16164	4	9	7	16155	16175	0.3340052932212572
M1	cpdb	0	network_modules	425	TRUE	1.5462118513980515e-7	12	13	4	0.3076923076923077	0.3333333333333333	GO:0061795	GO:BP	Golgi lumen acidification	16175	15668		0.34782608695652173	0.4166666666666667	12	16163	4	9	8	16154	16175	0.31973121621472905
M1	cpdb	0	network_modules	425	TRUE	1.5462118513980515e-7	12	13	4	0.3076923076923077	0.3333333333333333	GO:0036296	GO:BP	response to increased oxygen levels	16175	9547		0.34782608695652173	0.4166666666666667	12	16163	4	9	8	16154	16175	0.31973121621472905
M1	cpdb	0	network_modules	425	TRUE	1.0270736724735691e-5	96	13	5	0.38461538461538464	0.052083333333333336	GO:0007040	GO:BP	lysosome organization	16175	2644		0.43478260869565216	0.5	96	16079	5	8	91	16071	16175	0.13982215526684622
M1	cpdb	0	network_modules	425	TRUE	1.0270736724735691e-5	96	13	5	0.38461538461538464	0.052083333333333336	GO:0080171	GO:BP	lytic vacuole organization	16175	17845		0.43478260869565216	0.5	96	16079	5	8	91	16071	16175	0.13982215526684622
M1	cpdb	0	network_modules	425	TRUE	1.4668982692581912e-5	422	13	7	0.5384615384615384	0.016587677725118485	GO:0030003	GO:BP	intracellular monoatomic cation homeostasis	16175	6648		0.5217391304347826	0.5416666666666666	422	15753	7	6	415	15747	16175	0.09116242114090894
M1	cpdb	0	network_modules	425	TRUE	1.5657014598868527e-5	426	13	7	0.5384615384615384	0.01643192488262911	GO:0006873	GO:BP	intracellular monoatomic ion homeostasis	16175	2531		0.5652173913043478	0.5833333333333334	426	15749	7	6	419	15743	16175	0.0907011429819985
M1	cpdb	0	network_modules	425	TRUE	2.9515232553718288e-5	467	13	7	0.5384615384615384	0.014989293361884369	GO:0055080	GO:BP	monoatomic cation homeostasis	16175	14233		0.6086956521739131	0.625	467	15708	7	6	460	15702	16175	0.08631181986460905
M1	cpdb	0	network_modules	425	TRUE	3.317877408040018e-5	475	13	7	0.5384615384615384	0.014736842105263158	GO:0050801	GO:BP	monoatomic ion homeostasis	16175	13267		0.6521739130434783	0.6666666666666666	475	15700	7	6	468	15694	16175	0.08552061458913911
M1	cpdb	0	network_modules	425	TRUE	7.419958548716355e-5	534	13	7	0.5384615384615384	0.013108614232209739	GO:0055082	GO:BP	intracellular chemical homeostasis	16175	14235		0.6956521739130435	0.7083333333333334	534	15641	7	6	527	15635	16175	0.08023090492499418
M1	cpdb	0	network_modules	425	TRUE	1.1106683966943721e-4	12	13	3	0.23076923076923078	0.25	GO:0048388	GO:BP	endosomal lumen acidification	16175	12723		0.7391304347826086	0.75	12	16163	3	10	9	16153	16175	0.23960521810067908
M1	cpdb	0	network_modules	425	TRUE	1.594874865733388e-4	61	13	4	0.3076923076923077	0.06557377049180328	GO:0006879	GO:BP	intracellular iron ion homeostasis	16175	2535		0.782608695652174	0.7916666666666666	61	16114	4	9	57	16105	16175	0.1406250229461387
M1	cpdb	0	network_modules	425	TRUE	2.1309254177360218e-4	623	13	7	0.5384615384615384	0.011235955056179775	GO:0019725	GO:BP	cellular homeostasis	16175	6020		0.8260869565217391	0.8333333333333334	623	15552	7	6	616	15546	16175	0.07368070378580055
M1	cpdb	0	network_modules	425	TRUE	2.1977303947520485e-4	66	13	4	0.3076923076923077	0.06060606060606061	GO:1902600	GO:BP	proton transmembrane transport	16175	22372		0.8695652173913043	0.875	66	16109	4	9	62	16100	16175	0.13507687290432782
M1	cpdb	0	network_modules	425	TRUE	0.00042875343123388013	202	13	5	0.38461538461538464	0.024752475247524754	GO:0007033	GO:BP	vacuole organization	16175	2638		0.9130434782608695	0.9166666666666666	202	15973	5	8	197	15965	16175	0.095036544732762
M1	cpdb	0	network_modules	425	TRUE	8.454454598527719e-4	763	13	7	0.5384615384615384	0.009174311926605505	GO:0048878	GO:BP	chemical homeostasis	16175	13119		0.9565217391304348	0.9583333333333334	763	15412	7	6	756	15406	16175	0.06572257179510542
M1	cpdb	0	network_modules	425	TRUE	9.009931909800189e-4	30	11	3	0.2727272727272727	0.1	REAC:R-HSA-77387	REAC	Insulin receptor recycling	10916	1210		0	0.3333333333333333	30	10886	3	8	27	10878	10916	0.1637880634428025
M1	cpdb	0	network_modules	425	TRUE	9.96979190695199e-4	31	11	3	0.2727272727272727	0.0967741935483871	REAC:R-HSA-917977	REAC	Transferrin endocytosis and recycling	10916	2564		0.5	0.6666666666666666	31	10885	3	8	28	10877	10916	0.16107739149687908
M1	cpdb	0	network_modules	425	TRUE	0.0013775193493629088	50	10	3	0.3	0.06	KEGG:05110	KEGG	Vibrio cholerae infection	8484	424		0	0.3333333333333333	50	8434	3	7	47	8427	8484	0.13199556259439335
M1	cpdb	0	network_modules	425	TRUE	0.0013785409990695044	104	13	4	0.3076923076923077	0.038461538461538464	GO:0071453	GO:BP	cellular response to oxygen levels	16175	16687		1	1	104	16071	4	9	100	16062	16175	0.10689947208528179
M1	cpdb	0	network_modules	425	TRUE	0.003799722415118918	70	10	3	0.3	0.04285714285714286	KEGG:05120	KEGG	Epithelial cell signaling in Helicobacter pylori infection	8484	426		0.5	0.6666666666666666	70	8414	3	7	67	8407	8484	0.11079388537063849
M1	cpdb	0	network_modules	425	TRUE	0.006397519914748604	57	11	3	0.2727272727272727	0.05263157894736842	REAC:R-HSA-917937	REAC	Iron uptake and transport	10916	1277		1	1	57	10859	3	8	54	10851	10916	0.11788201083732425
M1	cpdb	0	network_modules	425	TRUE	0.007532450104938061	88	10	3	0.3	0.03409090909090909	KEGG:05323	KEGG	Rheumatoid arthritis	8484	485		1	1	88	8396	3	7	85	8389	8484	0.09820163662523691
M1	cpdb	0	network_modules	426	TRUE	5.9581089604574e-17	96	9	9	1	0.09375	REAC:R-HSA-5620912	REAC	Anchoring of the basal body to the plasma membrane	10916	147		0	0.3333333333333333	96	10820	9	0	87	10820	10916	0.3049626213517773
M1	cpdb	0	network_modules	426	TRUE	5.4016175506498015e-14	200	9	9	1	0.045	REAC:R-HSA-5617833	REAC	Cilium Assembly	10916	361		0.5	0.6666666666666666	200	10716	9	0	191	10716	10916	0.21026643565171307
M1	cpdb	0	network_modules	426	TRUE	1.7255744099448153e-12	292	9	9	1	0.030821917808219176	REAC:R-HSA-1852241	REAC	Organelle biogenesis and maintenance	10916	1646		1	1	292	10624	9	0	283	10624	10916	0.17326913345933234
M1	cpdb	0	network_modules	426	TRUE	1.8267325557671278e-9	343	14	9	0.6428571428571429	0.026239067055393587	GO:0060271	GO:BP	cilium assembly	16175	14488		0	0.25	343	15832	9	5	334	15827	16175	0.12700074901916455
M1	cpdb	0	network_modules	426	TRUE	3.4413243642830153e-9	368	14	9	0.6428571428571429	0.024456521739130436	GO:0044782	GO:BP	cilium organization	16175	11155		0.3333333333333333	0.5	368	15807	9	5	359	15802	16175	0.12240283539454572
M1	cpdb	0	network_modules	426	TRUE	5.663198470961559e-8	503	14	9	0.6428571428571429	0.017892644135188866	GO:0120031	GO:BP	plasma membrane bounded cell projection assembly	16175	19467		0.6666666666666666	0.75	503	15672	9	5	494	15667	16175	0.10373108062025063
M1	cpdb	0	network_modules	426	TRUE	6.86948737243183e-8	514	14	9	0.6428571428571429	0.017509727626459144	GO:0030031	GO:BP	cell projection assembly	16175	6655		1	1	514	15661	9	5	505	15656	16175	0.1025370339434506
M1	cpdb	0	network_modules	430	TRUE	0.0018001927016410263	11	5	2	0.4	0.18181818181818182	REAC:R-HSA-71288	REAC	Creatine metabolism	10916	412		NA	1	11	10905	2	3	9	10902	10916	0.2691978540546046
M1	cpdb	0	network_modules	430	TRUE	0.007443582190847047	5	13	2	0.15384615384615385	0.4	GO:0006599	GO:BP	phosphagen metabolic process	16175	2316		0	1	5	16170	2	11	3	16159	16175	0.24770886606428522
M1	cpdb	0	network_modules	430	TRUE	0.007443582190847047	5	13	2	0.15384615384615385	0.4	GO:0046314	GO:BP	phosphocreatine biosynthetic process	16175	12048		0	1	5	16170	2	11	3	16159	16175	0.24770886606428522
M1	cpdb	0	network_modules	430	TRUE	0.007443582190847047	5	13	2	0.15384615384615385	0.4	GO:0042396	GO:BP	phosphagen biosynthetic process	16175	10143		0	1	5	16170	2	11	3	16159	16175	0.24770886606428522
M1	cpdb	0	network_modules	430	TRUE	0.007443582190847047	5	13	2	0.15384615384615385	0.4	GO:0006603	GO:BP	phosphocreatine metabolic process	16175	2320		0	1	5	16170	2	11	3	16159	16175	0.24770886606428522
M1	cpdb	0	network_modules	434	TRUE	0.002313472617518886	23	3	2	0.6666666666666666	0.08695652173913043	REAC:R-HSA-1181150	REAC	Signaling by NODAL	10916	2273		NA	1	23	10893	2	1	21	10892	10916	0.24029702124942165
M1	cpdb	0	network_modules	435	TRUE	4.226883163972724e-9	147	12	7	0.5833333333333334	0.047619047619047616	GO:0006261	GO:BP	DNA-templated DNA replication	16175	2078		0	0.1	147	16028	7	5	140	16023	16175	0.16488190304693712
M1	cpdb	0	network_modules	435	TRUE	4.9208645376342664e-08	12	10	4	0.4	0.3333333333333333	REAC:R-HSA-176974	REAC	Unwinding of DNA	10916	2625		0	0.2	12	10904	4	6	8	10898	10916	0.3645121678783953
M1	cpdb	0	network_modules	435	TRUE	1.030952211209767e-7	231	12	7	0.5833333333333334	0.030303030303030304	GO:0006260	GO:BP	DNA replication	16175	2077		0.1111111111111111	0.2	231	15944	7	5	224	15939	16175	0.1306836554365453
M1	cpdb	0	network_modules	435	TRUE	1.2901826270109065e-6	21	12	4	0.3333333333333333	0.19047619047619047	GO:0006268	GO:BP	DNA unwinding involved in DNA replication	16175	2083		0.2222222222222222	0.3	21	16154	4	8	17	16146	16175	0.2512512021651199
M1	cpdb	0	network_modules	435	TRUE	3.543483355403353e-6	32	10	4	0.4	0.125	REAC:R-HSA-69190	REAC	DNA strand elongation	10916	449		0.25	0.4	32	10884	4	6	28	10878	10916	0.2223960069192694
M1	cpdb	0	network_modules	435	TRUE	1.122478117595115e-5	35	12	4	0.3333333333333333	0.11428571428571428	GO:0033260	GO:BP	nuclear DNA replication	16175	8103		0.3333333333333333	0.4	35	16140	4	8	31	16132	16175	0.19419519112781627
M1	cpdb	0	network_modules	435	TRUE	1.760479571191036e-5	39	12	4	0.3333333333333333	0.10256410256410256	GO:0044786	GO:BP	cell cycle DNA replication	16175	11158		0.4444444444444444	0.5	39	16136	4	8	35	16128	16175	0.18385252099029312
M1	cpdb	0	network_modules	435	TRUE	2.8998274198306515e-5	44	12	4	0.3333333333333333	0.09090909090909091	GO:0032508	GO:BP	DNA duplex unwinding	16175	7615		0.5555555555555556	0.6	44	16131	4	8	40	16123	16175	0.17295653716190748
M1	cpdb	0	network_modules	435	TRUE	5.764744483050689e-5	52	12	4	0.3333333333333333	0.07692307692307693	GO:0032392	GO:BP	DNA geometric change	16175	7543		0.6666666666666666	0.7	52	16123	4	8	48	16115	16175	0.15889827568842396
M1	cpdb	0	network_modules	435	TRUE	1.0350677313934518e-4	60	12	4	0.3333333333333333	0.06666666666666667	GO:0071103	GO:BP	DNA conformation change	16175	16453		0.7777777777777778	0.8	60	16115	4	8	56	16107	16175	0.14774127619106772
M1	cpdb	0	network_modules	435	TRUE	4.4142174778287143e-4	20	12	3	0.25	0.15	GO:0000076	GO:BP	DNA replication checkpoint signaling	16175	27		0.8888888888888888	0.9	20	16155	3	9	17	16146	16175	0.1928821983633001
M1	cpdb	0	network_modules	435	TRUE	8.048550239672626e-4	121	10	4	0.4	0.03305785123966942	REAC:R-HSA-69239	REAC	Synthesis of DNA	10916	2376		0.5	0.6	121	10795	4	6	117	10789	10916	0.11248169713481271
M1	cpdb	0	network_modules	435	TRUE	0.0025720727356260413	162	10	4	0.4	0.024691358024691357	REAC:R-HSA-69242	REAC	S Phase	10916	2111		0.75	0.8	162	10754	4	6	158	10748	10916	0.09645589105969801
M1	cpdb	0	network_modules	435	TRUE	0.003781075530133068	4	12	2	0.16666666666666666	0.5	GO:0043111	GO:BP	replication fork arrest	16175	10535		1	1	4	16171	2	10	2	16161	16175	0.2883894502100615
M1	cpdb	0	network_modules	435	TRUE	0.004538841235227108	187	10	4	0.4	0.0213903743315508	REAC:R-HSA-69306	REAC	DNA Replication	10916	445		1	1	187	10729	4	6	183	10723	10916	0.08934716272963848
M1	cpdb	0	network_modules	437	TRUE	2.181760273986104e-6	23	12	4	0.3333333333333333	0.17391304347826086	REAC:R-HSA-373753	REAC	Nephrin family interactions	10916	1582		0	0.3333333333333333	23	10893	4	8	19	10885	10916	0.2396339890267564
M1	cpdb	0	network_modules	437	TRUE	6.30699107025625e-4	2	12	2	0.16666666666666666	1	GO:0038188	GO:BP	cholecystokinin signaling pathway	16175	9758		NA	1	2	16173	2	10	0	16163	16175	0.40812205803437007
M1	cpdb	0	network_modules	437	TRUE	6.326895663919624e-4	91	12	4	0.3333333333333333	0.04395604395604396	REAC:R-HSA-163125	REAC	Post-translational modification: synthesis of GPI-anchored proteins	10916	1775		0.5	0.6666666666666666	91	10825	4	8	87	10817	10916	0.11857847490356012
M1	cpdb	0	network_modules	437	TRUE	0.004631987956731001	150	12	4	0.3333333333333333	0.02666666666666667	REAC:R-HSA-1500931	REAC	Cell-Cell communication	10916	328		1	1	150	10766	4	8	146	10758	10916	0.09107189220506161
M1	cpdb	0	network_modules	439	TRUE	1.1456679508443884e-6	791	13	9	0.6923076923076923	0.011378002528445006	GO:0000122	GO:BP	negative regulation of transcription by RNA polymerase II	16175	48		0	0.25	791	15384	9	4	782	15380	16175	0.08461162037713138
M1	cpdb	0	network_modules	439	TRUE	6.956065954962641e-5	529	13	7	0.5384615384615384	0.013232514177693762	GO:0006325	GO:BP	chromatin organization	16175	2122		0.3333333333333333	0.5	529	15646	7	6	522	15640	16175	0.08064558573124661
M1	cpdb	0	network_modules	439	TRUE	8.985868777332298e-4	84	6	3	0.5	0.03571428571428571	KEGG:03083	KEGG	Polycomb repressive complex	8484	220		NA	1	84	8400	3	3	81	8397	8484	0.13168433593715767
M1	cpdb	0	network_modules	439	TRUE	0.0011450594454137848	798	13	7	0.5384615384615384	0.008771929824561403	GO:0006974	GO:BP	DNA damage response	16175	2601		0.6666666666666666	0.75	798	15377	7	6	791	15371	16175	0.06405485292955472
M1	cpdb	0	network_modules	439	TRUE	0.0024955827486538573	545	13	6	0.46153846153846156	0.011009174311926606	GO:0051276	GO:BP	chromosome organization	16175	13613		1	1	545	15630	6	7	539	15623	16175	0.06724757326835291
M1	cpdb	0	network_modules	440	TRUE	2.5798948017413118e-14	53	12	8	0.6666666666666666	0.1509433962264151	REAC:R-HSA-6811436	REAC	COPI-independent Golgi-to-ER retrograde traffic	10916	278		0	0.025	53	10863	8	4	45	10859	10916	0.31585128878768326
M1	cpdb	0	network_modules	440	TRUE	4.803523383427993e-14	57	12	8	0.6666666666666666	0.14035087719298245	REAC:R-HSA-3371497	REAC	HSP90 chaperone cycle for steroid hormone receptors (SHR) in the presence of ligand	10916	1111		0.02564102564102564	0.05	57	10859	8	4	49	10855	10916	0.3044546453276063
M1	cpdb	0	network_modules	440	TRUE	7.32921093648233e-14	193	9	9	1	0.046632124352331605	KEGG:04814	KEGG	Motor proteins	8484	366		0	0.25	193	8291	9	0	184	8291	8484	0.21358768290727093
M1	cpdb	0	network_modules	440	TRUE	1.1817896614704108e-13	44	9	7	0.7777777777777778	0.1590909090909091	KEGG:04962	KEGG	Vasopressin-regulated water reabsorption	8484	398		0.3333333333333333	0.5	44	8440	7	2	37	8438	8484	0.3505132587666862
M1	cpdb	0	network_modules	440	TRUE	7.577805667350921e-13	249	9	9	1	0.03614457831325301	KEGG:05132	KEGG	Salmonella infection	8484	429		0.6666666666666666	0.75	249	8235	9	0	240	8235	8484	0.18740601653518402
M1	cpdb	0	network_modules	440	TRUE	6.281502885642674e-12	102	12	8	0.6666666666666666	0.0784313725490196	REAC:R-HSA-6807878	REAC	COPI-mediated anterograde transport	10916	279		0.05128205128205128	0.075	102	10814	8	4	94	10810	10916	0.22664519401569913
M1	cpdb	0	network_modules	440	TRUE	2.929684276406064e-11	123	12	8	0.6666666666666666	0.06504065040650407	REAC:R-HSA-2132295	REAC	MHC class II antigen presentation	10916	1371		0.07692307692307693	0.1	123	10793	8	4	115	10789	10916	0.20598862005302698
M1	cpdb	0	network_modules	440	TRUE	5.555221320423238e-11	133	12	8	0.6666666666666666	0.06015037593984962	REAC:R-HSA-8856688	REAC	Golgi-to-ER retrograde transport	10916	1084		0.10256410256410256	0.125	133	10783	8	4	125	10779	10916	0.19790819950260424
M1	cpdb	0	network_modules	440	TRUE	1.9357198751118712e-10	155	12	8	0.6666666666666666	0.05161290322580645	REAC:R-HSA-199977	REAC	ER to Golgi Anterograde Transport	10916	823		0.1282051282051282	0.15	155	10761	8	4	147	10757	10916	0.1829480699311857
M1	cpdb	0	network_modules	440	TRUE	8.498110381891389e-10	186	12	8	0.6666666666666666	0.043010752688172046	REAC:R-HSA-948021	REAC	Transport to the Golgi and subsequent modification	10916	2604		0.15384615384615385	0.175	186	10730	8	4	178	10726	10916	0.16652109909152896
M1	cpdb	0	network_modules	440	TRUE	1.467442809574122e-9	199	12	8	0.6666666666666666	0.04020100502512563	REAC:R-HSA-68877	REAC	Mitotic Prometaphase	10916	1484		0.1794871794871795	0.2	199	10717	8	4	191	10713	10916	0.1607924152113089
M1	cpdb	0	network_modules	440	TRUE	1.6559495215865117e-9	202	12	8	0.6666666666666666	0.039603960396039604	REAC:R-HSA-6811442	REAC	Intra-Golgi and retrograde Golgi-to-ER traffic	10916	1262		0.20512820512820512	0.225	202	10714	8	4	194	10710	10916	0.15954863795878393
M1	cpdb	0	network_modules	440	TRUE	4.5344421650451394e-8	305	12	8	0.6666666666666666	0.02622950819672131	REAC:R-HSA-446203	REAC	Asparagine N-linked glycosylation	10916	169		0.23076923076923078	0.25	305	10611	8	4	297	10607	10916	0.12857240462053887
M1	cpdb	0	network_modules	440	TRUE	9.152628281040535e-8	94	12	6	0.5	0.06382978723404255	REAC:R-HSA-380320	REAC	Recruitment of NuMA to mitotic centrosomes	10916	1950		0.2564102564102564	0.275	94	10822	6	6	88	10816	10916	0.17642851520898373
M1	cpdb	0	network_modules	440	TRUE	1.942727364611444e-7	44	12	5	0.4166666666666667	0.11363636363636363	REAC:R-HSA-9646399	REAC	Aggrephagy	10916	129		0.28205128205128205	0.3	44	10872	5	7	39	10865	10916	0.21604646443665376
M1	cpdb	0	network_modules	440	TRUE	4.4227939298740963e-7	406	12	8	0.6666666666666666	0.019704433497536946	REAC:R-HSA-68886	REAC	M Phase	10916	1343		0.3076923076923077	0.325	406	10510	8	4	398	10506	10916	0.11035050978258647
M1	cpdb	0	network_modules	440	TRUE	1.8408854264287377e-6	68	12	5	0.4166666666666667	0.07352941176470588	REAC:R-HSA-380259	REAC	Loss of Nlp from mitotic centrosomes	10916	1331		0.3333333333333333	0.375	68	10848	5	7	63	10841	10916	0.17305284095601015
M1	cpdb	0	network_modules	440	TRUE	1.8408854264287377e-6	68	12	5	0.4166666666666667	0.07352941176470588	REAC:R-HSA-380284	REAC	Loss of proteins required for interphase microtubule organization from the centrosome	10916	1335		0.3333333333333333	0.375	68	10848	5	7	63	10841	10916	0.17305284095601015
M1	cpdb	0	network_modules	440	TRUE	2.295595681429403e-6	71	12	5	0.4166666666666667	0.07042253521126761	REAC:R-HSA-8854518	REAC	AURKA Activation by TPX2	10916	41		0.38461538461538464	0.4	71	10845	5	7	66	10838	10916	0.16926734314624758
M1	cpdb	0	network_modules	440	TRUE	4.218156449282987e-6	80	12	5	0.4166666666666667	0.0625	REAC:R-HSA-380270	REAC	Recruitment of mitotic centrosome proteins and complexes	10916	1951		0.41025641025641024	0.475	80	10836	5	7	75	10829	10916	0.15920759192597375
M1	cpdb	0	network_modules	440	TRUE	4.218156449282987e-6	80	12	5	0.4166666666666667	0.0625	REAC:R-HSA-9663891	REAC	Selective autophagy	10916	2186		0.41025641025641024	0.475	80	10836	5	7	75	10829	10916	0.15920759192597375
M1	cpdb	0	network_modules	440	TRUE	4.218156449282987e-6	80	12	5	0.4166666666666667	0.0625	REAC:R-HSA-380287	REAC	Centrosome maturation	10916	341		0.41025641025641024	0.475	80	10836	5	7	75	10829	10916	0.15920759192597375
M1	cpdb	0	network_modules	440	TRUE	5.740040329059967e-6	85	12	5	0.4166666666666667	0.058823529411764705	REAC:R-HSA-2565942	REAC	Regulation of PLK1 Activity at G2/M Transition	10916	1998		0.48717948717948717	0.5	85	10831	5	7	80	10824	10916	0.15431682635611862
M1	cpdb	0	network_modules	440	TRUE	8.573336537483838e-6	92	12	5	0.4166666666666667	0.05434782608695652	REAC:R-HSA-141424	REAC	Amplification of signal from the kinetochores	10916	144		0.5128205128205128	0.55	92	10824	5	7	87	10817	10916	0.14814519320805275
M1	cpdb	0	network_modules	440	TRUE	8.573336537483838e-6	92	12	5	0.4166666666666667	0.05434782608695652	REAC:R-HSA-141444	REAC	Amplification  of signal from unattached  kinetochores via a MAD2  inhibitory signal	10916	143		0.5128205128205128	0.55	92	10824	5	7	87	10817	10916	0.14814519320805275
M1	cpdb	0	network_modules	440	TRUE	1.0633218009546467e-5	96	12	5	0.4166666666666667	0.052083333333333336	REAC:R-HSA-5620912	REAC	Anchoring of the basal body to the plasma membrane	10916	147		0.5641025641025641	0.575	96	10820	5	7	91	10813	10916	0.14492260300916215
M1	cpdb	0	network_modules	440	TRUE	2.018192632058645e-5	109	12	5	0.4166666666666667	0.045871559633027525	REAC:R-HSA-69618	REAC	Mitotic Spindle Checkpoint	10916	1486		0.5897435897435898	0.6	109	10807	5	7	104	10800	10916	0.13569055935148
M1	cpdb	0	network_modules	440	TRUE	2.6427290482190327e-5	115	12	5	0.4166666666666667	0.043478260869565216	REAC:R-HSA-9648025	REAC	EML4 and NUDC in mitotic spindle formation	10916	817		0.6153846153846154	0.625	115	10801	5	7	110	10794	10916	0.13196148211421885
M1	cpdb	0	network_modules	440	TRUE	3.704568529645101e-5	123	12	5	0.4166666666666667	0.04065040650406504	REAC:R-HSA-2500257	REAC	Resolution of Sister Chromatid Cohesion	10916	2079		0.6410256410256411	0.65	123	10793	5	7	118	10786	10916	0.12741484973321465
M1	cpdb	0	network_modules	440	TRUE	5.6902247877668476e-5	134	12	5	0.4166666666666667	0.03731343283582089	REAC:R-HSA-1632852	REAC	Macroautophagy	10916	1388		0.6666666666666666	0.675	134	10782	5	7	129	10775	10916	0.12183182869411346
M1	cpdb	0	network_modules	440	TRUE	5.9058945176596714e-5	135	12	5	0.4166666666666667	0.037037037037037035	REAC:R-HSA-9609690	REAC	HCMV Early Events	10916	1088		0.6923076923076923	0.7	135	10781	5	7	130	10774	10916	0.12135789217493521
M1	cpdb	0	network_modules	440	TRUE	6.128005274732198e-5	136	12	5	0.4166666666666667	0.03676470588235294	REAC:R-HSA-5663220	REAC	RHO GTPases Activate Formins	10916	1848		0.717948717948718	0.725	136	10780	5	7	131	10773	10916	0.12088911024322653
M1	cpdb	0	network_modules	440	TRUE	8.307087600617114e-5	52	13	4	0.3076923076923077	0.07692307692307693	GO:0051293	GO:BP	establishment of spindle localization	16175	13625		0	0.0625	52	16123	4	9	48	16114	16175	0.15254535140953654
M1	cpdb	0	network_modules	440	TRUE	9.6684470217912e-5	149	12	5	0.4166666666666667	0.03355704697986577	REAC:R-HSA-9612973	REAC	Autophagy	10916	193		0.7435897435897436	0.75	149	10767	5	7	144	10760	10916	0.11522430046838883
M1	cpdb	0	network_modules	440	TRUE	9.695381423777069e-5	54	13	4	0.3076923076923077	0.07407407407407407	GO:0051653	GO:BP	spindle localization	16175	13866		0.06666666666666667	0.125	54	16121	4	9	50	16112	16175	0.14964227626738597
M1	cpdb	0	network_modules	440	TRUE	1.0733448334437418e-4	153	13	5	0.38461538461538464	0.032679738562091505	GO:1902850	GO:BP	microtubule cytoskeleton organization involved in mitosis	16175	22560		0.13333333333333333	0.1875	153	16022	5	8	148	16014	16175	0.10991997698158211
M1	cpdb	0	network_modules	440	TRUE	1.336399413356197e-4	159	12	5	0.4166666666666667	0.031446540880503145	REAC:R-HSA-9609646	REAC	HCMV Infection	10916	1089		0.7692307692307693	0.775	159	10757	5	7	154	10750	10916	0.11134023107028931
M1	cpdb	0	network_modules	440	TRUE	1.4024333302935541e-4	586	13	7	0.5384615384615384	0.011945392491467578	GO:0000226	GO:BP	microtubule cytoskeleton organization	16175	61		0.2	0.25	586	15589	7	6	579	15583	16175	0.07622817841792867
M1	cpdb	0	network_modules	440	TRUE	1.7941347977476463e-4	348	13	6	0.46153846153846156	0.017241379310344827	GO:0007018	GO:BP	microtubule-based movement	16175	2626		0.26666666666666666	0.3125	348	15827	6	7	342	15820	16175	0.08601132480701913
M1	cpdb	0	network_modules	440	TRUE	3.07058281295611e-4	188	12	5	0.4166666666666667	0.026595744680851064	REAC:R-HSA-2467813	REAC	Separation of Sister Chromatids	10916	2204		0.7948717948717948	0.8	188	10728	5	7	183	10721	10916	0.10185423365022418
M1	cpdb	0	network_modules	440	TRUE	3.67961265697616e-4	195	12	5	0.4166666666666667	0.02564102564102564	REAC:R-HSA-69275	REAC	G2/M Transition	10916	1008		0.8205128205128205	0.825	195	10721	5	7	190	10714	10916	0.09988141128727304
M1	cpdb	0	network_modules	440	TRUE	3.8700775707160856e-4	197	12	5	0.4166666666666667	0.025380710659898477	REAC:R-HSA-453274	REAC	Mitotic G2-G2/M phases	10916	1481		0.8461538461538461	0.85	197	10719	5	7	192	10712	10916	0.09933671789251305
M1	cpdb	0	network_modules	440	TRUE	4.1703160239187146e-4	200	12	5	0.4166666666666667	0.025	REAC:R-HSA-5617833	REAC	Cilium Assembly	10916	361		0.8717948717948718	0.875	200	10716	5	7	195	10709	10916	0.09853469577088418
M1	cpdb	0	network_modules	440	TRUE	4.718161681557836e-4	410	13	6	0.46153846153846156	0.014634146341463415	GO:0051656	GO:BP	establishment of organelle localization	16175	13869		0.3333333333333333	0.375	410	15765	6	7	404	15758	16175	0.07870564870352667
M1	cpdb	0	network_modules	440	TRUE	5.508563939196378e-4	147	9	4	0.4444444444444444	0.027210884353741496	KEGG:04145	KEGG	Phagosome	8484	281		1	1	147	8337	4	5	143	8332	8484	0.10666847205170227
M1	cpdb	0	network_modules	440	TRUE	7.958086806875824e-4	228	12	5	0.4166666666666667	0.021929824561403508	REAC:R-HSA-68882	REAC	Mitotic Anaphase	10916	1479		0.8974358974358975	0.9	228	10688	5	7	223	10681	10916	0.09181197112880937
M1	cpdb	0	network_modules	440	TRUE	8.131311216304857e-4	229	12	5	0.4166666666666667	0.021834061135371178	REAC:R-HSA-2555396	REAC	Mitotic Metaphase and Anaphase	10916	1482		0.9230769230769231	0.925	229	10687	5	7	224	10680	10916	0.09159436932047141
M1	cpdb	0	network_modules	440	TRUE	0.0018771070550661123	519	13	6	0.46153846153846156	0.011560693641618497	GO:0051640	GO:BP	organelle localization	16175	13853		0.4	0.4375	519	15656	6	7	513	15649	16175	0.06911286011260784
M1	cpdb	0	network_modules	440	TRUE	0.0024809207458409864	32	13	3	0.23076923076923078	0.09375	GO:0000132	GO:BP	establishment of mitotic spindle orientation	16175	50		0.4666666666666667	0.5	32	16143	3	10	29	16133	16175	0.14602929542180088
M1	cpdb	0	network_modules	440	TRUE	0.0025427053342193476	289	12	5	0.4166666666666667	0.01730103806228374	REAC:R-HSA-69620	REAC	Cell Cycle Checkpoints	10916	321		0.9487179487179487	0.95	289	10627	5	7	284	10620	10916	0.08062784811420957
M1	cpdb	0	network_modules	440	TRUE	0.0026740384087551657	292	12	5	0.4166666666666667	0.017123287671232876	REAC:R-HSA-1852241	REAC	Organelle biogenesis and maintenance	10916	1646		0.9743589743589743	0.975	292	10624	5	7	287	10617	10916	0.08016741447079913
M1	cpdb	0	network_modules	440	TRUE	0.0027875165644243543	124	13	4	0.3076923076923077	0.03225806451612903	GO:0007052	GO:BP	mitotic spindle organization	16175	2651		0.5333333333333333	0.5625	124	16051	4	9	120	16042	16175	0.09755861864459163
M1	cpdb	0	network_modules	440	TRUE	0.003877433618986052	37	13	3	0.23076923076923078	0.08108108108108109	GO:0040001	GO:BP	establishment of mitotic spindle localization	16175	9890		0.6	0.625	37	16138	3	10	34	16128	16175	0.13564200894436634
M1	cpdb	0	network_modules	440	TRUE	0.004050074270554692	318	12	5	0.4166666666666667	0.015723270440251572	REAC:R-HSA-195258	REAC	RHO GTPase Effectors	10916	1846		1	1	318	10598	5	7	313	10591	10916	0.0764445931150014
M1	cpdb	0	network_modules	440	TRUE	0.004207831499233815	38	13	3	0.23076923076923078	0.07894736842105263	GO:0051294	GO:BP	establishment of spindle orientation	16175	13626		0.6666666666666666	0.6875	38	16137	3	10	35	16127	16175	0.1338132761058742
M1	cpdb	0	network_modules	440	TRUE	0.005059024567550194	144	13	4	0.3076923076923077	0.027777777777777776	GO:0010970	GO:BP	transport along microtubule	16175	4546		0.7333333333333333	0.75	144	16031	4	9	140	16022	16175	0.09021369156040307
M1	cpdb	0	network_modules	440	TRUE	0.005309751565146604	41	13	3	0.23076923076923078	0.07317073170731707	GO:0060236	GO:BP	regulation of mitotic spindle organization	16175	14457		0.8	0.8125	41	16134	3	10	38	16124	16175	0.1287320445595764
M1	cpdb	0	network_modules	440	TRUE	0.00658766283619541	44	13	3	0.23076923076923078	0.06818181818181818	GO:0090224	GO:BP	regulation of spindle organization	16175	18121		0.8666666666666667	0.875	44	16131	3	10	41	16121	16175	0.12417654470808295
M1	cpdb	0	network_modules	440	TRUE	0.007308968629921975	656	13	6	0.46153846153846156	0.009146341463414634	GO:1903047	GO:BP	mitotic cell cycle process	16175	22727		0.9333333333333333	0.9375	656	15519	6	7	650	15512	16175	0.06052686830827482
M1	cpdb	0	network_modules	440	TRUE	0.008685795346927547	165	13	4	0.3076923076923077	0.024242424242424242	GO:0099111	GO:BP	microtubule-based transport	16175	19044		1	1	165	16010	4	9	161	16001	16175	0.08396632836313316
M1	cpdb	0	network_modules	441	TRUE	1.0771370705029178e-9	46	12	6	0.5	0.13043478260869565	REAC:R-HSA-69231	REAC	Cyclin D associated events in G1	10916	420		0	0.1	46	10870	6	6	40	10864	10916	0.2538994742919169
M1	cpdb	0	network_modules	441	TRUE	1.0771370705029178e-9	46	12	6	0.5	0.13043478260869565	REAC:R-HSA-69236	REAC	G1 Phase	10916	1000		0	0.1	46	10870	6	6	40	10864	10916	0.2538994742919169
M1	cpdb	0	network_modules	441	TRUE	1.2899555131497115e-7	214	13	7	0.5384615384615384	0.03271028037383177	GO:0044843	GO:BP	cell cycle G1/S phase transition	16175	11189		0	0.07692307692307693	214	15961	7	6	207	15955	16175	0.13037131082139217
M1	cpdb	0	network_modules	441	TRUE	5.884714653599913e-7	17	12	4	0.3333333333333333	0.23529411764705882	REAC:R-HSA-9661069	REAC	Defective binding of RB1 mutants to E2F1,(E2F2, E2F3)	10916	689		0.10526315789473684	0.2	17	10899	4	8	13	10891	10916	0.2791183509245809
M1	cpdb	0	network_modules	441	TRUE	5.884714653599913e-7	17	12	4	0.3333333333333333	0.23529411764705882	REAC:R-HSA-9659787	REAC	Aberrant regulation of mitotic G1/S transition in cancer due to RB1 defects	10916	47		0.10526315789473684	0.2	17	10899	4	8	13	10891	10916	0.2791183509245809
M1	cpdb	0	network_modules	441	TRUE	1.3853447926466535e-6	147	12	6	0.5	0.04081632653061224	REAC:R-HSA-453279	REAC	Mitotic G1 phase and G1/S transition	10916	1480		0.21052631578947367	0.25	147	10769	6	6	141	10763	10916	0.14003211463544246
M1	cpdb	0	network_modules	441	TRUE	2.8358109128690903e-6	155	13	6	0.46153846153846156	0.03870967741935484	KEGG:04218	KEGG	Cellular senescence	8484	295		0	0.1	155	8329	6	7	149	8322	8484	0.12966114634784584
M1	cpdb	0	network_modules	441	TRUE	3.0173522659494393e-6	5	12	3	0.25	0.6	REAC:R-HSA-9754119	REAC	Drug-mediated inhibition of CDK4/CDK6 activity	10916	804		0.2631578947368421	0.3	5	10911	3	9	2	10902	10916	0.3868900179951331
M1	cpdb	0	network_modules	441	TRUE	3.0620351360929496e-6	157	13	6	0.46153846153846156	0.03821656050955414	KEGG:04110	KEGG	Cell cycle	8484	264		0.1111111111111111	0.2	157	8327	6	7	151	8320	8484	0.12877957927365324
M1	cpdb	0	network_modules	441	TRUE	4.419097407517265e-6	187	13	6	0.46153846153846156	0.03208556149732621	GO:0000082	GO:BP	G1/S transition of mitotic cell cycle	16175	31		0.08333333333333333	0.15384615384615385	187	15988	6	7	181	15981	16175	0.11938266056938365
M1	cpdb	0	network_modules	441	TRUE	9.650778462914531e-6	330	13	7	0.5384615384615384	0.021212121212121213	KEGG:05165	KEGG	Human papillomavirus infection	8484	446		0.2222222222222222	0.3	330	8154	7	6	323	8148	8484	0.10121724079775454
M1	cpdb	0	network_modules	441	TRUE	1.3345283528166218e-5	201	13	6	0.46153846153846156	0.029850746268656716	KEGG:05203	KEGG	Viral carcinogenesis	8484	455		0.3333333333333333	0.4	201	8283	6	7	195	8276	8484	0.11278083933469034
M1	cpdb	0	network_modules	441	TRUE	1.4403035052417402e-5	36	12	4	0.3333333333333333	0.1111111111111111	REAC:R-HSA-9687139	REAC	Aberrant regulation of mitotic cell cycle due to RB1 defects	10916	48		0.3157894736842105	0.35	36	10880	4	8	32	10872	10916	0.19096601470384308
M1	cpdb	0	network_modules	441	TRUE	1.8027522064657098e-5	38	12	4	0.3333333333333333	0.10526315789473684	REAC:R-HSA-9675126	REAC	Diseases of mitotic cell cycle	10916	769		0.3684210526315789	0.4	38	10878	4	8	34	10870	10916	0.18578656035293012
M1	cpdb	0	network_modules	441	TRUE	2.8655143899595452e-5	465	13	7	0.5384615384615384	0.015053763440860216	GO:0044770	GO:BP	cell cycle phase transition	16175	11146		0.16666666666666666	0.23076923076923078	465	15710	7	6	458	15704	16175	0.08651271795268825
M1	cpdb	0	network_modules	441	TRUE	1.9549325158388811e-4	74	13	4	0.3076923076923077	0.05405405405405406	KEGG:04115	KEGG	p53 signaling pathway	8484	269		0.4444444444444444	0.5	74	8410	4	9	70	8401	8484	0.12595597058368488
M1	cpdb	0	network_modules	441	TRUE	2.299751772316247e-4	630	13	7	0.5384615384615384	0.011111111111111112	GO:0010564	GO:BP	regulation of cell cycle process	16175	4217		0.25	0.3076923076923077	630	15545	7	6	623	15539	16175	0.07322327924234352
M1	cpdb	0	network_modules	441	TRUE	2.576971936434348e-4	370	13	6	0.46153846153846156	0.016216216216216217	GO:0044772	GO:BP	mitotic cell cycle phase transition	16175	11148		0.3333333333333333	0.38461538461538464	370	15805	6	7	364	15798	16175	0.0832150646260364
M1	cpdb	0	network_modules	441	TRUE	2.833520660702704e-4	376	13	6	0.46153846153846156	0.015957446808510637	GO:1901987	GO:BP	regulation of cell cycle phase transition	16175	21920		0.4166666666666667	0.46153846153846156	376	15799	6	7	370	15792	16175	0.0824942999391009
M1	cpdb	0	network_modules	441	TRUE	3.0298079775703264e-4	656	13	7	0.5384615384615384	0.010670731707317074	GO:1903047	GO:BP	mitotic cell cycle process	16175	22727		0.5	0.5384615384615384	656	15519	7	6	649	15513	16175	0.07158651556981822
M1	cpdb	0	network_modules	441	TRUE	3.804891359634814e-4	356	13	6	0.46153846153846156	0.016853932584269662	KEGG:04151	KEGG	PI3K-Akt signaling pathway	8484	285		0.5555555555555556	0.6	356	8128	6	7	350	8121	8484	0.08197849648198083
M1	cpdb	0	network_modules	441	TRUE	5.733958633881359e-4	20	13	3	0.23076923076923078	0.15	GO:2000773	GO:BP	negative regulation of cellular senescence	16175	26033		0.5833333333333334	0.6153846153846154	20	16155	3	10	17	16145	16175	0.18524419362516745
M1	cpdb	0	network_modules	441	TRUE	7.743804142918991e-4	26	12	3	0.25	0.11538461538461539	REAC:R-HSA-1538133	REAC	G0 and Early G1	10916	999		0.42105263157894735	0.45	26	10890	3	9	23	10881	10916	0.16851677276830831
M1	cpdb	0	network_modules	441	TRUE	8.706387220533925e-4	27	12	3	0.25	0.1111111111111111	REAC:R-HSA-69205	REAC	G1/S-Specific Transcription	10916	1003		0.47368421052631576	0.5	27	10889	3	9	24	10880	10916	0.16531306015909594
M1	cpdb	0	network_modules	441	TRUE	9.88560555320085e-4	3	12	2	0.16666666666666666	0.6666666666666666	REAC:R-HSA-9675132	REAC	Diseases of cellular response to stress	10916	764		0.5263157894736842	0.8	3	10913	2	10	1	10903	10916	0.3330125109557372
M1	cpdb	0	network_modules	441	TRUE	9.88560555320085e-4	3	12	2	0.16666666666666666	0.6666666666666666	REAC:R-HSA-9630750	REAC	Evasion of Oncogene Induced Senescence Due to p16INK4A Defects	10916	877		0.5263157894736842	0.8	3	10913	2	10	1	10903	10916	0.3330125109557372
M1	cpdb	0	network_modules	441	TRUE	9.88560555320085e-4	3	12	2	0.16666666666666666	0.6666666666666666	REAC:R-HSA-9630747	REAC	Diseases of Cellular Senescence	10916	756		0.5263157894736842	0.8	3	10913	2	10	1	10903	10916	0.3330125109557372
M1	cpdb	0	network_modules	441	TRUE	9.88560555320085e-4	3	12	2	0.16666666666666666	0.6666666666666666	REAC:R-HSA-9632700	REAC	Evasion of Oxidative Stress Induced Senescence Due to Defective p16INK4A binding to CDK4 and CDK6	10916	879		0.5263157894736842	0.8	3	10913	2	10	1	10903	10916	0.3330125109557372
M1	cpdb	0	network_modules	441	TRUE	9.88560555320085e-4	3	12	2	0.16666666666666666	0.6666666666666666	REAC:R-HSA-9632693	REAC	Evasion of Oxidative Stress Induced Senescence Due to p16INK4A Defects	10916	881		0.5263157894736842	0.8	3	10913	2	10	1	10903	10916	0.3330125109557372
M1	cpdb	0	network_modules	441	TRUE	9.88560555320085e-4	3	12	2	0.16666666666666666	0.6666666666666666	REAC:R-HSA-9630794	REAC	Evasion of Oncogene Induced Senescence Due to Defective p16INK4A binding to CDK4 and CDK6	10916	875		0.5263157894736842	0.8	3	10913	2	10	1	10903	10916	0.3330125109557372
M1	cpdb	0	network_modules	441	TRUE	0.0010881221318166758	792	13	7	0.5384615384615384	0.008838383838383838	GO:0000278	GO:BP	mitotic cell cycle	16175	76		0.6666666666666666	0.6923076923076923	792	15383	7	6	785	15377	16175	0.06433323867112943
M1	cpdb	0	network_modules	441	TRUE	0.0023264791779495954	138	13	4	0.3076923076923077	0.028985507246376812	KEGG:05162	KEGG	Measles	8484	443		0.6666666666666666	0.7	138	8346	4	9	134	8337	8484	0.09025164913321543
M1	cpdb	0	network_modules	441	TRUE	0.0023904768379701844	286	13	5	0.38461538461538464	0.017482517482517484	GO:1901990	GO:BP	regulation of mitotic cell cycle phase transition	16175	21923		0.75	0.7692307692307693	286	15889	5	8	281	15881	16175	0.07896321214947352
M1	cpdb	0	network_modules	441	TRUE	0.0026277816250186658	130	12	4	0.3333333333333333	0.03076923076923077	REAC:R-HSA-69206	REAC	G1/S Transition	10916	1002		0.8421052631578947	0.85	130	10786	4	8	126	10778	10916	0.09829647149675977
M1	cpdb	0	network_modules	441	TRUE	0.003485361388430074	153	13	4	0.3076923076923077	0.026143790849673203	KEGG:04934	KEGG	Cushing syndrome	8484	391		0.7777777777777778	0.8	153	8331	4	9	149	8322	8484	0.08527010192171068
M1	cpdb	0	network_modules	441	TRUE	0.004207831499233815	38	13	3	0.23076923076923078	0.07894736842105263	GO:2000772	GO:BP	regulation of cellular senescence	16175	26032		0.8333333333333334	0.8461538461538461	38	16137	3	10	35	16127	16175	0.1338132761058742
M1	cpdb	0	network_modules	441	TRUE	0.004933750718707183	6	12	2	0.16666666666666666	0.3333333333333333	REAC:R-HSA-8849470	REAC	PTK6 Regulates Cell Cycle	10916	1707		0.8947368421052632	0.9	6	10910	2	10	4	10900	10916	0.23511879436218117
M1	cpdb	0	network_modules	441	TRUE	0.00540975985800728	49	12	3	0.25	0.061224489795918366	REAC:R-HSA-6791312	REAC	TP53 Regulates Transcription of Cell Cycle Genes	10916	2454		0.9473684210526315	0.95	49	10867	3	9	46	10858	10916	0.1218371193123554
M1	cpdb	0	network_modules	441	TRUE	0.007288666777259918	359	12	5	0.4166666666666667	0.013927576601671309	REAC:R-HSA-3700989	REAC	Transcriptional Regulation by TP53	10916	2546		1	1	359	10557	5	7	354	10550	10916	0.07138798666633225
M1	cpdb	0	network_modules	441	TRUE	0.008580602350671875	72	13	3	0.23076923076923078	0.041666666666666664	KEGG:05223	KEGG	Non-small cell lung cancer	8484	474		0.8888888888888888	0.9	72	8412	3	10	69	8402	8484	0.0949280840308349
M1	cpdb	0	network_modules	441	TRUE	0.008896275696294026	166	13	4	0.3076923076923077	0.024096385542168676	GO:1902806	GO:BP	regulation of cell cycle G1/S phase transition	16175	22525		0.9166666666666666	0.9230769230769231	166	16009	4	9	162	16000	16175	0.08369825266988004
M1	cpdb	0	network_modules	441	TRUE	0.00945858813182289	686	13	6	0.46153846153846156	0.008746355685131196	GO:0008284	GO:BP	positive regulation of cell population proliferation	16175	3151		1	1	686	15489	6	7	680	15482	16175	0.05898487327134282
M1	cpdb	0	network_modules	441	TRUE	0.009490498868860124	198	13	4	0.3076923076923077	0.020202020202020204	KEGG:05169	KEGG	Epstein-Barr virus infection	8484	450		1	1	198	8286	4	9	194	8277	8484	0.07378357156538802
M1	cpdb	0	network_modules	442	TRUE	2.0506898046726747e-4	21	10	3	0.3	0.14285714285714285	REAC:R-HSA-379726	REAC	Mitochondrial tRNA aminoacylation	10916	1470		0	0.5	21	10895	3	7	18	10888	10916	0.20598464316337545
M1	cpdb	0	network_modules	442	TRUE	3.9991882288500555e-4	44	8	3	0.375	0.06818181818181818	KEGG:00970	KEGG	Aminoacyl-tRNA biosynthesis	8484	153		NA	1	44	8440	3	5	41	8435	8484	0.1581742166846865
M1	cpdb	0	network_modules	442	TRUE	0.0017522520977241894	42	10	3	0.3	0.07142857142857142	REAC:R-HSA-379724	REAC	tRNA Aminoacylation	10916	2740		1	1	42	10874	3	7	39	10867	10916	0.14485276221305743
M1	cpdb	0	network_modules	442	TRUE	0.0018913173803027153	3	12	2	0.16666666666666666	0.6666666666666666	GO:0006421	GO:BP	asparaginyl-tRNA aminoacylation	16175	2178		0	0.2	3	16172	2	10	1	16162	16175	0.33311686255037765
M1	cpdb	0	network_modules	442	TRUE	0.003242053080048044	38	12	3	0.25	0.07894736842105263	GO:0006418	GO:BP	tRNA aminoacylation for protein translation	16175	2175		0.25	0.4	38	16137	3	9	35	16128	16175	0.13938315158677447
M1	cpdb	0	network_modules	442	TRUE	0.0040916305351758366	41	12	3	0.25	0.07317073170731707	GO:0043039	GO:BP	tRNA aminoacylation	16175	10489		0.5	0.8	41	16134	3	9	38	16125	16175	0.13409887921903033
M1	cpdb	0	network_modules	442	TRUE	0.0040916305351758366	41	12	3	0.25	0.07317073170731707	GO:0043038	GO:BP	amino acid activation	16175	10488		0.5	0.8	41	16134	3	9	38	16125	16175	0.13409887921903033
M1	cpdb	0	network_modules	442	TRUE	0.009746868087964006	186	12	4	0.3333333333333333	0.021505376344086023	GO:0006399	GO:BP	tRNA metabolic process	16175	2160		1	1	186	15989	4	8	182	15981	16175	0.08225056099594871
M1	cpdb	0	network_modules	444	TRUE	1.6976161075238302e-7	104	12	6	0.5	0.057692307692307696	REAC:R-HSA-194138	REAC	Signaling by VEGF	10916	2313		0	0.2	104	10812	6	6	98	10806	10916	0.167496748309554
M1	cpdb	0	network_modules	444	TRUE	4.021288030566564e-7	51	13	5	0.38461538461538464	0.09803921568627451	GO:0048010	GO:BP	vascular endothelial growth factor receptor signaling pathway	16175	12466		0	0.058823529411764705	51	16124	5	8	46	16116	16175	0.1929739270880319
M1	cpdb	0	network_modules	444	TRUE	1.2076879195408305e-6	4	12	3	0.25	0.75	REAC:R-HSA-194306	REAC	Neurophilin interactions with VEGF and VEGFR	10916	1591		0.25	0.4	4	10912	3	9	1	10903	10916	0.4326951565792737
M1	cpdb	0	network_modules	444	TRUE	1.686583492834049e-5	8	12	3	0.25	0.375	REAC:R-HSA-194313	REAC	VEGF ligand-receptor interactions	10916	2633		0.5	0.8	8	10908	3	9	5	10899	10916	0.3055685724457451
M1	cpdb	0	network_modules	444	TRUE	1.686583492834049e-5	8	12	3	0.25	0.375	REAC:R-HSA-195399	REAC	VEGF binds to VEGFR leading to receptor dimerization	10916	2632		0.5	0.8	8	10908	3	9	5	10899	10916	0.3055685724457451
M1	cpdb	0	network_modules	444	TRUE	4.043247332570388e-5	790	13	8	0.6153846153846154	0.010126582278481013	GO:0007167	GO:BP	enzyme-linked receptor protein signaling pathway	16175	2731		0.0625	0.11764705882352941	790	15385	8	5	782	15380	16175	0.07454862171957258
M1	cpdb	0	network_modules	444	TRUE	4.590529417919415e-5	202	9	5	0.5555555555555556	0.024752475247524754	KEGG:04510	KEGG	Focal adhesion	8484	313		0	0.3333333333333333	202	8282	5	4	197	8278	8484	0.11366140519040868
M1	cpdb	0	network_modules	444	TRUE	4.853685385365309e-5	502	13	7	0.5384615384615384	0.013944223107569721	GO:0071363	GO:BP	cellular response to growth factor stimulus	16175	16615		0.125	0.17647058823529413	502	15673	7	6	495	15667	16175	0.08298759836607107
M1	cpdb	0	network_modules	444	TRUE	5.410872259173168e-5	510	13	7	0.5384615384615384	0.013725490196078431	GO:0007169	GO:BP	cell surface receptor protein tyrosine kinase signaling pathway	16175	2733		0.1875	0.23529411764705882	510	15665	7	6	503	15659	16175	0.08227489162510306
M1	cpdb	0	network_modules	444	TRUE	6.1018019453282346e-5	519	13	7	0.5384615384615384	0.01348747591522158	GO:0070848	GO:BP	response to growth factor	16175	16340		0.25	0.29411764705882354	519	15656	7	6	512	15650	16175	0.0814922994703416
M1	cpdb	0	network_modules	444	TRUE	8.60979884972129e-5	507	12	7	0.5833333333333334	0.013806706114398421	REAC:R-HSA-9006934	REAC	Signaling by Receptor Tyrosine Kinases	10916	2302		1	1	507	10409	7	5	500	10404	10916	0.08463231852947961
M1	cpdb	0	network_modules	444	TRUE	1.298375665588953e-4	58	13	4	0.3076923076923077	0.06896551724137931	GO:0035924	GO:BP	cellular response to vascular endothelial growth factor stimulus	16175	9346		0.3125	0.35294117647058826	58	16117	4	9	54	16108	16175	0.14429060561459006
M1	cpdb	0	network_modules	444	TRUE	5.709207322590613e-4	214	13	5	0.38461538461538464	0.02336448598130841	GO:0018108	GO:BP	peptidyl-tyrosine phosphorylation	16175	5327		0.375	0.4117647058823529	214	15961	5	8	209	15953	16175	0.09218408388014614
M1	cpdb	0	network_modules	444	TRUE	5.842710121711058e-4	215	13	5	0.38461538461538464	0.023255813953488372	GO:0018212	GO:BP	peptidyl-tyrosine modification	16175	5371		0.4375	0.47058823529411764	215	15960	5	8	210	15952	16175	0.09195702316328934
M1	cpdb	0	network_modules	444	TRUE	0.0014082679356248995	59	9	3	0.3333333333333333	0.05084745762711865	KEGG:04370	KEGG	VEGF signaling pathway	8484	307		0.5	0.6666666666666666	59	8425	3	6	56	8419	8484	0.12798627417139175
M1	cpdb	0	network_modules	444	TRUE	0.0015099402409069688	500	13	6	0.46153846153846156	0.012	GO:0001934	GO:BP	positive regulation of protein phosphorylation	16175	548		0.5	0.5294117647058824	500	15675	6	7	494	15668	16175	0.07056355465580094
M1	cpdb	0	network_modules	444	TRUE	0.0019412669650181152	522	13	6	0.46153846153846156	0.011494252873563218	GO:0042327	GO:BP	positive regulation of phosphorylation	16175	10095		0.5625	0.5882352941176471	522	15653	6	7	516	15646	16175	0.06889081198933716
M1	cpdb	0	network_modules	444	TRUE	0.001991641339415838	114	13	4	0.3076923076923077	0.03508771929824561	GO:0002040	GO:BP	sprouting angiogenesis	16175	640		0.625	0.6470588235294118	114	16061	4	9	110	16052	16175	0.10192549001901705
M1	cpdb	0	network_modules	444	TRUE	0.002364770758853039	119	13	4	0.3076923076923077	0.03361344537815126	GO:0001936	GO:BP	regulation of endothelial cell proliferation	16175	550		0.6875	0.7058823529411765	119	16056	4	9	115	16047	16175	0.09967416317027973
M1	cpdb	0	network_modules	444	TRUE	0.0030460080537536897	564	13	6	0.46153846153846156	0.010638297872340425	GO:0010562	GO:BP	positive regulation of phosphorus metabolic process	16175	4215		0.75	0.8235294117647058	564	15611	6	7	558	15604	16175	0.06596376601111235
M1	cpdb	0	network_modules	444	TRUE	0.0030460080537536897	564	13	6	0.46153846153846156	0.010638297872340425	GO:0045937	GO:BP	positive regulation of phosphate metabolic process	16175	11731		0.75	0.8235294117647058	564	15611	6	7	558	15604	16175	0.06596376601111235
M1	cpdb	0	network_modules	444	TRUE	0.003503215481853689	235	9	4	0.4444444444444444	0.01702127659574468	KEGG:04014	KEGG	Ras signaling pathway	8484	247		1	1	235	8249	4	5	231	8244	8484	0.08275383564272067
M1	cpdb	0	network_modules	444	TRUE	0.003912671174068932	135	13	4	0.3076923076923077	0.02962962962962963	GO:0001935	GO:BP	endothelial cell proliferation	16175	549		0.875	0.8823529411764706	135	16040	4	9	131	16031	16175	0.09331961626636728
M1	cpdb	0	network_modules	444	TRUE	0.004923518067838783	40	13	3	0.23076923076923078	0.075	GO:0038084	GO:BP	vascular endothelial growth factor signaling pathway	16175	9685		0.9375	0.9411764705882353	40	16135	3	10	37	16125	16175	0.13036252571258025
M1	cpdb	0	network_modules	444	TRUE	0.005893071178583179	632	13	6	0.46153846153846156	0.00949367088607595	GO:0031401	GO:BP	positive regulation of protein modification process	16175	7157		1	1	632	15543	6	7	626	15536	16175	0.06183495198068731
M1	cpdb	0	network_modules	446	TRUE	3.1147859329046e-13	29	7	6	0.8571428571428571	0.20689655172413793	KEGG:04744	KEGG	Phototransduction	8484	362		NA	1	29	8455	6	1	23	8454	8484	0.4203302138177598
M1	cpdb	0	network_modules	446	TRUE	1.7384522407126229e-12	30	8	6	0.75	0.2	REAC:R-HSA-2514859	REAC	Inactivation, recovery and regulation of the phototransduction cascade	10916	1179		0	0.3333333333333333	30	10886	6	2	24	10884	10916	0.3865521550397531
M1	cpdb	0	network_modules	446	TRUE	2.1553414303782972e-12	31	8	6	0.75	0.1935483870967742	REAC:R-HSA-2514856	REAC	The phototransduction cascade	10916	2501		0.5	0.6666666666666666	31	10885	6	2	25	10883	10916	0.38023718172898435
M1	cpdb	0	network_modules	446	TRUE	7.493019409954666e-10	132	11	7	0.6363636363636364	0.05303030303030303	GO:0007601	GO:BP	visual perception	16175	3060		0	0.05555555555555555	132	16043	7	4	125	16039	16175	0.18215302451907966
M1	cpdb	0	network_modules	446	TRUE	1.0831169649627993e-9	139	11	7	0.6363636363636364	0.050359712230215826	GO:0050953	GO:BP	sensory perception of light stimulus	16175	13395		0.058823529411764705	0.1111111111111111	139	16036	7	4	132	16032	16175	0.17742361890014174
M1	cpdb	0	network_modules	446	TRUE	2.86273359891109e-9	97	8	6	0.75	0.061855670103092786	REAC:R-HSA-2187338	REAC	Visual phototransduction	10916	2654		1	1	97	10819	6	2	91	10817	10916	0.21386588977862922
M1	cpdb	0	network_modules	446	TRUE	1.2876922485831297e-5	529	11	7	0.6363636363636364	0.013232514177693762	GO:0007600	GO:BP	sensory perception	16175	3059		0.11764705882352941	0.16666666666666666	529	15646	7	4	522	15642	16175	0.08853770910551255
M1	cpdb	0	network_modules	446	TRUE	2.2284992121675394e-5	9	11	3	0.2727272727272727	0.3333333333333333	GO:0022400	GO:BP	regulation of opsin-mediated signaling pathway	16175	6591		0.17647058823529413	0.2222222222222222	9	16166	3	8	6	16158	16175	0.30108234664318256
M1	cpdb	0	network_modules	446	TRUE	2.7436816684421116e-5	49	11	4	0.36363636363636365	0.08163265306122448	GO:0009583	GO:BP	detection of light stimulus	16175	3518		0.23529411764705882	0.2777777777777778	49	16126	4	7	45	16119	16175	0.17117447042862408
M1	cpdb	0	network_modules	446	TRUE	3.182388986359117e-5	10	11	3	0.2727272727272727	0.3	GO:0007168	GO:BP	receptor guanylyl cyclase signaling pathway	16175	2732		0.29411764705882354	0.3333333333333333	10	16165	3	8	7	16157	16175	0.2855757448755539
M1	cpdb	0	network_modules	446	TRUE	4.374161108352089e-5	11	11	3	0.2727272727272727	0.2727272727272727	GO:0016056	GO:BP	G protein-coupled opsin signaling pathway	16175	5088		0.35294117647058826	0.3888888888888889	11	16164	3	8	8	16156	16175	0.272232345729005
M1	cpdb	0	network_modules	446	TRUE	1.4818111813315871e-4	16	11	3	0.2727272727272727	0.1875	GO:0007603	GO:BP	phototransduction, visible light	16175	3062		0.4117647058823529	0.4444444444444444	16	16159	3	8	13	16151	16175	0.22550153409960236
M1	cpdb	0	network_modules	446	TRUE	1.798674357516373e-4	17	11	3	0.2727272727272727	0.17647058823529413	GO:0009584	GO:BP	detection of visible light	16175	3519		0.47058823529411764	0.5	17	16158	3	8	14	16150	16175	0.2187256175143531
M1	cpdb	0	network_modules	446	TRUE	2.3386905931512816e-4	806	11	7	0.6363636363636364	0.008684863523573201	GO:0050877	GO:BP	nervous system process	16175	13322		0.5294117647058824	0.5555555555555556	806	15369	7	4	799	15365	16175	0.07031837390671963
M1	cpdb	0	network_modules	446	TRUE	2.844638800290558e-4	87	11	4	0.36363636363636365	0.04597701149425287	GO:0009581	GO:BP	detection of external stimulus	16175	3516		0.5882352941176471	0.6111111111111112	87	16088	4	7	83	16081	16175	0.12777652728403843
M1	cpdb	0	network_modules	446	TRUE	3.4108625580083006e-4	91	11	4	0.36363636363636365	0.04395604395604396	GO:0009582	GO:BP	detection of abiotic stimulus	16175	3517		0.6470588235294118	0.6666666666666666	91	16084	4	7	87	16077	16175	0.12486597786966824
M1	cpdb	0	network_modules	446	TRUE	0.0011089202447214193	122	11	4	0.36363636363636365	0.03278688524590164	GO:0008277	GO:BP	regulation of G protein-coupled receptor signaling pathway	16175	3149		0.7058823529411765	0.7222222222222222	122	16053	4	7	118	16046	16175	0.1073674597111387
M1	cpdb	0	network_modules	446	TRUE	0.001432875283621309	3	11	2	0.18181818181818182	0.6666666666666666	GO:0031282	GO:BP	regulation of guanylate cyclase activity	16175	7106		0.7647058823529411	0.7777777777777778	3	16172	2	9	1	16163	16175	0.3479507533206276
M1	cpdb	0	network_modules	446	TRUE	0.00239769911521365	39	11	3	0.2727272727272727	0.07692307692307693	GO:0007602	GO:BP	phototransduction	16175	3061		0.8235294117647058	0.8333333333333334	39	16136	3	8	36	16128	16175	0.14378313524319236
M1	cpdb	0	network_modules	446	TRUE	0.0036145067045023566	164	11	4	0.36363636363636365	0.024390243902439025	GO:0006164	GO:BP	purine nucleotide biosynthetic process	16175	1999		0.8823529411764706	0.8888888888888888	164	16011	4	7	160	16004	16175	0.09204943141380294
M1	cpdb	0	network_modules	446	TRUE	0.0050280908962910195	774	11	6	0.5454545454545454	0.007751937984496124	GO:0007186	GO:BP	G protein-coupled receptor signaling pathway	16175	2744		0.9411764705882353	0.9444444444444444	774	15401	6	5	768	15396	16175	0.06081408722745404
M1	cpdb	0	network_modules	446	TRUE	0.005960738066782385	186	11	4	0.36363636363636365	0.021505376344086023	GO:0009165	GO:BP	nucleotide biosynthetic process	16175	3331		1	1	186	15989	4	7	182	15982	16175	0.08616103672128299
M1	cpdb	0	network_modules	450	TRUE	0.0016764303207580484	5	9	2	0.2222222222222222	0.4	REAC:R-HSA-2161517	REAC	Abacavir transmembrane transport	10916	45		0	0.5	5	10911	2	7	3	10904	10916	0.2977187878175293
M1	cpdb	0	network_modules	450	TRUE	0.006024832901546089	9	9	2	0.2222222222222222	0.2222222222222222	REAC:R-HSA-2161522	REAC	Abacavir ADME	10916	43		1	1	9	10907	2	7	7	10900	10916	0.22158043254586762
M1	cpdb	0	network_modules	450	TRUE	0.007156405668604097	6	11	2	0.18181818181818182	0.3333333333333333	GO:1990962	GO:BP	xenobiotic transport across blood-brain barrier	16175	25356		NA	1	6	16169	2	9	4	16160	16175	0.24580989962527874
M1	cpdb	0	network_modules	452	TRUE	2.915868111959612e-11	4	8	4	0.5	1	REAC:R-HSA-112126	REAC	ALKBH3 mediated reversal of alkylation damage	10916	19		0	0.16666666666666666	4	10912	4	4	0	10908	10916	0.7069771676246143
M1	cpdb	0	network_modules	452	TRUE	1.0196561969435468e-9	7	8	4	0.5	0.5714285714285714	REAC:R-HSA-73943	REAC	Reversal of alkylation damage by DNA dioxygenases	10916	2099		0.2	0.3333333333333333	7	10909	4	4	3	10905	10916	0.5342039808204538
M1	cpdb	0	network_modules	452	TRUE	2.0387142399625177e-9	8	8	4	0.5	0.5	REAC:R-HSA-73942	REAC	DNA Damage Reversal	10916	440		0.4	0.5	8	10908	4	4	4	10904	10916	0.49963329666299966
M1	cpdb	0	network_modules	452	TRUE	4.329994377818361e-8	11	11	4	0.36363636363636365	0.36363636363636365	GO:0006307	GO:BP	DNA alkylation repair	16175	2112		0	0.2	11	16164	4	7	7	16157	16175	0.3632033025128794
M1	cpdb	0	network_modules	452	TRUE	0.003234279216188246	8	8	2	0.25	0.25	REAC:R-HSA-72200	REAC	mRNA Editing: C to U Conversion	10916	2705		0.6	0.8333333333333334	8	10908	2	6	6	10902	10916	0.24944994499449946
M1	cpdb	0	network_modules	452	TRUE	0.003234279216188246	8	8	2	0.25	0.25	REAC:R-HSA-75094	REAC	Formation of the Editosome	10916	964		0.6	0.8333333333333334	8	10908	2	6	6	10902	10916	0.24944994499449946
M1	cpdb	0	network_modules	452	TRUE	0.0034682359164210975	44	11	3	0.2727272727272727	0.06818181818181818	GO:0032508	GO:BP	DNA duplex unwinding	16175	7615		0.25	0.4	44	16131	3	8	41	16123	16175	0.1352335010505478
M1	cpdb	0	network_modules	452	TRUE	0.005194138758048245	10	8	2	0.25	0.2	REAC:R-HSA-75072	REAC	mRNA Editing	10916	2703		1	1	10	10906	2	6	8	10900	10916	0.22297126089211025
M1	cpdb	0	network_modules	452	TRUE	0.005770202474320793	52	11	3	0.2727272727272727	0.057692307692307696	GO:0032392	GO:BP	DNA geometric change	16175	7543		0.5	0.6	52	16123	3	8	49	16115	16175	0.12419966375855541
M1	cpdb	0	network_modules	452	TRUE	0.007156405668604097	6	11	2	0.18181818181818182	0.3333333333333333	GO:1990116	GO:BP	ribosome-associated ubiquitin-dependent protein catabolic process	16175	25088		0.75	0.8	6	16169	2	9	4	16160	16175	0.24580989962527874
M1	cpdb	0	network_modules	452	TRUE	0.008908156749272592	60	11	3	0.2727272727272727	0.05	GO:0071103	GO:BP	DNA conformation change	16175	16453		1	1	60	16115	3	8	57	16107	16175	0.11544005358296473
M1	cpdb	0	network_modules	455	TRUE	0.001283697503478669	4	8	2	0.25	0.5	GO:0043490	GO:BP	malate-aspartate shuttle	16175	10735		0	0.5	4	16171	2	6	2	16165	16175	0.3533347320367318
M1	cpdb	0	network_modules	455	TRUE	0.0024163037408110387	10	6	2	0.3333333333333333	0.2	REAC:R-HSA-428643	REAC	Organic anion transporters	10916	1648		NA	1	10	10906	2	4	8	10902	10916	0.2576781409088113
M1	cpdb	0	network_modules	455	TRUE	0.008544033093902448	88	8	3	0.375	0.03409090909090909	GO:1990542	GO:BP	mitochondrial transmembrane transport	16175	25201		1	1	88	16087	3	5	85	16082	16175	0.11175837384845644
M1	cpdb	0	network_modules	456	TRUE	7.344090615103274e-9	182	11	7	0.6363636363636364	0.038461538461538464	GO:0006457	GO:BP	protein folding	16175	2203		0	0.16666666666666666	182	15993	7	4	175	15989	16175	0.15460487322190364
M1	cpdb	0	network_modules	456	TRUE	1.8444721964100025e-8	168	7	6	0.8571428571428571	0.03571428571428571	KEGG:04141	KEGG	Protein processing in endoplasmic reticulum	8484	278		NA	1	168	8316	6	1	162	8315	8484	0.17271060281615144
M1	cpdb	0	network_modules	456	TRUE	4.329994377818361e-8	11	11	4	0.36363636363636365	0.36363636363636365	GO:0034975	GO:BP	protein folding in endoplasmic reticulum	16175	8745		0.2	0.3333333333333333	11	16164	4	7	7	16157	16175	0.3632033025128794
M1	cpdb	0	network_modules	456	TRUE	6.855436926166704e-6	483	11	7	0.6363636363636364	0.014492753623188406	GO:0051604	GO:BP	protein maturation	16175	13821		0.4	0.5	483	15692	7	4	476	15688	16175	0.09295789122991412
M1	cpdb	0	network_modules	456	TRUE	1.074442912444946e-5	107	11	5	0.45454545454545453	0.04672897196261682	REAC:R-HSA-8957275	REAC	Post-translational protein phosphorylation	10916	1777		0	0.2	107	10809	5	6	102	10803	10916	0.143374471523884
M1	cpdb	0	network_modules	456	TRUE	2.2577639152703712e-5	124	11	5	0.45454545454545453	0.04032258064516129	REAC:R-HSA-381426	REAC	Regulation of Insulin-like Growth Factor (IGF) transport and uptake by Insulin-like Growth Factor Binding Proteins (IGFBPs)	10916	1981		0.25	0.4	124	10792	5	6	119	10786	10916	0.1328223742316966
M1	cpdb	0	network_modules	456	TRUE	5.78262523696255e-4	26	11	3	0.2727272727272727	0.11538461538461539	REAC:R-HSA-901042	REAC	Calnexin/calreticulin cycle	10916	302		0.5	0.6	26	10890	3	8	23	10882	10916	0.17614303780331245
M1	cpdb	0	network_modules	456	TRUE	0.0014484704857717812	35	11	3	0.2727272727272727	0.08571428571428572	REAC:R-HSA-532668	REAC	N-glycan trimming in the ER and Calnexin/Calreticulin cycle	10916	1508		0.75	0.8	35	10881	3	8	32	10873	10916	0.15141579055084173
M1	cpdb	0	network_modules	456	TRUE	0.007156405668604097	6	11	2	0.18181818181818182	0.3333333333333333	GO:0002502	GO:BP	peptide antigen assembly with MHC class I protein complex	16175	1025		0.6	0.8333333333333334	6	16169	2	9	4	16160	16175	0.24580989962527874
M1	cpdb	0	network_modules	456	TRUE	0.007156405668604097	6	11	2	0.18181818181818182	0.3333333333333333	GO:0002397	GO:BP	MHC class I protein complex assembly	16175	921		0.6	0.8333333333333334	6	16169	2	9	4	16160	16175	0.24580989962527874
M1	cpdb	0	network_modules	456	TRUE	0.007947678456419636	200	11	4	0.36363636363636365	0.02	GO:0034976	GO:BP	response to endoplasmic reticulum stress	16175	8746		1	1	200	15975	4	7	196	15968	16175	0.08292277411375908
M1	cpdb	0	network_modules	456	TRUE	0.009795339157893589	9	11	2	0.18181818181818182	0.2222222222222222	REAC:R-HSA-381183	REAC	ATF6 (ATF6-alpha) activates chaperone genes	10916	36		1	1	9	10907	2	9	7	10898	10916	0.20027954273656026
M1	cpdb	0	network_modules	457	TRUE	1.856623623588014e-19	59	12	10	0.8333333333333334	0.1694915254237288	REAC:R-HSA-6790901	REAC	rRNA modification in the nucleus and cytosol	10916	2731		0	0.25	59	10857	10	2	49	10855	10916	0.3746045915319354
M1	cpdb	0	network_modules	457	TRUE	3.3389580358964566e-19	94	11	10	0.9090909090909091	0.10638297872340426	GO:0042274	GO:BP	ribosomal small subunit biogenesis	16175	10071		0	0.1	94	16081	10	1	84	16080	16175	0.31000442903812164
M1	cpdb	0	network_modules	457	TRUE	7.194281511064859e-17	182	12	11	0.9166666666666666	0.06043956043956044	REAC:R-HSA-6791226	REAC	Major pathway of rRNA processing in the nucleolus and cytosol	10916	1389		0.3333333333333333	0.5	182	10734	11	1	171	10733	10916	0.23317624352322475
M1	cpdb	0	network_modules	457	TRUE	1.3159761805499773e-16	192	12	11	0.9166666666666666	0.057291666666666664	REAC:R-HSA-8868773	REAC	rRNA processing in the nucleus and cytosol	10916	2734		0.6666666666666666	0.75	192	10724	11	1	181	10723	10916	0.22689738405486637
M1	cpdb	0	network_modules	457	TRUE	2.332467497475226e-16	202	12	11	0.9166666666666666	0.054455445544554455	REAC:R-HSA-72312	REAC	rRNA processing	10916	2732		1	1	202	10714	11	1	191	10713	10916	0.22108753831535435
M1	cpdb	0	network_modules	457	TRUE	8.348790013291262e-15	251	11	10	0.9090909090909091	0.0398406374501992	GO:0042254	GO:BP	ribosome biogenesis	16175	10060		0.1111111111111111	0.2	251	15924	10	1	241	15923	16175	0.18859638722764532
M1	cpdb	0	network_modules	457	TRUE	7.351118892893542e-14	169	11	9	0.8181818181818182	0.05325443786982249	GO:0006364	GO:BP	rRNA processing	16175	2140		0.2222222222222222	0.3	169	16006	9	2	160	16004	16175	0.2072285551879709
M1	cpdb	0	network_modules	457	TRUE	4.326736723042082e-13	205	11	9	0.8181818181818182	0.04390243902439024	GO:0016072	GO:BP	rRNA metabolic process	16175	5099		0.3333333333333333	0.4	205	15970	9	2	196	15968	16175	0.18784803109979434
M1	cpdb	0	network_modules	457	TRUE	7.251321423068282e-13	390	11	10	0.9090909090909091	0.02564102564102564	GO:0022613	GO:BP	ribonucleoprotein complex biogenesis	16175	6620		0.4444444444444444	0.5	390	15785	10	1	380	15784	16175	0.15050290648036338
M1	cpdb	0	network_modules	457	TRUE	1.2011387528702452e-10	139	8	7	0.875	0.050359712230215826	KEGG:03008	KEGG	Ribosome biogenesis in eukaryotes	8484	207		NA	1	139	8345	7	1	132	8344	8484	0.20779193937481497
M1	cpdb	0	network_modules	457	TRUE	7.706115751813797e-8	46	11	5	0.45454545454545453	0.10869565217391304	GO:0030490	GO:BP	maturation of SSU-rRNA	16175	6815		0.5555555555555556	0.6	46	16129	5	6	41	16123	16175	0.2212764342209966
M1	cpdb	0	network_modules	457	TRUE	8.630062711246121e-4	28	11	3	0.2727272727272727	0.10714285714285714	GO:0000462	GO:BP	maturation of SSU-rRNA from tricistronic rRNA transcript (SSU-rRNA, 5.8S rRNA, LSU-rRNA)	16175	152		0.6666666666666666	0.7	28	16147	3	8	25	16139	16175	0.17006090420272324
M1	cpdb	0	network_modules	457	TRUE	0.004772707732796983	5	11	2	0.18181818181818182	0.4	GO:0000472	GO:BP	endonucleolytic cleavage to generate mature 5'-end of SSU-rRNA from (SSU-rRNA, 5.8S rRNA, LSU-rRNA)	16175	161		0.7777777777777778	1	5	16170	2	9	3	16161	16175	0.26935467227213133
M1	cpdb	0	network_modules	457	TRUE	0.004772707732796983	5	11	2	0.18181818181818182	0.4	GO:0000967	GO:BP	rRNA 5'-end processing	16175	275		0.7777777777777778	1	5	16170	2	9	3	16161	16175	0.26935467227213133
M1	cpdb	0	network_modules	457	TRUE	0.004772707732796983	5	11	2	0.18181818181818182	0.4	GO:0000480	GO:BP	endonucleolytic cleavage in 5'-ETS of tricistronic rRNA transcript (SSU-rRNA, 5.8S rRNA, LSU-rRNA)	16175	168		0.7777777777777778	1	5	16170	2	9	3	16161	16175	0.26935467227213133
M1	cpdb	0	network_modules	466	TRUE	3.097541159947832e-9	82	10	6	0.6	0.07317073170731707	GO:0019646	GO:BP	aerobic electron transport chain	16175	5967		0	0.07692307692307693	82	16093	6	4	76	16089	16175	0.2083517725130699
M1	cpdb	0	network_modules	466	TRUE	4.7878190018545735e-9	88	10	6	0.6	0.06818181818181818	GO:0042775	GO:BP	mitochondrial ATP synthesis coupled electron transport	16175	10360		0.08333333333333333	0.23076923076923078	88	16087	6	4	82	16083	16175	0.2010355648938779
M1	cpdb	0	network_modules	466	TRUE	4.7878190018545735e-9	88	10	6	0.6	0.06818181818181818	GO:0042773	GO:BP	ATP synthesis coupled electron transport	16175	10358		0.08333333333333333	0.23076923076923078	88	16087	6	4	82	16083	16175	0.2010355648938779
M1	cpdb	0	network_modules	466	TRUE	9.876412955698348e-9	99	10	6	0.6	0.06060606060606061	GO:0022904	GO:BP	respiratory electron transport chain	16175	6631		0.25	0.3076923076923077	99	16076	6	4	93	16072	16175	0.1893861135155447
M1	cpdb	0	network_modules	466	TRUE	1.3894608317865793e-8	103	9	6	0.6666666666666666	0.05825242718446602	REAC:R-HSA-611105	REAC	Respiratory electron transport	10916	2081		0	0.5	103	10813	6	3	97	10810	10916	0.19528030075284478
M1	cpdb	0	network_modules	466	TRUE	1.5902041082685592e-8	107	10	6	0.6	0.056074766355140186	GO:0022900	GO:BP	electron transport chain	16175	6630		0.3333333333333333	0.38461538461538464	107	16068	6	4	101	16064	16175	0.18206232761008725
M1	cpdb	0	network_modules	466	TRUE	4.529204488813885e-8	127	10	6	0.6	0.047244094488188976	GO:0006119	GO:BP	oxidative phosphorylation	16175	1977		0.4166666666666667	0.46153846153846156	127	16048	6	4	121	16044	16175	0.1668686144529346
M1	cpdb	0	network_modules	466	TRUE	5.5876877347667944e-8	13	10	4	0.4	0.3076923076923077	GO:0006122	GO:BP	mitochondrial electron transport, ubiquinol to cytochrome c	16175	1980		0.5	0.5384615384615384	13	16162	4	6	9	16156	16175	0.35036741145491396
M1	cpdb	0	network_modules	466	TRUE	6.062315213123311e-8	134	9	6	0.6666666666666666	0.04477611940298507	KEGG:00190	KEGG	Oxidative phosphorylation	8484	18		0	0.09090909090909091	134	8350	6	3	128	8347	8484	0.1701187436229632
M1	cpdb	0	network_modules	466	TRUE	1.4091056647963675e-7	154	9	6	0.6666666666666666	0.03896103896103896	KEGG:04932	KEGG	Non-alcoholic fatty liver disease	8484	389		0.1	0.18181818181818182	154	8330	6	3	148	8327	8484	0.15830299305961829
M1	cpdb	0	network_modules	466	TRUE	1.9880165919441803e-7	162	10	6	0.6	0.037037037037037035	GO:0009060	GO:BP	aerobic respiration	16175	3236		0.5833333333333334	0.6153846153846154	162	16013	6	4	156	16009	16175	0.147368007027877
M1	cpdb	0	network_modules	466	TRUE	3.7430148281600913e-7	177	9	6	0.6666666666666666	0.03389830508474576	REAC:R-HSA-1428517	REAC	Aerobic respiration and respiratory electron transport	10916	127		1	1	177	10739	6	3	171	10736	10916	0.14793767241827202
M1	cpdb	0	network_modules	466	TRUE	3.8713285584627764e-7	372	10	7	0.7	0.01881720430107527	GO:0006091	GO:BP	generation of precursor metabolites and energy	16175	1954		0.6666666666666666	0.6923076923076923	372	15803	7	3	365	15800	16175	0.11233235274362222
M1	cpdb	0	network_modules	466	TRUE	4.892642642150964e-7	188	10	6	0.6	0.031914893617021274	GO:0045333	GO:BP	cellular respiration	16175	11360		0.75	0.7692307692307693	188	15987	6	4	182	15983	16175	0.1365368259712767
M1	cpdb	0	network_modules	466	TRUE	2.857558530008954e-6	252	10	6	0.6	0.023809523809523808	GO:0015980	GO:BP	energy derivation by oxidation of organic compounds	16175	5060		0.8333333333333334	0.8461538461538461	252	15923	6	4	246	15919	16175	0.11737323793423492
M1	cpdb	0	network_modules	466	TRUE	3.684997398579235e-6	265	9	6	0.6666666666666666	0.022641509433962263	KEGG:05012	KEGG	Parkinson disease	8484	412		0.2	0.2727272727272727	265	8219	6	3	259	8216	8484	0.11903873578113434
M1	cpdb	0	network_modules	466	TRUE	4.212292586315994e-6	271	9	6	0.6666666666666666	0.02214022140221402	KEGG:05020	KEGG	Prion disease	8484	416		0.3	0.36363636363636365	271	8213	6	3	265	8210	8484	0.11762551883336496
M1	cpdb	0	network_modules	466	TRUE	8.52337351099057e-6	305	9	6	0.6666666666666666	0.019672131147540985	KEGG:05016	KEGG	Huntington disease	8484	414		0.4	0.45454545454545453	305	8179	6	3	299	8176	8484	0.11040438642520208
M1	cpdb	0	network_modules	466	TRUE	2.3977945568585888e-5	363	9	6	0.6666666666666666	0.01652892561983471	KEGG:05014	KEGG	Amyotrophic lateral sclerosis	8484	413		0.5	0.5454545454545454	363	8121	6	3	357	8118	8484	0.10046047505520381
M1	cpdb	0	network_modules	466	TRUE	3.243836044758185e-5	382	9	6	0.6666666666666666	0.015706806282722512	KEGG:05010	KEGG	Alzheimer disease	8484	411		0.6	0.6363636363636364	382	8102	6	3	376	8099	8484	0.09769306288250185
M1	cpdb	0	network_modules	466	TRUE	4.590529417919415e-5	202	9	5	0.5555555555555556	0.024752475247524754	KEGG:05415	KEGG	Diabetic cardiomyopathy	8484	492		0.7	0.7272727272727273	202	8282	5	4	197	8278	8484	0.11366140519040868
M1	cpdb	0	network_modules	466	TRUE	6.75705182900353e-5	87	9	4	0.4444444444444444	0.04597701149425287	KEGG:04260	KEGG	Cardiac muscle contraction	8484	296		0.8	0.8181818181818182	87	8397	4	5	83	8392	8484	0.1404462095131323
M1	cpdb	0	network_modules	466	TRUE	7.171941969707937e-5	221	9	5	0.5555555555555556	0.02262443438914027	KEGG:05208	KEGG	Chemical carcinogenesis - reactive oxygen species	8484	460		0.9	0.9090909090909091	221	8263	5	4	216	8259	8484	0.10833239927174654
M1	cpdb	0	network_modules	466	TRUE	9.123116169366395e-5	232	9	5	0.5555555555555556	0.021551724137931036	KEGG:04714	KEGG	Thermogenesis	8484	349		1	1	232	8252	5	4	227	8248	8484	0.10554436425330098
M1	cpdb	0	network_modules	466	TRUE	0.00365614327046356	5	10	2	0.2	0.4	GO:0006105	GO:BP	succinate metabolic process	16175	1964		0.9166666666666666	1	5	16170	2	8	3	16162	16175	0.28253656168710733
M1	cpdb	0	network_modules	466	TRUE	0.00365614327046356	5	10	2	0.2	0.4	GO:0006121	GO:BP	mitochondrial electron transport, succinate to ubiquinone	16175	1979		0.9166666666666666	1	5	16170	2	8	3	16162	16175	0.28253656168710733
M1	cpdb	0	network_modules	468	TRUE	1.0631610096373097e-6	4	11	3	0.2727272727272727	0.75	GO:0140916	GO:BP	zinc ion import into lysosome	16175	19936		0	0.16666666666666666	4	16171	3	8	1	16163	16175	0.4520665482913926
M1	cpdb	0	network_modules	468	TRUE	5.311861182755614e-6	6	11	3	0.2727272727272727	0.5	GO:0034486	GO:BP	vacuolar transmembrane transport	16175	8657		0.2	0.3333333333333333	6	16169	3	8	3	16161	16175	0.36896611095097825
M1	cpdb	0	network_modules	468	TRUE	3.182388986359117e-5	10	11	3	0.2727272727272727	0.3	GO:0062111	GO:BP	zinc ion import into organelle	16175	15827		0.4	0.5	10	16165	3	8	7	16157	16175	0.2855757448755539
M1	cpdb	0	network_modules	468	TRUE	1.6779674839189002e-4	5	4	2	0.5	0.4	REAC:R-HSA-435368	REAC	Zinc efflux and compartmentalization by the SLC30 family	10916	2681		0	0.25	5	10911	2	2	3	10909	10916	0.44698817556185216
M1	cpdb	0	network_modules	468	TRUE	6.854344208902706e-4	26	11	3	0.2727272727272727	0.11538461538461539	GO:0071577	GO:BP	zinc ion transmembrane transport	16175	16768		0.6	0.6666666666666666	26	16149	3	8	23	16141	16175	0.17655012993826932
M1	cpdb	0	network_modules	468	TRUE	8.630062711246121e-4	28	11	3	0.2727272727272727	0.10714285714285714	GO:0006829	GO:BP	zinc ion transport	16175	2503		0.8	0.8333333333333334	28	16147	3	8	25	16139	16175	0.17006090420272324
M1	cpdb	0	network_modules	468	TRUE	0.0010687437124711026	30	11	3	0.2727272727272727	0.1	GO:0010043	GO:BP	response to zinc ion	16175	3852		1	1	30	16145	3	8	27	16137	16175	0.16422965067086123
M1	cpdb	0	network_modules	468	TRUE	0.0017597137558513893	15	4	2	0.5	0.13333333333333333	REAC:R-HSA-435354	REAC	Zinc transporters	10916	2683		0.3333333333333333	0.5	15	10901	2	2	13	10899	10916	0.25771360850700775
M1	cpdb	0	network_modules	468	TRUE	0.004620445367777783	24	4	2	0.5	0.08333333333333333	REAC:R-HSA-425410	REAC	Metal ion SLC transporters	10916	1442		0.6666666666666666	0.75	24	10892	2	2	22	10890	10916	0.20348763012649823
M1	cpdb	0	network_modules	468	TRUE	0.007323454428993245	245	4	3	0.75	0.012244897959183673	REAC:R-HSA-425407	REAC	SLC-mediated transmembrane transport	10916	2146		1	1	245	10671	3	1	242	10670	10916	0.09404205215754793
M1	cpdb	0	network_modules	470	TRUE	4.742355575433494e-22	80	11	11	1	0.1375	REAC:R-HSA-380287	REAC	Centrosome maturation	10916	341		0	0.2857142857142857	80	10836	11	0	69	10836	10916	0.3696349364506037
M1	cpdb	0	network_modules	470	TRUE	4.742355575433494e-22	80	11	11	1	0.1375	REAC:R-HSA-380270	REAC	Recruitment of mitotic centrosome proteins and complexes	10916	1951		0	0.2857142857142857	80	10836	11	0	69	10836	10916	0.3696349364506037
M1	cpdb	0	network_modules	470	TRUE	3.1249603587836363e-21	94	11	11	1	0.11702127659574468	REAC:R-HSA-380320	REAC	Recruitment of NuMA to mitotic centrosomes	10916	1950		0.3333333333333333	0.42857142857142855	94	10822	11	0	83	10822	10916	0.3407794091707005
M1	cpdb	0	network_modules	470	TRUE	2.916794555210442e-18	88	9	9	1	0.10227272727272728	GO:0046785	GO:BP	microtubule polymerization	16175	12369		0	0.07692307692307693	88	16087	9	0	79	16087	16175	0.3190187156966865
M1	cpdb	0	network_modules	470	TRUE	1.318867500889433e-17	195	11	11	1	0.05641025641025641	REAC:R-HSA-69275	REAC	G2/M Transition	10916	1008		0.5	0.5714285714285714	195	10721	11	0	184	10721	10916	0.23549617086076655
M1	cpdb	0	network_modules	470	TRUE	1.4799218815560193e-17	197	11	11	1	0.05583756345177665	REAC:R-HSA-453274	REAC	Mitotic G2-G2/M phases	10916	1481		0.6666666666666666	0.7142857142857143	197	10719	11	0	186	10719	10916	0.23427585417531407
M1	cpdb	0	network_modules	470	TRUE	1.658660882269604e-17	199	11	11	1	0.05527638190954774	REAC:R-HSA-68877	REAC	Mitotic Prometaphase	10916	1484		0.8333333333333334	0.8571428571428571	199	10717	11	0	188	10717	10916	0.23307386862755047
M1	cpdb	0	network_modules	470	TRUE	2.149082810857685e-17	46	9	8	0.8888888888888888	0.17391304347826086	GO:0007020	GO:BP	microtubule nucleation	16175	2628		0.08333333333333333	0.15384615384615385	46	16129	8	1	38	16128	16175	0.3925883395386436
M1	cpdb	0	network_modules	470	TRUE	7.243798573741316e-17	124	9	9	1	0.07258064516129033	GO:0031109	GO:BP	microtubule polymerization or depolymerization	16175	7034		0.16666666666666666	0.23076923076923078	124	16051	9	0	115	16051	16175	0.2684479997298227
M1	cpdb	0	network_modules	470	TRUE	2.9576382198576996e-14	238	9	9	1	0.037815126050420166	GO:0051258	GO:BP	protein polymerization	16175	13605		0.25	0.3076923076923077	238	15937	9	0	229	15937	16175	0.19307888193587344
M1	cpdb	0	network_modules	470	TRUE	4.8866691059159564e-14	406	11	11	1	0.027093596059113302	REAC:R-HSA-68886	REAC	M Phase	10916	1343		1	1	406	10510	11	0	395	10510	10916	0.1615927414321739
M1	cpdb	0	network_modules	470	TRUE	1.0777268403422857e-10	586	9	9	1	0.015358361774744027	GO:0000226	GO:BP	microtubule cytoskeleton organization	16175	61		0.3333333333333333	0.38461538461538464	586	15589	9	0	577	15589	16175	0.12169711645947827
M1	cpdb	0	network_modules	470	TRUE	9.825919106000619e-10	748	9	9	1	0.012032085561497326	GO:0097435	GO:BP	supramolecular fiber organization	16175	18657		0.4166666666666667	0.46153846153846156	748	15427	9	0	739	15427	16175	0.10715437519553006
M1	cpdb	0	network_modules	470	TRUE	9.59759392290549e-8	361	9	7	0.7777777777777778	0.019390581717451522	GO:0007059	GO:BP	chromosome segregation	16175	2658		0.5	0.5384615384615384	361	15814	7	2	354	15812	16175	0.12067044367435908
M1	cpdb	0	network_modules	470	TRUE	1.3254579867627405e-7	176	9	6	0.6666666666666666	0.03409090909090909	GO:0007051	GO:BP	spindle organization	16175	2650		0.5833333333333334	0.6153846153846154	176	15999	6	3	170	15996	16175	0.14915005953902952
M1	cpdb	0	network_modules	470	TRUE	2.926679441049974e-7	792	9	8	0.8888888888888888	0.010101010101010102	GO:0000278	GO:BP	mitotic cell cycle	16175	76		0.6666666666666666	0.6923076923076923	792	15383	8	1	784	15382	16175	0.09183777710007894
M1	cpdb	0	network_modules	470	TRUE	1.995418779839329e-6	113	9	5	0.5555555555555556	0.04424778761061947	GO:0051225	GO:BP	spindle assembly	16175	13578		0.75	0.7692307692307693	113	16062	5	4	108	16058	16175	0.15540208983016338
M1	cpdb	0	network_modules	470	TRUE	7.373604740773406e-6	343	9	6	0.6666666666666666	0.01749271137026239	GO:0140694	GO:BP	membraneless organelle assembly	16175	19860		0.8333333333333334	0.8461538461538461	343	15832	6	3	337	15829	16175	0.10571080539759393
M1	cpdb	0	network_modules	470	TRUE	1.2577785537889712e-5	52	9	4	0.4444444444444444	0.07692307692307693	GO:0031122	GO:BP	cytoplasmic microtubule organization	16175	7047		0.9166666666666666	0.9230769230769231	52	16123	4	5	48	16118	16175	0.1839095594897652
M1	cpdb	0	network_modules	470	TRUE	3.8142173908812056e-5	203	9	5	0.5555555555555556	0.024630541871921183	GO:0051321	GO:BP	meiotic cell cycle	16175	13648		1	1	203	15972	5	4	198	15968	16175	0.11509081742376769
M1	cpdb	0	network_modules	471	TRUE	3.557817562585185e-6	8	8	3	0.375	0.375	REAC:R-HSA-201688	REAC	WNT mediated activation of DVL	10916	2669		0	0.25	8	10908	3	5	5	10903	10916	0.37454162082874953
M1	cpdb	0	network_modules	471	TRUE	6.940768756872857e-4	4	8	2	0.25	0.5	REAC:R-HSA-5368598	REAC	Negative regulation of TCF-dependent signaling by DVL-interacting proteins	10916	1577		0.3333333333333333	0.5	4	10912	2	6	2	10906	10916	0.35322933292575615
M1	cpdb	0	network_modules	471	TRUE	0.002448598409476608	684	11	6	0.5454545454545454	0.008771929824561403	GO:0032880	GO:BP	regulation of protein localization	16175	7877		0	0.3333333333333333	684	15491	6	5	678	15486	16175	0.06522448211327297
M1	cpdb	0	network_modules	471	TRUE	0.005103996156596798	776	11	6	0.5454545454545454	0.007731958762886598	GO:0060341	GO:BP	regulation of cellular localization	16175	14553		0.5	0.6666666666666666	776	15399	6	5	770	15394	16175	0.06072451902742205
M1	cpdb	0	network_modules	471	TRUE	0.005851359624240892	157	6	3	0.5	0.01910828025477707	KEGG:04390	KEGG	Hippo signaling pathway	8484	310		0	0.5	157	8327	3	3	154	8324	8484	0.09504447397336306
M1	cpdb	0	network_modules	471	TRUE	0.007612486045548108	12	8	2	0.25	0.16666666666666666	REAC:R-HSA-9673324	REAC	WNT5:FZD7-mediated leishmania damping	10916	2670		0.6666666666666666	1	12	10904	2	6	10	10898	10916	0.20341291469682457
M1	cpdb	0	network_modules	471	TRUE	0.007612486045548108	12	8	2	0.25	0.16666666666666666	REAC:R-HSA-9664420	REAC	Killing mechanisms	10916	1291		0.6666666666666666	1	12	10904	2	6	10	10898	10916	0.20341291469682457
M1	cpdb	0	network_modules	471	TRUE	0.007944034410447748	174	6	3	0.5	0.017241379310344827	KEGG:04310	KEGG	Wnt signaling pathway	8484	299		1	1	174	8310	3	3	171	8307	8484	0.08999838729959335
M1	cpdb	0	network_modules	471	TRUE	0.009365442617159088	61	11	3	0.2727272727272727	0.04918032786885246	GO:0035567	GO:BP	non-canonical Wnt signaling pathway	16175	9097		1	1	61	16114	3	8	58	16106	16175	0.11446715388212408
M1	cpdb	0	network_modules	475	TRUE	4.140918295978248e-25	34	10	10	1	0.29411764705882354	GO:0051932	GO:BP	synaptic transmission, GABAergic	16175	14002		0	0.043478260869565216	34	16141	10	0	24	16141	16175	0.5419234021348484
M1	cpdb	0	network_modules	475	TRUE	2.5375356222069957e-23	22	10	9	0.9	0.4090909090909091	GO:0007214	GO:BP	gamma-aminobutyric acid signaling pathway	16175	2768		0.045454545454545456	0.08695652173913043	22	16153	9	1	13	16152	16175	0.6064628242089116
M1	cpdb	0	network_modules	475	TRUE	2.365315522426232e-20	40	9	9	1	0.225	KEGG:05033	KEGG	Nicotine addiction	8484	421		0	0.16666666666666666	40	8444	9	0	31	8444	8484	0.4734733267571073
M1	cpdb	0	network_modules	475	TRUE	2.7080524890259575e-19	54	10	9	0.9	0.16666666666666666	GO:1902476	GO:BP	chloride transmembrane transport	16175	22306		0.09090909090909091	0.13043478260869565	54	16121	9	1	45	16120	16175	0.38662692550003447
M1	cpdb	0	network_modules	475	TRUE	1.6268432996245097e-18	65	10	9	0.9	0.13846153846153847	GO:0098656	GO:BP	monoatomic anion transmembrane transport	16175	18812		0.13636363636363635	0.17391304347826086	65	16110	9	1	56	16109	16175	0.35225000345245955
M1	cpdb	0	network_modules	475	TRUE	2.175770587543298e-18	67	10	9	0.9	0.13432835820895522	GO:0098661	GO:BP	inorganic anion transmembrane transport	16175	18817		0.18181818181818182	0.21739130434782608	67	16108	9	1	58	16107	16175	0.3469263643673971
M1	cpdb	0	network_modules	475	TRUE	2.0930347600896192e-17	85	10	9	0.9	0.10588235294117647	GO:0006821	GO:BP	chloride transport	16175	2498		0.22727272727272727	0.2608695652173913	85	16090	9	1	76	16089	16175	0.30779971888928204
M1	cpdb	0	network_modules	475	TRUE	5.498336819727973e-17	89	9	9	1	0.10112359550561797	KEGG:05032	KEGG	Morphine addiction	8484	420		0.2	0.5	89	8395	9	0	80	8395	8484	0.3164949233273665
M1	cpdb	0	network_modules	475	TRUE	5.498336819727973e-17	89	9	9	1	0.10112359550561797	KEGG:04727	KEGG	GABAergic synapse	8484	357		0.2	0.5	89	8395	9	0	80	8395	8484	0.3164949233273665
M1	cpdb	0	network_modules	475	TRUE	2.788938899377966e-16	112	10	9	0.9	0.08035714285714286	GO:0006820	GO:BP	monoatomic anion transport	16175	2497		0.2727272727272727	0.30434782608695654	112	16063	9	1	103	16062	16175	0.26786895480820705
M1	cpdb	0	network_modules	475	TRUE	3.5687709264107093e-16	115	10	9	0.9	0.0782608695652174	GO:0015698	GO:BP	inorganic anion transport	16175	4818		0.3181818181818182	0.34782608695652173	115	16060	9	1	106	16059	16175	0.2643217074572603
M1	cpdb	0	network_modules	475	TRUE	1.2771099036185e-15	60	9	8	0.8888888888888888	0.13333333333333333	REAC:R-HSA-977443	REAC	GABA receptor activation	10916	1011		0	0.16666666666666666	60	10856	8	1	52	10855	10916	0.34322208601181714
M1	cpdb	0	network_modules	475	TRUE	6.337233552384864e-15	148	9	9	1	0.060810810810810814	KEGG:04723	KEGG	Retrograde endocannabinoid signaling	8484	353		0.6	0.6666666666666666	148	8336	9	0	139	8336	8484	0.24456786739133254
M1	cpdb	0	network_modules	475	TRUE	5.950232712279481e-13	487	10	10	1	0.02053388090349076	GO:0007268	GO:BP	chemical synaptic transmission	16175	2796		0.36363636363636365	0.43478260869565216	487	15688	10	0	477	15688	16175	0.1411664376058933
M1	cpdb	0	network_modules	475	TRUE	5.950232712279481e-13	487	10	10	1	0.02053388090349076	GO:0098916	GO:BP	anterograde trans-synaptic signaling	16175	18949		0.36363636363636365	0.43478260869565216	487	15688	10	0	477	15688	16175	0.1411664376058933
M1	cpdb	0	network_modules	475	TRUE	6.596423728524035e-13	492	10	10	1	0.02032520325203252	GO:0099537	GO:BP	trans-synaptic signaling	16175	19116		0.45454545454545453	0.4782608695652174	492	15683	10	0	482	15683	16175	0.1404249136108411
M1	cpdb	0	network_modules	475	TRUE	9.617910804786675e-13	61	10	7	0.7	0.11475409836065574	GO:0060078	GO:BP	regulation of postsynaptic membrane potential	16175	14337		0.5	0.5217391304347826	61	16114	7	3	54	16111	16175	0.28251518091237626
M1	cpdb	0	network_modules	475	TRUE	1.0666590775428769e-12	516	10	10	1	0.01937984496124031	GO:0099536	GO:BP	synaptic signaling	16175	19115		0.5454545454545454	0.5652173913043478	516	15659	10	0	506	15659	16175	0.13701537597592403
M1	cpdb	0	network_modules	475	TRUE	2.3069641675450427e-11	196	9	8	0.8888888888888888	0.04081632653061224	REAC:R-HSA-112314	REAC	Neurotransmitter receptors and postsynaptic signal transmission	10916	1594		0.2	0.3333333333333333	196	10720	8	1	188	10719	10916	0.18840470293744777
M1	cpdb	0	network_modules	475	TRUE	2.481593369833911e-11	365	9	9	1	0.024657534246575342	KEGG:04080	KEGG	Neuroactive ligand-receptor interaction	8484	263		0.8	0.8333333333333334	365	8119	9	0	356	8119	8484	0.15369376153910974
M1	cpdb	0	network_modules	475	TRUE	2.2108456851878773e-10	259	9	8	0.8888888888888888	0.03088803088803089	REAC:R-HSA-112315	REAC	Transmission across Chemical Synapses	10916	2580		0.4	0.5	259	10657	8	1	251	10656	10916	0.16329102726178799
M1	cpdb	0	network_modules	475	TRUE	3.3685162440868227e-10	19	10	5	0.5	0.2631578947368421	GO:1904862	GO:BP	inhibitory synapse assembly	16175	24170		0.5909090909090909	0.6086956521739131	19	16156	5	5	14	16151	16175	0.3622106587635051
M1	cpdb	0	network_modules	475	TRUE	2.0049137385995505e-9	630	10	9	0.9	0.014285714285714285	GO:0098660	GO:BP	inorganic ion transmembrane transport	16175	18816		0.6363636363636364	0.6521739130434783	630	15545	9	1	621	15544	16175	0.11069287686579302
M1	cpdb	0	network_modules	475	TRUE	3.5402598366089524e-9	671	10	9	0.9	0.013412816691505217	GO:0034220	GO:BP	monoatomic ion transmembrane transport	16175	8508		0.6818181818181818	0.6956521739130435	671	15504	9	1	662	15503	16175	0.1070833142148353
M1	cpdb	0	network_modules	475	TRUE	7.3507907695185e-9	400	9	8	0.8888888888888888	0.02	REAC:R-HSA-112316	REAC	Neuronal System	10916	1590		0.6	0.6666666666666666	400	10516	8	1	392	10515	10916	0.13029913172955446
M1	cpdb	0	network_modules	475	TRUE	5.5504213917957217e-8	282	10	7	0.7	0.024822695035460994	GO:0042391	GO:BP	regulation of membrane potential	16175	10141		0.7272727272727273	0.7391304347826086	282	15893	7	3	275	15890	16175	0.12970997981582186
M1	cpdb	0	network_modules	475	TRUE	8.449837175905525e-8	54	9	5	0.5555555555555556	0.09259259259259259	REAC:R-HSA-1236394	REAC	Signaling by ERBB4	10916	2237		0.8	0.8333333333333334	54	10862	5	4	49	10858	10916	0.22543607074437771
M1	cpdb	0	network_modules	475	TRUE	6.327851931899615e-6	7	10	3	0.3	0.42857142857142855	GO:0071420	GO:BP	cellular response to histamine	16175	16671		0.7727272727272727	0.782608695652174	7	16168	3	7	4	16161	16175	0.3582395850344295
M1	cpdb	0	network_modules	475	TRUE	6.6105019674959315e-6	125	10	5	0.5	0.04	GO:0007416	GO:BP	synapse assembly	16175	2911		0.8181818181818182	0.8260869565217391	125	16050	5	5	120	16045	16175	0.13981992537329585
M1	cpdb	0	network_modules	475	TRUE	2.9792577744638428e-5	11	10	3	0.3	0.2727272727272727	GO:0034776	GO:BP	response to histamine	16175	8739		0.8636363636363636	0.8695652173913043	11	16164	3	7	8	16157	16175	0.2855757448755539
M1	cpdb	0	network_modules	475	TRUE	6.152391112960246e-5	85	9	4	0.4444444444444444	0.047058823529411764	KEGG:04742	KEGG	Taste transduction	8484	361		1	1	85	8399	4	5	81	8394	8484	0.14214912890679138
M1	cpdb	0	network_modules	475	TRUE	3.949219294617966e-4	283	10	5	0.5	0.0176678445229682	GO:0050808	GO:BP	synapse organization	16175	13274		0.9090909090909091	0.9130434782608695	283	15892	5	5	278	15887	16175	0.09153237570226036
M1	cpdb	0	network_modules	475	TRUE	0.0010681427274713698	346	10	5	0.5	0.014450867052023121	GO:0034329	GO:BP	cell junction assembly	16175	8571		0.9545454545454546	0.9565217391304348	346	15829	5	5	341	15824	16175	0.08227586837238003
M1	cpdb	0	network_modules	475	TRUE	0.006350279910425347	507	9	5	0.5555555555555556	0.009861932938856016	REAC:R-HSA-9006934	REAC	Signaling by Receptor Tyrosine Kinases	10916	2302		1	1	507	10409	5	4	502	10405	10916	0.06949206931052551
M1	cpdb	0	network_modules	475	TRUE	0.008911882015690683	533	10	5	0.5	0.009380863039399626	GO:0034330	GO:BP	cell junction organization	16175	8572		1	1	533	15642	5	5	528	15637	16175	0.06507409331861636
M1	cpdb	0	network_modules	477	TRUE	0.0035421800031743915	12	6	2	0.3333333333333333	0.16666666666666666	REAC:R-HSA-8851680	REAC	Butyrophilin (BTN) family interactions	10916	260		0	0.5	12	10904	2	4	10	10900	10916	0.23511879436218117
M1	cpdb	0	network_modules	477	TRUE	0.004881527570650452	14	6	2	0.3333333333333333	0.14285714285714285	REAC:R-HSA-74259	REAC	Purine catabolism	10916	1823		1	1	14	10902	2	4	12	10898	10916	0.2175776176442625
M1	cpdb	0	network_modules	479	TRUE	1.2153640512496417e-7	147	9	6	0.6666666666666666	0.04081632653061224	REAC:R-HSA-453279	REAC	Mitotic G1 phase and G1/S transition	10916	1480		0	0.05263157894736842	147	10769	6	3	141	10766	10916	0.1627916313504245
M1	cpdb	0	network_modules	479	TRUE	5.902840605395269e-7	157	6	5	0.8333333333333334	0.03184713375796178	KEGG:04110	KEGG	Cell cycle	8484	264		0	0.3333333333333333	157	8327	5	1	152	8326	8484	0.16084270467022246
M1	cpdb	0	network_modules	479	TRUE	7.471471833027292e-6	130	9	5	0.5555555555555556	0.038461538461538464	REAC:R-HSA-69206	REAC	G1/S Transition	10916	1002		0.05555555555555555	0.10526315789473684	130	10786	5	4	125	10782	10916	0.14396163903658069
M1	cpdb	0	network_modules	479	TRUE	7.661149961857396e-5	155	6	4	0.6666666666666666	0.025806451612903226	KEGG:04218	KEGG	Cellular senescence	8484	295		0.5	0.6666666666666666	155	8329	4	2	151	8327	8484	0.12879775225582407
M1	cpdb	0	network_modules	479	TRUE	1.4388998815284516e-4	231	10	5	0.5	0.021645021645021644	GO:0006260	GO:BP	DNA replication	16175	2077		0	0.16666666666666666	231	15944	5	5	226	15939	16175	0.10182082875180418
M1	cpdb	0	network_modules	479	TRUE	1.6450263983151567e-4	22	9	3	0.3333333333333333	0.13636363636363635	REAC:R-HSA-113510	REAC	E2F mediated regulation of DNA replication	10916	809		0.1111111111111111	0.15789473684210525	22	10894	3	6	19	10888	10916	0.21221303460611723
M1	cpdb	0	network_modules	479	TRUE	2.453816807747652e-4	25	9	3	0.3333333333333333	0.12	REAC:R-HSA-69273	REAC	Cyclin A/B1/B2 associated events during G2/M transition	10916	418		0.16666666666666666	0.21052631578947367	25	10891	3	6	22	10885	10916	0.19893573576338952
M1	cpdb	0	network_modules	479	TRUE	3.118039148666297e-4	27	9	3	0.3333333333333333	0.1111111111111111	REAC:R-HSA-69205	REAC	G1/S-Specific Transcription	10916	1003		0.2222222222222222	0.2631578947368421	27	10889	3	6	24	10883	10916	0.19133762463637052
M1	cpdb	0	network_modules	479	TRUE	5.033594723185619e-4	3	9	2	0.2222222222222222	0.6666666666666666	REAC:R-HSA-170145	REAC	Phosphorylation of proteins involved in the G2/M transition by Cyclin A:Cdc2 complexes	10916	1752		0.2777777777777778	0.3157894736842105	3	10913	2	7	1	10906	10916	0.3846355971777174
M1	cpdb	0	network_modules	479	TRUE	8.453629886455711e-4	656	10	6	0.6	0.009146341463414634	GO:1903047	GO:BP	mitotic cell cycle process	16175	22727		0.2	0.3333333333333333	656	15519	6	4	650	15515	16175	0.0705389429755259
M1	cpdb	0	network_modules	479	TRUE	0.0016114687407549058	102	6	3	0.5	0.029411764705882353	KEGG:04914	KEGG	Progesterone-mediated oocyte maturation	8484	371		1	1	102	8382	3	3	99	8379	8484	0.11911195314389028
M1	cpdb	0	network_modules	479	TRUE	0.0016764303207580484	5	9	2	0.2222222222222222	0.4	REAC:R-HSA-68911	REAC	G2 Phase	10916	1004		0.3333333333333333	0.42105263157894735	5	10911	2	7	3	10904	10916	0.2977187878175293
M1	cpdb	0	network_modules	479	TRUE	0.0016764303207580484	5	9	2	0.2222222222222222	0.4	REAC:R-HSA-69478	REAC	G2/M DNA replication checkpoint	10916	1007		0.3333333333333333	0.42105263157894735	5	10911	2	7	3	10904	10916	0.2977187878175293
M1	cpdb	0	network_modules	479	TRUE	0.0019462237602271494	49	9	3	0.3333333333333333	0.061224489795918366	REAC:R-HSA-6791312	REAC	TP53 Regulates Transcription of Cell Cycle Genes	10916	2454		0.4444444444444444	0.47368421052631576	49	10867	3	6	46	10861	10916	0.14130900774801558
M1	cpdb	0	network_modules	479	TRUE	0.002194409615158819	4	10	2	0.2	0.5	GO:1905448	GO:BP	positive regulation of mitochondrial ATP synthesis coupled electron transport	16175	24642		0.4	0.5	4	16171	2	8	2	16163	16175	0.3159735061817264
M1	cpdb	0	network_modules	479	TRUE	0.0025135702064138007	6	9	2	0.2222222222222222	0.3333333333333333	REAC:R-HSA-176417	REAC	Phosphorylation of Emi1	10916	1750		0.5	0.5263157894736842	6	10910	2	7	4	10903	10916	0.2716790073116455
M1	cpdb	0	network_modules	479	TRUE	0.002550926906834863	792	10	6	0.6	0.007575757575757576	GO:0000278	GO:BP	mitotic cell cycle	16175	76		0.6	0.6666666666666666	792	15383	6	4	786	15379	16175	0.06351158354824074
M1	cpdb	0	network_modules	479	TRUE	0.0033550511454643094	197	9	4	0.4444444444444444	0.02030456852791878	REAC:R-HSA-453274	REAC	Mitotic G2-G2/M phases	10916	1481		0.5555555555555556	0.5789473684210527	197	10719	4	5	193	10714	10916	0.0920103256738923
M1	cpdb	0	network_modules	479	TRUE	0.003517493525200745	7	9	2	0.2222222222222222	0.2857142857142857	REAC:R-HSA-2980767	REAC	Activation of NIMA Kinases NEK9, NEK6, NEK7	10916	88		0.6111111111111112	0.631578947368421	7	10909	2	7	5	10902	10916	0.25143346313144566
M1	cpdb	0	network_modules	479	TRUE	0.00365614327046356	5	10	2	0.2	0.4	GO:1905446	GO:BP	regulation of mitochondrial ATP synthesis coupled electron transport	16175	24640		0.8	0.8333333333333334	5	16170	2	8	3	16162	16175	0.28253656168710733
M1	cpdb	0	network_modules	479	TRUE	0.004572825774101335	465	10	5	0.5	0.010752688172043012	GO:0044770	GO:BP	cell cycle phase transition	16175	11146		1	1	465	15710	5	5	460	15705	16175	0.07014472381671014
M1	cpdb	0	network_modules	479	TRUE	0.006024832901546089	9	9	2	0.2222222222222222	0.2222222222222222	REAC:R-HSA-113507	REAC	E2F-enabled inhibition of pre-replication complex formation	10916	810		0.6666666666666666	0.6842105263157895	9	10907	2	7	7	10900	10916	0.22158043254586762
M1	cpdb	0	network_modules	479	TRUE	0.006240451175820265	72	9	3	0.3333333333333333	0.041666666666666664	REAC:R-HSA-2299718	REAC	Condensation of Prophase Chromosomes	10916	395		0.7222222222222222	0.7368421052631579	72	10844	3	6	69	10838	10916	0.11594983059125068
M1	cpdb	0	network_modules	479	TRUE	0.0073436993999453784	76	9	3	0.3333333333333333	0.039473684210526314	REAC:R-HSA-176409	REAC	APC/C:Cdc20 mediated degradation of mitotic proteins	10916	27		0.7777777777777778	0.7894736842105263	76	10840	3	6	73	10834	10916	0.11275150598603523
M1	cpdb	0	network_modules	479	TRUE	0.007527820621271228	10	9	2	0.2222222222222222	0.2	REAC:R-HSA-2465910	REAC	MASTL Facilitates Mitotic Progression	10916	1354		0.8333333333333334	0.8421052631578947	10	10906	2	7	8	10899	10916	0.21013230935567795
M1	cpdb	0	network_modules	479	TRUE	0.007638255464588674	77	9	3	0.3333333333333333	0.03896103896103896	REAC:R-HSA-176814	REAC	Activation of APC/C and APC/C:Cdc20 mediated degradation of mitotic proteins	10916	74		0.8888888888888888	0.8947368421052632	77	10839	3	6	74	10833	10916	0.11199068452323838
M1	cpdb	0	network_modules	479	TRUE	0.008894299380903534	81	9	3	0.3333333333333333	0.037037037037037035	REAC:R-HSA-176408	REAC	Regulation of APC/C activators between G1/S and early anaphase	10916	1963		0.9444444444444444	0.9473684210526315	81	10835	3	6	78	10829	10916	0.10908797639933616
M1	cpdb	0	network_modules	479	TRUE	0.009196735098244528	11	9	2	0.2222222222222222	0.18181818181818182	REAC:R-HSA-2514853	REAC	Condensation of Prometaphase Chromosomes	10916	394		1	1	11	10905	2	7	9	10898	10916	0.20027954273656026
M1	cpdb	0	network_modules	480	TRUE	1.6079149435872228e-13	88	10	8	0.8	0.09090909090909091	REAC:R-HSA-453276	REAC	Regulation of mitotic cell cycle	10916	2044		0	0.05128205128205128	88	10828	8	2	80	10826	10916	0.26816787085983496
M1	cpdb	0	network_modules	480	TRUE	1.6079149435872228e-13	88	10	8	0.8	0.09090909090909091	REAC:R-HSA-174143	REAC	APC/C-mediated degradation of cell cycle proteins	10916	24		0	0.05128205128205128	88	10828	8	2	80	10826	10916	0.26816787085983496
M1	cpdb	0	network_modules	480	TRUE	1.2054095919600462e-12	24	10	6	0.6	0.25	GO:0031145	GO:BP	anaphase-promoting complex-dependent catabolic process	16175	7063		0	0.015151515151515152	24	16151	6	4	18	16147	16175	0.3867470736181023
M1	cpdb	0	network_modules	480	TRUE	3.659517527597143e-12	9	10	5	0.5	0.5555555555555556	GO:1904668	GO:BP	positive regulation of ubiquitin protein ligase activity	16175	24008		0.015384615384615385	0.030303030303030304	9	16166	5	5	4	16161	16175	0.5267691501425877
M1	cpdb	0	network_modules	480	TRUE	5.751054155673082e-12	26	10	6	0.6	0.23076923076923078	REAC:R-HSA-179409	REAC	APC-Cdc20 mediated degradation of Nek2A	10916	23		0.05263157894736842	0.07692307692307693	26	10890	6	4	20	10886	10916	0.371239315737553
M1	cpdb	0	network_modules	480	TRUE	1.1987806410904629e-11	656	10	10	1	0.01524390243902439	GO:1903047	GO:BP	mitotic cell cycle process	16175	22727		0.03076923076923077	0.045454545454545456	656	15519	10	0	646	15519	16175	0.12097401437033778
M1	cpdb	0	network_modules	480	TRUE	2.1792018415060618e-11	77	10	7	0.7	0.09090909090909091	REAC:R-HSA-176814	REAC	Activation of APC/C and APC/C:Cdc20 mediated degradation of mitotic proteins	10916	74		0.07894736842105263	0.10256410256410256	77	10839	7	3	70	10836	10916	0.2507207543571932
M1	cpdb	0	network_modules	480	TRUE	3.147953696884877e-11	81	10	7	0.7	0.08641975308641975	REAC:R-HSA-176408	REAC	Regulation of APC/C activators between G1/S and early anaphase	10916	1963		0.10526315789473684	0.1282051282051282	81	10835	7	3	74	10832	10916	0.24436757026378703
M1	cpdb	0	network_modules	480	TRUE	7.982050382161753e-11	792	10	10	1	0.012626262626262626	GO:0000278	GO:BP	mitotic cell cycle	16175	76		0.046153846153846156	0.06060606060606061	792	15383	10	0	782	15383	16175	0.10961502184703101
M1	cpdb	0	network_modules	480	TRUE	3.1094056800389347e-10	277	10	8	0.8	0.02888086642599278	GO:0098813	GO:BP	nuclear chromosome segregation	16175	18900		0.06153846153846154	0.07575757575757576	277	15898	8	2	269	15896	16175	0.1500851147282909
M1	cpdb	0	network_modules	480	TRUE	3.3685162440868227e-10	19	10	5	0.5	0.2631578947368421	GO:1904666	GO:BP	regulation of ubiquitin protein ligase activity	16175	24006		0.07692307692307693	0.09090909090909091	19	16156	5	5	14	16151	16175	0.3622106587635051
M1	cpdb	0	network_modules	480	TRUE	5.891863823791982e-10	21	10	5	0.5	0.23809523809523808	GO:0051443	GO:BP	positive regulation of ubiquitin-protein transferase activity	16175	13706		0.09230769230769231	0.10606060606060606	21	16154	5	5	16	16149	16175	0.34446697960023376
M1	cpdb	0	network_modules	480	TRUE	8.456028837435106e-10	20	10	5	0.5	0.25	REAC:R-HSA-176412	REAC	Phosphorylation of the APC/C	10916	1753		0.13157894736842105	0.20512820512820512	20	10896	5	5	15	10891	10916	0.35274259981439204
M1	cpdb	0	network_modules	480	TRUE	8.456028837435106e-10	20	10	5	0.5	0.25	REAC:R-HSA-176407	REAC	Conversion from APC/C:Cdc20 to APC/C:Cdh1 in late anaphase	10916	409		0.13157894736842105	0.20512820512820512	20	10896	5	5	15	10891	10916	0.35274259981439204
M1	cpdb	0	network_modules	480	TRUE	8.456028837435106e-10	20	10	5	0.5	0.25	REAC:R-HSA-9687136	REAC	Aberrant regulation of mitotic exit in cancer due to RB1 defects	10916	49		0.13157894736842105	0.20512820512820512	20	10896	5	5	15	10891	10916	0.35274259981439204
M1	cpdb	0	network_modules	480	TRUE	1.1094295262315518e-9	21	10	5	0.5	0.23809523809523808	REAC:R-HSA-141405	REAC	Inhibition of the proteolytic activity of APC/C required for the onset of anaphase by mitotic spindle checkpoint components	10916	1199		0.21052631578947367	0.2564102564102564	21	10895	5	5	16	10890	10916	0.3441940208000714
M1	cpdb	0	network_modules	480	TRUE	1.1094295262315518e-9	21	10	5	0.5	0.23809523809523808	REAC:R-HSA-141430	REAC	Inactivation of APC/C via direct inhibition of the APC/C complex	10916	1176		0.21052631578947367	0.2564102564102564	21	10895	5	5	16	10890	10916	0.3441940208000714
M1	cpdb	0	network_modules	480	TRUE	2.0049137385995505e-9	630	10	9	0.9	0.014285714285714285	GO:0010564	GO:BP	regulation of cell cycle process	16175	4217		0.1076923076923077	0.12121212121212122	630	15545	9	1	621	15544	16175	0.11069287686579302
M1	cpdb	0	network_modules	480	TRUE	2.625409961824187e-9	361	10	8	0.8	0.0221606648199446	GO:0007059	GO:BP	chromosome segregation	16175	2658		0.12307692307692308	0.13636363636363635	361	15814	8	2	353	15812	16175	0.13094345460199722
M1	cpdb	0	network_modules	480	TRUE	3.199968675775123e-9	370	10	8	0.8	0.021621621621621623	GO:0044772	GO:BP	mitotic cell cycle phase transition	16175	11148		0.13846153846153847	0.15151515151515152	370	15805	8	2	362	15803	16175	0.12928534869145214
M1	cpdb	0	network_modules	480	TRUE	3.881486653350682e-9	379	10	8	0.8	0.021108179419525065	GO:0000280	GO:BP	nuclear division	16175	78		0.15384615384615385	0.16666666666666666	379	15796	8	2	371	15794	16175	0.12768597398571327
M1	cpdb	0	network_modules	480	TRUE	4.557979988915596e-9	74	10	6	0.6	0.08108108108108109	REAC:R-HSA-174178	REAC	APC/C:Cdh1 mediated degradation of Cdc20 and other APC/C:Cdh1 targeted proteins in late mitosis/early G1	10916	28		0.2631578947368421	0.3076923076923077	74	10842	6	4	68	10838	10916	0.21891559785106396
M1	cpdb	0	network_modules	480	TRUE	4.557979988915596e-9	74	10	6	0.6	0.08108108108108109	REAC:R-HSA-179419	REAC	APC:Cdc20 mediated degradation of cell cycle proteins prior to satisfation of the cell cycle checkpoint	10916	29		0.2631578947368421	0.3076923076923077	74	10842	6	4	68	10838	10916	0.21891559785106396
M1	cpdb	0	network_modules	480	TRUE	4.9069411274294604e-9	31	10	5	0.5	0.16129032258064516	GO:0070979	GO:BP	protein K11-linked ubiquitination	16175	16411		0.16923076923076924	0.18181818181818182	31	16144	5	5	26	16139	16175	0.2832514459852064
M1	cpdb	0	network_modules	480	TRUE	5.37558520412115e-9	76	10	6	0.6	0.07894736842105263	REAC:R-HSA-176409	REAC	APC/C:Cdc20 mediated degradation of mitotic proteins	10916	27		0.3157894736842105	0.3333333333333333	76	10840	6	4	70	10836	10916	0.21596912919349792
M1	cpdb	0	network_modules	480	TRUE	9.551325896749703e-9	424	10	8	0.8	0.018867924528301886	GO:0048285	GO:BP	organelle fission	16175	12627		0.18461538461538463	0.19696969696969696	424	15751	8	2	416	15749	16175	0.12045940285786003
M1	cpdb	0	network_modules	480	TRUE	1.010688007734417e-8	427	10	8	0.8	0.01873536299765808	GO:0007346	GO:BP	regulation of mitotic cell cycle	16175	2855		0.2	0.21212121212121213	427	15748	8	2	419	15746	16175	0.1200181559137029
M1	cpdb	0	network_modules	480	TRUE	1.6593270305378454e-8	39	10	5	0.5	0.1282051282051282	GO:0051438	GO:BP	regulation of ubiquitin-protein transferase activity	16175	13705		0.2153846153846154	0.22727272727272727	39	16136	5	5	34	16131	16175	0.2523462456599048
M1	cpdb	0	network_modules	480	TRUE	2.0013012874627705e-8	465	10	8	0.8	0.017204301075268817	GO:0044770	GO:BP	cell cycle phase transition	16175	11146		0.23076923076923078	0.24242424242424243	465	15710	8	2	457	15708	16175	0.11479900683679356
M1	cpdb	0	network_modules	480	TRUE	2.0436038896473282e-8	36	10	5	0.5	0.1388888888888889	REAC:R-HSA-9687139	REAC	Aberrant regulation of mitotic cell cycle due to RB1 defects	10916	48		0.34210526315789475	0.358974358974359	36	10880	5	5	31	10875	10916	0.2623379185960718
M1	cpdb	0	network_modules	480	TRUE	2.5154556217327273e-8	252	10	7	0.7	0.027777777777777776	GO:0140014	GO:BP	mitotic nuclear division	16175	19633		0.24615384615384617	0.25757575757575757	252	15923	7	3	245	15920	16175	0.13745693753844784
M1	cpdb	0	network_modules	480	TRUE	2.718852559345168e-8	38	10	5	0.5	0.13157894736842105	REAC:R-HSA-9675126	REAC	Diseases of mitotic cell cycle	10916	769		0.3684210526315789	0.38461538461538464	38	10878	5	5	33	10873	10916	0.2552702562364856
M1	cpdb	0	network_modules	480	TRUE	3.117490199450789e-8	39	10	5	0.5	0.1282051282051282	REAC:R-HSA-8853884	REAC	Transcriptional Regulation by VENTX	10916	2547		0.39473684210526316	0.41025641025641024	39	10877	5	5	34	10872	10916	0.2519413989678422
M1	cpdb	0	network_modules	480	TRUE	4.927591680481276e-8	109	10	6	0.6	0.05504587155963303	REAC:R-HSA-69618	REAC	Mitotic Spindle Checkpoint	10916	1486		0.42105263157894735	0.4358974358974359	109	10807	6	4	103	10803	10916	0.1796915919691805
M1	cpdb	0	network_modules	480	TRUE	4.0890084559408155e-7	64	10	5	0.5	0.078125	REAC:R-HSA-174084	REAC	Autodegradation of Cdh1 by Cdh1:APC/C	10916	190		0.4473684210526316	0.46153846153846156	64	10852	5	5	59	10847	10916	0.19598973058171162
M1	cpdb	0	network_modules	480	TRUE	8.027609728468831e-7	73	10	5	0.5	0.0684931506849315	REAC:R-HSA-69017	REAC	CDK-mediated phosphorylation and removal of Cdc6	10916	272		0.47368421052631576	0.5128205128205128	73	10843	5	5	68	10838	10916	0.1832807283325458
M1	cpdb	0	network_modules	480	TRUE	8.027609728468831e-7	73	10	5	0.5	0.0684931506849315	REAC:R-HSA-174184	REAC	Cdc20:Phospho-APC/C mediated degradation of Cyclin A	10916	319		0.47368421052631576	0.5128205128205128	73	10843	5	5	68	10838	10916	0.1832807283325458
M1	cpdb	0	network_modules	480	TRUE	1.0507786914930647e-6	24	10	4	0.4	0.16666666666666666	REAC:R-HSA-174048	REAC	APC/C:Cdc20 mediated degradation of Cyclin B	10916	25		0.5263157894736842	0.5384615384615384	24	10892	4	6	20	10886	10916	0.2571802665578508
M1	cpdb	0	network_modules	480	TRUE	1.1624505329510867e-6	217	10	6	0.6	0.027649769585253458	GO:0000819	GO:BP	sister chromatid segregation	16175	237		0.26153846153846155	0.2727272727272727	217	15958	6	4	211	15954	16175	0.1268141526752126
M1	cpdb	0	network_modules	480	TRUE	1.2500314225497273e-6	90	10	5	0.5	0.05555555555555555	GO:0007091	GO:BP	metaphase/anaphase transition of mitotic cell cycle	16175	2675		0.27692307692307694	0.2878787878787879	90	16085	5	5	85	16080	16175	0.1653235060739458
M1	cpdb	0	network_modules	480	TRUE	1.342541136648877e-6	188	10	6	0.6	0.031914893617021274	REAC:R-HSA-2467813	REAC	Separation of Sister Chromatids	10916	2204		0.5526315789473685	0.5641025641025641	188	10728	6	4	182	10724	10916	0.13564234979416095
M1	cpdb	0	network_modules	480	TRUE	1.3980017780991396e-6	92	10	5	0.5	0.05434782608695652	GO:0044784	GO:BP	metaphase/anaphase transition of cell cycle	16175	11156		0.2923076923076923	0.30303030303030304	92	16083	5	5	87	16078	16175	0.16348590979936214
M1	cpdb	0	network_modules	480	TRUE	1.5596282905199785e-6	94	10	5	0.5	0.05319148936170213	GO:0031398	GO:BP	positive regulation of protein ubiquitination	16175	7154		0.3076923076923077	0.3181818181818182	94	16081	5	5	89	16076	16175	0.1617069448664866
M1	cpdb	0	network_modules	480	TRUE	1.607352938037468e-6	229	10	6	0.6	0.026200873362445413	GO:0033044	GO:BP	regulation of chromosome organization	16175	7999		0.3230769230769231	0.3333333333333333	229	15946	6	4	223	15942	16175	0.12333705563878349
M1	cpdb	0	network_modules	480	TRUE	2.0295720297248087e-6	99	10	5	0.5	0.050505050505050504	GO:0033045	GO:BP	regulation of sister chromatid segregation	16175	8000		0.3384615384615385	0.3484848484848485	99	16076	5	5	94	16071	16175	0.1574964571953913
M1	cpdb	0	network_modules	480	TRUE	2.6091655437948023e-6	92	10	5	0.5	0.05434782608695652	REAC:R-HSA-69052	REAC	Switching of origins to a post-replicative state	10916	2365		0.5789473684210527	0.5897435897435898	92	10824	5	5	87	10819	10916	0.16282838530362148
M1	cpdb	0	network_modules	480	TRUE	2.86325983849521e-6	406	10	7	0.7	0.017241379310344827	REAC:R-HSA-68886	REAC	M Phase	10916	1343		0.6052631578947368	0.6153846153846154	406	10510	7	3	399	10507	10916	0.1060604387047824
M1	cpdb	0	network_modules	480	TRUE	2.87048700141062e-6	106	10	5	0.5	0.04716981132075472	GO:0007088	GO:BP	regulation of mitotic nuclear division	16175	2673		0.35384615384615387	0.36363636363636365	106	16069	5	5	101	16064	16175	0.15210703665277964
M1	cpdb	0	network_modules	480	TRUE	3.4255285781375245e-6	140	8	5	0.625	0.03571428571428571	KEGG:04120	KEGG	Ubiquitin mediated proteolysis	8484	270		0	0.25	140	8344	5	3	135	8341	8484	0.14674334636556186
M1	cpdb	0	network_modules	480	TRUE	4.277961203110936e-6	228	10	6	0.6	0.02631578947368421	REAC:R-HSA-68882	REAC	Mitotic Anaphase	10916	1479		0.631578947368421	0.6410256410256411	228	10688	6	4	222	10684	10916	0.12262488683462941
M1	cpdb	0	network_modules	480	TRUE	4.337102322548199e-6	115	10	5	0.5	0.043478260869565216	GO:1903322	GO:BP	positive regulation of protein modification by small protein conjugation or removal	16175	22906		0.36923076923076925	0.3787878787878788	115	16060	5	5	110	16055	16175	0.14590997491452365
M1	cpdb	0	network_modules	480	TRUE	4.391659822837482e-6	229	10	6	0.6	0.026200873362445413	REAC:R-HSA-2555396	REAC	Mitotic Metaphase and Anaphase	10916	1482		0.6578947368421053	0.6666666666666666	229	10687	6	4	223	10683	10916	0.12234322213862663
M1	cpdb	0	network_modules	480	TRUE	4.531293483946569e-6	116	10	5	0.5	0.04310344827586207	GO:1901875	GO:BP	positive regulation of post-translational protein modification	16175	21819		0.38461538461538464	0.3939393939393939	116	16059	5	5	111	16054	16175	0.14526599137005736
M1	cpdb	0	network_modules	480	TRUE	5.155825523726244e-6	119	10	5	0.5	0.04201680672268908	GO:0051783	GO:BP	regulation of nuclear division	16175	13933		0.4	0.4090909090909091	119	16056	5	5	114	16051	16175	0.14338263656457576
M1	cpdb	0	network_modules	480	TRUE	5.5488107463482906e-6	545	10	7	0.7	0.012844036697247707	GO:0051276	GO:BP	chromosome organization	16175	13613		0.4153846153846154	0.42424242424242425	545	15630	7	3	538	15627	16175	0.09184434830539372
M1	cpdb	0	network_modules	480	TRUE	5.691834085820746e-6	547	10	7	0.7	0.012797074954296161	GO:0006511	GO:BP	ubiquitin-dependent protein catabolic process	16175	2235		0.4307692307692308	0.4393939393939394	547	15628	7	3	540	15625	16175	0.09166514131944911
M1	cpdb	0	network_modules	480	TRUE	6.092673635297867e-6	157	8	5	0.625	0.03184713375796178	KEGG:04110	KEGG	Cell cycle	8484	264		0.3333333333333333	0.5	157	8327	5	3	152	8324	8484	0.1382556834650476
M1	cpdb	0	network_modules	480	TRUE	6.105640478397163e-6	286	10	6	0.6	0.02097902097902098	GO:1901990	GO:BP	regulation of mitotic cell cycle phase transition	16175	21923		0.4461538461538462	0.45454545454545453	286	15889	6	4	280	15885	16175	0.10989695097213825
M1	cpdb	0	network_modules	480	TRUE	6.295836129456723e-6	555	10	7	0.7	0.012612612612612612	GO:0019941	GO:BP	modification-dependent protein catabolic process	16175	6072		0.46153846153846156	0.4696969696969697	555	15620	7	3	548	15617	16175	0.09095781510476317
M1	cpdb	0	network_modules	480	TRUE	6.347726486088788e-6	124	10	5	0.5	0.04032258064516129	GO:0051983	GO:BP	regulation of chromosome segregation	16175	14045		0.47692307692307695	0.48484848484848486	124	16051	5	5	119	16046	16175	0.14039584011357834
M1	cpdb	0	network_modules	480	TRUE	6.6177945109846455e-6	559	10	7	0.7	0.012522361359570662	GO:0043632	GO:BP	modification-dependent macromolecule catabolic process	16175	10812		0.49230769230769234	0.5	559	15616	7	3	552	15613	16175	0.09060973423183077
M1	cpdb	0	network_modules	480	TRUE	6.750479846635611e-6	111	10	5	0.5	0.04504504504504504	REAC:R-HSA-2559582	REAC	Senescence-Associated Secretory Phenotype (SASP)	10916	2194		0.6842105263157895	0.6923076923076923	111	10805	5	5	106	10800	10916	0.14784395176646645
M1	cpdb	0	network_modules	480	TRUE	8.292434049872309e-6	301	10	6	0.6	0.019933554817275746	GO:0051347	GO:BP	positive regulation of transferase activity	16175	13674		0.5076923076923077	0.5151515151515151	301	15874	6	4	295	15870	16175	0.1070035854586142
M1	cpdb	0	network_modules	480	TRUE	9.625107395659963e-6	590	10	7	0.7	0.011864406779661017	GO:0016567	GO:BP	protein ubiquitination	16175	5254		0.5230769230769231	0.5303030303030303	590	15585	7	3	583	15582	16175	0.08803059424629292
M1	cpdb	0	network_modules	480	TRUE	1.0430259946833104e-5	121	10	5	0.5	0.04132231404958678	REAC:R-HSA-69239	REAC	Synthesis of DNA	10916	2376		0.7105263157894737	0.717948717948718	121	10795	5	5	116	10790	10916	0.14140359391541327
M1	cpdb	0	network_modules	480	TRUE	1.7646145916906023e-5	289	10	6	0.6	0.020761245674740483	REAC:R-HSA-69620	REAC	Cell Cycle Checkpoints	10916	321		0.7368421052631579	0.7435897435897436	289	10627	6	4	283	10623	10916	0.10817550929225322
M1	cpdb	0	network_modules	480	TRUE	2.251682123057529e-5	667	10	7	0.7	0.010494752623688156	GO:0032446	GO:BP	protein modification by small protein conjugation	16175	7568		0.5384615384615384	0.5454545454545454	667	15508	7	3	660	15505	16175	0.08240340655959619
M1	cpdb	0	network_modules	480	TRUE	2.332006246502444e-5	142	10	5	0.5	0.035211267605633804	REAC:R-HSA-68867	REAC	Assembly of the pre-replicative complex	10916	181		0.7631578947368421	0.7692307692307693	142	10774	5	5	137	10769	10916	0.13014262665274431
M1	cpdb	0	network_modules	480	TRUE	2.3956098620725948e-5	673	10	7	0.7	0.010401188707280832	GO:0051603	GO:BP	proteolysis involved in protein catabolic process	16175	13820		0.5538461538461539	0.5606060606060606	673	15502	7	3	666	15499	16175	0.08200493052702398
M1	cpdb	0	network_modules	480	TRUE	2.538967043718273e-5	363	10	6	0.6	0.01652892561983471	GO:0043161	GO:BP	proteasome-mediated ubiquitin-dependent protein catabolic process	16175	10561		0.5692307692307692	0.5757575757575758	363	15812	6	4	357	15808	16175	0.09698516145595949
M1	cpdb	0	network_modules	480	TRUE	2.8339011207278684e-5	56	10	4	0.4	0.07142857142857142	GO:0010965	GO:BP	regulation of mitotic sister chromatid separation	16175	4541		0.5846153846153846	0.5909090909090909	56	16119	4	6	52	16113	16175	0.1679105715691441
M1	cpdb	0	network_modules	480	TRUE	2.927320266278281e-5	168	10	5	0.5	0.02976190476190476	GO:0031396	GO:BP	regulation of protein ubiquitination	16175	7152		0.6	0.6060606060606061	168	16007	5	5	163	16002	16175	0.12011584347688457
M1	cpdb	0	network_modules	480	TRUE	3.131495721200671e-5	376	10	6	0.6	0.015957446808510637	GO:1901987	GO:BP	regulation of cell cycle phase transition	16175	21920		0.6153846153846154	0.6212121212121212	376	15799	6	4	370	15795	16175	0.09520034376131493
M1	cpdb	0	network_modules	480	TRUE	3.2715949004539816e-5	58	10	4	0.4	0.06896551724137931	GO:0051306	GO:BP	mitotic sister chromatid separation	16175	13637		0.6307692307692307	0.6363636363636364	58	16117	4	6	54	16111	16175	0.16494895156788278
M1	cpdb	0	network_modules	480	TRUE	3.91177620555364e-5	178	10	5	0.5	0.028089887640449437	GO:0000070	GO:BP	mitotic sister chromatid segregation	16175	24		0.6461538461538462	0.6515151515151515	178	15997	5	5	173	15992	16175	0.1165821076051931
M1	cpdb	0	network_modules	480	TRUE	4.109250983146271e-5	159	10	5	0.5	0.031446540880503145	REAC:R-HSA-69002	REAC	DNA Replication Pre-Initiation	10916	446		0.7894736842105263	0.7948717948717948	159	10757	5	5	154	10752	10916	0.12269222047594638
M1	cpdb	0	network_modules	480	TRUE	4.5119543089337376e-5	162	10	5	0.5	0.030864197530864196	REAC:R-HSA-69242	REAC	S Phase	10916	2111		0.8157894736842105	0.8205128205128205	162	10754	5	5	157	10749	10916	0.12149900082108284
M1	cpdb	0	network_modules	480	TRUE	5.0176777945836705e-5	749	10	7	0.7	0.009345794392523364	GO:0070647	GO:BP	protein modification by small protein conjugation or removal	16175	16231		0.6615384615384615	0.6666666666666666	749	15426	7	3	742	15423	16175	0.07736835139551447
M1	cpdb	0	network_modules	480	TRUE	7.04508174704743e-5	70	10	4	0.4	0.05714285714285714	GO:1905818	GO:BP	regulation of chromosome separation	16175	24928		0.676923076923077	0.6818181818181818	70	16105	4	6	66	16099	16175	0.14992109132408138
M1	cpdb	0	network_modules	480	TRUE	7.422974545535975e-5	102	8	4	0.5	0.0392156862745098	KEGG:04914	KEGG	Progesterone-mediated oocyte maturation	8484	371		0.6666666666666666	0.75	102	8382	4	4	98	8378	8484	0.1375548622985348
M1	cpdb	0	network_modules	480	TRUE	7.767881550375202e-5	798	10	7	0.7	0.008771929824561403	GO:0043687	GO:BP	post-translational protein modification	16175	10838		0.6923076923076923	0.696969696969697	798	15377	7	3	791	15374	16175	0.0747267965772737
M1	cpdb	0	network_modules	480	TRUE	7.898477528620515e-5	68	10	4	0.4	0.058823529411764705	REAC:R-HSA-174154	REAC	APC/C:Cdc20 mediated degradation of Securin	10916	26		0.8421052631578947	0.8461538461538461	68	10848	4	6	64	10842	10916	0.1515461076350598
M1	cpdb	0	network_modules	480	TRUE	8.124913024260241e-5	206	10	5	0.5	0.024271844660194174	GO:1903320	GO:BP	regulation of protein modification by small protein conjugation or removal	16175	22904		0.7076923076923077	0.7121212121212122	206	15969	5	5	201	15964	16175	0.1080808010377612
M1	cpdb	0	network_modules	480	TRUE	8.733377335505062e-5	209	10	5	0.5	0.023923444976076555	GO:1901873	GO:BP	regulation of post-translational protein modification	16175	21817		0.7230769230769231	0.7272727272727273	209	15966	5	5	204	15961	16175	0.10727153108710144
M1	cpdb	0	network_modules	480	TRUE	9.235278109630226e-5	187	10	5	0.5	0.026737967914438502	REAC:R-HSA-69306	REAC	DNA Replication	10916	445		0.868421052631579	0.8717948717948718	187	10729	5	5	182	10724	10916	0.11268337434749591
M1	cpdb	0	network_modules	480	TRUE	9.840314293383065e-5	76	10	4	0.4	0.05263157894736842	GO:0051304	GO:BP	chromosome separation	16175	13635		0.7384615384615385	0.7424242424242424	76	16099	4	6	72	16093	16175	0.14377339600545208
M1	cpdb	0	network_modules	480	TRUE	1.1089863259913052e-4	194	10	5	0.5	0.02577319587628866	REAC:R-HSA-2559583	REAC	Cellular Senescence	10916	331		0.8947368421052632	0.8974358974358975	194	10722	5	5	189	10717	10916	0.11052088846950645
M1	cpdb	0	network_modules	480	TRUE	1.1799609881945632e-4	470	10	6	0.6	0.01276595744680851	GO:0010498	GO:BP	proteasomal protein catabolic process	16175	4177		0.7538461538461538	0.7575757575757576	470	15705	6	4	464	15701	16175	0.08454367964601273
M1	cpdb	0	network_modules	480	TRUE	1.623906888053492e-4	86	10	4	0.4	0.046511627906976744	GO:0030071	GO:BP	regulation of mitotic metaphase/anaphase transition	16175	6671		0.7692307692307693	0.7727272727272727	86	16089	4	6	82	16083	16175	0.13498679077995282
M1	cpdb	0	network_modules	480	TRUE	1.7821611675968463e-4	88	10	4	0.4	0.045454545454545456	GO:1902099	GO:BP	regulation of metaphase/anaphase transition of cell cycle	16175	22013		0.7846153846153846	0.7878787878787878	88	16087	4	6	84	16081	16175	0.13341052044844845
M1	cpdb	0	network_modules	480	TRUE	1.9592163520674706e-4	512	10	6	0.6	0.01171875	GO:0051338	GO:BP	regulation of transferase activity	16175	13665		0.8	0.803030303030303	512	15663	6	4	506	15659	16175	0.08074152561926157
M1	cpdb	0	network_modules	480	TRUE	2.0493259502488923e-4	248	10	5	0.5	0.020161290322580645	GO:0000209	GO:BP	protein polyubiquitination	16175	59		0.8153846153846154	0.8181818181818182	248	15927	5	5	243	15922	16175	0.09810873579370916
M1	cpdb	0	network_modules	480	TRUE	2.6929052634003557e-4	262	10	5	0.5	0.019083969465648856	GO:0010948	GO:BP	negative regulation of cell cycle process	16175	4526		0.8307692307692308	0.8333333333333334	262	15913	5	5	257	15908	16175	0.09532296977077023
M1	cpdb	0	network_modules	480	TRUE	3.9701783346167326e-4	577	10	6	0.6	0.010398613518197574	GO:0043085	GO:BP	positive regulation of catalytic activity	16175	10518		0.8461538461538461	0.8484848484848485	577	15598	6	4	571	15594	16175	0.07567726224972042
M1	cpdb	0	network_modules	480	TRUE	4.884323508512205e-4	113	10	4	0.4	0.035398230088495575	GO:0051225	GO:BP	spindle assembly	16175	13578		0.8615384615384616	0.8636363636363636	113	16062	4	6	109	16056	16175	0.11736141158765863
M1	cpdb	0	network_modules	480	TRUE	6.789314187651186e-4	632	10	6	0.6	0.00949367088607595	GO:0031401	GO:BP	positive regulation of protein modification process	16175	7157		0.8769230769230769	0.8787878787878788	632	15543	6	4	626	15539	16175	0.0720007621771765
M1	cpdb	0	network_modules	480	TRUE	9.515725019104045e-4	338	10	5	0.5	0.014792899408284023	GO:0045786	GO:BP	negative regulation of cell cycle	16175	11618		0.8923076923076924	0.8939393939393939	338	15837	5	5	333	15832	16175	0.08330882700864875
M1	cpdb	0	network_modules	480	TRUE	0.001091024171113861	308	10	5	0.5	0.016233766233766232	REAC:R-HSA-983168	REAC	Antigen processing: Ubiquitination & Proteasome degradation	10916	154		0.9210526315789473	0.9230769230769231	308	10608	5	5	303	10603	10916	0.08627448362067319
M1	cpdb	0	network_modules	480	TRUE	0.001529568023278664	218	8	4	0.5	0.01834862385321101	KEGG:05166	KEGG	Human T-cell leukemia virus 1 infection	8484	447		1	1	218	8266	4	4	214	8262	8484	0.0920940440594218
M1	cpdb	0	network_modules	480	TRUE	0.0019182683808660749	159	10	4	0.4	0.025157232704402517	GO:1901991	GO:BP	negative regulation of mitotic cell cycle phase transition	16175	21924		0.9076923076923077	0.9090909090909091	159	16016	4	6	155	16010	16175	0.09836367211764034
M1	cpdb	0	network_modules	480	TRUE	0.0028758824855959924	176	10	4	0.4	0.022727272727272728	GO:0007051	GO:BP	spindle organization	16175	2650		0.9230769230769231	0.9242424242424242	176	15999	4	6	172	15993	16175	0.09329022295379895
M1	cpdb	0	network_modules	480	TRUE	0.0030512121535677785	380	10	5	0.5	0.013157894736842105	REAC:R-HSA-983169	REAC	Class I MHC mediated antigen processing & presentation	10916	368		0.9473684210526315	0.9487179487179487	380	10536	5	5	375	10531	10916	0.07684759324511486
M1	cpdb	0	network_modules	480	TRUE	0.0031764891873583357	6	10	2	0.2	0.3333333333333333	REAC:R-HSA-176417	REAC	Phosphorylation of Emi1	10916	1750		0.9736842105263158	0.9743589743589743	6	10910	2	8	4	10902	10916	0.2576781409088113
M1	cpdb	0	network_modules	480	TRUE	0.003494432739924985	50	10	3	0.3	0.06	GO:0051445	GO:BP	regulation of meiotic cell cycle	16175	13708		0.9384615384615385	0.9393939393939394	50	16125	3	7	47	16118	16175	0.13302848809606627
M1	cpdb	0	network_modules	480	TRUE	0.00365614327046356	5	10	2	0.2	0.4	GO:1905784	GO:BP	regulation of anaphase-promoting complex-dependent catabolic process	16175	24894		0.9538461538461539	0.9545454545454546	5	16170	2	8	3	16162	16175	0.28253656168710733
M1	cpdb	0	network_modules	480	TRUE	0.00497369434066614	202	10	4	0.4	0.019801980198019802	GO:0045930	GO:BP	negative regulation of mitotic cell cycle	16175	11724		0.9692307692307692	0.9696969696969697	202	15973	4	6	198	15967	16175	0.08679050248288427
M1	cpdb	0	network_modules	480	TRUE	0.005072150373811106	203	10	4	0.4	0.019704433497536946	GO:0051321	GO:BP	meiotic cell cycle	16175	13648		0.9846153846153847	0.9848484848484849	203	15972	4	6	199	15966	16175	0.08656536618635638
M1	cpdb	0	network_modules	480	TRUE	0.0074935398500032046	224	10	4	0.4	0.017857142857142856	GO:1901988	GO:BP	negative regulation of cell cycle phase transition	16175	21921		1	1	224	15951	4	6	220	15945	16175	0.08218568111677799
M1	cpdb	0	network_modules	480	TRUE	0.008602710613730842	71	10	3	0.3	0.04225352112676056	REAC:R-HSA-8854518	REAC	AURKA Activation by TPX2	10916	41		1	1	71	10845	3	7	68	10838	10916	0.11055762429378518
M1	cpdb	0	network_modules	481	TRUE	1.3026035982241828e-5	143	10	5	0.5	0.03496503496503497	GO:0043433	GO:BP	negative regulation of DNA-binding transcription factor activity	16175	10690		0	0.3333333333333333	143	16032	5	5	138	16027	16175	0.13050190282038504
M1	cpdb	0	network_modules	481	TRUE	1.6482213769375017e-5	140	10	5	0.5	0.03571428571428571	KEGG:04120	KEGG	Ubiquitin mediated proteolysis	8484	270		NA	1	140	8344	5	5	135	8339	8484	0.13037678296232788
M1	cpdb	0	network_modules	481	TRUE	1.9819704344751108e-4	97	9	4	0.4444444444444444	0.041237113402061855	REAC:R-HSA-5607764	REAC	CLEC7A (Dectin-1) signaling	10916	275		0	0.125	97	10819	4	5	93	10814	10916	0.1333211640751537
M1	cpdb	0	network_modules	481	TRUE	3.234245556912439e-4	102	10	4	0.4	0.0392156862745098	GO:0038061	GO:BP	non-canonical NF-kappaB signal transduction	16175	9680		0.5	0.6666666666666666	102	16073	4	6	98	16067	16175	0.12369912910539571
M1	cpdb	0	network_modules	481	TRUE	5.521988394120251e-4	308	9	5	0.5555555555555556	0.016233766233766232	REAC:R-HSA-983168	REAC	Antigen processing: Ubiquitination & Proteasome degradation	10916	154		0.14285714285714285	0.25	308	10608	5	4	303	10604	10916	0.09148097865578912
M1	cpdb	0	network_modules	481	TRUE	7.687396573441183e-4	136	9	4	0.4444444444444444	0.029411764705882353	REAC:R-HSA-5621481	REAC	C-type lectin receptors (CLRs)	10916	261		0.2857142857142857	0.375	136	10780	4	5	132	10775	10916	0.11187231608192169
M1	cpdb	0	network_modules	481	TRUE	0.0010529827331114637	345	10	5	0.5	0.014492753623188406	GO:0051090	GO:BP	regulation of DNA-binding transcription factor activity	16175	13485		1	1	345	15830	5	5	340	15825	16175	0.08240306289608092
M1	cpdb	0	network_modules	481	TRUE	0.0015529965976854372	380	9	5	0.5555555555555556	0.013157894736842105	REAC:R-HSA-983169	REAC	Class I MHC mediated antigen processing & presentation	10916	368		0.42857142857142855	0.5	380	10536	5	4	375	10532	10916	0.0816069121391877
M1	cpdb	0	network_modules	481	TRUE	0.003517493525200745	7	9	2	0.2222222222222222	0.2857142857142857	REAC:R-HSA-5603029	REAC	IkBA variant leads to EDA-ID	10916	1167		0.5714285714285714	0.625	7	10909	2	7	5	10902	10916	0.25143346313144566
M1	cpdb	0	network_modules	481	TRUE	0.005022934335235676	67	9	3	0.3333333333333333	0.04477611940298507	REAC:R-HSA-1169091	REAC	Activation of NF-kappaB in B cells	10916	87		0.7142857142857143	0.75	67	10849	3	6	64	10843	10916	0.12033923957713503
M1	cpdb	0	network_modules	481	TRUE	0.007805229866644828	244	9	4	0.4444444444444444	0.01639344262295082	REAC:R-HSA-8951664	REAC	Neddylation	10916	1559		0.8571428571428571	0.875	244	10672	4	5	240	10667	10916	0.08202030069443753
M1	cpdb	0	network_modules	481	TRUE	0.00856842654073085	80	9	3	0.3333333333333333	0.0375	REAC:R-HSA-1168372	REAC	Downstream signaling events of B Cell Receptor (BCR)	10916	791		1	1	80	10836	3	6	77	10830	10916	0.10979344618170156
M1	cpdb	0	network_modules	482	TRUE	8.029670167958865e-9	34	10	5	0.5	0.14705882352941177	GO:0006891	GO:BP	intra-Golgi vesicle-mediated transport	16175	2546		0	0.25	34	16141	5	5	29	16136	16175	0.27039093730828334
M1	cpdb	0	network_modules	482	TRUE	1.0899194180767385e-8	99	9	6	0.6666666666666666	0.06060606060606061	REAC:R-HSA-6811434	REAC	COPI-dependent Golgi-to-ER retrograde traffic	10916	277		0	0.14285714285714285	99	10817	6	3	93	10814	10916	0.19926049615937802
M1	cpdb	0	network_modules	482	TRUE	1.3088320956049935e-8	102	9	6	0.6666666666666666	0.058823529411764705	REAC:R-HSA-6807878	REAC	COPI-mediated anterograde transport	10916	279		0.16666666666666666	0.2857142857142857	102	10814	6	3	96	10811	10916	0.1962535000648632
M1	cpdb	0	network_modules	482	TRUE	4.316147033406798e-8	126	10	6	0.6	0.047619047619047616	GO:0006888	GO:BP	endoplasmic reticulum to Golgi vesicle-mediated transport	16175	2544		0.3333333333333333	0.5	126	16049	6	4	120	16045	16175	0.16754175397208887
M1	cpdb	0	network_modules	482	TRUE	6.615596166674846e-8	133	9	6	0.6666666666666666	0.045112781954887216	REAC:R-HSA-8856688	REAC	Golgi-to-ER retrograde transport	10916	1084		0.3333333333333333	0.42857142857142855	133	10783	6	3	127	10780	10916	0.17136995563749277
M1	cpdb	0	network_modules	482	TRUE	1.67613492859973e-7	155	9	6	0.6666666666666666	0.03870967741935484	REAC:R-HSA-199977	REAC	ER to Golgi Anterograde Transport	10916	823		0.5	0.5714285714285714	155	10761	6	3	149	10758	10916	0.1584158852784655
M1	cpdb	0	network_modules	482	TRUE	5.05060801623609e-7	186	9	6	0.6666666666666666	0.03225806451612903	REAC:R-HSA-948021	REAC	Transport to the Golgi and subsequent modification	10916	2604		0.6666666666666666	0.7142857142857143	186	10730	6	3	180	10727	10916	0.14419166783257176
M1	cpdb	0	network_modules	482	TRUE	8.30884437139087e-7	202	9	6	0.6666666666666666	0.0297029702970297	REAC:R-HSA-6811442	REAC	Intra-Golgi and retrograde Golgi-to-ER traffic	10916	1262		0.8333333333333334	0.8571428571428571	202	10714	6	3	196	10711	10916	0.13815416985115572
M1	cpdb	0	network_modules	482	TRUE	5.854224217301493e-6	284	10	6	0.6	0.02112676056338028	GO:0048193	GO:BP	Golgi vesicle transport	16175	12570		0.6666666666666666	0.75	284	15891	6	4	278	15887	16175	0.11029970869827029
M1	cpdb	0	network_modules	482	TRUE	9.852475401022595e-6	305	9	6	0.6666666666666666	0.019672131147540985	REAC:R-HSA-446203	REAC	Asparagine N-linked glycosylation	10916	169		1	1	305	10611	6	3	299	10608	10916	0.1113316544307078
M1	cpdb	0	network_modules	482	TRUE	0.003937590019716861	52	10	3	0.3	0.057692307692307696	GO:0006890	GO:BP	retrograde vesicle-mediated transport, Golgi to endoplasmic reticulum	16175	2545		1	1	52	16123	3	7	49	16116	16175	0.1303989278910677
M1	cpdb	0	network_modules	486	TRUE	2.5465369315507202e-14	44	9	7	0.7777777777777778	0.1590909090909091	GO:0048013	GO:BP	ephrin receptor signaling pathway	16175	12469		0	0.023255813953488372	44	16131	7	2	37	16129	16175	0.3511083947247049
M1	cpdb	0	network_modules	486	TRUE	4.524675240288392e-13	181	10	9	0.9	0.049723756906077346	KEGG:04360	KEGG	Axon guidance	8484	305		NA	1	181	8303	9	1	172	8302	8484	0.20889272185314503
M1	cpdb	0	network_modules	486	TRUE	2.0156740700662023e-11	90	9	7	0.7777777777777778	0.07777777777777778	REAC:R-HSA-2682334	REAC	EPH-Ephrin signaling	10916	818		0	0.25	90	10826	7	2	83	10824	10916	0.24445791720994076
M1	cpdb	0	network_modules	486	TRUE	1.3763905625814293e-10	49	9	6	0.6666666666666666	0.12244897959183673	REAC:R-HSA-3928665	REAC	EPH-ephrin mediated repulsion of cells	10916	819		0.3333333333333333	0.5	49	10867	6	3	43	10864	10916	0.28454692478556204
M1	cpdb	0	network_modules	486	TRUE	1.6721948315987267e-10	17	9	5	0.5555555555555556	0.29411764705882354	REAC:R-HSA-3928664	REAC	Ephrin signaling	10916	849		0.6666666666666666	0.75	17	10899	5	4	12	10895	10916	0.40357355321808497
M1	cpdb	0	network_modules	486	TRUE	3.808405120158452e-10	165	9	7	0.7777777777777778	0.04242424242424243	GO:0097485	GO:BP	neuron projection guidance	16175	18673		0.023809523809523808	0.06976744186046512	165	16010	7	2	158	16008	16175	0.18023888289587867
M1	cpdb	0	network_modules	486	TRUE	3.808405120158452e-10	165	9	7	0.7777777777777778	0.04242424242424243	GO:0007411	GO:BP	axon guidance	16175	2906		0.023809523809523808	0.06976744186046512	165	16010	7	2	158	16008	16175	0.18023888289587867
M1	cpdb	0	network_modules	486	TRUE	7.924587568432598e-10	379	9	8	0.8888888888888888	0.021108179419525065	GO:0048667	GO:BP	cell morphogenesis involved in neuron differentiation	16175	12925		0.07142857142857142	0.09302325581395349	379	15796	8	1	371	15795	16175	0.1349947625767337
M1	cpdb	0	network_modules	486	TRUE	2.6817896952310105e-9	441	9	8	0.8888888888888888	0.018140589569160998	GO:0048812	GO:BP	neuron projection morphogenesis	16175	13058		0.09523809523809523	0.11627906976744186	441	15734	8	1	433	15733	16175	0.12483704359382905
M1	cpdb	0	network_modules	486	TRUE	3.509012943647203e-9	456	9	8	0.8888888888888888	0.017543859649122806	GO:0120039	GO:BP	plasma membrane bounded cell projection morphogenesis	16175	19473		0.11904761904761904	0.13953488372093023	456	15719	8	1	448	15718	16175	0.12269300020389391
M1	cpdb	0	network_modules	486	TRUE	3.764136794243434e-9	460	9	8	0.8888888888888888	0.017391304347826087	GO:0048858	GO:BP	cell projection morphogenesis	16175	13102		0.14285714285714285	0.16279069767441862	460	15715	8	1	452	15714	16175	0.12213883040445864
M1	cpdb	0	network_modules	486	TRUE	8.62098494917302e-9	510	9	8	0.8888888888888888	0.01568627450980392	GO:0007169	GO:BP	cell surface receptor protein tyrosine kinase signaling pathway	16175	2733		0.16666666666666666	0.18604651162790697	510	15665	8	1	502	15664	16175	0.11576480740472407
M1	cpdb	0	network_modules	486	TRUE	1.3883872929850188e-8	43	9	5	0.5555555555555556	0.11627906976744186	GO:0060997	GO:BP	dendritic spine morphogenesis	16175	15121		0.19047619047619047	0.20930232558139536	43	16132	5	4	38	16128	16175	0.2533554550322512
M1	cpdb	0	network_modules	486	TRUE	1.765675043177994e-8	40	9	5	0.5555555555555556	0.125	REAC:R-HSA-3928662	REAC	EPHB-mediated forward signaling	10916	821		1	1	40	10876	5	4	35	10872	10916	0.262374127165982
M1	cpdb	0	network_modules	486	TRUE	2.434729026887627e-8	297	9	7	0.7777777777777778	0.02356902356902357	GO:0007409	GO:BP	axonogenesis	16175	2905		0.21428571428571427	0.23255813953488372	297	15878	7	2	290	15876	16175	0.1334651682893378
M1	cpdb	0	network_modules	486	TRUE	6.100662450017547e-8	651	9	8	0.8888888888888888	0.01228878648233487	GO:0000902	GO:BP	cell morphogenesis	16175	240		0.23809523809523808	0.2558139534883721	651	15524	8	1	643	15523	16175	0.10188171786090373
M1	cpdb	0	network_modules	486	TRUE	6.17167630068109e-8	339	9	7	0.7777777777777778	0.02064896755162242	GO:0061564	GO:BP	axon development	16175	15561		0.2619047619047619	0.27906976744186046	339	15836	7	2	332	15834	16175	0.12466196829508353
M1	cpdb	0	network_modules	486	TRUE	8.548800629902387e-8	61	9	5	0.5555555555555556	0.08196721311475409	GO:0097061	GO:BP	dendritic spine organization	16175	18469		0.2857142857142857	0.3023255813953488	61	16114	5	4	56	16110	16175	0.2124061082604591
M1	cpdb	0	network_modules	486	TRUE	9.062922772358269e-8	684	9	8	0.8888888888888888	0.011695906432748537	GO:0031175	GO:BP	neuron projection development	16175	7086		0.30952380952380953	0.32558139534883723	684	15491	8	1	676	15490	16175	0.09926027304694252
M1	cpdb	0	network_modules	486	TRUE	1.0949472815234338e-7	64	9	5	0.5555555555555556	0.078125	GO:0060996	GO:BP	dendritic spine development	16175	15120		0.3333333333333333	0.3488372093023256	64	16111	5	4	59	16107	16175	0.2073176890121721
M1	cpdb	0	network_modules	486	TRUE	1.8670696455886118e-7	71	9	5	0.5555555555555556	0.07042253521126761	GO:0106027	GO:BP	neuron projection organization	16175	19219		0.35714285714285715	0.37209302325581395	71	16104	5	4	66	16100	16175	0.19672097691853166
M1	cpdb	0	network_modules	486	TRUE	2.1271314575380972e-7	761	9	8	0.8888888888888888	0.010512483574244415	GO:0048666	GO:BP	neuron development	16175	12924		0.38095238095238093	0.3953488372093023	761	15414	8	1	753	15413	16175	0.09380895794434002
M1	cpdb	0	network_modules	486	TRUE	2.868145778835434e-7	790	9	8	0.8888888888888888	0.010126582278481013	GO:0007167	GO:BP	enzyme-linked receptor protein signaling pathway	16175	2731		0.40476190476190477	0.4186046511627907	790	15385	8	1	782	15384	16175	0.09196151283233032
M1	cpdb	0	network_modules	486	TRUE	7.418892738775845e-7	93	9	5	0.5555555555555556	0.053763440860215055	GO:0048813	GO:BP	dendrite morphogenesis	16175	13059		0.42857142857142855	0.4418604651162791	93	16082	5	4	88	16078	16175	0.17157822977895745
M1	cpdb	0	network_modules	486	TRUE	9.684235099256323e-7	98	9	5	0.5555555555555556	0.05102040816326531	GO:0099173	GO:BP	postsynapse organization	16175	19081		0.4523809523809524	0.46511627906976744	98	16077	5	4	93	16073	16175	0.16707593448331276
M1	cpdb	0	network_modules	486	TRUE	2.3268518395184837e-6	283	9	6	0.6666666666666666	0.02120141342756184	GO:0050808	GO:BP	synapse organization	16175	13274		0.47619047619047616	0.4883720930232558	283	15892	6	3	277	15889	16175	0.1168262825471087
M1	cpdb	0	network_modules	486	TRUE	3.193438126074044e-6	124	9	5	0.5555555555555556	0.04032258064516129	GO:0050807	GO:BP	regulation of synapse organization	16175	13273		0.5	0.5116279069767442	124	16051	5	4	119	16047	16175	0.1482160613769369
M1	cpdb	0	network_modules	486	TRUE	3.899769838428095e-6	129	9	5	0.5555555555555556	0.03875968992248062	GO:0050803	GO:BP	regulation of synapse structure or activity	16175	13269		0.5238095238095238	0.5348837209302325	129	16046	5	4	124	16042	16175	0.1452559099316412
M1	cpdb	0	network_modules	486	TRUE	7.086536732737162e-6	8	9	3	0.3333333333333333	0.375	GO:0022038	GO:BP	corpus callosum development	16175	6590		0.5476190476190477	0.5581395348837209	8	16167	3	6	5	16161	16175	0.3532144133982638
M1	cpdb	0	network_modules	486	TRUE	8.345882307021517e-6	150	9	5	0.5555555555555556	0.03333333333333333	GO:0016358	GO:BP	dendrite development	16175	5220		0.5714285714285714	0.5813953488372093	150	16025	5	4	145	16021	16175	0.1344734314500667
M1	cpdb	0	network_modules	486	TRUE	3.61416189530683e-5	13	9	3	0.3333333333333333	0.23076923076923078	GO:0106030	GO:BP	neuron projection fasciculation	16175	19221		0.5952380952380952	0.627906976744186	13	16162	3	6	10	16156	16175	0.27686966205164043
M1	cpdb	0	network_modules	486	TRUE	3.61416189530683e-5	13	9	3	0.3333333333333333	0.23076923076923078	GO:0007413	GO:BP	axonal fasciculation	16175	2908		0.5952380952380952	0.627906976744186	13	16162	3	6	10	16156	16175	0.27686966205164043
M1	cpdb	0	network_modules	486	TRUE	1.0225649916534597e-4	533	9	6	0.6666666666666666	0.01125703564727955	GO:0034330	GO:BP	cell junction organization	16175	8572		0.6428571428571429	0.6511627906976745	533	15642	6	3	527	15639	16175	0.08376222608897681
M1	cpdb	0	network_modules	486	TRUE	4.421717208908346e-4	125	9	4	0.4444444444444444	0.032	GO:0007416	GO:BP	synapse assembly	16175	2911		0.6666666666666666	0.6744186046511628	125	16050	4	5	121	16045	16175	0.11767150336756986
M1	cpdb	0	network_modules	486	TRUE	6.856416849127828e-4	33	9	3	0.3333333333333333	0.09090909090909091	GO:0051965	GO:BP	positive regulation of synapse assembly	16175	14034		0.6904761904761905	0.7209302325581395	33	16142	3	6	30	16136	16175	0.17323716536333697
M1	cpdb	0	network_modules	486	TRUE	6.856416849127828e-4	33	9	3	0.3333333333333333	0.09090909090909091	GO:0008038	GO:BP	neuron recognition	16175	3100		0.6904761904761905	0.7209302325581395	33	16142	3	6	30	16136	16175	0.17323716536333697
M1	cpdb	0	network_modules	486	TRUE	0.0011142761130581338	400	9	5	0.5555555555555556	0.0125	GO:0001525	GO:BP	angiogenesis	16175	330		0.7380952380952381	0.7441860465116279	400	15775	5	4	395	15771	16175	0.08064952096764474
M1	cpdb	0	network_modules	486	TRUE	0.0019279143708062474	447	9	5	0.5555555555555556	0.011185682326621925	GO:0048514	GO:BP	blood vessel morphogenesis	16175	12799		0.7619047619047619	0.7674418604651163	447	15728	5	4	442	15724	16175	0.07598749368875399
M1	cpdb	0	network_modules	486	TRUE	0.002737845667615115	480	9	5	0.5555555555555556	0.010416666666666666	GO:0001568	GO:BP	blood vessel development	16175	353		0.7857142857142857	0.7906976744186046	480	15695	5	4	475	15691	16175	0.07312228263520407
M1	cpdb	0	network_modules	486	TRUE	0.0034800848412278903	504	9	5	0.5555555555555556	0.00992063492063492	GO:0001944	GO:BP	vasculature development	16175	555		0.8095238095238095	0.813953488372093	504	15671	5	4	499	15667	16175	0.07121316715629995
M1	cpdb	0	network_modules	486	TRUE	0.0038506760167845953	58	9	3	0.3333333333333333	0.05172413793103448	GO:0051963	GO:BP	regulation of synapse assembly	16175	14032		0.8333333333333334	0.8372093023255814	58	16117	3	6	55	16111	16175	0.13016365594100812
M1	cpdb	0	network_modules	486	TRUE	0.004455089654283258	530	9	5	0.5555555555555556	0.009433962264150943	GO:0043408	GO:BP	regulation of MAPK cascade	16175	10676		0.8571428571428571	0.8604651162790697	530	15645	5	4	525	15641	16175	0.0692891015166467
M1	cpdb	0	network_modules	486	TRUE	0.005438514488858639	552	9	5	0.5555555555555556	0.009057971014492754	GO:0035239	GO:BP	tube morphogenesis	16175	8921		0.8809523809523809	0.8837209302325582	552	15623	5	4	547	15619	16175	0.06776532575389606
M1	cpdb	0	network_modules	486	TRUE	0.00587883733359789	239	9	4	0.4444444444444444	0.016736401673640166	GO:0070372	GO:BP	regulation of ERK1 and ERK2 cascade	16175	16083		0.9047619047619048	0.9069767441860465	239	15936	4	5	235	15931	16175	0.08402513479595791
M1	cpdb	0	network_modules	486	TRUE	0.006236815582248933	68	9	3	0.3333333333333333	0.04411764705882353	GO:1901890	GO:BP	positive regulation of cell junction assembly	16175	21834		0.9285714285714286	0.9302325581395349	68	16107	3	6	65	16101	16175	0.12002425992106877
M1	cpdb	0	network_modules	486	TRUE	0.0076000225106451404	255	9	4	0.4444444444444444	0.01568627450980392	GO:0070371	GO:BP	ERK1 and ERK2 cascade	16175	16082		0.9523809523809523	0.9534883720930233	255	15920	4	5	251	15915	16175	0.08119984938012041
M1	cpdb	0	network_modules	486	TRUE	0.007723850088141378	593	9	5	0.5555555555555556	0.008431703204047217	GO:0007417	GO:BP	central nervous system development	16175	2912		0.9761904761904762	0.9767441860465116	593	15582	5	4	588	15578	16175	0.06514843586687635
M1	cpdb	0	network_modules	486	TRUE	0.007852099255477323	595	9	5	0.5555555555555556	0.008403361344537815	GO:0000165	GO:BP	MAPK cascade	16175	55		1	1	595	15580	5	4	590	15576	16175	0.06502752576093683
M1	cpdb	0	network_modules	488	TRUE	1.1160163406867666e-11	4	7	4	0.5714285714285714	1	GO:0006003	GO:BP	fructose 2,6-bisphosphate metabolic process	16175	1878		0	0.05555555555555555	4	16171	4	3	0	16168	16175	0.7558588238235925
M1	cpdb	0	network_modules	488	TRUE	6.963946155177692e-9	12	7	4	0.5714285714285714	0.3333333333333333	REAC:R-HSA-9634600	REAC	Regulation of glycolysis by fructose 2,6-bisphosphate metabolism	10916	2038		0	0.25	12	10904	4	3	8	10901	10916	0.435975606579635
M1	cpdb	0	network_modules	488	TRUE	4.000202178095333e-8	68	7	5	0.7142857142857143	0.07352941176470588	REAC:R-HSA-70171	REAC	Glycolysis	10916	1074		0.3333333333333333	0.5	68	10848	5	2	63	10846	10916	0.22795996882999123
M1	cpdb	0	network_modules	488	TRUE	1.3327509717572108e-7	86	7	5	0.7142857142857143	0.05813953488372093	REAC:R-HSA-70326	REAC	Glucose metabolism	10916	1053		0.6666666666666666	0.75	86	10830	5	2	81	10828	10916	0.2024006226327591
M1	cpdb	0	network_modules	488	TRUE	1.571840343354132e-7	34	6	4	0.6666666666666666	0.11764705882352941	KEGG:00051	KEGG	Fructose and mannose metabolism	8484	6		0	0.5	34	8450	4	2	30	8448	8484	0.2790306734955726
M1	cpdb	0	network_modules	488	TRUE	2.7390865055170918e-5	120	6	4	0.6666666666666666	0.03333333333333333	KEGG:04152	KEGG	AMPK signaling pathway	8484	286		1	1	120	8364	4	2	116	8362	8484	0.14700339522373226
M1	cpdb	0	network_modules	488	TRUE	5.913974059649606e-5	288	7	5	0.7142857142857143	0.017361111111111112	REAC:R-HSA-71387	REAC	Metabolism of carbohydrates	10916	1422		1	1	288	10628	5	2	283	10626	10916	0.10872386909492282
M1	cpdb	0	network_modules	488	TRUE	0.002656718060147737	72	7	3	0.42857142857142855	0.041666666666666664	GO:0046032	GO:BP	ADP catabolic process	16175	11809		0.058823529411764705	0.16666666666666666	72	16103	3	4	69	16099	16175	0.13256668145646744
M1	cpdb	0	network_modules	488	TRUE	0.002656718060147737	72	7	3	0.42857142857142855	0.041666666666666664	GO:0006096	GO:BP	glycolytic process	16175	1956		0.058823529411764705	0.16666666666666666	72	16103	3	4	69	16099	16175	0.13256668145646744
M1	cpdb	0	network_modules	488	TRUE	0.002886570040669879	74	7	3	0.42857142857142855	0.04054054054054054	GO:0009137	GO:BP	purine nucleoside diphosphate catabolic process	16175	3304		0.17647058823529413	0.3333333333333333	74	16101	3	4	71	16097	16175	0.1307329653698209
M1	cpdb	0	network_modules	488	TRUE	0.002886570040669879	74	7	3	0.42857142857142855	0.04054054054054054	GO:0009181	GO:BP	purine ribonucleoside diphosphate catabolic process	16175	3347		0.17647058823529413	0.3333333333333333	74	16101	3	4	71	16097	16175	0.1307329653698209
M1	cpdb	0	network_modules	488	TRUE	0.002886570040669879	74	7	3	0.42857142857142855	0.04054054054054054	GO:0046031	GO:BP	ADP metabolic process	16175	11808		0.17647058823529413	0.3333333333333333	74	16101	3	4	71	16097	16175	0.1307329653698209
M1	cpdb	0	network_modules	488	TRUE	0.003129248318921616	76	7	3	0.42857142857142855	0.039473684210526314	GO:0019364	GO:BP	pyridine nucleotide catabolic process	16175	5726		0.35294117647058826	0.4444444444444444	76	16099	3	4	73	16095	16175	0.1289717169753835
M1	cpdb	0	network_modules	488	TRUE	0.003129248318921616	76	7	3	0.42857142857142855	0.039473684210526314	GO:0009179	GO:BP	purine ribonucleoside diphosphate metabolic process	16175	3345		0.35294117647058826	0.4444444444444444	76	16099	3	4	73	16095	16175	0.1289717169753835
M1	cpdb	0	network_modules	488	TRUE	0.0032555040717178667	77	7	3	0.42857142857142855	0.03896103896103896	GO:0009191	GO:BP	ribonucleoside diphosphate catabolic process	16175	3357		0.47058823529411764	0.5555555555555556	77	16098	3	4	74	16094	16175	0.12811679192798228
M1	cpdb	0	network_modules	488	TRUE	0.0032555040717178667	77	7	3	0.42857142857142855	0.03896103896103896	GO:0009135	GO:BP	purine nucleoside diphosphate metabolic process	16175	3302		0.47058823529411764	0.5555555555555556	77	16098	3	4	74	16094	16175	0.12811679192798228
M1	cpdb	0	network_modules	488	TRUE	0.0035180620236807338	79	7	3	0.42857142857142855	0.0379746835443038	GO:0072526	GO:BP	pyridine-containing compound catabolic process	16175	17428		0.5882352941176471	0.6111111111111112	79	16096	3	4	76	16092	16175	0.12645561772485178
M1	cpdb	0	network_modules	488	TRUE	0.003937653748182873	82	7	3	0.42857142857142855	0.036585365853658534	GO:0009134	GO:BP	nucleoside diphosphate catabolic process	16175	3301		0.6470588235294118	0.6666666666666666	82	16093	3	4	79	16089	16175	0.12407808057846476
M1	cpdb	0	network_modules	488	TRUE	0.0043891713613958975	85	7	3	0.42857142857142855	0.03529411764705882	GO:0009185	GO:BP	ribonucleoside diphosphate metabolic process	16175	3351		0.7058823529411765	0.7222222222222222	85	16090	3	4	82	16086	16175	0.12182678232478586
M1	cpdb	0	network_modules	488	TRUE	0.005215756465839129	90	7	3	0.42857142857142855	0.03333333333333333	GO:0009154	GO:BP	purine ribonucleotide catabolic process	16175	3321		0.7647058823529411	0.7777777777777778	90	16085	3	4	87	16081	16175	0.11832628240569532
M1	cpdb	0	network_modules	488	TRUE	0.005573296891132017	92	7	3	0.42857142857142855	0.03260869565217391	GO:0009261	GO:BP	ribonucleotide catabolic process	16175	3426		0.8235294117647058	0.8333333333333334	92	16083	3	4	89	16079	16175	0.117006125150534
M1	cpdb	0	network_modules	488	TRUE	0.005758001578749265	93	7	3	0.42857142857142855	0.03225806451612903	GO:0009132	GO:BP	nucleoside diphosphate metabolic process	16175	3299		0.8823529411764706	0.8888888888888888	93	16082	3	4	90	16078	16175	0.11636196378838377
M1	cpdb	0	network_modules	488	TRUE	0.006336358936943704	96	7	3	0.42857142857142855	0.03125	GO:0006090	GO:BP	pyruvate metabolic process	16175	1953		0.9411764705882353	0.9444444444444444	96	16079	3	4	93	16075	16175	0.11448981809974512
M1	cpdb	0	network_modules	488	TRUE	0.006951964151748747	99	7	3	0.42857142857142855	0.030303030303030304	GO:0006195	GO:BP	purine nucleotide catabolic process	16175	2024		1	1	99	16076	3	4	96	16072	16175	0.11270281771282976
M1	cpdb	0	network_modules	491	TRUE	6.30659130425118e-4	18	3	2	0.6666666666666666	0.1111111111111111	KEGG:00511	KEGG	Other glycan degradation	8484	64		NA	1	18	8466	2	1	16	8465	8484	0.2716356597912063
M1	cpdb	0	network_modules	496	TRUE	0.0018205784896406219	178	9	4	0.4444444444444444	0.02247191011235955	GO:0022618	GO:BP	protein-RNA complex assembly	16175	6625		0	0.5	178	15997	4	5	174	15992	16175	0.09803107796660503
M1	cpdb	0	network_modules	496	TRUE	0.0022639520201949872	188	9	4	0.4444444444444444	0.02127659574468085	GO:0071826	GO:BP	protein-RNA complex organization	16175	16929		1	1	188	15987	4	5	184	15982	16175	0.09528197276057217
M1	cpdb	0	network_modules	497	TRUE	1.6514815265764347e-10	20	8	5	0.625	0.25	REAC:R-HSA-190840	REAC	Microtubule-dependent trafficking of connexons from Golgi to the plasma membrane	10916	1451		0	0.014084507042253521	20	10896	5	3	15	10893	10916	0.3946321233008302
M1	cpdb	0	network_modules	497	TRUE	2.167072318887281e-10	21	8	5	0.625	0.23809523809523808	REAC:R-HSA-190872	REAC	Transport of connexons to the plasma membrane	10916	2592		0.014285714285714285	0.028169014084507043	21	10895	5	3	16	10892	10916	0.3850825744424474
M1	cpdb	0	network_modules	497	TRUE	4.5233605958983886e-10	24	8	5	0.625	0.20833333333333334	REAC:R-HSA-389977	REAC	Post-chaperonin tubulin folding pathway	10916	1773		0.02857142857142857	0.04225352112676056	24	10892	5	3	19	10889	10916	0.36010246442819815
M1	cpdb	0	network_modules	497	TRUE	6.997226902466194e-10	26	8	5	0.625	0.19230769230769232	REAC:R-HSA-389960	REAC	Formation of tubulin folding intermediates by CCT/TriC	10916	975		0.04285714285714286	0.056338028169014086	26	10890	5	3	21	10887	10916	0.34590523616911073
M1	cpdb	0	network_modules	497	TRUE	1.0449557200747892e-9	28	8	5	0.625	0.17857142857142858	REAC:R-HSA-389957	REAC	Prefoldin mediated transfer of substrate  to CCT/TriC	10916	1788		0.05714285714285714	0.08450704225352113	28	10888	5	3	23	10885	10916	0.333255142716289
M1	cpdb	0	network_modules	497	TRUE	1.0449557200747892e-9	28	8	5	0.625	0.17857142857142858	REAC:R-HSA-9619483	REAC	Activation of AMPK downstream of NMDARs	10916	73		0.05714285714285714	0.08450704225352113	28	10888	5	3	23	10885	10916	0.333255142716289
M1	cpdb	0	network_modules	497	TRUE	2.139152109173804e-9	32	8	5	0.625	0.15625	REAC:R-HSA-5626467	REAC	RHO GTPases activate IQGAPs	10916	1854		0.08571428571428572	0.11267605633802817	32	10884	5	3	27	10881	10916	0.31160536518602366
M1	cpdb	0	network_modules	497	TRUE	2.139152109173804e-9	32	8	5	0.625	0.15625	REAC:R-HSA-9668328	REAC	Sealing of the nuclear envelope (NE) by ESCRT-III	10916	2185		0.08571428571428572	0.11267605633802817	32	10884	5	3	27	10881	10916	0.31160536518602366
M1	cpdb	0	network_modules	497	TRUE	2.3599044551804434e-9	94	8	6	0.75	0.06382978723404255	REAC:R-HSA-380320	REAC	Recruitment of NuMA to mitotic centrosomes	10916	1950		0.11428571428571428	0.1267605633802817	94	10822	6	2	88	10820	10916	0.2173022772803588
M1	cpdb	0	network_modules	497	TRUE	2.520564771136143e-9	33	8	5	0.625	0.15151515151515152	REAC:R-HSA-389958	REAC	Cooperation of Prefoldin and TriC/CCT  in actin and tubulin folding	10916	411		0.12857142857142856	0.14084507042253522	33	10883	5	3	28	10880	10916	0.3068166593559719
M1	cpdb	0	network_modules	497	TRUE	5.3246259445015224e-9	38	8	5	0.625	0.13157894736842105	REAC:R-HSA-190861	REAC	Gap junction assembly	10916	1033		0.14285714285714285	0.15492957746478872	38	10878	5	3	33	10875	10916	0.28577481357726436
M1	cpdb	0	network_modules	497	TRUE	1.0199565374928757e-8	43	8	5	0.625	0.11627906976744186	REAC:R-HSA-9609736	REAC	Assembly and cell surface presentation of NMDA receptors	10916	173		0.15714285714285714	0.16901408450704225	43	10873	5	3	38	10870	10916	0.2685104374549108
M1	cpdb	0	network_modules	497	TRUE	1.15045581228292e-8	44	8	5	0.625	0.11363636363636363	REAC:R-HSA-9646399	REAC	Aggrephagy	10916	129		0.17142857142857143	0.18309859154929578	44	10872	5	3	39	10869	10916	0.26541469788370314
M1	cpdb	0	network_modules	497	TRUE	1.293965403844944e-8	45	8	5	0.625	0.1111111111111111	REAC:R-HSA-8955332	REAC	Carboxyterminal post-translational modifications of tubulin	10916	305		0.18571428571428572	0.19718309859154928	45	10871	5	3	40	10868	10916	0.2624224285895681
M1	cpdb	0	network_modules	497	TRUE	1.812251825377507e-8	48	8	5	0.625	0.10416666666666667	REAC:R-HSA-437239	REAC	Recycling pathway of L1	10916	1954		0.2	0.2112676056338028	48	10868	5	3	43	10865	10916	0.2540120049282593
M1	cpdb	0	network_modules	497	TRUE	2.0177256760244874e-8	49	8	5	0.625	0.10204081632653061	REAC:R-HSA-190828	REAC	Gap junction trafficking	10916	1035		0.21428571428571427	0.22535211267605634	49	10867	5	3	44	10864	10916	0.25138113945198326
M1	cpdb	0	network_modules	497	TRUE	2.241402102633104e-8	50	8	5	0.625	0.1	REAC:R-HSA-157858	REAC	Gap junction trafficking and regulation	10916	1036		0.22857142857142856	0.23943661971830985	50	10866	5	3	45	10863	10916	0.24882934138633958
M1	cpdb	0	network_modules	497	TRUE	3.033700379028688e-8	53	8	5	0.625	0.09433962264150944	REAC:R-HSA-6811436	REAC	COPI-independent Golgi-to-ER retrograde traffic	10916	278		0.24285714285714285	0.2535211267605634	53	10863	5	3	48	10860	10916	0.24161071851272056
M1	cpdb	0	network_modules	497	TRUE	3.342492955916579e-8	54	8	5	0.625	0.09259259259259259	REAC:R-HSA-5620924	REAC	Intraflagellar transport	10916	1267		0.2571428571428571	0.2676056338028169	54	10862	5	3	49	10859	10916	0.23933878552975354
M1	cpdb	0	network_modules	497	TRUE	4.422347958859779e-8	57	8	5	0.625	0.08771929824561403	REAC:R-HSA-3371497	REAC	HSP90 chaperone cycle for steroid hormone receptors (SHR) in the presence of ligand	10916	1111		0.2714285714285714	0.28169014084507044	57	10859	5	3	52	10856	10916	0.23288417745751974
M1	cpdb	0	network_modules	497	TRUE	5.7643739166032794e-8	60	8	5	0.625	0.08333333333333333	REAC:R-HSA-983189	REAC	Kinesins	10916	1292		0.2857142857142857	0.29577464788732394	60	10856	5	3	55	10853	10916	0.22691811354638122
M1	cpdb	0	network_modules	497	TRUE	1.2744808324721263e-7	70	8	5	0.625	0.07142857142857142	REAC:R-HSA-2995410	REAC	Nuclear Envelope (NE) Reassembly	10916	1612		0.3	0.30985915492957744	70	10846	5	3	65	10843	10916	0.2098713720026568
M1	cpdb	0	network_modules	497	TRUE	1.4726699754336717e-7	72	8	5	0.625	0.06944444444444445	REAC:R-HSA-1445148	REAC	Translocation of SLC2A4 (GLUT4) to the plasma membrane	10916	2578		0.3142857142857143	0.323943661971831	72	10844	5	3	67	10841	10916	0.20689374829394347
M1	cpdb	0	network_modules	497	TRUE	1.8153702089796532e-7	75	8	5	0.625	0.06666666666666667	REAC:R-HSA-9833482	REAC	PKR-mediated signaling	10916	1692		0.32857142857142857	0.3380281690140845	75	10841	5	3	70	10838	10916	0.20265159122587315
M1	cpdb	0	network_modules	497	TRUE	1.942765684875219e-7	76	8	5	0.625	0.06578947368421052	REAC:R-HSA-438064	REAC	Post NMDA receptor activation events	10916	1772		0.34285714285714286	0.352112676056338	76	10840	5	3	71	10837	10916	0.20129339111232794
M1	cpdb	0	network_modules	497	TRUE	2.0152870135012136e-7	195	8	6	0.75	0.03076923076923077	REAC:R-HSA-69275	REAC	G2/M Transition	10916	1008		0.35714285714285715	0.36619718309859156	195	10721	6	2	189	10719	10916	0.149690055838956
M1	cpdb	0	network_modules	497	TRUE	2.1435505273348905e-7	197	8	6	0.75	0.030456852791878174	REAC:R-HSA-453274	REAC	Mitotic G2-G2/M phases	10916	1481		0.37142857142857144	0.38028169014084506	197	10719	6	2	191	10717	10916	0.14890488983641206
M1	cpdb	0	network_modules	497	TRUE	2.2785308961479695e-7	199	8	6	0.75	0.03015075376884422	REAC:R-HSA-68877	REAC	Mitotic Prometaphase	10916	1484		0.38571428571428573	0.39436619718309857	199	10717	6	2	193	10715	10916	0.1481314696142509
M1	cpdb	0	network_modules	497	TRUE	2.3486262652398006e-7	200	8	6	0.75	0.03	REAC:R-HSA-5617833	REAC	Cilium Assembly	10916	361		0.4	0.4084507042253521	200	10716	6	2	194	10714	10916	0.14774907240835156
M1	cpdb	0	network_modules	497	TRUE	2.3683487349199975e-7	79	8	5	0.625	0.06329113924050633	REAC:R-HSA-8852276	REAC	The role of GTSE1 in G2/M progression after G2 checkpoint	10916	2503		0.4142857142857143	0.4225352112676056	79	10837	5	3	74	10834	10916	0.19737389352386736
M1	cpdb	0	network_modules	497	TRUE	2.5256567225445274e-7	80	8	5	0.625	0.0625	REAC:R-HSA-9663891	REAC	Selective autophagy	10916	2186		0.42857142857142855	0.43661971830985913	80	10836	5	3	75	10833	10916	0.19611639086248897
M1	cpdb	0	network_modules	497	TRUE	3.2686767413378e-7	88	8	5	0.625	0.056818181818181816	KEGG:04540	KEGG	Gap junction	8484	318		0	0.1	88	8396	5	3	83	8393	8484	0.18637370561054303
M1	cpdb	0	network_modules	497	TRUE	4.351778993896042e-7	89	8	5	0.625	0.056179775280898875	REAC:R-HSA-442755	REAC	Activation of NMDA receptors and postsynaptic events	10916	89		0.44285714285714284	0.4507042253521127	89	10827	5	3	84	10824	10916	0.18576514102712324
M1	cpdb	0	network_modules	497	TRUE	4.873411666199449e-7	91	8	5	0.625	0.054945054945054944	REAC:R-HSA-390466	REAC	Chaperonin-mediated protein folding	10916	345		0.45714285714285713	0.4647887323943662	91	10825	5	3	86	10822	10916	0.18367482313180392
M1	cpdb	0	network_modules	497	TRUE	7.105205395524622e-7	98	8	5	0.625	0.05102040816326531	REAC:R-HSA-391251	REAC	Protein folding	10916	1812		0.4714285714285714	0.4788732394366197	98	10818	5	3	93	10815	10916	0.17686662979287426
M1	cpdb	0	network_modules	497	TRUE	7.48141571231875e-7	99	8	5	0.625	0.050505050505050504	REAC:R-HSA-6811434	REAC	COPI-dependent Golgi-to-ER retrograde traffic	10916	277		0.4857142857142857	0.49295774647887325	99	10817	5	3	94	10814	10916	0.17595306075661316
M1	cpdb	0	network_modules	497	TRUE	8.706390560869435e-7	102	8	5	0.625	0.049019607843137254	REAC:R-HSA-6807878	REAC	COPI-mediated anterograde transport	10916	279		0.5	0.5070422535211268	102	10814	5	3	97	10811	10916	0.1732928905160806
M1	cpdb	0	network_modules	497	TRUE	1.4634946633498984e-6	113	8	5	0.625	0.04424778761061947	REAC:R-HSA-5610787	REAC	Hedgehog 'off' state	10916	1112		0.5142857142857142	0.5211267605633803	113	10803	5	3	108	10800	10916	0.16445655037632592
M1	cpdb	0	network_modules	497	TRUE	1.5994624380120247e-6	115	8	5	0.625	0.043478260869565216	REAC:R-HSA-9648025	REAC	EML4 and NUDC in mitotic spindle formation	10916	817		0.5285714285714286	0.5352112676056338	115	10801	5	3	110	10798	10916	0.16298671513536214
M1	cpdb	0	network_modules	497	TRUE	1.9016091973414751e-6	119	8	5	0.625	0.04201680672268908	REAC:R-HSA-373760	REAC	L1CAM interactions	10916	1294		0.5428571428571428	0.5492957746478874	119	10797	5	3	114	10794	10916	0.16015813805227447
M1	cpdb	0	network_modules	497	TRUE	2.247644971480216e-6	123	8	5	0.625	0.04065040650406504	REAC:R-HSA-2500257	REAC	Resolution of Sister Chromatid Cohesion	10916	2079		0.5571428571428572	0.5774647887323944	123	10793	5	3	118	10790	10916	0.15746758829247468
M1	cpdb	0	network_modules	497	TRUE	2.247644971480216e-6	123	8	5	0.625	0.04065040650406504	REAC:R-HSA-2132295	REAC	MHC class II antigen presentation	10916	1371		0.5571428571428572	0.5774647887323944	123	10793	5	3	118	10790	10916	0.15746758829247468
M1	cpdb	0	network_modules	497	TRUE	2.2959284254760795e-6	292	8	6	0.75	0.02054794520547945	REAC:R-HSA-1852241	REAC	Organelle biogenesis and maintenance	10916	1646		0.5857142857142857	0.5915492957746479	292	10624	6	2	286	10622	10916	0.12139173159543358
M1	cpdb	0	network_modules	497	TRUE	3.335608512924187e-6	133	8	5	0.625	0.03759398496240601	REAC:R-HSA-8856688	REAC	Golgi-to-ER retrograde transport	10916	1084		0.6	0.6056338028169014	133	10783	5	3	128	10780	10916	0.15127615025298494
M1	cpdb	0	network_modules	497	TRUE	3.464094384585288e-6	134	8	5	0.625	0.03731343283582089	REAC:R-HSA-1632852	REAC	Macroautophagy	10916	1388		0.6142857142857143	0.6197183098591549	134	10782	5	3	129	10779	10916	0.15069508830910336
M1	cpdb	0	network_modules	497	TRUE	3.5964968175755305e-6	135	8	5	0.625	0.037037037037037035	REAC:R-HSA-9609690	REAC	HCMV Early Events	10916	1088		0.6285714285714286	0.6338028169014085	135	10781	5	3	130	10778	10916	0.1501204358422248
M1	cpdb	0	network_modules	497	TRUE	3.7329041046913148e-6	136	8	5	0.625	0.03676470588235294	REAC:R-HSA-5663220	REAC	RHO GTPases Activate Formins	10916	1848		0.6428571428571429	0.647887323943662	136	10780	5	3	131	10777	10916	0.14955207501715928
M1	cpdb	0	network_modules	497	TRUE	4.37799070021566e-6	147	8	5	0.625	0.034013605442176874	KEGG:04145	KEGG	Phagosome	8484	281		0.1111111111111111	0.2	147	8337	5	3	142	8334	8484	0.14307268995775832
M1	cpdb	0	network_modules	497	TRUE	5.524270938267086e-6	147	8	5	0.625	0.034013605442176874	REAC:R-HSA-1169410	REAC	Antiviral mechanism by IFN-stimulated genes	10916	157		0.6571428571428571	0.6619718309859155	147	10769	5	3	142	10766	10916	0.14368448418796795
M1	cpdb	0	network_modules	497	TRUE	5.91321027501709e-6	149	8	5	0.625	0.03355704697986577	REAC:R-HSA-5358351	REAC	Signaling by Hedgehog	10916	2258		0.6714285714285714	0.6901408450704225	149	10767	5	3	144	10764	10916	0.14268739292490298
M1	cpdb	0	network_modules	497	TRUE	5.91321027501709e-6	149	8	5	0.625	0.03355704697986577	REAC:R-HSA-9612973	REAC	Autophagy	10916	193		0.6714285714285714	0.6901408450704225	149	10767	5	3	144	10764	10916	0.14268739292490298
M1	cpdb	0	network_modules	497	TRUE	7.2127030186412905e-6	155	8	5	0.625	0.03225806451612903	REAC:R-HSA-199977	REAC	ER to Golgi Anterograde Transport	10916	823		0.7	0.704225352112676	155	10761	5	3	150	10758	10916	0.13981162660596888
M1	cpdb	0	network_modules	497	TRUE	8.198631352062752e-6	159	8	5	0.625	0.031446540880503145	REAC:R-HSA-9609646	REAC	HCMV Infection	10916	1089		0.7142857142857143	0.7183098591549296	159	10757	5	3	154	10754	10916	0.13798462080887525
M1	cpdb	0	network_modules	497	TRUE	8.569437930233584e-6	363	8	6	0.75	0.01652892561983471	KEGG:05014	KEGG	Amyotrophic lateral sclerosis	8484	413		0.2222222222222222	0.3	363	8121	6	2	357	8119	8484	0.10736004926119713
M1	cpdb	0	network_modules	497	TRUE	1.113855899488687e-5	169	8	5	0.625	0.029585798816568046	REAC:R-HSA-983231	REAC	Factors involved in megakaryocyte development and platelet production	10916	931		0.7285714285714285	0.7323943661971831	169	10747	5	3	164	10744	10916	0.13370129486845597
M1	cpdb	0	network_modules	497	TRUE	1.6525692351574796e-5	406	8	6	0.75	0.014778325123152709	REAC:R-HSA-68886	REAC	M Phase	10916	1343		0.7428571428571429	0.7464788732394366	406	10510	6	2	400	10508	10916	0.10201016954335738
M1	cpdb	0	network_modules	497	TRUE	1.7126284312393535e-5	193	8	5	0.625	0.025906735751295335	KEGG:04814	KEGG	Motor proteins	8484	366		0.3333333333333333	0.4	193	8291	5	3	188	8288	8484	0.12409257909886104
M1	cpdb	0	network_modules	497	TRUE	1.801509085747821e-5	186	8	5	0.625	0.026881720430107527	REAC:R-HSA-948021	REAC	Transport to the Golgi and subsequent modification	10916	2604		0.7571428571428571	0.7605633802816901	186	10730	5	3	181	10727	10916	0.12721994236756454
M1	cpdb	0	network_modules	497	TRUE	1.897362734990111e-5	197	8	5	0.625	0.025380710659898477	KEGG:05130	KEGG	Pathogenic Escherichia coli infection	8484	427		0.4444444444444444	0.5	197	8287	5	3	192	8284	8484	0.12275975626989885
M1	cpdb	0	network_modules	497	TRUE	1.9006920656961004e-5	188	8	5	0.625	0.026595744680851064	REAC:R-HSA-2467813	REAC	Separation of Sister Chromatids	10916	2204		0.7714285714285715	0.7746478873239436	188	10728	5	3	183	10725	10916	0.12651508751135487
M1	cpdb	0	network_modules	497	TRUE	2.34182142252753e-5	196	8	5	0.625	0.025510204081632654	REAC:R-HSA-112314	REAC	Neurotransmitter receptors and postsynaptic signal transmission	10916	1594		0.7857142857142857	0.7887323943661971	196	10720	5	3	191	10717	10916	0.12380300973614365
M1	cpdb	0	network_modules	497	TRUE	2.7232841911407946e-5	202	8	5	0.625	0.024752475247524754	REAC:R-HSA-6811442	REAC	Intra-Golgi and retrograde Golgi-to-ER traffic	10916	1262		0.8	0.8028169014084507	202	10714	5	3	197	10711	10916	0.12187418178031648
M1	cpdb	0	network_modules	497	TRUE	4.987350019163547e-5	228	8	5	0.625	0.021929824561403508	REAC:R-HSA-68882	REAC	Mitotic Anaphase	10916	1479		0.8142857142857143	0.8169014084507042	228	10688	5	3	223	10685	10916	0.11440332723443179
M1	cpdb	0	network_modules	497	TRUE	5.097487512463979e-5	229	8	5	0.625	0.021834061135371178	REAC:R-HSA-2555396	REAC	Mitotic Metaphase and Anaphase	10916	1482		0.8285714285714286	0.8309859154929577	229	10687	5	3	224	10684	10916	0.11414129446211069
M1	cpdb	0	network_modules	497	TRUE	6.090980553133889e-5	249	8	5	0.625	0.020080321285140562	KEGG:05132	KEGG	Salmonella infection	8484	429		0.5555555555555556	0.6	249	8235	5	3	244	8232	8484	0.10842022749491721
M1	cpdb	0	network_modules	497	TRUE	8.296357820540452e-5	265	8	5	0.625	0.018867924528301886	KEGG:05012	KEGG	Parkinson disease	8484	412		0.6666666666666666	0.7	265	8219	5	3	260	8216	8484	0.10486538398314105
M1	cpdb	0	network_modules	497	TRUE	9.270090649240791e-5	271	8	5	0.625	0.01845018450184502	KEGG:05020	KEGG	Prion disease	8484	416		0.7777777777777778	0.8	271	8213	5	3	266	8210	8484	0.10361232989677926
M1	cpdb	0	network_modules	497	TRUE	9.415948252970688e-5	259	8	5	0.625	0.019305019305019305	REAC:R-HSA-112315	REAC	Transmission across Chemical Synapses	10916	2580		0.8428571428571429	0.8450704225352113	259	10657	5	3	254	10654	10916	0.10698935110462372
M1	cpdb	0	network_modules	497	TRUE	1.0162403918022962e-4	263	8	5	0.625	0.019011406844106463	REAC:R-HSA-913531	REAC	Interferon Signaling	10916	1227		0.8571428571428571	0.8591549295774648	263	10653	5	3	258	10650	10916	0.10612784056219139
M1	cpdb	0	network_modules	497	TRUE	1.663684273062279e-4	305	8	5	0.625	0.01639344262295082	KEGG:05016	KEGG	Huntington disease	8484	414		0.8888888888888888	0.9	305	8179	5	3	300	8176	8484	0.09720806505404672
M1	cpdb	0	network_modules	497	TRUE	1.794979706608413e-4	586	9	6	0.6666666666666666	0.010238907849829351	GO:0000226	GO:BP	microtubule cytoskeleton organization	16175	61		NA	1	586	15589	6	3	580	15586	16175	0.07960652140886436
M1	cpdb	0	network_modules	497	TRUE	2.122022734955644e-4	305	8	5	0.625	0.01639344262295082	REAC:R-HSA-446203	REAC	Asparagine N-linked glycosylation	10916	169		0.8714285714285714	0.8732394366197183	305	10611	5	3	300	10608	10916	0.09811273713364069
M1	cpdb	0	network_modules	497	TRUE	2.6100651546610593e-4	318	8	5	0.625	0.015723270440251572	REAC:R-HSA-195258	REAC	RHO GTPase Effectors	10916	1846		0.8857142857142857	0.8873239436619719	318	10598	5	3	313	10595	10916	0.0959535019041124
M1	cpdb	0	network_modules	497	TRUE	5.042024241145133e-4	382	8	5	0.625	0.013089005235602094	KEGG:05010	KEGG	Alzheimer disease	8484	411		1	1	382	8102	5	3	377	8099	8484	0.08592725827155807
M1	cpdb	0	network_modules	497	TRUE	8.114577904423419e-4	400	8	5	0.625	0.0125	REAC:R-HSA-112316	REAC	Neuronal System	10916	1590		0.9	0.9014084507042254	400	10516	5	3	395	10513	10916	0.08480496073704742
M1	cpdb	0	network_modules	497	TRUE	0.0031188954458283083	68	8	3	0.375	0.04411764705882353	REAC:R-HSA-380259	REAC	Loss of Nlp from mitotic centrosomes	10916	1331		0.9142857142857143	0.9295774647887324	68	10848	3	5	65	10843	10916	0.12692961572014927
M1	cpdb	0	network_modules	497	TRUE	0.0031188954458283083	68	8	3	0.375	0.04411764705882353	REAC:R-HSA-380284	REAC	Loss of proteins required for interphase microtubule organization from the centrosome	10916	1335		0.9142857142857143	0.9295774647887324	68	10848	3	5	65	10843	10916	0.12692961572014927
M1	cpdb	0	network_modules	497	TRUE	0.0035532795108500306	71	8	3	0.375	0.04225352112676056	REAC:R-HSA-8854518	REAC	AURKA Activation by TPX2	10916	41		0.9428571428571428	0.9436619718309859	71	10845	3	5	68	10840	10916	0.12414365542677853
M1	cpdb	0	network_modules	497	TRUE	0.005091987713643295	80	8	3	0.375	0.0375	REAC:R-HSA-380287	REAC	Centrosome maturation	10916	341		0.9571428571428572	0.971830985915493	80	10836	3	5	77	10831	10916	0.11673906336323314
M1	cpdb	0	network_modules	497	TRUE	0.005091987713643295	80	8	3	0.375	0.0375	REAC:R-HSA-380270	REAC	Recruitment of mitotic centrosome proteins and complexes	10916	1951		0.9571428571428572	0.971830985915493	80	10836	3	5	77	10831	10916	0.11673906336323314
M1	cpdb	0	network_modules	497	TRUE	0.006110865037061238	85	8	3	0.375	0.03529411764705882	REAC:R-HSA-2565942	REAC	Regulation of PLK1 Activity at G2/M Transition	10916	1998		0.9857142857142858	0.9859154929577465	85	10831	3	5	82	10826	10916	0.11313854154929873
M1	cpdb	0	network_modules	497	TRUE	0.008806432384092086	96	8	3	0.375	0.03125	REAC:R-HSA-5620912	REAC	Anchoring of the basal body to the plasma membrane	10916	147		1	1	96	10820	3	5	93	10815	10916	0.10622131029753365
M1	cpdb	0	network_modules	498	TRUE	3.3195442587167626e-15	12	9	6	0.6666666666666666	0.5	GO:0009304	GO:BP	tRNA transcription	16175	3451		0	0.125	12	16163	6	3	6	16160	16175	0.5770823928646084
M1	cpdb	0	network_modules	498	TRUE	8.720326132883211e-14	6	9	5	0.5555555555555556	0.8333333333333334	GO:0042791	GO:BP	5S class rRNA transcription by RNA polymerase III	16175	10369		0.14285714285714285	0.25	6	16169	5	4	1	16165	16175	0.680274938932812
M1	cpdb	0	network_modules	498	TRUE	2.0988733164076128e-13	27	7	6	0.8571428571428571	0.2222222222222222	REAC:R-HSA-76066	REAC	RNA Polymerase III Transcription Initiation From Type 2 Promoter	10916	1901		0	0.2	27	10889	6	1	21	10888	10916	0.4358553309539923
M1	cpdb	0	network_modules	498	TRUE	2.6710830951203975e-13	28	7	6	0.8571428571428571	0.21428571428571427	REAC:R-HSA-76061	REAC	RNA Polymerase III Transcription Initiation From Type 1 Promoter	10916	1900		0.25	0.4	28	10888	6	1	22	10887	10916	0.4279752148460844
M1	cpdb	0	network_modules	498	TRUE	1.3801132391593785e-12	36	7	6	0.8571428571428571	0.16666666666666666	REAC:R-HSA-76046	REAC	RNA Polymerase III Transcription Initiation	10916	1899		0.5	0.6	36	10880	6	1	30	10879	10916	0.3772535976650024
M1	cpdb	0	network_modules	498	TRUE	2.1270816674448562e-12	30	9	6	0.6666666666666666	0.2	GO:0009303	GO:BP	rRNA transcription	16175	3450		0.2857142857142857	0.375	30	16145	6	3	24	16142	16175	0.3645720948911474
M1	cpdb	0	network_modules	498	TRUE	3.1846732949985173e-12	41	7	6	0.8571428571428571	0.14634146341463414	REAC:R-HSA-749476	REAC	RNA Polymerase III Abortive And Retractive Initiation	10916	1896		0.75	1	41	10875	6	1	35	10874	10916	0.3533942575220425
M1	cpdb	0	network_modules	498	TRUE	3.1846732949985173e-12	41	7	6	0.8571428571428571	0.14634146341463414	REAC:R-HSA-74158	REAC	RNA Polymerase III Transcription	10916	1898		0.75	1	41	10875	6	1	35	10874	10916	0.3533942575220425
M1	cpdb	0	network_modules	498	TRUE	6.7077321037618936e-12	11	9	5	0.5555555555555556	0.45454545454545453	GO:0042797	GO:BP	tRNA transcription by RNA polymerase III	16175	10374		0.42857142857142855	0.5	11	16164	5	4	6	16160	16175	0.5022142574742847
M1	cpdb	0	network_modules	498	TRUE	1.1583088736831326e-10	56	9	6	0.6666666666666666	0.10714285714285714	GO:0006383	GO:BP	transcription by RNA polymerase III	16175	2148		0.5714285714285714	0.625	56	16119	6	3	50	16116	16175	0.26640887103381566
M1	cpdb	0	network_modules	498	TRUE	1.777386877528328e-9	205	9	7	0.7777777777777778	0.03414634146341464	GO:0016072	GO:BP	rRNA metabolic process	16175	5099		0.7142857142857143	0.75	205	15970	7	2	198	15968	16175	0.16138207047296255
M1	cpdb	0	network_modules	498	TRUE	1.8522601393660704e-7	186	9	6	0.6666666666666666	0.03225806451612903	GO:0006399	GO:BP	tRNA metabolic process	16175	2160		0.8571428571428571	0.875	186	15989	6	3	180	15986	16175	0.14499380239121173
M1	cpdb	0	network_modules	498	TRUE	2.5323152098981924e-6	6	9	3	0.3333333333333333	0.5	GO:0006384	GO:BP	transcription initiation at RNA polymerase III promoter	16175	2149		1	1	6	16169	3	6	3	16163	16175	0.4079831549351323
M1	cpdb	0	network_modules	499	TRUE	3.0905373586558114e-9	9	8	4	0.5	0.4444444444444444	GO:1900262	GO:BP	regulation of DNA-directed DNA polymerase activity	16175	20524		0	0.18181818181818182	9	16166	4	4	5	16162	16175	0.4711275072565784
M1	cpdb	0	network_modules	499	TRUE	3.0905373586558114e-9	9	8	4	0.5	0.4444444444444444	GO:1900264	GO:BP	positive regulation of DNA-directed DNA polymerase activity	16175	20525		0	0.18181818181818182	9	16166	4	4	5	16162	16175	0.4711275072565784
M1	cpdb	0	network_modules	499	TRUE	1.004303636156697e-8	23	5	4	0.8	0.17391304347826086	KEGG:03430	KEGG	Mismatch repair	8484	239		0	0.25	23	8461	4	1	19	8460	8484	0.3723525728907259
M1	cpdb	0	network_modules	499	TRUE	2.9102333179848248e-8	14	8	4	0.5	0.2857142857142857	REAC:R-HSA-69091	REAC	Polymerase switching	10916	1769		0	0.04081632653061224	14	10902	4	4	10	10898	10916	0.3773752716964847
M1	cpdb	0	network_modules	499	TRUE	2.9102333179848248e-8	14	8	4	0.5	0.2857142857142857	REAC:R-HSA-69109	REAC	Leading Strand Synthesis	10916	1308		0	0.04081632653061224	14	10902	4	4	10	10898	10916	0.3773752716964847
M1	cpdb	0	network_modules	499	TRUE	5.28822824849497e-8	16	8	4	0.5	0.25	REAC:R-HSA-110312	REAC	Translesion synthesis by REV1	10916	2576		0.041666666666666664	0.061224489795918366	16	10900	4	4	12	10896	10916	0.3529049304966047
M1	cpdb	0	network_modules	499	TRUE	6.672594299529116e-8	36	5	4	0.8	0.1111111111111111	KEGG:03030	KEGG	DNA replication	8484	214		0.3333333333333333	0.5	36	8448	4	1	32	8447	8484	0.2972798378529468
M1	cpdb	0	network_modules	499	TRUE	6.913345870624523e-8	17	8	4	0.5	0.23529411764705882	REAC:R-HSA-5656121	REAC	Translesion synthesis by POLI	10916	2574		0.0625	0.10204081632653061	17	10899	4	4	13	10895	10916	0.34232086255982386
M1	cpdb	0	network_modules	499	TRUE	6.913345870624523e-8	17	8	4	0.5	0.23529411764705882	REAC:R-HSA-5655862	REAC	Translesion synthesis by POLK	10916	2575		0.0625	0.10204081632653061	17	10899	4	4	13	10895	10916	0.34232086255982386
M1	cpdb	0	network_modules	499	TRUE	1.1252269361303738e-7	19	8	4	0.5	0.21052631578947367	REAC:R-HSA-110320	REAC	Translesion Synthesis by POLH	10916	2573		0.10416666666666667	0.12244897959183673	19	10897	4	4	15	10893	10916	0.323713798413934
M1	cpdb	0	network_modules	499	TRUE	1.406120799781323e-7	20	8	4	0.5	0.2	REAC:R-HSA-69186	REAC	Lagging Strand Synthesis	10916	1302		0.125	0.14285714285714285	20	10896	4	4	16	10892	10916	0.31547364741049827
M1	cpdb	0	network_modules	499	TRUE	1.53658542994189e-7	44	5	4	0.8	0.09090909090909091	KEGG:03410	KEGG	Base excision repair	8484	237		0.6666666666666666	0.75	44	8440	4	1	40	8439	8484	0.26870835101807583
M1	cpdb	0	network_modules	499	TRUE	1.7364628533018937e-7	21	8	4	0.5	0.19047619047619047	REAC:R-HSA-5651801	REAC	PCNA-Dependent Long Patch Base Excision Repair	10916	1658		0.14583333333333334	0.16326530612244897	21	10895	4	4	17	10891	10916	0.30782826688871373
M1	cpdb	0	network_modules	499	TRUE	3.665909604025392e-7	25	8	4	0.5	0.16	REAC:R-HSA-5696397	REAC	Gap-filling DNA repair synthesis and ligation in GG-NER	10916	1037		0.16666666666666666	0.20408163265306123	25	10891	4	4	21	10887	10916	0.2819734711054994
M1	cpdb	0	network_modules	499	TRUE	3.665909604025392e-7	25	8	4	0.5	0.16	REAC:R-HSA-110373	REAC	Resolution of AP sites via the multiple-nucleotide patch replacement pathway	10916	2073		0.16666666666666666	0.20408163265306123	25	10891	4	4	21	10887	10916	0.2819734711054994
M1	cpdb	0	network_modules	499	TRUE	4.331166399865942e-7	26	8	4	0.5	0.15384615384615385	REAC:R-HSA-174411	REAC	Polymerase switching on the C-strand of the telomere	10916	1770		0.20833333333333334	0.22448979591836735	26	10890	4	4	22	10886	10916	0.27645953694851905
M1	cpdb	0	network_modules	499	TRUE	5.897443795090574e-7	61	5	4	0.8	0.06557377049180328	KEGG:03420	KEGG	Nucleotide excision repair	8484	238		1	1	61	8423	4	1	57	8422	8484	0.22786842123376383
M1	cpdb	0	network_modules	499	TRUE	7.930182882209276e-7	30	8	4	0.5	0.13333333333333333	REAC:R-HSA-110314	REAC	Recognition of DNA damage by PCNA-containing replication complex	10916	1948		0.22916666666666666	0.24489795918367346	30	10886	4	4	26	10882	10916	0.25722754659259284
M1	cpdb	0	network_modules	499	TRUE	1.039963005308691e-6	32	8	4	0.5	0.125	REAC:R-HSA-69190	REAC	DNA strand elongation	10916	449		0.25	0.2857142857142857	32	10884	4	4	28	10880	10916	0.24899060621447086
M1	cpdb	0	network_modules	499	TRUE	1.039963005308691e-6	32	8	4	0.5	0.125	REAC:R-HSA-5656169	REAC	Termination of translesion DNA synthesis	10916	2492		0.25	0.2857142857142857	32	10884	4	4	28	10880	10916	0.24899060621447086
M1	cpdb	0	network_modules	499	TRUE	1.3404057207369169e-6	34	8	4	0.5	0.11764705882352941	REAC:R-HSA-174417	REAC	Telomere C-strand (Lagging Strand) Synthesis	10916	2486		0.2916666666666667	0.30612244897959184	34	10882	4	4	30	10878	10916	0.24148952118876782
M1	cpdb	0	network_modules	499	TRUE	1.512916641337443e-6	35	8	4	0.5	0.11428571428571428	REAC:R-HSA-9709570	REAC	Impaired BRCA2 binding to RAD51	10916	1173		0.3125	0.32653061224489793	35	10881	4	4	31	10877	10916	0.23798172379846555
M1	cpdb	0	network_modules	499	TRUE	1.7015310980682587e-6	36	8	4	0.5	0.1111111111111111	REAC:R-HSA-73933	REAC	Resolution of Abasic Sites (AP sites)	10916	2075		0.3333333333333333	0.3469387755102041	36	10880	4	4	32	10876	10916	0.23462065562007145
M1	cpdb	0	network_modules	499	TRUE	1.907216676083416e-6	37	8	4	0.5	0.10810810810810811	REAC:R-HSA-5685938	REAC	HDR through Single Strand Annealing (SSA)	10916	1100		0.3541666666666667	0.3877551020408163	37	10879	4	4	33	10875	10916	0.23139634016198032
M1	cpdb	0	network_modules	499	TRUE	1.907216676083416e-6	37	8	4	0.5	0.10810810810810811	REAC:R-HSA-176187	REAC	Activation of ATR in response to replication stress	10916	75		0.3541666666666667	0.3877551020408163	37	10879	4	4	33	10875	10916	0.23139634016198032
M1	cpdb	0	network_modules	499	TRUE	2.373810102047283e-6	39	8	4	0.5	0.10256410256410256	REAC:R-HSA-110313	REAC	Translesion synthesis by Y family DNA polymerases bypasses lesions on DNA template	10916	2577		0.3958333333333333	0.40816326530612246	39	10877	4	4	35	10873	10916	0.2253225782990497
M1	cpdb	0	network_modules	499	TRUE	2.6367915605130942e-6	40	8	4	0.5	0.1	REAC:R-HSA-5693616	REAC	Presynaptic phase of homologous DNA pairing and strand exchange	10916	1793		0.4166666666666667	0.42857142857142855	40	10876	4	4	36	10872	10916	0.22245738842109355
M1	cpdb	0	network_modules	499	TRUE	2.9209912778615046e-6	41	8	4	0.5	0.0975609756097561	REAC:R-HSA-5696400	REAC	Dual Incision in GG-NER	10916	807		0.4375	0.4897959183673469	41	10875	4	4	37	10871	10916	0.21969729172559171
M1	cpdb	0	network_modules	499	TRUE	2.9209912778615046e-6	41	8	4	0.5	0.0975609756097561	REAC:R-HSA-9701190	REAC	Defective homologous recombination repair (HRR) due to BRCA2 loss of function	10916	698		0.4375	0.4897959183673469	41	10875	4	4	37	10871	10916	0.21969729172559171
M1	cpdb	0	network_modules	499	TRUE	2.9209912778615046e-6	41	8	4	0.5	0.0975609756097561	REAC:R-HSA-9675136	REAC	Diseases of DNA Double-Strand Break Repair	10916	757		0.4375	0.4897959183673469	41	10875	4	4	37	10871	10916	0.21969729172559171
M1	cpdb	0	network_modules	499	TRUE	3.0066911530997732e-6	43	8	4	0.5	0.09302325581395349	GO:0090329	GO:BP	regulation of DNA-templated DNA replication	16175	18209		0.2	0.2727272727272727	43	16132	4	4	39	16128	16175	0.21485773636095493
M1	cpdb	0	network_modules	499	TRUE	3.5574961023553357e-6	43	8	4	0.5	0.09302325581395349	REAC:R-HSA-5693579	REAC	Homologous DNA Pairing and Strand Exchange	10916	1129		0.5	0.5102040816326531	43	10873	4	4	39	10869	10916	0.21446773638444458
M1	cpdb	0	network_modules	499	TRUE	5.600847040332312e-6	48	8	4	0.5	0.08333333333333333	REAC:R-HSA-73893	REAC	DNA Damage Bypass	10916	438		0.5208333333333334	0.5306122448979592	48	10868	4	4	44	10864	10916	0.20284964892787405
M1	cpdb	0	network_modules	499	TRUE	6.584030705271513e-6	52	8	4	0.5	0.07692307692307693	GO:2000573	GO:BP	positive regulation of DNA biosynthetic process	16175	25874		0.3	0.36363636363636365	52	16123	4	4	48	16119	16175	0.19521742545385457
M1	cpdb	0	network_modules	499	TRUE	6.625123320617068e-6	50	8	4	0.5	0.08	REAC:R-HSA-9675135	REAC	Diseases of DNA repair	10916	758		0.5416666666666666	0.5510204081632653	50	10866	4	4	46	10862	10916	0.19869606175228122
M1	cpdb	0	network_modules	499	TRUE	7.1868491678794986e-6	51	8	4	0.5	0.0784313725490196	REAC:R-HSA-180786	REAC	Extension of Telomeres	10916	887		0.5625	0.5714285714285714	51	10865	4	4	47	10861	10916	0.1967110900853052
M1	cpdb	0	network_modules	499	TRUE	1.707028066950943e-5	63	8	4	0.5	0.06349206349206349	REAC:R-HSA-6782210	REAC	Gap-filling DNA repair synthesis and ligation in TC-NER	10916	1038		0.5833333333333334	0.5918367346938775	63	10853	4	4	59	10849	10916	0.1766927384483973
M1	cpdb	0	network_modules	499	TRUE	1.820293943572417e-5	64	8	4	0.5	0.0625	REAC:R-HSA-6782135	REAC	Dual incision in TC-NER	10916	808		0.6041666666666666	0.6122448979591837	64	10852	4	4	60	10848	10916	0.17528247281203707
M1	cpdb	0	network_modules	499	TRUE	2.3303918686620833e-5	68	8	4	0.5	0.058823529411764705	REAC:R-HSA-5685942	REAC	HDR through Homologous Recombination (HRR)	10916	1097		0.625	0.6326530612244898	68	10848	4	4	64	10844	10916	0.16995419916323554
M1	cpdb	0	network_modules	499	TRUE	3.0768874613217435e-5	231	8	5	0.625	0.021645021645021644	GO:0006260	GO:BP	DNA replication	16175	2077		0.4	0.45454545454545453	231	15944	5	3	226	15941	16175	0.11450149318708051
M1	cpdb	0	network_modules	499	TRUE	3.862191744253012e-5	77	8	4	0.5	0.05194805194805195	REAC:R-HSA-6781827	REAC	Transcription-Coupled Nucleotide Excision Repair (TC-NER)	10916	2541		0.6458333333333334	0.6530612244897959	77	10839	4	4	73	10835	10916	0.15951276757190314
M1	cpdb	0	network_modules	499	TRUE	4.892132493122334e-5	85	8	4	0.5	0.047058823529411764	GO:2000278	GO:BP	regulation of DNA biosynthetic process	16175	25603		0.5	0.5454545454545454	85	16090	4	4	81	16086	16175	0.15221886250797645
M1	cpdb	0	network_modules	499	TRUE	5.495367892678887e-5	84	8	4	0.5	0.047619047619047616	REAC:R-HSA-5696399	REAC	Global Genome Nucleotide Excision Repair (GG-NER)	10916	1047		0.6666666666666666	0.673469387755102	84	10832	4	4	80	10828	10916	0.15257245073510867
M1	cpdb	0	network_modules	499	TRUE	6.633574914314255e-5	88	8	4	0.5	0.045454545454545456	REAC:R-HSA-73884	REAC	Base Excision Repair	10916	205		0.6875	0.6938775510204082	88	10828	4	4	84	10824	10916	0.14898112688717868
M1	cpdb	0	network_modules	499	TRUE	7.939218495030757e-5	92	8	4	0.5	0.043478260869565216	REAC:R-HSA-6804756	REAC	Regulation of TP53 Activity through Phosphorylation	10916	2016		0.7083333333333334	0.7142857142857143	92	10824	4	4	88	10820	10916	0.14562478317255856
M1	cpdb	0	network_modules	499	TRUE	8.659639884436041e-5	94	8	4	0.5	0.0425531914893617	REAC:R-HSA-69473	REAC	G2/M DNA damage checkpoint	10916	1006		0.7291666666666666	0.7346938775510204	94	10822	4	4	90	10818	10916	0.1440268646153274
M1	cpdb	0	network_modules	499	TRUE	9.83036994847994e-5	97	8	4	0.5	0.041237113402061855	REAC:R-HSA-5693607	REAC	Processing of DNA double-strand break ends	10916	1798		0.75	0.7551020408163265	97	10819	4	4	93	10815	10916	0.1417225012488543
M1	cpdb	0	network_modules	499	TRUE	1.492581809873885e-4	112	8	4	0.5	0.03571428571428571	GO:0006275	GO:BP	regulation of DNA replication	16175	2090		0.6	0.6363636363636364	112	16063	4	4	108	16059	16175	0.13227137028056518
M1	cpdb	0	network_modules	499	TRUE	1.5728130075760708e-4	109	8	4	0.5	0.03669724770642202	REAC:R-HSA-5696398	REAC	Nucleotide Excision Repair	10916	1622		0.7708333333333334	0.7755102040816326	109	10807	4	4	105	10803	10916	0.13346862981980934
M1	cpdb	0	network_modules	499	TRUE	1.6921802592700564e-4	111	8	4	0.5	0.036036036036036036	REAC:R-HSA-157579	REAC	Telomere Maintenance	10916	2489		0.7916666666666666	0.7959183673469388	111	10805	4	4	107	10801	10916	0.13222352711549634
M1	cpdb	0	network_modules	499	TRUE	2.3932791198774377e-4	121	8	4	0.5	0.03305785123966942	REAC:R-HSA-69239	REAC	Synthesis of DNA	10916	2376		0.8125	0.8163265306122449	121	10795	4	4	117	10791	10916	0.1264636240502877
M1	cpdb	0	network_modules	499	TRUE	3.392843808469618e-4	132	8	4	0.5	0.030303030303030304	REAC:R-HSA-5693567	REAC	HDR through Homologous Recombination (HRR) or Single Strand Annealing (SSA)	10916	1098		0.8333333333333334	0.8367346938775511	132	10784	4	4	128	10780	10916	0.12089175595572602
M1	cpdb	0	network_modules	499	TRUE	3.663541959023409e-4	140	8	4	0.5	0.02857142857142857	GO:0071897	GO:BP	DNA biosynthetic process	16175	16970		0.7	0.7272727272727273	140	16035	4	4	136	16031	16175	0.11799464852307968
M1	cpdb	0	network_modules	499	TRUE	4.054032267228392e-4	138	8	4	0.5	0.028985507246376812	REAC:R-HSA-73886	REAC	Chromosome Maintenance	10916	357		0.8541666666666666	0.8775510204081632	138	10778	4	4	134	10774	10916	0.11813414116571719
M1	cpdb	0	network_modules	499	TRUE	4.054032267228392e-4	138	8	4	0.5	0.028985507246376812	REAC:R-HSA-5693538	REAC	Homology Directed Repair	10916	1130		0.8541666666666666	0.8775510204081632	138	10778	4	4	134	10774	10916	0.11813414116571719
M1	cpdb	0	network_modules	499	TRUE	4.4560913536831185e-4	147	8	4	0.5	0.027210884353741496	GO:0006261	GO:BP	DNA-templated DNA replication	16175	2078		0.8	0.8181818181818182	147	16028	4	4	143	16024	16175	0.11507468378598723
M1	cpdb	0	network_modules	499	TRUE	7.322514480415767e-4	160	8	4	0.5	0.025	REAC:R-HSA-5633007	REAC	Regulation of TP53 Activity	10916	2012		0.8958333333333334	0.8979591836734694	160	10756	4	4	156	10752	10916	0.10937019708632899
M1	cpdb	0	network_modules	499	TRUE	7.6946178737206e-4	162	8	4	0.5	0.024691358024691357	REAC:R-HSA-69242	REAC	S Phase	10916	2111		0.9166666666666666	0.9183673469387755	162	10754	4	4	158	10750	10916	0.10866204695981337
M1	cpdb	0	network_modules	499	TRUE	8.686362153356399e-4	167	8	4	0.5	0.023952095808383235	REAC:R-HSA-69481	REAC	G2/M Checkpoints	10916	1005		0.9375	0.9387755102040817	167	10749	4	4	163	10745	10916	0.10694683176228031
M1	cpdb	0	network_modules	499	TRUE	8.895587688211113e-4	168	8	4	0.5	0.023809523809523808	REAC:R-HSA-5693532	REAC	DNA Double-Strand Break Repair	10916	443		0.9583333333333334	0.9591836734693877	168	10748	4	4	164	10744	10916	0.1066128691439802
M1	cpdb	0	network_modules	499	TRUE	0.0013628676728287788	187	8	4	0.5	0.0213903743315508	REAC:R-HSA-69306	REAC	DNA Replication	10916	445		0.9791666666666666	0.9795918367346939	187	10729	4	4	183	10725	10916	0.10077783382736386
M1	cpdb	0	network_modules	499	TRUE	0.0034839391167172094	246	8	4	0.5	0.016260162601626018	GO:0051054	GO:BP	positive regulation of DNA metabolic process	16175	13464		0.9	0.9090909090909091	246	15929	4	4	242	15925	16175	0.08811860463508535
M1	cpdb	0	network_modules	499	TRUE	0.007628837525293127	289	8	4	0.5	0.01384083044982699	REAC:R-HSA-69620	REAC	Cell Cycle Checkpoints	10916	321		1	1	289	10627	4	4	285	10623	10916	0.07987754330802299
M1	cpdb	0	network_modules	499	TRUE	0.007758284950379562	301	8	4	0.5	0.013289036544850499	GO:0051347	GO:BP	positive regulation of transferase activity	16175	13674		1	1	301	15874	4	4	297	15870	16175	0.07924030281041022
M1	cpdb	0	network_modules	500	TRUE	3.39940504783872e-13	8	8	5	0.625	0.625	GO:1905821	GO:BP	positive regulation of chromosome condensation	16175	24931		0	0.041666666666666664	8	16167	5	3	3	16164	16175	0.6248144368157358
M1	cpdb	0	network_modules	500	TRUE	1.5292592121052751e-12	10	8	5	0.625	0.5	GO:0060623	GO:BP	regulation of chromosome condensation	16175	14800		0.043478260869565216	0.08333333333333333	10	16165	5	3	5	16162	16175	0.5587749368667071
M1	cpdb	0	network_modules	500	TRUE	4.93137761741017e-12	11	8	5	0.625	0.45454545454545453	REAC:R-HSA-2514853	REAC	Condensation of Prometaphase Chromosomes	10916	394		0	0.3333333333333333	11	10905	5	3	6	10902	10916	0.5326059480826111
M1	cpdb	0	network_modules	500	TRUE	5.193051123726955e-11	18	8	5	0.625	0.2777777777777778	GO:0007076	GO:BP	mitotic chromosome condensation	16175	2665		0.08695652173913043	0.125	18	16157	5	3	13	16154	16175	0.4162593525105982
M1	cpdb	0	network_modules	500	TRUE	5.947524143599047e-10	28	8	5	0.625	0.17857142857142858	GO:0051984	GO:BP	positive regulation of chromosome segregation	16175	14046		0.13043478260869565	0.16666666666666666	28	16147	5	3	23	16144	16175	0.3335224755523794
M1	cpdb	0	network_modules	500	TRUE	7.185479330991122e-10	29	8	5	0.625	0.1724137931034483	GO:1905820	GO:BP	positive regulation of chromosome separation	16175	24930		0.17391304347826086	0.20833333333333334	29	16146	5	3	24	16143	16175	0.32769928206254667
M1	cpdb	0	network_modules	500	TRUE	1.1744975566378761e-9	98	8	6	0.75	0.061224489795918366	GO:2001252	GO:BP	positive regulation of chromosome organization	16175	26441		0.21739130434782608	0.25	98	16077	6	2	92	16075	16175	0.21325423777890984
M1	cpdb	0	network_modules	500	TRUE	1.9624190300901937e-9	35	8	5	0.625	0.14285714285714285	GO:0030261	GO:BP	chromosome condensation	16175	6749		0.2608695652173913	0.2916666666666667	35	16140	5	3	30	16137	16175	0.2981690760822525
M1	cpdb	0	network_modules	500	TRUE	7.276764421679634e-8	70	8	5	0.625	0.07142857142857142	GO:1905818	GO:BP	regulation of chromosome separation	16175	24928		0.30434782608695654	0.3333333333333333	70	16105	5	3	65	16102	16175	0.21033307274161087
M1	cpdb	0	network_modules	500	TRUE	1.109739994913626e-7	76	8	5	0.625	0.06578947368421052	GO:0051304	GO:BP	chromosome separation	16175	13635		0.34782608695652173	0.375	76	16099	5	3	71	16096	16175	0.20177672668295896
M1	cpdb	0	network_modules	500	TRUE	2.0630132103995416e-7	229	8	6	0.75	0.026200873362445413	GO:0033044	GO:BP	regulation of chromosome organization	16175	7999		0.391304347826087	0.4166666666666667	229	15946	6	2	223	15944	16175	0.13855293227015042
M1	cpdb	0	network_modules	500	TRUE	1.3423769009193824e-6	124	8	5	0.625	0.04032258064516129	GO:0051983	GO:BP	regulation of chromosome segregation	16175	14045		0.43478260869565216	0.4583333333333333	124	16051	5	3	119	16048	16175	0.15744641044768345
M1	cpdb	0	network_modules	500	TRUE	7.927590125152568e-6	420	8	6	0.75	0.014285714285714285	GO:0010638	GO:BP	positive regulation of organelle organization	16175	4284		0.4782608695652174	0.5	420	15755	6	2	414	15753	16175	0.10127439963988305
M1	cpdb	0	network_modules	500	TRUE	8.318835492983443e-6	178	8	5	0.625	0.028089887640449437	GO:0000070	GO:BP	mitotic sister chromatid segregation	16175	24		0.5217391304347826	0.5416666666666666	178	15997	5	3	173	15994	16175	0.13092132186135566
M1	cpdb	0	network_modules	500	TRUE	1.8632430595611444e-5	209	8	5	0.625	0.023923444976076555	GO:0090068	GO:BP	positive regulation of cell cycle process	16175	17994		0.5652173913043478	0.5833333333333334	209	15966	5	3	204	15963	16175	0.12056207489293817
M1	cpdb	0	network_modules	500	TRUE	2.2494229200167033e-5	217	8	5	0.625	0.02304147465437788	GO:0000819	GO:BP	sister chromatid segregation	16175	237		0.6086956521739131	0.625	217	15958	5	3	212	15955	16175	0.11825288590155947
M1	cpdb	0	network_modules	500	TRUE	2.5268255441519824e-5	199	8	5	0.625	0.02512562814070352	REAC:R-HSA-68877	REAC	Mitotic Prometaphase	10916	1484		0.5	0.6666666666666666	199	10717	5	3	194	10714	10916	0.12282784038432532
M1	cpdb	0	network_modules	500	TRUE	3.764505493550919e-5	545	8	6	0.75	0.011009174311926606	GO:0051276	GO:BP	chromosome organization	16175	13613		0.6521739130434783	0.6666666666666666	545	15630	6	2	539	15628	16175	0.08830706066745274
M1	cpdb	0	network_modules	500	TRUE	4.755699525730988e-5	252	8	5	0.625	0.01984126984126984	GO:0140014	GO:BP	mitotic nuclear division	16175	19633		0.6956521739130435	0.7083333333333334	252	15923	5	3	247	15920	16175	0.10946589568454525
M1	cpdb	0	network_modules	500	TRUE	6.0007858228254695e-5	264	8	5	0.625	0.01893939393939394	GO:0045787	GO:BP	positive regulation of cell cycle	16175	11619		0.7391304347826086	0.75	264	15911	5	3	259	15908	16175	0.10685917960832066
M1	cpdb	0	network_modules	500	TRUE	7.629283069297935e-5	277	8	5	0.625	0.018050541516245487	GO:0098813	GO:BP	nuclear chromosome segregation	16175	18900		0.782608695652174	0.7916666666666666	277	15898	5	3	272	15895	16175	0.10422636159153384
M1	cpdb	0	network_modules	500	TRUE	8.932220525671921e-5	630	8	6	0.75	0.009523809523809525	GO:0010564	GO:BP	regulation of cell cycle process	16175	4217		0.8260869565217391	0.8333333333333334	630	15545	6	2	624	15543	16175	0.08175412601854568
M1	cpdb	0	network_modules	500	TRUE	2.8548058624869874e-4	361	8	5	0.625	0.013850415512465374	GO:0007059	GO:BP	chromosome segregation	16175	2658		0.8695652173913043	0.875	361	15814	5	3	356	15811	16175	0.0907586512767164
M1	cpdb	0	network_modules	500	TRUE	3.6356510106829245e-4	379	8	5	0.625	0.013192612137203167	GO:0000280	GO:BP	nuclear division	16175	78		0.9130434782608695	0.9166666666666666	379	15796	5	3	374	15793	16175	0.08846402284270526
M1	cpdb	0	network_modules	500	TRUE	6.343950893944259e-4	424	8	5	0.625	0.01179245283018868	GO:0048285	GO:BP	organelle fission	16175	12627		0.9565217391304348	0.9583333333333334	424	15751	5	3	419	15748	16175	0.08336998450093355
M1	cpdb	0	network_modules	500	TRUE	8.732591146184423e-4	406	8	5	0.625	0.012315270935960592	REAC:R-HSA-68886	REAC	M Phase	10916	1343		1	1	406	10510	5	3	401	10507	10916	0.08412135366597516
M1	cpdb	0	network_modules	500	TRUE	0.0054663799517303225	656	8	5	0.625	0.007621951219512195	GO:1903047	GO:BP	mitotic cell cycle process	16175	22727		1	1	656	15519	5	3	651	15516	16175	0.06590727779086905
M1	cpdb	0	network_modules	506	TRUE	0.006291151474416468	31	5	2	0.4	0.06451612903225806	KEGG:03060	KEGG	Protein export	8484	217		NA	1	31	8453	2	3	29	8450	8484	0.15951503068985615
M1	cpdb	0	network_modules	506	TRUE	0.009161773496589474	19	6	2	0.3333333333333333	0.10526315789473684	REAC:R-HSA-9609523	REAC	Insertion of tail-anchored proteins into the endoplasmic reticulum membrane	10916	1207		NA	1	19	10897	2	4	17	10893	10916	0.18655270573943536
M1	cpdb	0	network_modules	508	TRUE	0.002066278881203097	70	7	3	0.42857142857142855	0.04285714285714286	REAC:R-HSA-9013026	REAC	RHOB GTPase cycle	10916	1860		0	0.5	70	10846	3	4	67	10842	10916	0.1339714095216808
M1	cpdb	0	network_modules	508	TRUE	0.002444221436922124	74	7	3	0.42857142857142855	0.04054054054054054	REAC:R-HSA-9013106	REAC	RHOC GTPase cycle	10916	1865		1	1	74	10842	3	4	71	10838	10916	0.13021117361565246
M1	cpdb	0	network_modules	509	TRUE	3.604212313303805e-8	4	5	3	0.6	0.75	REAC:R-HSA-111957	REAC	Cam-PDE 1 activation	10916	303		0	0.09090909090909091	4	10912	3	2	1	10910	10916	0.6706871909860763
M1	cpdb	0	network_modules	509	TRUE	5.872289793002207e-5	35	5	3	0.6	0.08571428571428572	REAC:R-HSA-111933	REAC	Calmodulin induced events	10916	301		0.1	0.2727272727272727	35	10881	3	2	32	10879	10916	0.22598106544572596
M1	cpdb	0	network_modules	509	TRUE	5.872289793002207e-5	35	5	3	0.6	0.08571428571428572	REAC:R-HSA-111997	REAC	CaM pathway	10916	297		0.1	0.2727272727272727	35	10881	3	2	32	10879	10916	0.22598106544572596
M1	cpdb	0	network_modules	509	TRUE	6.969461151861733e-5	37	5	3	0.6	0.08108108108108109	REAC:R-HSA-111996	REAC	Ca-dependent events	10916	294		0.3	0.36363636363636365	37	10879	3	2	34	10877	10916	0.21974134516370053
M1	cpdb	0	network_modules	509	TRUE	9.556438071872789e-5	41	5	3	0.6	0.07317073170731707	REAC:R-HSA-1489509	REAC	DAG and IP3 signaling	10916	431		0.4	0.45454545454545453	41	10875	3	2	38	10873	10916	0.20865737764291237
M1	cpdb	0	network_modules	509	TRUE	1.649847906220904e-4	49	5	3	0.6	0.061224489795918366	REAC:R-HSA-112043	REAC	PLC beta mediated events	10916	1693		0.5	0.5454545454545454	49	10867	3	2	46	10865	10916	0.19070114220001577
M1	cpdb	0	network_modules	509	TRUE	2.2196387344059737e-4	54	5	3	0.6	0.05555555555555555	REAC:R-HSA-112040	REAC	G-protein mediated events	10916	998		0.6	0.6363636363636364	54	10862	3	2	51	10860	10916	0.1815600184818599
M1	cpdb	0	network_modules	509	TRUE	4.8632383593566264e-4	293	5	4	0.8	0.013651877133105802	REAC:R-HSA-9006925	REAC	Intracellular signaling by second messengers	10916	1266		0.7	0.7272727272727273	293	10623	4	1	289	10622	10916	0.10240648944665326
M1	cpdb	0	network_modules	509	TRUE	4.960892978658017e-4	69	6	3	0.5	0.043478260869565216	KEGG:04924	KEGG	Renin secretion	8484	381		0	0.25	69	8415	3	3	66	8412	8484	0.14568864304302157
M1	cpdb	0	network_modules	509	TRUE	9.31213350161749e-4	85	6	3	0.5	0.03529411764705882	KEGG:04742	KEGG	Taste transduction	8484	361		0.3333333333333333	0.5	85	8399	3	3	82	8396	8484	0.1308837380817367
M1	cpdb	0	network_modules	509	TRUE	0.0010113527616832142	89	5	3	0.6	0.033707865168539325	REAC:R-HSA-111885	REAC	Opioid Signalling	10916	1642		0.8	0.8181818181818182	89	10827	3	2	86	10825	10916	0.14088881152819763
M1	cpdb	0	network_modules	509	TRUE	0.0010695495850991594	89	6	3	0.5	0.033707865168539325	KEGG:05032	KEGG	Morphine addiction	8484	420		0.6666666666666666	0.75	89	8395	3	3	86	8392	8484	0.12781608076995524
M1	cpdb	0	network_modules	509	TRUE	0.00303538238616243	126	6	3	0.5	0.023809523809523808	KEGG:00230	KEGG	Purine metabolism	8484	22		1	1	126	8358	3	3	123	8355	8484	0.10670083773768545
M1	cpdb	0	network_modules	509	TRUE	0.0034342118662853286	15	5	2	0.4	0.13333333333333333	REAC:R-HSA-418457	REAC	cGMP effects	10916	2691		0.9	0.9090909090909091	15	10901	2	3	13	10898	10916	0.23035780537119116
M1	cpdb	0	network_modules	509	TRUE	0.006860869965083985	21	5	2	0.4	0.09523809523809523	REAC:R-HSA-392154	REAC	Nitric oxide stimulates guanylate cyclase	10916	1601		1	1	21	10895	2	3	19	10892	10916	0.1944729578343617
M1	cpdb	0	network_modules	512	TRUE	7.136807575790226e-4	13	3	2	0.6666666666666666	0.15384615384615385	REAC:R-HSA-1483213	REAC	Synthesis of PE	10916	2388		0	0.5	13	10903	2	1	11	10902	10916	0.3199187039314686
M1	cpdb	0	network_modules	512	TRUE	0.00145856676457427	5	7	2	0.2857142857142857	0.4	GO:0006657	GO:BP	CDP-choline pathway	16175	2366		0	0.5	5	16170	2	5	3	16165	16175	0.33782126035976096
M1	cpdb	0	network_modules	512	TRUE	0.0034554356540607207	28	3	2	0.6666666666666666	0.07142857142857142	REAC:R-HSA-1483191	REAC	Synthesis of PC	10916	2387		1	1	28	10888	2	1	26	10887	10916	0.21768752796802934
M1	cpdb	0	network_modules	512	TRUE	0.003494265362984361	98	2	2	1	0.02040816326530612	KEGG:05231	KEGG	Choline metabolism in cancer	8484	479		0	0.5	98	8386	2	0	96	8386	8484	0.1420464076683573
M1	cpdb	0	network_modules	512	TRUE	0.0035663120714995024	99	2	2	1	0.020202020202020204	KEGG:00564	KEGG	Glycerophospholipid metabolism	8484	88		1	1	99	8385	2	0	97	8385	8484	0.14131875410226413
M1	cpdb	0	network_modules	512	TRUE	0.0065567886350286295	10	7	2	0.2857142857142857	0.2	GO:0006646	GO:BP	phosphatidylethanolamine biosynthetic process	16175	2356		1	1	10	16165	2	5	8	16160	16175	0.23865388102180132
M1	cpdb	0	network_modules	513	TRUE	4.947124644019165e-4	16	3	2	0.6666666666666666	0.125	KEGG:00430	KEGG	Taurine and hypotaurine metabolism	8484	56		NA	1	16	8468	2	1	14	8467	8484	0.288181291762653
M1	cpdb	0	network_modules	515	TRUE	2.245482332622215e-4	42	6	3	0.5	0.07142857142857142	REAC:R-HSA-9035034	REAC	RHOF GTPase cycle	10916	1867		NA	1	42	10874	3	3	39	10871	10916	0.18794145989073463
M1	cpdb	0	network_modules	516	TRUE	1.5430149323840482e-6	182	6	5	0.8333333333333334	0.027472527472527472	REAC:R-HSA-6791226	REAC	Major pathway of rRNA processing in the nucleolus and cytosol	10916	1389		0	0.3333333333333333	182	10734	5	1	177	10733	10916	0.14957254017432592
M1	cpdb	0	network_modules	516	TRUE	2.0204406965143273e-6	192	6	5	0.8333333333333334	0.026041666666666668	REAC:R-HSA-8868773	REAC	rRNA processing in the nucleus and cytosol	10916	2734		0.5	0.6666666666666666	192	10724	5	1	187	10723	10916	0.14552978904488523
M1	cpdb	0	network_modules	516	TRUE	2.609139594691586e-6	202	6	5	0.8333333333333334	0.024752475247524754	REAC:R-HSA-72312	REAC	rRNA processing	10916	2732		1	1	202	10714	5	1	197	10713	10916	0.1417886349479296
M1	cpdb	0	network_modules	518	TRUE	5.246585508569544e-5	257	8	5	0.625	0.019455252918287938	GO:0060070	GO:BP	canonical Wnt signaling pathway	16175	14332		0	0.16666666666666666	257	15918	5	3	252	15915	16175	0.10835785417112322
M1	cpdb	0	network_modules	518	TRUE	1.4507512471369346e-4	148	7	4	0.5714285714285714	0.02702702702702703	KEGG:05226	KEGG	Gastric cancer	8484	477		0	0.3333333333333333	148	8336	4	3	144	8333	8484	0.12159510040826552
M1	cpdb	0	network_modules	518	TRUE	1.8367456209683025e-4	157	7	4	0.5714285714285714	0.025477707006369428	KEGG:04390	KEGG	Hippo signaling pathway	8484	310		0.5	0.6666666666666666	157	8327	4	3	153	8324	8484	0.11789604949640874
M1	cpdb	0	network_modules	518	TRUE	2.278589876202412e-4	345	8	5	0.625	0.014492753623188406	GO:0016055	GO:BP	Wnt signaling pathway	16175	5087		0.2	0.3333333333333333	345	15830	5	3	340	15827	16175	0.09294471915549828
M1	cpdb	0	network_modules	518	TRUE	5.053314592223404e-4	58	7	3	0.42857142857142855	0.05172413793103448	KEGG:05213	KEGG	Endometrial cancer	8484	464		1	1	58	8426	3	4	55	8422	8484	0.14707658606256424
M1	cpdb	0	network_modules	518	TRUE	0.0017598217416883986	7	7	2	0.2857142857142857	0.2857142857142857	REAC:R-HSA-9833576	REAC	CDH11 homotypic and heterotypic interactions	10916	271		0	0.13333333333333333	7	10909	2	5	5	10904	10916	0.2852559485614762
M1	cpdb	0	network_modules	518	TRUE	0.0017598217416883986	7	7	2	0.2857142857142857	0.2857142857142857	REAC:R-HSA-9764302	REAC	Regulation of CDH19 Expression and Function	10916	1970		0	0.13333333333333333	7	10909	2	5	5	10904	10916	0.2852559485614762
M1	cpdb	0	network_modules	518	TRUE	0.0019271168205337275	212	8	4	0.5	0.018867924528301886	GO:0060828	GO:BP	regulation of canonical Wnt signaling pathway	16175	14976		0.4	0.5	212	15963	4	4	208	15959	16175	0.0952320696645404
M1	cpdb	0	network_modules	518	TRUE	0.0021389666702867466	5	8	2	0.25	0.4	GO:0071680	GO:BP	response to indole-3-methanol	16175	16853		0.6	0.8333333333333334	5	16170	2	6	3	16164	16175	0.31596373083382445
M1	cpdb	0	network_modules	518	TRUE	0.0021389666702867466	5	8	2	0.25	0.4	GO:0071681	GO:BP	cellular response to indole-3-methanol	16175	16854		0.6	0.8333333333333334	5	16170	2	6	3	16164	16175	0.31596373083382445
M1	cpdb	0	network_modules	518	TRUE	0.0037675917744648623	10	7	2	0.2857142857142857	0.2	REAC:R-HSA-9762292	REAC	Regulation of CDH11 function	10916	1967		0.14285714285714285	0.2	10	10906	2	5	8	10901	10916	0.23846495752727878
M1	cpdb	0	network_modules	518	TRUE	0.005581501627141609	277	8	4	0.5	0.01444043321299639	GO:0030111	GO:BP	regulation of Wnt signaling pathway	16175	6681		1	1	277	15898	4	4	273	15894	16175	0.0827938313185446
M1	cpdb	0	network_modules	518	TRUE	0.007609601569052462	14	7	2	0.2857142857142857	0.14285714285714285	REAC:R-HSA-4839735	REAC	Signaling by AXIN mutants	10916	2222		0.21428571428571427	0.6	14	10902	2	5	12	10897	10916	0.20131728516787525
M1	cpdb	0	network_modules	518	TRUE	0.007609601569052462	14	7	2	0.2857142857142857	0.14285714285714285	REAC:R-HSA-5467337	REAC	APC truncation mutants have impaired AXIN binding	10916	22		0.21428571428571427	0.6	14	10902	2	5	12	10897	10916	0.20131728516787525
M1	cpdb	0	network_modules	518	TRUE	0.007609601569052462	14	7	2	0.2857142857142857	0.14285714285714285	REAC:R-HSA-4839744	REAC	Signaling by APC mutants	10916	2221		0.21428571428571427	0.6	14	10902	2	5	12	10897	10916	0.20131728516787525
M1	cpdb	0	network_modules	518	TRUE	0.007609601569052462	14	7	2	0.2857142857142857	0.14285714285714285	REAC:R-HSA-4839748	REAC	Signaling by AMER1 mutants	10916	2220		0.21428571428571427	0.6	14	10902	2	5	12	10897	10916	0.20131728516787525
M1	cpdb	0	network_modules	518	TRUE	0.007609601569052462	14	7	2	0.2857142857142857	0.14285714285714285	REAC:R-HSA-5467340	REAC	AXIN missense mutants destabilize the destruction complex	10916	42		0.21428571428571427	0.6	14	10902	2	5	12	10897	10916	0.20131728516787525
M1	cpdb	0	network_modules	518	TRUE	0.007609601569052462	14	7	2	0.2857142857142857	0.14285714285714285	REAC:R-HSA-5467348	REAC	Truncations of AMER1 destabilize the destruction complex	10916	2609		0.21428571428571427	0.6	14	10902	2	5	12	10897	10916	0.20131728516787525
M1	cpdb	0	network_modules	518	TRUE	0.008777626855691513	15	7	2	0.2857142857142857	0.13333333333333333	REAC:R-HSA-5358747	REAC	CTNNB1 S33 mutants aren't phosphorylated	10916	289		0.6428571428571429	1	15	10901	2	5	13	10896	10916	0.19443725182357552
M1	cpdb	0	network_modules	518	TRUE	0.008777626855691513	15	7	2	0.2857142857142857	0.13333333333333333	REAC:R-HSA-5358751	REAC	CTNNB1 S45 mutants aren't phosphorylated	10916	291		0.6428571428571429	1	15	10901	2	5	13	10896	10916	0.19443725182357552
M1	cpdb	0	network_modules	518	TRUE	0.008777626855691513	15	7	2	0.2857142857142857	0.13333333333333333	REAC:R-HSA-4839743	REAC	Signaling by CTNNB1 phospho-site mutants	10916	2228		0.6428571428571429	1	15	10901	2	5	13	10896	10916	0.19443725182357552
M1	cpdb	0	network_modules	518	TRUE	0.008777626855691513	15	7	2	0.2857142857142857	0.13333333333333333	REAC:R-HSA-5339716	REAC	Signaling by GSK3beta mutants	10916	2257		0.6428571428571429	1	15	10901	2	5	13	10896	10916	0.19443725182357552
M1	cpdb	0	network_modules	518	TRUE	0.008777626855691513	15	7	2	0.2857142857142857	0.13333333333333333	REAC:R-HSA-5358749	REAC	CTNNB1 S37 mutants aren't phosphorylated	10916	290		0.6428571428571429	1	15	10901	2	5	13	10896	10916	0.19443725182357552
M1	cpdb	0	network_modules	518	TRUE	0.008777626855691513	15	7	2	0.2857142857142857	0.13333333333333333	REAC:R-HSA-5358752	REAC	CTNNB1 T41 mutants aren't phosphorylated	10916	292		0.6428571428571429	1	15	10901	2	5	13	10896	10916	0.19443725182357552
M1	cpdb	0	network_modules	519	TRUE	8.378640115638952e-5	253	8	5	0.625	0.019762845849802372	REAC:R-HSA-1257604	REAC	PIP3 activates AKT signaling	10916	1679		0	0.16666666666666666	253	10663	5	3	248	10660	10916	0.10831903458977794
M1	cpdb	0	network_modules	519	TRUE	1.4950485425934372e-4	317	8	5	0.625	0.015772870662460567	GO:0001558	GO:BP	regulation of cell growth	16175	348		0	0.07142857142857142	317	15858	5	3	312	15855	16175	0.09715484717053385
M1	cpdb	0	network_modules	519	TRUE	1.6416496226391792e-4	26	8	3	0.375	0.11538461538461539	REAC:R-HSA-5674400	REAC	Constitutive Signaling by AKT1 E17K in Cancer	10916	400		0.2	0.3333333333333333	26	10890	3	5	23	10885	10916	0.2070138377279273
M1	cpdb	0	network_modules	519	TRUE	1.738680673833798e-4	293	8	5	0.625	0.017064846416382253	REAC:R-HSA-9006925	REAC	Intracellular signaling by second messengers	10916	1266		0.4	0.5	293	10623	5	3	288	10620	10916	0.1002293592882339
M1	cpdb	0	network_modules	519	TRUE	2.738791768604332e-4	358	8	5	0.625	0.013966480446927373	GO:0016049	GO:BP	cell growth	16175	5081		0.07692307692307693	0.14285714285714285	358	15817	5	3	353	15814	16175	0.09115753266505369
M1	cpdb	0	network_modules	519	TRUE	3.9594191966469604e-4	155	8	4	0.5	0.025806451612903226	KEGG:04150	KEGG	mTOR signaling pathway	8484	284		0	0.3333333333333333	155	8329	4	4	151	8325	8484	0.11050753130758119
M1	cpdb	0	network_modules	519	TRUE	4.49273348859028e-4	36	8	3	0.375	0.08333333333333333	REAC:R-HSA-6804757	REAC	Regulation of TP53 Degradation	10916	2017		0.6	0.6666666666666666	36	10880	3	5	33	10875	10916	0.17557604392815196
M1	cpdb	0	network_modules	519	TRUE	4.88746831110464e-4	37	8	3	0.375	0.08108108108108109	REAC:R-HSA-6806003	REAC	Regulation of TP53 Expression and Degradation	10916	2019		0.8	0.8333333333333334	37	10879	3	5	34	10874	10916	0.17315241724166633
M1	cpdb	0	network_modules	519	TRUE	5.077080476807134e-4	165	8	4	0.5	0.024242424242424242	KEGG:04140	KEGG	Autophagy - animal	8484	277		0.5	0.6666666666666666	165	8319	4	4	161	8315	8484	0.10690861336807186
M1	cpdb	0	network_modules	519	TRUE	5.242313444352674e-4	408	8	5	0.625	0.012254901960784314	GO:0040008	GO:BP	regulation of growth	16175	9896		0.15384615384615385	0.21428571428571427	408	15767	5	3	403	15764	16175	0.08508616532362107
M1	cpdb	0	network_modules	519	TRUE	5.951342039273008e-4	158	8	4	0.5	0.02531645569620253	GO:0031929	GO:BP	TOR signaling	16175	7288		0.23076923076923078	0.2857142857142857	158	16017	4	4	154	16013	16175	0.11088095212185321
M1	cpdb	0	network_modules	519	TRUE	6.42007539213897e-4	3	8	2	0.25	0.6666666666666666	GO:1905857	GO:BP	positive regulation of pentose-phosphate shunt	16175	24967		0.3076923076923077	0.35714285714285715	3	16172	2	6	1	16166	16175	0.4080841830381798
M1	cpdb	0	network_modules	519	TRUE	0.0012745859670920128	47	8	3	0.375	0.06382978723404255	GO:0043470	GO:BP	regulation of carbohydrate catabolic process	16175	10718		0.38461538461538464	0.42857142857142855	47	16128	3	5	44	16123	16175	0.15377593373002132
M1	cpdb	0	network_modules	519	TRUE	0.0013114297409079156	491	8	5	0.625	0.010183299389002037	GO:0061919	GO:BP	process utilizing autophagic mechanism	16175	15723		0.46153846153846156	0.5714285714285714	491	15684	5	3	486	15681	16175	0.07710149813085575
M1	cpdb	0	network_modules	519	TRUE	0.0013114297409079156	491	8	5	0.625	0.010183299389002037	GO:0006914	GO:BP	autophagy	16175	2563		0.46153846153846156	0.5714285714285714	491	15684	5	3	486	15681	16175	0.07710149813085575
M1	cpdb	0	network_modules	519	TRUE	0.0016128999486984877	512	8	5	0.625	0.009765625	GO:0040007	GO:BP	growth	16175	9895		0.6153846153846154	0.6428571428571429	512	15663	5	3	507	15660	16175	0.07538939954393224
M1	cpdb	0	network_modules	519	TRUE	0.0024192573723068296	58	8	3	0.375	0.05172413793103448	GO:0034248	GO:BP	regulation of amide metabolic process	16175	8522		0.6923076923076923	0.7142857142857143	58	16117	3	5	55	16112	16175	0.13822194201041574
M1	cpdb	0	network_modules	519	TRUE	0.0024613906100276676	246	8	4	0.5	0.016260162601626018	KEGG:05131	KEGG	Shigellosis	8484	428		1	1	246	8238	4	4	242	8234	8484	0.08623757817950196
M1	cpdb	0	network_modules	519	TRUE	0.004489608271498064	7	8	2	0.25	0.2857142857142857	GO:0043456	GO:BP	regulation of pentose-phosphate shunt	16175	10707		0.7692307692307693	0.7857142857142857	7	16168	2	6	5	16162	16175	0.26692236123232677
M1	cpdb	0	network_modules	519	TRUE	0.005488844811517904	76	8	3	0.375	0.039473684210526314	GO:0010507	GO:BP	negative regulation of autophagy	16175	4182		0.8461538461538461	0.8571428571428571	76	16099	3	5	73	16094	16175	0.1204546751774371
M1	cpdb	0	network_modules	519	TRUE	0.006694501058002431	290	8	4	0.5	0.013793103448275862	GO:0009895	GO:BP	negative regulation of catabolic process	16175	3755		0.9230769230769231	0.9285714285714286	290	15885	4	4	286	15881	16175	0.08081519947585977
M1	cpdb	0	network_modules	519	TRUE	0.00769266439847492	9	8	2	0.25	0.2222222222222222	GO:1902031	GO:BP	regulation of NADP metabolic process	16175	21955		1	1	9	16166	2	6	7	16160	16175	0.2353013195399492
M1	cpdb	0	network_modules	519	TRUE	0.007750840702182365	92	8	3	0.375	0.03260869565217391	REAC:R-HSA-2219528	REAC	PI3K/AKT Signaling in Cancer	10916	1674		1	1	92	10824	3	5	89	10819	10916	0.10859440362746796
M1	cpdb	0	network_modules	521	TRUE	0.0018278707879155983	57	8	3	0.375	0.05263157894736842	REAC:R-HSA-112382	REAC	Formation of RNA Pol II elongation complex 	10916	949		0	0.6666666666666666	57	10859	3	5	54	10854	10916	0.13894567767456634
M1	cpdb	0	network_modules	521	TRUE	0.0018278707879155983	57	8	3	0.375	0.05263157894736842	REAC:R-HSA-75955	REAC	RNA Polymerase II Transcription Elongation	10916	1891		0	0.6666666666666666	57	10859	3	5	54	10854	10916	0.13894567767456634
M1	cpdb	0	network_modules	521	TRUE	0.005091987713643295	80	8	3	0.375	0.0375	REAC:R-HSA-674695	REAC	RNA Polymerase II Pre-transcription Events	10916	1888		1	1	80	10836	3	5	77	10831	10916	0.11673906336323314
M1	cpdb	0	network_modules	522	TRUE	1.5292592121052751e-12	10	8	5	0.625	0.5	GO:0006086	GO:BP	acetyl-CoA biosynthetic process from pyruvate	16175	1951		0	0.03333333333333333	10	16165	5	3	5	16162	16175	0.5587749368667071
M1	cpdb	0	network_modules	522	TRUE	3.751117211123516e-11	17	8	5	0.625	0.29411764705882354	GO:0006085	GO:BP	acetyl-CoA biosynthetic process	16175	1950		0.034482758620689655	0.06666666666666667	17	16158	5	3	12	16155	16175	0.42835652907993893
M1	cpdb	0	network_modules	522	TRUE	4.657051363996935e-11	16	8	5	0.625	0.3125	REAC:R-HSA-204174	REAC	Regulation of pyruvate dehydrogenase (PDH) complex	10916	2047		0	0.3333333333333333	16	10900	5	3	11	10897	10916	0.4413905566749614
M1	cpdb	0	network_modules	522	TRUE	4.657051363996935e-11	16	8	5	0.625	0.3125	REAC:R-HSA-9861718	REAC	Regulation of pyruvate metabolism	10916	2048		0	0.3333333333333333	16	10900	5	3	11	10897	10916	0.4413905566749614
M1	cpdb	0	network_modules	522	TRUE	5.947524143599047e-10	28	8	5	0.625	0.17857142857142858	GO:0006084	GO:BP	acetyl-CoA metabolic process	16175	1949		0.06896551724137931	0.1	28	16147	5	3	23	16144	16175	0.3335224755523794
M1	cpdb	0	network_modules	522	TRUE	6.053240101117629e-10	88	8	6	0.75	0.06818181818181818	GO:0006637	GO:BP	acyl-CoA metabolic process	16175	2348		0.10344827586206896	0.16666666666666666	88	16087	6	2	82	16085	16175	0.2251620059556133
M1	cpdb	0	network_modules	522	TRUE	6.053240101117629e-10	88	8	6	0.75	0.06818181818181818	GO:0035383	GO:BP	thioester metabolic process	16175	9012		0.10344827586206896	0.16666666666666666	88	16087	6	2	82	16085	16175	0.2251620059556133
M1	cpdb	0	network_modules	522	TRUE	1.5144903584741962e-9	30	8	5	0.625	0.16666666666666666	REAC:R-HSA-70268	REAC	Pyruvate metabolism	10916	1832		0.4	0.5	30	10886	5	3	25	10883	10916	0.321889850816173
M1	cpdb	0	network_modules	522	TRUE	5.136765125968327e-9	42	8	5	0.625	0.11904761904761904	GO:0035384	GO:BP	thioester biosynthetic process	16175	9013		0.1724137931034483	0.23333333333333334	42	16133	5	3	37	16130	16175	0.2720597584921804
M1	cpdb	0	network_modules	522	TRUE	5.136765125968327e-9	42	8	5	0.625	0.11904761904761904	GO:0071616	GO:BP	acyl-CoA biosynthetic process	16175	16800		0.1724137931034483	0.23333333333333334	42	16133	5	3	37	16130	16175	0.2720597584921804
M1	cpdb	0	network_modules	522	TRUE	1.0199565374928757e-8	43	8	5	0.625	0.11627906976744186	REAC:R-HSA-5362517	REAC	Signaling by Retinoic Acid	10916	2303		0.6	0.6666666666666666	43	10873	5	3	38	10870	10916	0.2685104374549108
M1	cpdb	0	network_modules	522	TRUE	1.185849584254533e-8	143	8	6	0.75	0.04195804195804196	GO:0043604	GO:BP	amide biosynthetic process	16175	10796		0.2413793103448276	0.26666666666666666	143	16032	6	2	137	16030	16175	0.1761262930505257
M1	cpdb	0	network_modules	522	TRUE	3.457336802142211e-8	389	8	7	0.875	0.017994858611825194	GO:0043603	GO:BP	amide metabolic process	16175	10795		0.27586206896551724	0.3	389	15786	7	1	382	15785	16175	0.1235571927568347
M1	cpdb	0	network_modules	522	TRUE	3.175749491254349e-7	4	8	3	0.375	0.75	GO:0010510	GO:BP	regulation of acetyl-CoA biosynthetic process from pyruvate	16175	4185		0.3103448275862069	0.36666666666666664	4	16171	3	5	1	16166	16175	0.5301770270640893
M1	cpdb	0	network_modules	522	TRUE	3.175749491254349e-7	4	8	3	0.375	0.75	GO:0050812	GO:BP	regulation of acyl-CoA biosynthetic process	16175	13276		0.3103448275862069	0.36666666666666664	4	16171	3	5	1	16166	16175	0.5301770270640893
M1	cpdb	0	network_modules	522	TRUE	3.6601972944629146e-7	96	8	5	0.625	0.052083333333333336	GO:0006090	GO:BP	pyruvate metabolic process	16175	1953		0.3793103448275862	0.4	96	16079	5	3	91	16076	16175	0.17928568752272825
M1	cpdb	0	network_modules	522	TRUE	8.39592911937016e-7	289	8	6	0.75	0.020761245674740483	GO:0006790	GO:BP	sulfur compound metabolic process	16175	2476		0.41379310344827586	0.43333333333333335	289	15886	6	2	283	15884	16175	0.12294427181596725
M1	cpdb	0	network_modules	522	TRUE	4.565167829770378e-6	158	8	5	0.625	0.03164556962025317	GO:0044272	GO:BP	sulfur compound biosynthetic process	16175	10944		0.4482758620689655	0.4666666666666667	158	16017	5	3	153	16014	16175	0.1391535323692045
M1	cpdb	0	network_modules	522	TRUE	9.513999379922102e-6	10	8	3	0.375	0.3	GO:0042762	GO:BP	regulation of sulfur metabolic process	16175	10354		0.4827586206896552	0.5	10	16165	3	5	7	16160	16175	0.3350436514203556
M1	cpdb	0	network_modules	522	TRUE	1.03059726704801e-5	58	8	4	0.5	0.06896551724137931	GO:0034248	GO:BP	regulation of amide metabolic process	16175	8522		0.5172413793103449	0.5333333333333333	58	16117	4	4	54	16113	16175	0.1847407392060312
M1	cpdb	0	network_modules	522	TRUE	1.4048759673637964e-5	177	8	5	0.625	0.02824858757062147	REAC:R-HSA-1428517	REAC	Aerobic respiration and respiratory electron transport	10916	127		0.8	0.8333333333333334	177	10739	5	3	172	10736	10916	0.13053637159682632
M1	cpdb	0	network_modules	522	TRUE	1.5346443151758953e-5	469	8	6	0.75	0.01279317697228145	GO:0072521	GO:BP	purine-containing compound metabolic process	16175	17423		0.5517241379310345	0.5666666666666667	469	15706	6	2	463	15704	16175	0.09558580531163766
M1	cpdb	0	network_modules	522	TRUE	2.3597880406018086e-5	504	8	6	0.75	0.011904761904761904	GO:0032787	GO:BP	monocarboxylic acid metabolic process	16175	7822		0.5862068965517241	0.6	504	15671	6	2	498	15669	16175	0.092033017435951
M1	cpdb	0	network_modules	522	TRUE	2.4096779989319804e-5	220	8	5	0.625	0.022727272727272728	GO:0072522	GO:BP	purine-containing compound biosynthetic process	16175	17424		0.6206896551724138	0.6333333333333333	220	15955	5	3	215	15952	16175	0.11741926974687227
M1	cpdb	0	network_modules	522	TRUE	2.8769810254718776e-5	521	8	6	0.75	0.011516314779270634	GO:0006753	GO:BP	nucleoside phosphate metabolic process	16175	2450		0.6551724137931034	0.6666666666666666	521	15654	6	2	515	15652	16175	0.09043578637859823
M1	cpdb	0	network_modules	522	TRUE	4.3330970974556306e-5	558	8	6	0.75	0.010752688172043012	GO:0055086	GO:BP	nucleobase-containing small molecule metabolic process	16175	14237		0.6896551724137931	0.7	558	15617	6	2	552	15615	16175	0.08721068634254052
M1	cpdb	0	network_modules	522	TRUE	5.55995400859836e-5	260	8	5	0.625	0.019230769230769232	GO:1901293	GO:BP	nucleoside phosphate biosynthetic process	16175	21368		0.7241379310344828	0.7333333333333333	260	15915	5	3	255	15912	16175	0.10770824554430725
M1	cpdb	0	network_modules	522	TRUE	1.6520440062933774e-4	290	8	5	0.625	0.017241379310344827	REAC:R-HSA-9006931	REAC	Signaling by Nuclear Receptors	10916	2289		1	1	290	10626	5	3	285	10623	10916	0.10077851219442396
M1	cpdb	0	network_modules	522	TRUE	2.363540630396038e-4	742	8	6	0.75	0.008086253369272238	GO:0019752	GO:BP	carboxylic acid metabolic process	16175	6036		0.7586206896551724	0.7666666666666667	742	15433	6	2	736	15431	16175	0.07486835132709616
M1	cpdb	0	network_modules	522	TRUE	2.746362045754451e-4	761	8	6	0.75	0.00788436268068331	GO:0043436	GO:BP	oxoacid metabolic process	16175	10693		0.7931034482758621	0.8	761	15414	6	2	755	15412	16175	0.07384996304796554
M1	cpdb	0	network_modules	522	TRUE	2.877409915735683e-4	767	8	6	0.75	0.007822685788787484	GO:0006082	GO:BP	organic acid metabolic process	16175	1947		0.8275862068965517	0.8333333333333334	767	15408	6	2	761	15406	16175	0.07353603960800775
M1	cpdb	0	network_modules	522	TRUE	0.0016128999486984877	512	8	5	0.625	0.009765625	GO:0090407	GO:BP	organophosphate biosynthetic process	16175	18274		0.8620689655172413	0.8666666666666667	512	15663	5	3	507	15660	16175	0.07538939954393224
M1	cpdb	0	network_modules	522	TRUE	0.003262104929172285	64	8	3	0.375	0.046875	GO:0010906	GO:BP	regulation of glucose metabolic process	16175	4492		0.896551724137931	0.9	64	16111	3	5	61	16106	16175	0.1314764273654694
M1	cpdb	0	network_modules	522	TRUE	0.003318056193448289	243	8	4	0.5	0.01646090534979424	GO:0019216	GO:BP	regulation of lipid metabolic process	16175	5593		0.9310344827586207	0.9333333333333333	243	15932	4	4	239	15928	16175	0.08868644693557384
M1	cpdb	0	network_modules	522	TRUE	0.0044677065492195345	71	8	3	0.375	0.04225352112676056	GO:0019217	GO:BP	regulation of fatty acid metabolic process	16175	5594		0.9655172413793104	0.9666666666666667	71	16104	3	5	68	16099	16175	0.12470855284693111
M1	cpdb	0	network_modules	522	TRUE	0.009763081598088549	319	8	4	0.5	0.012539184952978056	GO:0006631	GO:BP	fatty acid metabolic process	16175	2343		1	1	319	15856	4	4	315	15852	16175	0.07683786414475337
M1	cpdb	0	network_modules	526	TRUE	0.0015820227308202092	510	8	5	0.625	0.00980392156862745	GO:0007169	GO:BP	cell surface receptor protein tyrosine kinase signaling pathway	16175	2733		NA	1	510	15665	5	3	505	15662	16175	0.0755479952635344
M1	cpdb	0	network_modules	528	TRUE	1.0579350443913191e-10	57	8	6	0.75	0.10526315789473684	REAC:R-HSA-112382	REAC	Formation of RNA Pol II elongation complex 	10916	949		0	0.4	57	10859	6	2	51	10857	10916	0.2798534273489965
M1	cpdb	0	network_modules	528	TRUE	1.0579350443913191e-10	57	8	6	0.75	0.10526315789473684	REAC:R-HSA-75955	REAC	RNA Polymerase II Transcription Elongation	10916	1891		0	0.4	57	10859	6	2	51	10857	10916	0.2798534273489965
M1	cpdb	0	network_modules	528	TRUE	8.728920552019301e-10	80	8	6	0.75	0.075	REAC:R-HSA-674695	REAC	RNA Polymerase II Pre-transcription Events	10916	1888		0.5	0.6	80	10836	6	2	74	10834	10916	0.23580505461211687
M1	cpdb	0	network_modules	528	TRUE	5.236399641598147e-7	103	8	5	0.625	0.04854368932038835	GO:0006368	GO:BP	transcription elongation by RNA polymerase II	16175	2143		0	0.125	103	16072	5	3	98	16069	16175	0.17300293644399287
M1	cpdb	0	network_modules	528	TRUE	1.0441309074109896e-6	118	8	5	0.625	0.0423728813559322	GO:0006354	GO:BP	DNA-templated transcription elongation	16175	2131		0.14285714285714285	0.25	118	16057	5	3	113	16054	16175	0.16146646092787573
M1	cpdb	0	network_modules	528	TRUE	1.2176433088059256e-5	58	8	4	0.5	0.06896551724137931	REAC:R-HSA-8866654	REAC	E3 ubiquitin ligases ubiquitinate target proteins	10916	811		0.75	0.8	58	10858	4	4	54	10854	10916	0.1842796052391344
M1	cpdb	0	network_modules	528	TRUE	1.7434241936720227e-5	12	8	3	0.375	0.25	GO:0001711	GO:BP	endodermal cell fate commitment	16175	403		0.2857142857142857	0.375	12	16163	3	5	9	16158	16175	0.30576951144755105
M1	cpdb	0	network_modules	528	TRUE	4.069759425372258e-5	78	8	4	0.5	0.05128205128205128	REAC:R-HSA-8852135	REAC	Protein ubiquitination	10916	1818		1	1	78	10838	4	4	74	10834	10916	0.15846480839115118
M1	cpdb	0	network_modules	528	TRUE	9.017354873803988e-5	20	8	3	0.375	0.15	GO:0060795	GO:BP	cell fate commitment involved in formation of primary germ layer	16175	14961		0.42857142857142855	0.5	20	16155	3	5	17	16150	16175	0.23659360431701468
M1	cpdb	0	network_modules	528	TRUE	9.709703498116285e-4	43	8	3	0.375	0.06976744186046512	GO:0035987	GO:BP	endodermal cell differentiation	16175	9378		0.5714285714285714	0.625	43	16132	3	5	40	16127	16175	0.1608561842812973
M1	cpdb	0	network_modules	528	TRUE	0.001539591972084174	50	8	3	0.375	0.06	GO:0001706	GO:BP	endoderm formation	16175	398		0.7142857142857143	0.75	50	16125	3	5	47	16120	16175	0.14903084573643377
M1	cpdb	0	network_modules	528	TRUE	0.002294656437842883	57	8	3	0.375	0.05263157894736842	GO:0007492	GO:BP	endoderm development	16175	2978		0.8571428571428571	0.875	57	16118	3	5	54	16113	16175	0.13944802611099033
M1	cpdb	0	network_modules	528	TRUE	0.006408880426447946	80	8	3	0.375	0.0375	GO:0001704	GO:BP	formation of primary germ layer	16175	396		1	1	80	16095	3	5	77	16090	16175	0.11734086762643543
M1	cpdb	0	network_modules	530	TRUE	1.3970281272052574e-7	43	5	4	0.8	0.09302325581395349	KEGG:04975	KEGG	Fat digestion and absorption	8484	406		0	0.3333333333333333	43	8441	4	1	39	8440	8484	0.27183911489512935
M1	cpdb	0	network_modules	530	TRUE	1.801610741362213e-7	6	5	3	0.6	0.5	REAC:R-HSA-192456	REAC	Digestion of dietary lipid	10916	744		0	0.25	6	10910	3	2	3	10908	10916	0.5474966517046818
M1	cpdb	0	network_modules	530	TRUE	1.3841905265093007e-5	22	5	3	0.6	0.13636363636363635	REAC:R-HSA-8935690	REAC	Digestion	10916	741		0.3333333333333333	0.5	22	10894	3	2	19	10892	10916	0.28543106118269873
M1	cpdb	0	network_modules	530	TRUE	2.3356587594460882e-5	26	5	3	0.6	0.11538461538461539	REAC:R-HSA-8963743	REAC	Digestion and absorption	10916	742		0.6666666666666666	0.75	26	10890	3	2	23	10888	10916	0.2624456836468055
M1	cpdb	0	network_modules	530	TRUE	1.893054568522725e-4	63	5	3	0.6	0.047619047619047616	KEGG:00561	KEGG	Glycerolipid metabolism	8484	85		0.5	0.6666666666666666	63	8421	3	2	60	8419	8484	0.1676115788172982
M1	cpdb	0	network_modules	530	TRUE	0.0037402810708043552	24	5	2	0.4	0.08333333333333333	KEGG:04977	KEGG	Vitamin digestion and absorption	8484	408		1	1	24	8460	2	3	22	8457	8484	0.18159347175089363
M1	cpdb	0	network_modules	530	TRUE	0.00972634897893087	189	5	3	0.6	0.015873015873015872	REAC:R-HSA-196854	REAC	Metabolism of vitamins and cofactors	10916	1440		1	1	189	10727	3	2	186	10725	10916	0.09562705183841101
M1	cpdb	0	network_modules	537	TRUE	3.780196814467657e-9	56	6	5	0.8333333333333334	0.08928571428571429	REAC:R-HSA-72187	REAC	mRNA 3'-end processing	10916	2701		0	0.1	56	10860	5	1	51	10859	10916	0.27186592692354583
M1	cpdb	0	network_modules	537	TRUE	8.168575562879179e-9	65	6	5	0.8333333333333334	0.07692307692307693	REAC:R-HSA-73856	REAC	RNA Polymerase II Transcription Termination	10916	1895		0.1111111111111111	0.2	65	10851	5	1	60	10850	10916	0.2521968108820532
M1	cpdb	0	network_modules	537	TRUE	1.2870047271324471e-8	71	6	5	0.8333333333333334	0.07042253521126761	REAC:R-HSA-159236	REAC	Transport of Mature mRNA derived from an Intron-Containing Transcript	10916	2586		0.2222222222222222	0.3	71	10845	5	1	66	10844	10916	0.2412118211480849
M1	cpdb	0	network_modules	537	TRUE	2.311501878940644e-8	69	7	5	0.7142857142857143	0.07246376811594203	GO:0006406	GO:BP	mRNA export from nucleus	16175	2167		0	0.05	69	16106	5	2	64	16104	16175	0.22668212238389138
M1	cpdb	0	network_modules	537	TRUE	2.3746893486357884e-8	80	6	5	0.8333333333333334	0.0625	REAC:R-HSA-72202	REAC	Transport of Mature Transcript to Cytoplasm	10916	2584		0.3333333333333333	0.4	80	10836	5	1	75	10835	10916	0.2271066091009079
M1	cpdb	0	network_modules	537	TRUE	3.797096809741983e-8	76	7	5	0.7142857142857143	0.06578947368421052	GO:0051028	GO:BP	mRNA transport	16175	13445		0.05263157894736842	0.1	76	16099	5	2	71	16097	16175	0.21590595830544534
M1	cpdb	0	network_modules	537	TRUE	5.292526519199558e-8	276	6	6	1	0.021739130434782608	REAC:R-HSA-72203	REAC	Processing of Capped Intron-Containing Pre-mRNA	10916	1796		0.4444444444444444	0.5	276	10640	6	0	270	10640	10916	0.14560608431567057
M1	cpdb	0	network_modules	537	TRUE	9.01972858560798e-8	90	7	5	0.7142857142857143	0.05555555555555555	GO:0006405	GO:BP	RNA export from nucleus	16175	2166		0.10526315789473684	0.15	90	16085	5	2	85	16083	16175	0.19824809545140454
M1	cpdb	0	network_modules	537	TRUE	3.0053701359307763e-7	114	7	5	0.7142857142857143	0.043859649122807015	GO:0050657	GO:BP	nucleic acid transport	16175	13197		0.15789473684210525	0.25	114	16061	5	2	109	16059	16175	0.1759105584840256
M1	cpdb	0	network_modules	537	TRUE	3.0053701359307763e-7	114	7	5	0.7142857142857143	0.043859649122807015	GO:0050658	GO:BP	RNA transport	16175	13198		0.15789473684210525	0.25	114	16061	5	2	109	16059	16175	0.1759105584840256
M1	cpdb	0	network_modules	537	TRUE	3.4290272040346895e-7	117	7	5	0.7142857142857143	0.042735042735042736	GO:0051236	GO:BP	establishment of RNA localization	16175	13586		0.2631578947368421	0.3	117	16058	5	2	112	16056	16175	0.17361132788859263
M1	cpdb	0	network_modules	537	TRUE	1.1665152402862548e-6	149	7	5	0.7142857142857143	0.03355704697986577	GO:0006403	GO:BP	RNA localization	16175	2164		0.3157894736842105	0.35	149	16026	5	2	144	16024	16175	0.15356566895670357
M1	cpdb	0	network_modules	537	TRUE	1.2901159356505573e-6	152	7	5	0.7142857142857143	0.03289473684210526	GO:0051168	GO:BP	nuclear export	16175	13551		0.3684210526315789	0.4	152	16023	5	2	147	16021	16175	0.15201689994817907
M1	cpdb	0	network_modules	537	TRUE	1.3342203570738828e-6	108	4	4	1	0.037037037037037035	KEGG:03013	KEGG	Nucleocytoplasmic transport	8484	209		0	0.5	108	8376	4	0	104	8376	8484	0.19126633060818274
M1	cpdb	0	network_modules	537	TRUE	2.13800522084931e-6	168	7	5	0.7142857142857143	0.02976190476190476	GO:0015931	GO:BP	nucleobase-containing compound transport	16175	5016		0.42105263157894735	0.45	168	16007	5	2	163	16005	16175	0.14446614653729586
M1	cpdb	0	network_modules	537	TRUE	9.184272774913655e-6	174	4	4	1	0.022988505747126436	KEGG:03040	KEGG	Spliceosome	8484	215		1	1	174	8310	4	0	170	8310	8484	0.15009214259482498
M1	cpdb	0	network_modules	537	TRUE	1.9579714301797866e-5	261	7	5	0.7142857142857143	0.019157088122605363	GO:0006913	GO:BP	nucleocytoplasmic transport	16175	2562		0.47368421052631576	0.55	261	15914	5	2	256	15912	16175	0.11529322446573442
M1	cpdb	0	network_modules	537	TRUE	1.9579714301797866e-5	261	7	5	0.7142857142857143	0.019157088122605363	GO:0051169	GO:BP	nuclear transport	16175	13552		0.47368421052631576	0.55	261	15914	5	2	256	15912	16175	0.11529322446573442
M1	cpdb	0	network_modules	537	TRUE	3.671601726131787e-5	18	7	3	0.42857142857142855	0.16666666666666666	GO:0031053	GO:BP	primary miRNA processing	16175	7015		0.5789473684210527	0.6	18	16157	3	4	15	16153	16175	0.2667734487500034
M1	cpdb	0	network_modules	537	TRUE	4.4273932388627695e-4	40	7	3	0.42857142857142855	0.075	GO:0035196	GO:BP	miRNA processing	16175	8885		0.631578947368421	0.65	40	16135	3	4	37	16131	16175	0.17850922312755857
M1	cpdb	0	network_modules	537	TRUE	8.753204739511672e-4	4	7	2	0.2857142857142857	0.5	GO:0006408	GO:BP	snRNA export from nucleus	16175	2168		0.6842105263157895	0.75	4	16171	2	5	2	16166	16175	0.37776578586754944
M1	cpdb	0	network_modules	537	TRUE	8.753204739511672e-4	4	7	2	0.2857142857142857	0.5	GO:0031442	GO:BP	positive regulation of mRNA 3'-end processing	16175	7168		0.6842105263157895	0.75	4	16171	2	5	2	16166	16175	0.37776578586754944
M1	cpdb	0	network_modules	537	TRUE	0.001208774237140841	73	6	3	0.5	0.0410958904109589	REAC:R-HSA-6807505	REAC	RNA polymerase II transcribes snRNA genes	10916	1904		0.5555555555555556	0.6	73	10843	3	3	70	10840	10916	0.14194261390111396
M1	cpdb	0	network_modules	537	TRUE	0.00145856676457427	5	7	2	0.2857142857142857	0.4	GO:0051030	GO:BP	snRNA transport	16175	13447		0.7894736842105263	0.8	5	16170	2	5	3	16165	16175	0.33782126035976096
M1	cpdb	0	network_modules	537	TRUE	0.001948299981104326	65	7	3	0.42857142857142855	0.046153846153846156	GO:0070918	GO:BP	regulatory ncRNA processing	16175	16370		0.8421052631578947	0.85	65	16110	3	4	62	16106	16175	0.13963442575655335
M1	cpdb	0	network_modules	537	TRUE	0.0024163037408110387	10	6	2	0.3333333333333333	0.2	REAC:R-HSA-111367	REAC	SLBP independent Processing of Histone Pre-mRNAs	10916	2144		0.6666666666666666	0.7	10	10906	2	4	8	10902	10916	0.2576781409088113
M1	cpdb	0	network_modules	537	TRUE	0.0029525383240401573	11	6	2	0.3333333333333333	0.18181818181818182	REAC:R-HSA-77588	REAC	SLBP Dependent Processing of Replication-Dependent Histone Pre-mRNAs	10916	2143		0.7777777777777778	0.8	11	10905	2	4	9	10901	10916	0.24563002182252458
M1	cpdb	0	network_modules	537	TRUE	0.0030617276505831527	7	7	2	0.2857142857142857	0.2857142857142857	GO:0002191	GO:BP	cap-dependent translational initiation	16175	735		0.8947368421052632	0.9	7	16168	2	5	5	16163	16175	0.2854050328691595
M1	cpdb	0	network_modules	537	TRUE	0.005246512395443979	9	7	2	0.2857142857142857	0.2222222222222222	GO:0031440	GO:BP	regulation of mRNA 3'-end processing	16175	7166		0.9473684210526315	0.95	9	16166	2	5	7	16161	16175	0.25161004852258095
M1	cpdb	0	network_modules	537	TRUE	0.006336358936943704	96	7	3	0.42857142857142855	0.03125	GO:0032784	GO:BP	regulation of DNA-templated transcription elongation	16175	7819		1	1	96	16079	3	4	93	16075	16175	0.11448981809974512
M1	cpdb	0	network_modules	537	TRUE	0.008199380901080522	18	6	2	0.3333333333333333	0.1111111111111111	REAC:R-HSA-8851708	REAC	Signaling by FGFR2 IIIa TM	10916	2245		0.8888888888888888	0.9	18	10898	2	4	16	10894	10916	0.19170883997736607
M1	cpdb	0	network_modules	537	TRUE	0.009161773496589474	19	6	2	0.3333333333333333	0.10526315789473684	REAC:R-HSA-77595	REAC	Processing of Intronless Pre-mRNAs	10916	1799		1	1	19	10897	2	4	17	10893	10916	0.18655270573943536
M1	cpdb	0	network_modules	538	TRUE	6.700424401537237e-10	35	7	5	0.7142857142857143	0.14285714285714285	GO:0000184	GO:BP	nuclear-transcribed mRNA catabolic process, nonsense-mediated decay	16175	57		0	0.09090909090909091	35	16140	5	2	30	16138	16175	0.3188847145068542
M1	cpdb	0	network_modules	538	TRUE	8.189775368412373e-9	96	5	5	1	0.052083333333333336	KEGG:03015	KEGG	mRNA surveillance pathway	8484	210		0	0.5	96	8388	5	0	91	8388	8484	0.22698976692146755
M1	cpdb	0	network_modules	538	TRUE	1.4935320922738883e-8	108	5	5	1	0.046296296296296294	KEGG:03013	KEGG	Nucleocytoplasmic transport	8484	209		1	1	108	8376	5	0	103	8376	8484	0.21385486826241545
M1	cpdb	0	network_modules	538	TRUE	2.8738534787519064e-7	113	7	5	0.7142857142857143	0.04424778761061947	GO:0000956	GO:BP	nuclear-transcribed mRNA catabolic process	16175	264		0.1	0.18181818181818182	113	16062	5	2	108	16060	16175	0.17669715385387966
M1	cpdb	0	network_modules	538	TRUE	2.0182385733674353e-6	116	4	4	1	0.034482758620689655	REAC:R-HSA-927802	REAC	Nonsense-Mediated Decay (NMD)	10916	1608		0	0.2	116	10800	4	0	112	10800	10916	0.18473989827090934
M1	cpdb	0	network_modules	538	TRUE	2.0182385733674353e-6	116	4	4	1	0.034482758620689655	REAC:R-HSA-975957	REAC	Nonsense Mediated Decay (NMD) enhanced by the Exon Junction Complex (EJC)	10916	1606		0	0.2	116	10800	4	0	112	10800	10916	0.18473989827090934
M1	cpdb	0	network_modules	538	TRUE	9.508727512484215e-6	226	7	5	0.7142857142857143	0.022123893805309734	GO:0006402	GO:BP	mRNA catabolic process	16175	2163		0.2	0.2727272727272727	226	15949	5	2	221	15947	16175	0.1241471432798393
M1	cpdb	0	network_modules	538	TRUE	9.693361201017164e-6	171	4	4	1	0.023391812865497075	REAC:R-HSA-9010553	REAC	Regulation of expression of SLITs and ROBOs	10916	2031		0.2222222222222222	0.3	171	10745	4	0	167	10745	10916	0.15176896475235646
M1	cpdb	0	network_modules	538	TRUE	1.417166597264143e-5	590	7	6	0.8571428571428571	0.010169491525423728	GO:0016071	GO:BP	mRNA metabolic process	16175	5098		0.3	0.36363636363636365	590	15585	6	1	584	15584	16175	0.09108620786467056
M1	cpdb	0	network_modules	538	TRUE	2.5327894946823958e-5	217	4	4	1	0.018433179723502304	REAC:R-HSA-376176	REAC	Signaling by ROBO receptors	10916	2301		0.3333333333333333	0.4	217	10699	4	0	213	10699	10916	0.13443722638925845
M1	cpdb	0	network_modules	538	TRUE	2.734600281708799e-5	279	7	5	0.7142857142857143	0.017921146953405017	GO:0006401	GO:BP	RNA catabolic process	16175	2162		0.4	0.45454545454545453	279	15896	5	2	274	15894	16175	0.11139735610021442
M1	cpdb	0	network_modules	538	TRUE	3.8669872476709286e-5	299	7	5	0.7142857142857143	0.016722408026755852	GO:0141188	GO:BP	nucleic acid catabolic process	16175	20075		0.5	0.5454545454545454	299	15876	5	2	294	15874	16175	0.10748396832894344
M1	cpdb	0	network_modules	538	TRUE	8.495661871643829e-5	56	4	3	0.75	0.05357142857142857	REAC:R-HSA-72187	REAC	mRNA 3'-end processing	10916	2701		0.4444444444444444	0.5	56	10860	3	1	53	10859	10916	0.19962404520820204
M1	cpdb	0	network_modules	538	TRUE	1.3378792981294337e-4	65	4	3	0.75	0.046153846153846156	REAC:R-HSA-73856	REAC	RNA Polymerase II Transcription Termination	10916	1895		0.5555555555555556	0.6	65	10851	3	1	62	10850	10916	0.18516088253497198
M1	cpdb	0	network_modules	538	TRUE	1.749881529930586e-4	71	4	3	0.75	0.04225352112676056	REAC:R-HSA-159236	REAC	Transport of Mature mRNA derived from an Intron-Containing Transcript	10916	2586		0.6666666666666666	0.7	71	10845	3	1	68	10844	10916	0.17708260529646086
M1	cpdb	0	network_modules	538	TRUE	2.5138819522440995e-4	80	4	3	0.75	0.0375	REAC:R-HSA-72202	REAC	Transport of Mature Transcript to Cytoplasm	10916	2584		0.7777777777777778	0.8	80	10836	3	1	77	10835	10916	0.1667087896212419
M1	cpdb	0	network_modules	538	TRUE	2.9072557925810874e-4	448	7	5	0.7142857142857143	0.011160714285714286	GO:0034655	GO:BP	nucleobase-containing compound catabolic process	16175	8711		0.6	0.6363636363636364	448	15727	5	2	443	15725	16175	0.08705622461774262
M1	cpdb	0	network_modules	538	TRUE	0.002335240992542277	69	7	3	0.42857142857142855	0.043478260869565216	GO:0006406	GO:BP	mRNA export from nucleus	16175	2167		0.7	0.7272727272727273	69	16106	3	4	66	16102	16175	0.13546450546779418
M1	cpdb	0	network_modules	538	TRUE	0.003129248318921616	76	7	3	0.42857142857142855	0.039473684210526314	GO:0051028	GO:BP	mRNA transport	16175	13445		0.8	0.8181818181818182	76	16099	3	4	73	16095	16175	0.1289717169753835
M1	cpdb	0	network_modules	538	TRUE	0.00410614606372029	202	4	3	0.75	0.01485148514851485	REAC:R-HSA-72163	REAC	mRNA Splicing - Major Pathway	10916	2707		0.8888888888888888	0.9	202	10714	3	1	199	10713	10916	0.10392050098562043
M1	cpdb	0	network_modules	538	TRUE	0.0045480482137003585	209	4	3	0.75	0.014354066985645933	REAC:R-HSA-72172	REAC	mRNA Splicing	10916	2706		1	1	209	10707	3	1	206	10706	10916	0.10210918377031558
M1	cpdb	0	network_modules	538	TRUE	0.005215756465839129	90	7	3	0.42857142857142855	0.03333333333333333	GO:0006405	GO:BP	RNA export from nucleus	16175	2166		0.9	0.9090909090909091	90	16085	3	4	87	16081	16175	0.11832628240569532
M1	cpdb	0	network_modules	538	TRUE	0.009612658981152065	12	7	2	0.2857142857142857	0.16666666666666666	GO:2000622	GO:BP	regulation of nuclear-transcribed mRNA catabolic process, nonsense-mediated decay	16175	25904		1	1	12	16163	2	5	10	16158	16175	0.2177791757308338
M1	cpdb	0	network_modules	539	TRUE	1.1681368892883443e-4	26	7	3	0.42857142857142855	0.11538461538461539	GO:0048026	GO:BP	positive regulation of mRNA splicing, via spliceosome	16175	12477		0	0.1111111111111111	26	16149	3	4	23	16145	16175	0.22176700751010106
M1	cpdb	0	network_modules	539	TRUE	1.6407673443469856e-4	29	7	3	0.42857142857142855	0.10344827586206896	GO:0050685	GO:BP	positive regulation of mRNA processing	16175	13216		0.125	0.2222222222222222	29	16146	3	4	26	16142	16175	0.20991151240631
M1	cpdb	0	network_modules	539	TRUE	3.781717468386327e-4	38	7	3	0.42857142857142855	0.07894736842105263	GO:0033120	GO:BP	positive regulation of RNA splicing	16175	8044		0.25	0.3333333333333333	38	16137	3	4	35	16133	16175	0.18318839193808537
M1	cpdb	0	network_modules	539	TRUE	4.0960996117903064e-4	39	7	3	0.42857142857142855	0.07692307692307693	GO:0000387	GO:BP	spliceosomal snRNP assembly	16175	114		0.375	0.4444444444444444	39	16136	3	4	36	16132	16175	0.18080394523610888
M1	cpdb	0	network_modules	539	TRUE	7.902144444479114e-4	51	7	3	0.42857142857142855	0.058823529411764705	REAC:R-HSA-194441	REAC	Metabolism of non-coding RNA	10916	1431		0	1	51	10865	3	4	48	10861	10916	0.15746459185360706
M1	cpdb	0	network_modules	539	TRUE	7.902144444479114e-4	51	7	3	0.42857142857142855	0.058823529411764705	REAC:R-HSA-191859	REAC	snRNP Assembly	10916	2736		0	1	51	10865	3	4	48	10861	10916	0.15746459185360706
M1	cpdb	0	network_modules	539	TRUE	0.0029614929514672956	287	7	4	0.5714285714285714	0.013937282229965157	GO:0000398	GO:BP	mRNA splicing, via spliceosome	16175	121		0.5	0.6666666666666666	287	15888	4	3	283	15885	16175	0.08726748564470001
M1	cpdb	0	network_modules	539	TRUE	0.0029614929514672956	287	7	4	0.5714285714285714	0.013937282229965157	GO:0000377	GO:BP	RNA splicing, via transesterification reactions with bulged adenosine as nucleophile	16175	109		0.5	0.6666666666666666	287	15888	4	3	283	15885	16175	0.08726748564470001
M1	cpdb	0	network_modules	539	TRUE	0.003129101750524031	291	7	4	0.5714285714285714	0.013745704467353952	GO:0000375	GO:BP	RNA splicing, via transesterification reactions	16175	107		0.75	0.7777777777777778	291	15884	4	3	287	15881	16175	0.08663783258044509
M1	cpdb	0	network_modules	539	TRUE	0.006661810885653246	352	7	4	0.5714285714285714	0.011363636363636364	GO:0006397	GO:BP	mRNA processing	16175	2158		0.875	0.8888888888888888	352	15823	4	3	348	15820	16175	0.07838785057476214
M1	cpdb	0	network_modules	539	TRUE	0.006742553771060284	98	7	3	0.42857142857142855	0.030612244897959183	GO:0048024	GO:BP	regulation of mRNA splicing, via spliceosome	16175	12475		1	1	98	16077	3	4	95	16073	16175	0.11328942664150835
M1	cpdb	0	network_modules	540	TRUE	1.6136274129416946e-4	3	6	2	0.3333333333333333	0.6666666666666666	REAC:R-HSA-177539	REAC	Autointegration results in viral DNA circles	10916	192		0	0.2857142857142857	3	10913	2	4	1	10909	10916	0.47121011381117145
M1	cpdb	0	network_modules	540	TRUE	1.6136274129416946e-4	3	6	2	0.3333333333333333	0.6666666666666666	REAC:R-HSA-175567	REAC	Integration of viral DNA into host genomic DNA	10916	1215		0	0.2857142857142857	3	10913	2	4	1	10909	10916	0.47121011381117145
M1	cpdb	0	network_modules	540	TRUE	3.2264662661123924e-4	4	6	2	0.3333333333333333	0.5	REAC:R-HSA-180689	REAC	APOBEC3G mediated resistance to HIV-1 infection	10916	31		0.3333333333333333	0.42857142857142855	4	10912	2	4	2	10908	10916	0.40798637869251825
M1	cpdb	0	network_modules	540	TRUE	0.0011284355467893483	7	6	2	0.3333333333333333	0.2857142857142857	REAC:R-HSA-164843	REAC	2-LTR circle formation	10916	1		0.5	0.5714285714285714	7	10909	2	4	5	10905	10916	0.30819652589076213
M1	cpdb	0	network_modules	540	TRUE	0.001933515543395235	9	6	2	0.3333333333333333	0.2222222222222222	REAC:R-HSA-162592	REAC	Integration of provirus	10916	1214		0.6666666666666666	0.7142857142857143	9	10907	2	4	7	10903	10916	0.2716790073116455
M1	cpdb	0	network_modules	540	TRUE	0.004881527570650452	14	6	2	0.3333333333333333	0.14285714285714285	REAC:R-HSA-162594	REAC	Early Phase of HIV Life Cycle	10916	831		0.8333333333333334	0.8571428571428571	14	10902	2	4	12	10898	10916	0.2175776176442625
M1	cpdb	0	network_modules	540	TRUE	0.006434032448418521	16	6	2	0.3333333333333333	0.125	REAC:R-HSA-2995383	REAC	Initiation of Nuclear Envelope (NE) Reformation	10916	1201		1	1	16	10900	2	4	14	10896	10916	0.20343158583831095
M1	cpdb	0	network_modules	541	TRUE	1.1878753365781343e-9	39	7	5	0.7142857142857143	0.1282051282051282	GO:0000387	GO:BP	spliceosomal snRNP assembly	16175	114		0	0.1	39	16136	5	2	34	16134	16175	0.30202187668740876
M1	cpdb	0	network_modules	541	TRUE	1.1795475233120952e-6	390	7	6	0.8571428571428571	0.015384615384615385	GO:0022613	GO:BP	ribonucleoprotein complex biogenesis	16175	6620		0.1111111111111111	0.2	390	15785	6	1	384	15784	16175	0.11299833002531624
M1	cpdb	0	network_modules	541	TRUE	2.8614681734093576e-6	178	7	5	0.7142857142857143	0.028089887640449437	GO:0022618	GO:BP	protein-RNA complex assembly	16175	6625		0.2222222222222222	0.3	178	15997	5	2	173	15995	16175	0.1402700067758608
M1	cpdb	0	network_modules	541	TRUE	3.4856519951954414e-6	51	7	4	0.5714285714285714	0.0784313725490196	REAC:R-HSA-194441	REAC	Metabolism of non-coding RNA	10916	1431		0	0.6	51	10865	4	3	47	10862	10916	0.21053129200716747
M1	cpdb	0	network_modules	541	TRUE	3.4856519951954414e-6	51	7	4	0.5714285714285714	0.0784313725490196	REAC:R-HSA-9754678	REAC	SARS-CoV-2 modulates host translation machinery	10916	2125		0	0.6	51	10865	4	3	47	10862	10916	0.21053129200716747
M1	cpdb	0	network_modules	541	TRUE	3.4856519951954414e-6	51	7	4	0.5714285714285714	0.0784313725490196	REAC:R-HSA-191859	REAC	snRNP Assembly	10916	2736		0	0.6	51	10865	4	3	47	10862	10916	0.21053129200716747
M1	cpdb	0	network_modules	541	TRUE	3.768304318897827e-6	188	7	5	0.7142857142857143	0.026595744680851064	GO:0071826	GO:BP	protein-RNA complex organization	16175	16929		0.3333333333333333	0.4	188	15987	5	2	183	15985	16175	0.13641110700833647
M1	cpdb	0	network_modules	541	TRUE	3.150342024028351e-5	287	7	5	0.7142857142857143	0.017421602787456445	GO:0000398	GO:BP	mRNA splicing, via spliceosome	16175	121		0.4444444444444444	0.6	287	15888	5	2	282	15886	16175	0.10978350198361664
M1	cpdb	0	network_modules	541	TRUE	3.150342024028351e-5	287	7	5	0.7142857142857143	0.017421602787456445	GO:0000377	GO:BP	RNA splicing, via transesterification reactions with bulged adenosine as nucleophile	16175	109		0.4444444444444444	0.6	287	15888	5	2	282	15886	16175	0.10978350198361664
M1	cpdb	0	network_modules	541	TRUE	3.376305338392192e-5	291	7	5	0.7142857142857143	0.01718213058419244	GO:0000375	GO:BP	RNA splicing, via transesterification reactions	16175	107		0.6666666666666666	0.7	291	15884	5	2	286	15882	16175	0.10900137952184112
M1	cpdb	0	network_modules	541	TRUE	8.740301472837331e-5	352	7	5	0.7142857142857143	0.014204545454545454	GO:0006397	GO:BP	mRNA processing	16175	2158		0.7777777777777778	0.8	352	15823	5	2	347	15821	16175	0.09876068113981737
M1	cpdb	0	network_modules	541	TRUE	1.5926602000661749e-4	397	7	5	0.7142857142857143	0.012594458438287154	GO:0008380	GO:BP	RNA splicing	16175	3186		0.8888888888888888	0.9	397	15778	5	2	392	15776	16175	0.0927535180168076
M1	cpdb	0	network_modules	541	TRUE	8.218733483171686e-4	197	7	4	0.5714285714285714	0.02030456852791878	REAC:R-HSA-9705683	REAC	SARS-CoV-2-host interactions	10916	2128		0.75	0.8	197	10719	4	3	193	10716	10916	0.10530150917223018
M1	cpdb	0	network_modules	541	TRUE	0.001140711622665018	590	7	5	0.7142857142857143	0.00847457627118644	GO:0016071	GO:BP	mRNA metabolic process	16175	5098		1	1	590	15585	5	2	585	15583	16175	0.07523042426360463
M1	cpdb	0	network_modules	541	TRUE	0.003922781218889589	292	7	4	0.5714285714285714	0.0136986301369863	REAC:R-HSA-9694516	REAC	SARS-CoV-2 Infection	10916	2122		1	1	292	10624	4	3	288	10621	10916	0.08551161884302425
M1	cpdb	0	network_modules	542	TRUE	6.794832974376056e-4	46	7	3	0.42857142857142855	0.06521739130434782	GO:0030490	GO:BP	maturation of SSU-rRNA	16175	6815		0	0.5	46	16129	3	4	43	16125	16175	0.16634672734727224
M1	cpdb	0	network_modules	542	TRUE	0.005946718759638413	94	7	3	0.42857142857142855	0.031914893617021274	GO:0042274	GO:BP	ribosomal small subunit biogenesis	16175	10071		1	1	94	16081	3	4	91	16077	16175	0.11572803696769736
M1	cpdb	0	network_modules	543	TRUE	0.007993505642808704	177	5	3	0.6	0.01694915254237288	REAC:R-HSA-1428517	REAC	Aerobic respiration and respiratory electron transport	10916	127		NA	1	177	10739	3	2	174	10737	10916	0.0989465894167921
M1	cpdb	0	network_modules	544	TRUE	8.267138850878091e-5	48	5	3	0.6	0.0625	KEGG:00280	KEGG	Valine, leucine and isoleucine degradation	8484	31		NA	1	48	8436	3	2	45	8434	8484	0.19242481355420207
M1	cpdb	0	network_modules	544	TRUE	6.878505125691542e-4	7	5	2	0.4	0.2857142857142857	REAC:R-HSA-3371599	REAC	Defective HLCS causes multiple carboxylase deficiency	10916	567		0	0.2	7	10909	2	3	5	10906	10916	0.33770535962789805
M1	cpdb	0	network_modules	544	TRUE	9.169659126549938e-4	8	5	2	0.4	0.25	REAC:R-HSA-3323169	REAC	Defects in biotin (Btn) metabolism	10916	713		0.25	0.4	8	10908	2	3	6	10905	10916	0.31583645181620407
M1	cpdb	0	network_modules	544	TRUE	9.394741790157856e-4	5	6	2	0.3333333333333333	0.4	GO:0006552	GO:BP	L-leucine catabolic process	16175	2272		0	0.25	5	16170	2	4	3	16166	16175	0.36493383771979027
M1	cpdb	0	network_modules	544	TRUE	0.0018001927016410263	11	5	2	0.4	0.18181818181818182	REAC:R-HSA-196780	REAC	Biotin transport and metabolism	10916	251		0.5	0.6	11	10905	2	3	9	10902	10916	0.2691978540546046
M1	cpdb	0	network_modules	544	TRUE	0.00197224517358476	7	6	2	0.3333333333333333	0.2857142857142857	GO:0006551	GO:BP	L-leucine metabolic process	16175	2271		0.3333333333333333	0.75	7	16168	2	4	5	16164	16175	0.3083299398805696
M1	cpdb	0	network_modules	544	TRUE	0.00197224517358476	7	6	2	0.3333333333333333	0.2857142857142857	GO:0009080	GO:BP	pyruvate family amino acid catabolic process	16175	3253		0.3333333333333333	0.75	7	16168	2	4	5	16164	16175	0.3083299398805696
M1	cpdb	0	network_modules	544	TRUE	0.00516199753145213	11	6	2	0.3333333333333333	0.18181818181818182	GO:0009078	GO:BP	pyruvate family amino acid metabolic process	16175	3251		1	1	11	16164	2	4	9	16160	16175	0.24580989962527874
M1	cpdb	0	network_modules	544	TRUE	0.006860869965083985	21	5	2	0.4	0.09523809523809523	REAC:R-HSA-70895	REAC	Branched-chain amino acid catabolism	10916	254		0.75	0.8	21	10895	2	3	19	10892	10916	0.1944729578343617
M1	cpdb	0	network_modules	544	TRUE	0.007545572771065852	22	5	2	0.4	0.09090909090909091	REAC:R-HSA-3296482	REAC	Defects in vitamin and cofactor metabolism	10916	715		1	1	22	10894	2	3	20	10891	10916	0.18996671092011097
M1	cpdb	0	network_modules	545	TRUE	1.0335437485256194e-4	25	7	3	0.42857142857142855	0.12	GO:0006783	GO:BP	heme biosynthetic process	16175	2469		0	0.125	25	16150	3	4	22	16146	16175	0.22618460430073142
M1	cpdb	0	network_modules	545	TRUE	1.4713059805601404e-4	28	7	3	0.42857142857142855	0.10714285714285714	GO:0006779	GO:BP	porphyrin-containing compound biosynthetic process	16175	2465		0.14285714285714285	0.375	28	16147	3	4	25	16143	16175	0.2136513790804247
M1	cpdb	0	network_modules	545	TRUE	1.4713059805601404e-4	28	7	3	0.42857142857142855	0.10714285714285714	GO:0033014	GO:BP	tetrapyrrole biosynthetic process	16175	7979		0.14285714285714285	0.375	28	16147	3	4	25	16143	16175	0.2136513790804247
M1	cpdb	0	network_modules	545	TRUE	4.4273932388627695e-4	40	7	3	0.42857142857142855	0.075	GO:0042168	GO:BP	heme metabolic process	16175	10001		0.42857142857142855	0.5	40	16135	3	4	37	16131	16175	0.17850922312755857
M1	cpdb	0	network_modules	545	TRUE	5.527127071042539e-4	43	7	3	0.42857142857142855	0.06976744186046512	GO:0006778	GO:BP	porphyrin-containing compound metabolic process	16175	2464		0.5714285714285714	0.625	43	16132	3	4	40	16128	16175	0.17211064252460476
M1	cpdb	0	network_modules	545	TRUE	5.930449031721639e-4	44	7	3	0.42857142857142855	0.06818181818181818	GO:0046148	GO:BP	pigment biosynthetic process	16175	11918		0.7142857142857143	0.75	44	16131	3	4	41	16127	16175	0.17012417475866906
M1	cpdb	0	network_modules	545	TRUE	9.88132176006121e-4	52	7	3	0.42857142857142855	0.057692307692307696	GO:0033013	GO:BP	tetrapyrrole metabolic process	16175	7978		0.8571428571428571	0.875	52	16123	3	4	49	16119	16175	0.15634850281880738
M1	cpdb	0	network_modules	545	TRUE	0.001948299981104326	65	7	3	0.42857142857142855	0.046153846153846156	GO:0042440	GO:BP	pigment metabolic process	16175	10180		1	1	65	16110	3	4	62	16106	16175	0.13963442575655335
M1	cpdb	0	network_modules	546	TRUE	0.00145856676457427	5	7	2	0.2857142857142857	0.4	GO:0006561	GO:BP	proline biosynthetic process	16175	2280		0	0.3333333333333333	5	16170	2	5	3	16165	16175	0.33782126035976096
M1	cpdb	0	network_modules	546	TRUE	0.0016289095455634052	247	7	4	0.5714285714285714	0.016194331983805668	GO:0006520	GO:BP	amino acid metabolic process	16175	2241		0.5	0.6666666666666666	247	15928	4	3	243	15925	16175	0.0943700792357514
M1	cpdb	0	network_modules	546	TRUE	0.0035168464095975726	21	4	2	0.5	0.09523809523809523	REAC:R-HSA-379726	REAC	Mitochondrial tRNA aminoacylation	10916	1470		NA	1	21	10895	2	2	19	10893	10916	0.21762755623977673
M1	cpdb	0	network_modules	546	TRUE	0.0065567886350286295	10	7	2	0.2857142857142857	0.2	GO:0006560	GO:BP	proline metabolic process	16175	2279		1	1	10	16165	2	5	8	16160	16175	0.23865388102180132
M1	cpdb	0	network_modules	551	TRUE	0.006222855153780529	346	7	4	0.5714285714285714	0.011560693641618497	GO:0034329	GO:BP	cell junction assembly	16175	8571		NA	1	346	15829	4	3	342	15826	16175	0.07910295326642988
M1	cpdb	0	network_modules	554	TRUE	0.001933515543395235	9	6	2	0.3333333333333333	0.2222222222222222	REAC:R-HSA-727802	REAC	Transport of nucleotide sugars	10916	2598		NA	1	9	10907	2	4	7	10903	10916	0.2716790073116455
M1	cpdb	0	network_modules	554	TRUE	0.003379876718209125	9	6	2	0.3333333333333333	0.2222222222222222	GO:0090481	GO:BP	pyrimidine nucleotide-sugar transmembrane transport	16175	18313		0	0.5	9	16166	2	4	7	16162	16175	0.2718372629362925
M1	cpdb	0	network_modules	554	TRUE	0.0042241491632657386	10	6	2	0.3333333333333333	0.2	GO:0015780	GO:BP	nucleotide-sugar transmembrane transport	16175	4898		1	1	10	16165	2	4	8	16161	16175	0.2578475355270565
M1	cpdb	0	network_modules	555	TRUE	1.3369614907900958e-5	17	6	3	0.5	0.17647058823529413	REAC:R-HSA-1482922	REAC	Acyl chain remodelling of PI	10916	115		0	0.14285714285714285	17	10899	3	3	14	10896	10916	0.2964313888728945
M1	cpdb	0	network_modules	555	TRUE	1.604022733521059e-5	18	6	3	0.5	0.16666666666666666	REAC:R-HSA-1482925	REAC	Acyl chain remodelling of PG	10916	114		0.16666666666666666	0.2857142857142857	18	10898	3	3	15	10895	10916	0.2880397963939067
M1	cpdb	0	network_modules	555	TRUE	3.0247015397243475e-5	22	6	3	0.5	0.13636363636363635	REAC:R-HSA-1482801	REAC	Acyl chain remodelling of PS	10916	116		0.3333333333333333	0.42857142857142855	22	10894	3	3	19	10891	10916	0.26039801666268764
M1	cpdb	0	network_modules	555	TRUE	5.7390414898770686e-5	27	6	3	0.5	0.1111111111111111	REAC:R-HSA-1482788	REAC	Acyl chain remodelling of PC	10916	112		0.5	0.5714285714285714	27	10889	3	3	24	10886	10916	0.23489142991848785
M1	cpdb	0	network_modules	555	TRUE	7.166426889138637e-5	29	6	3	0.5	0.10344827586206896	REAC:R-HSA-1482839	REAC	Acyl chain remodelling of PE	10916	113		0.6666666666666666	0.7142857142857143	29	10887	3	3	26	10884	10916	0.22658438701846975
M1	cpdb	0	network_modules	555	TRUE	9.399390566700814e-5	2	6	2	0.3333333333333333	1	GO:1903210	GO:BP	podocyte apoptotic process	16175	22828		0	0.42857142857142855	2	16173	2	4	0	16169	16175	0.5772788679688248
M1	cpdb	0	network_modules	555	TRUE	9.399390566700814e-5	2	6	2	0.3333333333333333	1	GO:1904635	GO:BP	positive regulation of podocyte apoptotic process	16175	23975		0	0.42857142857142855	2	16173	2	4	0	16169	16175	0.5772788679688248
M1	cpdb	0	network_modules	555	TRUE	9.399390566700814e-5	2	6	2	0.3333333333333333	1	GO:1904633	GO:BP	regulation of podocyte apoptotic process	16175	23973		0	0.42857142857142855	2	16173	2	4	0	16169	16175	0.5772788679688248
M1	cpdb	0	network_modules	555	TRUE	1.7162815687525514e-4	61	5	3	0.6	0.04918032786885246	KEGG:00590	KEGG	Arachidonic acid metabolism	8484	92		0	0.3333333333333333	61	8423	3	2	58	8421	8484	0.17038468046639882
M1	cpdb	0	network_modules	555	TRUE	1.7886924584424634e-4	39	6	3	0.5	0.07692307692307693	REAC:R-HSA-1483166	REAC	Synthesis of PA	10916	2386		0.8333333333333334	0.8571428571428571	39	10877	3	3	36	10874	10916	0.19511719014185458
M1	cpdb	0	network_modules	555	TRUE	0.002629226587076545	8	6	2	0.3333333333333333	0.25	GO:0032429	GO:BP	regulation of phospholipase A2 activity	16175	7560		0.5	0.5714285714285714	8	16167	2	4	6	16163	16175	0.28837160488364655
M1	cpdb	0	network_modules	555	TRUE	0.004402236950023732	26	5	2	0.4	0.07692307692307693	KEGG:00592	KEGG	alpha-Linolenic acid metabolism	8484	94		0.5	0.6666666666666666	26	8458	2	3	24	8455	8484	0.17438642357721043
M1	cpdb	0	network_modules	555	TRUE	0.0058866610624297875	30	5	2	0.4	0.06666666666666667	KEGG:00591	KEGG	Linoleic acid metabolism	8484	93		1	1	30	8454	2	3	28	8451	8484	0.16219045017711642
M1	cpdb	0	network_modules	555	TRUE	0.006559366023817458	128	6	3	0.5	0.0234375	REAC:R-HSA-1483206	REAC	Glycerophospholipid biosynthesis	10916	1060		1	1	128	10788	3	3	125	10785	10916	0.10636898257467813
M1	cpdb	0	network_modules	555	TRUE	0.008536534460640288	14	6	2	0.3333333333333333	0.14285714285714285	GO:1904037	GO:BP	positive regulation of epithelial cell apoptotic process	16175	23478		0.6666666666666666	1	14	16161	2	4	12	16157	16175	0.21778591592692415
M1	cpdb	0	network_modules	555	TRUE	0.008536534460640288	14	6	2	0.3333333333333333	0.14285714285714285	GO:1903963	GO:BP	arachidonate transport	16175	23420		0.6666666666666666	1	14	16161	2	4	12	16157	16175	0.21778591592692415
M1	cpdb	0	network_modules	555	TRUE	0.008536534460640288	14	6	2	0.3333333333333333	0.14285714285714285	GO:0050482	GO:BP	arachidonate secretion	16175	13190		0.6666666666666666	1	14	16161	2	4	12	16157	16175	0.21778591592692415
M1	cpdb	0	network_modules	556	TRUE	2.0075089406885187e-10	36	6	5	0.8333333333333334	0.1388888888888889	GO:0006749	GO:BP	glutathione metabolic process	16175	2447		0	0.14285714285714285	36	16139	5	1	31	16138	16175	0.3397395181446393
M1	cpdb	0	network_modules	556	TRUE	2.7583442763027773e-10	34	6	5	0.8333333333333334	0.14705882352941177	REAC:R-HSA-156590	REAC	Glutathione conjugation	10916	1058		0	0.25	34	10882	5	1	29	10881	10916	0.34940204065920777
M1	cpdb	0	network_modules	556	TRUE	3.0554215518968698e-9	56	6	5	0.8333333333333334	0.08928571428571429	KEGG:00480	KEGG	Glutathione metabolism	8484	61		0	0.1	56	8428	5	1	51	8427	8484	0.27160540213042206
M1	cpdb	0	network_modules	556	TRUE	7.716634456714628e-9	67	6	5	0.8333333333333334	0.07462686567164178	KEGG:05204	KEGG	Chemical carcinogenesis - DNA adducts	8484	456		0.1111111111111111	0.2	67	8417	5	1	62	8416	8484	0.24808298595894365
M1	cpdb	0	network_modules	556	TRUE	8.328242146617358e-9	68	6	5	0.8333333333333334	0.07352941176470588	KEGG:00982	KEGG	Drug metabolism - cytochrome P450	8484	156		0.2222222222222222	0.3	68	8416	5	1	63	8415	8484	0.24623155386344386
M1	cpdb	0	network_modules	556	TRUE	1.1173967912581886e-8	72	6	5	0.8333333333333334	0.06944444444444445	KEGG:01524	KEGG	Platinum drug resistance	8484	198		0.3333333333333333	0.4	72	8412	5	1	67	8411	8484	0.2392142114309028
M1	cpdb	0	network_modules	556	TRUE	1.2862282834798288e-8	74	6	5	0.8333333333333334	0.06756756756756757	KEGG:00980	KEGG	Metabolism of xenobiotics by cytochrome P450	8484	154		0.4444444444444444	0.5	74	8410	5	1	69	8409	8484	0.23592005572095187
M1	cpdb	0	network_modules	556	TRUE	1.7986511429971487e-8	79	6	5	0.8333333333333334	0.06329113924050633	KEGG:00983	KEGG	Drug metabolism - other enzymes	8484	157		0.5555555555555556	0.6	79	8405	5	1	74	8404	8484	0.22823687726262248
M1	cpdb	0	network_modules	556	TRUE	8.505584053263762e-8	116	6	5	0.8333333333333334	0.04310344827586207	GO:0006805	GO:BP	xenobiotic metabolic process	16175	2487		0.16666666666666666	0.2857142857142857	116	16059	5	1	111	16058	16175	0.1886058616650795
M1	cpdb	0	network_modules	556	TRUE	9.990528521595745e-8	106	6	5	0.8333333333333334	0.04716981132075472	REAC:R-HSA-156580	REAC	Phase II - Conjugation of compounds	10916	1738		0.3333333333333333	0.5	106	10810	5	1	101	10809	10916	0.1969651388637678
M1	cpdb	0	network_modules	556	TRUE	2.5471250380054567e-7	144	6	5	0.8333333333333334	0.034722222222222224	GO:0006575	GO:BP	modified amino acid metabolic process	16175	2294		0.3333333333333333	0.5714285714285714	144	16031	5	1	139	16030	16175	0.16907170782193323
M1	cpdb	0	network_modules	556	TRUE	2.5471250380054567e-7	144	6	5	0.8333333333333334	0.034722222222222224	GO:0071466	GO:BP	cellular response to xenobiotic stimulus	16175	16699		0.3333333333333333	0.5714285714285714	144	16031	5	1	139	16030	16175	0.16907170782193323
M1	cpdb	0	network_modules	556	TRUE	3.0753361080051397e-7	138	6	5	0.8333333333333334	0.036231884057971016	KEGG:05418	KEGG	Fluid shear stress and atherosclerosis	8484	495		0.6666666666666666	0.7	138	8346	5	1	133	8345	8484	0.17183385751723443
M1	cpdb	0	network_modules	556	TRUE	7.820622150794164e-7	166	6	5	0.8333333333333334	0.030120481927710843	KEGG:05225	KEGG	Hepatocellular carcinoma	8484	476		0.7777777777777778	0.8	166	8318	5	1	161	8317	8484	0.15630259907898028
M1	cpdb	0	network_modules	556	TRUE	1.0614600333754921e-6	191	6	5	0.8333333333333334	0.02617801047120419	GO:0009410	GO:BP	response to xenobiotic stimulus	16175	3475		0.6666666666666666	0.7142857142857143	191	15984	5	1	186	15983	16175	0.14650069743851396
M1	cpdb	0	network_modules	556	TRUE	2.617149253748435e-6	211	6	5	0.8333333333333334	0.023696682464454975	KEGG:05207	KEGG	Chemical carcinogenesis - receptor activation	8484	459		0.8888888888888888	0.9	211	8273	5	1	206	8272	8484	0.13810741042258665
M1	cpdb	0	network_modules	556	TRUE	3.302829832343056e-6	221	6	5	0.8333333333333334	0.02262443438914027	KEGG:05208	KEGG	Chemical carcinogenesis - reactive oxygen species	8484	460		1	1	221	8263	5	1	216	8262	8484	0.13483140872229935
M1	cpdb	0	network_modules	556	TRUE	3.5711966726741866e-6	215	6	5	0.8333333333333334	0.023255813953488372	REAC:R-HSA-211859	REAC	Biological oxidations	10916	227		0.6666666666666666	0.75	215	10701	5	1	210	10700	10916	0.1373176327030528
M1	cpdb	0	network_modules	556	TRUE	8.527431464520612e-6	289	6	5	0.8333333333333334	0.01730103806228374	GO:0006790	GO:BP	sulfur compound metabolic process	16175	2476		0.8333333333333334	0.8571428571428571	289	15886	5	1	284	15885	16175	0.11858455477622845
M1	cpdb	0	network_modules	556	TRUE	3.781795737707358e-5	389	6	5	0.8333333333333334	0.012853470437017995	GO:0043603	GO:BP	amide metabolic process	16175	10795		1	1	389	15786	5	1	384	15785	16175	0.1017579550902162
M1	cpdb	0	network_modules	556	TRUE	0.008199380901080522	18	6	2	0.3333333333333333	0.1111111111111111	REAC:R-HSA-9818027	REAC	NFE2L2 regulating anti-oxidant/detoxification enzymes	10916	1521		1	1	18	10898	2	4	16	10894	10916	0.19170883997736607
M1	cpdb	0	network_modules	558	TRUE	3.0412949316680416e-7	191	5	5	1	0.02617801047120419	REAC:R-HSA-202733	REAC	Cell surface interactions at the vascular wall	10916	327		NA	1	191	10725	5	0	186	10725	10916	0.1604112012536602
M1	cpdb	0	network_modules	558	TRUE	6.905834289526728e-5	142	6	4	0.6666666666666666	0.028169014084507043	GO:0016064	GO:BP	immunoglobulin mediated immune response	16175	5095		0	0.16666666666666666	142	16033	4	2	138	16031	16175	0.13585590617814922
M1	cpdb	0	network_modules	558	TRUE	7.938715674127762e-5	147	6	4	0.6666666666666666	0.027210884353741496	GO:0019724	GO:BP	B cell mediated immunity	16175	6019		0.2	0.3333333333333333	147	16028	4	2	143	16026	16175	0.13348351972050063
M1	cpdb	0	network_modules	558	TRUE	8.960574298378731e-4	269	6	4	0.6666666666666666	0.01486988847583643	GO:0002449	GO:BP	lymphocyte mediated immunity	16175	972		0.4	0.5	269	15906	4	2	265	15904	16175	0.09791723850298617
M1	cpdb	0	network_modules	558	TRUE	9.9290153863256e-4	276	6	4	0.6666666666666666	0.014492753623188406	GO:0002460	GO:BP	adaptive immune response based on somatic recombination of immune receptors built from immunoglobulin superfamily domains	16175	983		0.6	0.6666666666666666	276	15899	4	2	272	15897	16175	0.0966244664820055
M1	cpdb	0	network_modules	558	TRUE	0.0021251010267962674	334	6	4	0.6666666666666666	0.011976047904191617	GO:0002443	GO:BP	leukocyte mediated immunity	16175	966		0.8	1	334	15841	4	2	330	15839	16175	0.08751008338397714
M1	cpdb	0	network_modules	558	TRUE	0.0021251010267962674	334	6	4	0.6666666666666666	0.011976047904191617	GO:0002250	GO:BP	adaptive immune response	16175	782		0.8	1	334	15841	4	2	330	15839	16175	0.08751008338397714
M1	cpdb	0	network_modules	559	TRUE	8.255196032957833e-6	84	6	4	0.6666666666666666	0.047619047619047616	GO:2000781	GO:BP	positive regulation of double-strand break repair	16175	26037		0	0.045454545454545456	84	16091	4	2	80	16089	16175	0.17727994251326384
M1	cpdb	0	network_modules	559	TRUE	4.402713299629561e-5	127	6	4	0.6666666666666666	0.031496062992125984	GO:0045739	GO:BP	positive regulation of DNA repair	16175	11579		0.047619047619047616	0.09090909090909091	127	16048	4	2	123	16046	16175	0.14379027796483815
M1	cpdb	0	network_modules	559	TRUE	4.544284004674842e-5	128	6	4	0.6666666666666666	0.03125	GO:2000779	GO:BP	regulation of double-strand break repair	16175	26035		0.09523809523809523	0.13636363636363635	128	16047	4	2	124	16045	16175	0.14321851751574974
M1	cpdb	0	network_modules	559	TRUE	6.777102354657864e-5	27	6	3	0.5	0.1111111111111111	GO:2000819	GO:BP	regulation of nucleotide-excision repair	16175	26073		0.14285714285714285	0.18181818181818182	27	16148	3	3	24	16145	16175	0.23515530167234228
M1	cpdb	0	network_modules	559	TRUE	1.2332778073344651e-4	116	3	3	1	0.02586206896551724	KEGG:03082	KEGG	ATP-dependent chromatin remodeling	8484	219		NA	1	116	8368	3	0	113	8368	8484	0.15974193354384125
M1	cpdb	0	network_modules	559	TRUE	1.3851165186819494e-4	34	6	3	0.5	0.08823529411764706	GO:0070316	GO:BP	regulation of G0 to G1 transition	16175	16055		0.19047619047619047	0.22727272727272727	34	16141	3	3	31	16138	16175	0.2094180109807884
M1	cpdb	0	network_modules	559	TRUE	1.6522354184097342e-4	36	6	3	0.5	0.08333333333333333	GO:0045023	GO:BP	G0 to G1 transition	16175	11235		0.23809523809523808	0.2727272727272727	36	16139	3	3	33	16136	16175	0.2034797900054474
M1	cpdb	0	network_modules	559	TRUE	2.4650649042154687e-4	41	6	3	0.5	0.07317073170731707	GO:1902459	GO:BP	positive regulation of stem cell population maintenance	16175	22297		0.2857142857142857	0.3181818181818182	41	16134	3	3	38	16131	16175	0.19058034360921766
M1	cpdb	0	network_modules	559	TRUE	3.1403030670706646e-4	207	6	4	0.6666666666666666	0.01932367149758454	GO:0006282	GO:BP	regulation of DNA repair	16175	2096		0.3333333333333333	0.36363636363636365	207	15968	4	2	203	15966	16175	0.1120620956735765
M1	cpdb	0	network_modules	559	TRUE	6.268354085414353e-4	246	6	4	0.6666666666666666	0.016260162601626018	GO:0051054	GO:BP	positive regulation of DNA metabolic process	16175	13464		0.38095238095238093	0.4090909090909091	246	15929	4	2	242	15927	16175	0.10254227619936067
M1	cpdb	0	network_modules	559	TRUE	7.498683728206359e-4	59	6	3	0.5	0.05084745762711865	GO:2000036	GO:BP	regulation of stem cell population maintenance	16175	25399		0.42857142857142855	0.45454545454545453	59	16116	3	3	56	16113	16175	0.15860388501909614
M1	cpdb	0	network_modules	559	TRUE	0.0013485884042340138	298	6	4	0.6666666666666666	0.013422818791946308	GO:0006302	GO:BP	double-strand break repair	16175	2109		0.47619047619047616	0.5	298	15877	4	2	294	15875	16175	0.09285898487133964
M1	cpdb	0	network_modules	559	TRUE	0.0018189922988469656	79	6	3	0.5	0.0379746835443038	GO:0006289	GO:BP	nucleotide-excision repair	16175	2102		0.5238095238095238	0.5454545454545454	79	16096	3	3	76	16093	16175	0.1368083790463259
M1	cpdb	0	network_modules	559	TRUE	0.00235174790904305	86	6	3	0.5	0.03488372093023256	GO:0030071	GO:BP	regulation of mitotic metaphase/anaphase transition	16175	6671		0.5714285714285714	0.5909090909090909	86	16089	3	3	83	16086	16175	0.13103632447851885
M1	cpdb	0	network_modules	559	TRUE	0.0025210021627133845	88	6	3	0.5	0.03409090909090909	GO:1902099	GO:BP	regulation of metaphase/anaphase transition of cell cycle	16175	22013		0.6190476190476191	0.6363636363636364	88	16087	3	3	85	16084	16175	0.12951438881408725
M1	cpdb	0	network_modules	559	TRUE	0.002698154158646704	90	6	3	0.5	0.03333333333333333	GO:0007091	GO:BP	metaphase/anaphase transition of mitotic cell cycle	16175	2675		0.6666666666666666	0.6818181818181818	90	16085	3	3	87	16082	16175	0.12804319610350862
M1	cpdb	0	network_modules	559	TRUE	0.002883380914190138	92	6	3	0.5	0.03260869565217391	GO:0044784	GO:BP	metaphase/anaphase transition of cell cycle	16175	11156		0.7142857142857143	0.7272727272727273	92	16083	3	3	89	16080	16175	0.12661997622550558
M1	cpdb	0	network_modules	559	TRUE	0.003597814228511958	99	6	3	0.5	0.030303030303030304	GO:0033045	GO:BP	regulation of sister chromatid segregation	16175	8000		0.7619047619047619	0.8181818181818182	99	16076	3	3	96	16073	16175	0.12198114008819379
M1	cpdb	0	network_modules	559	TRUE	0.003597814228511958	99	6	3	0.5	0.030303030303030304	GO:0019827	GO:BP	stem cell population maintenance	16175	6046		0.7619047619047619	0.8181818181818182	99	16076	3	3	96	16073	16175	0.12198114008819379
M1	cpdb	0	network_modules	559	TRUE	0.0037085687935766638	100	6	3	0.5	0.03	GO:0098727	GO:BP	maintenance of cell number	16175	18856		0.8571428571428571	0.8636363636363636	100	16075	3	3	97	16072	16175	0.12135828347503899
M1	cpdb	0	network_modules	559	TRUE	0.00607790153615547	435	6	4	0.6666666666666666	0.009195402298850575	GO:0051052	GO:BP	regulation of DNA metabolic process	16175	13462		0.9047619047619048	0.9090909090909091	435	15740	4	2	431	15738	16175	0.07618289316387161
M1	cpdb	0	network_modules	559	TRUE	0.006189594605338672	437	6	4	0.6666666666666666	0.009153318077803204	GO:0080135	GO:BP	regulation of cellular response to stress	16175	17817		0.9523809523809523	0.9545454545454546	437	15738	4	2	433	15736	16175	0.07599850022775106
M1	cpdb	0	network_modules	559	TRUE	0.007088838703287924	124	6	3	0.5	0.024193548387096774	GO:0051983	GO:BP	regulation of chromosome segregation	16175	14045		1	1	124	16051	3	3	121	16048	16175	0.10873669760995228
M1	cpdb	0	network_modules	560	TRUE	7.0799673155197006e-6	24	4	3	0.75	0.125	GO:0016973	GO:BP	poly(A)+ mRNA export from nucleus	16175	5260		0	0.1	24	16151	3	1	21	16150	16175	0.3058452484972161
M1	cpdb	0	network_modules	560	TRUE	6.952210728002376e-5	96	3	3	1	0.03125	KEGG:03015	KEGG	mRNA surveillance pathway	8484	210		0	0.2	96	8388	3	0	93	8388	8484	0.17580478449045323
M1	cpdb	0	network_modules	560	TRUE	9.933759332209239e-5	108	3	3	1	0.027777777777777776	KEGG:03013	KEGG	Nucleocytoplasmic transport	8484	209		0.25	0.4	108	8376	3	0	105	8376	8484	0.16563173546107776
M1	cpdb	0	network_modules	560	TRUE	1.8289175241448453e-4	69	4	3	0.75	0.043478260869565216	GO:0006406	GO:BP	mRNA export from nucleus	16175	2167		0.1111111111111111	0.2	69	16106	3	1	66	16105	16175	0.17995813748619782
M1	cpdb	0	network_modules	560	TRUE	2.131153292656098e-4	139	3	3	1	0.02158273381294964	KEGG:03008	KEGG	Ribosome biogenesis in eukaryotes	8484	207		0.5	0.6	139	8345	3	0	136	8345	8484	0.145727953538524
M1	cpdb	0	network_modules	560	TRUE	2.4531632345590635e-4	76	4	3	0.75	0.039473684210526314	GO:0051028	GO:BP	mRNA transport	16175	13445		0.2222222222222222	0.3	76	16099	3	1	73	16098	16175	0.17140817537647662
M1	cpdb	0	network_modules	560	TRUE	3.7094433157518555e-4	167	3	3	1	0.017964071856287425	KEGG:05164	KEGG	Influenza A	8484	445		0.75	0.8	167	8317	3	0	164	8317	8484	0.1327278962757968
M1	cpdb	0	network_modules	560	TRUE	4.096868605879269e-4	90	4	3	0.75	0.03333333333333333	GO:0006405	GO:BP	RNA export from nucleus	16175	2166		0.3333333333333333	0.4	90	16085	3	1	87	16084	16175	0.15739877320398826
M1	cpdb	0	network_modules	560	TRUE	8.376306305248639e-4	114	4	3	0.75	0.02631578947368421	GO:0050657	GO:BP	nucleic acid transport	16175	13197		0.4444444444444444	0.6	114	16061	3	1	111	16060	16175	0.13967797702770382
M1	cpdb	0	network_modules	560	TRUE	8.376306305248639e-4	114	4	3	0.75	0.02631578947368421	GO:0050658	GO:BP	RNA transport	16175	13198		0.4444444444444444	0.6	114	16061	3	1	111	16060	16175	0.13967797702770382
M1	cpdb	0	network_modules	560	TRUE	9.060083162586441e-4	117	4	3	0.75	0.02564102564102564	GO:0051236	GO:BP	establishment of RNA localization	16175	13586		0.6666666666666666	0.7	117	16058	3	1	114	16057	16175	0.1378540609501311
M1	cpdb	0	network_modules	560	TRUE	0.0018789161038261322	149	4	3	0.75	0.020134228187919462	GO:0006403	GO:BP	RNA localization	16175	2164		0.7777777777777778	0.8	149	16026	3	1	146	16025	16175	0.12195348916208706
M1	cpdb	0	network_modules	560	TRUE	0.0019952302709114887	152	4	3	0.75	0.019736842105263157	GO:0051168	GO:BP	nuclear export	16175	13551		0.8888888888888888	0.9	152	16023	3	1	149	16022	16175	0.12072507260833053
M1	cpdb	0	network_modules	560	TRUE	0.002697059027994638	168	4	3	0.75	0.017857142857142856	GO:0015931	GO:BP	nucleobase-containing compound transport	16175	5016		1	1	168	16007	3	1	165	16006	16175	0.11473637436795284
M1	cpdb	0	network_modules	560	TRUE	0.00384700395734791	363	3	3	1	0.008264462809917356	KEGG:05014	KEGG	Amyotrophic lateral sclerosis	8484	413		1	1	363	8121	3	0	360	8121	8484	0.08895872268962902
M1	cpdb	0	network_modules	562	TRUE	1.9511281125445056e-6	9	6	3	0.5	0.3333333333333333	GO:0030388	GO:BP	fructose 1,6-bisphosphate metabolic process	16175	6785		0	0.025	9	16166	3	3	6	16163	16175	0.4079831549351323
M1	cpdb	0	network_modules	562	TRUE	3.8315064269056755e-6	11	6	3	0.5	0.2727272727272727	GO:0006002	GO:BP	fructose 6-phosphate metabolic process	16175	1877		0.02564102564102564	0.05	11	16164	3	3	8	16161	16175	0.36896611095097825
M1	cpdb	0	network_modules	562	TRUE	3.870406556289881e-6	74	6	4	0.6666666666666666	0.05405405405405406	KEGG:01230	KEGG	Biosynthesis of amino acids	8484	188		0	0.08333333333333333	74	8410	4	2	70	8408	8484	0.18823695698032494
M1	cpdb	0	network_modules	562	TRUE	1.2994853360542101e-5	16	6	3	0.5	0.1875	GO:0061621	GO:BP	canonical glycolysis	16175	15590		0.05128205128205128	0.125	16	16159	3	3	13	16156	16175	0.3057884404350395
M1	cpdb	0	network_modules	562	TRUE	1.2994853360542101e-5	16	6	3	0.5	0.1875	GO:0006735	GO:BP	NADH regeneration	16175	2436		0.05128205128205128	0.125	16	16159	3	3	13	16156	16175	0.3057884404350395
M1	cpdb	0	network_modules	562	TRUE	1.2994853360542101e-5	16	6	3	0.5	0.1875	GO:0061718	GO:BP	glucose catabolic process to pyruvate	16175	15628		0.05128205128205128	0.125	16	16159	3	3	13	16156	16175	0.3057884404350395
M1	cpdb	0	network_modules	562	TRUE	1.5777268260592357e-5	17	6	3	0.5	0.17647058823529413	GO:0061620	GO:BP	glycolytic process through glucose-6-phosphate	16175	15589		0.1282051282051282	0.175	17	16158	3	3	14	16155	16175	0.29663078695383466
M1	cpdb	0	network_modules	562	TRUE	1.5777268260592357e-5	17	6	3	0.5	0.17647058823529413	GO:0061615	GO:BP	glycolytic process through fructose-6-phosphate	16175	15586		0.1282051282051282	0.175	17	16158	3	3	14	16155	16175	0.29663078695383466
M1	cpdb	0	network_modules	562	TRUE	1.725034968351404e-5	107	6	4	0.6666666666666666	0.037383177570093455	KEGG:04922	KEGG	Glucagon signaling pathway	8484	379		0.09090909090909091	0.16666666666666666	107	8377	4	2	103	8375	8484	0.15592203608816074
M1	cpdb	0	network_modules	562	TRUE	2.247634807808757e-5	19	6	3	0.5	0.15789473684210525	GO:0019677	GO:BP	NAD catabolic process	16175	5995		0.1794871794871795	0.225	19	16156	3	3	16	16153	16175	0.28053246336363274
M1	cpdb	0	network_modules	562	TRUE	2.247634807808757e-5	19	6	3	0.5	0.15789473684210525	GO:0006007	GO:BP	glucose catabolic process	16175	1882		0.1794871794871795	0.225	19	16156	3	3	16	16153	16175	0.28053246336363274
M1	cpdb	0	network_modules	562	TRUE	2.3073995712879198e-5	115	6	4	0.6666666666666666	0.034782608695652174	KEGG:01200	KEGG	Carbon metabolism	8484	184		0.18181818181818182	0.25	115	8369	4	2	111	8367	8484	0.15025584151710228
M1	cpdb	0	network_modules	562	TRUE	2.7390865055170918e-5	120	6	4	0.6666666666666666	0.03333333333333333	KEGG:04152	KEGG	AMPK signaling pathway	8484	286		0.2727272727272727	0.3333333333333333	120	8364	4	2	116	8362	8484	0.14700339522373226
M1	cpdb	0	network_modules	562	TRUE	4.2993471119343766e-5	31	6	3	0.5	0.0967741935483871	KEGG:00030	KEGG	Pentose phosphate pathway	8484	4		0.36363636363636365	0.4166666666666667	31	8453	3	3	28	8450	8484	0.2188405910655658
M1	cpdb	0	network_modules	562	TRUE	4.74284584634562e-5	32	6	3	0.5	0.09375	KEGG:00052	KEGG	Galactose metabolism	8484	7		0.45454545454545453	0.5	32	8452	3	3	29	8449	8484	0.21535565560637443
M1	cpdb	0	network_modules	562	TRUE	5.7189714616272025e-5	34	6	3	0.5	0.08823529411764706	KEGG:00051	KEGG	Fructose and mannose metabolism	8484	6		0.5454545454545454	0.5833333333333334	34	8450	3	3	31	8447	8484	0.20885113377256662
M1	cpdb	0	network_modules	562	TRUE	6.777102354657864e-5	27	6	3	0.5	0.1111111111111111	GO:0006734	GO:BP	NADH metabolic process	16175	2435		0.23076923076923078	0.25	27	16148	3	3	24	16145	16175	0.23515530167234228
M1	cpdb	0	network_modules	562	TRUE	1.3851165186819494e-4	34	6	3	0.5	0.08823529411764706	GO:0019320	GO:BP	hexose catabolic process	16175	5683		0.2564102564102564	0.275	34	16141	3	3	31	16138	16175	0.2094180109807884
M1	cpdb	0	network_modules	562	TRUE	1.7977704068804646e-4	37	6	3	0.5	0.08108108108108109	GO:0046365	GO:BP	monosaccharide catabolic process	16175	12096		0.28205128205128205	0.3	37	16138	3	3	34	16135	16175	0.2006925177790762
M1	cpdb	0	network_modules	562	TRUE	4.5382744579059223e-4	67	6	3	0.5	0.04477611940298507	KEGG:00010	KEGG	Glycolysis / Gluconeogenesis	8484	2		0.6363636363636364	0.6666666666666666	67	8417	3	3	64	8414	8484	0.14790039502764382
M1	cpdb	0	network_modules	562	TRUE	5.181640482463608e-4	70	6	3	0.5	0.04285714285714286	KEGG:05230	KEGG	Central carbon metabolism in cancer	8484	478		0.7272727272727273	0.75	70	8414	3	3	67	8411	8484	0.1446181977443263
M1	cpdb	0	network_modules	562	TRUE	6.054868627653349e-4	55	6	3	0.5	0.05454545454545454	GO:0019674	GO:BP	NAD metabolic process	16175	5993		0.3076923076923077	0.325	55	16120	3	3	52	16117	16175	0.16433153630806108
M1	cpdb	0	network_modules	562	TRUE	7.467597245104226e-4	79	6	3	0.5	0.0379746835443038	KEGG:03018	KEGG	RNA degradation	8484	211		0.8181818181818182	0.8333333333333334	79	8405	3	3	76	8402	8484	0.13591047347222104
M1	cpdb	0	network_modules	562	TRUE	9.750091363099853e-4	68	6	3	0.5	0.04411764705882353	REAC:R-HSA-70171	REAC	Glycolysis	10916	1074		0	0.5	68	10848	3	3	65	10845	10916	0.14717116253448934
M1	cpdb	0	network_modules	562	TRUE	0.0013731928848827555	72	6	3	0.5	0.041666666666666664	GO:0046032	GO:BP	ADP catabolic process	16175	11809		0.3333333333333333	0.375	72	16103	3	3	69	16100	16175	0.14339863536526445
M1	cpdb	0	network_modules	562	TRUE	0.0013731928848827555	72	6	3	0.5	0.041666666666666664	GO:0006096	GO:BP	glycolytic process	16175	1956		0.3333333333333333	0.375	72	16103	3	3	69	16100	16175	0.14339863536526445
M1	cpdb	0	network_modules	562	TRUE	0.0014921364608598156	74	6	3	0.5	0.04054054054054054	GO:0046031	GO:BP	ADP metabolic process	16175	11808		0.38461538461538464	0.45	74	16101	3	3	71	16098	16175	0.14142103165689845
M1	cpdb	0	network_modules	562	TRUE	0.0014921364608598156	74	6	3	0.5	0.04054054054054054	GO:0009181	GO:BP	purine ribonucleoside diphosphate catabolic process	16175	3347		0.38461538461538464	0.45	74	16101	3	3	71	16098	16175	0.14142103165689845
M1	cpdb	0	network_modules	562	TRUE	0.0014921364608598156	74	6	3	0.5	0.04054054054054054	GO:0009137	GO:BP	purine nucleoside diphosphate catabolic process	16175	3304		0.38461538461538464	0.45	74	16101	3	3	71	16098	16175	0.14142103165689845
M1	cpdb	0	network_modules	562	TRUE	0.00161773297877222	76	6	3	0.5	0.039473684210526314	GO:0009179	GO:BP	purine ribonucleoside diphosphate metabolic process	16175	3345		0.46153846153846156	0.5	76	16099	3	3	73	16096	16175	0.13952166019312726
M1	cpdb	0	network_modules	562	TRUE	0.00161773297877222	76	6	3	0.5	0.039473684210526314	GO:0019364	GO:BP	pyridine nucleotide catabolic process	16175	5726		0.46153846153846156	0.5	76	16099	3	3	73	16096	16175	0.13952166019312726
M1	cpdb	0	network_modules	562	TRUE	0.0016830818607008367	77	6	3	0.5	0.03896103896103896	GO:0009191	GO:BP	ribonucleoside diphosphate catabolic process	16175	3357		0.5128205128205128	0.55	77	16098	3	3	74	16095	16175	0.13859971757555867
M1	cpdb	0	network_modules	562	TRUE	0.0016830818607008367	77	6	3	0.5	0.03896103896103896	GO:0009135	GO:BP	purine nucleoside diphosphate metabolic process	16175	3302		0.5128205128205128	0.55	77	16098	3	3	74	16095	16175	0.13859971757555867
M1	cpdb	0	network_modules	562	TRUE	0.0018189922988469656	79	6	3	0.5	0.0379746835443038	GO:0072526	GO:BP	pyridine-containing compound catabolic process	16175	17428		0.5641025641025641	0.575	79	16096	3	3	76	16093	16175	0.1368083790463259
M1	cpdb	0	network_modules	562	TRUE	0.0019666242700209094	109	6	3	0.5	0.027522935779816515	KEGG:04066	KEGG	HIF-1 signaling pathway	8484	257		0.9090909090909091	0.9166666666666666	109	8375	3	3	106	8372	8484	0.11507703603850171
M1	cpdb	0	network_modules	562	TRUE	0.001983621054592915	86	6	3	0.5	0.03488372093023256	REAC:R-HSA-70326	REAC	Glucose metabolism	10916	1053		1	1	86	10830	3	3	83	10827	10916	0.13053765297643705
M1	cpdb	0	network_modules	562	TRUE	0.0020362235459277693	82	6	3	0.5	0.036585365853658534	GO:0009134	GO:BP	nucleoside diphosphate catabolic process	16175	3301		0.5897435897435898	0.6	82	16093	3	3	79	16090	16175	0.13424467712498003
M1	cpdb	0	network_modules	562	TRUE	0.0022700270622358285	85	6	3	0.5	0.03529411764705882	GO:0009185	GO:BP	ribonucleoside diphosphate metabolic process	16175	3351		0.6153846153846154	0.625	85	16090	3	3	82	16087	16175	0.13181724864309374
M1	cpdb	0	network_modules	562	TRUE	0.0025315004258959287	349	6	4	0.6666666666666666	0.011461318051575931	GO:0006163	GO:BP	purine nucleotide metabolic process	16175	1998		0.6410256410256411	0.65	349	15826	4	2	345	15824	16175	0.08552645219170468
M1	cpdb	0	network_modules	562	TRUE	0.0026890956313416012	121	6	3	0.5	0.024793388429752067	KEGG:04919	KEGG	Thyroid hormone signaling pathway	8484	376		1	1	121	8363	3	3	118	8360	8484	0.10898275944500015
M1	cpdb	0	network_modules	562	TRUE	0.002698154158646704	90	6	3	0.5	0.03333333333333333	GO:0009154	GO:BP	purine ribonucleotide catabolic process	16175	3321		0.6666666666666666	0.675	90	16085	3	3	87	16082	16175	0.12804319610350862
M1	cpdb	0	network_modules	562	TRUE	0.002883380914190138	92	6	3	0.5	0.03260869565217391	GO:0009261	GO:BP	ribonucleotide catabolic process	16175	3426		0.6923076923076923	0.7	92	16083	3	3	89	16080	16175	0.12661997622550558
M1	cpdb	0	network_modules	562	TRUE	0.002979077589359165	93	6	3	0.5	0.03225806451612903	GO:0009132	GO:BP	nucleoside diphosphate metabolic process	16175	3299		0.717948717948718	0.725	93	16082	3	3	90	16079	16175	0.125925547672859
M1	cpdb	0	network_modules	562	TRUE	0.0032787657610314387	96	6	3	0.5	0.03125	GO:0006090	GO:BP	pyruvate metabolic process	16175	1953		0.7435897435897436	0.75	96	16079	3	3	93	16076	16175	0.12390739151136416
M1	cpdb	0	network_modules	562	TRUE	0.003597814228511958	99	6	3	0.5	0.030303030303030304	GO:0006195	GO:BP	purine nucleotide catabolic process	16175	2024		0.7692307692307693	0.775	99	16076	3	3	96	16073	16175	0.12198114008819379
M1	cpdb	0	network_modules	562	TRUE	0.0038588078908445653	388	6	4	0.6666666666666666	0.010309278350515464	GO:0009117	GO:BP	nucleotide metabolic process	16175	3286		0.7948717948717948	0.8	388	15787	4	2	384	15785	16175	0.08091085625934241
M1	cpdb	0	network_modules	562	TRUE	0.005800091418750991	116	6	3	0.5	0.02586206896551724	GO:0072523	GO:BP	purine-containing compound catabolic process	16175	17425		0.8205128205128205	0.825	116	16059	3	3	113	16056	16175	0.11250863390138424
M1	cpdb	0	network_modules	562	TRUE	0.005951893429908986	117	6	3	0.5	0.02564102564102564	GO:0009166	GO:BP	nucleotide catabolic process	16175	3332		0.8461538461538461	0.85	117	16058	3	3	114	16055	16175	0.1120162302820489
M1	cpdb	0	network_modules	562	TRUE	0.006263352764920577	119	6	3	0.5	0.025210084033613446	GO:0006006	GO:BP	glucose metabolic process	16175	1881		0.8717948717948718	0.875	119	16056	3	3	116	16053	16175	0.1110499740022716
M1	cpdb	0	network_modules	562	TRUE	0.006918301739733577	123	6	3	0.5	0.024390243902439025	GO:0016052	GO:BP	carbohydrate catabolic process	16175	5084		0.8974358974358975	0.9	123	16052	3	3	120	16049	16175	0.10918813047087013
M1	cpdb	0	network_modules	562	TRUE	0.008192790062319481	469	6	4	0.6666666666666666	0.008528784648187633	GO:0072521	GO:BP	purine-containing compound metabolic process	16175	17423		0.9230769230769231	0.925	469	15706	4	2	465	15704	16175	0.07320756965116641
M1	cpdb	0	network_modules	562	TRUE	0.00977634894002655	138	6	3	0.5	0.021739130434782608	GO:0019362	GO:BP	pyridine nucleotide metabolic process	16175	5724		0.9487179487179487	0.975	138	16037	3	3	135	16034	16175	0.10293729474737487
M1	cpdb	0	network_modules	562	TRUE	0.00977634894002655	138	6	3	0.5	0.021739130434782608	GO:0046496	GO:BP	nicotinamide nucleotide metabolic process	16175	12199		0.9487179487179487	0.975	138	16037	3	3	135	16034	16175	0.10293729474737487
M1	cpdb	0	network_modules	562	TRUE	0.009990605940195973	139	6	3	0.5	0.02158273381294964	GO:1901292	GO:BP	nucleoside phosphate catabolic process	16175	21367		1	1	139	16036	3	3	136	16033	16175	0.10255664364644193
M1	cpdb	0	network_modules	563	TRUE	1.604022733521059e-5	18	6	3	0.5	0.16666666666666666	REAC:R-HSA-1362277	REAC	Transcription of E2F targets under negative control by DREAM complex	10916	2536		0	0.1	18	10898	3	3	15	10895	10916	0.2880397963939067
M1	cpdb	0	network_modules	563	TRUE	5.1024236537392664e-5	26	6	3	0.5	0.11538461538461539	REAC:R-HSA-1538133	REAC	G0 and Early G1	10916	999		0.1111111111111111	0.2	26	10890	3	3	23	10887	10916	0.23939903601547216
M1	cpdb	0	network_modules	563	TRUE	1.1724037983924791e-4	34	6	3	0.5	0.08823529411764706	REAC:R-HSA-8953750	REAC	Transcriptional Regulation by E2F6	10916	2543		0.2222222222222222	0.3	34	10882	3	3	31	10879	10916	0.20911689001054248
M1	cpdb	0	network_modules	563	TRUE	1.9974737162561736e-4	84	4	3	0.75	0.03571428571428571	KEGG:03083	KEGG	Polycomb repressive complex	8484	220		NA	1	84	8400	3	1	81	8399	8484	0.16234662573269718
M1	cpdb	0	network_modules	563	TRUE	0.0017179512274934073	82	6	3	0.5	0.036585365853658534	REAC:R-HSA-69202	REAC	Cyclin E associated events during G1/S transition 	10916	421		0.3333333333333333	0.4	82	10834	3	3	79	10831	10916	0.13375843171441223
M1	cpdb	0	network_modules	563	TRUE	0.0018476225352299037	84	6	3	0.5	0.03571428571428571	REAC:R-HSA-69656	REAC	Cyclin A:Cdk2-associated events at S phase entry	10916	419		0.4444444444444444	0.5	84	10832	3	3	81	10829	10916	0.1321195066434072
M1	cpdb	0	network_modules	563	TRUE	0.005631154960289099	15	6	2	0.3333333333333333	0.13333333333333333	REAC:R-HSA-1362300	REAC	Transcription of E2F targets under negative control by p107 (RBL1) and p130 (RBL2) in complex with HDAC1	10916	2537		0.5555555555555556	0.6	15	10901	2	4	13	10897	10916	0.21015159549681772
M1	cpdb	0	network_modules	563	TRUE	0.006434032448418521	16	6	2	0.3333333333333333	0.125	REAC:R-HSA-2559584	REAC	Formation of Senescence-Associated Heterochromatin Foci (SAHF)	10916	950		0.6666666666666666	0.7	16	10900	2	4	14	10896	10916	0.20343158583831095
M1	cpdb	0	network_modules	563	TRUE	0.006871320645483846	130	6	3	0.5	0.023076923076923078	REAC:R-HSA-69206	REAC	G1/S Transition	10916	1002		0.7777777777777778	0.8	130	10786	3	3	127	10783	10916	0.10551776456321066
M1	cpdb	0	network_modules	563	TRUE	0.008199380901080522	18	6	2	0.3333333333333333	0.1111111111111111	REAC:R-HSA-6804114	REAC	TP53 Regulates Transcription of Genes Involved in G2 Cell Cycle Arrest	10916	2460		0.8888888888888888	0.9	18	10898	2	4	16	10894	10916	0.19170883997736607
M1	cpdb	0	network_modules	563	TRUE	0.009926604081379305	147	6	3	0.5	0.02040816326530612	REAC:R-HSA-453279	REAC	Mitotic G1 phase and G1/S transition	10916	1480		1	1	147	10769	3	3	144	10766	10916	0.09899042651116124
M1	cpdb	0	network_modules	564	TRUE	1.1140549408243956e-5	177	4	4	1	0.022598870056497175	REAC:R-HSA-2990846	REAC	SUMOylation	10916	2167		0	0.14285714285714285	177	10739	4	0	173	10739	10916	0.14913277703046035
M1	cpdb	0	network_modules	564	TRUE	3.2704710416246626e-5	41	4	3	0.75	0.07317073170731707	REAC:R-HSA-3899300	REAC	SUMOylation of transcription cofactors	10916	2177		0.16666666666666666	0.2857142857142857	41	10875	3	1	38	10874	10916	0.23356924751547856
M1	cpdb	0	network_modules	564	TRUE	1.6779674839189002e-4	5	4	2	0.5	0.4	REAC:R-HSA-3065676	REAC	SUMO is conjugated to E1 (UBA2:SAE1)	10916	2164		0.3333333333333333	0.42857142857142855	5	10911	2	2	3	10909	10916	0.44698817556185216
M1	cpdb	0	network_modules	564	TRUE	3.5228706385558213e-4	7	4	2	0.5	0.2857142857142857	REAC:R-HSA-3065678	REAC	SUMO is transferred from E1 to E2 (UBE2I, UBC9)	10916	2166		0.5	0.5714285714285714	7	10909	2	2	5	10907	10916	0.37767001729423827
M1	cpdb	0	network_modules	564	TRUE	7.546241237176022e-4	10	4	2	0.5	0.2	REAC:R-HSA-3215018	REAC	Processing and activation of SUMO	10916	1795		0.6666666666666666	0.7142857142857143	10	10906	2	2	8	10904	10916	0.31585093673197046
M1	cpdb	0	network_modules	564	TRUE	7.892250619887132e-4	60	6	3	0.5	0.05	GO:0016925	GO:BP	protein sumoylation	16175	5258		0	0.5	60	16115	3	3	57	16112	16175	0.15726192186902072
M1	cpdb	0	network_modules	564	TRUE	0.0024895782684612377	171	4	3	0.75	0.017543859649122806	REAC:R-HSA-3108232	REAC	SUMO E3 ligases SUMOylate target proteins	10916	2163		0.8333333333333334	0.8571428571428571	171	10745	3	1	168	10744	10916	0.11322289636620655
M1	cpdb	0	network_modules	564	TRUE	0.007798836205213833	128	6	3	0.5	0.0234375	GO:0018205	GO:BP	peptidyl-lysine modification	16175	5364		1	1	128	16047	3	3	125	16044	16175	0.10698377558968374
M1	cpdb	0	network_modules	564	TRUE	0.008295286235839682	32	4	2	0.5	0.0625	REAC:R-HSA-4085377	REAC	SUMOylation of SUMOylation proteins	10916	2172		1	1	32	10884	2	2	30	10882	10916	0.17603067354664229
M1	cpdb	0	network_modules	567	TRUE	0.001586337996458355	167	4	3	0.75	0.017964071856287425	KEGG:05164	KEGG	Influenza A	8484	445		NA	1	167	8317	3	1	164	8316	8484	0.11418311647225332
M1	cpdb	0	network_modules	568	TRUE	5.537682446162073e-4	5	5	2	0.4	0.4	GO:0051664	GO:BP	nuclear pore localization	16175	13876		0	0.25	5	16170	2	3	3	16167	16175	0.3998144712430426
M1	cpdb	0	network_modules	568	TRUE	0.003043465800624165	11	5	2	0.4	0.18181818181818182	GO:0090435	GO:BP	protein localization to nuclear envelope	16175	18286		0.3333333333333333	0.5	11	16164	2	3	9	16161	16175	0.26935467227213133
M1	cpdb	0	network_modules	568	TRUE	0.004254496796512925	137	5	3	0.6	0.021897810218978103	GO:0031503	GO:BP	protein-containing complex localization	16175	7188		0.6666666666666666	0.75	137	16038	3	2	134	16036	16175	0.11350520325266379
M1	cpdb	0	network_modules	568	TRUE	0.0066496171277495375	135	2	2	1	0.014814814814814815	KEGG:04210	KEGG	Apoptosis	8484	287		NA	1	135	8349	2	0	133	8349	8484	0.1207580829845106
M1	cpdb	0	network_modules	568	TRUE	0.0075200767606027966	17	5	2	0.4	0.11764705882352941	GO:0007097	GO:BP	nuclear migration	16175	2680		1	1	17	16158	2	3	15	16155	16175	0.21650772406949978
M1	cpdb	0	network_modules	569	TRUE	0.004185189504531335	13	6	2	0.3333333333333333	0.15384615384615385	REAC:R-HSA-162658	REAC	Golgi Cisternae Pericentriolar Stack Reorganization	10916	1083		NA	1	13	10903	2	4	11	10899	10916	0.22584289982209305
M1	cpdb	0	network_modules	573	TRUE	7.63190999773547e-5	99	3	3	1	0.030303030303030304	KEGG:00564	KEGG	Glycerophospholipid metabolism	8484	88		NA	1	99	8385	3	0	96	8385	8484	0.17308962296857108
M1	cpdb	0	network_modules	573	TRUE	2.863850412583413e-4	128	3	3	1	0.0234375	REAC:R-HSA-1483206	REAC	Glycerophospholipid biosynthesis	10916	1060		0	0.5	128	10788	3	0	125	10788	10916	0.152213801969879
M1	cpdb	0	network_modules	573	TRUE	0.0012764241422226273	210	3	3	1	0.014285714285714285	REAC:R-HSA-1483257	REAC	Phospholipid metabolism	10916	1748		1	1	210	10706	3	0	207	10706	10916	0.11838386695947034
M1	cpdb	0	network_modules	573	TRUE	0.003043465800624165	11	5	2	0.4	0.18181818181818182	GO:0036152	GO:BP	phosphatidylethanolamine acyl-chain remodeling	16175	9465		NA	1	11	16164	2	3	9	16161	16175	0.26935467227213133
M1	cpdb	0	network_modules	580	TRUE	1.077230787321733e-10	46	5	5	1	0.10869565217391304	GO:0006120	GO:BP	mitochondrial electron transport, NADH to ubiquinone	16175	1978		0	0.022727272727272728	46	16129	5	0	41	16129	16175	0.3292719967762847
M1	cpdb	0	network_modules	580	TRUE	6.491176136220887e-10	65	5	5	1	0.07692307692307693	GO:0042776	GO:BP	proton motive force-driven mitochondrial ATP synthesis	16175	10361		0.023255813953488372	0.045454545454545456	65	16110	5	0	60	16110	16175	0.2768350557032463
M1	cpdb	0	network_modules	580	TRUE	1.0995497338666697e-9	72	5	5	1	0.06944444444444445	GO:0015986	GO:BP	proton motive force-driven ATP synthesis	16175	5062		0.046511627906976744	0.06818181818181818	72	16103	5	0	67	16103	16175	0.2629766207959835
M1	cpdb	0	network_modules	580	TRUE	2.144265417545232e-9	82	5	5	1	0.06097560975609756	GO:0019646	GO:BP	aerobic electron transport chain	16175	5967		0.06976744186046512	0.09090909090909091	82	16093	5	0	77	16093	16175	0.24634376328545432
M1	cpdb	0	network_modules	580	TRUE	3.0786943660847086e-9	88	5	5	1	0.056818181818181816	GO:0042773	GO:BP	ATP synthesis coupled electron transport	16175	10358		0.09302325581395349	0.13636363636363635	88	16087	5	0	83	16087	16175	0.23775309931592573
M1	cpdb	0	network_modules	580	TRUE	3.0786943660847086e-9	88	5	5	1	0.056818181818181816	GO:0042775	GO:BP	mitochondrial ATP synthesis coupled electron transport	16175	10360		0.09302325581395349	0.13636363636363635	88	16087	5	0	83	16087	16175	0.23775309931592573
M1	cpdb	0	network_modules	580	TRUE	3.4538293938849673e-9	90	5	5	1	0.05555555555555555	GO:0006754	GO:BP	ATP biosynthetic process	16175	2451		0.13953488372093023	0.1590909090909091	90	16085	5	0	85	16085	16175	0.2350819422015094
M1	cpdb	0	network_modules	580	TRUE	3.864669832344958e-9	92	5	5	1	0.05434782608695652	GO:0009145	GO:BP	purine nucleoside triphosphate biosynthetic process	16175	3312		0.16279069767441862	0.20454545454545456	92	16083	5	0	87	16083	16175	0.23249820780611705
M1	cpdb	0	network_modules	580	TRUE	3.864669832344958e-9	92	5	5	1	0.05434782608695652	GO:0009206	GO:BP	purine ribonucleoside triphosphate biosynthetic process	16175	3372		0.16279069767441862	0.20454545454545456	92	16083	5	0	87	16083	16175	0.23249820780611705
M1	cpdb	0	network_modules	580	TRUE	5.064602486899562e-9	97	5	5	1	0.05154639175257732	GO:0009201	GO:BP	ribonucleoside triphosphate biosynthetic process	16175	3367		0.20930232558139536	0.22727272727272727	97	16078	5	0	92	16078	16175	0.22639151056144807
M1	cpdb	0	network_modules	580	TRUE	5.620770227396435e-9	99	5	5	1	0.050505050505050504	GO:0022904	GO:BP	respiratory electron transport chain	16175	6631		0.23255813953488372	0.25	99	16076	5	0	94	16076	16175	0.22407912176027334
M1	cpdb	0	network_modules	580	TRUE	6.8795804553169065e-9	103	5	5	1	0.04854368932038835	GO:0009142	GO:BP	nucleoside triphosphate biosynthetic process	16175	3309		0.2558139534883721	0.2727272727272727	103	16072	5	0	98	16072	16175	0.21965765441406548
M1	cpdb	0	network_modules	580	TRUE	8.354442901587284e-9	107	5	5	1	0.04672897196261682	GO:0022900	GO:BP	electron transport chain	16175	6630		0.27906976744186046	0.29545454545454547	107	16068	5	0	102	16068	16175	0.2154859778450208
M1	cpdb	0	network_modules	580	TRUE	1.997924464531583e-8	127	5	5	1	0.03937007874015748	GO:0006119	GO:BP	oxidative phosphorylation	16175	1977		0.3023255813953488	0.3181818181818182	127	16048	5	0	122	16048	16175	0.1976690110972849
M1	cpdb	0	network_modules	580	TRUE	2.0791409061791942e-8	128	5	5	1	0.0390625	GO:0009152	GO:BP	purine ribonucleotide biosynthetic process	16175	3319		0.32558139534883723	0.3409090909090909	128	16047	5	0	123	16047	16175	0.19688921783628865
M1	cpdb	0	network_modules	580	TRUE	2.9357405562780257e-8	137	5	5	1	0.0364963503649635	GO:0009260	GO:BP	ribonucleotide biosynthetic process	16175	3425		0.3488372093023256	0.36363636363636365	137	16038	5	0	132	16038	16175	0.1902588262715533
M1	cpdb	0	network_modules	580	TRUE	3.6488357943420823e-8	143	5	5	1	0.03496503496503497	GO:0046390	GO:BP	ribose phosphate biosynthetic process	16175	12117		0.37209302325581395	0.38636363636363635	143	16032	5	0	138	16032	16175	0.18618977434120668
M1	cpdb	0	network_modules	580	TRUE	4.4732538113706655e-8	134	5	5	1	0.03731343283582089	KEGG:00190	KEGG	Oxidative phosphorylation	8484	18		0	0.1	134	8350	5	0	129	8350	8484	0.1916917945419597
M1	cpdb	0	network_modules	580	TRUE	6.865672348185136e-8	162	5	5	1	0.030864197530864196	GO:0009060	GO:BP	aerobic respiration	16175	3236		0.3953488372093023	0.4090909090909091	162	16013	5	0	157	16013	16175	0.17482713346695536
M1	cpdb	0	network_modules	580	TRUE	7.305674437213785e-8	164	5	5	1	0.03048780487804878	GO:0006164	GO:BP	purine nucleotide biosynthetic process	16175	1999		0.4186046511627907	0.4318181818181818	164	16011	5	0	159	16011	16175	0.17374699294478604
M1	cpdb	0	network_modules	580	TRUE	7.405270420267239e-8	148	5	5	1	0.033783783783783786	KEGG:04723	KEGG	Retrograde endocannabinoid signaling	8484	353		0.1111111111111111	0.2	148	8336	5	0	143	8336	8484	0.18224712243608468
M1	cpdb	0	network_modules	580	TRUE	1.1134038274749883e-7	57	4	4	1	0.07017543859649122	REAC:R-HSA-6799198	REAC	Complex I biogenesis	10916	391		0	0.3333333333333333	57	10859	4	0	53	10859	10916	0.26426235792469216
M1	cpdb	0	network_modules	580	TRUE	1.3075532058913294e-7	184	5	5	1	0.02717391304347826	GO:0046034	GO:BP	ATP metabolic process	16175	11811		0.4418604651162791	0.45454545454545453	184	15991	5	0	179	15991	16175	0.1639301711676766
M1	cpdb	0	network_modules	580	TRUE	1.380997722980993e-7	186	5	5	1	0.026881720430107527	GO:0009165	GO:BP	nucleotide biosynthetic process	16175	3331		0.46511627906976744	0.4772727272727273	186	15989	5	0	181	15989	16175	0.16303624767355396
M1	cpdb	0	network_modules	580	TRUE	1.4577059973914648e-7	188	5	5	1	0.026595744680851064	GO:0045333	GO:BP	cellular respiration	16175	11360		0.4883720930232558	0.5	188	15987	5	0	183	15987	16175	0.16215657210961418
M1	cpdb	0	network_modules	580	TRUE	1.8940516516266152e-7	198	5	5	1	0.025252525252525252	GO:0009205	GO:BP	purine ribonucleoside triphosphate metabolic process	16175	3371		0.5116279069767442	0.5227272727272727	198	15977	5	0	193	15977	16175	0.157959232420784
M1	cpdb	0	network_modules	580	TRUE	2.0435183180774618e-7	201	5	5	1	0.024875621890547265	GO:0009144	GO:BP	purine nucleoside triphosphate metabolic process	16175	3311		0.5348837209302325	0.5454545454545454	201	15974	5	0	196	15974	16175	0.15676128093685912
M1	cpdb	0	network_modules	580	TRUE	2.2022753462257153e-7	204	5	5	1	0.024509803921568627	GO:0009199	GO:BP	ribonucleoside triphosphate metabolic process	16175	3365		0.5581395348837209	0.5681818181818182	204	15971	5	0	199	15971	16175	0.1555897429644099
M1	cpdb	0	network_modules	580	TRUE	2.870900507667353e-7	215	5	5	1	0.023255813953488372	GO:0009141	GO:BP	nucleoside triphosphate metabolic process	16175	3308		0.5813953488372093	0.5909090909090909	215	15960	5	0	210	15960	16175	0.15150508372873453
M1	cpdb	0	network_modules	580	TRUE	3.2240722339691474e-7	220	5	5	1	0.022727272727272728	GO:0072522	GO:BP	purine-containing compound biosynthetic process	16175	17424		0.6046511627906976	0.6136363636363636	220	15955	5	0	215	15955	16175	0.14975007758520212
M1	cpdb	0	network_modules	580	TRUE	3.572516237125318e-7	202	5	5	1	0.024752475247524754	KEGG:05415	KEGG	Diabetic cardiomyopathy	8484	492		0.2222222222222222	0.3	202	8282	5	0	197	8282	8484	0.15549076952651902
M1	cpdb	0	network_modules	580	TRUE	5.624110163561247e-7	221	5	5	1	0.02262443438914027	KEGG:05208	KEGG	Chemical carcinogenesis - reactive oxygen species	8484	460		0.3333333333333333	0.4	221	8263	5	0	216	8263	8484	0.1484859712582647
M1	cpdb	0	network_modules	580	TRUE	6.394893085398306e-7	252	5	5	1	0.01984126984126984	GO:0015980	GO:BP	energy derivation by oxidation of organic compounds	16175	5060		0.627906976744186	0.6363636363636364	252	15923	5	0	247	15923	16175	0.13977907732045525
M1	cpdb	0	network_modules	580	TRUE	7.185825262637716e-7	232	5	5	1	0.021551724137931036	KEGG:04714	KEGG	Thermogenesis	8484	349		0.4444444444444444	0.5	232	8252	5	0	227	8252	8484	0.14482658885872338
M1	cpdb	0	network_modules	580	TRUE	7.48572546958841e-7	260	5	5	1	0.019230769230769232	GO:1901293	GO:BP	nucleoside phosphate biosynthetic process	16175	21368		0.6511627906976745	0.6590909090909091	260	15915	5	0	255	15915	16175	0.1375772549164949
M1	cpdb	0	network_modules	580	TRUE	8.39762479312541e-7	266	5	5	1	0.018796992481203006	GO:0009150	GO:BP	purine ribonucleotide metabolic process	16175	3317		0.6744186046511628	0.6818181818181818	266	15909	5	0	261	15909	16175	0.13599114011835506
M1	cpdb	0	network_modules	580	TRUE	1.0113276448911664e-6	276	5	5	1	0.018115942028985508	GO:0009259	GO:BP	ribonucleotide metabolic process	16175	3424		0.6976744186046512	0.7045454545454546	276	15899	5	0	271	15899	16175	0.13346283807761947
M1	cpdb	0	network_modules	580	TRUE	1.1472870394574093e-6	283	5	5	1	0.0176678445229682	GO:0019693	GO:BP	ribose phosphate metabolic process	16175	6010		0.7209302325581395	0.7272727272727273	283	15892	5	0	278	15892	16175	0.13177288447714405
M1	cpdb	0	network_modules	580	TRUE	1.2462126293814124e-6	103	4	4	1	0.038834951456310676	REAC:R-HSA-611105	REAC	Respiratory electron transport	10916	2081		0.5	0.6666666666666666	103	10813	4	0	99	10813	10916	0.1961698708450724
M1	cpdb	0	network_modules	580	TRUE	1.4048367836483425e-6	265	5	5	1	0.018867924528301886	KEGG:05012	KEGG	Parkinson disease	8484	412		0.5555555555555556	0.6	265	8219	5	0	260	8219	8484	0.13523815517515844
M1	cpdb	0	network_modules	580	TRUE	1.5725697328325484e-6	271	5	5	1	0.01845018450184502	KEGG:05020	KEGG	Prion disease	8484	416		0.6666666666666666	0.7	271	8213	5	0	266	8213	8484	0.13368385186961143
M1	cpdb	0	network_modules	580	TRUE	2.8514647826356674e-6	305	5	5	1	0.01639344262295082	KEGG:05016	KEGG	Huntington disease	8484	414		0.7777777777777778	0.8	305	8179	5	0	300	8179	8484	0.12575141163103637
M1	cpdb	0	network_modules	580	TRUE	3.2945592980255166e-6	349	5	5	1	0.014326647564469915	GO:0006163	GO:BP	purine nucleotide metabolic process	16175	1998		0.7441860465116279	0.75	349	15826	5	0	344	15826	16175	0.11841394756558185
M1	cpdb	0	network_modules	580	TRUE	4.541096673953647e-6	372	5	5	1	0.013440860215053764	GO:0006091	GO:BP	generation of precursor metabolites and energy	16175	1954		0.7674418604651163	0.7727272727272727	372	15803	5	0	367	15803	16175	0.11461152529423808
M1	cpdb	0	network_modules	580	TRUE	5.611641758455691e-6	388	5	5	1	0.01288659793814433	GO:0009117	GO:BP	nucleotide metabolic process	16175	3286		0.7906976744186046	0.7954545454545454	388	15787	5	0	383	15787	16175	0.11216669767527661
M1	cpdb	0	network_modules	580	TRUE	6.845384843859273e-6	363	5	5	1	0.013774104683195593	KEGG:05014	KEGG	Amyotrophic lateral sclerosis	8484	413		0.8888888888888888	0.9	363	8121	5	0	358	8121	8484	0.11485876102562434
M1	cpdb	0	network_modules	580	TRUE	8.84670340112422e-6	382	5	5	1	0.013089005235602094	KEGG:05010	KEGG	Alzheimer disease	8484	411		1	1	382	8102	5	0	377	8102	8484	0.11183484045216296
M1	cpdb	0	network_modules	580	TRUE	1.1140549408243956e-5	177	4	4	1	0.022598870056497175	REAC:R-HSA-1428517	REAC	Aerobic respiration and respiratory electron transport	10916	127		1	1	177	10739	4	0	173	10739	10916	0.14913277703046035
M1	cpdb	0	network_modules	580	TRUE	1.4545961544900096e-5	469	5	5	1	0.010660980810234541	GO:0072521	GO:BP	purine-containing compound metabolic process	16175	17423		0.813953488372093	0.8181818181818182	469	15706	5	0	464	15706	16175	0.10175982874478731
M1	cpdb	0	network_modules	580	TRUE	2.2594905067790222e-5	512	5	5	1	0.009765625	GO:0090407	GO:BP	organophosphate biosynthetic process	16175	18274		0.8372093023255814	0.8409090909090909	512	15663	5	0	507	15663	16175	0.09725960147383764
M1	cpdb	0	network_modules	580	TRUE	2.3041434331965835e-5	514	5	5	1	0.009727626459143969	GO:1901137	GO:BP	carbohydrate derivative biosynthetic process	16175	21245		0.8604651162790697	0.8636363636363636	514	15661	5	0	509	15661	16175	0.0970639984149132
M1	cpdb	0	network_modules	580	TRUE	2.466020694316151e-5	521	5	5	1	0.009596928982725527	GO:0006753	GO:BP	nucleoside phosphate metabolic process	16175	2450		0.8837209302325582	0.8863636363636364	521	15654	5	0	516	15654	16175	0.09638818339560405
M1	cpdb	0	network_modules	580	TRUE	3.479644872172782e-5	558	5	5	1	0.008960573476702509	GO:0055086	GO:BP	nucleobase-containing small molecule metabolic process	16175	14237		0.9069767441860465	0.9090909090909091	558	15617	5	0	553	15617	16175	0.09302757452428584
M1	cpdb	0	network_modules	580	TRUE	3.6784286834843266e-4	61	5	3	0.6	0.04918032786885246	GO:0032981	GO:BP	mitochondrial respiratory chain complex I assembly	16175	7963		0.9302325581395349	0.9545454545454546	61	16114	3	2	58	16112	16175	0.17104902254369697
M1	cpdb	0	network_modules	580	TRUE	3.6784286834843266e-4	61	5	3	0.6	0.04918032786885246	GO:0010257	GO:BP	NADH dehydrogenase complex assembly	16175	4030		0.9302325581395349	0.9545454545454546	61	16114	3	2	58	16112	16175	0.17104902254369697
M1	cpdb	0	network_modules	580	TRUE	0.001501899387090707	97	5	3	0.6	0.030927835051546393	GO:0033108	GO:BP	mitochondrial respiratory chain complex assembly	16175	8042		0.9767441860465116	0.9772727272727273	97	16078	3	2	94	16076	16175	0.13528857031187916
M1	cpdb	0	network_modules	580	TRUE	0.0021361060053248096	109	5	3	0.6	0.027522935779816515	GO:0097250	GO:BP	mitochondrial respirasome assembly	16175	18559		1	1	109	16066	3	2	106	16064	16175	0.12751260001869028
M1	cpdb	0	network_modules	585	TRUE	4.6979173434767313e-8	8	3	3	1	0.375	REAC:R-HSA-72731	REAC	Recycling of eIF2:GDP	10916	1953		0	0.05263157894736842	8	10908	3	0	5	10908	10916	0.6122321345425118
M1	cpdb	0	network_modules	585	TRUE	3.8170578415748307e-7	15	3	3	1	0.2	REAC:R-HSA-9648895	REAC	Response of EIF2AK1 (HRI) to heme deficiency	10916	2086		0.05555555555555555	0.10526315789473684	15	10901	3	0	12	10901	10916	0.44696764849941306
M1	cpdb	0	network_modules	585	TRUE	4.161012504222237e-6	32	3	3	1	0.09375	REAC:R-HSA-381042	REAC	PERK regulates gene expression	10916	1664		0.1111111111111111	0.15789473684210525	32	10884	3	0	29	10884	10916	0.3057791204797942
M1	cpdb	0	network_modules	585	TRUE	7.570695449918813e-6	111	5	4	0.8	0.036036036036036036	GO:0006413	GO:BP	translational initiation	16175	2171		0	0.3333333333333333	111	16064	4	1	107	16063	16175	0.16894076647604928
M1	cpdb	0	network_modules	585	TRUE	1.853999523050632e-5	52	3	3	1	0.057692307692307696	REAC:R-HSA-72695	REAC	Formation of the ternary complex, and subsequently, the 43S complex	10916	973		0.16666666666666666	0.21052631578947367	52	10864	3	0	49	10864	10916	0.23965238555088889
M1	cpdb	0	network_modules	585	TRUE	2.727224909269368e-5	59	3	3	1	0.05084745762711865	REAC:R-HSA-72702	REAC	Ribosomal scanning and start codon recognition	10916	2106		0.2222222222222222	0.3157894736842105	59	10857	3	0	56	10857	10916	0.22491450414665626
M1	cpdb	0	network_modules	585	TRUE	2.727224909269368e-5	59	3	3	1	0.05084745762711865	REAC:R-HSA-72649	REAC	Translation initiation complex formation	10916	2566		0.2222222222222222	0.3157894736842105	59	10857	3	0	56	10857	10916	0.22491450414665626
M1	cpdb	0	network_modules	585	TRUE	2.8707630623888116e-5	60	3	3	1	0.05	REAC:R-HSA-72662	REAC	Activation of the mRNA upon binding of the cap-binding complex and eIFs, and subsequent binding to 43S	10916	105		0.3333333333333333	0.3684210526315789	60	10856	3	0	57	10856	10916	0.22302206971743874
M1	cpdb	0	network_modules	585	TRUE	5.66476551104045e-5	75	3	3	1	0.04	REAC:R-HSA-9833482	REAC	PKR-mediated signaling	10916	1692		0.3888888888888889	0.42105263157894735	75	10841	3	0	72	10841	10916	0.1993391445906042
M1	cpdb	0	network_modules	585	TRUE	1.0535079642746532e-4	92	3	3	1	0.03260869565217391	REAC:R-HSA-381119	REAC	Unfolded Protein Response (UPR)	10916	2624		0.4444444444444444	0.47368421052631576	92	10824	3	0	89	10824	10916	0.17984092509126676
M1	cpdb	0	network_modules	585	TRUE	1.440415014062419e-4	102	3	3	1	0.029411764705882353	REAC:R-HSA-9633012	REAC	Response of EIF2AK4 (GCN2) to amino acid deficiency	10916	2087		0.5	0.5263157894736842	102	10814	3	0	99	10814	10916	0.17071891679101905
M1	cpdb	0	network_modules	585	TRUE	1.483627464484293e-4	103	3	3	1	0.02912621359223301	REAC:R-HSA-382556	REAC	ABC-family proteins mediated transport	10916	9		0.5555555555555556	0.5789473684210527	103	10813	3	0	100	10813	10916	0.16988030768226756
M1	cpdb	0	network_modules	585	TRUE	1.9120523587950252e-4	112	3	3	1	0.026785714285714284	REAC:R-HSA-156827	REAC	L13a-mediated translational silencing of Ceruloplasmin expression	10916	1293		0.6111111111111112	0.631578947368421	112	10804	3	0	109	10804	10916	0.16284402422240726
M1	cpdb	0	network_modules	585	TRUE	1.9641992413076215e-4	113	3	3	1	0.02654867256637168	REAC:R-HSA-72706	REAC	GTP hydrolysis and joining of the 60S ribosomal subunit	10916	1027		0.6666666666666666	0.6842105263157895	113	10803	3	0	110	10803	10916	0.16211437117813662
M1	cpdb	0	network_modules	585	TRUE	2.3560055477535853e-4	120	3	3	1	0.025	REAC:R-HSA-72737	REAC	Cap-dependent Translation Initiation	10916	304		0.7222222222222222	0.7894736842105263	120	10796	3	0	117	10796	10916	0.15726401700233061
M1	cpdb	0	network_modules	585	TRUE	2.3560055477535853e-4	120	3	3	1	0.025	REAC:R-HSA-72613	REAC	Eukaryotic Translation Initiation	10916	871		0.7222222222222222	0.7894736842105263	120	10796	3	0	117	10796	10916	0.15726401700233061
M1	cpdb	0	network_modules	585	TRUE	4.351152319561349e-4	147	3	3	1	0.02040816326530612	REAC:R-HSA-1169410	REAC	Antiviral mechanism by IFN-stimulated genes	10916	157		0.8333333333333334	0.8421052631578947	147	10769	3	0	144	10769	10916	0.14191149356637248
M1	cpdb	0	network_modules	585	TRUE	5.307891575698489e-4	157	3	3	1	0.01910828025477707	REAC:R-HSA-9711097	REAC	Cellular response to starvation	10916	337		0.8888888888888888	0.8947368421052632	157	10759	3	0	154	10759	10916	0.13725389486615083
M1	cpdb	0	network_modules	585	TRUE	0.0024904164306056202	10	5	2	0.4	0.2	GO:0001731	GO:BP	formation of translation preinitiation complex	16175	410		0.5	0.6666666666666666	10	16165	2	3	8	16162	16175	0.28253656168710733
M1	cpdb	0	network_modules	585	TRUE	0.0025145694861478402	263	3	3	1	0.011406844106463879	REAC:R-HSA-913531	REAC	Interferon Signaling	10916	1227		0.9444444444444444	0.9473684210526315	263	10653	3	0	260	10653	10916	0.10552288079518544
M1	cpdb	0	network_modules	585	TRUE	0.0034454022448771504	292	3	3	1	0.010273972602739725	REAC:R-HSA-72766	REAC	Translation	10916	2565		1	1	292	10624	3	0	289	10624	10916	0.1000094767485677
M1	cpdb	0	network_modules	585	TRUE	0.005227350113804158	566	5	4	0.8	0.007067137809187279	GO:0006412	GO:BP	translation	16175	2170		1	1	566	15609	4	1	562	15608	16175	0.07320560733157234
M1	cpdb	0	network_modules	588	TRUE	0.0036517071985304244	12	5	2	0.4	0.16666666666666666	GO:0014029	GO:BP	neural crest formation	16175	4599		NA	1	12	16163	2	3	10	16160	16175	0.2578555143451957
M1	cpdb	0	network_modules	590	TRUE	0.006792586088506564	29	4	2	0.5	0.06896551724137931	REAC:R-HSA-2173795	REAC	Downregulation of SMAD2/3:SMAD4 transcriptional activity	10916	787		NA	1	29	10887	2	2	27	10885	10916	0.18498842221014508
M1	cpdb	0	network_modules	591	TRUE	6.643840547136762e-8	35	5	4	0.8	0.11428571428571428	GO:0030261	GO:BP	chromosome condensation	16175	6749		0	0.14285714285714285	35	16140	4	1	31	16139	16175	0.3019271820948009
M1	cpdb	0	network_modules	591	TRUE	1.4197615611170526e-7	42	5	4	0.8	0.09523809523809523	GO:0045910	GO:BP	negative regulation of DNA recombination	16175	11704		0.16666666666666666	0.2857142857142857	42	16133	4	1	38	16132	16175	0.27553079970567385
M1	cpdb	0	network_modules	591	TRUE	8.138395430819119e-6	113	5	4	0.8	0.035398230088495575	GO:0000018	GO:BP	regulation of DNA recombination	16175	6		0.3333333333333333	0.42857142857142855	113	16062	4	1	109	16061	16175	0.16742336036259534
M1	cpdb	0	network_modules	591	TRUE	1.0379382017237632e-5	120	5	4	0.8	0.03333333333333333	GO:0051053	GO:BP	negative regulation of DNA metabolic process	16175	13463		0.5	0.5714285714285714	120	16055	4	1	116	16054	16175	0.16241354261470836
M1	cpdb	0	network_modules	591	TRUE	3.1871000264265225e-4	281	5	4	0.8	0.014234875444839857	GO:0006310	GO:BP	DNA recombination	16175	2115		0.6666666666666666	0.7142857142857143	281	15894	4	1	277	15893	16175	0.1053318295753493
M1	cpdb	0	network_modules	591	TRUE	0.0013075355858833061	13	4	2	0.5	0.15384615384615385	REAC:R-HSA-140342	REAC	Apoptosis induced DNA fragmentation	10916	159		0	0.5	13	10903	2	2	11	10901	10916	0.2769051410026544
M1	cpdb	0	network_modules	591	TRUE	0.0018300597648408913	435	5	4	0.8	0.009195402298850575	GO:0051052	GO:BP	regulation of DNA metabolic process	16175	13462		0.8333333333333334	0.8571428571428571	435	15740	4	1	431	15739	16175	0.08403625607773904
M1	cpdb	0	network_modules	591	TRUE	0.0020108555737305294	16	4	2	0.5	0.125	REAC:R-HSA-2559584	REAC	Formation of Senescence-Associated Heterochromatin Foci (SAHF)	10916	950		1	1	16	10900	2	2	14	10898	10916	0.249495728203251
M1	cpdb	0	network_modules	591	TRUE	0.004496634327639707	545	5	4	0.8	0.007339449541284404	GO:0051276	GO:BP	chromosome organization	16175	13613		1	1	545	15630	4	1	541	15629	16175	0.074679049753081
M1	cpdb	0	network_modules	592	TRUE	0.0011832004165349805	390	5	4	0.8	0.010256410256410256	GO:0022613	GO:BP	ribonucleoprotein complex biogenesis	16175	6620		0	0.5	390	15785	4	1	386	15784	16175	0.08894450477682453
M1	cpdb	0	network_modules	592	TRUE	0.007995947541933992	169	5	3	0.6	0.01775147928994083	GO:0006364	GO:BP	rRNA processing	16175	2140		1	1	169	16006	3	2	166	16004	16175	0.10195569185133899
M1	cpdb	0	network_modules	595	TRUE	5.537682446162073e-4	5	5	2	0.4	0.4	GO:0016076	GO:BP	snRNA catabolic process	16175	5103		NA	1	5	16170	2	3	3	16167	16175	0.3998144712430426
M1	cpdb	0	network_modules	596	TRUE	1.0958842652328392e-4	202	5	4	0.8	0.019801980198019802	REAC:R-HSA-72163	REAC	mRNA Splicing - Major Pathway	10916	2707		0	0.3333333333333333	202	10714	4	1	198	10713	10916	0.12413406540428025
M1	cpdb	0	network_modules	596	TRUE	1.2564787817153866e-4	209	5	4	0.8	0.019138755980861243	REAC:R-HSA-72172	REAC	mRNA Splicing	10916	2706		0.5	0.6666666666666666	209	10707	4	1	205	10706	10916	0.12197727612213675
M1	cpdb	0	network_modules	596	TRUE	3.8290560531751015e-4	276	5	4	0.8	0.014492753623188406	REAC:R-HSA-72203	REAC	Processing of Capped Intron-Containing Pre-mRNA	10916	1796		1	1	276	10640	4	1	272	10639	10916	0.10564122512377254
M1	cpdb	0	network_modules	596	TRUE	0.001794477998144094	174	4	3	0.75	0.017241379310344827	KEGG:03040	KEGG	Spliceosome	8484	215		NA	1	174	8310	3	1	171	8309	8484	0.1117834260552794
M1	cpdb	0	network_modules	598	TRUE	1.6779674839189002e-4	5	4	2	0.5	0.4	REAC:R-HSA-426048	REAC	Arachidonate production from DAG	10916	166		0	0.5	5	10911	2	2	3	10909	10916	0.44698817556185216
M1	cpdb	0	network_modules	598	TRUE	0.005873845223360233	27	4	2	0.5	0.07407407407407407	REAC:R-HSA-114508	REAC	Effects of PIP2 hydrolysis	10916	833		1	1	27	10889	2	2	25	10887	10916	0.19177047272795533
M1	cpdb	0	network_modules	598	TRUE	0.00799718464518069	148	2	2	1	0.013513513513513514	KEGG:04723	KEGG	Retrograde endocannabinoid signaling	8484	353		NA	1	148	8336	2	0	146	8336	8484	0.11524281524882975
M1	cpdb	0	network_modules	604	TRUE	4.697917343476725e-7	16	3	3	1	0.1875	REAC:R-HSA-210993	REAC	Tie2 Signaling	10916	2509		0	0.5	16	10900	3	0	13	10900	10916	0.43275471405453747
M1	cpdb	0	network_modules	604	TRUE	8.493563784161808e-5	3	4	2	0.5	0.6666666666666666	GO:0048014	GO:BP	Tie signaling pathway	16175	12470		0	0.0625	3	16172	2	2	1	16170	16175	0.5772610151803533
M1	cpdb	0	network_modules	604	TRUE	1.0214903464252901e-4	109	3	3	1	0.027522935779816515	KEGG:04066	KEGG	HIF-1 signaling pathway	8484	257		0	0.2	109	8375	3	0	106	8375	8484	0.16486036409079768
M1	cpdb	0	network_modules	604	TRUE	2.274968585595656e-4	400	4	4	1	0.01	GO:0001525	GO:BP	angiogenesis	16175	330		0.06666666666666667	0.125	400	15775	4	0	396	15775	16175	0.09876799676557386
M1	cpdb	0	network_modules	604	TRUE	3.205201566376696e-4	83	4	3	0.75	0.03614457831325301	GO:0043535	GO:BP	regulation of blood vessel endothelial cell migration	16175	10756		0.13333333333333333	0.1875	83	16092	3	1	80	16091	16175	0.16396134395943227
M1	cpdb	0	network_modules	604	TRUE	3.553483482503358e-4	447	4	4	1	0.008948545861297539	GO:0048514	GO:BP	blood vessel morphogenesis	16175	12799		0.2	0.25	447	15728	4	0	443	15728	16175	0.09329203054116589
M1	cpdb	0	network_modules	604	TRUE	4.7292466466684473e-4	480	4	4	1	0.008333333333333333	GO:0001568	GO:BP	blood vessel development	16175	353		0.26666666666666666	0.3125	480	15695	4	0	476	15695	16175	0.08993352132429028
M1	cpdb	0	network_modules	604	TRUE	5.751867891523418e-4	504	4	4	1	0.007936507936507936	GO:0001944	GO:BP	vasculature development	16175	555		0.3333333333333333	0.375	504	15671	4	0	500	15671	16175	0.08769900058534327
M1	cpdb	0	network_modules	604	TRUE	5.984331642611292e-4	102	4	3	0.75	0.029411764705882353	GO:0043534	GO:BP	blood vessel endothelial cell migration	16175	10755		0.4	0.4375	102	16073	3	1	99	16072	16175	0.14775818563965293
M1	cpdb	0	network_modules	604	TRUE	7.403364828436578e-4	210	3	3	1	0.014285714285714285	KEGG:04015	KEGG	Rap1 signaling pathway	8484	248		0.25	0.4	210	8274	3	0	207	8274	8484	0.1180552232089669
M1	cpdb	0	network_modules	604	TRUE	8.285040746527623e-4	552	4	4	1	0.007246376811594203	GO:0035239	GO:BP	tube morphogenesis	16175	8921		0.4666666666666667	0.5	552	15623	4	0	548	15623	16175	0.08367086034228655
M1	cpdb	0	network_modules	604	TRUE	9.589917397205856e-4	191	3	3	1	0.015706806282722512	REAC:R-HSA-202733	REAC	Cell surface interactions at the vascular wall	10916	327		1	1	191	10725	3	0	188	10725	10916	0.12424259580996512
M1	cpdb	0	network_modules	604	TRUE	0.001039058205351277	235	3	3	1	0.01276595744680851	KEGG:04014	KEGG	Ras signaling pathway	8484	247		0.5	0.6	235	8249	3	0	232	8249	8484	0.11143043256481941
M1	cpdb	0	network_modules	604	TRUE	0.00137213210183923	626	4	4	1	0.006389776357827476	GO:0035295	GO:BP	tube development	16175	8953		0.5333333333333333	0.5625	626	15549	4	0	622	15549	16175	0.07838367515666418
M1	cpdb	0	network_modules	604	TRUE	0.002116236656957348	155	4	3	0.75	0.01935483870967742	GO:0010594	GO:BP	regulation of endothelial cell migration	16175	4242		0.6	0.625	155	16020	3	1	152	16019	16175	0.11953230803392657
M1	cpdb	0	network_modules	604	TRUE	0.0021895717151087847	301	3	3	1	0.009966777408637873	KEGG:04010	KEGG	MAPK signaling pathway	8484	243		0.75	0.8	301	8183	3	0	298	8183	8484	0.09806411731219163
M1	cpdb	0	network_modules	604	TRUE	0.0027419075075628737	744	4	4	1	0.005376344086021506	GO:0072359	GO:BP	circulatory system development	16175	17370		0.6666666666666666	0.6875	744	15431	4	0	740	15431	16175	0.07162623527955848
M1	cpdb	0	network_modules	604	TRUE	0.0031466075986038393	770	4	4	1	0.005194805194805195	GO:0048646	GO:BP	anatomical structure formation involved in morphogenesis	16175	12904		0.7333333333333333	0.75	770	15405	4	0	766	15405	16175	0.07034723721869703
M1	cpdb	0	network_modules	604	TRUE	0.003393785221493802	16	4	2	0.5	0.125	GO:0072012	GO:BP	glomerulus vasculature development	16175	17048		0.8	0.8125	16	16159	2	2	14	16157	16175	0.24965977593568692
M1	cpdb	0	network_modules	604	TRUE	0.0036281217186794213	356	3	3	1	0.008426966292134831	KEGG:04151	KEGG	PI3K-Akt signaling pathway	8484	285		1	1	356	8128	3	0	353	8128	8484	0.08986776567517764
M1	cpdb	0	network_modules	604	TRUE	0.003845972661947621	17	4	2	0.5	0.11764705882352941	GO:0061437	GO:BP	renal system vasculature development	16175	15472		0.8666666666666667	0.9375	17	16158	2	2	15	16156	16175	0.2421830455760906
M1	cpdb	0	network_modules	604	TRUE	0.003845972661947621	17	4	2	0.5	0.11764705882352941	GO:0061440	GO:BP	kidney vasculature development	16175	15475		0.8666666666666667	0.9375	17	16158	2	2	15	16156	16175	0.2421830455760906
M1	cpdb	0	network_modules	604	TRUE	0.004288252538788436	196	4	3	0.75	0.015306122448979591	GO:0043542	GO:BP	endothelial cell migration	16175	10759		1	1	196	15979	3	1	193	15978	16175	0.10606943203904223
M1	cpdb	0	network_modules	608	TRUE	3.294716546085134e-4	9	3	2	0.6666666666666666	0.2222222222222222	REAC:R-HSA-3785653	REAC	Myoclonic epilepsy of Lafora	10916	1503		0	0.2	9	10907	2	1	7	10906	10916	0.3846355971777174
M1	cpdb	0	network_modules	608	TRUE	8.325766564043051e-4	14	3	2	0.6666666666666666	0.14285714285714285	REAC:R-HSA-3322077	REAC	Glycogen synthesis	10916	1073		0.25	0.4	14	10902	2	1	12	10901	10916	0.30825307569254096
M1	cpdb	0	network_modules	608	TRUE	9.606066488074039e-4	15	3	2	0.6666666666666666	0.13333333333333333	REAC:R-HSA-3229121	REAC	Glycogen storage diseases	10916	1072		0.5	0.6	15	10901	2	1	13	10900	10916	0.29777342010998115
M1	cpdb	0	network_modules	608	TRUE	0.002742912597541342	25	3	2	0.6666666666666666	0.08	REAC:R-HSA-8982491	REAC	Glycogen metabolism	10916	1064		0.75	0.8	25	10891	2	1	23	10890	10916	0.23044241792134862
M1	cpdb	0	network_modules	608	TRUE	0.0048251637903800396	33	3	2	0.6666666666666666	0.06060606060606061	REAC:R-HSA-5663084	REAC	Diseases of carbohydrate metabolism	10916	763		1	1	33	10883	2	1	31	10882	10916	0.20042675288201525
M1	cpdb	0	network_modules	610	TRUE	0.006259976765371717	131	2	2	1	0.015267175572519083	KEGG:04142	KEGG	Lysosome	8484	279		NA	1	131	8353	2	0	129	8353	8484	0.12261721750023377
M1	cpdb	0	network_modules	611	TRUE	4.6979173434767313e-8	8	3	3	1	0.375	REAC:R-HSA-444821	REAC	Relaxin receptors	10916	2053		0	0.25	8	10908	3	0	5	10908	10916	0.6122321345425118
M1	cpdb	0	network_modules	611	TRUE	2.740935470985429e-6	129	4	4	1	0.031007751937984496	KEGG:04926	KEGG	Relaxin signaling pathway	8484	383		0	0.5	129	8355	4	0	125	8355	8484	0.1747875285106489
M1	cpdb	0	network_modules	611	TRUE	1.8110661310123015e-4	365	4	4	1	0.010958904109589041	KEGG:04080	KEGG	Neuroactive ligand-receptor interaction	8484	263		1	1	365	8119	4	0	361	8119	8484	0.10243229613150731
M1	cpdb	0	network_modules	611	TRUE	5.206466895908084e-4	156	3	3	1	0.019230769230769232	REAC:R-HSA-418555	REAC	G alpha (s) signalling events	10916	989		0.3333333333333333	0.5	156	10760	3	0	153	10760	10916	0.13769950727697977
M1	cpdb	0	network_modules	611	TRUE	0.0010208448550303208	195	3	3	1	0.015384615384615385	REAC:R-HSA-375276	REAC	Peptide ligand-binding receptors	10916	1726		0.6666666666666666	0.75	195	10721	3	0	192	10721	10916	0.122938778034972
M1	cpdb	0	network_modules	611	TRUE	0.0048888339930051395	328	3	3	1	0.009146341463414634	REAC:R-HSA-373076	REAC	Class A/1 (Rhodopsin-like receptors)	10916	365		1	1	328	10588	3	0	325	10588	10916	0.0942016683117276
M1	cpdb	0	network_modules	613	TRUE	7.799935660657043e-4	19	2	2	1	0.10526315789473684	REAC:R-HSA-3000480	REAC	Scavenging by Class A Receptors	10916	2180		NA	1	19	10897	2	0	17	10897	10916	0.32419006244733173
M1	cpdb	0	network_modules	614	TRUE	1.2465456555382572e-5	30	4	3	0.75	0.1	REAC:R-HSA-9680350	REAC	Signaling by CSF1 (M-CSF) in myeloid cells	10916	2226		0	0.5	30	10886	3	1	27	10885	10916	0.27328354770919544
M1	cpdb	0	network_modules	614	TRUE	0.0012732994063267206	10	4	2	0.5	0.2	GO:0045657	GO:BP	positive regulation of monocyte differentiation	16175	11508		0	0.14285714285714285	10	16165	2	2	8	16163	16175	0.3159735061817264
M1	cpdb	0	network_modules	614	TRUE	0.0018671977926583044	12	4	2	0.5	0.16666666666666666	GO:0045651	GO:BP	positive regulation of macrophage differentiation	16175	11502		0.16666666666666666	0.2857142857142857	12	16163	2	2	10	16161	16175	0.2883894502100615
M1	cpdb	0	network_modules	614	TRUE	0.0025740450520222633	14	4	2	0.5	0.14285714285714285	GO:0010759	GO:BP	positive regulation of macrophage chemotaxis	16175	4380		0.3333333333333333	0.42857142857142855	14	16161	2	2	12	16159	16175	0.26694714088648164
M1	cpdb	0	network_modules	614	TRUE	0.003393785221493802	16	4	2	0.5	0.125	GO:0045655	GO:BP	regulation of monocyte differentiation	16175	11506		0.5	0.5714285714285714	16	16159	2	2	14	16157	16175	0.24965977593568692
M1	cpdb	0	network_modules	614	TRUE	0.003494265362984361	98	2	2	1	0.02040816326530612	KEGG:04061	KEGG	Viral protein interaction with cytokine and cytokine receptor	8484	254		NA	1	98	8386	2	0	96	8386	8484	0.1420464076683573
M1	cpdb	0	network_modules	614	TRUE	0.004326362348540647	18	4	2	0.5	0.1111111111111111	GO:0045649	GO:BP	regulation of macrophage differentiation	16175	11500		0.6666666666666666	0.7142857142857143	18	16157	2	2	16	16155	16175	0.23533773430016888
M1	cpdb	0	network_modules	614	TRUE	0.004620445367777783	24	4	2	0.5	0.08333333333333333	REAC:R-HSA-449836	REAC	Other interleukin signaling	10916	1651		1	1	24	10892	2	2	22	10890	10916	0.20348763012649823
M1	cpdb	0	network_modules	614	TRUE	0.005371720491023053	20	4	2	0.5	0.1	GO:1905523	GO:BP	positive regulation of macrophage migration	16175	24699		0.8333333333333334	0.8571428571428571	20	16155	2	2	18	16153	16175	0.22321945948355051
M1	cpdb	0	network_modules	614	TRUE	0.005936674963975641	21	4	2	0.5	0.09523809523809523	GO:0010758	GO:BP	regulation of macrophage chemotaxis	16175	4379		1	1	21	16154	2	2	19	16152	16175	0.21781962629720591
M1	cpdb	0	network_modules	625	TRUE	0.007464186036267645	143	2	2	1	0.013986013986013986	KEGG:04550	KEGG	Signaling pathways regulating pluripotency of stem cells	8484	319		NA	1	143	8341	2	0	141	8341	8484	0.1172753953371743
M1	cpdb	0	network_modules	630	TRUE	2.8314213558950658e-5	2	4	2	0.5	1	GO:0032119	GO:BP	sequestering of zinc ion	16175	7374		0	0.15384615384615385	2	16173	2	2	0	16171	16175	0.7070630583989846
M1	cpdb	0	network_modules	630	TRUE	2.8314213558950658e-5	2	4	2	0.5	1	GO:0070488	GO:BP	neutrophil aggregation	16175	16149		0	0.15384615384615385	2	16173	2	2	0	16171	16175	0.7070630583989846
M1	cpdb	0	network_modules	630	TRUE	2.9490013714038288e-5	38	4	3	0.75	0.07894736842105263	GO:0050832	GO:BP	defense response to fungus	16175	13290		0.16666666666666666	0.23076923076923078	38	16137	3	1	35	16136	16175	0.24288538905699725
M1	cpdb	0	network_modules	630	TRUE	3.725933355669333e-5	41	4	3	0.75	0.07317073170731707	GO:0009620	GO:BP	response to fungus	16175	3544		0.25	0.3076923076923077	41	16134	3	1	38	16133	16175	0.23379428114801076
M1	cpdb	0	network_modules	630	TRUE	2.516643687567665e-4	6	4	2	0.5	0.3333333333333333	REAC:R-HSA-6799990	REAC	Metal sequestration by antimicrobial proteins	10916	1443		0	0.14285714285714285	6	10910	2	2	4	10908	10916	0.40798637869251825
M1	cpdb	0	network_modules	630	TRUE	0.0010187235318037853	9	4	2	0.5	0.2222222222222222	GO:0051238	GO:BP	sequestering of metal ion	16175	13588		0.3333333333333333	0.38461538461538464	9	16166	2	2	7	16164	16175	0.33309625079917915
M1	cpdb	0	network_modules	630	TRUE	0.0015561264922747044	11	4	2	0.5	0.18181818181818182	GO:0018119	GO:BP	peptidyl-cysteine S-nitrosylation	16175	5330		0.4166666666666667	0.5384615384615384	11	16164	2	2	9	16162	16175	0.30124093787466694
M1	cpdb	0	network_modules	630	TRUE	0.0015561264922747044	11	4	2	0.5	0.18181818181818182	GO:0017014	GO:BP	protein nitrosylation	16175	5275		0.4166666666666667	0.5384615384615384	11	16164	2	2	9	16162	16175	0.30124093787466694
M1	cpdb	0	network_modules	630	TRUE	0.0017672022304981762	146	4	3	0.75	0.02054794520547945	GO:0062207	GO:BP	regulation of pattern recognition receptor signaling pathway	16175	15863		0.5833333333333334	0.6153846153846154	146	16029	3	1	143	16028	16175	0.12321937799416906
M1	cpdb	0	network_modules	630	TRUE	0.0018671977926583044	12	4	2	0.5	0.16666666666666666	GO:0070486	GO:BP	leukocyte aggregation	16175	16147		0.6666666666666666	0.6923076923076923	12	16163	2	2	10	16161	16175	0.2883894502100615
M1	cpdb	0	network_modules	630	TRUE	0.0022786910263296054	17	4	2	0.5	0.11764705882352941	REAC:R-HSA-5602498	REAC	MyD88 deficiency (TLR2/4)	10916	1498		0.16666666666666666	0.2857142857142857	17	10899	2	2	15	10897	10916	0.2420130338313592
M1	cpdb	0	network_modules	630	TRUE	0.002563213974298041	18	4	2	0.5	0.1111111111111111	REAC:R-HSA-5603041	REAC	IRAK4 deficiency (TLR2/4)	10916	1158		0.3333333333333333	0.42857142857142855	18	10898	2	2	16	10896	10916	0.23516195519816133
M1	cpdb	0	network_modules	630	TRUE	0.0025740450520222633	14	4	2	0.5	0.14285714285714285	GO:0002523	GO:BP	leukocyte migration involved in inflammatory response	16175	1045		0.75	0.7692307692307693	14	16161	2	2	12	16159	16175	0.26694714088648164
M1	cpdb	0	network_modules	630	TRUE	0.0035168464095975726	21	4	2	0.5	0.09523809523809523	REAC:R-HSA-5686938	REAC	Regulation of TLR by endogenous ligand	10916	2010		0.5	0.5714285714285714	21	10895	2	2	19	10893	10916	0.21762755623977673
M1	cpdb	0	network_modules	630	TRUE	0.004620445367777783	24	4	2	0.5	0.08333333333333333	REAC:R-HSA-5668599	REAC	RHO GTPases Activate NADPH Oxidases	10916	1849		0.6666666666666666	0.7142857142857143	24	10892	2	2	22	10890	10916	0.20348763012649823
M1	cpdb	0	network_modules	630	TRUE	0.006529803717193811	22	4	2	0.5	0.09090909090909091	GO:0034121	GO:BP	regulation of toll-like receptor signaling pathway	16175	8429		0.8333333333333334	0.8461538461538461	22	16153	2	2	20	16151	16175	0.21279181343662382
M1	cpdb	0	network_modules	630	TRUE	0.006666137794205181	227	4	3	0.75	0.013215859030837005	GO:0002221	GO:BP	pattern recognition receptor signaling pathway	16175	755		0.9166666666666666	0.9230769230769231	227	15948	3	1	224	15947	16175	0.09840055634533401
M1	cpdb	0	network_modules	630	TRUE	0.007276880419360215	30	4	2	0.5	0.06666666666666667	REAC:R-HSA-5260271	REAC	Diseases of Immune System	10916	759		0.8333333333333334	1	30	10886	2	2	28	10884	10916	0.18185400232505983
M1	cpdb	0	network_modules	630	TRUE	0.007276880419360215	30	4	2	0.5	0.06666666666666667	REAC:R-HSA-5602358	REAC	Diseases associated with the TLR signaling cascade	10916	753		0.8333333333333334	1	30	10886	2	2	28	10884	10916	0.18185400232505983
M1	cpdb	0	network_modules	630	TRUE	0.008178438509248568	243	4	3	0.75	0.012345679012345678	GO:0002758	GO:BP	innate immune response-activating signaling pathway	16175	1269		1	1	243	15932	3	1	240	15931	16175	0.0950257269823134
M1	cpdb	0	network_modules	632	TRUE	2.830721104848348e-4	5	4	2	0.5	0.4	GO:1902857	GO:BP	positive regulation of non-motile cilium assembly	16175	22566		0	0.2	5	16170	2	2	3	16168	16175	0.4470614869492386
M1	cpdb	0	network_modules	632	TRUE	4.245731564225828e-4	6	4	2	0.5	0.3333333333333333	GO:1902855	GO:BP	regulation of non-motile cilium assembly	16175	22564		0.25	0.4	6	16169	2	2	4	16167	16175	0.4080715603825347
M1	cpdb	0	network_modules	632	TRUE	7.113545042256107e-4	108	4	3	0.75	0.027777777777777776	GO:0061640	GO:BP	cytoskeleton-dependent cytokinesis	16175	15599		0.5	0.6	108	16067	3	1	105	16066	16175	0.14355031837130697
M1	cpdb	0	network_modules	632	TRUE	0.0011925902470688201	246	3	3	1	0.012195121951219513	KEGG:05131	KEGG	Shigellosis	8484	428		NA	1	246	8238	3	0	243	8238	8484	0.10883797077897832
M1	cpdb	0	network_modules	632	TRUE	0.0030496353494716263	175	4	3	0.75	0.017142857142857144	GO:0000910	GO:BP	cytokinesis	16175	243		0.75	0.8	175	16000	3	1	172	15999	16175	0.11237702451872121
M1	cpdb	0	network_modules	632	TRUE	0.00715109976083305	23	4	2	0.5	0.08695652173913043	GO:0045724	GO:BP	positive regulation of cilium assembly	16175	11566		1	1	23	16152	2	2	21	16150	16175	0.2080951375401522
M1	cpdb	0	network_modules	634	TRUE	9.222056481421138e-4	11	4	2	0.5	0.18181818181818182	REAC:R-HSA-9664873	REAC	Pexophagy	10916	1730		0	0.14285714285714285	11	10905	2	2	9	10903	10916	0.301110579538925
M1	cpdb	0	network_modules	634	TRUE	0.0013075355858833061	13	4	2	0.5	0.15384615384615385	REAC:R-HSA-209560	REAC	NF-kB is activated and signals survival	10916	1516		0.16666666666666666	0.42857142857142855	13	10903	2	2	11	10901	10916	0.2769051410026544
M1	cpdb	0	network_modules	634	TRUE	0.0013075355858833061	13	4	2	0.5	0.15384615384615385	REAC:R-HSA-209543	REAC	p75NTR recruits signalling complexes	10916	2723		0.16666666666666666	0.42857142857142855	13	10903	2	2	11	10901	10916	0.2769051410026544
M1	cpdb	0	network_modules	634	TRUE	0.0020108555737305294	16	4	2	0.5	0.125	REAC:R-HSA-193639	REAC	p75NTR signals via NF-kB	10916	2725		0.5	0.7142857142857143	16	10900	2	2	14	10898	10916	0.249495728203251
M1	cpdb	0	network_modules	634	TRUE	0.0020108555737305294	16	4	2	0.5	0.125	REAC:R-HSA-205043	REAC	NRIF signals cell death from the nucleus	10916	1549		0.5	0.7142857142857143	16	10900	2	2	14	10898	10916	0.249495728203251
M1	cpdb	0	network_modules	634	TRUE	0.0038680579624495374	22	4	2	0.5	0.09090909090909091	REAC:R-HSA-5205685	REAC	PINK1-PRKN Mediated Mitophagy	10916	1678		0.8333333333333334	0.8571428571428571	22	10894	2	2	20	10892	10916	0.21259460496347032
M1	cpdb	0	network_modules	634	TRUE	0.005873845223360233	27	4	2	0.5	0.07407407407407407	REAC:R-HSA-5205647	REAC	Mitophagy	10916	1478		1	1	27	10889	2	2	25	10887	10916	0.19177047272795533
M1	cpdb	0	network_modules	635	TRUE	0.0019147482169786776	31	3	2	0.6666666666666666	0.06451612903225806	KEGG:03060	KEGG	Protein export	8484	217		NA	1	31	8453	2	1	29	8452	8484	0.20666804971147343
M1	cpdb	0	network_modules	635	TRUE	0.004326362348540647	18	4	2	0.5	0.1111111111111111	GO:0006613	GO:BP	cotranslational protein targeting to membrane	16175	2328		NA	1	18	16157	2	2	16	16155	16175	0.23533773430016888
M1	cpdb	0	network_modules	638	TRUE	0.002116236656957348	155	4	3	0.75	0.01935483870967742	GO:0009451	GO:BP	RNA modification	16175	3498		NA	1	155	16020	3	1	152	16019	16175	0.11953230803392657
M1	cpdb	0	network_modules	642	TRUE	7.66683332179178e-6	39	3	3	1	0.07692307692307693	REAC:R-HSA-420499	REAC	Class C/3 (Metabotropic glutamate/pheromone receptors)	10916	367		0	0.25	39	10877	3	0	36	10877	10916	0.2768922564792782
M1	cpdb	0	network_modules	642	TRUE	8.94282122883248e-6	41	3	3	1	0.07317073170731707	REAC:R-HSA-9717207	REAC	Sensory perception of sweet, bitter, and umami (glutamate) taste	10916	2199		0.3333333333333333	0.5	41	10875	3	0	38	10875	10916	0.2700295260839489
M1	cpdb	0	network_modules	642	TRUE	1.0921196658452368e-5	2	3	2	0.6666666666666666	1	GO:0001582	GO:BP	detection of chemical stimulus involved in sensory perception of sweet taste	16175	365		0	0.16666666666666666	2	16173	2	1	0	16172	16175	0.8164713379547893
M1	cpdb	0	network_modules	642	TRUE	1.3602987450799138e-5	47	3	3	1	0.06382978723404255	REAC:R-HSA-9717189	REAC	Sensory perception of taste	10916	2200		0.6666666666666666	0.75	47	10869	3	0	44	10869	10916	0.2521357424964972
M1	cpdb	0	network_modules	642	TRUE	1.492354208568584e-5	52	3	3	1	0.057692307692307696	GO:0050909	GO:BP	sensory perception of taste	16175	13351		0.2	0.3333333333333333	52	16123	3	0	49	16123	16175	0.23982807203954792
M1	cpdb	0	network_modules	642	TRUE	3.2762239428562035e-5	3	3	2	0.6666666666666666	0.6666666666666666	GO:0050917	GO:BP	sensory perception of umami taste	16175	13359		0.4	0.5	3	16172	2	1	1	16171	16175	0.6666048313958282
M1	cpdb	0	network_modules	642	TRUE	4.805920028029098e-5	85	3	3	1	0.03529411764705882	KEGG:04742	KEGG	Taste transduction	8484	361		0	0.5	85	8399	3	0	82	8399	8484	0.18695686783345603
M1	cpdb	0	network_modules	642	TRUE	6.552177776353408e-5	4	3	2	0.6666666666666666	0.5	GO:0050916	GO:BP	sensory perception of sweet taste	16175	13358		0.6	0.6666666666666666	4	16171	2	1	2	16170	16175	0.5772610151803533
M1	cpdb	0	network_modules	642	TRUE	0.0018010392356935265	253	3	3	1	0.011857707509881422	GO:0007606	GO:BP	sensory perception of chemical stimulus	16175	3065		0.8	0.8333333333333334	253	15922	3	0	250	15922	16175	0.10804814376486138
M1	cpdb	0	network_modules	642	TRUE	0.004205743388642631	312	3	3	1	0.009615384615384616	REAC:R-HSA-418594	REAC	G alpha (i) signalling events	10916	987		1	1	312	10604	3	0	309	10604	10916	0.09665984898263484
M1	cpdb	0	network_modules	642	TRUE	0.004445664331186693	47	3	2	0.6666666666666666	0.0425531914893617	KEGG:04973	KEGG	Carbohydrate digestion and absorption	8484	404		1	1	47	8437	2	1	45	8436	8484	0.16752498288675283
M1	cpdb	0	network_modules	642	TRUE	0.00808026407675292	39	3	2	0.6666666666666666	0.05128205128205128	GO:0050912	GO:BP	detection of chemical stimulus involved in sensory perception of taste	16175	13354		1	1	39	16136	2	1	37	16135	16175	0.18447095172203207
M1	cpdb	0	network_modules	645	TRUE	2.4674489946197286e-6	29	3	3	1	0.10344827586206896	GO:0045116	GO:BP	protein neddylation	16175	11286		0	0.3333333333333333	29	16146	3	0	26	16146	16175	0.3213751084107489
M1	cpdb	0	network_modules	645	TRUE	1.0919846111657282e-4	5	3	2	0.6666666666666666	0.4	GO:2000436	GO:BP	positive regulation of protein neddylation	16175	25751		0.5	0.6666666666666666	5	16170	2	1	3	16169	16175	0.5162860129823625
M1	cpdb	0	network_modules	645	TRUE	0.0020062154006345325	244	3	3	1	0.012295081967213115	REAC:R-HSA-8951664	REAC	Neddylation	10916	1559		NA	1	244	10672	3	0	241	10672	10916	0.1096519968353462
M1	cpdb	0	network_modules	645	TRUE	0.0020734877417595598	20	3	2	0.6666666666666666	0.1	GO:2000434	GO:BP	regulation of protein neddylation	16175	25749		1	1	20	16155	2	1	18	16154	16175	0.25790340281345747
M1	cpdb	0	network_modules	647	TRUE	3.355655245340525e-9	4	3	3	1	0.75	REAC:R-HSA-1296061	REAC	HCN channels	10916	1091		0	0.3333333333333333	4	10912	3	0	1	10912	10916	0.865985724262584
M1	cpdb	0	network_modules	647	TRUE	3.349356051810046e-6	32	3	3	1	0.09375	GO:0071320	GO:BP	cellular response to cAMP	16175	16576		0	0.05	32	16143	3	0	29	16143	16175	0.3059115646022684
M1	cpdb	0	network_modules	647	TRUE	4.0408360108934126e-6	34	3	3	1	0.08823529411764706	GO:0003254	GO:BP	regulation of membrane depolarization	16175	1684		0.05263157894736842	0.1	34	16141	3	0	31	16141	16175	0.2967594252337395
M1	cpdb	0	network_modules	647	TRUE	6.171323580139506e-6	39	3	3	1	0.07692307692307693	GO:0051591	GO:BP	response to cAMP	16175	13808		0.10526315789473684	0.15	39	16136	3	0	36	16136	16175	0.2770412257922045
M1	cpdb	0	network_modules	647	TRUE	2.0836235954566695e-5	58	3	3	1	0.05172413793103448	GO:0051899	GO:BP	membrane depolarization	16175	13983		0.15789473684210525	0.2	58	16117	3	0	55	16117	16175	0.2270423468138765
M1	cpdb	0	network_modules	647	TRUE	3.234897210926619e-5	67	3	3	1	0.04477611940298507	GO:0046683	GO:BP	response to organophosphorus	16175	12314		0.21052631578947367	0.25	67	16108	3	0	64	16108	16175	0.2111845634057583
M1	cpdb	0	network_modules	647	TRUE	4.559783616904682e-5	75	3	3	1	0.04	GO:0014074	GO:BP	response to purine-containing compound	16175	4639		0.2631578947368421	0.3	75	16100	3	0	72	16100	16175	0.19955428940512696
M1	cpdb	0	network_modules	647	TRUE	1.0919846111657282e-4	5	3	2	0.6666666666666666	0.4	GO:0071321	GO:BP	cellular response to cGMP	16175	16577		0.3157894736842105	0.35	5	16170	2	1	3	16169	16175	0.5162860129823625
M1	cpdb	0	network_modules	647	TRUE	1.483627464484293e-4	103	3	3	1	0.02912621359223301	REAC:R-HSA-1296071	REAC	Potassium Channels	10916	1780		0.5	0.6666666666666666	103	10813	3	0	100	10813	10916	0.16988030768226756
M1	cpdb	0	network_modules	647	TRUE	1.637909389408838e-4	6	3	2	0.6666666666666666	0.3333333333333333	GO:0070305	GO:BP	response to cGMP	16175	16048		0.3684210526315789	0.4	6	16169	2	1	4	16168	16175	0.47127333823288325
M1	cpdb	0	network_modules	647	TRUE	1.756588689026906e-4	117	3	3	1	0.02564102564102564	GO:0035725	GO:BP	sodium ion transmembrane transport	16175	9195		0.42105263157894735	0.45	117	16058	3	0	114	16058	16175	0.15956276629529037
M1	cpdb	0	network_modules	647	TRUE	4.438970453350398e-4	159	3	3	1	0.018867924528301886	GO:0006814	GO:BP	sodium ion transport	16175	2494		0.47368421052631576	0.5	159	16016	3	0	156	16016	16175	0.1366964477426408
M1	cpdb	0	network_modules	647	TRUE	6.784681159861183e-4	183	3	3	1	0.01639344262295082	GO:0071805	GO:BP	potassium ion transmembrane transport	16175	16918		0.5263157894736842	0.55	183	15992	3	0	180	15992	16175	0.12732233853228214
M1	cpdb	0	network_modules	647	TRUE	8.604306620548711e-4	198	3	3	1	0.015151515151515152	GO:0006813	GO:BP	potassium ion transport	16175	2493		0.5789473684210527	0.6	198	15977	3	0	195	15977	16175	0.1223471292394256
M1	cpdb	0	network_modules	647	TRUE	0.0022916550710375388	21	3	2	0.6666666666666666	0.09523809523809523	GO:0086012	GO:BP	membrane depolarization during cardiac muscle cell action potential	16175	17886		0.631578947368421	0.65	21	16154	2	1	19	16153	16175	0.25167235521278336
M1	cpdb	0	network_modules	647	TRUE	0.0024971340131756913	282	3	3	1	0.010638297872340425	GO:0042391	GO:BP	regulation of membrane potential	16175	10141		0.6842105263157895	0.7	282	15893	3	0	279	15893	16175	0.10224854779367558
M1	cpdb	0	network_modules	647	TRUE	0.00252071658603807	22	3	2	0.6666666666666666	0.09090909090909091	GO:0098719	GO:BP	sodium ion import across plasma membrane	16175	18849		0.7368421052631579	0.75	22	16153	2	1	20	16152	16175	0.2458707737811223
M1	cpdb	0	network_modules	647	TRUE	0.0038293896777411626	27	3	2	0.6666666666666666	0.07407407407407407	GO:0086010	GO:BP	membrane depolarization during action potential	16175	17884		0.7894736842105263	0.8	27	16148	2	1	25	16147	16175	0.22187162332806412
M1	cpdb	0	network_modules	647	TRUE	0.00458141937656194	345	3	3	1	0.008695652173913044	GO:0071407	GO:BP	cellular response to organic cyclic compound	16175	16659		0.8421052631578947	0.85	345	15830	3	0	342	15830	16175	0.09225919713188198
M1	cpdb	0	network_modules	647	TRUE	0.008279779353066069	64	3	2	0.6666666666666666	0.03125	KEGG:04929	KEGG	GnRH secretion	8484	386		NA	1	64	8420	2	1	62	8419	8484	0.1432709780855199
M1	cpdb	0	network_modules	647	TRUE	0.008881412737842752	400	3	3	1	0.0075	REAC:R-HSA-112316	REAC	Neuronal System	10916	1590		1	1	400	10516	3	0	397	10516	10916	0.08501270650656163
M1	cpdb	0	network_modules	647	TRUE	0.008948111941806405	431	3	3	1	0.0069605568445475635	GO:1901699	GO:BP	cellular response to nitrogen compound	16175	21652		0.8947368421052632	0.9	431	15744	3	0	428	15744	16175	0.08231854138518924
M1	cpdb	0	network_modules	647	TRUE	0.009327936346089036	437	3	3	1	0.006864988558352402	GO:0014070	GO:BP	response to organic cyclic compound	16175	4635		0.9473684210526315	0.95	437	15738	3	0	434	15738	16175	0.08173589322395253
M1	cpdb	0	network_modules	647	TRUE	0.009845173484584356	43	3	2	0.6666666666666666	0.046511627906976744	GO:1990573	GO:BP	potassium ion import across plasma membrane	16175	25222		1	1	43	16132	2	1	41	16131	16175	0.1756378801439702
M1	cpdb	0	network_modules	650	TRUE	0.004014030902986451	105	2	2	1	0.01904761904761905	KEGG:04928	KEGG	Parathyroid hormone synthesis, secretion and action	8484	385		NA	1	105	8379	2	0	103	8379	8484	0.13717258073824373
M1	cpdb	0	network_modules	653	TRUE	6.039206301591784e-4	12	3	2	0.6666666666666666	0.16666666666666666	REAC:R-HSA-1433617	REAC	Regulation of signaling by NODAL	10916	2050		0	0.5	12	10904	2	1	10	10903	10916	0.3330125109557372
M1	cpdb	0	network_modules	653	TRUE	0.002313472617518886	23	3	2	0.6666666666666666	0.08695652173913043	REAC:R-HSA-1181150	REAC	Signaling by NODAL	10916	2273		1	1	23	10893	2	1	21	10892	10916	0.24029702124942165
M1	cpdb	0	network_modules	653	TRUE	0.006870710990708103	36	3	2	0.6666666666666666	0.05555555555555555	GO:0009948	GO:BP	anterior/posterior axis specification	16175	3786		NA	1	36	16139	2	1	34	16138	16175	0.19203921355844009
M1	cpdb	0	network_modules	656	TRUE	8.3891381133513e-9	5	3	3	1	0.6	REAC:R-HSA-2142850	REAC	Hyaluronan biosynthesis and export	10916	1134		0	0.25	5	10911	3	0	2	10911	10916	0.774525686728689
M1	cpdb	0	network_modules	656	TRUE	1.931281916971113e-7	13	3	3	1	0.23076923076923078	GO:0030213	GO:BP	hyaluronan biosynthetic process	16175	6722		0	0.07692307692307693	13	16162	3	0	10	16162	16175	0.4802359149317893
M1	cpdb	0	network_modules	656	TRUE	5.704613917078885e-7	17	3	3	1	0.17647058823529413	REAC:R-HSA-2142845	REAC	Hyaluronan metabolism	10916	1135		0.3333333333333333	0.5	17	10899	3	0	14	10899	10916	0.4198144813723684
M1	cpdb	0	network_modules	656	TRUE	7.698116731982747e-7	20	3	3	1	0.15	GO:0030212	GO:BP	hyaluronan metabolic process	16175	6721		0.08333333333333333	0.15384615384615385	20	16155	3	0	17	16155	16175	0.38709471716798444
M1	cpdb	0	network_modules	656	TRUE	3.684291656991038e-6	33	3	3	1	0.09090909090909091	GO:0085029	GO:BP	extracellular matrix assembly	16175	17872		0.16666666666666666	0.23076923076923078	33	16142	3	0	30	16142	16175	0.3012315542258971
M1	cpdb	0	network_modules	656	TRUE	2.4303089577549098e-5	61	3	3	1	0.04918032786885246	GO:1903510	GO:BP	mucopolysaccharide metabolic process	16175	23060		0.25	0.3076923076923077	61	16114	3	0	58	16114	16175	0.2213683475409664
M1	cpdb	0	network_modules	656	TRUE	3.0900510671537764e-5	66	3	3	1	0.045454545454545456	GO:0006024	GO:BP	glycosaminoglycan biosynthetic process	16175	1897		0.3333333333333333	0.38461538461538464	66	16109	3	0	63	16109	16175	0.21278503642036736
M1	cpdb	0	network_modules	656	TRUE	3.234897210926619e-5	67	3	3	1	0.04477611940298507	GO:0006023	GO:BP	aminoglycan biosynthetic process	16175	1896		0.4166666666666667	0.46153846153846156	67	16108	3	0	64	16108	16175	0.2111845634057583
M1	cpdb	0	network_modules	656	TRUE	5.980221208635006e-5	82	3	3	1	0.036585365853658534	GO:0030203	GO:BP	glycosaminoglycan metabolic process	16175	6712		0.5	0.5384615384615384	82	16093	3	0	79	16093	16175	0.19080525894000389
M1	cpdb	0	network_modules	656	TRUE	7.933111874327498e-5	90	3	3	1	0.03333333333333333	GO:0006022	GO:BP	aminoglycan metabolic process	16175	1895		0.5833333333333334	0.6153846153846154	90	16085	3	0	87	16085	16175	0.18208242926735604
M1	cpdb	0	network_modules	656	TRUE	2.665648635517377e-4	125	3	3	1	0.024	REAC:R-HSA-1630316	REAC	Glycosaminoglycan metabolism	10916	1076		0.6666666666666666	0.75	125	10791	3	0	122	10791	10916	0.15405095307142927
M1	cpdb	0	network_modules	656	TRUE	3.930496337734984e-4	9	3	2	0.6666666666666666	0.2222222222222222	GO:0036120	GO:BP	cellular response to platelet-derived growth factor stimulus	16175	9456		0.6666666666666666	0.6923076923076923	9	16166	2	1	7	16165	16175	0.38472164991098856
M1	cpdb	0	network_modules	656	TRUE	4.912917840149466e-4	10	3	2	0.6666666666666666	0.2	GO:0036119	GO:BP	response to platelet-derived growth factor	16175	9455		0.75	0.7692307692307693	10	16165	2	1	8	16164	16175	0.3649564167636381
M1	cpdb	0	network_modules	656	TRUE	0.0014605758424802414	236	3	3	1	0.012711864406779662	GO:0030198	GO:BP	extracellular matrix organization	16175	6707		0.8333333333333334	0.8461538461538461	236	15939	3	0	233	15939	16175	0.11193175027220635
M1	cpdb	0	network_modules	656	TRUE	0.001479301173794092	237	3	3	1	0.012658227848101266	GO:0043062	GO:BP	extracellular structure organization	16175	10509		0.9166666666666666	0.9230769230769231	237	15938	3	0	234	15938	16175	0.11169185382304198
M1	cpdb	0	network_modules	656	TRUE	0.0014981858696297618	238	3	3	1	0.012605042016806723	GO:0045229	GO:BP	external encapsulating structure organization	16175	11340		1	1	238	15937	3	0	235	15937	16175	0.11145346344036322
M1	cpdb	0	network_modules	656	TRUE	0.003305266726176485	288	3	3	1	0.010416666666666666	REAC:R-HSA-71387	REAC	Metabolism of carbohydrates	10916	1422		1	1	288	10628	3	0	285	10628	10916	0.10072054770631735
M1	cpdb	0	network_modules	657	TRUE	2.2929786068967136e-4	7	3	2	0.6666666666666666	0.2857142857142857	GO:0002933	GO:BP	lipid hydroxylation	16175	1441		0	0.2	7	16168	2	1	5	16167	16175	0.4362873362648091
M1	cpdb	0	network_modules	657	TRUE	4.912917840149466e-4	10	3	2	0.6666666666666666	0.2	GO:0070989	GO:BP	oxidative demethylation	16175	16419		0.25	0.4	10	16165	2	1	8	16164	16175	0.3649564167636381
M1	cpdb	0	network_modules	657	TRUE	0.001146111150345736	15	3	2	0.6666666666666666	0.13333333333333333	GO:0070988	GO:BP	demethylation	16175	16418		0.5	0.6	15	16160	2	1	13	16159	16175	0.29789344298100395
M1	cpdb	0	network_modules	657	TRUE	0.0011540255685065697	23	2	2	1	0.08695652173913043	REAC:R-HSA-211981	REAC	Xenobiotics	10916	2677		0	0.5	23	10893	2	0	21	10893	10916	0.29460007760859136
M1	cpdb	0	network_modules	657	TRUE	0.001390207406144211	62	2	2	1	0.03225806451612903	KEGG:00140	KEGG	Steroid hormone biosynthesis	8484	17		0	0.3333333333333333	62	8422	2	0	60	8422	8484	0.17896892834049777
M1	cpdb	0	network_modules	657	TRUE	0.0016254619645609948	67	2	2	1	0.029850746268656716	KEGG:05204	KEGG	Chemical carcinogenesis - DNA adducts	8484	456		0.5	0.6666666666666666	67	8417	2	0	65	8417	8484	0.1721104047813823
M1	cpdb	0	network_modules	657	TRUE	0.0016747183877295119	68	2	2	1	0.029411764705882353	KEGG:00830	KEGG	Retinol metabolism	8484	127		1	1	68	8416	2	0	66	8416	8484	0.17083005111004895
M1	cpdb	0	network_modules	657	TRUE	0.0044290709453424304	29	3	2	0.6666666666666666	0.06896551724137931	GO:0042573	GO:BP	retinoic acid metabolic process	16175	10249		0.75	0.8	29	16146	2	1	27	16145	16175	0.21405766387249664
M1	cpdb	0	network_modules	657	TRUE	0.005759023252348881	33	3	2	0.6666666666666666	0.06060606060606061	GO:0008210	GO:BP	estrogen metabolic process	16175	3137		1	1	33	16142	2	1	31	16141	16175	0.2006157612716187
M1	cpdb	0	network_modules	657	TRUE	0.009195713620985127	64	2	2	1	0.03125	REAC:R-HSA-211897	REAC	Cytochrome P450 - arranged by substrate type	10916	423		1	1	64	10852	2	0	62	10852	10916	0.1762738656728775
M1	cpdb	0	network_modules	659	TRUE	2.701093590169388e-9	4	3	3	1	0.75	GO:0044278	GO:BP	disruption of cell wall in another organism	16175	10947		0	0.14285714285714285	4	16171	3	0	1	16171	16175	0.8659986279128109
M1	cpdb	0	network_modules	659	TRUE	8.103280770508186e-8	10	3	3	1	0.3	GO:0140975	GO:BP	disruption of cellular anatomical structure in another organism	16175	19959		0.16666666666666666	0.2857142857142857	10	16165	3	0	7	16165	16175	0.547604004670564
M1	cpdb	0	network_modules	659	TRUE	3.538027439083378e-5	69	3	3	1	0.043478260869565216	GO:0141060	GO:BP	disruption of anatomical structure in another organism	16175	19996		0.3333333333333333	0.42857142857142855	69	16106	3	0	66	16106	16175	0.20808849205844884
M1	cpdb	0	network_modules	659	TRUE	5.137209899143152e-5	78	3	3	1	0.038461538461538464	GO:0061844	GO:BP	antimicrobial humoral immune response mediated by antimicrobial peptide	16175	15685		0.5	0.5714285714285714	78	16097	3	0	75	16097	16175	0.19566084812237194
M1	cpdb	0	network_modules	659	TRUE	2.04351910837663e-4	123	3	3	1	0.024390243902439025	GO:0019730	GO:BP	antimicrobial humoral response	16175	6021		0.6666666666666666	0.7142857142857143	123	16052	3	0	120	16052	16175	0.1555932602072986
M1	cpdb	0	network_modules	659	TRUE	0.0012480564998993032	224	3	3	1	0.013392857142857142	GO:0006959	GO:BP	humoral immune response	16175	2590		0.8333333333333334	0.8571428571428571	224	15951	3	0	221	15951	16175	0.11493404971194514
M1	cpdb	0	network_modules	659	TRUE	0.0014605758424802414	236	3	3	1	0.012711864406779662	GO:0043434	GO:BP	response to peptide hormone	16175	10691		1	1	236	15939	3	0	233	15939	16175	0.11193175027220635
M1	cpdb	0	network_modules	660	TRUE	8.981136187313249e-7	21	3	3	1	0.14285714285714285	GO:0052695	GO:BP	cellular glucuronidation	16175	14152		0	0.2	21	16154	3	0	18	16154	16175	0.3777540706266271
M1	cpdb	0	network_modules	660	TRUE	1.1959091870474974e-6	23	3	3	1	0.13043478260869565	GO:0006063	GO:BP	uronic acid metabolic process	16175	1930		0.25	0.6	23	16152	3	0	20	16152	16175	0.3609341674135441
M1	cpdb	0	network_modules	660	TRUE	1.1959091870474974e-6	23	3	3	1	0.13043478260869565	GO:0019585	GO:BP	glucuronate metabolic process	16175	5912		0.25	0.6	23	16152	3	0	20	16152	16175	0.3609341674135441
M1	cpdb	0	network_modules	660	TRUE	1.929501766070792e-6	25	3	3	1	0.12	REAC:R-HSA-156588	REAC	Glucuronidation	10916	1054		0	0.2	25	10891	3	0	22	10891	10916	0.34606081356548346
M1	cpdb	0	network_modules	660	TRUE	1.9755022085449094e-6	30	3	3	1	0.1	KEGG:00053	KEGG	Ascorbate and aldarate metabolism	8484	8		0	0.08333333333333333	30	8454	3	0	27	8454	8484	0.3157239954705416
M1	cpdb	0	network_modules	660	TRUE	3.474159056406562e-6	36	3	3	1	0.08333333333333333	KEGG:00040	KEGG	Pentose and glucuronate interconversions	8484	5		0.09090909090909091	0.16666666666666666	36	8448	3	0	33	8448	8484	0.2881129624262479
M1	cpdb	0	network_modules	660	TRUE	6.004845506318434e-6	43	3	3	1	0.06976744186046512	KEGG:00860	KEGG	Porphyrin metabolism	8484	128		0.18181818181818182	0.25	43	8441	3	0	40	8441	8484	0.2635116486172567
M1	cpdb	0	network_modules	660	TRUE	1.035303534568683e-5	43	3	3	1	0.06976744186046512	REAC:R-HSA-9749641	REAC	Aspirin ADME	10916	171		0.25	0.4	43	10873	3	0	40	10873	10916	0.26365075296840695
M1	cpdb	0	network_modules	660	TRUE	1.8402338307184354e-5	62	3	3	1	0.04838709677419355	KEGG:00140	KEGG	Steroid hormone biosynthesis	8484	17		0.2727272727272727	0.3333333333333333	62	8422	3	0	59	8422	8484	0.21920419923267398
M1	cpdb	0	network_modules	660	TRUE	2.3309466330133993e-5	67	3	3	1	0.04477611940298507	KEGG:05204	KEGG	Chemical carcinogenesis - DNA adducts	8484	456		0.36363636363636365	0.4166666666666667	67	8417	3	0	64	8417	8484	0.21080376247175198
M1	cpdb	0	network_modules	660	TRUE	2.4385287853063256e-5	68	3	3	1	0.04411764705882353	KEGG:00982	KEGG	Drug metabolism - cytochrome P450	8484	156		0.45454545454545453	0.5833333333333334	68	8416	3	0	65	8416	8484	0.2092355634337309
M1	cpdb	0	network_modules	660	TRUE	2.4385287853063256e-5	68	3	3	1	0.04411764705882353	KEGG:00830	KEGG	Retinol metabolism	8484	127		0.45454545454545453	0.5833333333333334	68	8416	3	0	65	8416	8484	0.2092355634337309
M1	cpdb	0	network_modules	660	TRUE	3.154186087850138e-5	74	3	3	1	0.04054054054054054	KEGG:00980	KEGG	Metabolism of xenobiotics by cytochrome P450	8484	154		0.6363636363636364	0.6666666666666666	74	8410	3	0	71	8410	8484	0.20050224225819893
M1	cpdb	0	network_modules	660	TRUE	3.847801456884805e-5	79	3	3	1	0.0379746835443038	KEGG:00983	KEGG	Drug metabolism - other enzymes	8484	157		0.7272727272727273	0.75	79	8405	3	0	76	8405	8484	0.19399583637009363
M1	cpdb	0	network_modules	660	TRUE	5.52576189190135e-5	89	3	3	1	0.033707865168539325	KEGG:04976	KEGG	Bile secretion	8484	407		0.8181818181818182	0.8333333333333334	89	8395	3	0	86	8395	8484	0.18266378087491605
M1	cpdb	0	network_modules	660	TRUE	1.6184325248277335e-4	106	3	3	1	0.02830188679245283	REAC:R-HSA-156580	REAC	Phase II - Conjugation of compounds	10916	1738		0.5	0.6	106	10810	3	0	103	10810	10916	0.16743585497071176
M1	cpdb	0	network_modules	660	TRUE	1.6651180784285302e-4	107	3	3	1	0.028037383177570093	REAC:R-HSA-9748784	REAC	Drug ADME	10916	796		0.75	0.8	107	10809	3	0	104	10809	10916	0.16664389938564111
M1	cpdb	0	network_modules	660	TRUE	2.8478178093801235e-4	153	3	3	1	0.0196078431372549	KEGG:01240	KEGG	Biosynthesis of cofactors	8484	190		0.9090909090909091	0.9166666666666666	153	8331	3	0	150	8331	8484	0.13878417483653263
M1	cpdb	0	network_modules	660	TRUE	7.510144128846731e-4	211	3	3	1	0.014218009478672985	KEGG:05207	KEGG	Chemical carcinogenesis - receptor activation	8484	459		1	1	211	8273	3	0	208	8273	8484	0.11776802185028673
M1	cpdb	0	network_modules	660	TRUE	0.0013702440683132906	215	3	3	1	0.013953488372093023	REAC:R-HSA-211859	REAC	Biological oxidations	10916	227		1	1	215	10701	3	0	212	10701	10916	0.11697188855984345
M1	cpdb	0	network_modules	660	TRUE	0.0015753318036585908	242	3	3	1	0.012396694214876033	GO:0008202	GO:BP	steroid metabolic process	16175	3129		0.75	0.8	242	15933	3	0	239	15933	16175	0.11051465088934323
M1	cpdb	0	network_modules	660	TRUE	0.005759023252348881	33	3	2	0.6666666666666666	0.06060606060606061	GO:0008210	GO:BP	estrogen metabolic process	16175	3137		1	1	33	16142	2	1	31	16141	16175	0.2006157612716187
M1	cpdb	0	network_modules	661	TRUE	1.6954277070581312e-4	11	2	2	1	0.18181818181818182	GO:0035723	GO:BP	interleukin-15-mediated signaling pathway	16175	9193		0	0.6	11	16164	2	0	9	16164	16175	0.426282773620928
M1	cpdb	0	network_modules	661	TRUE	1.6954277070581312e-4	11	2	2	1	0.18181818181818182	GO:0070672	GO:BP	response to interleukin-15	16175	16253		0	0.6	11	16164	2	0	9	16164	16175	0.426282773620928
M1	cpdb	0	network_modules	661	TRUE	1.6954277070581312e-4	11	2	2	1	0.18181818181818182	GO:0071350	GO:BP	cellular response to interleukin-15	16175	16602		0	0.6	11	16164	2	0	9	16164	16175	0.426282773620928
M1	cpdb	0	network_modules	661	TRUE	8.325766564043051e-4	14	3	2	0.6666666666666666	0.14285714285714285	REAC:R-HSA-8983432	REAC	Interleukin-15 signaling	10916	1237		0	0.5	14	10902	2	1	12	10901	10916	0.30825307569254096
M1	cpdb	0	network_modules	661	TRUE	0.0038913909617740374	44	3	2	0.6666666666666666	0.045454545454545456	KEGG:04672	KEGG	Intestinal immune network for IgA production	8484	344		NA	1	44	8440	2	1	42	8439	8484	0.17320371249089678
M1	cpdb	0	network_modules	661	TRUE	0.005274321466866296	59	2	2	1	0.03389830508474576	GO:0050766	GO:BP	positive regulation of phagocytosis	16175	13240		0.75	0.8	59	16116	2	0	57	16116	16175	0.18379019057702187
M1	cpdb	0	network_modules	661	TRUE	0.008639265299683726	44	3	2	0.6666666666666666	0.045454545454545456	REAC:R-HSA-451927	REAC	Interleukin-2 family signaling	10916	1240		1	1	44	10872	2	1	42	10871	10916	0.17339875254737833
M1	cpdb	0	network_modules	661	TRUE	0.009987610492487902	81	2	2	1	0.024691358024691357	GO:0050764	GO:BP	regulation of phagocytosis	16175	13238		1	1	81	16094	2	0	79	16094	16175	0.15675059341054035
M1	cpdb	0	network_modules	662	TRUE	0.0010208448550303208	195	3	3	1	0.015384615384615385	REAC:R-HSA-375276	REAC	Peptide ligand-binding receptors	10916	1726		0	0.3333333333333333	195	10721	3	0	192	10721	10916	0.122938778034972
M1	cpdb	0	network_modules	662	TRUE	0.0013321833876068286	213	3	3	1	0.014084507042253521	REAC:R-HSA-416476	REAC	G alpha (q) signalling events	10916	988		0.5	0.6666666666666666	213	10703	3	0	210	10703	10916	0.11753075087246338
M1	cpdb	0	network_modules	662	TRUE	0.0039111197087069605	365	3	3	1	0.00821917808219178	KEGG:04080	KEGG	Neuroactive ligand-receptor interaction	8484	263		NA	1	365	8119	3	0	362	8119	8484	0.08870374059865381
M1	cpdb	0	network_modules	662	TRUE	0.0048888339930051395	328	3	3	1	0.009146341463414634	REAC:R-HSA-373076	REAC	Class A/1 (Rhodopsin-like receptors)	10916	365		1	1	328	10588	3	0	325	10588	10916	0.0942016683117276
M1	cpdb	0	network_modules	662	TRUE	0.005120703516213635	358	3	3	1	0.008379888268156424	GO:0008015	GO:BP	blood circulation	16175	3096		0	0.5	358	15817	3	0	355	15817	16175	0.09053141429152059
M1	cpdb	0	network_modules	662	TRUE	0.009456892631544296	439	3	3	1	0.00683371298405467	GO:0003013	GO:BP	circulatory system process	16175	1464		1	1	439	15736	3	0	436	15736	16175	0.0815443122787777
M1	cpdb	0	network_modules	674	TRUE	0.00702450346047476	56	2	2	1	0.03571428571428571	REAC:R-HSA-72187	REAC	mRNA 3'-end processing	10916	2701		0	0.5	56	10860	2	0	54	10860	10916	0.18851413612190576
M1	cpdb	0	network_modules	674	TRUE	0.009487641037524355	65	2	2	1	0.03076923076923077	REAC:R-HSA-73856	REAC	RNA Polymerase II Transcription Termination	10916	1895		1	1	65	10851	2	0	63	10851	10916	0.17490459795874555
M1	cpdb	0	network_modules	683	TRUE	3.7768877396746205e-4	168	3	3	1	0.017857142857142856	KEGG:04141	KEGG	Protein processing in endoplasmic reticulum	8484	278		NA	1	168	8316	3	0	165	8316	8484	0.13232432741736927
M1	cpdb	0	network_modules	683	TRUE	6.673456878551998e-4	182	3	3	1	0.016483516483516484	GO:0006457	GO:BP	protein folding	16175	2203		NA	1	182	15993	3	0	179	15993	16175	0.12767563768832096
M1	cpdb	0	network_modules	684	TRUE	3.8817002138770055e-4	33	2	2	1	0.06060606060606061	KEGG:01210	KEGG	2-Oxocarboxylic acid metabolism	8484	185		NA	1	33	8451	2	0	31	8451	8484	0.2457326955716985
M1	cpdb	0	network_modules	684	TRUE	0.0018662159487509247	19	3	2	0.6666666666666666	0.10526315789473684	GO:0009083	GO:BP	branched-chain amino acid catabolic process	16175	3256		0	0.5	19	16156	2	1	17	16155	16175	0.26461970208734953
M1	cpdb	0	network_modules	684	TRUE	0.001920508610013286	21	3	2	0.6666666666666666	0.09523809523809523	REAC:R-HSA-70895	REAC	Branched-chain amino acid catabolism	10916	254		NA	1	21	10895	2	1	19	10894	10916	0.25152578306476736
M1	cpdb	0	network_modules	684	TRUE	0.003545877492329801	26	3	2	0.6666666666666666	0.07692307692307693	GO:0009081	GO:BP	branched-chain amino acid metabolic process	16175	3254		1	1	26	16149	2	1	24	16148	16175	0.22611214812597225
