network_method	network_db	network_cutoff	experiment_info	func_module_number	significant	p_value	term_size	query_size	intersection_size	precision	recall	term_id	source	term_name	effective_domain_size	source_order	parents	perc_rank	cumelative_dist	P	N	tp	fp	fn	tn	tot_pop_valid	MCC
R1	cpdb	0	network_modules	1	TRUE	1.0706292658932235e-11	131	21	10	0.47619047619047616	0.07633587786259542	KEGG:04142	KEGG	Lysosome	8484	279		NA	1	131	8353	10	11	121	8342	8484	0.18614709319820752
R1	cpdb	0	network_modules	1	TRUE	1.3757513068019553e-8	36	21	6	0.2857142857142857	0.16666666666666666	REAC:R-HSA-9840310	REAC	Glycosphingolipid catabolism	10916	1078		0	0.25	36	10880	6	15	30	10865	10916	0.21626375148629998
R1	cpdb	0	network_modules	1	TRUE	6.538205995754993e-8	46	21	6	0.2857142857142857	0.13043478260869565	REAC:R-HSA-1660662	REAC	Glycosphingolipid metabolism	10916	1079		0.3333333333333333	0.5	46	10870	6	15	40	10855	10916	0.1907852135814885
R1	cpdb	0	network_modules	1	TRUE	1.6475783234516884e-7	21	25	5	0.2	0.23809523809523808	GO:0019377	GO:BP	glycolipid catabolic process	16175	5738		0	0.08333333333333333	21	16154	5	20	16	16134	16175	0.2171100497137049
R1	cpdb	0	network_modules	1	TRUE	3.4714994003011533e-6	37	25	5	0.2	0.13513513513513514	GO:0046466	GO:BP	membrane lipid catabolic process	16175	12174		0.09090909090909091	0.16666666666666666	37	16138	5	20	32	16118	16175	0.16283077233420043
R1	cpdb	0	network_modules	1	TRUE	3.855026607958823e-6	89	21	6	0.2857142857142857	0.06741573033707865	REAC:R-HSA-428157	REAC	Sphingolipid metabolism	10916	2349		0.6666666666666666	0.75	89	10827	6	15	83	10812	10916	0.13550930268337583
R1	cpdb	0	network_modules	1	TRUE	2.418798763803228e-5	19	25	4	0.16	0.21052631578947367	GO:0046479	GO:BP	glycosphingolipid catabolic process	16175	12186		0.18181818181818182	0.25	19	16156	4	21	15	16135	16175	0.18243330355913667
R1	cpdb	0	network_modules	1	TRUE	1.624140176254548e-4	7	25	3	0.12	0.42857142857142855	GO:0046477	GO:BP	glycosylceramide catabolic process	16175	12184		0.2727272727272727	0.3333333333333333	7	16168	3	22	4	16146	16175	0.22618460430073142
R1	cpdb	0	network_modules	1	TRUE	2.2139417037615e-4	32	25	4	0.16	0.125	GO:0030149	GO:BP	sphingolipid catabolic process	16175	6683		0.36363636363636365	0.4166666666666667	32	16143	4	21	28	16122	16175	0.13991925302498212
R1	cpdb	0	network_modules	1	TRUE	3.700240925653236e-4	92	25	5	0.2	0.05434782608695652	GO:0006664	GO:BP	glycolipid metabolic process	16175	2373		0.45454545454545453	0.5	92	16083	5	20	87	16063	16175	0.10166013389620004
R1	cpdb	0	network_modules	1	TRUE	3.906443177131924e-4	93	25	5	0.2	0.053763440860215055	GO:1903509	GO:BP	liposaccharide metabolic process	16175	23059		0.5454545454545454	0.5833333333333334	93	16082	5	20	88	16062	16175	0.10108306886123505
R1	cpdb	0	network_modules	1	TRUE	4.2250245759077284e-4	12	21	3	0.14285714285714285	0.25	REAC:R-HSA-1663150	REAC	The activation of arylsulfatases	10916	2498		1	1	12	10904	3	18	9	10886	10916	0.1878118959846124
R1	cpdb	0	network_modules	1	TRUE	6.123930105337236e-4	196	25	6	0.24	0.030612244897959183	GO:1901136	GO:BP	carbohydrate derivative catabolic process	16175	21244		0.6363636363636364	0.6666666666666666	196	15979	6	19	190	15960	16175	0.08194759979715938
R1	cpdb	0	network_modules	1	TRUE	0.0023695478935030147	57	25	4	0.16	0.07017543859649122	GO:0006687	GO:BP	glycosphingolipid metabolic process	16175	2395		0.7272727272727273	0.75	57	16118	4	21	53	16097	16175	0.10389218557707551
R1	cpdb	0	network_modules	1	TRUE	0.002423114151578036	248	25	6	0.24	0.024193548387096774	GO:0016042	GO:BP	lipid catabolic process	16175	5076		0.8181818181818182	0.8333333333333334	248	15927	6	19	242	15908	16175	0.07194089451263563
R1	cpdb	0	network_modules	1	TRUE	0.0031234301241226206	17	25	3	0.12	0.17647058823529413	GO:0006677	GO:BP	glycosylceramide metabolic process	16175	2385		0.9090909090909091	0.9166666666666666	17	16158	3	22	14	16136	16175	0.14443436822943198
R1	cpdb	0	network_modules	1	TRUE	0.00522033197525266	20	25	3	0.12	0.15	GO:0046514	GO:BP	ceramide catabolic process	16175	12213		1	1	20	16155	3	22	17	16133	16175	0.13296661929196105
R1	cpdb	0	network_modules	2	TRUE	4.009588640883723e-10	10	17	5	0.29411764705882354	0.5	REAC:R-HSA-418890	REAC	Role of second messengers in netrin-1 signaling	10916	2110		0	0.14285714285714285	10	10906	5	12	5	10894	10916	0.382761450984001
R1	cpdb	0	network_modules	2	TRUE	1.538124431900211e-7	28	17	5	0.29411764705882354	0.17857142857142858	REAC:R-HSA-3295583	REAC	TRP channels	10916	2474		0.16666666666666666	0.2857142857142857	28	10888	5	12	23	10876	10916	0.22764520955001197
R1	cpdb	0	network_modules	2	TRUE	2.0746673355810206e-6	40	21	5	0.23809523809523808	0.125	GO:0051480	GO:BP	regulation of cytosolic calcium ion concentration	16175	13738		0	0.1	40	16135	5	16	35	16119	16175	0.17104712627748878
R1	cpdb	0	network_modules	2	TRUE	2.9273430677573927e-6	49	17	5	0.29411764705882354	0.10204081632653061	REAC:R-HSA-373752	REAC	Netrin-1 signaling	10916	1586		0.3333333333333333	0.42857142857142855	49	10867	5	12	44	10855	10916	0.17111322149391534
R1	cpdb	0	network_modules	2	TRUE	5.6717084390449225e-6	324	21	8	0.38095238095238093	0.024691358024691357	GO:0006816	GO:BP	calcium ion transport	16175	2495		0.1111111111111111	0.2	324	15851	8	13	316	15838	16175	0.09288076328718181
R1	cpdb	0	network_modules	2	TRUE	2.6793012429482498e-5	249	21	7	0.3333333333333333	0.028112449799196786	GO:0070588	GO:BP	calcium ion transmembrane transport	16175	16193		0.2222222222222222	0.3	249	15926	7	14	242	15912	16175	0.09311184973802525
R1	cpdb	0	network_modules	2	TRUE	8.195784143456181e-5	64	12	4	0.3333333333333333	0.0625	KEGG:04929	KEGG	GnRH secretion	8484	386		0	0.5	64	8420	4	8	60	8412	8484	0.14170646211064217
R1	cpdb	0	network_modules	2	TRUE	1.4078814969509482e-4	105	17	5	0.29411764705882354	0.047619047619047616	REAC:R-HSA-2672351	REAC	Stimuli-sensing channels	10916	2354		0.5	0.5714285714285714	105	10811	5	12	100	10799	10916	0.11511911017715122
R1	cpdb	0	network_modules	2	TRUE	1.7258435830690583e-4	181	12	5	0.4166666666666667	0.027624309392265192	KEGG:04360	KEGG	Axon guidance	8484	305		1	1	181	8303	5	7	176	8296	8484	0.10296838505034524
R1	cpdb	0	network_modules	2	TRUE	5.578777615804748e-4	233	21	6	0.2857142857142857	0.02575107296137339	GO:0006874	GO:BP	intracellular calcium ion homeostasis	16175	2532		0.3333333333333333	0.4	233	15942	6	15	227	15927	16175	0.08209737651184419
R1	cpdb	0	network_modules	2	TRUE	5.783898292704148e-4	16	17	3	0.17647058823529413	0.1875	REAC:R-HSA-139853	REAC	Elevation of cytosolic Ca2+ levels	10916	839		0.6666666666666666	0.7142857142857143	16	10900	3	14	13	10886	10916	0.1806639517172271
R1	cpdb	0	network_modules	2	TRUE	7.673339063840448e-4	246	21	6	0.2857142857142857	0.024390243902439025	GO:0055074	GO:BP	calcium ion homeostasis	16175	14230		0.4444444444444444	0.5	246	15929	6	15	240	15914	16175	0.07969450854922079
R1	cpdb	0	network_modules	2	TRUE	0.0016660503110503848	677	21	8	0.38095238095238093	0.011816838995568686	GO:0030001	GO:BP	metal ion transport	16175	6646		0.5555555555555556	0.6	677	15498	8	13	669	15485	16175	0.06105293357514996
R1	cpdb	0	network_modules	2	TRUE	0.0021379471083024784	182	17	5	0.29411764705882354	0.027472527472527472	REAC:R-HSA-983712	REAC	Ion channel transport	10916	1272		0.8333333333333334	0.8571428571428571	182	10734	5	12	177	10722	10916	0.08557657007788441
R1	cpdb	0	network_modules	2	TRUE	0.0033447138902351014	28	17	3	0.17647058823529413	0.10714285714285714	REAC:R-HSA-418360	REAC	Platelet calcium homeostasis	10916	1763		1	1	28	10888	3	14	25	10874	10916	0.1357860084762307
R1	cpdb	0	network_modules	2	TRUE	0.0035247023299654766	748	21	8	0.38095238095238093	0.0106951871657754	GO:0006812	GO:BP	monoatomic cation transport	16175	2492		0.6666666666666666	0.7	748	15427	8	13	740	15414	16175	0.05746305099095306
R1	cpdb	0	network_modules	2	TRUE	0.0076585455499403885	575	21	7	0.3333333333333333	0.01217391304347826	GO:0098662	GO:BP	inorganic cation transmembrane transport	16175	18818		0.7777777777777778	0.8	575	15600	7	14	568	15586	16175	0.05798557644851031
R1	cpdb	0	network_modules	2	TRUE	0.007835793164174884	577	21	7	0.3333333333333333	0.012131715771230503	GO:0098655	GO:BP	monoatomic cation transmembrane transport	16175	18811		0.8888888888888888	0.9	577	15598	7	14	570	15584	16175	0.05786466838083935
R1	cpdb	0	network_modules	2	TRUE	0.008362769168120454	93	21	4	0.19047619047619047	0.043010752688172046	GO:0051928	GO:BP	positive regulation of calcium ion transport	16175	13999		1	1	93	16082	4	17	89	16065	16175	0.08809104800883613
R1	cpdb	0	network_modules	3	TRUE	8.076360271312165e-12	774	27	16	0.5925925925925926	0.020671834625323	GO:0007186	GO:BP	G protein-coupled receptor signaling pathway	16175	2744		0	0.2	774	15401	16	11	758	15390	16175	0.10435467259975696
R1	cpdb	0	network_modules	3	TRUE	7.082622266691426e-8	217	27	9	0.3333333333333333	0.041474654377880185	GO:0007188	GO:BP	adenylate cyclase-modulating G protein-coupled receptor signaling pathway	16175	2746		0.25	0.4	217	15958	9	18	208	15940	16175	0.11370663144545391
R1	cpdb	0	network_modules	3	TRUE	1.8484409808758284e-6	251	19	8	0.42105263157894735	0.03187250996015936	KEGG:04020	KEGG	Calcium signaling pathway	8484	250		0	0.3333333333333333	251	8233	8	11	243	8222	8484	0.1094570669672176
R1	cpdb	0	network_modules	3	TRUE	3.7576144850230433e-6	140	27	7	0.25925925925925924	0.05	GO:0007189	GO:BP	adenylate cyclase-activating G protein-coupled receptor signaling pathway	16175	2747		0.5	0.6	140	16035	7	20	133	16015	16175	0.11062573601761445
R1	cpdb	0	network_modules	3	TRUE	2.847279371488479e-5	213	21	7	0.3333333333333333	0.03286384976525822	REAC:R-HSA-416476	REAC	G alpha (q) signalling events	10916	988		0	0.3333333333333333	213	10703	7	14	206	10689	10916	0.09960899709246965
R1	cpdb	0	network_modules	3	TRUE	4.3589572707915963e-4	58	19	4	0.21052631578947367	0.06896551724137931	KEGG:04923	KEGG	Regulation of lipolysis in adipocytes	8484	380		0.5	0.6666666666666666	58	8426	4	15	54	8411	8484	0.11711399286009172
R1	cpdb	0	network_modules	3	TRUE	5.116084181212545e-4	365	19	7	0.3684210526315789	0.019178082191780823	KEGG:04080	KEGG	Neuroactive ligand-receptor interaction	8484	263		1	1	365	8119	7	12	358	8107	8484	0.07597703612761555
R1	cpdb	0	network_modules	3	TRUE	5.310078046888408e-4	328	21	7	0.3333333333333333	0.021341463414634148	REAC:R-HSA-373076	REAC	Class A/1 (Rhodopsin-like receptors)	10916	365		0.5	0.6666666666666666	328	10588	7	14	321	10574	10916	0.07799515007641032
R1	cpdb	0	network_modules	3	TRUE	0.0024828293908336577	122	27	5	0.18518518518518517	0.040983606557377046	GO:0008277	GO:BP	regulation of G protein-coupled receptor signaling pathway	16175	3149		0.75	0.8	122	16053	5	22	117	16031	16175	0.0839568435844559
R1	cpdb	0	network_modules	3	TRUE	0.004958568296375354	460	21	7	0.3333333333333333	0.015217391304347827	REAC:R-HSA-500792	REAC	GPCR ligand binding	10916	1019		1	1	460	10456	7	14	453	10442	10916	0.06363254812411841
R1	cpdb	0	network_modules	3	TRUE	0.00844875176401832	21	27	3	0.1111111111111111	0.14285714285714285	GO:0071880	GO:BP	adenylate cyclase-activating adrenergic receptor signaling pathway	16175	16961		1	1	21	16154	3	24	18	16130	16175	0.12470105400611571
R1	cpdb	0	network_modules	4	TRUE	7.662070786093351e-15	43	25	9	0.36	0.20930232558139536	GO:1990573	GO:BP	potassium ion import across plasma membrane	16175	25222		0	0.07142857142857142	43	16132	9	16	34	16116	16175	0.2730443818671967
R1	cpdb	0	network_modules	4	TRUE	6.2344766999271e-14	35	18	8	0.4444444444444444	0.22857142857142856	REAC:R-HSA-1296065	REAC	Inwardly rectifying K+ channels	10916	1271		0	0.07142857142857142	35	10881	8	10	27	10871	10916	0.31719840684588774
R1	cpdb	0	network_modules	4	TRUE	1.0503013341801928e-10	117	25	9	0.36	0.07692307692307693	GO:0099587	GO:BP	inorganic ion import across plasma membrane	16175	19152		0.07692307692307693	0.21428571428571427	117	16058	9	16	108	16042	16175	0.1637860279111621
R1	cpdb	0	network_modules	4	TRUE	1.0503013341801928e-10	117	25	9	0.36	0.07692307692307693	GO:0098659	GO:BP	inorganic cation import across plasma membrane	16175	18815		0.07692307692307693	0.21428571428571427	117	16058	9	16	108	16042	16175	0.1637860279111621
R1	cpdb	0	network_modules	4	TRUE	1.0819108232667792e-10	183	25	10	0.4	0.0546448087431694	GO:0071805	GO:BP	potassium ion transmembrane transport	16175	16918		0.23076923076923078	0.2857142857142857	183	15992	10	15	173	15977	16175	0.1445939979576428
R1	cpdb	0	network_modules	4	TRUE	2.394173373449361e-10	198	25	10	0.4	0.050505050505050504	GO:0006813	GO:BP	potassium ion transport	16175	2493		0.3076923076923077	0.35714285714285715	198	15977	10	15	188	15962	16175	0.1387425198607835
R1	cpdb	0	network_modules	4	TRUE	5.957061182972422e-10	103	18	8	0.4444444444444444	0.07766990291262135	REAC:R-HSA-1296071	REAC	Potassium Channels	10916	1780		0.07692307692307693	0.14285714285714285	103	10813	8	10	95	10803	10916	0.18286587159180145
R1	cpdb	0	network_modules	4	TRUE	1.5972477546623236e-9	4	18	4	0.2222222222222222	1	REAC:R-HSA-1296025	REAC	ATP sensitive Potassium channels	10916	39		0.15384615384615385	0.21428571428571427	4	10912	4	14	0	10898	10916	0.4711020198069048
R1	cpdb	0	network_modules	4	TRUE	5.924803259995677e-9	182	25	9	0.36	0.04945054945054945	GO:0098739	GO:BP	import across plasma membrane	16175	18866		0.38461538461538464	0.42857142857142855	182	15993	9	16	173	15977	16175	0.13008858149772423
R1	cpdb	0	network_modules	4	TRUE	1.7725092574553047e-8	748	25	13	0.52	0.017379679144385027	GO:0006812	GO:BP	monoatomic cation transport	16175	2492		0.46153846153846156	0.5	748	15427	13	12	735	15415	16175	0.08875463204660884
R1	cpdb	0	network_modules	4	TRUE	1.8435455533403678e-8	577	25	12	0.48	0.02079722703639515	GO:0098655	GO:BP	monoatomic cation transmembrane transport	16175	18811		0.5384615384615384	0.5714285714285714	577	15598	12	13	565	15585	16175	0.09425600344794823
R1	cpdb	0	network_modules	4	TRUE	1.0664222359088444e-7	671	25	12	0.48	0.01788375558867362	GO:0034220	GO:BP	monoatomic ion transmembrane transport	16175	8508		0.6153846153846154	0.6428571428571429	671	15504	12	13	659	15491	16175	0.08652279911063701
R1	cpdb	0	network_modules	4	TRUE	1.219697766694782e-6	400	18	9	0.5	0.0225	REAC:R-HSA-112316	REAC	Neuronal System	10916	1590		0.23076923076923078	0.2857142857142857	400	10516	9	9	391	10507	10916	0.1002273831364043
R1	cpdb	0	network_modules	4	TRUE	1.899467476129045e-6	43	18	5	0.2777777777777778	0.11627906976744186	REAC:R-HSA-991365	REAC	Activation of GABAB receptors	10916	83		0.3076923076923077	0.42857142857142855	43	10873	5	13	38	10860	10916	0.17766919358686453
R1	cpdb	0	network_modules	4	TRUE	1.899467476129045e-6	43	18	5	0.2777777777777778	0.11627906976744186	REAC:R-HSA-977444	REAC	GABA B receptor activation	10916	1010		0.3076923076923077	0.42857142857142855	43	10873	5	13	38	10860	10916	0.17766919358686453
R1	cpdb	0	network_modules	4	TRUE	2.3737745417477928e-6	677	25	11	0.44	0.01624815361890694	GO:0030001	GO:BP	metal ion transport	16175	6646		0.6923076923076923	0.7142857142857143	677	15498	11	14	666	15484	16175	0.07822353634698583
R1	cpdb	0	network_modules	4	TRUE	8.600673718744612e-6	575	25	10	0.4	0.017391304347826087	GO:0098662	GO:BP	inorganic cation transmembrane transport	16175	18818		0.7692307692307693	0.7857142857142857	575	15600	10	15	565	15585	16175	0.07744106713647647
R1	cpdb	0	network_modules	4	TRUE	1.059616747533447e-5	60	18	5	0.2777777777777778	0.08333333333333333	REAC:R-HSA-977443	REAC	GABA receptor activation	10916	1011		0.46153846153846156	0.5	60	10856	5	13	55	10843	10916	0.1496695955828029
R1	cpdb	0	network_modules	4	TRUE	2.058235770401667e-5	630	25	10	0.4	0.015873015873015872	GO:0098660	GO:BP	inorganic ion transmembrane transport	16175	18816		0.8461538461538461	0.8571428571428571	630	15545	10	15	620	15530	16175	0.07342280131316027
R1	cpdb	0	network_modules	4	TRUE	3.286342289402417e-5	76	19	5	0.2631578947368421	0.06578947368421052	KEGG:04971	KEGG	Gastric acid secretion	8484	402		NA	1	76	8408	5	14	71	8394	8484	0.12781626769910462
R1	cpdb	0	network_modules	4	TRUE	3.6974309067320126e-5	29	18	4	0.2222222222222222	0.13793103448275862	REAC:R-HSA-1296059	REAC	G protein gated Potassium channels	10916	995		0.5384615384615384	0.7142857142857143	29	10887	4	14	25	10873	10916	0.1733554540152339
R1	cpdb	0	network_modules	4	TRUE	3.6974309067320126e-5	29	18	4	0.2222222222222222	0.13793103448275862	REAC:R-HSA-1296041	REAC	Activation of G protein gated Potassium channels	10916	82		0.5384615384615384	0.7142857142857143	29	10887	4	14	25	10873	10916	0.1733554540152339
R1	cpdb	0	network_modules	4	TRUE	3.6974309067320126e-5	29	18	4	0.2222222222222222	0.13793103448275862	REAC:R-HSA-997272	REAC	Inhibition  of voltage gated Ca2+ channels via Gbeta/gamma subunits	10916	1188		0.5384615384615384	0.7142857142857143	29	10887	4	14	25	10873	10916	0.1733554540152339
R1	cpdb	0	network_modules	4	TRUE	7.926640268529954e-4	2	18	2	0.1111111111111111	1	REAC:R-HSA-5683177	REAC	Defective ABCC8 can cause hypo- and hyper-glycemias	10916	467		0.7692307692307693	0.8571428571428571	2	10914	2	16	0	10898	10916	0.3330889092246938
R1	cpdb	0	network_modules	4	TRUE	7.926640268529954e-4	2	18	2	0.1111111111111111	1	REAC:R-HSA-5678420	REAC	Defective ABCC9 causes CMD10, ATFB12 and Cantu syndrome	10916	468		0.7692307692307693	0.8571428571428571	2	10914	2	16	0	10898	10916	0.3330889092246938
R1	cpdb	0	network_modules	4	TRUE	0.0012605468526021518	740	25	9	0.36	0.012162162162162163	GO:0098657	GO:BP	import into cell	16175	18813		0.9230769230769231	0.9285714285714286	740	15435	9	16	731	15419	16175	0.05917451048100634
R1	cpdb	0	network_modules	4	TRUE	0.0023756679785927656	3	18	2	0.1111111111111111	0.6666666666666666	REAC:R-HSA-1296067	REAC	Potassium transport channels	10916	1781		0.9230769230769231	0.9285714285714286	3	10913	2	16	1	10897	10916	0.27175380533553956
R1	cpdb	0	network_modules	4	TRUE	0.003332107294997113	262	25	6	0.24	0.022900763358778626	GO:0034765	GO:BP	regulation of monoatomic ion transmembrane transport	16175	8734		1	1	262	15913	6	19	256	15894	16175	0.06975344065870011
R1	cpdb	0	network_modules	4	TRUE	0.0038777042506005686	196	18	5	0.2777777777777778	0.025510204081632654	REAC:R-HSA-112314	REAC	Neurotransmitter receptors and postsynaptic signal transmission	10916	1594		1	1	196	10720	5	13	191	10707	10916	0.07952023921951228
R1	cpdb	0	network_modules	5	TRUE	0.00293052110335139	2	23	2	0.08695652173913043	1	GO:0051412	GO:BP	response to corticosterone	16175	13699		NA	1	2	16173	2	21	0	16152	16175	0.29469240258173435
R1	cpdb	0	network_modules	5	TRUE	0.003342657390845911	3	21	2	0.09523809523809523	0.6666666666666666	REAC:R-HSA-4341670	REAC	Defective NEU1 causes sialidosis	10916	597		NA	1	3	10913	2	19	1	10894	10916	0.25152578306476736
R1	cpdb	0	network_modules	5	TRUE	0.007681080136697778	232	19	5	0.2631578947368421	0.021551724137931036	KEGG:04714	KEGG	Thermogenesis	8484	349		NA	1	232	8252	5	14	227	8238	8484	0.068502565527139625
R1	cpdb	0	network_modules	6	TRUE	5.957030705805177e-23	43	18	12	0.6666666666666666	0.27906976744186046	KEGG:03022	KEGG	Basal transcription factors	8484	213		0	0.5	43	8441	12	6	31	8435	8484	0.42959674763902783
R1	cpdb	0	network_modules	6	TRUE	5.936861435659144e-22	46	21	12	0.5714285714285714	0.2608695652173913	REAC:R-HSA-167162	REAC	RNA Polymerase II HIV Promoter Escape	10916	1887		0	0.13953488372093023	46	10870	12	9	34	10861	10916	0.3844264401231462
R1	cpdb	0	network_modules	6	TRUE	5.936861435659144e-22	46	21	12	0.5714285714285714	0.2608695652173913	REAC:R-HSA-73779	REAC	RNA Polymerase II Transcription Pre-Initiation And Promoter Opening	10916	1894		0	0.13953488372093023	46	10870	12	9	34	10861	10916	0.3844264401231462
R1	cpdb	0	network_modules	6	TRUE	5.936861435659144e-22	46	21	12	0.5714285714285714	0.2608695652173913	REAC:R-HSA-76042	REAC	RNA Polymerase II Transcription Initiation And Promoter Clearance	10916	1893		0	0.13953488372093023	46	10870	12	9	34	10861	10916	0.3844264401231462
R1	cpdb	0	network_modules	6	TRUE	5.936861435659144e-22	46	21	12	0.5714285714285714	0.2608695652173913	REAC:R-HSA-75953	REAC	RNA Polymerase II Transcription Initiation	10916	1892		0	0.13953488372093023	46	10870	12	9	34	10861	10916	0.3844264401231462
R1	cpdb	0	network_modules	6	TRUE	5.936861435659144e-22	46	21	12	0.5714285714285714	0.2608695652173913	REAC:R-HSA-73776	REAC	RNA Polymerase II Promoter Escape	10916	1889		0	0.13953488372093023	46	10870	12	9	34	10861	10916	0.3844264401231462
R1	cpdb	0	network_modules	6	TRUE	5.936861435659144e-22	46	21	12	0.5714285714285714	0.2608695652173913	REAC:R-HSA-167161	REAC	HIV Transcription Initiation	10916	1105		0	0.13953488372093023	46	10870	12	9	34	10861	10916	0.3844264401231462
R1	cpdb	0	network_modules	6	TRUE	8.861659414966841e-20	26	21	10	0.47619047619047616	0.38461538461538464	REAC:R-HSA-167160	REAC	RNA Pol II CTD phosphorylation and interaction with CE during HIV infection	10916	1880		0.14285714285714285	0.18604651162790697	26	10890	10	11	16	10879	10916	0.42673860140344766
R1	cpdb	0	network_modules	6	TRUE	8.861659414966841e-20	26	21	10	0.47619047619047616	0.38461538461538464	REAC:R-HSA-77075	REAC	RNA Pol II CTD phosphorylation and interaction with CE	10916	1879		0.14285714285714285	0.18604651162790697	26	10890	10	11	16	10879	10916	0.42673860140344766
R1	cpdb	0	network_modules	6	TRUE	1.321521443021482e-19	69	21	12	0.5714285714285714	0.17391304347826086	REAC:R-HSA-167172	REAC	Transcription of the HIV genome	10916	2540		0.19047619047619047	0.20930232558139536	69	10847	12	9	57	10838	10916	0.3130482787805747
R1	cpdb	0	network_modules	6	TRUE	2.1853329804644273e-19	28	21	10	0.47619047619047616	0.35714285714285715	REAC:R-HSA-72086	REAC	mRNA Capping	10916	2702		0.21428571428571427	0.23255813953488372	28	10888	10	11	18	10877	10916	0.4110943439710388
R1	cpdb	0	network_modules	6	TRUE	8.956146771942028e-19	80	21	12	0.5714285714285714	0.15	REAC:R-HSA-674695	REAC	RNA Polymerase II Pre-transcription Events	10916	1888		0.23809523809523808	0.2558139534883721	80	10836	12	9	68	10827	10916	0.29035952176388274
R1	cpdb	0	network_modules	6	TRUE	1.0703529229562975e-18	32	21	10	0.47619047619047616	0.3125	REAC:R-HSA-167158	REAC	Formation of the HIV-1 Early Elongation Complex	10916	965		0.2619047619047619	0.3023255813953488	32	10884	10	11	22	10873	10916	0.38431663450750747
R1	cpdb	0	network_modules	6	TRUE	1.0703529229562975e-18	32	21	10	0.47619047619047616	0.3125	REAC:R-HSA-113418	REAC	Formation of the Early Elongation Complex	10916	963		0.2619047619047619	0.3023255813953488	32	10884	10	11	22	10873	10916	0.38431663450750747
R1	cpdb	0	network_modules	6	TRUE	2.4190020801825598e-17	42	21	10	0.47619047619047616	0.23809523809523808	REAC:R-HSA-167246	REAC	Tat-mediated elongation of the HIV-1 transcript	10916	2485		0.30952380952380953	0.37209302325581395	42	10874	10	11	32	10863	10916	0.3349636275197148
R1	cpdb	0	network_modules	6	TRUE	2.4190020801825598e-17	42	21	10	0.47619047619047616	0.23809523809523808	REAC:R-HSA-167169	REAC	HIV Transcription Elongation	10916	1104		0.30952380952380953	0.37209302325581395	42	10874	10	11	32	10863	10916	0.3349636275197148
R1	cpdb	0	network_modules	6	TRUE	2.4190020801825598e-17	42	21	10	0.47619047619047616	0.23809523809523808	REAC:R-HSA-167200	REAC	Formation of HIV-1 elongation complex containing HIV-1 Tat	10916	947		0.30952380952380953	0.37209302325581395	42	10874	10	11	32	10863	10916	0.3349636275197148
R1	cpdb	0	network_modules	6	TRUE	4.071605909247234e-17	44	21	10	0.47619047619047616	0.22727272727272727	REAC:R-HSA-167152	REAC	Formation of HIV elongation complex in the absence of HIV Tat	10916	946		0.38095238095238093	0.3953488372093023	44	10872	10	11	34	10861	10916	0.32716543120746283
R1	cpdb	0	network_modules	6	TRUE	4.3855981072210405e-16	61	18	10	0.5555555555555556	0.16393442622950818	KEGG:03420	KEGG	Nucleotide excision repair	8484	238		1	1	61	8423	10	8	51	8415	8484	0.2992744397123988
R1	cpdb	0	network_modules	6	TRUE	4.9848551957857e-16	132	21	12	0.5714285714285714	0.09090909090909091	REAC:R-HSA-162599	REAC	Late Phase of HIV Life Cycle	10916	1304		0.40476190476190477	0.4186046511627907	132	10784	12	9	120	10775	10916	0.2246754409382967
R1	cpdb	0	network_modules	6	TRUE	7.001836678158268e-16	57	21	10	0.47619047619047616	0.17543859649122806	REAC:R-HSA-75955	REAC	RNA Polymerase II Transcription Elongation	10916	1891		0.42857142857142855	0.46511627906976744	57	10859	10	11	47	10848	10916	0.28689259240463316
R1	cpdb	0	network_modules	6	TRUE	7.001836678158268e-16	57	21	10	0.47619047619047616	0.17543859649122806	REAC:R-HSA-112382	REAC	Formation of RNA Pol II elongation complex 	10916	949		0.42857142857142855	0.46511627906976744	57	10859	10	11	47	10848	10916	0.28689259240463316
R1	cpdb	0	network_modules	6	TRUE	1.4567869698289394e-15	61	21	10	0.47619047619047616	0.16393442622950818	REAC:R-HSA-6796648	REAC	TP53 Regulates Transcription of DNA Repair Genes	10916	2456		0.47619047619047616	0.4883720930232558	61	10855	10	11	51	10844	10916	0.2771620826105055
R1	cpdb	0	network_modules	6	TRUE	1.597550745430588e-15	145	21	12	0.5714285714285714	0.08275862068965517	REAC:R-HSA-162587	REAC	HIV Life Cycle	10916	1103		0.5	0.5116279069767442	145	10771	12	9	133	10762	10916	0.2140399439764277
R1	cpdb	0	network_modules	6	TRUE	2.4402556429378264e-15	64	21	10	0.47619047619047616	0.15625	REAC:R-HSA-6782135	REAC	Dual incision in TC-NER	10916	808		0.5238095238095238	0.5348837209302325	64	10852	10	11	54	10841	10916	0.2704674902947927
R1	cpdb	0	network_modules	6	TRUE	8.389839716933597e-15	43	21	9	0.42857142857142855	0.20930232558139536	REAC:R-HSA-5696395	REAC	Formation of Incision Complex in GG-NER	10916	948		0.5476190476190477	0.5581395348837209	43	10873	9	12	34	10861	10916	0.29762103116197147
R1	cpdb	0	network_modules	6	TRUE	1.746226088679013e-14	77	21	10	0.47619047619047616	0.12987012987012986	REAC:R-HSA-6781827	REAC	Transcription-Coupled Nucleotide Excision Repair (TC-NER)	10916	2541		0.5714285714285714	0.5813953488372093	77	10839	10	11	67	10828	10916	0.24610413568877448
R1	cpdb	0	network_modules	6	TRUE	2.019264447772938e-14	47	21	9	0.42857142857142855	0.19148936170212766	REAC:R-HSA-73762	REAC	RNA Polymerase I Transcription Initiation	10916	1885		0.5952380952380952	0.6046511627906976	47	10869	9	12	38	10857	10916	0.2844814030001166
R1	cpdb	0	network_modules	6	TRUE	5.424881766263841e-14	52	21	9	0.42857142857142855	0.17307692307692307	REAC:R-HSA-6781823	REAC	Formation of TC-NER Pre-Incision Complex	10916	951		0.6190476190476191	0.627906976744186	52	10864	9	12	43	10852	10916	0.27022898537635104
R1	cpdb	0	network_modules	6	TRUE	9.940172274591604e-14	31	21	8	0.38095238095238093	0.25806451612903225	REAC:R-HSA-73863	REAC	RNA Polymerase I Transcription Termination	10916	1886		0.6428571428571429	0.6511627906976745	31	10885	8	13	23	10872	10916	0.31195039735864916
R1	cpdb	0	network_modules	6	TRUE	3.4518986011461366e-13	63	21	9	0.42857142857142855	0.14285714285714285	REAC:R-HSA-6782210	REAC	Gap-filling DNA repair synthesis and ligation in TC-NER	10916	1038		0.6666666666666666	0.6744186046511628	63	10853	9	12	54	10841	10916	0.24504703131609815
R1	cpdb	0	network_modules	6	TRUE	3.4663794656627483e-13	225	21	12	0.5714285714285714	0.05333333333333334	REAC:R-HSA-162906	REAC	HIV Infection	10916	1102		0.6904761904761905	0.6976744186046512	225	10691	12	9	213	10682	10916	0.17020259356494422
R1	cpdb	0	network_modules	6	TRUE	6.589085585738496e-13	109	21	10	0.47619047619047616	0.09174311926605505	REAC:R-HSA-5696398	REAC	Nucleotide Excision Repair	10916	1622		0.7142857142857143	0.7209302325581395	109	10807	10	11	99	10796	10916	0.20585943845679866
R1	cpdb	0	network_modules	6	TRUE	2.707883566873526e-12	79	25	9	0.36	0.11392405063291139	GO:0006289	GO:BP	nucleotide-excision repair	16175	2102		0	0.16666666666666666	79	16096	9	16	70	16080	16175	0.20041288732171966
R1	cpdb	0	network_modules	6	TRUE	5.2581577988723075e-12	84	21	9	0.42857142857142855	0.10714285714285714	REAC:R-HSA-5696399	REAC	Global Genome Nucleotide Excision Repair (GG-NER)	10916	1047		0.7380952380952381	0.7441860465116279	84	10832	9	12	75	10820	10916	0.21145602376257855
R1	cpdb	0	network_modules	6	TRUE	3.3599019132875936e-11	329	21	12	0.5714285714285714	0.0364741641337386	REAC:R-HSA-73894	REAC	DNA Repair	10916	444		0.7619047619047619	0.7674418604651163	329	10587	12	9	317	10578	10916	0.1389967401065115
R1	cpdb	0	network_modules	6	TRUE	5.93960431157417e-11	109	21	9	0.42857142857142855	0.08256880733944955	REAC:R-HSA-73854	REAC	RNA Polymerase I Promoter Clearance	10916	1881		0.7857142857142857	0.7906976744186046	109	10807	9	12	100	10795	10916	0.18483257775376027
R1	cpdb	0	network_modules	6	TRUE	6.462423341401893e-11	110	21	9	0.42857142857142855	0.08181818181818182	REAC:R-HSA-73864	REAC	RNA Polymerase I Transcription	10916	1884		0.8095238095238095	0.813953488372093	110	10806	9	12	101	10794	10916	0.18395875600682632
R1	cpdb	0	network_modules	6	TRUE	9.173156398495536e-10	90	21	8	0.38095238095238093	0.08888888888888889	REAC:R-HSA-73772	REAC	RNA Polymerase I Promoter Escape	10916	1882		0.8333333333333334	0.8372093023255814	90	10826	8	13	82	10813	10916	0.18095581460646734
R1	cpdb	0	network_modules	6	TRUE	3.247167927496425e-9	105	21	8	0.38095238095238093	0.0761904761904762	REAC:R-HSA-427413	REAC	NoRC negatively regulates rRNA expression	10916	1602		0.8571428571428571	0.8604651162790697	105	10811	8	13	97	10798	10916	0.16703061233633737
R1	cpdb	0	network_modules	6	TRUE	4.0866411439637465e-9	108	21	8	0.38095238095238093	0.07407407407407407	REAC:R-HSA-5250941	REAC	Negative epigenetic regulation of rRNA expression	10916	1566		0.8809523809523809	0.8837209302325582	108	10808	8	13	100	10795	10916	0.1645953523564141
R1	cpdb	0	network_modules	6	TRUE	7.411642361611251e-9	185	21	9	0.42857142857142855	0.04864864864864865	REAC:R-HSA-212165	REAC	Epigenetic regulation of gene expression	10916	852		0.9047619047619048	0.9069767441860465	185	10731	9	12	176	10719	10916	0.14000840348250232
R1	cpdb	0	network_modules	6	TRUE	3.157156057166712e-8	41	21	6	0.2857142857142857	0.14634146341463414	REAC:R-HSA-5696400	REAC	Dual Incision in GG-NER	10916	807		0.9285714285714286	0.9302325581395349	41	10875	6	15	35	10860	10916	0.20236617701080234
R1	cpdb	0	network_modules	6	TRUE	4.169588016476031e-8	143	25	8	0.32	0.055944055944055944	GO:0006367	GO:BP	transcription initiation at RNA polymerase II promoter	16175	2142		0.2	0.3333333333333333	143	16032	8	17	135	16015	16175	0.13078224873720548
R1	cpdb	0	network_modules	6	TRUE	1.0568069112664888e-7	359	21	10	0.47619047619047616	0.027855153203342618	REAC:R-HSA-3700989	REAC	Transcriptional Regulation by TP53	10916	2546		0.9523809523809523	0.9534883720930233	359	10557	10	11	349	10546	10916	0.10912963798899307
R1	cpdb	0	network_modules	6	TRUE	1.7016210792680037e-7	528	25	11	0.44	0.020833333333333332	GO:0006281	GO:BP	DNA repair	16175	2095		0.4	0.5	528	15647	11	14	517	15633	16175	0.09019256664756596
R1	cpdb	0	network_modules	6	TRUE	1.926391401036675e-7	173	25	8	0.32	0.046242774566473986	GO:0006352	GO:BP	DNA-templated transcription initiation	16175	2129		0.6	0.6666666666666666	173	16002	8	17	165	15985	16175	0.1183052613486986
R1	cpdb	0	network_modules	6	TRUE	7.945131318747407e-7	9	25	4	0.16	0.4444444444444444	GO:0006283	GO:BP	transcription-coupled nucleotide-excision repair	16175	2097		0.8	0.8333333333333334	9	16166	4	21	5	16145	16175	0.2660189293333782
R1	cpdb	0	network_modules	6	TRUE	1.3275467889684885e-5	798	25	11	0.44	0.013784461152882205	GO:0006974	GO:BP	DNA damage response	16175	2601		1	1	798	15377	11	14	787	15363	16175	0.07097327462031938
R1	cpdb	0	network_modules	6	TRUE	6.89658616648413e-5	73	21	5	0.23809523809523808	0.0684931506849315	REAC:R-HSA-6807505	REAC	RNA polymerase II transcribes snRNA genes	10916	1904		0.9761904761904762	0.9767441860465116	73	10843	5	16	68	10827	10916	0.12465261807265644
R1	cpdb	0	network_modules	6	TRUE	0.004346571905437383	25	21	3	0.14285714285714285	0.12	REAC:R-HSA-69273	REAC	Cyclin A/B1/B2 associated events during G2/M transition	10916	418		1	1	25	10891	3	18	22	10873	10916	0.1291037399356338
R1	cpdb	0	network_modules	7	TRUE	4.6285625701027804e-46	43	29	22	0.7586206896551724	0.5116279069767442	KEGG:03022	KEGG	Basal transcription factors	8484	213		0	0.5	43	8441	22	7	21	8434	8484	0.6214770412046027
R1	cpdb	0	network_modules	7	TRUE	7.578520923847144e-33	64	42	19	0.4523809523809524	0.296875	GO:0051123	GO:BP	RNA polymerase II preinitiation complex assembly	16175	13507		0	0.041666666666666664	64	16111	19	23	45	16088	16175	0.36445943868527775
R1	cpdb	0	network_modules	7	TRUE	2.090508030837275e-32	67	42	19	0.4523809523809524	0.2835820895522388	GO:0070897	GO:BP	transcription preinitiation complex assembly	16175	16360		0.043478260869565216	0.08333333333333333	67	16108	19	23	48	16085	16175	0.35609228261920434
R1	cpdb	0	network_modules	7	TRUE	7.407521976583273e-30	173	42	22	0.5238095238095238	0.12716763005780346	GO:0006352	GO:BP	DNA-templated transcription initiation	16175	2129		0.08695652173913043	0.125	173	16002	22	20	151	15982	16175	0.2545159784443169
R1	cpdb	0	network_modules	7	TRUE	4.539314022022548e-29	46	40	17	0.425	0.3695652173913043	REAC:R-HSA-75953	REAC	RNA Polymerase II Transcription Initiation	10916	1892		0	0.2608695652173913	46	10870	17	23	29	10847	10916	0.39393676986374865
R1	cpdb	0	network_modules	7	TRUE	4.539314022022548e-29	46	40	17	0.425	0.3695652173913043	REAC:R-HSA-73776	REAC	RNA Polymerase II Promoter Escape	10916	1889		0	0.2608695652173913	46	10870	17	23	29	10847	10916	0.39393676986374865
R1	cpdb	0	network_modules	7	TRUE	4.539314022022548e-29	46	40	17	0.425	0.3695652173913043	REAC:R-HSA-167161	REAC	HIV Transcription Initiation	10916	1105		0	0.2608695652173913	46	10870	17	23	29	10847	10916	0.39393676986374865
R1	cpdb	0	network_modules	7	TRUE	4.539314022022548e-29	46	40	17	0.425	0.3695652173913043	REAC:R-HSA-73779	REAC	RNA Polymerase II Transcription Pre-Initiation And Promoter Opening	10916	1894		0	0.2608695652173913	46	10870	17	23	29	10847	10916	0.39393676986374865
R1	cpdb	0	network_modules	7	TRUE	4.539314022022548e-29	46	40	17	0.425	0.3695652173913043	REAC:R-HSA-167162	REAC	RNA Polymerase II HIV Promoter Escape	10916	1887		0	0.2608695652173913	46	10870	17	23	29	10847	10916	0.39393676986374865
R1	cpdb	0	network_modules	7	TRUE	4.539314022022548e-29	46	40	17	0.425	0.3695652173913043	REAC:R-HSA-76042	REAC	RNA Polymerase II Transcription Initiation And Promoter Clearance	10916	1893		0	0.2608695652173913	46	10870	17	23	29	10847	10916	0.39393676986374865
R1	cpdb	0	network_modules	7	TRUE	1.4614007176845526e-27	143	42	20	0.47619047619047616	0.13986013986013987	GO:0006367	GO:BP	transcription initiation at RNA polymerase II promoter	16175	2142		0.13043478260869565	0.16666666666666666	143	16032	20	22	123	16010	16175	0.25473665369926934
R1	cpdb	0	network_modules	7	TRUE	7.004460724636351e-27	55	42	16	0.38095238095238093	0.2909090909090909	GO:0060261	GO:BP	positive regulation of transcription initiation by RNA polymerase II	16175	14478		0.17391304347826086	0.20833333333333334	55	16120	16	26	39	16094	16175	0.3309210258592328
R1	cpdb	0	network_modules	7	TRUE	4.73166609716924e-26	61	42	16	0.38095238095238093	0.26229508196721313	GO:2000144	GO:BP	positive regulation of DNA-templated transcription initiation	16175	25492		0.21739130434782608	0.25	61	16114	16	26	45	16088	16175	0.3139747524050335
R1	cpdb	0	network_modules	7	TRUE	1.4778331335730125e-25	69	40	17	0.425	0.2463768115942029	REAC:R-HSA-167172	REAC	Transcription of the HIV genome	10916	2540		0.2727272727272727	0.30434782608695654	69	10847	17	23	52	10824	10916	0.32037656404504583
R1	cpdb	0	network_modules	7	TRUE	1.9807125225746278e-25	66	42	16	0.38095238095238093	0.24242424242424243	GO:0060260	GO:BP	regulation of transcription initiation by RNA polymerase II	16175	14477		0.2608695652173913	0.2916666666666667	66	16109	16	26	50	16083	16175	0.30164698791584205
R1	cpdb	0	network_modules	7	TRUE	9.444721338804476e-25	72	42	16	0.38095238095238093	0.2222222222222222	GO:2000142	GO:BP	regulation of DNA-templated transcription initiation	16175	25490		0.30434782608695654	0.3333333333333333	72	16103	16	26	56	16077	16175	0.28857448847677303
R1	cpdb	0	network_modules	7	TRUE	1.9200536590866296e-24	40	42	14	0.3333333333333333	0.35	GO:0042789	GO:BP	mRNA transcription by RNA polymerase II	16175	10367		0.34782608695652173	0.375	40	16135	14	28	26	16107	16175	0.33989255581067745
R1	cpdb	0	network_modules	7	TRUE	2.459703496327785e-24	80	40	17	0.425	0.2125	REAC:R-HSA-674695	REAC	RNA Polymerase II Pre-transcription Events	10916	1888		0.3181818181818182	0.34782608695652173	80	10836	17	23	63	10813	10916	0.2969710223436999
R1	cpdb	0	network_modules	7	TRUE	3.4238079004332526e-24	207	42	20	0.47619047619047616	0.0966183574879227	GO:0006282	GO:BP	regulation of DNA repair	16175	2096		0.391304347826087	0.4166666666666667	207	15968	20	22	187	15946	16175	0.21035379635254484
R1	cpdb	0	network_modules	7	TRUE	1.3694877931634242e-23	45	42	14	0.3333333333333333	0.3111111111111111	GO:0009299	GO:BP	mRNA transcription	16175	3446		0.43478260869565216	0.4583333333333333	45	16130	14	28	31	16102	16175	0.32020399565207497
R1	cpdb	0	network_modules	7	TRUE	2.2385866733339333e-23	183	42	19	0.4523809523809524	0.10382513661202186	GO:0065004	GO:BP	protein-DNA complex assembly	16175	15888		0.4782608695652174	0.5	183	15992	19	23	164	15969	16175	0.21278410916755192
R1	cpdb	0	network_modules	7	TRUE	2.299565622023951e-22	206	42	19	0.4523809523809524	0.09223300970873786	GO:0071824	GO:BP	protein-DNA complex organization	16175	16927		0.5217391304347826	0.5416666666666666	206	15969	19	23	187	15946	16175	0.20005125557979234
R1	cpdb	0	network_modules	7	TRUE	2.346452778203706e-20	132	40	17	0.425	0.12878787878787878	REAC:R-HSA-162599	REAC	Late Phase of HIV Life Cycle	10916	1304		0.36363636363636365	0.391304347826087	132	10784	17	23	115	10761	10916	0.22910520508138785
R1	cpdb	0	network_modules	7	TRUE	1.247850116463364e-19	145	40	17	0.425	0.11724137931034483	REAC:R-HSA-162587	REAC	HIV Life Cycle	10916	1103		0.4090909090909091	0.43478260869565216	145	10771	17	23	128	10748	10916	0.21809486528004335
R1	cpdb	0	network_modules	7	TRUE	3.020536234759253e-19	92	40	15	0.375	0.16304347826086957	REAC:R-HSA-6804756	REAC	Regulation of TP53 Activity through Phosphorylation	10916	2016		0.45454545454545453	0.4782608695652174	92	10824	15	25	77	10799	10916	0.24318143224977187
R1	cpdb	0	network_modules	7	TRUE	3.5957127417616356e-19	437	42	21	0.5	0.04805491990846682	GO:0080135	GO:BP	regulation of cellular response to stress	16175	17817		0.5652173913043478	0.5833333333333334	437	15738	21	21	416	15717	16175	0.14884745340601538
R1	cpdb	0	network_modules	7	TRUE	4.636151544938135e-18	141	40	16	0.4	0.11347517730496454	REAC:R-HSA-3214847	REAC	HATs acetylate histones	10916	1087		0.5	0.5217391304347826	141	10775	16	24	125	10751	10916	0.20789547104970857
R1	cpdb	0	network_modules	7	TRUE	1.1840079952215222e-17	435	42	20	0.47619047619047616	0.04597701149425287	GO:0051052	GO:BP	regulation of DNA metabolic process	16175	13462		0.6086956521739131	0.625	435	15740	20	22	415	15718	16175	0.14170918884031755
R1	cpdb	0	network_modules	7	TRUE	2.1197002393422024e-16	175	42	15	0.35714285714285715	0.08571428571428572	GO:0043484	GO:BP	regulation of RNA splicing	16175	10730		0.6521739130434783	0.6666666666666666	175	16000	15	27	160	15973	16175	0.1708104962057665
R1	cpdb	0	network_modules	7	TRUE	2.6564881877074527e-16	225	40	17	0.425	0.07555555555555556	REAC:R-HSA-162906	REAC	HIV Infection	10916	1102		0.5454545454545454	0.5652173913043478	225	10691	17	23	208	10668	10916	0.17260636922595124
R1	cpdb	0	network_modules	7	TRUE	5.454966239436247e-16	528	42	20	0.47619047619047616	0.03787878787878788	GO:0006281	GO:BP	DNA repair	16175	2095		0.6956521739130435	0.7083333333333334	528	15647	20	22	508	15625	16175	0.12735588241362536
R1	cpdb	0	network_modules	7	TRUE	1.78193974516091e-15	160	40	15	0.375	0.09375	REAC:R-HSA-5633007	REAC	Regulation of TP53 Activity	10916	2012		0.5909090909090909	0.6086956521739131	160	10756	15	25	145	10731	10916	0.18183989109180934
R1	cpdb	0	network_modules	7	TRUE	4.216785951970969e-15	798	42	22	0.5238095238095238	0.02756892230576441	GO:0006974	GO:BP	DNA damage response	16175	2601		0.7391304347826086	0.75	798	15377	22	20	776	15357	16175	0.11178580345532994
R1	cpdb	0	network_modules	7	TRUE	1.8841836255267696e-13	271	40	16	0.4	0.05904059040590406	REAC:R-HSA-3247509	REAC	Chromatin modifying enzymes	10916	355		0.6363636363636364	0.6956521739130435	271	10645	16	24	255	10621	10916	0.14622924707097348
R1	cpdb	0	network_modules	7	TRUE	1.8841836255267696e-13	271	40	16	0.4	0.05904059040590406	REAC:R-HSA-4839726	REAC	Chromatin organization	10916	356		0.6363636363636364	0.6956521739130435	271	10645	16	24	255	10621	10916	0.14622924707097348
R1	cpdb	0	network_modules	7	TRUE	4.5821571583952644e-11	397	42	15	0.35714285714285715	0.037783375314861464	GO:0008380	GO:BP	RNA splicing	16175	3186		0.782608695652174	0.7916666666666666	397	15778	15	27	382	15751	16175	0.10967580390660674
R1	cpdb	0	network_modules	7	TRUE	3.098586245867074e-10	359	40	15	0.375	0.04178272980501393	REAC:R-HSA-3700989	REAC	Transcriptional Regulation by TP53	10916	2546		0.7272727272727273	0.7391304347826086	359	10557	15	25	344	10532	10916	0.11633499483958921
R1	cpdb	0	network_modules	7	TRUE	6.674530819022616e-8	73	40	8	0.2	0.1095890410958904	REAC:R-HSA-6807505	REAC	RNA polymerase II transcribes snRNA genes	10916	1904		0.7727272727272727	0.782608695652174	73	10843	8	32	65	10811	10916	0.14384105375229986
R1	cpdb	0	network_modules	7	TRUE	2.0378732763255798e-7	590	42	14	0.3333333333333333	0.023728813559322035	GO:0016071	GO:BP	mRNA metabolic process	16175	5098		0.8260869565217391	0.8333333333333334	590	15585	14	28	576	15557	16175	0.080794105496558
R1	cpdb	0	network_modules	7	TRUE	1.424678214752882e-4	17	42	4	0.09523809523809523	0.23529411764705882	GO:0090043	GO:BP	regulation of tubulin deacetylation	16175	17974		0.8695652173913043	0.875	17	16158	4	38	13	16120	16175	0.14831479881351237
R1	cpdb	0	network_modules	7	TRUE	2.883918200829208e-4	20	42	4	0.09523809523809523	0.2	GO:0090042	GO:BP	tubulin deacetylation	16175	17973		0.9130434782608695	0.9166666666666666	20	16155	4	38	16	16117	16175	0.1364828941063482
R1	cpdb	0	network_modules	7	TRUE	6.277572331977316e-4	24	42	4	0.09523809523809523	0.16666666666666666	GO:0090311	GO:BP	regulation of protein deacetylation	16175	18191		0.9565217391304348	0.9583333333333334	24	16151	4	38	20	16113	16175	0.12427888405333369
R1	cpdb	0	network_modules	7	TRUE	0.0014394019890402998	9	40	3	0.075	0.3333333333333333	REAC:R-HSA-381183	REAC	ATF6 (ATF6-alpha) activates chaperone genes	10916	36		0.8181818181818182	0.8260869565217391	9	10907	3	37	6	10870	10916	0.15672765087886065
R1	cpdb	0	network_modules	7	TRUE	0.0028130448712005178	11	40	3	0.075	0.2727272727272727	REAC:R-HSA-381033	REAC	ATF6 (ATF6-alpha) activates chaperones	10916	37		0.8636363636363636	0.8695652173913043	11	10905	3	37	8	10868	10916	0.14142829363778636
R1	cpdb	0	network_modules	7	TRUE	0.0032967270549985107	201	29	6	0.20689655172413793	0.029850746268656716	KEGG:05203	KEGG	Viral carcinogenesis	8484	455		1	1	201	8283	6	23	195	8260	8484	0.07054854659795354
R1	cpdb	0	network_modules	7	TRUE	0.004724046990044618	39	42	4	0.09523809523809523	0.10256410256410256	GO:0006476	GO:BP	protein deacetylation	16175	2213		1	1	39	16136	4	38	35	16098	16175	0.09657290197876739
R1	cpdb	0	network_modules	7	TRUE	0.005417940661897149	41	40	4	0.1	0.0975609756097561	REAC:R-HSA-9917777	REAC	Epigenetic regulation by WDR5-containing histone modifying complexes	10916	850		0.9090909090909091	0.9565217391304348	41	10875	4	36	37	10839	10916	0.09541710407215821
R1	cpdb	0	network_modules	7	TRUE	0.005417940661897149	41	40	4	0.1	0.0975609756097561	REAC:R-HSA-9772755	REAC	Formation of WDR5-containing histone-modifying complexes	10916	952		0.9090909090909091	0.9565217391304348	41	10875	4	36	37	10839	10916	0.09541710407215821
R1	cpdb	0	network_modules	7	TRUE	0.009426650306752786	16	40	3	0.075	0.1875	REAC:R-HSA-9614657	REAC	FOXO-mediated transcription of cell death genes	10916	925		1	1	16	10900	3	37	13	10863	10916	0.11656694615548616
R1	cpdb	0	network_modules	8	TRUE	1.682485747045798e-7	9	17	4	0.23529411764705882	0.4444444444444444	REAC:R-HSA-193634	REAC	Axonal growth inhibition (RHOA activation)	10916	195		0	0.25	9	10907	4	13	5	10894	10916	0.32263194506535536
R1	cpdb	0	network_modules	8	TRUE	2.8014698526490707e-7	10	17	4	0.23529411764705882	0.4	REAC:R-HSA-193697	REAC	p75NTR regulates axonogenesis	10916	2724		0.3333333333333333	0.5	10	10906	4	13	6	10893	10916	0.30596997884760413
R1	cpdb	0	network_modules	8	TRUE	9.465938565891949e-5	97	17	5	0.29411764705882354	0.05154639175257732	REAC:R-HSA-193704	REAC	p75 NTR receptor-mediated signalling	10916	2721		0.6666666666666666	0.75	97	10819	5	12	92	10807	10916	0.12003637855498536
R1	cpdb	0	network_modules	8	TRUE	9.122979042965383e-4	153	17	5	0.29411764705882354	0.032679738562091505	REAC:R-HSA-73887	REAC	Death Receptor Signaling	10916	455		1	1	153	10763	5	12	148	10751	10916	0.09410176029167522
R1	cpdb	0	network_modules	8	TRUE	0.002253978923787456	210	9	4	0.4444444444444444	0.01904761904761905	KEGG:04015	KEGG	Rap1 signaling pathway	8484	248		0	0.5	210	8274	4	5	206	8269	8484	0.08802688110088136
R1	cpdb	0	network_modules	8	TRUE	0.0025037407161416407	684	22	8	0.36363636363636365	0.011695906432748537	GO:0031175	GO:BP	neuron projection development	16175	7086		0	0.3333333333333333	684	15491	8	14	676	15477	16175	0.05893021831198627
R1	cpdb	0	network_modules	8	TRUE	0.0055516080387087675	761	22	8	0.36363636363636365	0.010512483574244415	GO:0048666	GO:BP	neuron development	16175	12924		0.5	0.6666666666666666	761	15414	8	14	753	15400	16175	0.05517903414979204
R1	cpdb	0	network_modules	8	TRUE	0.006156624794849715	339	22	6	0.2727272727272727	0.017699115044247787	GO:0061564	GO:BP	axon development	16175	15561		1	1	339	15836	6	16	333	15820	16175	0.06486474260207725
R1	cpdb	0	network_modules	8	TRUE	0.009185586181021034	301	9	4	0.4444444444444444	0.013289036544850499	KEGG:04010	KEGG	MAPK signaling pathway	8484	243		1	1	301	8183	4	5	297	8178	8484	0.07204430094717251
R1	cpdb	0	network_modules	9	TRUE	5.190892256331335e-34	165	28	23	0.8214285714285714	0.1393939393939394	KEGG:04140	KEGG	Autophagy - animal	8484	277		0	0.09090909090909091	165	8319	23	5	142	8314	8484	0.334182188803366
R1	cpdb	0	network_modules	9	TRUE	3.402503652085235e-28	202	31	20	0.6451612903225806	0.09900990099009901	GO:0007033	GO:BP	vacuole organization	16175	2638		0	0.03225806451612903	202	15973	20	11	182	15962	16175	0.24964901181306395
R1	cpdb	0	network_modules	9	TRUE	2.099736542379775e-26	309	31	21	0.6774193548387096	0.06796116504854369	GO:0016236	GO:BP	macroautophagy	16175	5179		0.03333333333333333	0.06451612903225806	309	15866	21	10	288	15856	16175	0.21073703999190352
R1	cpdb	0	network_modules	9	TRUE	6.498367138134051e-26	491	31	23	0.7419354838709677	0.04684317718940937	GO:0006914	GO:BP	autophagy	16175	2563		0.06666666666666667	0.12903225806451613	491	15684	23	8	468	15676	16175	0.18174987892061703
R1	cpdb	0	network_modules	9	TRUE	6.498367138134051e-26	491	31	23	0.7419354838709677	0.04684317718940937	GO:0061919	GO:BP	process utilizing autophagic mechanism	16175	15723		0.06666666666666667	0.12903225806451613	491	15684	23	8	468	15676	16175	0.18174987892061703
R1	cpdb	0	network_modules	9	TRUE	9.846721811961032e-25	104	31	16	0.5161290322580645	0.15384615384615385	GO:0000045	GO:BP	autophagosome assembly	16175	17		0.13333333333333333	0.16129032258064516	104	16071	16	15	88	16056	16175	0.2794444748377619
R1	cpdb	0	network_modules	9	TRUE	1.8819439211344082e-24	108	31	16	0.5161290322580645	0.14814814814814814	GO:1905037	GO:BP	autophagosome organization	16175	24312		0.16666666666666666	0.1935483870967742	108	16067	16	15	92	16052	16175	0.27412182295630055
R1	cpdb	0	network_modules	9	TRUE	2.2132069866398515e-23	134	24	16	0.6666666666666666	0.11940298507462686	REAC:R-HSA-1632852	REAC	Macroautophagy	10916	1388		0	0.125	134	10782	16	8	118	10774	10916	0.27896560344493765
R1	cpdb	0	network_modules	9	TRUE	1.3184253363262867e-22	149	24	16	0.6666666666666666	0.10738255033557047	REAC:R-HSA-9612973	REAC	Autophagy	10916	193		0.14285714285714285	0.25	149	10767	16	8	133	10759	10916	0.26417962152963076
R1	cpdb	0	network_modules	9	TRUE	1.1585341372948856e-16	103	28	13	0.4642857142857143	0.1262135922330097	KEGG:04137	KEGG	Mitophagy - animal	8484	274		0.1	0.18181818181818182	103	8381	13	15	90	8366	8484	0.23757929777926662
R1	cpdb	0	network_modules	9	TRUE	1.8636034396882214e-14	32	28	9	0.32142857142857145	0.28125	KEGG:04136	KEGG	Autophagy - other	8484	273		0.2	0.2727272727272727	32	8452	9	19	23	8433	8484	0.2981951425223896
R1	cpdb	0	network_modules	9	TRUE	2.088783842533666e-14	11	31	7	0.22580645161290322	0.6363636363636364	GO:0043562	GO:BP	cellular response to nitrogen levels	16175	10771		0.2	0.25806451612903225	11	16164	7	24	4	16140	16175	0.37842097927686036
R1	cpdb	0	network_modules	9	TRUE	2.088783842533666e-14	11	31	7	0.22580645161290322	0.6363636363636364	GO:0006995	GO:BP	cellular response to nitrogen starvation	16175	2610		0.2	0.25806451612903225	11	16164	7	24	4	16140	16175	0.37842097927686036
R1	cpdb	0	network_modules	9	TRUE	5.795774396524646e-12	159	31	11	0.3548387096774194	0.06918238993710692	GO:0042594	GO:BP	response to starvation	16175	10254		0.26666666666666666	0.2903225806451613	159	16016	11	20	148	15996	16175	0.15324067204286956
R1	cpdb	0	network_modules	9	TRUE	2.0351698581047844e-10	15	31	6	0.1935483870967742	0.4	GO:0016237	GO:BP	microautophagy	16175	5180		0.3	0.3225806451612903	15	16160	6	25	9	16135	16175	0.2773045241511555
R1	cpdb	0	network_modules	9	TRUE	4.749190010812356e-10	324	31	12	0.3870967741935484	0.037037037037037035	GO:0010506	GO:BP	regulation of autophagy	16175	4181		0.3333333333333333	0.3548387096774194	324	15851	12	19	312	15832	16175	0.11480550678673308
R1	cpdb	0	network_modules	9	TRUE	1.4422129157486547e-9	262	31	11	0.3548387096774194	0.04198473282442748	GO:0031667	GO:BP	response to nutrient levels	16175	7271		0.36666666666666664	0.3870967741935484	262	15913	11	20	251	15893	16175	0.11755260576196228
R1	cpdb	0	network_modules	9	TRUE	1.6719588961604103e-9	187	31	10	0.3225806451612903	0.053475935828877004	GO:0031669	GO:BP	cellular response to nutrient levels	16175	7272		0.4	0.41935483870967744	187	15988	10	21	177	15967	16175	0.12749390963459947
R1	cpdb	0	network_modules	9	TRUE	4.394328290433518e-9	138	31	9	0.2903225806451613	0.06521739130434782	GO:0009267	GO:BP	cellular response to starvation	16175	3432		0.43333333333333335	0.45161290322580644	138	16037	9	22	129	16015	16175	0.1342596194572149
R1	cpdb	0	network_modules	9	TRUE	6.8903981698030955e-9	145	31	9	0.2903225806451613	0.06206896551724138	GO:0010508	GO:BP	positive regulation of autophagy	16175	4183		0.4666666666666667	0.4838709677419355	145	16030	9	22	136	16008	16175	0.13080618132995717
R1	cpdb	0	network_modules	9	TRUE	1.21300672015163e-8	55	31	7	0.22580645161290322	0.12727272727272726	GO:0097352	GO:BP	autophagosome maturation	16175	18619		0.5	0.5161290322580645	55	16120	7	24	48	16096	16175	0.16741812583713844
R1	cpdb	0	network_modules	9	TRUE	1.576264955291603e-8	57	31	7	0.22580645161290322	0.12280701754385964	GO:0000422	GO:BP	autophagy of mitochondrion	16175	126		0.5333333333333333	0.5483870967741935	57	16118	7	24	50	16094	16175	0.16437350689939367
R1	cpdb	0	network_modules	9	TRUE	3.242599354462754e-8	363	28	12	0.42857142857142855	0.03305785123966942	KEGG:05014	KEGG	Amyotrophic lateral sclerosis	8484	413		0.3	0.36363636363636365	363	8121	12	16	351	8105	8484	0.10969440228796845
R1	cpdb	0	network_modules	9	TRUE	3.302683700406649e-8	120	24	8	0.3333333333333333	0.06666666666666667	REAC:R-HSA-9007101	REAC	Rab regulation of trafficking	10916	1939		0.2857142857142857	0.375	120	10796	8	16	112	10780	10916	0.14511351783574317
R1	cpdb	0	network_modules	9	TRUE	1.1841454754473798e-7	44	24	6	0.25	0.13636363636363635	REAC:R-HSA-8854214	REAC	TBC/RABGAPs	10916	2420		0.42857142857142855	0.5	44	10872	6	18	38	10854	10916	0.18222796884469977
R1	cpdb	0	network_modules	9	TRUE	2.3885690741298067e-7	43	31	6	0.1935483870967742	0.13953488372093023	GO:0000423	GO:BP	mitophagy	16175	127		0.5666666666666667	0.5806451612903226	43	16132	6	25	37	16107	16175	0.16245172321425558
R1	cpdb	0	network_modules	9	TRUE	2.9205804149637843e-7	19	31	5	0.16129032258064516	0.2631578947368421	GO:0044804	GO:BP	nucleophagy	16175	11165		0.6	0.6129032258064516	19	16156	5	26	14	16130	16175	0.2048375991779781
R1	cpdb	0	network_modules	9	TRUE	6.93752891580581e-7	9	24	4	0.16666666666666666	0.4444444444444444	REAC:R-HSA-8934903	REAC	Receptor Mediated Mitophagy	10916	1944		0.5714285714285714	0.625	9	10907	4	20	5	10887	10916	0.27122919894403336
R1	cpdb	0	network_modules	9	TRUE	7.051738323351134e-7	141	28	8	0.2857142857142857	0.05673758865248227	KEGG:05017	KEGG	Spinocerebellar ataxia	8484	415		0.4	0.45454545454545453	141	8343	8	20	133	8323	8484	0.12112443434435448
R1	cpdb	0	network_modules	9	TRUE	9.026743432444872e-7	477	31	11	0.3548387096774194	0.023060796645702306	GO:0009896	GO:BP	positive regulation of catabolic process	16175	3756		0.6333333333333333	0.6451612903225806	477	15698	11	20	466	15678	16175	0.08427278771805041
R1	cpdb	0	network_modules	9	TRUE	3.1932053821178236e-6	10	31	4	0.12903225806451613	0.4	GO:0034727	GO:BP	piecemeal microautophagy of the nucleus	16175	8722		0.6666666666666666	0.6774193548387096	10	16165	4	27	6	16138	16175	0.22638317640398983
R1	cpdb	0	network_modules	9	TRUE	5.0111918198853515e-6	11	31	4	0.12903225806451613	0.36363636363636365	GO:1903059	GO:BP	regulation of protein lipidation	16175	22738		0.7	0.7096774193548387	11	16164	4	27	7	16137	16175	0.2157506449565878
R1	cpdb	0	network_modules	9	TRUE	5.2159552314490355e-6	182	28	8	0.2857142857142857	0.04395604395604396	KEGG:04621	KEGG	NOD-like receptor signaling pathway	8484	326		0.5	0.5454545454545454	182	8302	8	20	174	8282	8484	0.10495547011716269
R1	cpdb	0	network_modules	9	TRUE	2.0392527040382532e-5	156	31	7	0.22580645161290322	0.04487179487179487	GO:0016241	GO:BP	regulation of macroautophagy	16175	5183		0.7333333333333333	0.7419354838709677	156	16019	7	24	149	15995	16175	0.09692120126715999
R1	cpdb	0	network_modules	9	TRUE	2.0617589172165657e-5	15	31	4	0.12903225806451613	0.26666666666666666	GO:0050746	GO:BP	regulation of lipoprotein metabolic process	16175	13232		0.7666666666666667	0.7741935483870968	15	16160	4	27	11	16133	16175	0.18442466334161073
R1	cpdb	0	network_modules	9	TRUE	4.600571649582562e-5	49	31	5	0.16129032258064516	0.10204081632653061	GO:0006497	GO:BP	protein lipidation	16175	2226		0.8	0.8064516129032258	49	16126	5	26	44	16100	16175	0.12619204537513054
R1	cpdb	0	network_modules	9	TRUE	5.104892576311459e-5	50	31	5	0.16129032258064516	0.1	GO:0042158	GO:BP	lipoprotein biosynthetic process	16175	9996		0.8333333333333334	0.8387096774193549	50	16125	5	26	45	16099	16175	0.12487882265452163
R1	cpdb	0	network_modules	9	TRUE	9.411055575701623e-5	27	24	4	0.16666666666666666	0.14814814814814814	REAC:R-HSA-5205647	REAC	Mitophagy	10916	1478		0.7142857142857143	0.75	27	10889	4	20	23	10869	10916	0.15516533568011806
R1	cpdb	0	network_modules	9	TRUE	1.4050866338545038e-4	382	28	9	0.32142857142857145	0.02356020942408377	KEGG:05010	KEGG	Alzheimer disease	8484	411		0.6	0.6363636363636364	382	8102	9	19	373	8083	8484	0.07670286300497711
R1	cpdb	0	network_modules	9	TRUE	1.851836508797457e-4	215	31	7	0.22580645161290322	0.03255813953488372	GO:0032984	GO:BP	protein-containing complex disassembly	16175	7964		0.8666666666666667	0.8709677419354839	215	15960	7	24	208	15936	16175	0.08131527161458532
R1	cpdb	0	network_modules	9	TRUE	2.1913720763896857e-4	80	24	5	0.20833333333333334	0.0625	REAC:R-HSA-9663891	REAC	Selective autophagy	10916	2186		0.8571428571428571	0.875	80	10836	5	19	75	10817	10916	0.11062210693899145
R1	cpdb	0	network_modules	9	TRUE	2.2744132878867854e-4	67	31	5	0.16129032258064516	0.07462686567164178	GO:0042157	GO:BP	lipoprotein metabolic process	16175	9995		0.9	0.9032258064516129	67	16108	5	26	62	16082	16175	0.10721870598844965
R1	cpdb	0	network_modules	9	TRUE	2.657382005821682e-4	305	28	8	0.2857142857142857	0.02622950819672131	KEGG:05016	KEGG	Huntington disease	8484	414		0.7	0.7272727272727273	305	8179	8	20	297	8159	8484	0.07720180625880553
R1	cpdb	0	network_modules	9	TRUE	5.566016772407379e-4	41	28	4	0.14285714285714285	0.0975609756097561	KEGG:04216	KEGG	Ferroptosis	8484	293		0.8	0.8181818181818182	41	8443	4	24	37	8419	8484	0.11452837549462455
R1	cpdb	0	network_modules	9	TRUE	5.804363535121732e-4	89	28	5	0.17857142857142858	0.056179775280898875	KEGG:04211	KEGG	Longevity regulating pathway	8484	288		0.9	0.9090909090909091	89	8395	5	23	84	8372	8484	0.0949315781060221
R1	cpdb	0	network_modules	9	TRUE	7.00531471227135e-4	246	28	7	0.25	0.028455284552845527	KEGG:05131	KEGG	Shigellosis	8484	428		1	1	246	8238	7	21	239	8217	8484	0.07579129946184572
R1	cpdb	0	network_modules	9	TRUE	0.00431868161691075	22	24	3	0.125	0.13636363636363635	REAC:R-HSA-5205685	REAC	PINK1-PRKN Mediated Mitophagy	10916	1678		1	1	22	10894	3	21	19	10873	10916	0.12872445833395138
R1	cpdb	0	network_modules	9	TRUE	0.005911620580495352	17	31	3	0.0967741935483871	0.17647058823529413	GO:1901096	GO:BP	regulation of autophagosome maturation	16175	21208		0.9333333333333333	0.967741935483871	17	16158	3	28	14	16130	16175	0.129454889231472
R1	cpdb	0	network_modules	9	TRUE	0.005911620580495352	17	31	3	0.0967741935483871	0.17647058823529413	GO:0061709	GO:BP	reticulophagy	16175	15625		0.9333333333333333	0.967741935483871	17	16158	3	28	14	16130	16175	0.129454889231472
R1	cpdb	0	network_modules	9	TRUE	0.007556942215546158	374	31	7	0.22580645161290322	0.01871657754010695	GO:0022411	GO:BP	cellular component disassembly	16175	6602		1	1	374	15801	7	24	367	15777	16175	0.059096490388390564
R1	cpdb	0	network_modules	10	TRUE	1.957920216522634e-27	174	20	18	0.9	0.10344827586206896	KEGG:04310	KEGG	Wnt signaling pathway	8484	299		0	0.07692307692307693	174	8310	18	2	156	8308	8484	0.3016365731647326
R1	cpdb	0	network_modules	10	TRUE	1.422172968780717e-24	257	25	18	0.72	0.07003891050583658	GO:0060070	GO:BP	canonical Wnt signaling pathway	16175	14332		0	0.016666666666666666	257	15918	18	7	239	15911	16175	0.22154324982641724
R1	cpdb	0	network_modules	10	TRUE	2.4467222118505533e-24	345	25	19	0.76	0.05507246376811594	GO:0016055	GO:BP	Wnt signaling pathway	16175	5087		0.01694915254237288	0.03333333333333333	345	15830	19	6	326	15824	16175	0.20115412825946774
R1	cpdb	0	network_modules	10	TRUE	2.629319471518756e-22	63	20	13	0.65	0.20634920634920634	KEGG:05217	KEGG	Basal cell carcinoma	8484	468		0.08333333333333333	0.15384615384615385	63	8421	13	7	50	8414	8484	0.36383045114105506
R1	cpdb	0	network_modules	10	TRUE	1.8713103524563667e-20	61	25	12	0.48	0.19672131147540983	GO:0035567	GO:BP	non-canonical Wnt signaling pathway	16175	9097		0.03389830508474576	0.05	61	16114	12	13	49	16101	16175	0.3056870506057739
R1	cpdb	0	network_modules	10	TRUE	1.7090007044724643e-19	26	22	10	0.45454545454545453	0.38461538461538464	REAC:R-HSA-3238698	REAC	WNT ligand biogenesis and trafficking	10916	2668		0	0.09090909090909091	26	10890	10	12	16	10878	10916	0.41684653375636055
R1	cpdb	0	network_modules	10	TRUE	1.9904075998354376e-19	101	20	13	0.65	0.12871287128712872	KEGG:04916	KEGG	Melanogenesis	8484	373		0.16666666666666666	0.23076923076923078	101	8383	13	7	88	8376	8484	0.28599136066213626
R1	cpdb	0	network_modules	10	TRUE	2.6297645628592903e-19	147	20	14	0.7	0.09523809523809523	KEGG:05224	KEGG	Breast cancer	8484	475		0.25	0.3076923076923077	147	8337	14	6	133	8331	8484	0.2543180347740792
R1	cpdb	0	network_modules	10	TRUE	2.902567840935617e-19	148	20	14	0.7	0.0945945945945946	KEGG:05226	KEGG	Gastric cancer	8484	477		0.3333333333333333	0.38461538461538464	148	8336	14	6	134	8330	8484	0.2534288340560107
R1	cpdb	0	network_modules	10	TRUE	5.682628622445132e-19	155	20	14	0.7	0.09032258064516129	KEGG:04150	KEGG	mTOR signaling pathway	8484	284		0.4166666666666667	0.46153846153846156	155	8329	14	6	141	8323	8484	0.24744470066236274
R1	cpdb	0	network_modules	10	TRUE	1.5350312385511626e-18	166	20	14	0.7	0.08433734939759036	KEGG:05225	KEGG	Hepatocellular carcinoma	8484	476		0.5	0.5384615384615384	166	8318	14	6	152	8312	8484	0.23880871953288701
R1	cpdb	0	network_modules	10	TRUE	1.4110964741216382e-17	93	22	12	0.5454545454545454	0.12903225806451613	REAC:R-HSA-373080	REAC	Class B/2 (Secretin family receptors)	10916	366		0.1	0.18181818181818182	93	10823	12	10	81	10813	10916	0.2625352027252252
R1	cpdb	0	network_modules	10	TRUE	2.2595173163907997e-17	143	20	13	0.65	0.09090909090909091	KEGG:04550	KEGG	Signaling pathways regulating pluripotency of stem cells	8484	319		0.5833333333333334	0.6153846153846154	143	8341	13	7	130	8334	8484	0.23908578537811606
R1	cpdb	0	network_modules	10	TRUE	3.201778166348694e-17	205	20	14	0.7	0.06829268292682927	KEGG:05205	KEGG	Proteoglycans in cancer	8484	457		0.6666666666666666	0.6923076923076923	205	8279	14	6	191	8273	8484	0.2139458363335721
R1	cpdb	0	network_modules	10	TRUE	5.606201418842769e-17	153	20	13	0.65	0.08496732026143791	KEGG:04934	KEGG	Cushing syndrome	8484	391		0.75	0.7692307692307693	153	8331	13	7	140	8324	8484	0.2308486283064109
R1	cpdb	0	network_modules	10	TRUE	7.924749525094263e-17	157	20	13	0.65	0.08280254777070063	KEGG:04390	KEGG	Hippo signaling pathway	8484	310		0.8333333333333334	0.8461538461538461	157	8327	13	7	144	8320	8484	0.22777358003547535
R1	cpdb	0	network_modules	10	TRUE	4.807469539926725e-16	327	22	15	0.6818181818181818	0.045871559633027525	REAC:R-HSA-195721	REAC	Signaling by WNT	10916	2314		0.2	0.2727272727272727	327	10589	15	7	312	10582	10916	0.17184448496786606
R1	cpdb	0	network_modules	10	TRUE	2.7469841679133157e-14	330	20	14	0.7	0.04242424242424243	KEGG:05165	KEGG	Human papillomavirus infection	8484	446		0.9166666666666666	0.9230769230769231	330	8154	14	6	316	8148	8484	0.16620910123847085
R1	cpdb	0	network_modules	10	TRUE	2.1368348781512413e-13	382	20	14	0.7	0.03664921465968586	KEGG:05010	KEGG	Alzheimer disease	8484	411		1	1	382	8102	14	6	368	8096	8484	0.15354091895739064
R1	cpdb	0	network_modules	10	TRUE	1.7347763929526033e-11	13	25	6	0.24	0.46153846153846156	GO:1904948	GO:BP	midbrain dopaminergic neuron differentiation	16175	24239		0.05084745762711865	0.06666666666666667	13	16162	6	19	7	16143	16175	0.3320956931164084
R1	cpdb	0	network_modules	10	TRUE	5.244789543114179e-11	15	22	6	0.2727272727272727	0.4	REAC:R-HSA-3772470	REAC	Negative regulation of TCF-dependent signaling by WNT ligand antagonists	10916	1578		0.3	0.36363636363636365	15	10901	6	16	9	10885	10916	0.3291828787272566
R1	cpdb	0	network_modules	10	TRUE	6.88582325529298e-11	175	25	10	0.4	0.05714285714285714	GO:0045165	GO:BP	cell fate commitment	16175	11307		0.06779661016949153	0.08333333333333333	175	16000	10	15	165	15985	16175	0.14801320399937332
R1	cpdb	0	network_modules	10	TRUE	4.4220151654162727e-10	44	25	7	0.28	0.1590909090909091	GO:0071300	GO:BP	cellular response to retinoic acid	16175	16557		0.0847457627118644	0.1	44	16131	7	18	37	16113	16175	0.20945426329187697
R1	cpdb	0	network_modules	10	TRUE	3.998264576577714e-9	460	22	12	0.5454545454545454	0.02608695652173913	REAC:R-HSA-500792	REAC	GPCR ligand binding	10916	1019		0.4	0.45454545454545453	460	10456	12	10	448	10446	10916	0.11257941282043069
R1	cpdb	0	network_modules	10	TRUE	4.549448811835047e-9	512	25	12	0.48	0.0234375	GO:0009790	GO:BP	embryo development	16175	3677		0.1016949152542373	0.11666666666666667	512	15663	12	13	500	15650	16175	0.10075557410559592
R1	cpdb	0	network_modules	10	TRUE	5.900711593320569e-9	30	25	6	0.24	0.2	GO:0071542	GO:BP	dopaminergic neuron differentiation	16175	16752		0.11864406779661017	0.13333333333333333	30	16145	6	19	24	16126	16175	0.21776614716377785
R1	cpdb	0	network_modules	10	TRUE	6.87012236584002e-9	277	25	10	0.4	0.036101083032490974	GO:0030111	GO:BP	regulation of Wnt signaling pathway	16175	6681		0.13559322033898305	0.15	277	15898	10	15	267	15883	16175	0.11611108682136666
R1	cpdb	0	network_modules	10	TRUE	7.02991476451158e-9	64	25	7	0.28	0.109375	GO:0032526	GO:BP	response to retinoic acid	16175	7620		0.15254237288135594	0.16666666666666666	64	16111	7	18	57	16093	16175	0.17300313314112187
R1	cpdb	0	network_modules	10	TRUE	9.50886098607974e-8	231	22	9	0.4090909090909091	0.03896103896103896	REAC:R-HSA-201681	REAC	TCF dependent signaling in response to WNT	10916	2421		0.5	0.5454545454545454	231	10685	9	13	222	10672	10916	0.12112687820206093
R1	cpdb	0	network_modules	10	TRUE	1.2288850285591192e-7	92	22	7	0.3181818181818182	0.07608695652173914	REAC:R-HSA-4086400	REAC	PCP/CE pathway	10916	1659		0.6	0.6363636363636364	92	10824	7	15	85	10809	10916	0.15226849352704175
R1	cpdb	0	network_modules	10	TRUE	1.7688494189935797e-7	701	25	12	0.48	0.017118402282453638	GO:0060429	GO:BP	epithelium development	16175	14627		0.1694915254237288	0.18333333333333332	701	15474	12	13	689	15461	16175	0.08437477777637663
R1	cpdb	0	network_modules	10	TRUE	9.73589633197577e-7	212	25	8	0.32	0.03773584905660377	GO:0060828	GO:BP	regulation of canonical Wnt signaling pathway	16175	14976		0.1864406779661017	0.2	212	15963	8	17	204	15946	16175	0.10616719092989411
R1	cpdb	0	network_modules	10	TRUE	1.1453216503458472e-6	69	25	6	0.24	0.08695652173913043	GO:0030901	GO:BP	midbrain development	16175	6957		0.2033898305084746	0.21666666666666667	69	16106	6	19	63	16087	16175	0.14230893008562945
R1	cpdb	0	network_modules	10	TRUE	2.7560536727871158e-6	143	22	7	0.3181818181818182	0.04895104895104895	REAC:R-HSA-3858494	REAC	Beta-catenin independent WNT signaling	10916	216		0.7	0.7272727272727273	143	10773	7	15	136	10758	10916	0.12057606514739354
R1	cpdb	0	network_modules	10	TRUE	3.514179323316621e-6	153	25	7	0.28	0.0457516339869281	GO:0043010	GO:BP	camera-type eye development	16175	10480		0.22033898305084745	0.23333333333333334	153	16022	7	18	146	16004	16175	0.10996563216478723
R1	cpdb	0	network_modules	10	TRUE	4.062823004169875e-6	254	25	8	0.32	0.031496062992125984	GO:0001503	GO:BP	ossification	16175	320		0.23728813559322035	0.25	254	15921	8	17	246	15904	16175	0.09629934227136702
R1	cpdb	0	network_modules	10	TRUE	4.659386443042193e-6	3	25	3	0.12	1	GO:0061184	GO:BP	positive regulation of dermatome development	16175	15281		0.2542372881355932	0.26666666666666666	3	16172	3	22	0	16150	16175	0.34617445729716456
R1	cpdb	0	network_modules	10	TRUE	4.737715607652831e-6	87	25	6	0.24	0.06896551724137931	GO:0021953	GO:BP	central nervous system neuron differentiation	16175	6508		0.2711864406779661	0.2833333333333333	87	16088	6	19	81	16069	16175	0.12620741342783837
R1	cpdb	0	network_modules	10	TRUE	7.726835614663659e-6	408	25	9	0.36	0.022058823529411766	GO:0071396	GO:BP	cellular response to lipid	16175	16648		0.288135593220339	0.3	408	15767	9	16	399	15751	16175	0.08399967129703363
R1	cpdb	0	network_modules	10	TRUE	1.0815797812661374e-5	46	25	5	0.2	0.10869565217391304	GO:0002088	GO:BP	lens development in camera-type eye	16175	674		0.3050847457627119	0.31666666666666665	46	16129	5	20	41	16109	16175	0.14566513760736194
R1	cpdb	0	network_modules	10	TRUE	1.664897749029367e-5	50	25	5	0.2	0.1	GO:0048144	GO:BP	fibroblast proliferation	16175	12545		0.3220338983050847	0.3333333333333333	50	16125	5	20	45	16105	16175	0.13955914941683512
R1	cpdb	0	network_modules	10	TRUE	1.861853022027406e-5	4	25	3	0.12	0.75	GO:0061054	GO:BP	dermatome development	16175	15170		0.3389830508474576	0.38333333333333336	4	16171	3	22	1	16149	16175	0.29965044535356145
R1	cpdb	0	network_modules	10	TRUE	1.861853022027406e-5	4	25	3	0.12	0.75	GO:0033278	GO:BP	cell proliferation in midbrain	16175	8110		0.3389830508474576	0.38333333333333336	4	16171	3	22	1	16149	16175	0.29965044535356145
R1	cpdb	0	network_modules	10	TRUE	1.861853022027406e-5	4	25	3	0.12	0.75	GO:0061183	GO:BP	regulation of dermatome development	16175	15280		0.3389830508474576	0.38333333333333336	4	16171	3	22	1	16149	16175	0.29965044535356145
R1	cpdb	0	network_modules	10	TRUE	1.887547311860863e-5	309	25	8	0.32	0.025889967637540454	GO:0048598	GO:BP	embryonic morphogenesis	16175	12865		0.3898305084745763	0.4	309	15866	8	17	301	15849	16175	0.08648327404027695
R1	cpdb	0	network_modules	10	TRUE	1.9115641141113835e-5	18	25	4	0.16	0.2222222222222222	GO:0062009	GO:BP	secondary palate development	16175	15779		0.4067796610169492	0.4166666666666667	18	16157	4	21	14	16136	16175	0.1874995584348584
R1	cpdb	0	network_modules	10	TRUE	2.185192674981949e-5	199	25	7	0.28	0.035175879396984924	GO:0001654	GO:BP	eye development	16175	368		0.423728813559322	0.43333333333333335	199	15976	7	18	192	15958	16175	0.09554568386425283
R1	cpdb	0	network_modules	10	TRUE	2.4232266384101905e-5	202	25	7	0.28	0.034653465346534656	GO:0150063	GO:BP	visual system development	16175	20119		0.4406779661016949	0.45	202	15973	7	18	195	15955	16175	0.09477672675156903
R1	cpdb	0	network_modules	10	TRUE	2.9658486733080496e-5	208	25	7	0.28	0.03365384615384615	GO:0048880	GO:BP	sensory system development	16175	13120		0.4576271186440678	0.4666666666666667	208	15967	7	18	201	15949	16175	0.0932877626088571
R1	cpdb	0	network_modules	10	TRUE	3.2244364380760955e-5	331	25	8	0.32	0.02416918429003021	GO:0048729	GO:BP	tissue morphogenesis	16175	12986		0.4745762711864407	0.48333333333333334	331	15844	8	17	323	15827	16175	0.08323981544304321
R1	cpdb	0	network_modules	10	TRUE	3.7271525448558866e-5	21	25	4	0.16	0.19047619047619047	GO:2000050	GO:BP	regulation of non-canonical Wnt signaling pathway	16175	25410		0.4915254237288136	0.5	21	16154	4	21	17	16133	16175	0.17340432408683273
R1	cpdb	0	network_modules	10	TRUE	4.649883605893815e-5	5	25	3	0.12	0.6	GO:0007223	GO:BP	Wnt signaling pathway, calcium modulating pathway	16175	2776		0.5084745762711864	0.5166666666666667	5	16170	3	22	2	16148	16175	0.26788542285229483
R1	cpdb	0	network_modules	10	TRUE	6.311895174448888e-5	520	25	9	0.36	0.01730769230769231	GO:0033993	GO:BP	response to lipid	16175	8371		0.5254237288135594	0.5333333333333333	520	15655	9	16	511	15639	16175	0.07312689952025264
R1	cpdb	0	network_modules	10	TRUE	1.0180446563309373e-4	384	25	8	0.32	0.020833333333333332	GO:0007420	GO:BP	brain development	16175	2915		0.5423728813559322	0.55	384	15791	8	17	376	15774	16175	0.07656497083576656
R1	cpdb	0	network_modules	10	TRUE	1.0714532230480296e-4	146	25	6	0.24	0.0410958904109589	GO:0030178	GO:BP	negative regulation of Wnt signaling pathway	16175	6698		0.559322033898305	0.5666666666666667	146	16029	6	19	140	16010	16175	0.09608618847196025
R1	cpdb	0	network_modules	10	TRUE	1.2013108497455599e-4	255	25	7	0.28	0.027450980392156862	GO:0002009	GO:BP	morphogenesis of an epithelium	16175	612		0.576271186440678	0.5833333333333334	255	15920	7	18	248	15902	16175	0.08345966495284962
R1	cpdb	0	network_modules	10	TRUE	1.2520684938188508e-4	31	22	4	0.18181818181818182	0.12903225806451613	REAC:R-HSA-4641262	REAC	Disassembly of the destruction complex and recruitment of AXIN to the membrane	10916	746		0.8	0.8181818181818182	31	10885	4	18	27	10867	10916	0.15114247524712943
R1	cpdb	0	network_modules	10	TRUE	0.00013177416819013259	8	22	3	0.13636363636363635	0.375	REAC:R-HSA-5340588	REAC	Signaling by RNF43 mutants	10916	2300		0.9	0.9090909090909091	8	10908	3	19	5	10889	10916	0.22522772086011703
R1	cpdb	0	network_modules	10	TRUE	1.4485299213658136e-4	402	25	8	0.32	0.01990049751243781	GO:0060322	GO:BP	head development	16175	14534		0.5932203389830508	0.6	402	15773	8	17	394	15756	16175	0.07459263989640913
R1	cpdb	0	network_modules	10	TRUE	1.4668406750367057e-4	29	25	4	0.16	0.13793103448275862	GO:0061053	GO:BP	somite development	16175	15169		0.6101694915254238	0.6166666666666667	29	16146	4	21	25	16125	16175	0.1471372225785833
R1	cpdb	0	network_modules	10	TRUE	1.8314117748525514e-4	80	25	5	0.2	0.0625	GO:0061351	GO:BP	neural precursor cell proliferation	16175	15426		0.6271186440677966	0.65	80	16095	5	20	75	16075	16175	0.10939377781946275
R1	cpdb	0	network_modules	10	TRUE	1.8314117748525514e-4	80	25	5	0.2	0.0625	GO:0030278	GO:BP	regulation of ossification	16175	6755		0.6271186440677966	0.65	80	16095	5	20	75	16075	16175	0.10939377781946275
R1	cpdb	0	network_modules	10	TRUE	1.9392140684227816e-4	31	25	4	0.16	0.12903225806451613	GO:0099054	GO:BP	presynapse assembly	16175	19026		0.6610169491525424	0.6666666666666666	31	16144	4	21	27	16123	16175	0.14220931603669823
R1	cpdb	0	network_modules	10	TRUE	2.2139417037615e-4	32	25	4	0.16	0.125	GO:0099172	GO:BP	presynapse organization	16175	19080		0.6779661016949152	0.6833333333333333	32	16143	4	21	28	16122	16175	0.13991925302498212
R1	cpdb	0	network_modules	10	TRUE	2.2180372481492226e-4	279	25	7	0.28	0.025089605734767026	GO:0007423	GO:BP	sensory organ development	16175	2918		0.6949152542372882	0.7	279	15896	7	18	272	15878	16175	0.07940112254367322
R1	cpdb	0	network_modules	10	TRUE	2.44344425827508e-4	283	25	7	0.28	0.024734982332155476	GO:0001501	GO:BP	skeletal system development	16175	318		0.711864406779661	0.7166666666666667	283	15892	7	18	276	15874	16175	0.07877369820833656
R1	cpdb	0	network_modules	10	TRUE	2.595973150559093e-4	8	25	3	0.12	0.375	GO:0070307	GO:BP	lens fiber cell development	16175	16050		0.7288135593220338	0.7333333333333333	8	16167	3	22	5	16145	16175	0.2114734655362776
R1	cpdb	0	network_modules	10	TRUE	3.6115409801606524e-4	36	25	4	0.16	0.1111111111111111	GO:0060071	GO:BP	Wnt signaling pathway, planar cell polarity pathway	16175	14333		0.7457627118644068	0.75	36	16139	4	21	32	16118	16175	0.1317270147774988
R1	cpdb	0	network_modules	10	TRUE	4.0450956451494396e-4	37	25	4	0.16	0.10810810810810811	GO:0060021	GO:BP	roof of mouth development	16175	14284		0.7627118644067796	0.7666666666666667	37	16138	4	21	33	16117	16175	0.12988783621780656
R1	cpdb	0	network_modules	10	TRUE	8.680435139493934e-4	208	25	6	0.24	0.028846153846153848	GO:0051091	GO:BP	positive regulation of DNA-binding transcription factor activity	16175	13486		0.7796610169491526	0.7833333333333333	208	15967	6	19	202	15948	16175	0.07931942601826915
R1	cpdb	0	network_modules	10	TRUE	0.0011276738593460603	115	25	5	0.2	0.043478260869565216	GO:0030177	GO:BP	positive regulation of Wnt signaling pathway	16175	6697		0.7966101694915254	0.8	115	16060	5	20	110	16040	16175	0.09032680407279736
R1	cpdb	0	network_modules	10	TRUE	0.0012815716571780874	118	25	5	0.2	0.0423728813559322	GO:0090090	GO:BP	negative regulation of canonical Wnt signaling pathway	16175	18011		0.8135593220338984	0.8166666666666667	118	16057	5	20	113	16037	16175	0.08909376988907296
R1	cpdb	0	network_modules	10	TRUE	0.0012815982591957908	49	25	4	0.16	0.08163265306122448	GO:0048145	GO:BP	regulation of fibroblast proliferation	16175	12546		0.8305084745762712	0.8333333333333334	49	16126	4	21	45	16105	16175	0.11237897694587205
R1	cpdb	0	network_modules	10	TRUE	0.0014289667360700177	543	25	8	0.32	0.014732965009208104	GO:0009887	GO:BP	animal organ morphogenesis	16175	3747		0.847457627118644	0.85	543	15632	8	17	535	15615	16175	0.06256606668492184
R1	cpdb	0	network_modules	10	TRUE	0.0021977512518651173	791	25	9	0.36	0.011378002528445006	GO:1901701	GO:BP	cellular response to oxygen-containing compound	16175	21654		0.864406779661017	0.8666666666666667	791	15384	9	16	782	15368	16175	0.056754656051307986
R1	cpdb	0	network_modules	10	TRUE	0.0025388375363157817	250	25	6	0.24	0.024	GO:0007389	GO:BP	pattern specification process	16175	2889		0.8813559322033898	0.8833333333333333	250	15925	6	19	244	15906	16175	0.07161761531503799
R1	cpdb	0	network_modules	10	TRUE	0.0027679487900614257	593	25	8	0.32	0.013490725126475547	GO:0007417	GO:BP	central nervous system development	16175	2912		0.8983050847457628	0.9	593	15582	8	17	585	15565	16175	0.059319113432800566
R1	cpdb	0	network_modules	10	TRUE	0.0030769327692432304	21	22	3	0.13636363636363635	0.14285714285714285	REAC:R-HSA-4641263	REAC	Regulation of FZD by ubiquitination	10916	1974		1	1	21	10895	3	19	18	10876	10916	0.13787513538282495
R1	cpdb	0	network_modules	10	TRUE	0.003276358997535711	2	25	2	0.08	1	GO:0003408	GO:BP	optic cup formation involved in camera-type eye development	16175	1821		0.9152542372881356	0.9333333333333333	2	16173	2	23	0	16150	16175	0.282641522315189
R1	cpdb	0	network_modules	10	TRUE	0.003276358997535711	2	25	2	0.08	1	GO:0061642	GO:BP	chemoattraction of axon	16175	15600		0.9152542372881356	0.9333333333333333	2	16173	2	23	0	16150	16175	0.282641522315189
R1	cpdb	0	network_modules	10	TRUE	0.00520271366008081	283	25	6	0.24	0.02120141342756184	GO:0050808	GO:BP	synapse organization	16175	13274		0.9491525423728814	0.95	283	15892	6	19	277	15873	16175	0.06677026374277044
R1	cpdb	0	network_modules	10	TRUE	0.005579637745764452	159	25	5	0.2	0.031446540880503145	GO:0001649	GO:BP	osteoblast differentiation	16175	367		0.9661016949152542	0.9666666666666667	159	16016	5	20	154	15996	16175	0.07583932865834134
R1	cpdb	0	network_modules	10	TRUE	0.006084175383553334	21	25	3	0.12	0.14285714285714285	GO:0040019	GO:BP	positive regulation of embryonic development	16175	9907		0.9830508474576272	0.9833333333333333	21	16154	3	22	18	16132	16175	0.1296985984599606
R1	cpdb	0	network_modules	10	TRUE	0.007037649377665408	22	25	3	0.12	0.13636363636363635	GO:0070306	GO:BP	lens fiber cell differentiation	16175	16049		1	1	22	16153	3	22	19	16131	16175	0.12665454491867303
R1	cpdb	0	network_modules	11	TRUE	1.4858776555521978e-7	101	24	7	0.2916666666666667	0.06930693069306931	GO:0007269	GO:BP	neurotransmitter secretion	16175	2797		0	0.09090909090909091	101	16074	7	17	94	16057	16175	0.13967403569580042
R1	cpdb	0	network_modules	11	TRUE	1.4858776555521978e-7	101	24	7	0.2916666666666667	0.06930693069306931	GO:0099643	GO:BP	signal release from synapse	16175	19183		0	0.09090909090909091	101	16074	7	17	94	16057	16175	0.13967403569580042
R1	cpdb	0	network_modules	11	TRUE	1.9146079314498142e-6	145	24	7	0.2916666666666667	0.04827586206896552	GO:0006836	GO:BP	neurotransmitter transport	16175	2506		0.09523809523809523	0.13636363636363635	145	16030	7	17	138	16013	16175	0.11561885153322995
R1	cpdb	0	network_modules	11	TRUE	1.4601709373514066e-5	50	24	5	0.20833333333333334	0.1	GO:0017156	GO:BP	calcium-ion regulated exocytosis	16175	5286		0.14285714285714285	0.18181818181818182	50	16125	5	19	45	16106	16175	0.14252199040414432
R1	cpdb	0	network_modules	11	TRUE	1.5012443684368543e-5	311	24	8	0.3333333333333333	0.02572347266881029	GO:0023061	GO:BP	signal release	16175	6645		0.19047619047619047	0.22727272727272727	311	15864	8	16	303	15848	16175	0.08817390392836373
R1	cpdb	0	network_modules	11	TRUE	2.580323997193653e-5	487	24	9	0.375	0.018480492813141684	GO:0098916	GO:BP	anterograde trans-synaptic signaling	16175	18949		0.23809523809523808	0.3181818181818182	487	15688	9	15	478	15673	16175	0.0778009338866586
R1	cpdb	0	network_modules	11	TRUE	2.580323997193653e-5	487	24	9	0.375	0.018480492813141684	GO:0007268	GO:BP	chemical synaptic transmission	16175	2796		0.23809523809523808	0.3181818181818182	487	15688	9	15	478	15673	16175	0.0778009338866586
R1	cpdb	0	network_modules	11	TRUE	2.818858622681535e-5	492	24	9	0.375	0.018292682926829267	GO:0099537	GO:BP	trans-synaptic signaling	16175	19116		0.3333333333333333	0.36363636363636365	492	15683	9	15	483	15668	16175	0.07734754524709866
R1	cpdb	0	network_modules	11	TRUE	4.2541528230837e-5	516	24	9	0.375	0.01744186046511628	GO:0099536	GO:BP	synaptic signaling	16175	19115		0.38095238095238093	0.4090909090909091	516	15659	9	15	507	15644	16175	0.0752597354426131
R1	cpdb	0	network_modules	11	TRUE	1.1845210646389347e-4	263	24	7	0.2916666666666667	0.026615969581749048	GO:0006887	GO:BP	exocytosis	16175	2543		0.42857142857142855	0.45454545454545453	263	15912	7	17	256	15895	16175	0.08394308527369893
R1	cpdb	0	network_modules	11	TRUE	1.5635251887141397e-4	7	24	3	0.125	0.42857142857142855	GO:1990709	GO:BP	presynaptic active zone organization	16175	25263		0.47619047619047616	0.5	7	16168	3	21	4	16147	16175	0.23087496910088323
R1	cpdb	0	network_modules	11	TRUE	1.6061323558495683e-4	161	24	6	0.25	0.037267080745341616	GO:0045055	GO:BP	regulated exocytosis	16175	11253		0.5238095238095238	0.5454545454545454	161	16014	6	18	155	15996	16175	0.09321428884040557
R1	cpdb	0	network_modules	11	TRUE	0.0018714325980632896	583	24	8	0.3333333333333333	0.0137221269296741	GO:0032940	GO:BP	secretion by cell	16175	7926		0.5714285714285714	0.5909090909090909	583	15592	8	16	575	15576	16175	0.0614816331145011
R1	cpdb	0	network_modules	11	TRUE	0.0023421019681164187	58	24	4	0.16666666666666666	0.06896551724137931	GO:0016079	GO:BP	synaptic vesicle exocytosis	16175	5106		0.6190476190476191	0.6363636363636364	58	16117	4	20	54	16097	16175	0.1051712811966921
R1	cpdb	0	network_modules	11	TRUE	0.0024798009978851004	16	24	3	0.125	0.1875	GO:0048791	GO:BP	calcium ion-regulated exocytosis of neurotransmitter	16175	13037		0.6666666666666666	0.6818181818181818	16	16159	3	21	13	16138	16175	0.15206964990454408
R1	cpdb	0	network_modules	11	TRUE	0.004036453050077967	646	24	8	0.3333333333333333	0.01238390092879257	GO:0140352	GO:BP	export from cell	16175	19748		0.7142857142857143	0.7272727272727273	646	15529	8	16	638	15513	16175	0.05775839794592207
R1	cpdb	0	network_modules	11	TRUE	0.004178355294243638	649	24	8	0.3333333333333333	0.012326656394453005	GO:0046903	GO:BP	secretion	16175	12430		0.7619047619047619	0.7727272727272727	649	15526	8	16	641	15510	16175	0.05759388498448083
R1	cpdb	0	network_modules	11	TRUE	0.006779710287488683	22	24	3	0.125	0.13636363636363635	GO:0018149	GO:BP	peptide cross-linking	16175	5337		0.8095238095238095	0.8181818181818182	22	16153	3	21	19	16132	16175	0.1293215278126346
R1	cpdb	0	network_modules	11	TRUE	0.009114875946244268	78	12	3	0.25	0.038461538461538464	KEGG:04721	KEGG	Synaptic vesicle cycle	8484	351		NA	1	78	8406	3	9	75	8397	8484	0.09495635205104383
R1	cpdb	0	network_modules	11	TRUE	0.009881539404908083	3	24	2	0.08333333333333333	0.6666666666666666	GO:0099525	GO:BP	presynaptic dense core vesicle exocytosis	16175	19109		0.8571428571428571	1	3	16172	2	22	1	16150	16175	0.23537416597204877
R1	cpdb	0	network_modules	11	TRUE	0.009881539404908083	3	24	2	0.08333333333333333	0.6666666666666666	GO:0099011	GO:BP	neuronal dense core vesicle exocytosis	16175	19004		0.8571428571428571	1	3	16172	2	22	1	16150	16175	0.23537416597204877
R1	cpdb	0	network_modules	11	TRUE	0.009881539404908083	3	24	2	0.08333333333333333	0.6666666666666666	GO:0061789	GO:BP	dense core granule priming	16175	15664		0.8571428571428571	1	3	16172	2	22	1	16150	16175	0.23537416597204877
R1	cpdb	0	network_modules	11	TRUE	0.009881539404908083	3	24	2	0.08333333333333333	0.6666666666666666	GO:1904071	GO:BP	presynaptic active zone assembly	16175	23509		0.8571428571428571	1	3	16172	2	22	1	16150	16175	0.23537416597204877
R1	cpdb	0	network_modules	12	TRUE	5.1853586549641643e-39	24	26	16	0.6153846153846154	0.6666666666666666	GO:0031145	GO:BP	anaphase-promoting complex-dependent catabolic process	16175	7063		0	0.016129032258064516	24	16151	16	10	8	16141	16175	0.6399573733132177
R1	cpdb	0	network_modules	12	TRUE	3.1158539039021333e-37	20	22	15	0.6818181818181818	0.75	REAC:R-HSA-176407	REAC	Conversion from APC/C:Cdc20 to APC/C:Cdh1 in late anaphase	10916	409		0	0.02631578947368421	20	10896	15	7	5	10889	10916	0.7145499838442245
R1	cpdb	0	network_modules	12	TRUE	1.0603652835352984e-33	20	22	14	0.6363636363636364	0.7	REAC:R-HSA-9687136	REAC	Aberrant regulation of mitotic exit in cancer due to RB1 defects	10916	49		0.02702702702702703	0.05263157894736842	20	10896	14	8	6	10888	10916	0.6667849647159725
R1	cpdb	0	network_modules	12	TRUE	3.178916066465167e-33	21	22	14	0.6363636363636364	0.6666666666666666	REAC:R-HSA-141405	REAC	Inhibition of the proteolytic activity of APC/C required for the onset of anaphase by mitotic spindle checkpoint components	10916	1199		0.05405405405405406	0.10526315789473684	21	10895	14	8	7	10887	10916	0.6506514085733128
R1	cpdb	0	network_modules	12	TRUE	3.178916066465167e-33	21	22	14	0.6363636363636364	0.6666666666666666	REAC:R-HSA-141430	REAC	Inactivation of APC/C via direct inhibition of the APC/C complex	10916	1176		0.05405405405405406	0.10526315789473684	21	10895	14	8	7	10887	10916	0.6506514085733128
R1	cpdb	0	network_modules	12	TRUE	3.4191455697717256e-32	50	26	16	0.6153846153846154	0.32	GO:0051445	GO:BP	regulation of meiotic cell cycle	16175	13708		0.01639344262295082	0.03225806451612903	50	16125	16	10	34	16115	16175	0.4425709240293252
R1	cpdb	0	network_modules	12	TRUE	5.350755339755646e-32	24	22	14	0.6363636363636364	0.5833333333333334	REAC:R-HSA-174048	REAC	APC/C:Cdc20 mediated degradation of Cyclin B	10916	25		0.10810810810810811	0.13157894736842105	24	10892	14	8	10	10884	10916	0.6084487928748435
R1	cpdb	0	network_modules	12	TRUE	2.6312305858911816e-31	26	22	14	0.6363636363636364	0.5384615384615384	REAC:R-HSA-179409	REAC	APC-Cdc20 mediated degradation of Nek2A	10916	23		0.13513513513513514	0.15789473684210525	26	10890	14	8	12	10882	10916	0.584463462421938
R1	cpdb	0	network_modules	12	TRUE	2.5659191798173025e-30	20	22	13	0.5909090909090909	0.65	REAC:R-HSA-176412	REAC	Phosphorylation of the APC/C	10916	1753		0.16216216216216217	0.18421052631578946	20	10896	13	9	7	10887	10916	0.6190199455877204
R1	cpdb	0	network_modules	12	TRUE	3.672804233992344e-30	31	26	14	0.5384615384615384	0.45161290322580644	GO:0070979	GO:BP	protein K11-linked ubiquitination	16175	16411		0.03278688524590164	0.04838709677419355	31	16144	14	12	17	16132	16175	0.4922411052943871
R1	cpdb	0	network_modules	12	TRUE	1.0272256789709068e-28	36	22	14	0.6363636363636364	0.3888888888888889	REAC:R-HSA-9687139	REAC	Aberrant regulation of mitotic cell cycle due to RB1 defects	10916	48		0.1891891891891892	0.21052631578947367	36	10880	14	8	22	10872	10916	0.49620859754684743
R1	cpdb	0	network_modules	12	TRUE	2.6128585919494553e-28	38	22	14	0.6363636363636364	0.3684210526315789	REAC:R-HSA-9675126	REAC	Diseases of mitotic cell cycle	10916	769		0.21621621621621623	0.23684210526315788	38	10878	14	8	24	10870	10916	0.4828785886599668
R1	cpdb	0	network_modules	12	TRUE	4.0732621857415355e-28	39	22	14	0.6363636363636364	0.358974358974359	REAC:R-HSA-8853884	REAC	Transcriptional Regulation by VENTX	10916	2547		0.24324324324324326	0.2631578947368421	39	10877	14	8	25	10869	10916	0.47660054935407964
R1	cpdb	0	network_modules	12	TRUE	4.20404349641448e-28	81	22	16	0.7272727272727273	0.19753086419753085	REAC:R-HSA-176408	REAC	Regulation of APC/C activators between G1/S and early anaphase	10916	1963		0.2702702702702703	0.2894736842105263	81	10835	16	6	65	10829	10916	0.3769360609392224
R1	cpdb	0	network_modules	12	TRUE	1.8051261755649777e-27	88	22	16	0.7272727272727273	0.18181818181818182	REAC:R-HSA-174143	REAC	APC/C-mediated degradation of cell cycle proteins	10916	24		0.2972972972972973	0.34210526315789475	88	10828	16	6	72	10822	10916	0.36142829068810023
R1	cpdb	0	network_modules	12	TRUE	1.8051261755649777e-27	88	22	16	0.7272727272727273	0.18181818181818182	REAC:R-HSA-453276	REAC	Regulation of mitotic cell cycle	10916	2044		0.2972972972972973	0.34210526315789475	88	10828	16	6	72	10822	10916	0.36142829068810023
R1	cpdb	0	network_modules	12	TRUE	1.8919172576082566e-27	140	19	17	0.8947368421052632	0.12142857142857143	KEGG:04120	KEGG	Ubiquitin mediated proteolysis	8484	270		0	0.2	140	8344	17	2	123	8342	8484	0.3266056168941562
R1	cpdb	0	network_modules	12	TRUE	3.5481386515171885e-26	74	22	15	0.6818181818181818	0.20270270270270271	REAC:R-HSA-174178	REAC	APC/C:Cdh1 mediated degradation of Cdc20 and other APC/C:Cdh1 targeted proteins in late mitosis/early G1	10916	28		0.35135135135135137	0.3684210526315789	74	10842	15	7	59	10835	10916	0.36969159468422996
R1	cpdb	0	network_modules	12	TRUE	8.052523815573726e-25	130	26	16	0.6153846153846154	0.12307692307692308	GO:2000241	GO:BP	regulation of reproductive process	16175	25569		0.04918032786885246	0.06451612903225806	130	16045	16	10	114	16035	16175	0.27293163222386035
R1	cpdb	0	network_modules	12	TRUE	1.2702331646289441e-24	64	22	14	0.6363636363636364	0.21875	REAC:R-HSA-174084	REAC	Autodegradation of Cdh1 by Cdh1:APC/C	10916	190		0.3783783783783784	0.39473684210526316	64	10852	14	8	50	10844	10916	0.3711264126516836
R1	cpdb	0	network_modules	12	TRUE	3.262015478711237e-24	68	22	14	0.6363636363636364	0.20588235294117646	REAC:R-HSA-174154	REAC	APC/C:Cdc20 mediated degradation of Securin	10916	26		0.40540540540540543	0.42105263157894735	68	10848	14	8	54	10840	10916	0.35990258985390927
R1	cpdb	0	network_modules	12	TRUE	4.9626854395722356e-24	157	19	16	0.8421052631578947	0.10191082802547771	KEGG:04110	KEGG	Cell cycle	8484	264		0.25	0.4	157	8327	16	3	141	8324	8484	0.2895250363202217
R1	cpdb	0	network_modules	12	TRUE	9.753188217408247e-24	73	22	14	0.6363636363636364	0.1917808219178082	REAC:R-HSA-69017	REAC	CDK-mediated phosphorylation and removal of Cdc6	10916	272		0.43243243243243246	0.47368421052631576	73	10843	14	8	59	10835	10916	0.34718608050873534
R1	cpdb	0	network_modules	12	TRUE	9.753188217408247e-24	73	22	14	0.6363636363636364	0.1917808219178082	REAC:R-HSA-174184	REAC	Cdc20:Phospho-APC/C mediated degradation of Cyclin A	10916	319		0.43243243243243246	0.47368421052631576	73	10843	14	8	59	10835	10916	0.34718608050873534
R1	cpdb	0	network_modules	12	TRUE	1.2020653144616438e-23	74	22	14	0.6363636363636364	0.1891891891891892	REAC:R-HSA-179419	REAC	APC:Cdc20 mediated degradation of cell cycle proteins prior to satisfation of the cell cycle checkpoint	10916	29		0.4864864864864865	0.5	74	10842	14	8	60	10834	10916	0.3447979813331329
R1	cpdb	0	network_modules	12	TRUE	1.8091863583410978e-23	76	22	14	0.6363636363636364	0.18421052631578946	REAC:R-HSA-176409	REAC	APC/C:Cdc20 mediated degradation of mitotic proteins	10916	27		0.5135135135135135	0.5263157894736842	76	10840	14	8	62	10832	10916	0.3401632834260701
R1	cpdb	0	network_modules	12	TRUE	2.2097054991021845e-23	77	22	14	0.6363636363636364	0.18181818181818182	REAC:R-HSA-176814	REAC	Activation of APC/C and APC/C:Cdc20 mediated degradation of mitotic proteins	10916	74		0.5405405405405406	0.5526315789473685	77	10839	14	8	63	10831	10916	0.3379136113390521
R1	cpdb	0	network_modules	12	TRUE	6.763165685641093e-23	131	19	15	0.7894736842105263	0.11450381679389313	KEGG:04114	KEGG	Oocyte meiosis	8484	268		0.5	0.6	131	8353	15	4	116	8349	8484	0.2974174772931633
R1	cpdb	0	network_modules	12	TRUE	3.2803515969292616e-22	92	22	14	0.6363636363636364	0.15217391304347827	REAC:R-HSA-69052	REAC	Switching of origins to a post-replicative state	10916	2365		0.5675675675675675	0.5789473684210527	92	10824	14	8	78	10816	10916	0.30868001322629857
R1	cpdb	0	network_modules	12	TRUE	3.578500982165458e-22	102	19	14	0.7368421052631579	0.13725490196078433	KEGG:04914	KEGG	Progesterone-mediated oocyte maturation	8484	371		0.75	0.8	102	8382	14	5	88	8377	8484	0.3150793337089574
R1	cpdb	0	network_modules	12	TRUE	1.3755224031325739e-21	203	26	16	0.6153846153846154	0.07881773399014778	GO:0051321	GO:BP	meiotic cell cycle	16175	13648		0.06557377049180328	0.08064516129032258	203	15972	16	10	187	15962	16175	0.21728437207212603
R1	cpdb	0	network_modules	12	TRUE	2.5269004559458107e-21	363	26	18	0.6923076923076923	0.049586776859504134	GO:0043161	GO:BP	proteasome-mediated ubiquitin-dependent protein catabolic process	16175	10561		0.08196721311475409	0.0967741935483871	363	15812	18	8	345	15804	16175	0.18146761871101588
R1	cpdb	0	network_modules	12	TRUE	3.3082703590079568e-21	590	26	20	0.7692307692307693	0.03389830508474576	GO:0016567	GO:BP	protein ubiquitination	16175	5254		0.09836065573770492	0.11290322580645161	590	15585	20	6	570	15579	16175	0.1568329693299933
R1	cpdb	0	network_modules	12	TRUE	4.125693482733322e-21	109	22	14	0.6363636363636364	0.12844036697247707	REAC:R-HSA-69618	REAC	Mitotic Spindle Checkpoint	10916	1486		0.5945945945945946	0.6052631578947368	109	10807	14	8	95	10799	10916	0.2831079445612729
R1	cpdb	0	network_modules	12	TRUE	5.4021894907622674e-21	111	22	14	0.6363636363636364	0.12612612612612611	REAC:R-HSA-2559582	REAC	Senescence-Associated Secretory Phenotype (SASP)	10916	2194		0.6216216216216216	0.631578947368421	111	10805	14	8	97	10797	10916	0.2804897242744351
R1	cpdb	0	network_modules	12	TRUE	1.9318587589728862e-20	121	22	14	0.6363636363636364	0.11570247933884298	REAC:R-HSA-69239	REAC	Synthesis of DNA	10916	2376		0.6486486486486487	0.6578947368421053	121	10795	14	8	107	10787	10916	0.26838053211312257
R1	cpdb	0	network_modules	12	TRUE	3.690578940753343e-20	248	26	16	0.6153846153846154	0.06451612903225806	GO:0000209	GO:BP	protein polyubiquitination	16175	59		0.11475409836065574	0.12903225806451613	248	15927	16	10	232	15917	16175	0.1959541336559054
R1	cpdb	0	network_modules	12	TRUE	3.884195354018992e-20	667	26	20	0.7692307692307693	0.029985007496251874	GO:0032446	GO:BP	protein modification by small protein conjugation	16175	7568		0.13114754098360656	0.14516129032258066	667	15508	20	6	647	15502	16175	0.146907953141843
R1	cpdb	0	network_modules	12	TRUE	2.016594300416815e-19	142	22	14	0.6363636363636364	0.09859154929577464	REAC:R-HSA-68867	REAC	Assembly of the pre-replicative complex	10916	181		0.6756756756756757	0.6842105263157895	142	10774	14	8	128	10766	10916	0.24722029292085287
R1	cpdb	0	network_modules	12	TRUE	2.7708707425627963e-19	470	26	18	0.6923076923076923	0.03829787234042553	GO:0010498	GO:BP	proteasomal protein catabolic process	16175	4177		0.14754098360655737	0.16129032258064516	470	15705	18	8	452	15697	16175	0.158441095383669
R1	cpdb	0	network_modules	12	TRUE	3.9545306544088316e-19	749	26	20	0.7692307692307693	0.0267022696929239	GO:0070647	GO:BP	protein modification by small protein conjugation or removal	16175	16231		0.16393442622950818	0.1774193548387097	749	15426	20	6	729	15420	16175	0.13803323360633585
R1	cpdb	0	network_modules	12	TRUE	1.0439927805949343e-18	159	22	14	0.6363636363636364	0.0880503144654088	REAC:R-HSA-69002	REAC	DNA Replication Pre-Initiation	10916	446		0.7027027027027027	0.7105263157894737	159	10757	14	8	145	10749	10916	0.23323099198601147
R1	cpdb	0	network_modules	12	TRUE	1.3687460776297646e-18	162	22	14	0.6363636363636364	0.08641975308641975	REAC:R-HSA-69242	REAC	S Phase	10916	2111		0.7297297297297297	0.7368421052631579	162	10754	14	8	148	10746	10916	0.23099144096032553
R1	cpdb	0	network_modules	12	TRUE	1.4012743249835762e-18	798	26	20	0.7692307692307693	0.02506265664160401	GO:0043687	GO:BP	post-translational protein modification	16175	10838		0.18032786885245902	0.1935483870967742	798	15377	20	6	778	15371	16175	0.13337986597639176
R1	cpdb	0	network_modules	12	TRUE	2.11606285711031e-18	229	22	15	0.6818181818181818	0.06550218340611354	REAC:R-HSA-2555396	REAC	Mitotic Metaphase and Anaphase	10916	1482		0.7567567567567568	0.7631578947368421	229	10687	15	7	214	10680	10916	0.2072200280363584
R1	cpdb	0	network_modules	12	TRUE	3.7418382366871115e-18	427	26	17	0.6538461538461539	0.03981264637002342	GO:0007346	GO:BP	regulation of mitotic cell cycle	16175	2855		0.19672131147540983	0.20967741935483872	427	15748	17	9	410	15739	16175	0.1570394707004219
R1	cpdb	0	network_modules	12	TRUE	4.293928553549349e-18	547	26	18	0.6923076923076923	0.03290676416819013	GO:0006511	GO:BP	ubiquitin-dependent protein catabolic process	16175	2235		0.21311475409836064	0.22580645161290322	547	15628	18	8	529	15620	16175	0.14617126770015834
R1	cpdb	0	network_modules	12	TRUE	5.577813978822406e-18	555	26	18	0.6923076923076923	0.032432432432432434	GO:0019941	GO:BP	modification-dependent protein catabolic process	16175	6072		0.22950819672131148	0.24193548387096775	555	15620	18	8	537	15612	16175	0.14504209075960003
R1	cpdb	0	network_modules	12	TRUE	6.347999160662051e-18	559	26	18	0.6923076923076923	0.03220035778175313	GO:0043632	GO:BP	modification-dependent macromolecule catabolic process	16175	10812		0.2459016393442623	0.25806451612903225	559	15616	18	8	541	15608	16175	0.14448641037131116
R1	cpdb	0	network_modules	12	TRUE	1.0858427013800014e-17	187	22	14	0.6363636363636364	0.0748663101604278	REAC:R-HSA-69306	REAC	DNA Replication	10916	445		0.7837837837837838	0.7894736842105263	187	10729	14	8	173	10721	10916	0.21445428181692663
R1	cpdb	0	network_modules	12	TRUE	1.1723941485577956e-17	188	22	14	0.6363636363636364	0.07446808510638298	REAC:R-HSA-2467813	REAC	Separation of Sister Chromatids	10916	2204		0.8108108108108109	0.8157894736842105	188	10728	14	8	174	10720	10916	0.21386148930570528
R1	cpdb	0	network_modules	12	TRUE	1.841201737453298e-17	194	22	14	0.6363636363636364	0.07216494845360824	REAC:R-HSA-2559583	REAC	Cellular Senescence	10916	331		0.8378378378378378	0.8421052631578947	194	10722	14	8	180	10714	10916	0.21040032428097932
R1	cpdb	0	network_modules	12	TRUE	2.3126556127964324e-17	218	19	14	0.7368421052631579	0.06422018348623854	KEGG:05166	KEGG	Human T-cell leukemia virus 1 infection	8484	447		1	1	218	8266	14	5	204	8261	8484	0.21293508128715644
R1	cpdb	0	network_modules	12	TRUE	1.7781498854101915e-16	673	26	18	0.6923076923076923	0.02674591381872214	GO:0051603	GO:BP	proteolysis involved in protein catabolic process	16175	13820		0.26229508196721313	0.27419354838709675	673	15502	18	8	655	15494	16175	0.13074880760727425
R1	cpdb	0	network_modules	12	TRUE	1.8553689231173617e-16	228	22	14	0.6363636363636364	0.06140350877192982	REAC:R-HSA-68882	REAC	Mitotic Anaphase	10916	1479		0.8648648648648649	0.868421052631579	228	10688	14	8	214	10680	10916	0.19340926237539857
R1	cpdb	0	network_modules	12	TRUE	1.9417137354735663e-16	308	22	15	0.6818181818181818	0.048701298701298704	REAC:R-HSA-983168	REAC	Antigen processing: Ubiquitination & Proteasome degradation	10916	154		0.8918918918918919	0.8947368421052632	308	10608	15	7	293	10601	10916	0.17737929231862917
R1	cpdb	0	network_modules	12	TRUE	8.430686575659875e-16	90	26	11	0.4230769230769231	0.12222222222222222	GO:0007091	GO:BP	metaphase/anaphase transition of mitotic cell cycle	16175	2675		0.2786885245901639	0.2903225806451613	90	16085	11	15	79	16070	16175	0.22521438853535092
R1	cpdb	0	network_modules	12	TRUE	1.0873640154397926e-15	92	26	11	0.4230769230769231	0.11956521739130435	GO:0044784	GO:BP	metaphase/anaphase transition of cell cycle	16175	11156		0.29508196721311475	0.3064516129032258	92	16083	11	15	81	16068	16175	0.22270083194663765
R1	cpdb	0	network_modules	12	TRUE	2.5346894979767093e-15	99	26	11	0.4230769230769231	0.1111111111111111	GO:0033045	GO:BP	regulation of sister chromatid segregation	16175	8000		0.3114754098360656	0.3225806451612903	99	16076	11	15	88	16061	16175	0.21450734108116176
R1	cpdb	0	network_modules	12	TRUE	4.636502368576142e-15	380	22	15	0.6818181818181818	0.039473684210526314	REAC:R-HSA-983169	REAC	Class I MHC mediated antigen processing & presentation	10916	368		0.918918918918919	0.9210526315789473	380	10536	15	7	365	10529	10916	0.15862090082276933
R1	cpdb	0	network_modules	12	TRUE	5.361909803051179e-15	289	22	14	0.6363636363636364	0.04844290657439446	REAC:R-HSA-69620	REAC	Cell Cycle Checkpoints	10916	321		0.9459459459459459	0.9473684210526315	289	10627	14	8	275	10619	10916	0.17071730002104013
R1	cpdb	0	network_modules	12	TRUE	1.2536733364056145e-14	406	22	15	0.6818181818181818	0.03694581280788178	REAC:R-HSA-68886	REAC	M Phase	10916	1343		0.972972972972973	0.9736842105263158	406	10510	15	7	391	10503	10916	0.15308195475625644
R1	cpdb	0	network_modules	12	TRUE	3.328632605210661e-14	124	26	11	0.4230769230769231	0.08870967741935484	GO:0051983	GO:BP	regulation of chromosome segregation	16175	14045		0.32786885245901637	0.3387096774193548	124	16051	11	15	113	16036	16175	0.19110586237971794
R1	cpdb	0	network_modules	12	TRUE	1.0158263463483445e-13	15	26	7	0.2692307692307692	0.4666666666666667	GO:1902101	GO:BP	positive regulation of metaphase/anaphase transition of cell cycle	16175	22015		0.3442622950819672	0.3709677419354839	15	16160	7	19	8	16141	16175	0.3536861342282694
R1	cpdb	0	network_modules	12	TRUE	1.0158263463483445e-13	15	26	7	0.2692307692307692	0.4666666666666667	GO:0045842	GO:BP	positive regulation of mitotic metaphase/anaphase transition	16175	11658		0.3442622950819672	0.3709677419354839	15	16160	7	19	8	16141	16175	0.3536861342282694
R1	cpdb	0	network_modules	12	TRUE	1.296749814800373e-13	792	26	17	0.6538461538461539	0.021464646464646464	GO:0000278	GO:BP	mitotic cell cycle	16175	76		0.3770491803278688	0.3870967741935484	792	15383	17	9	775	15374	16175	0.11247227574907467
R1	cpdb	0	network_modules	12	TRUE	2.0072567680144556e-13	651	26	16	0.6153846153846154	0.02457757296466974	GO:0019953	GO:BP	sexual reproduction	16175	6073		0.39344262295081966	0.4032258064516129	651	15524	16	10	635	15514	16175	0.11741873149074604
R1	cpdb	0	network_modules	12	TRUE	7.921550336098117e-13	19	26	7	0.2692307692307692	0.3684210526315789	GO:1901970	GO:BP	positive regulation of mitotic sister chromatid separation	16175	21909		0.4098360655737705	0.41935483870967744	19	16156	7	19	12	16137	16175	0.31400758987242233
R1	cpdb	0	network_modules	12	TRUE	1.7678542744839334e-11	217	26	11	0.4230769230769231	0.05069124423963134	GO:0000819	GO:BP	sister chromatid segregation	16175	237		0.4262295081967213	0.43548387096774194	217	15958	11	15	206	15943	16175	0.14287749820076878
R1	cpdb	0	network_modules	12	TRUE	2.428588360841129e-11	29	26	7	0.2692307692307692	0.2413793103448276	GO:1905820	GO:BP	positive regulation of chromosome separation	16175	24930		0.4426229508196721	0.45161290322580644	29	16146	7	19	22	16127	16175	0.25365860065430024
R1	cpdb	0	network_modules	12	TRUE	2.533497645506635e-11	56	26	8	0.3076923076923077	0.14285714285714285	GO:0010965	GO:BP	regulation of mitotic sister chromatid separation	16175	4541		0.45901639344262296	0.46774193548387094	56	16119	8	18	48	16101	16175	0.20782480028949368
R1	cpdb	0	network_modules	12	TRUE	3.206654176680855e-11	229	26	11	0.4230769230769231	0.048034934497816595	GO:0033044	GO:BP	regulation of chromosome organization	16175	7999		0.47540983606557374	0.4838709677419355	229	15946	11	15	218	15931	16175	0.13888396425640098
R1	cpdb	0	network_modules	12	TRUE	3.411893140366182e-11	58	26	8	0.3076923076923077	0.13793103448275862	GO:0051306	GO:BP	mitotic sister chromatid separation	16175	13637		0.4918032786885246	0.5	58	16117	8	18	50	16099	16175	0.20413984844474667
R1	cpdb	0	network_modules	12	TRUE	1.4721752575173786e-10	69	26	8	0.3076923076923077	0.11594202898550725	GO:1901992	GO:BP	positive regulation of mitotic cell cycle phase transition	16175	21925		0.5081967213114754	0.5161290322580645	69	16106	8	18	61	16088	16175	0.18680702807435717
R1	cpdb	0	network_modules	12	TRUE	1.6604840465923407e-10	70	26	8	0.3076923076923077	0.11428571428571428	GO:1905818	GO:BP	regulation of chromosome separation	16175	24928		0.5245901639344263	0.532258064516129	70	16105	8	18	62	16087	16175	0.1854358596631864
R1	cpdb	0	network_modules	12	TRUE	1.7289217628543315e-10	370	26	12	0.46153846153846156	0.032432432432432434	GO:0044772	GO:BP	mitotic cell cycle phase transition	16175	11148		0.5409836065573771	0.5483870967741935	370	15805	12	14	358	15791	16175	0.11773123141816773
R1	cpdb	0	network_modules	12	TRUE	2.3687675129124316e-10	39	26	7	0.2692307692307692	0.1794871794871795	GO:0045840	GO:BP	positive regulation of mitotic nuclear division	16175	11656		0.5573770491803278	0.5645161290322581	39	16136	7	19	32	16117	16175	0.21829595851853276
R1	cpdb	0	network_modules	12	TRUE	2.6047938226270003e-10	277	26	11	0.4230769230769231	0.039711191335740074	GO:0098813	GO:BP	nuclear chromosome segregation	16175	18900		0.5737704918032787	0.5806451612903226	277	15898	11	15	266	15883	16175	0.12555135715359514
R1	cpdb	0	network_modules	12	TRUE	3.29690262772853e-10	76	26	8	0.3076923076923077	0.10526315789473684	GO:0051304	GO:BP	chromosome separation	16175	13635		0.5901639344262295	0.5967741935483871	76	16099	8	18	68	16081	16175	0.1777810620969622
R1	cpdb	0	network_modules	12	TRUE	9.185772728434219e-10	86	26	8	0.3076923076923077	0.09302325581395349	GO:1901989	GO:BP	positive regulation of cell cycle phase transition	16175	21922		0.6065573770491803	0.6290322580645161	86	16089	8	18	78	16071	16175	0.16683644902168346
R1	cpdb	0	network_modules	12	TRUE	9.185772728434219e-10	86	26	8	0.3076923076923077	0.09302325581395349	GO:0030071	GO:BP	regulation of mitotic metaphase/anaphase transition	16175	6671		0.6065573770491803	0.6290322580645161	86	16089	8	18	78	16071	16175	0.16683644902168346
R1	cpdb	0	network_modules	12	TRUE	1.1105486160578108e-9	88	26	8	0.3076923076923077	0.09090909090909091	GO:1902099	GO:BP	regulation of metaphase/anaphase transition of cell cycle	16175	22013		0.639344262295082	0.6451612903225806	88	16087	8	18	80	16069	16175	0.16487248880030436
R1	cpdb	0	network_modules	12	TRUE	1.1234718138701165e-9	48	26	7	0.2692307692307692	0.14583333333333334	GO:0051785	GO:BP	positive regulation of nuclear division	16175	13935		0.6557377049180327	0.6612903225806451	48	16127	7	19	41	16108	16175	0.19641376704975563
R1	cpdb	0	network_modules	12	TRUE	1.7508516096057746e-9	93	26	8	0.3076923076923077	0.08602150537634409	GO:0045931	GO:BP	positive regulation of mitotic cell cycle	16175	11725		0.6721311475409836	0.6774193548387096	93	16082	8	18	85	16064	16175	0.1602400857253654
R1	cpdb	0	network_modules	12	TRUE	2.5775064224737435e-9	465	26	12	0.46153846153846156	0.025806451612903226	GO:0044770	GO:BP	cell cycle phase transition	16175	11146		0.6885245901639344	0.6935483870967742	465	15710	12	14	453	15696	16175	0.10392527669071475
R1	cpdb	0	network_modules	12	TRUE	4.677993278010357e-9	361	26	11	0.4230769230769231	0.030470914127423823	GO:0007059	GO:BP	chromosome segregation	16175	2658		0.7049180327868853	0.7096774193548387	361	15814	11	15	350	15799	16175	0.10885952960259489
R1	cpdb	0	network_modules	12	TRUE	5.118166757682988e-9	106	26	8	0.3076923076923077	0.07547169811320754	GO:0007088	GO:BP	regulation of mitotic nuclear division	16175	2673		0.7213114754098361	0.7258064516129032	106	16069	8	18	98	16051	16175	0.14975377186625838
R1	cpdb	0	network_modules	12	TRUE	1.3138581344575329e-8	119	26	8	0.3076923076923077	0.06722689075630252	GO:0051783	GO:BP	regulation of nuclear division	16175	13933		0.7377049180327869	0.7419354838709677	119	16056	8	18	111	16038	16175	0.14101727882262355
R1	cpdb	0	network_modules	12	TRUE	8.938362881077155e-8	630	26	12	0.46153846153846156	0.01904761904761905	GO:0010564	GO:BP	regulation of cell cycle process	16175	4217		0.7540983606557377	0.7580645161290323	630	15545	12	14	618	15531	16175	0.08764177715917167
R1	cpdb	0	network_modules	12	TRUE	1.4272567874784012e-7	656	26	12	0.46153846153846156	0.018292682926829267	GO:1903047	GO:BP	mitotic cell cycle process	16175	22727		0.7704918032786885	0.7741935483870968	656	15519	12	14	644	15505	16175	0.08563236442634337
R1	cpdb	0	network_modules	12	TRUE	3.3660084976514915e-7	178	26	8	0.3076923076923077	0.0449438202247191	GO:0000070	GO:BP	mitotic sister chromatid segregation	16175	24		0.7868852459016393	0.7903225806451613	178	15997	8	18	170	15979	16175	0.11411122608593564
R1	cpdb	0	network_modules	12	TRUE	3.8992327521278416e-7	545	26	11	0.4230769230769231	0.02018348623853211	GO:0051276	GO:BP	chromosome organization	16175	13613		0.8032786885245902	0.8064516129032258	545	15630	11	15	534	15615	16175	0.08658792612854867
R1	cpdb	0	network_modules	12	TRUE	4.968843976812883e-7	286	26	9	0.34615384615384615	0.03146853146853147	GO:1901990	GO:BP	regulation of mitotic cell cycle phase transition	16175	21923		0.819672131147541	0.8225806451612904	286	15889	9	17	277	15872	16175	0.10000587578247318
R1	cpdb	0	network_modules	12	TRUE	1.2075145787867122e-6	209	26	8	0.3076923076923077	0.03827751196172249	GO:0090068	GO:BP	positive regulation of cell cycle process	16175	17994		0.8360655737704918	0.8387096774193549	209	15966	8	18	201	15948	16175	0.10473018997278823
R1	cpdb	0	network_modules	12	TRUE	5.289423435298812e-6	252	26	8	0.3076923076923077	0.031746031746031744	GO:0140014	GO:BP	mitotic nuclear division	16175	19633		0.8524590163934426	0.8548387096774194	252	15923	8	18	244	15905	16175	0.09464460896697191
R1	cpdb	0	network_modules	12	TRUE	5.513153047126658e-6	376	26	9	0.34615384615384615	0.023936170212765957	GO:1901987	GO:BP	regulation of cell cycle phase transition	16175	21920		0.8688524590163934	0.8709677419354839	376	15799	9	17	367	15782	16175	0.08598612121720413
R1	cpdb	0	network_modules	12	TRUE	7.621776912736237e-6	264	26	8	0.3076923076923077	0.030303030303030304	GO:0045787	GO:BP	positive regulation of cell cycle	16175	11619		0.8852459016393442	0.8870967741935484	264	15911	8	18	256	15893	16175	0.09226850985925601
R1	cpdb	0	network_modules	12	TRUE	2.777112118919247e-5	19	26	4	0.15384615384615385	0.21052631578947367	GO:1904666	GO:BP	regulation of ubiquitin protein ligase activity	16175	24006		0.9016393442622951	0.9032258064516129	19	16156	4	22	15	16134	16175	0.17884318701465213
R1	cpdb	0	network_modules	12	TRUE	4.718534401969994e-5	6	22	3	0.13636363636363635	0.5	REAC:R-HSA-176417	REAC	Phosphorylation of Emi1	10916	1750		1	1	6	10910	3	19	3	10891	10916	0.26039801666268764
R1	cpdb	0	network_modules	12	TRUE	1.265960109601274e-4	379	26	8	0.3076923076923077	0.021108179419525065	GO:0000280	GO:BP	nuclear division	16175	78		0.9180327868852459	0.9193548387096774	379	15796	8	18	371	15778	16175	0.07540191753093094
R1	cpdb	0	network_modules	12	TRUE	2.9922702715640695e-4	424	26	8	0.3076923076923077	0.018867924528301886	GO:0048285	GO:BP	organelle fission	16175	12627		0.9344262295081968	0.9354838709677419	424	15751	8	18	416	15733	16175	0.07069149649412344
R1	cpdb	0	network_modules	12	TRUE	4.2740370063761187e-4	9	26	3	0.11538461538461539	0.3333333333333333	GO:1904668	GO:BP	positive regulation of ubiquitin protein ligase activity	16175	24008		0.9508196721311475	0.9516129032258065	9	16166	3	23	6	16143	16175	0.19538182665355472
R1	cpdb	0	network_modules	12	TRUE	5.766215495442562e-4	39	26	4	0.15384615384615385	0.10256410256410256	GO:0051438	GO:BP	regulation of ubiquitin-protein transferase activity	16175	13705		0.9672131147540983	0.967741935483871	39	16136	4	22	35	16114	16175	0.12389512983763872
R1	cpdb	0	network_modules	12	TRUE	0.004511747352281066	420	26	7	0.2692307692307692	0.016666666666666666	GO:0010638	GO:BP	positive regulation of organelle organization	16175	4284		0.9836065573770492	0.9838709677419355	420	15755	7	19	413	15736	16175	0.061376697908141147
R1	cpdb	0	network_modules	12	TRUE	0.0066811333727300375	21	26	3	0.11538461538461539	0.14285714285714285	GO:0051443	GO:BP	positive regulation of ubiquitin-protein transferase activity	16175	13706		1	1	21	16154	3	23	18	16131	16175	0.12712823401015022
R1	cpdb	0	network_modules	13	TRUE	9.67772229036584e-10	25	20	6	0.3	0.24	REAC:R-HSA-8854691	REAC	Interleukin-20 family signaling	10916	1242		0	0.047619047619047616	25	10891	6	14	19	10877	10916	0.26682972064593746
R1	cpdb	0	network_modules	13	TRUE	2.407126712491754e-7	236	28	9	0.32142857142857145	0.038135593220338986	GO:0043434	GO:BP	response to peptide hormone	16175	10691		0	0.015625	236	15939	9	19	227	15920	16175	0.10656147101170245
R1	cpdb	0	network_modules	13	TRUE	5.772429178667442e-7	10	20	4	0.2	0.4	REAC:R-HSA-9020958	REAC	Interleukin-21 signaling	10916	1243		0.05	0.09523809523809523	10	10906	4	16	6	10890	10916	0.2819346149013008
R1	cpdb	0	network_modules	13	TRUE	8.242082933414285e-7	162	17	7	0.4117647058823529	0.043209876543209874	KEGG:04630	KEGG	JAK-STAT signaling pathway	8484	332		0	0.16666666666666666	162	8322	7	10	155	8312	8484	0.1285631879250034
R1	cpdb	0	network_modules	13	TRUE	1.0719492094349865e-6	699	28	12	0.42857142857142855	0.017167381974248927	GO:0045321	GO:BP	leukocyte activation	16175	11356		0.015873015873015872	0.03125	699	15476	12	16	687	15460	16175	0.07891730125658551
R1	cpdb	0	network_modules	13	TRUE	1.5330401672196307e-6	555	28	11	0.39285714285714285	0.01981981981981982	GO:0071345	GO:BP	cellular response to cytokine stimulus	16175	16597		0.031746031746031744	0.046875	555	15620	11	17	544	15603	16175	0.08202268183797012
R1	cpdb	0	network_modules	13	TRUE	1.5508932370893082e-6	9	28	4	0.14285714285714285	0.4444444444444444	GO:0038110	GO:BP	interleukin-2-mediated signaling pathway	16175	9704		0.047619047619047616	0.078125	9	16166	4	24	5	16142	16175	0.25128233804226063
R1	cpdb	0	network_modules	13	TRUE	1.5508932370893082e-6	9	28	4	0.14285714285714285	0.4444444444444444	GO:0071352	GO:BP	cellular response to interleukin-2	16175	16604		0.047619047619047616	0.078125	9	16166	4	24	5	16142	16175	0.25128233804226063
R1	cpdb	0	network_modules	13	TRUE	2.479143659487802e-6	125	28	7	0.25	0.056	GO:0046631	GO:BP	alpha-beta T cell activation	16175	12268		0.07936507936507936	0.09375	125	16050	7	21	118	16029	16175	0.1152094560983262
R1	cpdb	0	network_modules	13	TRUE	2.561486618907937e-6	434	28	10	0.35714285714285715	0.02304147465437788	GO:0002521	GO:BP	leukocyte differentiation	16175	1043		0.09523809523809523	0.109375	434	15741	10	18	424	15723	16175	0.08512160913066665
R1	cpdb	0	network_modules	13	TRUE	2.5817530452173434e-6	10	28	4	0.14285714285714285	0.4	GO:0070669	GO:BP	response to interleukin-2	16175	16250		0.1111111111111111	0.125	10	16165	4	24	6	16141	16175	0.23829115796090963
R1	cpdb	0	network_modules	13	TRUE	2.6016132845561895e-6	206	28	8	0.2857142857142857	0.038834951456310676	GO:0030217	GO:BP	T cell differentiation	16175	6725		0.12698412698412698	0.140625	206	15969	8	20	198	15949	16175	0.10137561128055173
R1	cpdb	0	network_modules	13	TRUE	3.027551888322003e-6	31	28	5	0.17857142857142858	0.16129032258064516	GO:0043368	GO:BP	positive T cell selection	16175	10645		0.14285714285714285	0.15625	31	16144	5	23	26	16121	16175	0.16819637300857265
R1	cpdb	0	network_modules	13	TRUE	5.341888152286893e-6	625	28	11	0.39285714285714285	0.0176	GO:0034097	GO:BP	response to cytokine	16175	8408		0.15873015873015872	0.1875	625	15550	11	17	614	15533	16175	0.07653179584180961
R1	cpdb	0	network_modules	13	TRUE	5.341888152286893e-6	625	28	11	0.39285714285714285	0.0176	GO:1901652	GO:BP	response to peptide	16175	21619		0.15873015873015872	0.1875	625	15550	11	17	614	15533	16175	0.07653179584180961
R1	cpdb	0	network_modules	13	TRUE	6.061022045029422e-6	142	28	7	0.25	0.04929577464788732	GO:0007259	GO:BP	cell surface receptor signaling pathway via JAK-STAT	16175	2789		0.19047619047619047	0.203125	142	16033	7	21	135	16012	16175	0.10768146701648335
R1	cpdb	0	network_modules	13	TRUE	7.711907371996202e-6	37	28	5	0.17857142857142858	0.13513513513513514	GO:0045058	GO:BP	T cell selection	16175	11256		0.20634920634920634	0.21875	37	16138	5	23	32	16115	16175	0.1536612751289379
R1	cpdb	0	network_modules	13	TRUE	8.481392914584485e-6	149	28	7	0.25	0.04697986577181208	GO:0097696	GO:BP	cell surface receptor signaling pathway via STAT	16175	18727		0.2222222222222222	0.234375	149	16026	7	21	142	16005	16175	0.10495592864739245
R1	cpdb	0	network_modules	13	TRUE	9.244250125589421e-6	357	28	9	0.32142857142857145	0.025210084033613446	GO:1903131	GO:BP	mononuclear cell differentiation	16175	22787		0.23809523809523808	0.25	357	15818	9	19	348	15799	16175	0.08485112296176554
R1	cpdb	0	network_modules	13	TRUE	1.0423967648629735e-5	85	28	6	0.21428571428571427	0.07058823529411765	GO:0046632	GO:BP	alpha-beta T cell differentiation	16175	12269		0.25396825396825395	0.265625	85	16090	6	22	79	16068	16175	0.12039264444250808
R1	cpdb	0	network_modules	13	TRUE	1.6240324350860877e-5	21	20	4	0.2	0.19047619047619047	REAC:R-HSA-9008059	REAC	Interleukin-37 signaling	10916	1250		0.1	0.14285714285714285	21	10895	4	16	17	10879	10916	0.19366629709065022
R1	cpdb	0	network_modules	13	TRUE	2.82522018013218e-5	406	28	9	0.32142857142857145	0.022167487684729065	GO:0042110	GO:BP	T cell activation	16175	9970		0.2698412698412698	0.28125	406	15769	9	19	397	15750	16175	0.0788833120252993
R1	cpdb	0	network_modules	13	TRUE	3.4255835857734105e-5	569	28	10	0.35714285714285715	0.01757469244288225	GO:0046649	GO:BP	lymphocyte activation	16175	12286		0.2857142857142857	0.296875	569	15606	10	18	559	15588	16175	0.0727753435822967
R1	cpdb	0	network_modules	13	TRUE	3.7099682001079734e-5	419	28	9	0.32142857142857145	0.021479713603818614	GO:0019221	GO:BP	cytokine-mediated signaling pathway	16175	5598		0.30158730158730157	0.3125	419	15756	9	19	410	15737	16175	0.07747127912056623
R1	cpdb	0	network_modules	13	TRUE	3.726397370762878e-5	18	28	4	0.14285714285714285	0.2222222222222222	GO:0072540	GO:BP	T-helper 17 cell lineage commitment	16175	17438		0.31746031746031744	0.328125	18	16157	4	24	14	16133	16175	0.17703796751553944
R1	cpdb	0	network_modules	13	TRUE	4.580356148829455e-5	297	28	8	0.2857142857142857	0.026936026936026935	GO:0030098	GO:BP	lymphocyte differentiation	16175	6676		0.3333333333333333	0.34375	297	15878	8	20	289	15858	16175	0.08292504151856415
R1	cpdb	0	network_modules	13	TRUE	5.8861265398165824e-5	20	28	4	0.14285714285714285	0.2	GO:0002295	GO:BP	T-helper cell lineage commitment	16175	827		0.3492063492063492	0.359375	20	16155	4	24	16	16131	16175	0.167816839702699
R1	cpdb	0	network_modules	13	TRUE	6.296119265497435e-5	199	28	7	0.25	0.035175879396984924	GO:0071375	GO:BP	cellular response to peptide hormone stimulus	16175	16627		0.36507936507936506	0.375	199	15976	7	21	192	15955	16175	0.08979261809064754
R1	cpdb	0	network_modules	13	TRUE	6.911814901806105e-5	76	20	5	0.25	0.06578947368421052	REAC:R-HSA-909733	REAC	Interferon alpha/beta signaling	10916	1228		0.15	0.19047619047619047	76	10840	5	15	71	10825	10916	0.12522679433915962
R1	cpdb	0	network_modules	13	TRUE	7.35817492643081e-5	30	20	4	0.2	0.13333333333333333	REAC:R-HSA-9674555	REAC	Signaling by CSF3 (G-CSF)	10916	2227		0.2	0.23809523809523808	30	10886	4	16	26	10870	10916	0.1614250870743807
R1	cpdb	0	network_modules	13	TRUE	8.629016906544059e-5	59	28	5	0.17857142857142858	0.0847457627118644	GO:0042093	GO:BP	T-helper cell differentiation	16175	9964		0.38095238095238093	0.390625	59	16116	5	23	54	16093	16175	0.12082914730447339
R1	cpdb	0	network_modules	13	TRUE	8.715317397158873e-5	263	20	7	0.35	0.026615969581749048	REAC:R-HSA-913531	REAC	Interferon Signaling	10916	1227		0.25	0.2857142857142857	263	10653	7	13	256	10640	10916	0.09105938843943806
R1	cpdb	0	network_modules	13	TRUE	1.0100447643825346e-4	638	28	10	0.35714285714285715	0.01567398119122257	GO:0030097	GO:BP	hemopoiesis	16175	6675		0.3968253968253968	0.40625	638	15537	10	18	628	15519	16175	0.06796724694685954
R1	cpdb	0	network_modules	13	TRUE	1.0229642706922932e-4	61	28	5	0.17857142857142858	0.08196721311475409	GO:0002294	GO:BP	CD4-positive, alpha-beta T cell differentiation involved in immune response	16175	826		0.4126984126984127	0.421875	61	16114	5	23	56	16091	16175	0.11875520464035587
R1	cpdb	0	network_modules	13	TRUE	1.0719548262330762e-4	23	28	4	0.14285714285714285	0.17391304347826086	GO:0043373	GO:BP	CD4-positive, alpha-beta T cell lineage commitment	16175	10650		0.42857142857142855	0.453125	23	16152	4	24	19	16128	16175	0.15629957827469917
R1	cpdb	0	network_modules	13	TRUE	1.0719548262330762e-4	23	28	4	0.14285714285714285	0.17391304347826086	GO:0002363	GO:BP	alpha-beta T cell lineage commitment	16175	895		0.42857142857142855	0.453125	23	16152	4	24	19	16128	16175	0.15629957827469917
R1	cpdb	0	network_modules	13	TRUE	1.1053627490650228e-4	216	28	7	0.25	0.032407407407407406	GO:0002366	GO:BP	leukocyte activation involved in immune response	16175	898		0.4603174603174603	0.46875	216	15959	7	21	209	15938	16175	0.08585131372357886
R1	cpdb	0	network_modules	13	TRUE	1.1113776865732665e-4	62	28	5	0.17857142857142858	0.08064516129032258	GO:0002287	GO:BP	alpha-beta T cell activation involved in immune response	16175	819		0.47619047619047616	0.5	62	16113	5	23	57	16090	16175	0.11775560053186356
R1	cpdb	0	network_modules	13	TRUE	1.1113776865732665e-4	62	28	5	0.17857142857142858	0.08064516129032258	GO:0002293	GO:BP	alpha-beta T cell differentiation involved in immune response	16175	825		0.47619047619047616	0.5	62	16113	5	23	57	16090	16175	0.11775560053186356
R1	cpdb	0	network_modules	13	TRUE	1.284818447019468e-4	24	28	4	0.14285714285714285	0.16666666666666666	GO:0002360	GO:BP	T cell lineage commitment	16175	892		0.5079365079365079	0.53125	24	16151	4	24	20	16127	16175	0.1529465441689966
R1	cpdb	0	network_modules	13	TRUE	1.284818447019468e-4	24	28	4	0.14285714285714285	0.16666666666666666	GO:0043369	GO:BP	CD4-positive or CD8-positive, alpha-beta T cell lineage commitment	16175	10646		0.5079365079365079	0.53125	24	16151	4	24	20	16127	16175	0.1529465441689966
R1	cpdb	0	network_modules	13	TRUE	1.2928875806999057e-4	221	28	7	0.25	0.03167420814479638	GO:0002263	GO:BP	cell activation involved in immune response	16175	795		0.5396825396825397	0.546875	221	15954	7	21	214	15933	16175	0.08477700296113763
R1	cpdb	0	network_modules	13	TRUE	1.4822665818691074e-4	9	20	3	0.15	0.3333333333333333	REAC:R-HSA-8985947	REAC	Interleukin-9 signaling	10916	1256		0.3	0.38095238095238093	9	10907	3	17	6	10890	10916	0.22267354999920771
R1	cpdb	0	network_modules	13	TRUE	1.4822665818691074e-4	9	20	3	0.15	0.3333333333333333	REAC:R-HSA-2586552	REAC	Signaling by Leptin	10916	2266		0.3	0.38095238095238093	9	10907	3	17	6	10890	10916	0.22267354999920771
R1	cpdb	0	network_modules	13	TRUE	1.527621630539075e-4	66	28	5	0.17857142857142858	0.07575757575757576	GO:0002292	GO:BP	T cell differentiation involved in immune response	16175	824		0.5555555555555556	0.5625	66	16109	5	23	61	16086	16175	0.11398410640235737
R1	cpdb	0	network_modules	13	TRUE	2.3746466775636477e-4	72	28	5	0.17857142857142858	0.06944444444444445	GO:0043367	GO:BP	CD4-positive, alpha-beta T cell differentiation	16175	10644		0.5714285714285714	0.578125	72	16103	5	23	67	16080	16175	0.10891976171405779
R1	cpdb	0	network_modules	13	TRUE	2.7904078941657794e-4	7	28	3	0.10714285714285714	0.42857142857142855	GO:0038113	GO:BP	interleukin-9-mediated signaling pathway	16175	9707		0.5873015873015873	0.609375	7	16168	3	25	4	16143	16175	0.2136513790804247
R1	cpdb	0	network_modules	13	TRUE	2.7904078941657794e-4	7	28	3	0.10714285714285714	0.42857142857142855	GO:0071355	GO:BP	cellular response to interleukin-9	16175	16607		0.5873015873015873	0.609375	7	16168	3	25	4	16143	16175	0.2136513790804247
R1	cpdb	0	network_modules	13	TRUE	2.8547889473122025e-4	29	28	4	0.14285714285714285	0.13793103448275862	GO:0072539	GO:BP	T-helper 17 cell differentiation	16175	17437		0.6190476190476191	0.625	29	16146	4	24	25	16122	16175	0.1388554344222556
R1	cpdb	0	network_modules	13	TRUE	2.9047958422388765e-4	11	20	3	0.15	0.2727272727272727	REAC:R-HSA-1059683	REAC	Interleukin-6 signaling	10916	1254		0.4	0.42857142857142855	11	10905	3	17	8	10888	10916	0.2011868721154232
R1	cpdb	0	network_modules	13	TRUE	3.0960895971992615e-4	472	20	8	0.4	0.01694915254237288	REAC:R-HSA-449147	REAC	Signaling by Interleukins	10916	2261		0.45	0.47619047619047616	472	10444	8	12	464	10432	10916	0.07514802586973003
R1	cpdb	0	network_modules	13	TRUE	3.2048592500190083e-4	539	28	9	0.32142857142857145	0.016697588126159554	GO:0009725	GO:BP	response to hormone	16175	3623		0.6349206349206349	0.640625	539	15636	9	19	530	15617	16175	0.06684543925115011
R1	cpdb	0	network_modules	13	TRUE	3.5854259220876976e-4	44	20	4	0.2	0.09090909090909091	REAC:R-HSA-451927	REAC	Interleukin-2 family signaling	10916	1240		0.5	0.5238095238095238	44	10872	4	16	40	10856	10916	0.1325109539112535
R1	cpdb	0	network_modules	13	TRUE	3.8685362789884185e-4	12	20	3	0.15	0.25	REAC:R-HSA-8984722	REAC	Interleukin-35 Signalling	10916	1248		0.55	0.5714285714285714	12	10904	3	17	9	10887	10916	0.19251215763931284
R1	cpdb	0	network_modules	13	TRUE	4.295087923258644e-4	158	28	6	0.21428571428571427	0.0379746835443038	GO:0002285	GO:BP	lymphocyte activation involved in immune response	16175	817		0.6507936507936508	0.65625	158	16017	6	22	152	15995	16175	0.08659420713431258
R1	cpdb	0	network_modules	13	TRUE	4.4594768412236935e-4	8	28	3	0.10714285714285714	0.375	GO:0071104	GO:BP	response to interleukin-9	16175	16454		0.6666666666666666	0.671875	8	16167	3	25	5	16142	16175	0.19974295534656084
R1	cpdb	0	network_modules	13	TRUE	6.385722337373682e-4	14	20	3	0.15	0.21428571428571427	REAC:R-HSA-8983432	REAC	Interleukin-15 signaling	10916	1237		0.6	0.6190476190476191	14	10902	3	17	11	10885	10916	0.17802864463696338
R1	cpdb	0	network_modules	13	TRUE	6.523758717538493e-4	88	28	5	0.17857142857142858	0.056818181818181816	GO:0035710	GO:BP	CD4-positive, alpha-beta T cell activation	16175	9184		0.6825396825396826	0.6875	88	16087	5	23	83	16064	16175	0.09801063146648246
R1	cpdb	0	network_modules	13	TRUE	6.645504063258961e-4	158	17	5	0.29411764705882354	0.03164556962025317	KEGG:04217	KEGG	Necroptosis	8484	294		0.2	0.3333333333333333	158	8326	5	12	153	8314	8484	0.09131167303747925
R1	cpdb	0	network_modules	13	TRUE	6.681460795650107e-4	9	28	3	0.10714285714285714	0.3333333333333333	GO:0035771	GO:BP	interleukin-4-mediated signaling pathway	16175	9230		0.6984126984126984	0.703125	9	16166	3	25	6	16141	16175	0.18821611693635254
R1	cpdb	0	network_modules	13	TRUE	7.506509563020468e-4	162	17	5	0.29411764705882354	0.030864197530864196	KEGG:05161	KEGG	Hepatitis B	8484	442		0.4	0.5	162	8322	5	12	157	8310	8484	0.09004462711857161
R1	cpdb	0	network_modules	13	TRUE	7.846896369146674e-4	175	28	6	0.21428571428571427	0.03428571428571429	GO:0045165	GO:BP	cell fate commitment	16175	11307		0.7142857142857143	0.71875	175	16000	6	22	169	15978	16175	0.08190141132278424
R1	cpdb	0	network_modules	13	TRUE	7.863289405212752e-4	37	28	4	0.14285714285714285	0.10810810810810811	GO:0072538	GO:BP	T-helper 17 type immune response	16175	17436		0.7301587301587301	0.734375	37	16138	4	24	33	16114	16175	0.12253023484523481
R1	cpdb	0	network_modules	13	TRUE	9.533879337877791e-4	10	28	3	0.10714285714285714	0.3	GO:0060397	GO:BP	growth hormone receptor signaling pathway via JAK-STAT	16175	14600		0.746031746031746	0.75	10	16165	3	25	7	16140	16175	0.1784594367560398
R1	cpdb	0	network_modules	13	TRUE	0.001008243586731957	96	28	5	0.17857142857142858	0.052083333333333336	GO:0140888	GO:BP	interferon-mediated signaling pathway	16175	19923		0.7619047619047619	0.765625	96	16079	5	23	91	16056	16175	0.09359323901719177
R1	cpdb	0	network_modules	13	TRUE	0.0010298663344155004	619	28	9	0.32142857142857145	0.014539579967689823	GO:1901698	GO:BP	response to nitrogen compound	16175	21651		0.7777777777777778	0.78125	619	15556	9	19	610	15537	16175	0.06146309688873219
R1	cpdb	0	network_modules	13	TRUE	0.0012359826204824678	100	28	5	0.17857142857142858	0.05	GO:0002286	GO:BP	T cell activation involved in immune response	16175	818		0.7936507936507936	0.796875	100	16075	5	23	95	16052	16175	0.09158230370822343
R1	cpdb	0	network_modules	13	TRUE	0.0013093888251545815	11	28	3	0.10714285714285714	0.2727272727272727	GO:0035723	GO:BP	interleukin-15-mediated signaling pathway	16175	9193		0.8095238095238095	0.84375	11	16164	3	25	8	16139	16175	0.17006090420272324
R1	cpdb	0	network_modules	13	TRUE	0.0013093888251545815	11	28	3	0.10714285714285714	0.2727272727272727	GO:0071350	GO:BP	cellular response to interleukin-15	16175	16602		0.8095238095238095	0.84375	11	16164	3	25	8	16139	16175	0.17006090420272324
R1	cpdb	0	network_modules	13	TRUE	0.0013093888251545815	11	28	3	0.10714285714285714	0.2727272727272727	GO:0070672	GO:BP	response to interleukin-15	16175	16253		0.8095238095238095	0.84375	11	16164	3	25	8	16139	16175	0.17006090420272324
R1	cpdb	0	network_modules	13	TRUE	0.0014850131347075623	89	17	4	0.23529411764705882	0.0449438202247191	KEGG:04658	KEGG	Th1 and Th2 cell differentiation	8484	336		0.6	0.6666666666666666	89	8395	4	13	85	8382	8484	0.09886864955204107
R1	cpdb	0	network_modules	13	TRUE	0.0016314680364674509	654	28	9	0.32142857142857145	0.013761467889908258	GO:0031347	GO:BP	regulation of defense response	16175	7138		0.8571428571428571	0.859375	654	15521	9	19	645	15502	16175	0.05940575158399234
R1	cpdb	0	network_modules	13	TRUE	0.002112893279721258	334	28	7	0.25	0.020958083832335328	GO:0002250	GO:BP	adaptive immune response	16175	782		0.873015873015873	0.875	334	15841	7	21	327	15820	16175	0.06716038949373937
R1	cpdb	0	network_modules	13	TRUE	0.0028505999669847485	105	17	4	0.23529411764705882	0.0380952380952381	KEGG:04659	KEGG	Th17 cell differentiation	8484	337		0.8	0.8333333333333334	105	8379	4	13	101	8366	8484	0.09034715890673416
R1	cpdb	0	network_modules	13	TRUE	0.003263473154710179	76	20	4	0.2	0.05263157894736842	REAC:R-HSA-6806834	REAC	Signaling by MET	10916	2270		0.65	0.6666666666666666	76	10840	4	16	72	10824	10916	0.09946396571107319
R1	cpdb	0	network_modules	13	TRUE	0.0035094784688445447	24	20	3	0.15	0.125	REAC:R-HSA-912694	REAC	Regulation of IFNA/IFNB signaling	10916	1979		0.7	0.7619047619047619	24	10892	3	17	21	10875	10916	0.13519606957514896
R1	cpdb	0	network_modules	13	TRUE	0.0035094784688445447	24	20	3	0.15	0.125	REAC:R-HSA-6783589	REAC	Interleukin-6 family signaling	10916	1253		0.7	0.7619047619047619	24	10892	3	17	21	10875	10916	0.13519606957514896
R1	cpdb	0	network_modules	13	TRUE	0.0039833848544508525	25	20	3	0.15	0.12	REAC:R-HSA-9705462	REAC	Inactivation of CSF3 (G-CSF) signaling	10916	1178		0.8	0.8095238095238095	25	10891	3	17	22	10874	10916	0.13238852900778805
R1	cpdb	0	network_modules	13	TRUE	0.004101643230152553	369	28	7	0.25	0.018970189701897018	GO:0051249	GO:BP	regulation of lymphocyte activation	16175	13596		0.8888888888888888	0.890625	369	15806	7	21	362	15785	16175	0.06336314421296996
R1	cpdb	0	network_modules	13	TRUE	0.0043654055585514865	129	28	5	0.17857142857142858	0.03875968992248062	GO:0045580	GO:BP	regulation of T cell differentiation	16175	11431		0.9047619047619048	0.90625	129	16046	5	23	124	16023	16175	0.07986718539709937
R1	cpdb	0	network_modules	13	TRUE	0.0044976964357209	26	20	3	0.15	0.11538461538461539	REAC:R-HSA-186763	REAC	Downstream signal transduction	10916	790		0.85	0.8571428571428571	26	10890	3	17	23	10873	10916	0.12974307774804228
R1	cpdb	0	network_modules	13	TRUE	0.005358849775277653	17	28	3	0.10714285714285714	0.17647058823529413	GO:0071353	GO:BP	cellular response to interleukin-4	16175	16605		0.9206349206349206	0.921875	17	16158	3	25	14	16133	16175	0.13634560791566383
R1	cpdb	0	network_modules	13	TRUE	0.005419345167910193	756	28	9	0.32142857142857145	0.011904761904761904	GO:0050776	GO:BP	regulation of immune response	16175	13250		0.9365079365079365	0.9375	756	15419	9	19	747	15400	16175	0.05419146317689345
R1	cpdb	0	network_modules	13	TRUE	0.006423166935591639	18	28	3	0.10714285714285714	0.16666666666666666	GO:0070102	GO:BP	interleukin-6-mediated signaling pathway	16175	15914		0.9523809523809523	0.96875	18	16157	3	25	15	16132	16175	0.13243099629359648
R1	cpdb	0	network_modules	13	TRUE	0.006423166935591639	18	28	3	0.10714285714285714	0.16666666666666666	GO:0070670	GO:BP	response to interleukin-4	16175	16251		0.9523809523809523	0.96875	18	16157	3	25	15	16132	16175	0.13243099629359648
R1	cpdb	0	network_modules	13	TRUE	0.006450603655071502	4	20	2	0.1	0.5	REAC:R-HSA-8865999	REAC	MET activates PTPN11	10916	1363		0.9	0.9047619047619048	4	10912	2	18	2	10894	10916	0.22303266570648034
R1	cpdb	0	network_modules	13	TRUE	0.006679516979825819	91	20	4	0.2	0.04395604395604396	REAC:R-HSA-877300	REAC	Interferon gamma signaling	10916	1229		0.95	0.9523809523809523	91	10825	4	16	87	10809	10916	0.0903129440201157
R1	cpdb	0	network_modules	13	TRUE	0.008280692081214873	138	17	4	0.23529411764705882	0.028985507246376812	KEGG:05162	KEGG	Measles	8484	443		1	1	138	8346	4	13	134	8333	8484	0.07758569448500334
R1	cpdb	0	network_modules	13	TRUE	0.008520256921361111	32	20	3	0.15	0.09375	REAC:R-HSA-5655302	REAC	Signaling by FGFR1 in disease	10916	2243		1	1	32	10884	3	17	29	10867	10916	0.11654548499042781
R1	cpdb	0	network_modules	13	TRUE	0.009763920173586491	152	28	5	0.17857142857142858	0.03289473684210526	GO:0045619	GO:BP	regulation of lymphocyte differentiation	16175	11470		0.9841269841269841	0.984375	152	16023	5	23	147	16000	16175	0.07301596524869543
R1	cpdb	0	network_modules	13	TRUE	0.009790229171886664	421	28	7	0.25	0.0166270783847981	GO:0002694	GO:BP	regulation of leukocyte activation	16175	1212		1	1	421	15754	7	21	414	15733	16175	0.05857806069331507
R1	cpdb	0	network_modules	14	TRUE	3.0002987041382163e-12	72	14	8	0.5714285714285714	0.1111111111111111	KEGG:05218	KEGG	Melanoma	8484	469		0	0.00980392156862745	72	8412	8	6	64	8406	8484	0.24950011525112703
R1	cpdb	0	network_modules	14	TRUE	1.0845294144299512e-11	84	14	8	0.5714285714285714	0.09523809523809523	KEGG:04012	KEGG	ErbB signaling pathway	8484	245		0.009900990099009901	0.0196078431372549	84	8400	8	6	76	8394	8484	0.23057636027725104
R1	cpdb	0	network_modules	14	TRUE	9.159008742940178e-11	58	14	7	0.5	0.1206896551724138	KEGG:05213	KEGG	Endometrial cancer	8484	464		0.019801980198019802	0.029411764705882353	58	8426	7	7	51	8419	8484	0.2433264187972279
R1	cpdb	0	network_modules	14	TRUE	2.931701246139434e-10	68	14	7	0.5	0.10294117647058823	KEGG:05211	KEGG	Renal cell carcinoma	8484	462		0.0297029702970297	0.0392156862745098	68	8416	7	7	61	8409	8484	0.2243197114530712
R1	cpdb	0	network_modules	14	TRUE	3.185698170744483e-10	211	14	9	0.6428571428571429	0.04265402843601896	KEGG:05207	KEGG	Chemical carcinogenesis - receptor activation	8484	459		0.039603960396039604	0.049019607843137254	211	8273	9	5	202	8268	8484	0.16133531099488108
R1	cpdb	0	network_modules	14	TRUE	4.441903425615012e-10	72	14	7	0.5	0.09722222222222222	KEGG:05223	KEGG	Non-small cell lung cancer	8484	474		0.04950495049504951	0.058823529411764705	72	8412	7	7	65	8405	8484	0.21784243731097147
R1	cpdb	0	network_modules	14	TRUE	5.971861664875853e-10	75	14	7	0.5	0.09333333333333334	KEGG:05214	KEGG	Glioma	8484	465		0.0594059405940594	0.06862745098039216	75	8409	7	7	68	8402	8484	0.21332561443702483
R1	cpdb	0	network_modules	14	TRUE	6.172859265893036e-10	227	14	9	0.6428571428571429	0.039647577092511016	KEGG:04810	KEGG	Regulation of actin cytoskeleton	8484	365		0.06930693069306931	0.0784313725490196	227	8257	9	5	218	8252	8484	0.1552210946625225
R1	cpdb	0	network_modules	14	TRUE	6.572919692522703e-10	76	14	7	0.5	0.09210526315789473	KEGG:05212	KEGG	Pancreatic cancer	8484	463		0.07920792079207921	0.08823529411764706	76	8408	7	7	69	8401	8484	0.21187925178730502
R1	cpdb	0	network_modules	14	TRUE	8.440737954273831e-10	235	14	9	0.6428571428571429	0.03829787234042553	KEGG:04014	KEGG	Ras signaling pathway	8484	247		0.0891089108910891	0.09803921568627451	235	8249	9	5	226	8244	8484	0.1523965118104432
R1	cpdb	0	network_modules	14	TRUE	8.696288502629844e-10	79	14	7	0.5	0.08860759493670886	KEGG:01521	KEGG	EGFR tyrosine kinase inhibitor resistance	8484	195		0.09900990099009901	0.10784313725490197	79	8405	7	7	72	8398	8484	0.20770469762993513
R1	cpdb	0	network_modules	14	TRUE	1.064756916606054e-9	147	14	8	0.5714285714285714	0.05442176870748299	KEGG:05224	KEGG	Breast cancer	8484	475		0.10891089108910891	0.11764705882352941	147	8337	8	6	139	8331	8484	0.17264300860387424
R1	cpdb	0	network_modules	14	TRUE	1.124882111662863e-9	148	14	8	0.5714285714285714	0.05405405405405406	KEGG:05226	KEGG	Gastric cancer	8484	477		0.1188118811881188	0.12745098039215685	148	8336	8	6	140	8330	8484	0.1720324838863825
R1	cpdb	0	network_modules	14	TRUE	1.6037728048277609e-9	86	14	7	0.5	0.08139534883720931	KEGG:05210	KEGG	Colorectal cancer	8484	461		0.12871287128712872	0.13725490196078433	86	8398	7	7	79	8391	8484	0.19882028444263536
R1	cpdb	0	network_modules	14	TRUE	2.052093322853661e-9	89	14	7	0.5	0.07865168539325842	KEGG:05235	KEGG	PD-L1 expression and PD-1 checkpoint pathway in cancer	8484	480		0.13861386138613863	0.14705882352941177	89	8395	7	7	82	8388	8484	0.19533447077566915
R1	cpdb	0	network_modules	14	TRUE	3.803693777115413e-9	97	14	7	0.5	0.07216494845360824	KEGG:05215	KEGG	Prostate cancer	8484	466		0.1485148514851485	0.1568627450980392	97	8387	7	7	90	8380	8484	0.18683475158085475
R1	cpdb	0	network_modules	14	TRUE	4.093300816440546e-9	98	14	7	0.5	0.07142857142857142	KEGG:05231	KEGG	Choline metabolism in cancer	8484	479		0.15841584158415842	0.16666666666666666	98	8386	7	7	91	8379	8484	0.1858453043661829
R1	cpdb	0	network_modules	14	TRUE	1.3786281767893847e-8	202	14	8	0.5714285714285714	0.039603960396039604	KEGG:04510	KEGG	Focal adhesion	8484	313		0.16831683168316833	0.17647058823529413	202	8282	8	6	194	8276	8484	0.14603542547909362
R1	cpdb	0	network_modules	14	TRUE	1.4457832136456724e-8	59	14	6	0.42857142857142855	0.1016949152542373	KEGG:04370	KEGG	VEGF signaling pathway	8484	307		0.1782178217821782	0.18627450980392157	59	8425	6	8	53	8417	8484	0.20626725651422764
R1	cpdb	0	network_modules	14	TRUE	1.471029557807513e-8	21	15	5	0.3333333333333333	0.23809523809523808	REAC:R-HSA-912631	REAC	Regulation of signaling by CBL	10916	2049		0	0.020833333333333332	21	10895	5	10	16	10885	10916	0.2805548257817498
R1	cpdb	0	network_modules	14	TRUE	1.6322307301419974e-8	119	14	7	0.5	0.058823529411764705	KEGG:04660	KEGG	T cell receptor signaling pathway	8484	338		0.18811881188118812	0.19607843137254902	119	8365	7	7	112	8358	8484	0.16800770297728337
R1	cpdb	0	network_modules	14	TRUE	1.8815294679719652e-8	210	14	8	0.5714285714285714	0.0380952380952381	KEGG:04015	KEGG	Rap1 signaling pathway	8484	248		0.19801980198019803	0.20588235294117646	210	8274	8	6	202	8268	8484	0.1430492717939069
R1	cpdb	0	network_modules	14	TRUE	2.3959830724455054e-8	64	14	6	0.42857142857142855	0.09375	KEGG:04929	KEGG	GnRH secretion	8484	386		0.2079207920792079	0.21568627450980393	64	8420	6	8	58	8412	8484	0.19782798622450973
R1	cpdb	0	network_modules	14	TRUE	2.8299351995623626e-8	221	14	8	0.5714285714285714	0.03619909502262444	KEGG:05208	KEGG	Chemical carcinogenesis - reactive oxygen species	8484	460		0.21782178217821782	0.22549019607843138	221	8263	8	6	213	8257	8484	0.1392056296212942
R1	cpdb	0	network_modules	14	TRUE	3.181435578222949e-8	67	14	6	0.42857142857142855	0.08955223880597014	KEGG:04664	KEGG	Fc epsilon RI signaling pathway	8484	340		0.22772277227722773	0.24509803921568626	67	8417	6	8	61	8409	8484	0.19322031940572326
R1	cpdb	0	network_modules	14	TRUE	3.181435578222949e-8	67	14	6	0.42857142857142855	0.08955223880597014	KEGG:05221	KEGG	Acute myeloid leukemia	8484	472		0.22772277227722773	0.24509803921568626	67	8417	6	8	61	8409	8484	0.19322031940572326
R1	cpdb	0	network_modules	14	TRUE	3.223424944649062e-8	131	14	7	0.5	0.05343511450381679	KEGG:04068	KEGG	FoxO signaling pathway	8484	258		0.24752475247524752	0.2549019607843137	131	8353	7	7	124	8346	8484	0.15977649907195898
R1	cpdb	0	network_modules	14	TRUE	4.169721790315126e-8	70	14	6	0.42857142857142855	0.08571428571428572	KEGG:05230	KEGG	Central carbon metabolism in cancer	8484	478		0.25742574257425743	0.27450980392156865	70	8414	6	8	64	8406	8484	0.18890931692555732
R1	cpdb	0	network_modules	14	TRUE	4.169721790315126e-8	70	14	6	0.42857142857142855	0.08571428571428572	KEGG:04917	KEGG	Prolactin signaling pathway	8484	374		0.25742574257425743	0.27450980392156865	70	8414	6	8	64	8406	8484	0.18890931692555732
R1	cpdb	0	network_modules	14	TRUE	4.7370873724843214e-8	26	15	5	0.3333333333333333	0.19230769230769232	REAC:R-HSA-912526	REAC	Interleukin receptor SHC signaling	10916	1230		0.02127659574468085	0.041666666666666664	26	10890	5	10	21	10880	10916	0.25184871412294296
R1	cpdb	0	network_modules	14	TRUE	4.9605963506099287e-8	72	14	6	0.42857142857142855	0.08333333333333333	KEGG:01524	KEGG	Platinum drug resistance	8484	198		0.27722772277227725	0.28431372549019607	72	8412	6	8	66	8404	8484	0.1861847593708159
R1	cpdb	0	network_modules	14	TRUE	5.313009369917076e-8	65	15	6	0.4	0.09230769230769231	REAC:R-HSA-2219530	REAC	Constitutive Signaling by Aberrant PI3K in Cancer	10916	401		0.0425531914893617	0.0625	65	10851	6	9	59	10842	10916	0.18998999460458302
R1	cpdb	0	network_modules	14	TRUE	6.918606433707525e-8	76	14	6	0.42857142857142855	0.07894736842105263	KEGG:05220	KEGG	Chronic myeloid leukemia	8484	471		0.2871287128712871	0.29411764705882354	76	8408	6	8	70	8400	8484	0.18105860210340993
R1	cpdb	0	network_modules	14	TRUE	7.267386422926671e-8	147	14	7	0.5	0.047619047619047616	KEGG:04072	KEGG	Phospholipase D signaling pathway	8484	261		0.297029702970297	0.30392156862745096	147	8337	7	7	140	8330	8484	0.15038781540796958
R1	cpdb	0	network_modules	14	TRUE	1.0228957146267595e-7	81	14	6	0.42857142857142855	0.07407407407407407	KEGG:04662	KEGG	B cell receptor signaling pathway	8484	339		0.3069306930693069	0.3137254901960784	81	8403	6	8	75	8395	8484	0.17518714156301407
R1	cpdb	0	network_modules	14	TRUE	1.2069868704780357e-7	158	14	7	0.5	0.04430379746835443	KEGG:05160	KEGG	Hepatitis C	8484	441		0.31683168316831684	0.3235294117647059	158	8326	7	7	151	8319	8484	0.1447642415539934
R1	cpdb	0	network_modules	14	TRUE	1.3371375769466815e-7	37	14	5	0.35714285714285715	0.13513513513513514	KEGG:04960	KEGG	Aldosterone-regulated sodium reabsorption	8484	396		0.32673267326732675	0.3333333333333333	37	8447	5	9	32	8438	8484	0.2176591457657613
R1	cpdb	0	network_modules	14	TRUE	1.4384652281252468e-7	162	14	7	0.5	0.043209876543209874	KEGG:04630	KEGG	JAK-STAT signaling pathway	8484	332		0.33663366336633666	0.3431372549019608	162	8322	7	7	155	8315	8484	0.14286015361036358
R1	cpdb	0	network_modules	14	TRUE	1.7067510275244609e-7	166	14	7	0.5	0.04216867469879518	KEGG:05225	KEGG	Hepatocellular carcinoma	8484	476		0.3465346534653465	0.35294117647058826	166	8318	7	7	159	8311	8484	0.14102398608376016
R1	cpdb	0	network_modules	14	TRUE	2.708207867177256e-7	95	14	6	0.42857142857142855	0.06315789473684211	KEGG:01522	KEGG	Endocrine resistance	8484	196		0.3564356435643564	0.3627450980392157	95	8389	6	8	89	8381	8484	0.1612617392949658
R1	cpdb	0	network_modules	14	TRUE	2.8864005425731326e-7	96	14	6	0.42857142857142855	0.0625	KEGG:04666	KEGG	Fc gamma R-mediated phagocytosis	8484	341		0.36633663366336633	0.37254901960784315	96	8388	6	8	90	8380	8484	0.16038389166323716
R1	cpdb	0	network_modules	14	TRUE	3.126448725716962e-7	181	14	7	0.5	0.03867403314917127	KEGG:04360	KEGG	Axon guidance	8484	305		0.37623762376237624	0.38235294117647056	181	8303	7	7	174	8296	8484	0.1346785697862919
R1	cpdb	0	network_modules	14	TRUE	3.58165061442878e-7	38	15	5	0.3333333333333333	0.13157894736842105	REAC:R-HSA-8853659	REAC	RET signaling	10916	1845		0.06382978723404255	0.08333333333333333	38	10878	5	10	33	10868	10916	0.2077442692669519
R1	cpdb	0	network_modules	14	TRUE	4.074679418281034e-7	188	14	7	0.5	0.03723404255319149	KEGG:04613	KEGG	Neutrophil extracellular trap formation	8484	323		0.38613861386138615	0.39215686274509803	188	8296	7	7	181	8289	8484	0.13197533124437918
R1	cpdb	0	network_modules	14	TRUE	4.1714150818592204e-7	46	14	5	0.35714285714285715	0.10869565217391304	KEGG:04930	KEGG	Type II diabetes mellitus	8484	387		0.39603960396039606	0.4019607843137255	46	8438	5	9	41	8429	8484	0.19472533296010772
R1	cpdb	0	network_modules	14	TRUE	4.172063546653805e-7	102	14	6	0.42857142857142855	0.058823529411764705	KEGG:04914	KEGG	Progesterone-mediated oocyte maturation	8484	371		0.40594059405940597	0.4117647058823529	102	8382	6	8	96	8374	8484	0.1553870936379598
R1	cpdb	0	network_modules	14	TRUE	4.4994995835702273e-7	92	15	6	0.4	0.06521739130434782	REAC:R-HSA-2219528	REAC	PI3K/AKT Signaling in Cancer	10916	1674		0.0851063829787234	0.125	92	10824	6	9	86	10815	10916	0.1588911891789213
R1	cpdb	0	network_modules	14	TRUE	4.4994995835702273e-7	92	15	6	0.4	0.06521739130434782	REAC:R-HSA-6811558	REAC	PI5P, PP2A and IER3 Regulate PI3K/AKT Signaling	10916	1677		0.0851063829787234	0.125	92	10824	6	9	86	10815	10916	0.1588911891789213
R1	cpdb	0	network_modules	14	TRUE	4.6638702399176534e-7	47	14	5	0.35714285714285715	0.10638297872340426	KEGG:04973	KEGG	Carbohydrate digestion and absorption	8484	404		0.4158415841584158	0.4215686274509804	47	8437	5	9	42	8428	8484	0.19258950304284989
R1	cpdb	0	network_modules	14	TRUE	4.69369608551541e-7	104	14	6	0.42857142857142855	0.057692307692307696	KEGG:04625	KEGG	C-type lectin receptor signaling pathway	8484	330		0.42574257425742573	0.43137254901960786	104	8380	6	8	98	8372	8484	0.153816997117264
R1	cpdb	0	network_modules	14	TRUE	6.238467284445198e-7	109	14	6	0.42857142857142855	0.05504587155963303	KEGG:04066	KEGG	HIF-1 signaling pathway	8484	257		0.43564356435643564	0.4411764705882353	109	8375	6	8	103	8367	8484	0.15007975619278396
R1	cpdb	0	network_modules	14	TRUE	7.035473649897193e-7	99	15	6	0.4	0.06060606060606061	REAC:R-HSA-199418	REAC	Negative regulation of the PI3K/AKT network	10916	1580		0.1276595744680851	0.14583333333333334	99	10817	6	9	93	10808	10916	0.15296948354695872
R1	cpdb	0	network_modules	14	TRUE	7.713789221021104e-7	44	15	5	0.3333333333333333	0.11363636363636363	REAC:R-HSA-451927	REAC	Interleukin-2 family signaling	10916	1240		0.14893617021276595	0.16666666666666666	44	10872	5	10	39	10862	10916	0.19279245075570325
R1	cpdb	0	network_modules	14	TRUE	8.804164291682519e-7	210	14	7	0.5	0.03333333333333333	KEGG:05170	KEGG	Human immunodeficiency virus 1 infection	8484	451		0.44554455445544555	0.45098039215686275	210	8274	7	7	203	8267	8484	0.1243584872516241
R1	cpdb	0	network_modules	14	TRUE	1.0076977662735421e-6	118	14	6	0.42857142857142855	0.05084745762711865	KEGG:04722	KEGG	Neurotrophin signaling pathway	8484	352		0.45544554455445546	0.46078431372549017	118	8366	6	8	112	8358	8484	0.14395216933883412
R1	cpdb	0	network_modules	14	TRUE	1.0870389582780024e-6	47	15	5	0.3333333333333333	0.10638297872340426	REAC:R-HSA-512988	REAC	Interleukin-3, Interleukin-5 and GM-CSF signaling	10916	1246		0.1702127659574468	0.1875	47	10869	5	10	42	10859	10916	0.1864080916849508
R1	cpdb	0	network_modules	14	TRUE	1.1152327713722152e-6	120	14	6	0.42857142857142855	0.05	KEGG:04935	KEGG	Growth hormone synthesis, secretion and action	8484	392		0.46534653465346537	0.4803921568627451	120	8364	6	8	114	8356	8484	0.14268343101239545
R1	cpdb	0	network_modules	14	TRUE	1.1152327713722152e-6	120	14	6	0.42857142857142855	0.05	KEGG:04071	KEGG	Sphingolipid signaling pathway	8484	260		0.46534653465346537	0.4803921568627451	120	8364	6	8	114	8356	8484	0.14268343101239545
R1	cpdb	0	network_modules	14	TRUE	1.172460347350044e-6	121	14	6	0.42857142857142855	0.049586776859504134	KEGG:04919	KEGG	Thyroid hormone signaling pathway	8484	376		0.48514851485148514	0.49019607843137253	121	8363	6	8	115	8355	8484	0.14206068631520818
R1	cpdb	0	network_modules	14	TRUE	1.2346655415747723e-6	356	14	8	0.5714285714285714	0.02247191011235955	KEGG:04151	KEGG	PI3K-Akt signaling pathway	8484	285		0.49504950495049505	0.5	356	8128	8	6	348	8122	8484	0.10736067017182653
R1	cpdb	0	network_modules	14	TRUE	1.3589205974812724e-6	124	14	6	0.42857142857142855	0.04838709677419355	KEGG:04650	KEGG	Natural killer cell mediated cytotoxicity	8484	334		0.504950495049505	0.5098039215686274	124	8360	6	8	118	8352	8484	0.1402370729786895
R1	cpdb	0	network_modules	14	TRUE	1.3796275213677615e-6	58	14	5	0.35714285714285715	0.08620689655172414	KEGG:04923	KEGG	Regulation of lipolysis in adipocytes	8484	380		0.5148514851485149	0.5196078431372549	58	8426	5	9	53	8417	8484	0.1728408500634229
R1	cpdb	0	network_modules	14	TRUE	1.723947964999394e-6	129	14	6	0.42857142857142855	0.046511627906976744	KEGG:04926	KEGG	Relaxin signaling pathway	8484	383		0.5247524752475248	0.5294117647058824	129	8355	6	8	123	8347	8484	0.13733777156928645
R1	cpdb	0	network_modules	14	TRUE	1.7864578929526902e-6	61	14	5	0.35714285714285715	0.08196721311475409	KEGG:04213	KEGG	Longevity regulating pathway - multiple species	8484	290		0.5346534653465347	0.5392156862745098	61	8423	5	9	56	8414	8484	0.16839693879838427
R1	cpdb	0	network_modules	14	TRUE	1.83473508474016e-6	52	15	5	0.3333333333333333	0.09615384615384616	REAC:R-HSA-1660499	REAC	Synthesis of PIPs at the plasma membrane	10916	2395		0.19148936170212766	0.20833333333333334	52	10864	5	10	47	10854	10916	0.1770137187843968
R1	cpdb	0	network_modules	14	TRUE	2.2655092485869674e-6	135	14	6	0.42857142857142855	0.044444444444444446	KEGG:04210	KEGG	Apoptosis	8484	287		0.5445544554455446	0.5490196078431373	135	8349	6	8	129	8341	8484	0.13406959845983815
R1	cpdb	0	network_modules	14	TRUE	2.3681327561281845e-6	136	14	6	0.42857142857142855	0.04411764705882353	KEGG:04915	KEGG	Estrogen signaling pathway	8484	372		0.5544554455445545	0.5588235294117647	136	8348	6	8	130	8340	8484	0.13354563043857476
R1	cpdb	0	network_modules	14	TRUE	2.4745710923147047e-6	137	14	6	0.42857142857142855	0.043795620437956206	KEGG:04910	KEGG	Insulin signaling pathway	8484	367		0.5643564356435643	0.5686274509803921	137	8347	6	8	131	8339	8484	0.13302729643206482
R1	cpdb	0	network_modules	14	TRUE	2.584935306011463e-6	138	14	6	0.42857142857142855	0.043478260869565216	KEGG:05418	KEGG	Fluid shear stress and atherosclerosis	8484	495		0.5742574257425742	0.5784313725490197	138	8346	6	8	132	8338	8484	0.13251449456555803
R1	cpdb	0	network_modules	14	TRUE	2.7288777166789205e-6	50	18	5	0.2777777777777778	0.1	GO:0046854	GO:BP	phosphatidylinositol phosphate biosynthetic process	16175	12405		0	0.09090909090909091	50	16125	5	13	45	16112	16175	0.16515919974383517
R1	cpdb	0	network_modules	14	TRUE	3.1996966224399373e-6	143	14	6	0.42857142857142855	0.04195804195804196	KEGG:04550	KEGG	Signaling pathways regulating pluripotency of stem cells	8484	319		0.5841584158415841	0.5882352941176471	143	8341	6	8	137	8333	8484	0.1300300767774793
R1	cpdb	0	network_modules	14	TRUE	5.181193733891664e-6	155	14	6	0.42857142857142855	0.03870967741935484	KEGG:04218	KEGG	Cellular senescence	8484	295		0.594059405940594	0.6078431372549019	155	8329	6	8	149	8321	8484	0.1245558287827804
R1	cpdb	0	network_modules	14	TRUE	5.181193733891664e-6	155	14	6	0.42857142857142855	0.03870967741935484	KEGG:04150	KEGG	mTOR signaling pathway	8484	284		0.594059405940594	0.6078431372549019	155	8329	6	8	149	8321	8484	0.1245558287827804
R1	cpdb	0	network_modules	14	TRUE	5.849223767376234e-6	77	14	5	0.35714285714285715	0.06493506493506493	KEGG:05100	KEGG	Bacterial invasion of epithelial cells	8484	423		0.6138613861386139	0.6176470588235294	77	8407	5	9	72	8398	8484	0.14921753910983462
R1	cpdb	0	network_modules	14	TRUE	6.743673055153746e-6	162	14	6	0.42857142857142855	0.037037037037037035	KEGG:05161	KEGG	Hepatitis B	8484	442		0.6237623762376238	0.6274509803921569	162	8322	6	8	156	8314	8484	0.12164121903000076
R1	cpdb	0	network_modules	14	TRUE	7.522971171726932e-6	165	14	6	0.42857142857142855	0.03636363636363636	KEGG:04140	KEGG	Autophagy - animal	8484	277		0.6336633663366337	0.6372549019607843	165	8319	6	8	159	8311	8484	0.12044794425829354
R1	cpdb	0	network_modules	14	TRUE	8.082682427818864e-6	167	14	6	0.42857142857142855	0.03592814371257485	KEGG:05164	KEGG	Influenza A	8484	445		0.6435643564356436	0.6470588235294118	167	8317	6	8	161	8309	8484	0.11966992702625188
R1	cpdb	0	network_modules	14	TRUE	1.215761548726707e-5	89	14	5	0.35714285714285715	0.056179775280898875	KEGG:04211	KEGG	Longevity regulating pathway	8484	288		0.6534653465346535	0.6568627450980392	89	8395	5	9	84	8386	8484	0.1383286006624712
R1	cpdb	0	network_modules	14	TRUE	1.4365577872266105e-5	92	14	5	0.35714285714285715	0.05434782608695652	KEGG:05222	KEGG	Small cell lung cancer	8484	473		0.6633663366336634	0.6666666666666666	92	8392	5	9	87	8383	8484	0.13594005861998606
R1	cpdb	0	network_modules	14	TRUE	1.7393880747991463e-5	190	14	6	0.42857142857142855	0.031578947368421054	KEGG:04062	KEGG	Chemokine signaling pathway	8484	255		0.6732673267326733	0.6764705882352942	190	8294	6	8	184	8286	8484	0.11160374542848465
R1	cpdb	0	network_modules	14	TRUE	1.8742239302501017e-5	97	14	5	0.35714285714285715	0.05154639175257732	KEGG:04070	KEGG	Phosphatidylinositol signaling system	8484	259		0.6831683168316832	0.6862745098039216	97	8387	5	9	92	8378	8484	0.13220418006915488
R1	cpdb	0	network_modules	14	TRUE	1.96778484567008e-5	194	14	6	0.42857142857142855	0.030927835051546393	KEGG:05167	KEGG	Kaposi sarcoma-associated herpesvirus infection	8484	448		0.693069306930693	0.696078431372549	194	8290	6	8	188	8282	8484	0.11034560710239727
R1	cpdb	0	network_modules	14	TRUE	1.973229503486384e-5	98	14	5	0.35714285714285715	0.05102040816326531	KEGG:04750	KEGG	Inflammatory mediator regulation of TRP channels	8484	364		0.7029702970297029	0.7058823529411765	98	8386	5	9	93	8377	8484	0.1314909344598572
R1	cpdb	0	network_modules	14	TRUE	1.9778940542476733e-5	330	14	7	0.5	0.021212121212121213	KEGG:05165	KEGG	Human papillomavirus infection	8484	446		0.7128712871287128	0.7156862745098039	330	8154	7	7	323	8147	8484	0.09695692543556653
R1	cpdb	0	network_modules	14	TRUE	2.0015383457035663e-5	83	15	5	0.3333333333333333	0.060240963855421686	REAC:R-HSA-1483255	REAC	PI Metabolism	10916	1665		0.2127659574468085	0.22916666666666666	83	10833	5	10	78	10823	10916	0.13909774272103598
R1	cpdb	0	network_modules	14	TRUE	2.1836711552747044e-5	100	14	5	0.35714285714285715	0.05	KEGG:04933	KEGG	AGE-RAGE signaling pathway in diabetic complications	8484	390		0.7227722772277227	0.7254901960784313	100	8384	5	9	95	8375	8484	0.1300961061893279
R1	cpdb	0	network_modules	14	TRUE	2.2349286365171406e-5	31	15	4	0.26666666666666666	0.12903225806451613	REAC:R-HSA-389356	REAC	Co-stimulation by CD28	10916	378		0.23404255319148937	0.25	31	10885	4	11	27	10874	10916	0.18390766511096948
R1	cpdb	0	network_modules	14	TRUE	2.2953572296207733e-5	101	14	5	0.35714285714285715	0.04950495049504951	KEGG:05146	KEGG	Amoebiasis	8484	438		0.7326732673267327	0.7450980392156863	101	8383	5	9	96	8374	8484	0.12941400105946058
R1	cpdb	0	network_modules	14	TRUE	2.2953572296207733e-5	101	14	5	0.35714285714285715	0.04950495049504951	KEGG:05142	KEGG	Chagas disease	8484	434		0.7326732673267327	0.7450980392156863	101	8383	5	9	96	8374	8484	0.12941400105946058
R1	cpdb	0	network_modules	14	TRUE	2.7264368923225196e-5	205	14	6	0.42857142857142855	0.02926829268292683	KEGG:05205	KEGG	Proteoglycans in cancer	8484	457		0.7524752475247525	0.7549019607843137	205	8279	6	8	199	8271	8484	0.10707230668914586
R1	cpdb	0	network_modules	14	TRUE	2.923653512192671e-5	106	14	5	0.35714285714285715	0.04716981132075472	KEGG:04620	KEGG	Toll-like receptor signaling pathway	8484	325		0.7623762376237624	0.7647058823529411	106	8378	5	9	101	8369	8484	0.1261468964882817
R1	cpdb	0	network_modules	14	TRUE	3.210121515773983e-5	108	14	5	0.35714285714285715	0.046296296296296294	KEGG:04931	KEGG	Insulin resistance	8484	388		0.7722772277227723	0.7745098039215687	108	8376	5	9	103	8367	8484	0.12490283967231605
R1	cpdb	0	network_modules	14	TRUE	3.7070832858844075e-5	35	15	4	0.26666666666666666	0.11428571428571428	REAC:R-HSA-114604	REAC	GPVI-mediated activation cascade	10916	1021		0.2553191489361702	0.2708333333333333	35	10881	4	11	31	10870	10916	0.17287127968240615
R1	cpdb	0	network_modules	14	TRUE	3.9182276761016806e-5	218	14	6	0.42857142857142855	0.027522935779816515	KEGG:05166	KEGG	Human T-cell leukemia virus 1 infection	8484	447		0.7821782178217822	0.7843137254901961	218	8266	6	8	212	8258	8484	0.10351860807522249
R1	cpdb	0	network_modules	14	TRUE	4.0242702277954924e-5	113	14	5	0.35714285714285715	0.04424778761061947	KEGG:04725	KEGG	Cholinergic synapse	8484	355		0.7920792079207921	0.803921568627451	113	8371	5	9	108	8362	8484	0.12193569250516761
R1	cpdb	0	network_modules	14	TRUE	4.0242702277954924e-5	113	14	5	0.35714285714285715	0.04424778761061947	KEGG:04668	KEGG	TNF signaling pathway	8484	342		0.7920792079207921	0.803921568627451	113	8371	5	9	108	8362	8484	0.12193569250516761
R1	cpdb	0	network_modules	14	TRUE	4.205116341146086e-5	114	14	5	0.35714285714285715	0.043859649122807015	KEGG:04670	KEGG	Leukocyte transendothelial migration	8484	343		0.8118811881188119	0.8137254901960784	114	8370	5	9	109	8361	8484	0.12136534021428486
R1	cpdb	0	network_modules	14	TRUE	4.376949573261153e-5	510	18	8	0.4444444444444444	0.01568627450980392	GO:0007169	GO:BP	cell surface receptor protein tyrosine kinase signaling pathway	16175	2733		0.1	0.18181818181818182	510	15665	8	10	502	15655	16175	0.07886963317857791
R1	cpdb	0	network_modules	14	TRUE	4.4778686690239045e-5	223	14	6	0.42857142857142855	0.026905829596412557	KEGG:05163	KEGG	Human cytomegalovirus infection	8484	444		0.8217821782178217	0.8333333333333334	223	8261	6	8	217	8253	8484	0.10223270648237236
R1	cpdb	0	network_modules	14	TRUE	4.4778686690239045e-5	223	14	6	0.42857142857142855	0.026905829596412557	KEGG:04024	KEGG	cAMP signaling pathway	8484	252		0.8217821782178217	0.8333333333333334	223	8261	6	8	217	8253	8484	0.10223270648237236
R1	cpdb	0	network_modules	14	TRUE	5.429872671343418e-5	120	14	5	0.35714285714285715	0.041666666666666664	KEGG:04152	KEGG	AMPK signaling pathway	8484	286		0.8415841584158416	0.8431372549019608	120	8364	5	9	115	8355	8484	0.11809123556486655
R1	cpdb	0	network_modules	14	TRUE	5.518151557000285e-5	9	15	3	0.2	0.3333333333333333	REAC:R-HSA-198203	REAC	PI3K/AKT activation	10916	1675		0.2765957446808511	0.2916666666666667	9	10907	3	12	6	10895	10916	0.25741748318742463
R1	cpdb	0	network_modules	14	TRUE	6.392017209252825e-5	124	14	5	0.35714285714285715	0.04032258064516129	KEGG:04611	KEGG	Platelet activation	8484	321		0.8514851485148515	0.8529411764705882	124	8360	5	9	119	8351	8484	0.11603899034056711
R1	cpdb	0	network_modules	14	TRUE	7.876571735972976e-5	10	15	3	0.2	0.3	REAC:R-HSA-9673770	REAC	Signaling by PDGFRA extracellular domain mutants	10916	2293		0.2978723404255319	0.3333333333333333	10	10906	3	12	7	10894	10916	0.244106536843253
R1	cpdb	0	network_modules	14	TRUE	7.876571735972976e-5	10	15	3	0.2	0.3	REAC:R-HSA-9673767	REAC	Signaling by PDGFRA transmembrane, juxtamembrane and kinase domain mutants	10916	2294		0.2978723404255319	0.3333333333333333	10	10906	3	12	7	10894	10916	0.244106536843253
R1	cpdb	0	network_modules	14	TRUE	8.719062093264343e-5	132	14	5	0.35714285714285715	0.03787878787878788	KEGG:04380	KEGG	Osteoclast differentiation	8484	309		0.8613861386138614	0.8627450980392157	132	8352	5	9	127	8343	8484	0.11221178873323975
R1	cpdb	0	network_modules	14	TRUE	1.0109560281002914e-4	136	14	5	0.35714285714285715	0.03676470588235294	KEGG:05135	KEGG	Yersinia infection	8484	432		0.8712871287128713	0.8725490196078431	136	8348	5	9	131	8339	8484	0.11042315842549581
R1	cpdb	0	network_modules	14	TRUE	1.0867509429088349e-4	138	14	5	0.35714285714285715	0.036231884057971016	KEGG:05162	KEGG	Measles	8484	443		0.8811881188118812	0.8823529411764706	138	8346	5	9	133	8337	8484	0.1095574380456243
R1	cpdb	0	network_modules	14	TRUE	1.2087870443227449e-4	141	14	5	0.35714285714285715	0.03546099290780142	KEGG:05017	KEGG	Spinocerebellar ataxia	8484	415		0.8910891089108911	0.8921568627450981	141	8343	5	9	136	8334	8484	0.10829269863694387
R1	cpdb	0	network_modules	14	TRUE	1.4416569993232393e-4	12	15	3	0.2	0.25	REAC:R-HSA-9027276	REAC	Erythropoietin activates Phosphoinositide-3-kinase (PI3K)	10916	857		0.3404255319148936	0.3541666666666667	12	10904	3	12	9	10892	10916	0.22265309968803057
R1	cpdb	0	network_modules	14	TRUE	1.7804983808655112e-4	418	15	7	0.4666666666666667	0.01674641148325359	REAC:R-HSA-5663202	REAC	Diseases of signal transduction by growth factor receptors and second messengers	10916	773		0.3617021276595745	0.375	418	10498	7	8	411	10490	10916	0.08280525912576112
R1	cpdb	0	network_modules	14	TRUE	1.868366414816182e-4	154	14	5	0.35714285714285715	0.032467532467532464	KEGG:04932	KEGG	Non-alcoholic fatty liver disease	8484	389		0.900990099009901	0.9019607843137255	154	8330	5	9	149	8321	8484	0.10323532593235851
R1	cpdb	0	network_modules	14	TRUE	1.9296898309388528e-4	253	15	6	0.4	0.023715415019762844	REAC:R-HSA-1257604	REAC	PIP3 activates AKT signaling	10916	1679		0.3829787234042553	0.3958333333333333	253	10663	6	9	247	10654	10916	0.09289951319522176
R1	cpdb	0	network_modules	14	TRUE	1.9761413270926755e-4	116	18	5	0.2777777777777778	0.04310344827586207	GO:0006661	GO:BP	phosphatidylinositol biosynthetic process	16175	2370		0.2	0.2727272727272727	116	16059	5	13	111	16046	16175	0.1070408884944166
R1	cpdb	0	network_modules	14	TRUE	2.0220723224304016e-4	235	18	6	0.3333333333333333	0.02553191489361702	GO:0043491	GO:BP	phosphatidylinositol 3-kinase/protein kinase B signal transduction	16175	10736		0.3	0.36363636363636365	235	15940	6	12	229	15928	16175	0.0889297065790683
R1	cpdb	0	network_modules	14	TRUE	2.2145965234627484e-4	259	15	6	0.4	0.023166023166023165	REAC:R-HSA-76002	REAC	Platelet activation, signaling and aggregation	10916	1762		0.40425531914893614	0.4166666666666667	259	10657	6	9	253	10648	10916	0.09170902864436835
R1	cpdb	0	network_modules	14	TRUE	3.065204280504383e-4	310	14	6	0.42857142857142855	0.01935483870967742	KEGG:05206	KEGG	MicroRNAs in cancer	8484	458		0.9108910891089109	0.9117647058823529	310	8174	6	8	304	8166	8484	0.08494667688895415
R1	cpdb	0	network_modules	14	TRUE	3.614046334002599e-4	12	18	3	0.16666666666666666	0.25	GO:0036092	GO:BP	phosphatidylinositol-3-phosphate biosynthetic process	16175	9435		0.4	0.45454545454545453	12	16163	3	15	9	16148	16175	0.20340415639299522
R1	cpdb	0	network_modules	14	TRUE	3.657579443393749e-4	16	15	3	0.2	0.1875	REAC:R-HSA-210993	REAC	Tie2 Signaling	10916	2509		0.425531914893617	0.4375	16	10900	3	12	13	10888	10916	0.19250331445187688
R1	cpdb	0	network_modules	14	TRUE	4.3754129884983816e-4	136	18	5	0.2777777777777778	0.03676470588235294	GO:0046488	GO:BP	phosphatidylinositol metabolic process	16175	12192		0.5	0.5454545454545454	136	16039	5	13	131	16026	16175	0.09846704155316967
R1	cpdb	0	network_modules	14	TRUE	4.437682804254711e-4	17	15	3	0.2	0.17647058823529413	REAC:R-HSA-9670439	REAC	Signaling by phosphorylated juxtamembrane, extracellular and kinase domain KIT mutants	10916	2326		0.44680851063829785	0.4791666666666667	17	10899	3	12	14	10887	10916	0.18667803647579717
R1	cpdb	0	network_modules	14	TRUE	4.437682804254711e-4	17	15	3	0.2	0.17647058823529413	REAC:R-HSA-9669938	REAC	Signaling by KIT in disease	10916	2262		0.44680851063829785	0.4791666666666667	17	10899	3	12	14	10887	10916	0.18667803647579717
R1	cpdb	0	network_modules	14	TRUE	4.5606773021821396e-4	293	15	6	0.4	0.020477815699658702	REAC:R-HSA-9006925	REAC	Intracellular signaling by second messengers	10916	1266		0.48936170212765956	0.5	293	10623	6	9	287	10614	10916	0.08564699261030748
R1	cpdb	0	network_modules	14	TRUE	5.288094558457781e-4	67	15	4	0.26666666666666666	0.05970149253731343	REAC:R-HSA-388841	REAC	Regulation of T cell activation by CD28 family	10916	2007		0.5106382978723404	0.5208333333333334	67	10849	4	11	63	10838	10916	0.12373700939442242
R1	cpdb	0	network_modules	14	TRUE	5.320826517285181e-4	18	15	3	0.2	0.16666666666666666	REAC:R-HSA-9671555	REAC	Signaling by PDGFR in disease	10916	2292		0.5319148936170213	0.5416666666666666	18	10898	3	12	15	10886	10916	0.1813430115663804
R1	cpdb	0	network_modules	14	TRUE	6.102764538436308e-4	308	15	6	0.4	0.01948051948051948	REAC:R-HSA-5683057	REAC	MAPK family signaling cascades	10916	1348		0.5531914893617021	0.5625	308	10608	6	9	302	10599	10916	0.08328661187957936
R1	cpdb	0	network_modules	14	TRUE	6.40372385609744e-4	198	14	5	0.35714285714285715	0.025252525252525252	KEGG:05169	KEGG	Epstein-Barr virus infection	8484	450		0.9207920792079208	0.9215686274509803	198	8286	5	9	193	8277	8484	0.08988981820027263
R1	cpdb	0	network_modules	14	TRUE	6.890477787619285e-4	201	14	5	0.35714285714285715	0.024875621890547265	KEGG:05203	KEGG	Viral carcinogenesis	8484	455		0.9306930693069307	0.9313725490196079	201	8283	5	9	196	8274	8484	0.0891381057435332
R1	cpdb	0	network_modules	14	TRUE	7.059020283770541e-4	202	14	5	0.35714285714285715	0.024752475247524754	KEGG:05415	KEGG	Diabetic cardiomyopathy	8484	492		0.9405940594059405	0.9411764705882353	202	8282	5	9	197	8273	8484	0.08889112855249177
R1	cpdb	0	network_modules	14	TRUE	7.472927374616213e-4	73	15	4	0.26666666666666666	0.0547945205479452	REAC:R-HSA-9009391	REAC	Extra-nuclear estrogen signaling	10916	888		0.574468085106383	0.5833333333333334	73	10843	4	11	69	10832	10916	0.1183255385680386
R1	cpdb	0	network_modules	14	TRUE	9.345377199275359e-4	214	14	5	0.35714285714285715	0.02336448598130841	KEGG:05417	KEGG	Lipid and atherosclerosis	8484	494		0.9504950495049505	0.9509803921568627	214	8270	5	9	209	8261	8484	0.0860588070716054
R1	cpdb	0	network_modules	14	TRUE	0.0010008661079990483	22	15	3	0.2	0.13636363636363635	REAC:R-HSA-389357	REAC	CD28 dependent PI3K/Akt signaling	10916	267		0.5957446808510638	0.6041666666666666	22	10894	3	12	19	10882	10916	0.1637579498907437
R1	cpdb	0	network_modules	14	TRUE	0.001020036796476119	382	14	6	0.42857142857142855	0.015706806282722512	KEGG:05010	KEGG	Alzheimer disease	8484	411		0.9603960396039604	0.9607843137254902	382	8102	6	8	376	8094	8484	0.07519899914017898
R1	cpdb	0	network_modules	14	TRUE	0.0011500464662575801	23	15	3	0.2	0.13043478260869565	REAC:R-HSA-373753	REAC	Nephrin family interactions	10916	1582		0.6170212765957447	0.6458333333333334	23	10893	3	12	20	10881	10916	0.16009167612828332
R1	cpdb	0	network_modules	14	TRUE	0.0011500464662575801	23	15	3	0.2	0.13043478260869565	REAC:R-HSA-9006335	REAC	Signaling by Erythropoietin	10916	2238		0.6170212765957447	0.6458333333333334	23	10893	3	12	20	10881	10916	0.16009167612828332
R1	cpdb	0	network_modules	14	TRUE	0.001262191944425717	790	18	8	0.4444444444444444	0.010126582278481013	GO:0007167	GO:BP	enzyme-linked receptor protein signaling pathway	16175	2731		0.6	0.6363636363636364	790	15385	8	10	782	15375	16175	0.06126298634115005
R1	cpdb	0	network_modules	14	TRUE	0.0013535070480908452	231	14	5	0.35714285714285715	0.021645021645021644	KEGG:05171	KEGG	Coronavirus disease - COVID-19	8484	452		0.9702970297029703	0.9705882352941176	231	8253	5	9	226	8244	8484	0.0824163351537273
R1	cpdb	0	network_modules	14	TRUE	0.0014911034402193993	25	15	3	0.2	0.12	REAC:R-HSA-201556	REAC	Signaling by ALK	10916	2217		0.6595744680851063	0.6875	25	10891	3	12	22	10879	10916	0.15342645994579163
R1	cpdb	0	network_modules	14	TRUE	0.0014911034402193993	25	15	3	0.2	0.12	REAC:R-HSA-2424491	REAC	DAP12 signaling	10916	433		0.6595744680851063	0.6875	25	10891	3	12	22	10879	10916	0.15342645994579163
R1	cpdb	0	network_modules	14	TRUE	0.0016842045228516408	26	15	3	0.2	0.11538461538461539	REAC:R-HSA-186763	REAC	Downstream signal transduction	10916	790		0.7021276595744681	0.7083333333333334	26	10890	3	12	23	10878	10916	0.15038421648994627
R1	cpdb	0	network_modules	14	TRUE	0.0018338767312404774	246	14	5	0.35714285714285715	0.02032520325203252	KEGG:05131	KEGG	Shigellosis	8484	428		0.9801980198019802	0.9803921568627451	246	8238	5	9	241	8229	8484	0.07950841506691098
R1	cpdb	0	network_modules	14	TRUE	0.0019441620245202276	249	14	5	0.35714285714285715	0.020080321285140562	KEGG:05132	KEGG	Salmonella infection	8484	429		0.9900990099009901	0.9901960784313726	249	8235	5	9	244	8226	8484	0.07895721588294467
R1	cpdb	0	network_modules	14	TRUE	0.0020279530008416586	210	15	5	0.3333333333333333	0.023809523809523808	REAC:R-HSA-1483257	REAC	Phospholipid metabolism	10916	1748		0.723404255319149	0.7291666666666666	210	10706	5	10	205	10696	10916	0.08482316204285008
R1	cpdb	0	network_modules	14	TRUE	0.0020584314075528624	94	15	4	0.26666666666666666	0.0425531914893617	REAC:R-HSA-4420097	REAC	VEGFA-VEGFR2 Pathway	10916	2634		0.7446808510638298	0.75	94	10822	4	11	90	10811	10916	0.10360276280696454
R1	cpdb	0	network_modules	14	TRUE	0.002234879976985367	189	18	5	0.2777777777777778	0.026455026455026454	GO:0046474	GO:BP	glycerophospholipid biosynthetic process	16175	12181		0.7	0.7272727272727273	189	15986	5	13	184	15973	16175	0.08264811486174718
R1	cpdb	0	network_modules	14	TRUE	0.002673061714161503	196	18	5	0.2777777777777778	0.025510204081632654	GO:0043542	GO:BP	endothelial cell migration	16175	10759		0.8	0.8181818181818182	196	15979	5	13	191	15966	16175	0.08104458908270708
R1	cpdb	0	network_modules	14	TRUE	0.0029200870942348673	271	14	5	0.35714285714285715	0.01845018450184502	KEGG:05020	KEGG	Prion disease	8484	416		1	1	271	8213	5	9	266	8204	8484	0.07518625551726223
R1	cpdb	0	network_modules	14	TRUE	0.003078723294826982	104	15	4	0.26666666666666666	0.038461538461538464	REAC:R-HSA-194138	REAC	Signaling by VEGF	10916	2313		0.7659574468085106	0.7708333333333334	104	10812	4	11	100	10801	10916	0.0981917204462884
R1	cpdb	0	network_modules	14	TRUE	0.004208281195643667	35	15	3	0.2	0.08571428571428572	REAC:R-HSA-2172127	REAC	DAP12 interactions	10916	432		0.7872340425531915	0.7916666666666666	35	10881	3	12	32	10869	10916	0.12912750052634908
R1	cpdb	0	network_modules	14	TRUE	0.004506439502576759	218	18	5	0.2777777777777778	0.022935779816513763	GO:0008654	GO:BP	phospholipid biosynthetic process	16175	3225		0.9	0.9090909090909091	218	15957	5	13	213	15944	16175	0.07650569832218138
R1	cpdb	0	network_modules	14	TRUE	0.004587063939819155	36	15	3	0.2	0.08333333333333333	REAC:R-HSA-109704	REAC	PI3K Cascade	10916	1671		0.8085106382978723	0.8125	36	10880	3	12	33	10868	10916	0.12726801197024068
R1	cpdb	0	network_modules	14	TRUE	0.005376042901550902	226	18	5	0.2777777777777778	0.022123893805309734	GO:0045017	GO:BP	glycerolipid biosynthetic process	16175	11231		1	1	226	15949	5	13	221	15936	16175	0.0750176125835002
R1	cpdb	0	network_modules	14	TRUE	0.005429289955894696	120	15	4	0.26666666666666666	0.03333333333333333	REAC:R-HSA-202403	REAC	TCR signaling	10916	2422		0.8297872340425532	0.8333333333333334	120	10796	4	11	116	10785	10916	0.09095778196895749
R1	cpdb	0	network_modules	14	TRUE	0.0058567901838209565	39	15	3	0.2	0.07692307692307693	REAC:R-HSA-1433557	REAC	Signaling by SCF-KIT	10916	2306		0.851063829787234	0.875	39	10877	3	12	36	10865	10916	0.12212114951031841
R1	cpdb	0	network_modules	14	TRUE	0.0058567901838209565	39	15	3	0.2	0.07692307692307693	REAC:R-HSA-112399	REAC	IRS-mediated signalling	10916	1164		0.851063829787234	0.875	39	10877	3	12	36	10865	10916	0.12212114951031841
R1	cpdb	0	network_modules	14	TRUE	0.006167548010688583	264	15	5	0.3333333333333333	0.01893939393939394	REAC:R-HSA-5673001	REAC	RAF/MAP kinase cascade	10916	1841		0.8936170212765957	0.8958333333333334	264	10652	5	10	259	10642	10916	0.07464931023275992
R1	cpdb	0	network_modules	14	TRUE	0.006752737869738447	269	15	5	0.3333333333333333	0.01858736059479554	REAC:R-HSA-5684996	REAC	MAPK1/MAPK3 signaling	10916	1351		0.9148936170212766	0.9166666666666666	269	10647	5	10	264	10637	10916	0.0738600563236168
R1	cpdb	0	network_modules	14	TRUE	0.007882738652959702	43	15	3	0.2	0.06976744186046512	REAC:R-HSA-2428928	REAC	IRS-related events triggered by IGF1R	10916	1165		0.9361702127659575	0.9583333333333334	43	10873	3	12	40	10861	10916	0.11610686467493356
R1	cpdb	0	network_modules	14	TRUE	0.007882738652959702	43	15	3	0.2	0.06976744186046512	REAC:R-HSA-2428924	REAC	IGF1R signaling cascade	10916	1142		0.9361702127659575	0.9583333333333334	43	10873	3	12	40	10861	10916	0.11610686467493356
R1	cpdb	0	network_modules	14	TRUE	0.008452542807022203	44	15	3	0.2	0.06818181818181818	REAC:R-HSA-2404192	REAC	Signaling by Type 1 Insulin-like Growth Factor 1 Receptor (IGF1R)	10916	2312		0.9787234042553191	0.9791666666666666	44	10872	3	12	41	10860	10916	0.11473153115446968
R1	cpdb	0	network_modules	14	TRUE	0.009048821620613266	45	15	3	0.2	0.06666666666666667	REAC:R-HSA-74751	REAC	Insulin receptor signalling cascade	10916	1211		1	1	45	10871	3	12	42	10859	10916	0.1134017561563497
R1	cpdb	0	network_modules	15	TRUE	1.1695194887965178e-6	88	20	6	0.3	0.06818181818181818	GO:0031110	GO:BP	regulation of microtubule polymerization or depolymerization	16175	7035		0	0.07692307692307693	88	16087	6	14	82	16073	16175	0.14089642732560237
R1	cpdb	0	network_modules	15	TRUE	9.3816383339616e-6	124	20	6	0.3	0.04838709677419355	GO:0031109	GO:BP	microtubule polymerization or depolymerization	16175	7034		0.08333333333333333	0.15384615384615385	124	16051	6	14	118	16037	16175	0.11792965284105378
R1	cpdb	0	network_modules	15	TRUE	2.610060561378929e-5	147	20	6	0.3	0.04081632653061224	GO:0070507	GO:BP	regulation of microtubule cytoskeleton organization	16175	16162		0.16666666666666666	0.23076923076923078	147	16028	6	14	141	16014	16175	0.10786212203178738
R1	cpdb	0	network_modules	15	TRUE	3.671588814620674e-5	26	20	4	0.2	0.15384615384615385	GO:0031114	GO:BP	regulation of microtubule depolymerization	16175	7039		0.25	0.3076923076923077	26	16149	4	16	22	16133	16175	0.17424958101181034
R1	cpdb	0	network_modules	15	TRUE	3.912728239429471e-5	440	20	8	0.4	0.01818181818181818	GO:0051493	GO:BP	regulation of cytoskeleton organization	16175	13748		0.3333333333333333	0.38461538461538464	440	15735	8	12	432	15723	16175	0.08063416944064965
R1	cpdb	0	network_modules	15	TRUE	9.726683482824108e-5	318	20	7	0.35	0.0220125786163522	GO:1902903	GO:BP	regulation of supramolecular fiber organization	16175	22602		0.4166666666666667	0.46153846153846156	318	15857	7	13	311	15844	16175	0.08372264455757186
R1	cpdb	0	network_modules	15	TRUE	2.457720188151276e-4	41	20	4	0.2	0.0975609756097561	GO:0007019	GO:BP	microtubule depolymerization	16175	2627		0.5	0.5384615384615384	41	16134	4	16	37	16118	16175	0.13817627281659906
R1	cpdb	0	network_modules	15	TRUE	3.932320643428877e-4	232	20	6	0.3	0.02586206896551724	GO:0032886	GO:BP	regulation of microtubule-based process	16175	7882		0.5833333333333334	0.6153846153846154	232	15943	6	14	226	15929	16175	0.08453206449973143
R1	cpdb	0	network_modules	15	TRUE	0.0014206312949762393	63	20	4	0.2	0.06349206349206349	GO:1901879	GO:BP	regulation of protein depolymerization	16175	21823		0.6666666666666666	0.6923076923076923	63	16112	4	16	59	16096	16175	0.11077702405764889
R1	cpdb	0	network_modules	15	TRUE	0.002008209743542546	227	15	5	0.3333333333333333	0.022026431718061675	KEGG:04810	KEGG	Regulation of actin cytoskeleton	8484	365		NA	1	227	8257	5	10	222	8247	8484	0.0799550399103696
R1	cpdb	0	network_modules	15	TRUE	0.002273926205080043	748	20	8	0.4	0.0106951871657754	GO:0097435	GO:BP	supramolecular fiber organization	16175	18657		0.75	0.7692307692307693	748	15427	8	12	740	15415	16175	0.0592676669088606
R1	cpdb	0	network_modules	15	TRUE	0.004973052869565879	86	20	4	0.2	0.046511627906976744	GO:0034446	GO:BP	substrate adhesion-dependent cell spreading	16175	8640		0.8333333333333334	0.8461538461538461	86	16089	4	16	82	16073	16175	0.09419338967123383
R1	cpdb	0	network_modules	15	TRUE	0.006799735211003229	93	20	4	0.2	0.043010752688172046	GO:0051261	GO:BP	protein depolymerization	16175	13608		0.9166666666666666	0.9230769230769231	93	16082	4	16	89	16066	16175	0.0903974530083411
R1	cpdb	0	network_modules	15	TRUE	0.008043663661391864	97	20	4	0.2	0.041237113402061855	GO:0043244	GO:BP	regulation of protein-containing complex disassembly	16175	10582		1	1	97	16078	4	16	93	16062	16175	0.08841227718885022
R1	cpdb	0	network_modules	16	TRUE	0.001029883574570837	16	19	3	0.15789473684210525	0.1875	GO:0072376	GO:BP	protein activation cascade	16175	17373		0	0.1	16	16159	3	16	13	16143	16175	0.17116905694947215
R1	cpdb	0	network_modules	16	TRUE	0.001249644959466613	17	19	3	0.15789473684210525	0.17647058823529413	GO:0051917	GO:BP	regulation of fibrinolysis	16175	13993		0.1111111111111111	0.2	17	16158	3	16	14	16142	16175	0.16599808314375786
R1	cpdb	0	network_modules	16	TRUE	0.0017665773513739864	2	19	2	0.10526315789473684	1	GO:0002353	GO:BP	plasma kallikrein-kinin cascade	16175	885		0.2222222222222222	0.5	2	16173	2	17	0	16156	16175	0.32427228087924065
R1	cpdb	0	network_modules	16	TRUE	0.0017665773513739864	2	19	2	0.10526315789473684	1	GO:0002542	GO:BP	Factor XII activation	16175	1063		0.2222222222222222	0.5	2	16173	2	17	0	16156	16175	0.32427228087924065
R1	cpdb	0	network_modules	16	TRUE	0.0017665773513739864	2	19	2	0.10526315789473684	1	GO:0002254	GO:BP	kinin cascade	16175	786		0.2222222222222222	0.5	2	16173	2	17	0	16156	16175	0.32427228087924065
R1	cpdb	0	network_modules	16	TRUE	0.0022807807055670263	3	17	2	0.11764705882352941	0.6666666666666666	REAC:R-HSA-9657688	REAC	Defective factor XII causes hereditary angioedema	10916	695		0	1	3	10913	2	15	1	10898	10916	0.2796580487130793
R1	cpdb	0	network_modules	16	TRUE	0.0022807807055670263	3	17	2	0.11764705882352941	0.6666666666666666	REAC:R-HSA-9657689	REAC	Defective SERPING1 causes hereditary angioedema	10916	614		0	1	3	10913	2	15	1	10898	10916	0.2796580487130793
R1	cpdb	0	network_modules	16	TRUE	0.002449001606498958	43	14	3	0.21428571428571427	0.06976744186046512	KEGG:04975	KEGG	Fat digestion and absorption	8484	406		NA	1	43	8441	3	11	40	8430	8484	0.11978142960694002
R1	cpdb	0	network_modules	16	TRUE	0.0024803964412886998	78	19	4	0.21052631578947367	0.05128205128205128	GO:1903035	GO:BP	negative regulation of response to wounding	16175	22715		0.5555555555555556	0.6	78	16097	4	15	74	16082	16175	0.10183035458658803
R1	cpdb	0	network_modules	16	TRUE	0.0037002546257368834	24	19	3	0.15789473684210525	0.125	GO:0031639	GO:BP	plasminogen activation	16175	7249		0.6666666666666666	0.8	24	16151	3	16	21	16135	16175	0.1393529077787942
R1	cpdb	0	network_modules	16	TRUE	0.0037002546257368834	24	19	3	0.15789473684210525	0.125	GO:0042730	GO:BP	fibrinolysis	16175	10330		0.6666666666666666	0.8	24	16151	3	16	21	16135	16175	0.1393529077787942
R1	cpdb	0	network_modules	16	TRUE	0.005296018232941796	3	19	2	0.10526315789473684	0.6666666666666666	GO:0002541	GO:BP	activation of plasma proteins involved in acute inflammatory response	16175	1062		0.8888888888888888	0.9	3	16172	2	17	1	16155	16175	0.26461970208734953
R1	cpdb	0	network_modules	16	TRUE	0.008427209286380492	236	19	5	0.2631578947368421	0.0211864406779661	GO:0050678	GO:BP	regulation of epithelial cell proliferation	16175	13212		1	1	236	15939	5	14	231	15925	16175	0.07109056006429332
R1	cpdb	0	network_modules	17	TRUE	6.750027262906146e-38	22	26	16	0.6153846153846154	0.7272727272727273	REAC:R-HSA-392170	REAC	ADP signalling through P2Y purinoceptor 12	10916	13		0	0.015873015873015872	22	10894	16	10	6	10884	10916	0.6682719267547267
R1	cpdb	0	network_modules	17	TRUE	3.443151246297063e-34	43	26	17	0.6538461538461539	0.3953488372093023	REAC:R-HSA-991365	REAC	Activation of GABAB receptors	10916	83		0.016129032258064516	0.047619047619047616	43	10873	17	9	26	10864	10916	0.5069656589880209
R1	cpdb	0	network_modules	17	TRUE	3.443151246297063e-34	43	26	17	0.6538461538461539	0.3953488372093023	REAC:R-HSA-977444	REAC	GABA B receptor activation	10916	1010		0.016129032258064516	0.047619047619047616	43	10873	17	9	26	10864	10916	0.5069656589880209
R1	cpdb	0	network_modules	17	TRUE	5.390991980170479e-34	32	26	16	0.6153846153846154	0.5	REAC:R-HSA-392518	REAC	Signal amplification	10916	2213		0.04838709677419355	0.06349206349206349	32	10884	16	10	16	10874	10916	0.5535283512983049
R1	cpdb	0	network_modules	17	TRUE	2.3558432415753176e-31	43	26	16	0.6153846153846154	0.37209302325581395	REAC:R-HSA-9660821	REAC	ADORA2B mediated anti-inflammatory cytokines production	10916	11		0.06451612903225806	0.07936507936507936	43	10873	16	10	27	10863	10916	0.4769633975379399
R1	cpdb	0	network_modules	17	TRUE	3.123775877632749e-31	60	26	17	0.6538461538461539	0.2833333333333333	REAC:R-HSA-977443	REAC	GABA receptor activation	10916	1011		0.08064516129032258	0.09523809523809523	60	10856	17	9	43	10847	10916	0.42848437458569794
R1	cpdb	0	network_modules	17	TRUE	3.698835564957993e-31	44	26	16	0.6153846153846154	0.36363636363636365	REAC:R-HSA-9634597	REAC	GPER1 signaling	10916	1020		0.0967741935483871	0.1111111111111111	44	10872	16	10	28	10862	10916	0.471463245792589
R1	cpdb	0	network_modules	17	TRUE	1.9945236394135965e-30	48	26	16	0.6153846153846154	0.3333333333333333	REAC:R-HSA-418597	REAC	G alpha (z) signalling events	10916	990		0.11290322580645161	0.12698412698412698	48	10868	16	10	32	10858	10916	0.4512041463046755
R1	cpdb	0	network_modules	17	TRUE	5.850827074322725e-30	18	26	13	0.5	0.7222222222222222	REAC:R-HSA-8964315	REAC	G beta:gamma signalling through BTK	10916	991		0.12903225806451613	0.14285714285714285	18	10898	13	13	5	10885	10916	0.6001529973896865
R1	cpdb	0	network_modules	17	TRUE	1.3642059546786802e-29	38	26	15	0.5769230769230769	0.39473684210526316	REAC:R-HSA-6814122	REAC	Cooperation of PDCL (PhLP1) and TRiC/CCT in G-protein beta folding	10916	410		0.14516129032258066	0.15873015873015872	38	10878	15	11	23	10867	10916	0.47572874622875155
R1	cpdb	0	network_modules	17	TRUE	1.8507097723402572e-29	19	26	13	0.5	0.6842105263157895	REAC:R-HSA-392851	REAC	Prostacyclin signalling through prostacyclin receptor	10916	1809		0.16129032258064516	0.1746031746031746	19	10897	13	13	6	10884	10916	0.5840654505339674
R1	cpdb	0	network_modules	17	TRUE	3.237518948551008e-29	28	26	14	0.5384615384615384	0.5	REAC:R-HSA-400042	REAC	Adrenaline,noradrenaline inhibits insulin secretion	10916	124		0.1774193548387097	0.19047619047619047	28	10888	14	12	14	10876	10916	0.5176832424570914
R1	cpdb	0	network_modules	17	TRUE	5.281884991138541e-29	20	26	13	0.5	0.65	REAC:R-HSA-418217	REAC	G beta:gamma signalling through PLC beta	10916	994		0.1935483870967742	0.2222222222222222	20	10896	13	13	7	10883	10916	0.569198035144601
R1	cpdb	0	network_modules	17	TRUE	5.281884991138541e-29	20	26	13	0.5	0.65	REAC:R-HSA-8964616	REAC	G beta:gamma signalling through CDC42	10916	992		0.1935483870967742	0.2222222222222222	20	10896	13	13	7	10883	10916	0.569198035144601
R1	cpdb	0	network_modules	17	TRUE	6.252765670046492e-29	29	26	14	0.5384615384615384	0.4827586206896552	REAC:R-HSA-1296059	REAC	G protein gated Potassium channels	10916	995		0.22580645161290322	0.2698412698412698	29	10887	14	12	15	10875	10916	0.5086157700082553
R1	cpdb	0	network_modules	17	TRUE	6.252765670046492e-29	29	26	14	0.5384615384615384	0.4827586206896552	REAC:R-HSA-1296041	REAC	Activation of G protein gated Potassium channels	10916	82		0.22580645161290322	0.2698412698412698	29	10887	14	12	15	10875	10916	0.5086157700082553
R1	cpdb	0	network_modules	17	TRUE	6.252765670046492e-29	29	26	14	0.5384615384615384	0.4827586206896552	REAC:R-HSA-997272	REAC	Inhibition  of voltage gated Ca2+ channels via Gbeta/gamma subunits	10916	1188		0.22580645161290322	0.2698412698412698	29	10887	14	12	15	10875	10916	0.5086157700082553
R1	cpdb	0	network_modules	17	TRUE	1.3849588714106153e-28	21	26	13	0.5	0.6190476190476191	REAC:R-HSA-500657	REAC	Presynaptic function of Kainate receptors	10916	1791		0.27419354838709675	0.2857142857142857	21	10895	13	13	8	10882	10916	0.5554037432706111
R1	cpdb	0	network_modules	17	TRUE	1.693242240415976e-27	24	26	13	0.5	0.5416666666666666	REAC:R-HSA-418592	REAC	ADP signalling through P2Y purinoceptor 1	10916	12		0.2903225806451613	0.3333333333333333	24	10892	13	13	11	10879	10916	0.5193174680370095
R1	cpdb	0	network_modules	17	TRUE	1.693242240415976e-27	24	26	13	0.5	0.5416666666666666	REAC:R-HSA-202040	REAC	G-protein activation	10916	996		0.2903225806451613	0.3333333333333333	24	10892	13	13	11	10879	10916	0.5193174680370095
R1	cpdb	0	network_modules	17	TRUE	1.693242240415976e-27	24	26	13	0.5	0.5416666666666666	REAC:R-HSA-428930	REAC	Thromboxane signalling through TP receptor	10916	2507		0.2903225806451613	0.3333333333333333	24	10892	13	13	11	10879	10916	0.5193174680370095
R1	cpdb	0	network_modules	17	TRUE	1.8588292107752568e-27	35	26	14	0.5384615384615384	0.4	REAC:R-HSA-1296065	REAC	Inwardly rectifying K+ channels	10916	1271		0.3387096774193548	0.3492063492063492	35	10881	14	12	21	10869	10916	0.46262463768002615
R1	cpdb	0	network_modules	17	TRUE	3.523678940198128e-27	25	26	13	0.5	0.52	REAC:R-HSA-392451	REAC	G beta:gamma signalling through PI3Kgamma	10916	993		0.3548387096774194	0.36507936507936506	25	10891	13	13	12	10878	10916	0.5087548422303249
R1	cpdb	0	network_modules	17	TRUE	4.56313837981485e-27	73	26	16	0.6153846153846154	0.2191780821917808	REAC:R-HSA-9009391	REAC	Extra-nuclear estrogen signaling	10916	888		0.3709677419354839	0.38095238095238093	73	10843	16	10	57	10833	10916	0.36492313302465085
R1	cpdb	0	network_modules	17	TRUE	8.06995231545722e-26	30	26	13	0.5	0.43333333333333335	REAC:R-HSA-451326	REAC	Activation of kainate receptors upon glutamate binding	10916	102		0.3870967741935484	0.3968253968253968	30	10886	13	13	17	10873	10916	0.46410663872363056
R1	cpdb	0	network_modules	17	TRUE	1.3882842611889188e-25	31	26	13	0.5	0.41935483870967744	REAC:R-HSA-456926	REAC	Thrombin signalling through proteinase activated receptors (PARs)	10916	2506		0.4032258064516129	0.4126984126984127	31	10885	13	13	18	10872	10916	0.4564965420168595
R1	cpdb	0	network_modules	17	TRUE	1.5067038824983496e-25	89	26	16	0.6153846153846154	0.1797752808988764	REAC:R-HSA-111885	REAC	Opioid Signalling	10916	1642		0.41935483870967744	0.42857142857142855	89	10827	16	10	73	10817	10916	0.32994491760492195
R1	cpdb	0	network_modules	17	TRUE	2.335570503669966e-25	32	26	13	0.5	0.40625	REAC:R-HSA-397795	REAC	G-protein beta:gamma signalling	10916	997		0.43548387096774194	0.4444444444444444	32	10884	13	13	19	10871	10916	0.4492450161528883
R1	cpdb	0	network_modules	17	TRUE	3.8494181687946505e-25	33	26	13	0.5	0.3939393939393939	REAC:R-HSA-420092	REAC	Glucagon-type ligand receptors	10916	1050		0.45161290322580644	0.4603174603174603	33	10883	13	13	20	10870	10916	0.44232470048313255
R1	cpdb	0	network_modules	17	TRUE	1.5138857971835693e-24	113	22	16	0.7272727272727273	0.1415929203539823	KEGG:04725	KEGG	Cholinergic synapse	8484	355		0	0.058823529411764705	113	8371	16	6	97	8365	8484	0.3175539705039926
R1	cpdb	0	network_modules	17	TRUE	4.6896033894192716e-24	312	26	20	0.7692307692307693	0.0641025641025641	REAC:R-HSA-418594	REAC	G alpha (i) signalling events	10916	987		0.46774193548387094	0.47619047619047616	312	10604	20	6	292	10598	10916	0.21718832191111406
R1	cpdb	0	network_modules	17	TRUE	6.3523504498528654e-24	89	22	15	0.6818181818181818	0.16853932584269662	KEGG:04727	KEGG	GABAergic synapse	8484	357		0.0625	0.17647058823529413	89	8395	15	7	74	8388	8484	0.33597332585978473
R1	cpdb	0	network_modules	17	TRUE	6.3523504498528654e-24	89	22	15	0.6818181818181818	0.16853932584269662	KEGG:05032	KEGG	Morphine addiction	8484	420		0.0625	0.17647058823529413	89	8395	15	7	74	8388	8484	0.33597332585978473
R1	cpdb	0	network_modules	17	TRUE	1.6968176464697165e-23	42	26	13	0.5	0.30952380952380953	REAC:R-HSA-381676	REAC	Glucagon-like Peptide-1 (GLP1) regulates insulin secretion	10916	1049		0.4838709677419355	0.49206349206349204	42	10874	13	13	29	10861	10916	0.3915904395827577
R1	cpdb	0	network_modules	17	TRUE	2.429406296275558e-23	43	26	13	0.5	0.3023255813953488	REAC:R-HSA-432040	REAC	Vasopressin regulates renal water homeostasis via Aquaporins	10916	2643		0.5	0.5079365079365079	43	10873	13	13	30	10860	10916	0.38695661318769703
R1	cpdb	0	network_modules	17	TRUE	2.5597137217183966e-23	97	22	15	0.6818181818181818	0.15463917525773196	KEGG:04713	KEGG	Circadian entrainment	8484	348		0.1875	0.23529411764705882	97	8387	15	7	82	8380	8484	0.3215218720144013
R1	cpdb	0	network_modules	17	TRUE	4.5976072676212526e-23	91	26	15	0.5769230769230769	0.16483516483516483	REAC:R-HSA-390466	REAC	Chaperonin-mediated protein folding	10916	345		0.5161290322580645	0.5238095238095238	91	10825	15	11	76	10814	10916	0.3055612665561582
R1	cpdb	0	network_modules	17	TRUE	6.537173370529993e-23	93	26	15	0.5769230769230769	0.16129032258064516	REAC:R-HSA-373080	REAC	Class B/2 (Secretin family receptors)	10916	366		0.532258064516129	0.5396825396825397	93	10823	15	11	78	10812	10916	0.3021883241466222
R1	cpdb	0	network_modules	17	TRUE	1.2951922577524223e-22	132	26	16	0.6153846153846154	0.12121212121212122	REAC:R-HSA-9662851	REAC	Anti-inflammatory response favouring Leishmania parasite infection	10916	150		0.5483870967741935	0.5714285714285714	132	10784	16	10	116	10774	10916	0.26970383348192417
R1	cpdb	0	network_modules	17	TRUE	1.2951922577524223e-22	132	26	16	0.6153846153846154	0.12121212121212122	REAC:R-HSA-9664433	REAC	Leishmania parasite growth and survival	10916	1311		0.5483870967741935	0.5714285714285714	132	10784	16	10	116	10774	10916	0.26970383348192417
R1	cpdb	0	network_modules	17	TRUE	1.5217649311799443e-22	98	26	15	0.5769230769230769	0.15306122448979592	REAC:R-HSA-391251	REAC	Protein folding	10916	1812		0.5806451612903226	0.5873015873015873	98	10818	15	11	83	10807	10916	0.2942092640099461
R1	cpdb	0	network_modules	17	TRUE	2.5662143684337314e-22	112	22	15	0.6818181818181818	0.13392857142857142	KEGG:04726	KEGG	Serotonergic synapse	8484	356		0.25	0.29411764705882354	112	8372	15	7	97	8365	8484	0.29869585321616565
R1	cpdb	0	network_modules	17	TRUE	3.909237065681397e-22	115	22	15	0.6818181818181818	0.13043478260869565	KEGG:04724	KEGG	Glutamatergic synapse	8484	354		0.3125	0.35294117647058826	115	8369	15	7	100	8362	8484	0.29467097991549324
R1	cpdb	0	network_modules	17	TRUE	4.1757563589185174e-22	52	26	13	0.5	0.25	REAC:R-HSA-445717	REAC	Aquaporin-mediated transport	10916	164		0.5967741935483871	0.6031746031746031	52	10864	13	13	39	10851	10916	0.35144083748543176
R1	cpdb	0	network_modules	17	TRUE	7.846638299089732e-22	78	26	14	0.5384615384615384	0.1794871794871795	REAC:R-HSA-422356	REAC	Regulation of insulin secretion	10916	2040		0.6129032258064516	0.6190476190476191	78	10838	14	12	64	10826	10916	0.30822462515261156
R1	cpdb	0	network_modules	17	TRUE	9.274931908703124e-22	196	26	17	0.6538461538461539	0.08673469387755102	REAC:R-HSA-112314	REAC	Neurotransmitter receptors and postsynaptic signal transmission	10916	1594		0.6290322580645161	0.6349206349206349	196	10720	17	9	179	10711	10916	0.23398790804611427
R1	cpdb	0	network_modules	17	TRUE	2.1358224383037318e-21	156	26	16	0.6153846153846154	0.10256410256410256	REAC:R-HSA-418555	REAC	G alpha (s) signalling events	10916	989		0.6451612903225806	0.6507936507936508	156	10760	16	10	140	10750	10916	0.24746283164632266
R1	cpdb	0	network_modules	17	TRUE	2.4126572756498516e-21	129	22	15	0.6818181818181818	0.11627906976744186	KEGG:04926	KEGG	Relaxin signaling pathway	8484	383		0.375	0.4117647058823529	129	8355	15	7	114	8348	8484	0.27776738157599856
R1	cpdb	0	network_modules	17	TRUE	2.6408679266756124e-21	59	26	13	0.5	0.22033898305084745	REAC:R-HSA-4086398	REAC	Ca2+ pathway	10916	296		0.6612903225806451	0.6666666666666666	59	10857	13	13	46	10844	10916	0.3296136108307391
R1	cpdb	0	network_modules	17	TRUE	2.891262342273733e-21	85	26	14	0.5384615384615384	0.16470588235294117	REAC:R-HSA-418346	REAC	Platelet homeostasis	10916	1765		0.6774193548387096	0.6825396825396826	85	10831	14	12	71	10819	10916	0.2949993017416405
R1	cpdb	0	network_modules	17	TRUE	3.0751952656014226e-21	131	22	15	0.6818181818181818	0.11450381679389313	KEGG:04728	KEGG	Dopaminergic synapse	8484	358		0.4375	0.47058823529411764	131	8353	15	7	116	8346	8484	0.2755743740618816
R1	cpdb	0	network_modules	17	TRUE	6.976565772145514e-21	138	22	15	0.6818181818181818	0.10869565217391304	KEGG:04371	KEGG	Apelin signaling pathway	8484	308		0.5	0.5294117647058824	138	8346	15	7	123	8339	8484	0.26827421025968623
R1	cpdb	0	network_modules	17	TRUE	9.333496050556744e-21	190	22	16	0.7272727272727273	0.08421052631578947	KEGG:04062	KEGG	Chemokine signaling pathway	8484	255		0.5625	0.5882352941176471	190	8294	16	6	174	8288	8484	0.2429016148994109
R1	cpdb	0	network_modules	17	TRUE	2.0889638835449868e-20	148	22	15	0.6818181818181818	0.10135135135135136	KEGG:04723	KEGG	Retrograde endocannabinoid signaling	8484	353		0.625	0.6470588235294118	148	8336	15	7	133	8329	8484	0.25874867399663226
R1	cpdb	0	network_modules	17	TRUE	5.139604337518191e-20	103	26	14	0.5384615384615384	0.13592233009708737	REAC:R-HSA-1296071	REAC	Potassium Channels	10916	1780		0.6935483870967742	0.6984126984126984	103	10813	14	12	89	10801	10916	0.2673753949259261
R1	cpdb	0	network_modules	17	TRUE	9.046664013579469e-20	107	26	14	0.5384615384615384	0.1308411214953271	REAC:R-HSA-163685	REAC	Integration of energy metabolism	10916	1213		0.7096774193548387	0.7142857142857143	107	10809	14	12	93	10797	10916	0.2621969185453685
R1	cpdb	0	network_modules	17	TRUE	1.2035106065905146e-19	259	26	17	0.6538461538461539	0.06563706563706563	REAC:R-HSA-112315	REAC	Transmission across Chemical Synapses	10916	2580		0.7258064516129032	0.7301587301587301	259	10657	17	9	242	10648	10916	0.20229811011794588
R1	cpdb	0	network_modules	17	TRUE	2.0087363409483696e-19	80	26	13	0.5	0.1625	REAC:R-HSA-416482	REAC	G alpha (12/13) signalling events	10916	986		0.7419354838709677	0.746031746031746	80	10836	13	13	67	10823	10916	0.2822370605140229
R1	cpdb	0	network_modules	17	TRUE	4.299471720548907e-19	215	26	16	0.6153846153846154	0.07441860465116279	REAC:R-HSA-9658195	REAC	Leishmania infection	10916	1310		0.7580645161290323	0.7777777777777778	215	10701	16	10	199	10691	10916	0.20947116677722638
R1	cpdb	0	network_modules	17	TRUE	4.299471720548907e-19	215	26	16	0.6153846153846154	0.07441860465116279	REAC:R-HSA-9824443	REAC	Parasitic Infection Pathways	10916	1717		0.7580645161290323	0.7777777777777778	215	10701	16	10	199	10691	10916	0.20947116677722638
R1	cpdb	0	network_modules	17	TRUE	4.639352211186242e-19	216	26	16	0.6153846153846154	0.07407407407407407	REAC:R-HSA-8939211	REAC	ESR-mediated signaling	10916	830		0.7903225806451613	0.7936507936507936	216	10700	16	10	200	10690	10916	0.20896334216278262
R1	cpdb	0	network_modules	17	TRUE	7.618750779417129e-19	774	26	20	0.7692307692307693	0.025839793281653745	GO:0007186	GO:BP	G protein-coupled receptor signaling pathway	16175	2744		NA	1	774	15401	20	6	754	15395	16175	0.13560533903650718
R1	cpdb	0	network_modules	17	TRUE	7.917099629058371e-19	187	22	15	0.6818181818181818	0.08021390374331551	KEGG:05034	KEGG	Alcoholism	8484	422		0.6875	0.7058823529411765	187	8297	15	7	172	8290	8484	0.22913483037226723
R1	cpdb	0	network_modules	17	TRUE	4.725211534756214e-18	210	22	15	0.6818181818181818	0.07142857142857142	KEGG:05170	KEGG	Human immunodeficiency virus 1 infection	8484	451		0.75	0.7647058823529411	210	8274	15	7	195	8267	8484	0.21563382432181188
R1	cpdb	0	network_modules	17	TRUE	8.98388434241685e-18	259	26	16	0.6153846153846154	0.06177606177606178	REAC:R-HSA-76002	REAC	Platelet activation, signaling and aggregation	10916	1762		0.8064516129032258	0.8095238095238095	259	10657	16	10	243	10647	10916	0.18995014061455454
R1	cpdb	0	network_modules	17	TRUE	1.1870953776962377e-17	223	22	15	0.6818181818181818	0.06726457399103139	KEGG:05163	KEGG	Human cytomegalovirus infection	8484	444		0.8125	0.8235294117647058	223	8261	15	7	208	8254	8484	0.20893037240708712
R1	cpdb	0	network_modules	17	TRUE	2.37885470811659e-17	33	26	10	0.38461538461538464	0.30303030303030304	REAC:R-HSA-163359	REAC	Glucagon signaling in metabolic regulation	10916	1048		0.8225806451612904	0.8253968253968254	33	10883	10	16	23	10867	10916	0.33962885297216744
R1	cpdb	0	network_modules	17	TRUE	5.617039753525702e-17	290	26	16	0.6153846153846154	0.05517241379310345	REAC:R-HSA-9006931	REAC	Signaling by Nuclear Receptors	10916	2289		0.8387096774193549	0.8412698412698413	290	10626	16	10	274	10616	10916	0.1789095459193712
R1	cpdb	0	network_modules	17	TRUE	2.106788257514301e-16	400	26	17	0.6538461538461539	0.0425	REAC:R-HSA-112316	REAC	Neuronal System	10916	1590		0.8548387096774194	0.8571428571428571	400	10516	17	9	383	10507	10916	0.16051247459605777
R1	cpdb	0	network_modules	17	TRUE	5.686641838543326e-16	143	26	13	0.5	0.09090909090909091	REAC:R-HSA-3858494	REAC	Beta-catenin independent WNT signaling	10916	216		0.8709677419354839	0.873015873015873	143	10773	13	13	130	10760	10916	0.20923756356628578
R1	cpdb	0	network_modules	17	TRUE	2.2604269946338617e-15	460	26	17	0.6538461538461539	0.036956521739130437	REAC:R-HSA-500792	REAC	GPCR ligand binding	10916	1019		0.8870967741935484	0.8888888888888888	460	10456	17	9	443	10447	10916	0.14877070572021328
R1	cpdb	0	network_modules	17	TRUE	8.612106374363755e-15	194	22	13	0.5909090909090909	0.06701030927835051	KEGG:05167	KEGG	Kaposi sarcoma-associated herpesvirus infection	8484	448		0.875	0.8823529411764706	194	8290	13	9	181	8281	8484	0.19376628099154378
R1	cpdb	0	network_modules	17	TRUE	1.0748032308387182e-13	235	22	13	0.5909090909090909	0.05531914893617021	KEGG:04014	KEGG	Ras signaling pathway	8484	247		0.9375	0.9411764705882353	235	8249	13	9	222	8240	8484	0.17498917398606734
R1	cpdb	0	network_modules	17	TRUE	1.1276181561511892e-13	213	26	13	0.5	0.06103286384976526	REAC:R-HSA-416476	REAC	G alpha (q) signalling events	10916	988		0.9032258064516129	0.9047619047619048	213	10703	13	13	200	10690	10916	0.16973666395795892
R1	cpdb	0	network_modules	17	TRUE	2.3622826543459774e-11	356	22	13	0.5909090909090909	0.03651685393258427	KEGG:04151	KEGG	PI3K-Akt signaling pathway	8484	285		1	1	356	8128	13	9	343	8119	8484	0.13960136159422765
R1	cpdb	0	network_modules	17	TRUE	2.976189206761072e-11	327	26	13	0.5	0.039755351681957186	REAC:R-HSA-195721	REAC	Signaling by WNT	10916	2314		0.9193548387096774	0.9206349206349206	327	10589	13	13	314	10576	10916	0.13473281952956484
R1	cpdb	0	network_modules	17	TRUE	4.842940149588136e-5	21	26	4	0.15384615384615385	0.19047619047619047	REAC:R-HSA-381771	REAC	Synthesis, secretion, and inactivation of Glucagon-like Peptide-1 (GLP-1)	10916	2415		0.9354838709677419	0.9365079365079365	21	10895	4	22	17	10873	10916	0.1694083176691205
R1	cpdb	0	network_modules	17	TRUE	8.556798544923667e-5	24	26	4	0.15384615384615385	0.16666666666666666	REAC:R-HSA-400508	REAC	Incretin synthesis, secretion, and inactivation	10916	1180		0.9516129032258065	0.9523809523809523	24	10892	4	22	20	10870	10916	0.1582020881650639
R1	cpdb	0	network_modules	17	TRUE	7.934175054641341e-4	41	26	4	0.15384615384615385	0.0975609756097561	REAC:R-HSA-9717207	REAC	Sensory perception of sweet, bitter, and umami (glutamate) taste	10916	2199		0.967741935483871	0.9682539682539683	41	10875	4	22	37	10853	10916	0.11988974436557294
R1	cpdb	0	network_modules	17	TRUE	0.0013839582343191457	47	26	4	0.15384615384615385	0.0851063829787234	REAC:R-HSA-9717189	REAC	Sensory perception of taste	10916	2200		0.9838709677419355	0.9841269841269841	47	10869	4	22	43	10847	10916	0.11159673891653538
R1	cpdb	0	network_modules	17	TRUE	0.0014116438207892412	14	26	3	0.11538461538461539	0.21428571428571427	REAC:R-HSA-170670	REAC	Adenylate cyclase inhibitory pathway	10916	120		1	1	14	10902	3	23	11	10879	10916	0.15578038408283765
R1	cpdb	0	network_modules	18	TRUE	1.3842077887029693e-7	11	3	3	1	0.2727272727272727	REAC:R-HSA-2485179	REAC	Activation of the phototransduction cascade	10916	106		0	0.25	11	10905	3	0	8	10905	10916	0.5220415159431939
R1	cpdb	0	network_modules	18	TRUE	1.7779519876904212e-6	29	3	3	1	0.10344827586206896	KEGG:04744	KEGG	Phototransduction	8484	362		NA	1	29	8455	3	0	26	8455	8484	0.32114036953180575
R1	cpdb	0	network_modules	18	TRUE	3.770917581951418e-6	31	3	3	1	0.0967741935483871	REAC:R-HSA-2514856	REAC	The phototransduction cascade	10916	2501		0.3333333333333333	0.5	31	10885	3	0	28	10885	10916	0.3106861687058293
R1	cpdb	0	network_modules	18	TRUE	1.2368945234325157e-4	97	3	3	1	0.030927835051546393	REAC:R-HSA-2187338	REAC	Visual phototransduction	10916	2654		0.6666666666666666	0.75	97	10819	3	0	94	10819	10916	0.17510407095771763
R1	cpdb	0	network_modules	18	TRUE	2.5299793112321594e-4	132	3	3	1	0.022727272727272728	GO:0007601	GO:BP	visual perception	16175	3060		0	0.5	132	16043	3	0	129	16043	16175	0.15015319828745174
R1	cpdb	0	network_modules	18	TRUE	2.9576232011617514e-4	139	3	3	1	0.02158273381294964	GO:0050953	GO:BP	sensory perception of light stimulus	16175	13395		1	1	139	16036	3	0	136	16036	16175	0.14629159826526764
R1	cpdb	0	network_modules	18	TRUE	0.003976006841408507	30	3	2	0.6666666666666666	0.06666666666666667	REAC:R-HSA-2514859	REAC	Inactivation, recovery and regulation of the phototransduction cascade	10916	1179		1	1	30	10886	2	1	28	10885	10916	0.21026742396583623
R1	cpdb	0	network_modules	19	TRUE	5.551605249324552e-6	84	13	5	0.38461538461538464	0.05952380952380952	KEGG:04012	KEGG	ErbB signaling pathway	8484	245		NA	1	84	8400	5	8	79	8392	8484	0.14826071347409783
R1	cpdb	0	network_modules	19	TRUE	1.8857902250976187e-5	9	11	3	0.2727272727272727	0.3333333333333333	REAC:R-HSA-1250342	REAC	PI3K events in ERBB4 signaling	10916	1673		0	0.034482758620689655	9	10907	3	8	6	10899	10916	0.3008754792622259
R1	cpdb	0	network_modules	19	TRUE	2.3349624277875406e-5	264	11	6	0.5454545454545454	0.022727272727272728	REAC:R-HSA-5673001	REAC	RAF/MAP kinase cascade	10916	1841		0.03571428571428571	0.06896551724137931	264	10652	6	5	258	10647	10916	0.10776856720853478
R1	cpdb	0	network_modules	19	TRUE	2.6107523006997e-5	269	11	6	0.5454545454545454	0.022304832713754646	REAC:R-HSA-5684996	REAC	MAPK1/MAPK3 signaling	10916	1351		0.07142857142857142	0.10344827586206896	269	10647	6	5	263	10642	10916	0.10669353364893332
R1	cpdb	0	network_modules	19	TRUE	3.700157756017234e-5	11	11	3	0.2727272727272727	0.2727272727272727	REAC:R-HSA-1250347	REAC	SHC1 events in ERBB4 signaling	10916	2140		0.10714285714285714	0.1724137931034483	11	10905	3	8	8	10897	10916	0.2719936642907757
R1	cpdb	0	network_modules	19	TRUE	3.700157756017234e-5	11	11	3	0.2727272727272727	0.2727272727272727	REAC:R-HSA-8847993	REAC	ERBB2 Activates PTK6 Signaling	10916	825		0.10714285714285714	0.1724137931034483	11	10905	3	8	8	10897	10916	0.2719936642907757
R1	cpdb	0	network_modules	19	TRUE	5.832706529422681e-5	308	11	6	0.5454545454545454	0.01948051948051948	REAC:R-HSA-5683057	REAC	MAPK family signaling cascades	10916	1348		0.17857142857142858	0.20689655172413793	308	10608	6	5	302	10603	10916	0.09920789915175283
R1	cpdb	0	network_modules	19	TRUE	6.406554082610514e-5	13	11	3	0.2727272727272727	0.23076923076923078	REAC:R-HSA-6785631	REAC	ERBB2 Regulates Cell Motility	10916	826		0.21428571428571427	0.3103448275862069	13	10903	3	8	10	10895	10916	0.25005200707026665
R1	cpdb	0	network_modules	19	TRUE	6.406554082610514e-5	13	11	3	0.2727272727272727	0.23076923076923078	REAC:R-HSA-1963642	REAC	PI3K events in ERBB2 signaling	10916	1672		0.21428571428571427	0.3103448275862069	13	10903	3	8	10	10895	10916	0.25005200707026665
R1	cpdb	0	network_modules	19	TRUE	6.406554082610514e-5	13	11	3	0.2727272727272727	0.23076923076923078	REAC:R-HSA-1963640	REAC	GRB2 events in ERBB2 signaling	10916	1023		0.21428571428571427	0.3103448275862069	13	10903	3	8	10	10895	10916	0.25005200707026665
R1	cpdb	0	network_modules	19	TRUE	9.290279180855125e-5	6	25	3	0.12	0.5	GO:0038130	GO:BP	ERBB4 signaling pathway	16175	9719		0	0.5	6	16169	3	22	3	16147	16175	0.2444260585285185
R1	cpdb	0	network_modules	19	TRUE	1.0833927450489731e-4	65	11	4	0.36363636363636365	0.06153846153846154	REAC:R-HSA-2219530	REAC	Constitutive Signaling by Aberrant PI3K in Cancer	10916	401		0.32142857142857145	0.3448275862068966	65	10851	4	7	61	10844	10916	0.1476564146564962
R1	cpdb	0	network_modules	19	TRUE	1.822862402658396e-4	18	11	3	0.2727272727272727	0.16666666666666666	REAC:R-HSA-1250196	REAC	SHC1 events in ERBB2 signaling	10916	2139		0.35714285714285715	0.41379310344827586	18	10898	3	8	15	10890	10916	0.21219354140982122
R1	cpdb	0	network_modules	19	TRUE	1.822862402658396e-4	18	11	3	0.2727272727272727	0.16666666666666666	REAC:R-HSA-9665686	REAC	Signaling by ERBB2 TMD/JMD mutants	10916	2235		0.35714285714285715	0.41379310344827586	18	10898	3	8	15	10890	10916	0.21219354140982122
R1	cpdb	0	network_modules	19	TRUE	2.966186295934519e-4	21	11	3	0.2727272727272727	0.14285714285714285	REAC:R-HSA-9664565	REAC	Signaling by ERBB2 KD Mutants	10916	2234		0.42857142857142855	0.4482758620689655	21	10895	3	8	18	10887	10916	0.19628089464160198
R1	cpdb	0	network_modules	19	TRUE	3.4326419419031056e-4	22	11	3	0.2727272727272727	0.13636363636363635	REAC:R-HSA-1227990	REAC	Signaling by ERBB2 in Cancer	10916	2236		0.4642857142857143	0.4827586206896552	22	10894	3	8	19	10886	10916	0.19171201310844765
R1	cpdb	0	network_modules	19	TRUE	4.4093880041626656e-4	92	11	4	0.36363636363636365	0.043478260869565216	REAC:R-HSA-2219528	REAC	PI3K/AKT Signaling in Cancer	10916	1674		0.5	0.5517241379310345	92	10824	4	7	88	10817	10916	0.12340774525674053
R1	cpdb	0	network_modules	19	TRUE	4.4093880041626656e-4	92	11	4	0.36363636363636365	0.043478260869565216	REAC:R-HSA-6811558	REAC	PI5P, PP2A and IER3 Regulate PI3K/AKT Signaling	10916	1677		0.5	0.5517241379310345	92	10824	4	7	88	10817	10916	0.12340774525674053
R1	cpdb	0	network_modules	19	TRUE	5.919056054460997e-4	99	11	4	0.36363636363636365	0.04040404040404041	REAC:R-HSA-199418	REAC	Negative regulation of the PI3K/AKT network	10916	1580		0.5714285714285714	0.5862068965517241	99	10817	4	7	95	10810	10916	0.11878851877064497
R1	cpdb	0	network_modules	19	TRUE	6.50187366693047e-4	27	11	3	0.2727272727272727	0.1111111111111111	REAC:R-HSA-8863795	REAC	Downregulation of ERBB2 signaling	10916	784		0.6071428571428571	0.6206896551724138	27	10889	3	8	24	10881	10916	0.17279971661140084
R1	cpdb	0	network_modules	19	TRUE	7.84097422221556e-4	253	11	5	0.45454545454545453	0.019762845849802372	REAC:R-HSA-1257604	REAC	PIP3 activates AKT signaling	10916	1679		0.6428571428571429	0.6551724137931034	253	10663	5	6	248	10657	10916	0.09105325256723924
R1	cpdb	0	network_modules	19	TRUE	9.96979190695199e-4	31	11	3	0.2727272727272727	0.0967741935483871	REAC:R-HSA-1251985	REAC	Nuclear signaling by ERBB4	10916	1620		0.6785714285714286	0.6896551724137931	31	10885	3	8	28	10877	10916	0.16107739149687908
R1	cpdb	0	network_modules	19	TRUE	0.0016120241145627754	293	11	5	0.45454545454545453	0.017064846416382253	REAC:R-HSA-9006925	REAC	Intracellular signaling by second messengers	10916	1266		0.7142857142857143	0.7241379310344828	293	10623	5	6	288	10617	10916	0.08404910016171865
R1	cpdb	0	network_modules	19	TRUE	0.0033391886757592514	46	11	3	0.2727272727272727	0.06521739130434782	REAC:R-HSA-1227986	REAC	Signaling by ERBB2	10916	2232		0.75	0.7586206896551724	46	10870	3	8	43	10862	10916	0.13164946793187832
R1	cpdb	0	network_modules	19	TRUE	0.004568335869927015	51	11	3	0.2727272727272727	0.058823529411764705	REAC:R-HSA-8848021	REAC	Signaling by PTK6	10916	2295		0.7857142857142857	0.8275862068965517	51	10865	3	8	48	10857	10916	0.1248450619226793
R1	cpdb	0	network_modules	19	TRUE	0.004568335869927015	51	11	3	0.2727272727272727	0.058823529411764705	REAC:R-HSA-9006927	REAC	Signaling by Non-Receptor Tyrosine Kinases	10916	2288		0.7857142857142857	0.8275862068965517	51	10865	3	8	48	10857	10916	0.1248450619226793
R1	cpdb	0	network_modules	19	TRUE	0.005432214771239401	54	11	3	0.2727272727272727	0.05555555555555555	REAC:R-HSA-1236394	REAC	Signaling by ERBB4	10916	2237		0.8571428571428571	0.8620689655172413	54	10862	3	8	51	10854	10916	0.12121993610317544
R1	cpdb	0	network_modules	19	TRUE	0.007622787767750788	8	11	2	0.18181818181818182	0.25	REAC:R-HSA-5638302	REAC	Signaling by Overexpressed Wild-Type EGFR in Cancer	10916	2290		0.8928571428571429	0.9310344827586207	8	10908	2	9	6	10899	10916	0.21252631092836188
R1	cpdb	0	network_modules	19	TRUE	0.007622787767750788	8	11	2	0.18181818181818182	0.25	REAC:R-HSA-5638303	REAC	Inhibition of Signaling by Overexpressed EGFR	10916	1194		0.8928571428571429	0.9310344827586207	8	10908	2	9	6	10899	10916	0.21252631092836188
R1	cpdb	0	network_modules	19	TRUE	0.00907662001304885	418	11	5	0.45454545454545453	0.011961722488038277	REAC:R-HSA-5663202	REAC	Diseases of signal transduction by growth factor receptors and second messengers	10916	773		0.9642857142857143	0.9655172413793104	418	10498	5	6	413	10492	10916	0.06889108544533008
R1	cpdb	0	network_modules	19	TRUE	0.009795339157893589	9	11	2	0.18181818181818182	0.2222222222222222	REAC:R-HSA-212718	REAC	EGFR interacts with phospholipase C-gamma	10916	815		1	1	9	10907	2	9	7	10898	10916	0.20027954273656026
R1	cpdb	0	network_modules	19	TRUE	0.009819758219721055	3	25	2	0.08	0.6666666666666666	GO:0018343	GO:BP	protein farnesylation	16175	5410		1	1	3	16172	2	23	1	16149	16175	0.23060434694047444
R1	cpdb	0	network_modules	20	TRUE	6.898383807788398e-15	79	18	10	0.5555555555555556	0.12658227848101267	KEGG:00983	KEGG	Drug metabolism - other enzymes	8484	157		0	0.08333333333333333	79	8405	10	8	69	8397	8484	0.2622418403388128
R1	cpdb	0	network_modules	20	TRUE	1.3668907517226278e-13	21	19	7	0.3684210526315789	0.3333333333333333	GO:0052695	GO:BP	cellular glucuronidation	16175	14152		0	0.029411764705882353	21	16154	7	12	14	16142	16175	0.34963570939176486
R1	cpdb	0	network_modules	20	TRUE	2.8781169871581763e-13	23	19	7	0.3684210526315789	0.30434782608695654	GO:0006063	GO:BP	uronic acid metabolic process	16175	1930		0.030303030303030304	0.08823529411764706	23	16152	7	12	16	16140	16175	0.33399664315920585
R1	cpdb	0	network_modules	20	TRUE	2.8781169871581763e-13	23	19	7	0.3684210526315789	0.30434782608695654	GO:0019585	GO:BP	glucuronate metabolic process	16175	5912		0.030303030303030304	0.08823529411764706	23	16152	7	12	16	16140	16175	0.33399664315920585
R1	cpdb	0	network_modules	20	TRUE	2.0728172746600123e-12	25	19	7	0.3684210526315789	0.28	REAC:R-HSA-156588	REAC	Glucuronidation	10916	1054		0	0.14285714285714285	25	10891	7	12	18	10879	10916	0.31983005771052203
R1	cpdb	0	network_modules	20	TRUE	6.198858374070857e-12	30	18	7	0.3888888888888889	0.23333333333333334	KEGG:00053	KEGG	Ascorbate and aldarate metabolism	8484	8		0.09090909090909091	0.16666666666666666	30	8454	7	11	23	8443	8484	0.29933987559498687
R1	cpdb	0	network_modules	20	TRUE	1.0217377005699096e-11	6	19	5	0.2631578947368421	0.8333333333333334	GO:0051552	GO:BP	flavone metabolic process	16175	13783		0.09090909090909091	0.11764705882352941	6	16169	5	14	1	16155	16175	0.46799451103489587
R1	cpdb	0	network_modules	20	TRUE	2.5245007098437495e-11	36	18	7	0.3888888888888889	0.19444444444444445	KEGG:00040	KEGG	Pentose and glucuronate interconversions	8484	5		0.18181818181818182	0.25	36	8448	7	11	29	8437	8484	0.2728540186770579
R1	cpdb	0	network_modules	20	TRUE	9.667793199839221e-11	43	18	7	0.3888888888888889	0.16279069767441862	KEGG:00860	KEGG	Porphyrin metabolism	8484	128		0.2727272727272727	0.3333333333333333	43	8441	7	11	36	8430	8484	0.24922683221602604
R1	cpdb	0	network_modules	20	TRUE	7.839036868502383e-10	11	19	5	0.2631578947368421	0.45454545454545453	GO:0009812	GO:BP	flavonoid metabolic process	16175	3696		0.12121212121212122	0.14705882352941177	11	16164	5	14	6	16150	16175	0.34528366739818006
R1	cpdb	0	network_modules	20	TRUE	1.4438443527352487e-9	62	18	7	0.3888888888888889	0.11290322580645161	KEGG:00140	KEGG	Steroid hormone biosynthesis	8484	17		0.36363636363636365	0.4166666666666667	62	8422	7	11	55	8411	8484	0.20657657670007973
R1	cpdb	0	network_modules	20	TRUE	2.5386315072231202e-09	67	18	7	0.3888888888888889	0.1044776119402985	KEGG:05204	KEGG	Chemical carcinogenesis - DNA adducts	8484	456		0.45454545454545453	0.5	67	8417	7	11	60	8406	8484	0.1984710633099982
R1	cpdb	0	network_modules	20	TRUE	2.8267198957035303e-9	68	18	7	0.3888888888888889	0.10294117647058823	KEGG:00830	KEGG	Retinol metabolism	8484	127		0.5454545454545454	0.6666666666666666	68	8416	7	11	61	8405	8484	0.19695706386314923
R1	cpdb	0	network_modules	20	TRUE	2.8267198957035303e-9	68	18	7	0.3888888888888889	0.10294117647058823	KEGG:00982	KEGG	Drug metabolism - cytochrome P450	8484	156		0.5454545454545454	0.6666666666666666	68	8416	7	11	61	8405	8484	0.19695706386314923
R1	cpdb	0	network_modules	20	TRUE	5.211398830219219e-9	74	18	7	0.3888888888888889	0.0945945945945946	KEGG:00980	KEGG	Metabolism of xenobiotics by cytochrome P450	8484	154		0.7272727272727273	0.75	74	8410	7	11	67	8399	8484	0.18852018952122718
R1	cpdb	0	network_modules	20	TRUE	9.17898903805198e-9	5	19	4	0.21052631578947367	0.8	GO:0052696	GO:BP	flavonoid glucuronidation	16175	14153		0.15151515151515152	0.17647058823529413	5	16170	4	15	1	16155	16175	0.41009303750964266
R1	cpdb	0	network_modules	20	TRUE	1.9614215987905225e-8	89	18	7	0.3888888888888889	0.07865168539325842	KEGG:04976	KEGG	Bile secretion	8484	407		0.8181818181818182	0.8333333333333334	89	8395	7	11	82	8384	8484	0.17125446172313288
R1	cpdb	0	network_modules	20	TRUE	2.151621937072313e-8	153	18	8	0.4444444444444444	0.05228758169934641	KEGG:01240	KEGG	Biosynthesis of cofactors	8484	190		0.9090909090909091	0.9166666666666666	153	8331	8	10	145	8321	8484	0.14775132564817345
R1	cpdb	0	network_modules	20	TRUE	2.1614241958873988e-8	43	19	6	0.3157894736842105	0.13953488372093023	REAC:R-HSA-9749641	REAC	Aspirin ADME	10916	171		0.16666666666666666	0.2857142857142857	43	10873	6	13	37	10860	10916	0.20788545240351317
R1	cpdb	0	network_modules	20	TRUE	6.415759548403405e-8	7	19	4	0.21052631578947367	0.5714285714285714	GO:0052697	GO:BP	xenobiotic glucuronidation	16175	14154		0.18181818181818182	0.20588235294117646	7	16168	4	15	3	16153	16175	0.346409437324016
R1	cpdb	0	network_modules	20	TRUE	9.717129518939449e-8	106	19	7	0.3684210526315789	0.0660377358490566	REAC:R-HSA-156580	REAC	Phase II - Conjugation of compounds	10916	1738		0.3333333333333333	0.42857142857142855	106	10810	7	12	99	10798	10916	0.1527443677875398
R1	cpdb	0	network_modules	20	TRUE	1.0387255300195293e-7	107	19	7	0.3684210526315789	0.06542056074766354	REAC:R-HSA-9748784	REAC	Drug ADME	10916	796		0.5	0.5714285714285714	107	10809	7	12	100	10797	10916	0.1519971384809403
R1	cpdb	0	network_modules	20	TRUE	1.1700623661462163e-7	65	19	6	0.3157894736842105	0.09230769230769231	GO:0042440	GO:BP	pigment metabolic process	16175	10180		0.21212121212121213	0.23529411764705882	65	16110	6	13	59	16097	16175	0.16899946613042774
R1	cpdb	0	network_modules	20	TRUE	1.8569105900796214e-6	3	19	3	0.15789473684210525	1	GO:2001030	GO:BP	negative regulation of cellular glucuronidation	16175	26276		0.24242424242424243	0.2647058823529412	3	16172	3	16	0	16156	16175	0.39716309171553144
R1	cpdb	0	network_modules	20	TRUE	4.057534713801477e-6	116	19	6	0.3157894736842105	0.05172413793103448	GO:0006805	GO:BP	xenobiotic metabolic process	16175	2487		0.2727272727272727	0.29411764705882354	116	16059	6	13	110	16046	16175	0.1254258501619568
R1	cpdb	0	network_modules	20	TRUE	7.4221308769939816e-6	4	19	3	0.15789473684210525	0.75	GO:2001029	GO:BP	regulation of cellular glucuronidation	16175	26275		0.30303030303030304	0.3235294117647059	4	16171	3	16	1	16155	16175	0.3438291238544239
R1	cpdb	0	network_modules	20	TRUE	8.26538627792345e-6	211	18	7	0.3888888888888889	0.03317535545023697	KEGG:05207	KEGG	Chemical carcinogenesis - receptor activation	8484	459		1	1	211	8273	7	11	204	8262	8484	0.10778257366652237
R1	cpdb	0	network_modules	20	TRUE	1.3690431054070077e-5	215	19	7	0.3684210526315789	0.03255813953488372	REAC:R-HSA-211859	REAC	Biological oxidations	10916	227		0.6666666666666666	0.7142857142857143	215	10701	7	12	208	10689	10916	0.1047945660893861
R1	cpdb	0	network_modules	20	TRUE	1.4945369876911048e-5	144	19	6	0.3157894736842105	0.041666666666666664	GO:0071466	GO:BP	cellular response to xenobiotic stimulus	16175	16699		0.3333333333333333	0.35294117647058826	144	16031	6	13	138	16018	16175	0.11203942943649943
R1	cpdb	0	network_modules	20	TRUE	4.162950717912328e-5	28	19	4	0.21052631578947367	0.14285714285714285	REAC:R-HSA-9753281	REAC	Paracetamol ADME	10916	1714		0.8333333333333334	0.8571428571428571	28	10888	4	15	24	10873	10916	0.1716786339093554
R1	cpdb	0	network_modules	20	TRUE	4.2831891398518676e-5	29	19	4	0.21052631578947367	0.13793103448275862	GO:0042573	GO:BP	retinoic acid metabolic process	16175	10249		0.36363636363636365	0.4117647058823529	29	16146	4	15	25	16131	16175	0.16920558544715944
R1	cpdb	0	network_modules	20	TRUE	4.2831891398518676e-5	29	19	4	0.21052631578947367	0.13793103448275862	GO:0045922	GO:BP	negative regulation of fatty acid metabolic process	16175	11716		0.36363636363636365	0.4117647058823529	29	16146	4	15	25	16131	16175	0.16920558544715944
R1	cpdb	0	network_modules	20	TRUE	8.086438783271536e-5	191	19	6	0.3157894736842105	0.031413612565445025	GO:0009410	GO:BP	response to xenobiotic stimulus	16175	3475		0.42424242424242425	0.4411764705882353	191	15984	6	13	185	15971	16175	0.09650312342644489
R1	cpdb	0	network_modules	20	TRUE	2.2167443285318439e-4	10	19	3	0.15789473684210525	0.3	GO:0046385	GO:BP	deoxyribose phosphate biosynthetic process	16175	12113		0.45454545454545453	0.5294117647058824	10	16165	3	16	7	16149	16175	0.2169852164756029
R1	cpdb	0	network_modules	20	TRUE	2.2167443285318439e-4	10	19	3	0.15789473684210525	0.3	GO:0009263	GO:BP	deoxyribonucleotide biosynthetic process	16175	3428		0.45454545454545453	0.5294117647058824	10	16165	3	16	7	16149	16175	0.2169852164756029
R1	cpdb	0	network_modules	20	TRUE	2.2167443285318439e-4	10	19	3	0.15789473684210525	0.3	GO:0009265	GO:BP	2'-deoxyribonucleotide biosynthetic process	16175	3430		0.45454545454545453	0.5294117647058824	10	16165	3	16	7	16149	16175	0.2169852164756029
R1	cpdb	0	network_modules	20	TRUE	2.655188006051391e-4	45	19	4	0.21052631578947367	0.08888888888888889	GO:0001889	GO:BP	liver development	16175	515		0.5454545454545454	0.5588235294117647	45	16130	4	15	41	16115	16175	0.13525699297699292
R1	cpdb	0	network_modules	20	TRUE	2.9059032628765994e-4	46	19	4	0.21052631578947367	0.08695652173913043	GO:0061008	GO:BP	hepaticobiliary system development	16175	15132		0.5757575757575758	0.5882352941176471	46	16129	4	15	42	16114	16175	0.1337430639592492
R1	cpdb	0	network_modules	20	TRUE	0.0013452516475601262	504	19	7	0.3684210526315789	0.013888888888888888	GO:0032787	GO:BP	monocarboxylic acid metabolic process	16175	7822		0.6060606060606061	0.6176470588235294	504	15671	7	12	497	15659	16175	0.06656681381047193
R1	cpdb	0	network_modules	20	TRUE	0.0016038899824150504	70	19	4	0.21052631578947367	0.05714285714285714	GO:0001523	GO:BP	retinoid metabolic process	16175	329		0.6363636363636364	0.6470588235294118	70	16105	4	15	66	16090	16175	0.10772353580804464
R1	cpdb	0	network_modules	20	TRUE	0.0016983816619549454	71	19	4	0.21052631578947367	0.056338028169014086	GO:0019217	GO:BP	regulation of fatty acid metabolic process	16175	5594		0.6666666666666666	0.6764705882352942	71	16104	4	15	67	16089	16175	0.10693347902976721
R1	cpdb	0	network_modules	20	TRUE	0.0017665773513739864	2	19	2	0.10526315789473684	1	GO:0006789	GO:BP	bilirubin conjugation	16175	2475		0.696969696969697	0.7058823529411765	2	16173	2	17	0	16156	16175	0.32427228087924065
R1	cpdb	0	network_modules	20	TRUE	0.0017969501952389048	72	19	4	0.21052631578947367	0.05555555555555555	GO:0016101	GO:BP	diterpenoid metabolic process	16175	5119		0.7272727272727273	0.7352941176470589	72	16103	4	15	68	16088	16175	0.10615973742817363
R1	cpdb	0	network_modules	20	TRUE	0.0027461076274558024	80	19	4	0.21052631578947367	0.05	GO:0006721	GO:BP	terpenoid metabolic process	16175	2427		0.7575757575757576	0.7941176470588235	80	16095	4	15	76	16080	16175	0.10049522221400894
R1	cpdb	0	network_modules	20	TRUE	0.0027461076274558024	80	19	4	0.21052631578947367	0.05	GO:0045833	GO:BP	negative regulation of lipid metabolic process	16175	11649		0.7575757575757576	0.7941176470588235	80	16095	4	15	76	16080	16175	0.10049522221400894
R1	cpdb	0	network_modules	20	TRUE	0.0030323917349067858	82	19	4	0.21052631578947367	0.04878048780487805	GO:0062014	GO:BP	negative regulation of small molecule metabolic process	16175	15783		0.8181818181818182	0.8235294117647058	82	16093	4	15	78	16078	16175	0.09920856762685983
R1	cpdb	0	network_modules	20	TRUE	0.003920455405650977	370	19	6	0.3157894736842105	0.016216216216216217	GO:0044772	GO:BP	mitotic cell cycle phase transition	16175	11148		0.8484848484848485	0.8529411764705882	370	15805	6	13	364	15792	16175	0.06718884473352442
R1	cpdb	0	network_modules	20	TRUE	0.0040563227740468	27	19	3	0.15789473684210525	0.1111111111111111	REAC:R-HSA-499943	REAC	Interconversion of nucleotide di- and triphosphates	10916	1225		1	1	27	10889	3	16	24	10873	10916	0.13065364120266185
R1	cpdb	0	network_modules	20	TRUE	0.0059404522446590575	97	19	4	0.21052631578947367	0.041237113402061855	GO:0006720	GO:BP	isoprenoid metabolic process	16175	2426		0.8787878787878788	0.8823529411764706	97	16078	4	15	93	16063	16175	0.09084646805947554
R1	cpdb	0	network_modules	20	TRUE	0.00665545531548152	29	19	3	0.15789473684210525	0.10344827586206896	GO:0009394	GO:BP	2'-deoxyribonucleotide metabolic process	16175	3463		0.9090909090909091	0.9411764705882353	29	16146	3	16	26	16130	16175	0.12654084640823748
R1	cpdb	0	network_modules	20	TRUE	0.00665545531548152	29	19	3	0.15789473684210525	0.10344827586206896	GO:0019692	GO:BP	deoxyribose phosphate metabolic process	16175	6009		0.9090909090909091	0.9411764705882353	29	16146	3	16	26	16130	16175	0.12654084640823748
R1	cpdb	0	network_modules	20	TRUE	0.006979361238720626	101	19	4	0.21052631578947367	0.039603960396039604	GO:0010565	GO:BP	regulation of ketone metabolic process	16175	4218		0.9696969696969697	0.9705882352941176	101	16074	4	15	97	16059	16175	0.08893277365857144
R1	cpdb	0	network_modules	20	TRUE	0.007389463159395117	30	19	3	0.15789473684210525	0.1	GO:0009262	GO:BP	deoxyribonucleotide metabolic process	16175	3427		1	1	30	16145	3	16	27	16129	16175	0.12436853556759232
R1	cpdb	0	network_modules	21	TRUE	1.2830882027890857e-38	43	29	19	0.6551724137931034	0.4418604651162791	REAC:R-HSA-5693579	REAC	Homologous DNA Pairing and Strand Exchange	10916	1129		0	0.014925373134328358	43	10873	19	10	24	10863	10916	0.5365819427088209
R1	cpdb	0	network_modules	21	TRUE	2.2189113962742493e-37	168	29	24	0.8275862068965517	0.14285714285714285	REAC:R-HSA-5693532	REAC	DNA Double-Strand Break Repair	10916	443		0.015151515151515152	0.029850746268656716	168	10748	24	5	144	10743	10916	0.3405263838133536
R1	cpdb	0	network_modules	21	TRUE	5.038279492595917e-37	138	29	23	0.7931034482758621	0.16666666666666666	REAC:R-HSA-5693538	REAC	Homology Directed Repair	10916	1130		0.030303030303030304	0.04477611940298507	138	10778	23	6	115	10772	10916	0.3605381623480406
R1	cpdb	0	network_modules	21	TRUE	1.1876513640336687e-36	68	29	20	0.6896551724137931	0.29411764705882354	REAC:R-HSA-5685942	REAC	HDR through Homologous Recombination (HRR)	10916	1097		0.045454545454545456	0.05970149253731343	68	10848	20	9	48	10839	10916	0.4483017970316242
R1	cpdb	0	network_modules	21	TRUE	1.2759970585194734e-33	40	29	17	0.5862068965517241	0.425	REAC:R-HSA-5693616	REAC	Presynaptic phase of homologous DNA pairing and strand exchange	10916	1793		0.06060606060606061	0.07462686567164178	40	10876	17	12	23	10864	10916	0.4975898035835237
R1	cpdb	0	network_modules	21	TRUE	2.177557240851638e-33	41	29	17	0.5862068965517241	0.4146341463414634	REAC:R-HSA-9701190	REAC	Defective homologous recombination repair (HRR) due to BRCA2 loss of function	10916	698		0.07575757575757576	0.1044776119402985	41	10875	17	12	24	10863	10916	0.4914294797717315
R1	cpdb	0	network_modules	21	TRUE	2.177557240851638e-33	41	29	17	0.5862068965517241	0.4146341463414634	REAC:R-HSA-9675136	REAC	Diseases of DNA Double-Strand Break Repair	10916	757		0.07575757575757576	0.1044776119402985	41	10875	17	12	24	10863	10916	0.4914294797717315
R1	cpdb	0	network_modules	21	TRUE	2.8581034173443705e-32	329	29	25	0.8620689655172413	0.07598784194528875	REAC:R-HSA-73894	REAC	DNA Repair	10916	444		0.10606060606060606	0.11940298507462686	329	10587	25	4	304	10583	10916	0.2511369690882138
R1	cpdb	0	network_modules	21	TRUE	1.4013913322798496e-31	50	29	17	0.5862068965517241	0.34	REAC:R-HSA-9675135	REAC	Diseases of DNA repair	10916	758		0.12121212121212122	0.13432835820895522	50	10866	17	12	33	10854	10916	0.4445623922549302
R1	cpdb	0	network_modules	21	TRUE	3.2003361841862786e-30	132	29	20	0.6896551724137931	0.15151515151515152	REAC:R-HSA-5693567	REAC	HDR through Homologous Recombination (HRR) or Single Strand Annealing (SSA)	10916	1098		0.13636363636363635	0.14925373134328357	132	10784	20	9	112	10775	10916	0.31994924018716464
R1	cpdb	0	network_modules	21	TRUE	3.0487853339153545e-29	35	29	15	0.5172413793103449	0.42857142857142855	REAC:R-HSA-9709570	REAC	Impaired BRCA2 binding to RAD51	10916	1173		0.15151515151515152	0.16417910447761194	35	10881	15	14	20	10867	10916	0.4692807529789214
R1	cpdb	0	network_modules	21	TRUE	1.2299866578986812e-27	528	37	26	0.7027027027027027	0.04924242424242424	GO:0006281	GO:BP	DNA repair	16175	2095		0	0.015384615384615385	528	15647	26	11	502	15636	16175	0.180551588869677
R1	cpdb	0	network_modules	21	TRUE	2.1314436720803744e-26	798	37	28	0.7567567567567568	0.03508771929824561	GO:0006974	GO:BP	DNA damage response	16175	2601		0.015625	0.03076923076923077	798	15377	28	9	770	15368	16175	0.1564088105740314
R1	cpdb	0	network_modules	21	TRUE	4.143744555113196e-26	37	29	14	0.4827586206896552	0.3783783783783784	REAC:R-HSA-5685938	REAC	HDR through Single Strand Annealing (SSA)	10916	1100		0.16666666666666666	0.1791044776119403	37	10879	14	15	23	10864	10916	0.4256798577860427
R1	cpdb	0	network_modules	21	TRUE	2.9364254857718904e-24	298	37	21	0.5675675675675675	0.07046979865771812	GO:0006302	GO:BP	double-strand break repair	16175	2109		0.03125	0.046153846153846156	298	15877	21	16	277	15861	16175	0.1955303794776802
R1	cpdb	0	network_modules	21	TRUE	2.9129356550745286e-23	172	37	18	0.4864864864864865	0.10465116279069768	GO:0000724	GO:BP	double-strand break repair via homologous recombination	16175	203		0.046875	0.06153846153846154	172	16003	18	19	154	15984	16175	0.22214062632359788
R1	cpdb	0	network_modules	21	TRUE	4.4823998809824596e-23	176	37	18	0.4864864864864865	0.10227272727272728	GO:0000725	GO:BP	recombinational repair	16175	204		0.0625	0.09230769230769231	176	15999	18	19	158	15980	16175	0.21951510436795205
R1	cpdb	0	network_modules	21	TRUE	4.4823998809824596e-23	176	37	18	0.4864864864864865	0.10227272727272728	GO:0000075	GO:BP	cell cycle checkpoint signaling	16175	26		0.0625	0.09230769230769231	176	15999	18	19	158	15980	16175	0.21951510436795205
R1	cpdb	0	network_modules	21	TRUE	8.276144333855834e-22	123	37	16	0.43243243243243246	0.13008130081300814	GO:0031570	GO:BP	DNA integrity checkpoint signaling	16175	7220		0.09375	0.1076923076923077	123	16052	16	21	107	16031	16175	0.2341619923492239
R1	cpdb	0	network_modules	21	TRUE	3.974726658549804e-21	224	37	18	0.4864864864864865	0.08035714285714286	GO:1901988	GO:BP	negative regulation of cell cycle phase transition	16175	21921		0.109375	0.12307692307692308	224	15951	18	19	206	15932	16175	0.19365598497479003
R1	cpdb	0	network_modules	21	TRUE	2.689178018116739e-20	114	37	15	0.40540540540540543	0.13157894736842105	GO:0000077	GO:BP	DNA damage checkpoint signaling	16175	28		0.125	0.13846153846153847	114	16061	15	22	99	16039	16175	0.22801035381335943
R1	cpdb	0	network_modules	21	TRUE	7.093487688334353e-20	262	37	18	0.4864864864864865	0.06870229007633588	GO:0010948	GO:BP	negative regulation of cell cycle process	16175	4526		0.140625	0.15384615384615385	262	15913	18	19	244	15894	16175	0.17838491123839442
R1	cpdb	0	network_modules	21	TRUE	7.963199259050797e-20	92	29	14	0.4827586206896552	0.15217391304347827	REAC:R-HSA-6804756	REAC	Regulation of TP53 Activity through Phosphorylation	10916	2016		0.18181818181818182	0.19402985074626866	92	10824	14	15	78	10809	10916	0.26779457496106707
R1	cpdb	0	network_modules	21	TRUE	1.098646816142393e-19	94	29	14	0.4827586206896552	0.14893617021276595	REAC:R-HSA-69473	REAC	G2/M DNA damage checkpoint	10916	1006		0.19696969696969696	0.208955223880597	94	10822	14	15	80	10807	10916	0.2648525163263377
R1	cpdb	0	network_modules	21	TRUE	1.7561538594625025e-19	97	29	14	0.4827586206896552	0.14432989690721648	REAC:R-HSA-5693607	REAC	Processing of DNA double-strand break ends	10916	1798		0.21212121212121213	0.22388059701492538	97	10819	14	15	83	10804	10916	0.26060969514794624
R1	cpdb	0	network_modules	21	TRUE	2.551201607755449e-19	281	37	18	0.4864864864864865	0.06405693950177936	GO:0006310	GO:BP	DNA recombination	16175	2115		0.15625	0.16923076923076924	281	15894	18	19	263	15875	16175	0.17192099806926084
R1	cpdb	0	network_modules	21	TRUE	4.704357724035157e-19	231	37	17	0.4594594594594595	0.0735930735930736	GO:0006260	GO:BP	DNA replication	16175	2077		0.171875	0.18461538461538463	231	15944	17	20	214	15924	16175	0.17965922183634736
R1	cpdb	0	network_modules	21	TRUE	1.1306844551417591e-18	376	37	19	0.5135135135135135	0.05053191489361702	GO:1901987	GO:BP	regulation of cell cycle phase transition	16175	21920		0.1875	0.2	376	15799	19	18	357	15781	16175	0.1557919137550157
R1	cpdb	0	network_modules	21	TRUE	1.6224626596505539e-18	465	37	20	0.5405405405405406	0.043010752688172046	GO:0044770	GO:BP	cell cycle phase transition	16175	11146		0.203125	0.2153846153846154	465	15710	20	17	445	15693	16175	0.14665592748342351
R1	cpdb	0	network_modules	21	TRUE	3.810380559149895e-18	54	29	12	0.41379310344827586	0.2222222222222222	KEGG:03460	KEGG	Fanconi anemia pathway	8484	242		0	0.2	54	8430	12	17	42	8413	8484	0.30004282846846986
R1	cpdb	0	network_modules	21	TRUE	7.31046897102836e-18	338	37	18	0.4864864864864865	0.05325443786982249	GO:0045786	GO:BP	negative regulation of cell cycle	16175	11618		0.21875	0.23076923076923078	338	15837	18	19	320	15818	16175	0.15585802541134647
R1	cpdb	0	network_modules	21	TRUE	1.6665439853681164e-17	172	37	15	0.40540540540540543	0.0872093023255814	GO:0042770	GO:BP	signal transduction in response to DNA damage	16175	10355		0.234375	0.24615384615384617	172	16003	15	22	157	15981	16175	0.1842898404972139
R1	cpdb	0	network_modules	21	TRUE	1.6846017737432426e-17	41	29	11	0.3793103448275862	0.2682926829268293	KEGG:03440	KEGG	Homologous recombination	8484	240		0.25	0.4	41	8443	11	18	30	8425	8484	0.3162485276581904
R1	cpdb	0	network_modules	21	TRUE	2.663554885373337e-16	160	29	14	0.4827586206896552	0.0875	REAC:R-HSA-5633007	REAC	Regulation of TP53 Activity	10916	2012		0.22727272727272727	0.23880597014925373	160	10756	14	15	146	10741	10916	0.20103089918636172
R1	cpdb	0	network_modules	21	TRUE	3.5450436385042347e-16	37	29	10	0.3448275862068966	0.2702702702702703	REAC:R-HSA-176187	REAC	Activation of ATR in response to replication stress	10916	75		0.24242424242424243	0.2537313432835821	37	10879	10	19	27	10860	10916	0.3031970714428241
R1	cpdb	0	network_modules	21	TRUE	4.929697419447612e-16	167	29	14	0.4827586206896552	0.08383233532934131	REAC:R-HSA-69481	REAC	G2/M Checkpoints	10916	1005		0.25757575757575757	0.26865671641791045	167	10749	14	15	153	10734	10916	0.19656698680360074
R1	cpdb	0	network_modules	21	TRUE	6.629755623367086e-16	630	37	20	0.5405405405405406	0.031746031746031744	GO:0010564	GO:BP	regulation of cell cycle process	16175	4217		0.25	0.26153846153846155	630	15545	20	17	610	15528	16175	0.12413803463502929
R1	cpdb	0	network_modules	21	TRUE	4.948624830869547e-13	147	37	12	0.32432432432432434	0.08163265306122448	GO:0006261	GO:BP	DNA-templated DNA replication	16175	2078		0.265625	0.27692307692307694	147	16028	12	25	135	16003	16175	0.15905893865817455
R1	cpdb	0	network_modules	21	TRUE	6.466389595003205e-13	27	29	8	0.27586206896551724	0.2962962962962963	REAC:R-HSA-5693554	REAC	Resolution of D-loop Structures through Synthesis-Dependent Strand Annealing (SDSA)	10916	2078		0.2727272727272727	0.2835820895522388	27	10889	8	21	19	10868	10916	0.28406190215184507
R1	cpdb	0	network_modules	21	TRUE	1.1546713742761176e-12	289	29	14	0.4827586206896552	0.04844290657439446	REAC:R-HSA-69620	REAC	Cell Cycle Checkpoints	10916	321		0.2878787878787879	0.29850746268656714	289	10627	14	15	275	10612	10916	0.1466861560171505
R1	cpdb	0	network_modules	21	TRUE	5.2252300455261084e-12	34	29	8	0.27586206896551724	0.23529411764705882	REAC:R-HSA-5693568	REAC	Resolution of D-loop Structures through Holliday Junction Intermediates	10916	2077		0.30303030303030304	0.31343283582089554	34	10882	8	21	26	10861	10916	0.2526243299305358
R1	cpdb	0	network_modules	21	TRUE	6.7618366786852874e-12	35	29	8	0.27586206896551724	0.22857142857142856	REAC:R-HSA-5693537	REAC	Resolution of D-Loop Structures	10916	2076		0.3181818181818182	0.3283582089552239	35	10881	8	21	27	10860	10916	0.24891706641185832
R1	cpdb	0	network_modules	21	TRUE	2.3366429367656918e-11	359	29	14	0.4827586206896552	0.03899721448467967	REAC:R-HSA-3700989	REAC	Transcriptional Regulation by TP53	10916	2546		0.3333333333333333	0.34328358208955223	359	10557	14	15	345	10542	10916	0.13019042348636453
R1	cpdb	0	network_modules	21	TRUE	3.9128404770621835e-11	152	37	11	0.2972972972972973	0.07236842105263158	GO:0000723	GO:BP	telomere maintenance	16175	202		0.28125	0.2923076923076923	152	16023	11	26	141	15997	16175	0.14287898951766972
R1	cpdb	0	network_modules	21	TRUE	5.0113952712931857e-11	24	29	7	0.2413793103448276	0.2916666666666667	REAC:R-HSA-9709603	REAC	Impaired BRCA2 binding to PALB2	10916	1172		0.3484848484848485	0.3582089552238806	24	10892	7	22	17	10870	10916	0.26355733954865107
R1	cpdb	0	network_modules	21	TRUE	6.000955951864903e-11	42	37	8	0.21621621621621623	0.19047619047619047	GO:0006284	GO:BP	base-excision repair	16175	2098		0.296875	0.3076923076923077	42	16133	8	29	34	16104	16175	0.20099220506719892
R1	cpdb	0	network_modules	21	TRUE	6.46923137987008e-11	12	29	6	0.20689655172413793	0.5	REAC:R-HSA-5685939	REAC	HDR through MMEJ (alt-NHEJ)	10916	1099		0.36363636363636365	0.373134328358209	12	10904	6	23	6	10881	10916	0.32052686280722653
R1	cpdb	0	network_modules	21	TRUE	6.947977989930763e-11	25	29	7	0.2413793103448276	0.28	REAC:R-HSA-9704331	REAC	Defective HDR through Homologous Recombination Repair (HRR) due to PALB2 loss of BRCA1 binding function	10916	562		0.3787878787878788	0.43283582089552236	25	10891	7	22	18	10869	10916	0.2581453448007413
R1	cpdb	0	network_modules	21	TRUE	6.947977989930763e-11	25	29	7	0.2413793103448276	0.28	REAC:R-HSA-9704646	REAC	Defective HDR through Homologous Recombination Repair (HRR) due to PALB2 loss of BRCA2/RAD51/RAD51C binding function	10916	563		0.3787878787878788	0.43283582089552236	25	10891	7	22	18	10869	10916	0.2581453448007413
R1	cpdb	0	network_modules	21	TRUE	6.947977989930763e-11	25	29	7	0.2413793103448276	0.28	REAC:R-HSA-9701192	REAC	Defective homologous recombination repair (HRR) due to BRCA1 loss of function	10916	697		0.3787878787878788	0.43283582089552236	25	10891	7	22	18	10869	10916	0.2581453448007413
R1	cpdb	0	network_modules	21	TRUE	6.947977989930763e-11	25	29	7	0.2413793103448276	0.28	REAC:R-HSA-9701193	REAC	Defective homologous recombination repair (HRR) due to PALB2 loss of function	10916	699		0.3787878787878788	0.43283582089552236	25	10891	7	22	18	10869	10916	0.2581453448007413
R1	cpdb	0	network_modules	21	TRUE	9.147325219766294e-11	300	37	13	0.35135135135135137	0.043333333333333335	GO:0009314	GO:BP	response to radiation	16175	3460		0.3125	0.3230769230769231	300	15875	13	24	287	15851	16175	0.11811134467489384
R1	cpdb	0	network_modules	21	TRUE	1.9002336682197798e-10	48	37	8	0.21621621621621623	0.16666666666666666	GO:0031297	GO:BP	replication fork processing	16175	7119		0.328125	0.3384615384615385	48	16127	8	29	40	16098	16175	0.1877194283120399
R1	cpdb	0	network_modules	21	TRUE	2.8885876947947046e-10	182	37	11	0.2972972972972973	0.06043956043956044	GO:0032200	GO:BP	telomere organization	16175	7392		0.34375	0.35384615384615387	182	15993	11	26	171	15967	16175	0.12985376574065938
R1	cpdb	0	network_modules	21	TRUE	5.034295239242444e-10	134	37	10	0.2702702702702703	0.07462686567164178	GO:0007093	GO:BP	mitotic cell cycle checkpoint signaling	16175	2676		0.359375	0.36923076923076925	134	16041	10	27	124	16014	16175	0.1383980795302282
R1	cpdb	0	network_modules	21	TRUE	5.991903389682885e-10	90	37	9	0.24324324324324326	0.1	GO:0010212	GO:BP	response to ionizing radiation	16175	3993		0.375	0.38461538461538464	90	16085	9	28	81	16057	16175	0.15299579853197198
R1	cpdb	0	network_modules	21	TRUE	8.20228855923846e-10	57	37	8	0.21621621621621623	0.14035087719298245	GO:0045005	GO:BP	DNA-templated DNA replication maintenance of fidelity	16175	11223		0.390625	0.4	57	16118	8	29	49	16089	16175	0.17186165005666482
R1	cpdb	0	network_modules	21	TRUE	3.6986626742105216e-9	116	29	9	0.3103448275862069	0.07758620689655173	REAC:R-HSA-1500620	REAC	Meiosis	10916	1410		0.4393939393939394	0.44776119402985076	116	10800	9	20	107	10780	10916	0.15086228912854396
R1	cpdb	0	network_modules	21	TRUE	4.007333044490245e-9	19	37	6	0.16216216216216217	0.3157894736842105	GO:2000001	GO:BP	regulation of DNA damage checkpoint	16175	25365		0.40625	0.4153846153846154	19	16156	6	31	13	16125	16175	0.2250446827317883
R1	cpdb	0	network_modules	21	TRUE	6.154149269054498e-9	41	37	7	0.1891891891891892	0.17073170731707318	GO:1901976	GO:BP	regulation of cell cycle checkpoint	16175	21911		0.421875	0.4307692307692308	41	16134	7	30	34	16104	16175	0.1777442679351173
R1	cpdb	0	network_modules	21	TRUE	1.0116169072671066e-8	77	37	8	0.21621621621621623	0.1038961038961039	GO:0044773	GO:BP	mitotic DNA damage checkpoint signaling	16175	11149		0.4375	0.4461538461538462	77	16098	8	29	69	16069	16175	0.1470986000635797
R1	cpdb	0	network_modules	21	TRUE	1.3965270828835544e-8	86	29	8	0.27586206896551724	0.09302325581395349	REAC:R-HSA-912446	REAC	Meiotic recombination	10916	1411		0.45454545454545453	0.4626865671641791	86	10830	8	21	78	10809	10916	0.15644200758497118
R1	cpdb	0	network_modules	21	TRUE	1.5364626194313255e-8	81	37	8	0.21621621621621623	0.09876543209876543	GO:0044774	GO:BP	mitotic DNA integrity checkpoint signaling	16175	11150		0.453125	0.46153846153846156	81	16094	8	29	73	16065	16175	0.1432706251530915
R1	cpdb	0	network_modules	21	TRUE	3.0926703048597196e-8	202	37	10	0.2702702702702703	0.04950495049504951	GO:0045930	GO:BP	negative regulation of mitotic cell cycle	16175	11724		0.46875	0.47692307692307695	202	15973	10	27	192	15946	16175	0.11114852966749521
R1	cpdb	0	network_modules	21	TRUE	4.1379035743353425e-8	53	37	7	0.1891891891891892	0.1320754716981132	GO:0071479	GO:BP	cellular response to ionizing radiation	16175	16712		0.484375	0.49230769230769234	53	16122	7	30	46	16092	16175	0.15576918878731805
R1	cpdb	0	network_modules	21	TRUE	4.818115256095143e-8	154	29	9	0.3103448275862069	0.05844155844155844	REAC:R-HSA-1474165	REAC	Reproduction	10916	2064		0.4696969696969697	0.47761194029850745	154	10762	9	20	145	10742	10916	0.12964059082926546
R1	cpdb	0	network_modules	21	TRUE	6.336355494917074e-8	14	29	5	0.1724137931034483	0.35714285714285715	REAC:R-HSA-69166	REAC	Removal of the Flap Intermediate	10916	2058		0.48484848484848486	0.4925373134328358	14	10902	5	24	9	10878	10916	0.2467860951695492
R1	cpdb	0	network_modules	21	TRUE	9.487107244007491e-8	15	29	5	0.1724137931034483	0.3333333333333333	REAC:R-HSA-69183	REAC	Processive synthesis on the lagging strand	10916	1802		0.5	0.5074626865671642	15	10901	5	24	10	10877	10916	0.2383013201596366
R1	cpdb	0	network_modules	21	TRUE	1.1780675268453717e-7	656	37	14	0.3783783783783784	0.021341463414634148	GO:1903047	GO:BP	mitotic cell cycle process	16175	22727		0.5	0.5076923076923077	656	15519	14	23	642	15496	16175	0.08200199007128495
R1	cpdb	0	network_modules	21	TRUE	1.7133675917835792e-7	545	37	13	0.35135135135135137	0.023853211009174313	GO:0051276	GO:BP	chromosome organization	16175	13613		0.515625	0.5230769230769231	545	15630	13	24	532	15606	16175	0.0842949396561244
R1	cpdb	0	network_modules	21	TRUE	1.9477569065696477e-7	17	29	5	0.1724137931034483	0.29411764705882354	REAC:R-HSA-174437	REAC	Removal of the Flap Intermediate from the C-strand	10916	2059		0.5151515151515151	0.5373134328358209	17	10899	5	24	12	10875	10916	0.22362584574172734
R1	cpdb	0	network_modules	21	TRUE	1.9477569065696477e-7	17	29	5	0.1724137931034483	0.29411764705882354	REAC:R-HSA-5655862	REAC	Translesion synthesis by POLK	10916	2575		0.5151515151515151	0.5373134328358209	17	10899	5	24	12	10875	10916	0.22362584574172734
R1	cpdb	0	network_modules	21	TRUE	2.8287240027209564e-7	701	37	14	0.3783783783783784	0.019971469329529243	GO:0009628	GO:BP	response to abiotic stimulus	16175	3549		0.53125	0.5384615384615384	701	15474	14	23	687	15451	16175	0.07878735338264091
R1	cpdb	0	network_modules	21	TRUE	3.646660720385381e-7	19	29	5	0.1724137931034483	0.2631578947368421	REAC:R-HSA-174414	REAC	Processive synthesis on the C-strand of the telomere	10916	1801		0.5454545454545454	0.5522388059701493	19	10897	5	24	14	10873	10916	0.21132143108738421
R1	cpdb	0	network_modules	21	TRUE	4.853298564417666e-7	20	29	5	0.1724137931034483	0.25	REAC:R-HSA-69186	REAC	Lagging Strand Synthesis	10916	1302		0.5606060606060606	0.5671641791044776	20	10896	5	24	15	10872	10916	0.20586954482231654
R1	cpdb	0	network_modules	21	TRUE	7.459141292481936e-7	79	37	7	0.1891891891891892	0.08860759493670886	GO:0006289	GO:BP	nucleotide-excision repair	16175	2102		0.546875	0.5538461538461539	79	16096	7	30	72	16066	16175	0.1265858441903309
R1	cpdb	0	network_modules	21	TRUE	1.1532189201569747e-6	20	37	5	0.13513513513513514	0.25	GO:0000076	GO:BP	DNA replication checkpoint signaling	16175	27		0.5625	0.5692307692307692	20	16155	5	32	15	16123	16175	0.18244335275507553
R1	cpdb	0	network_modules	21	TRUE	1.398489877199047e-6	792	37	14	0.3783783783783784	0.017676767676767676	GO:0000278	GO:BP	mitotic cell cycle	16175	76		0.578125	0.5846153846153846	792	15383	14	23	778	15360	16175	0.0730935645223774
R1	cpdb	0	network_modules	21	TRUE	1.6479624999745025e-6	25	29	5	0.1724137931034483	0.2	REAC:R-HSA-5696397	REAC	Gap-filling DNA repair synthesis and ligation in GG-NER	10916	1037		0.5757575757575758	0.582089552238806	25	10891	5	24	20	10867	10916	0.18368303069541564
R1	cpdb	0	network_modules	21	TRUE	2.0208168436284184e-6	148	37	8	0.21621621621621623	0.05405405405405406	GO:0071478	GO:BP	cellular response to radiation	16175	16711		0.59375	0.6	148	16027	8	29	140	15998	16175	0.10412924735051292
R1	cpdb	0	network_modules	21	TRUE	2.837142960560074e-6	427	37	11	0.2972972972972973	0.02576112412177986	GO:0007346	GO:BP	regulation of mitotic cell cycle	16175	2855		0.609375	0.6153846153846154	427	15748	11	26	416	15722	16175	0.08090964761100349
R1	cpdb	0	network_modules	21	TRUE	3.5712860433323934e-6	159	37	8	0.21621621621621623	0.050314465408805034	GO:1901991	GO:BP	negative regulation of mitotic cell cycle phase transition	16175	21924		0.625	0.6307692307692307	159	16016	8	29	151	15987	16175	0.10016717487955772
R1	cpdb	0	network_modules	21	TRUE	6.1664374191926935e-6	32	29	5	0.1724137931034483	0.15625	REAC:R-HSA-69190	REAC	DNA strand elongation	10916	449		0.5909090909090909	0.6119402985074627	32	10884	5	24	27	10860	10916	0.16179442383617365
R1	cpdb	0	network_modules	21	TRUE	6.1664374191926935e-6	32	29	5	0.1724137931034483	0.15625	REAC:R-HSA-5656169	REAC	Termination of translesion DNA synthesis	10916	2492		0.5909090909090909	0.6119402985074627	32	10884	5	24	27	10860	10916	0.16179442383617365
R1	cpdb	0	network_modules	21	TRUE	6.2103039535804225e-6	251	37	9	0.24324324324324326	0.035856573705179286	GO:0071214	GO:BP	cellular response to abiotic stimulus	16175	16476		0.640625	0.6615384615384615	251	15924	9	28	242	15896	16175	0.08822038639350244
R1	cpdb	0	network_modules	21	TRUE	6.2103039535804225e-6	251	37	9	0.24324324324324326	0.035856573705179286	GO:0104004	GO:BP	cellular response to environmental stimulus	16175	19202		0.640625	0.6615384615384615	251	15924	9	28	242	15896	16175	0.08822038639350244
R1	cpdb	0	network_modules	21	TRUE	7.581812115765945e-6	36	29	5	0.1724137931034483	0.1388888888888889	KEGG:03030	KEGG	DNA replication	8484	214		0.5	0.6	36	8448	5	24	31	8424	8484	0.15151809286844525
R1	cpdb	0	network_modules	21	TRUE	8.489388990130459e-6	34	29	5	0.1724137931034483	0.14705882352941177	REAC:R-HSA-174417	REAC	Telomere C-strand (Lagging Strand) Synthesis	10916	2486		0.6212121212121212	0.6268656716417911	34	10882	5	24	29	10858	10916	0.15680837064577072
R1	cpdb	0	network_modules	21	TRUE	1.1262799927651462e-5	370	37	10	0.2702702702702703	0.02702702702702703	GO:0044772	GO:BP	mitotic cell cycle phase transition	16175	11148		0.671875	0.676923076923077	370	15805	10	27	360	15778	16175	0.07923442585846564
R1	cpdb	0	network_modules	21	TRUE	1.145959389516042e-5	36	29	5	0.1724137931034483	0.1388888888888889	REAC:R-HSA-73933	REAC	Resolution of Abasic Sites (AP sites)	10916	2075		0.6363636363636364	0.6417910447761194	36	10880	5	24	31	10856	10916	0.15223941652821704
R1	cpdb	0	network_modules	21	TRUE	1.7405398250735538e-5	39	29	5	0.1724137931034483	0.1282051282051282	REAC:R-HSA-6783310	REAC	Fanconi Anemia Pathway	10916	932		0.6515151515151515	0.6716417910447762	39	10877	5	24	34	10853	10916	0.146049342456205
R1	cpdb	0	network_modules	21	TRUE	1.7405398250735538e-5	39	29	5	0.1724137931034483	0.1282051282051282	REAC:R-HSA-110313	REAC	Translesion synthesis by Y family DNA polymerases bypasses lesions on DNA template	10916	2577		0.6515151515151515	0.6716417910447762	39	10877	5	24	34	10853	10916	0.146049342456205
R1	cpdb	0	network_modules	21	TRUE	1.9371895794862717e-5	286	37	9	0.24324324324324326	0.03146853146853147	GO:1901990	GO:BP	regulation of mitotic cell cycle phase transition	16175	21923		0.6875	0.6923076923076923	286	15889	9	28	277	15861	16175	0.08195099525898104
R1	cpdb	0	network_modules	21	TRUE	2.500474593165192e-5	16	29	4	0.13793103448275862	0.25	REAC:R-HSA-110312	REAC	Translesion synthesis by REV1	10916	2576		0.6818181818181818	0.6865671641791045	16	10900	4	25	12	10875	10916	0.18410152929061982
R1	cpdb	0	network_modules	21	TRUE	3.2638582928881145e-5	17	29	4	0.13793103448275862	0.23529411764705882	REAC:R-HSA-5656121	REAC	Translesion synthesis by POLI	10916	2574		0.696969696969697	0.7014925373134329	17	10899	4	25	13	10874	10916	0.17849300916146416
R1	cpdb	0	network_modules	21	TRUE	4.184024060896499e-5	140	37	7	0.1891891891891892	0.05	GO:0071897	GO:BP	DNA biosynthetic process	16175	16970		0.703125	0.7076923076923077	140	16035	7	30	133	16005	16175	0.09332123042539303
R1	cpdb	0	network_modules	21	TRUE	4.404583958166565e-5	155	29	7	0.2413793103448276	0.04516129032258064	KEGG:04218	KEGG	Cellular senescence	8484	295		0.75	0.8	155	8329	7	22	148	8307	8484	0.0975660856276781
R1	cpdb	0	network_modules	21	TRUE	5.0915201242884136e-5	48	29	5	0.1724137931034483	0.10416666666666667	REAC:R-HSA-73893	REAC	DNA Damage Bypass	10916	438		0.7121212121212122	0.7164179104477612	48	10868	5	24	43	10844	10916	0.13105847678844315
R1	cpdb	0	network_modules	21	TRUE	5.466276087980023e-5	437	37	10	0.2702702702702703	0.02288329519450801	GO:0080135	GO:BP	regulation of cellular response to stress	16175	17817		0.71875	0.7230769230769231	437	15738	10	27	427	15711	16175	0.07183953153940147
R1	cpdb	0	network_modules	21	TRUE	6.218916014132924e-5	86	37	6	0.16216216216216217	0.06976744186046512	GO:0010389	GO:BP	regulation of G2/M transition of mitotic cell cycle	16175	4098		0.734375	0.7384615384615385	86	16089	6	31	80	16058	16175	0.10327093179523482
R1	cpdb	0	network_modules	21	TRUE	6.946525441964049e-5	51	29	5	0.1724137931034483	0.09803921568627451	REAC:R-HSA-180786	REAC	Extension of Telomeres	10916	887		0.7272727272727273	0.7313432835820896	51	10865	5	24	46	10841	10916	0.1269549491958346
R1	cpdb	0	network_modules	21	TRUE	8.147635969219425e-5	21	29	4	0.13793103448275862	0.19047619047619047	REAC:R-HSA-5651801	REAC	PCNA-Dependent Long Patch Base Excision Repair	10916	1658		0.7424242424242424	0.746268656716418	21	10895	4	25	17	10870	10916	0.1601943588154428
R1	cpdb	0	network_modules	21	TRUE	1.0912377380903937e-4	47	37	5	0.13513513513513514	0.10638297872340426	GO:0044818	GO:BP	mitotic G2/M transition checkpoint	16175	11174		0.75	0.7538461538461538	47	16128	5	32	42	16096	16175	0.11762758772915846
R1	cpdb	0	network_modules	21	TRUE	1.3650827824288164e-4	98	37	6	0.16216216216216217	0.061224489795918366	GO:1902749	GO:BP	regulation of cell cycle G2/M phase transition	16175	22475		0.765625	0.7692307692307693	98	16077	6	31	92	16046	16175	0.09632016027679066
R1	cpdb	0	network_modules	21	TRUE	1.7095079467592476e-4	25	29	4	0.13793103448275862	0.16	REAC:R-HSA-110373	REAC	Resolution of AP sites via the multiple-nucleotide patch replacement pathway	10916	2073		0.7575757575757576	0.7611940298507462	25	10891	4	25	21	10866	10916	0.1464518736427528
R1	cpdb	0	network_modules	21	TRUE	2.0332161445090431e-4	63	29	5	0.1724137931034483	0.07936507936507936	REAC:R-HSA-6782210	REAC	Gap-filling DNA repair synthesis and ligation in TC-NER	10916	1038		0.7727272727272727	0.7761194029850746	63	10853	5	24	58	10829	10916	0.11353999632653038
R1	cpdb	0	network_modules	21	TRUE	3.3685942034549014e-4	114	37	6	0.16216216216216217	0.05263157894736842	GO:0000086	GO:BP	G2/M transition of mitotic cell cycle	16175	34		0.78125	0.7846153846153846	114	16061	6	31	108	16030	16175	0.08878370670828366
R1	cpdb	0	network_modules	21	TRUE	3.491658835646449e-4	59	37	5	0.13513513513513514	0.0847457627118644	GO:0010972	GO:BP	negative regulation of G2/M transition of mitotic cell cycle	16175	4548		0.796875	0.8	59	16116	5	32	54	16084	16175	0.10443600022433891
R1	cpdb	0	network_modules	21	TRUE	4.135501245144826e-4	61	37	5	0.13513513513513514	0.08196721311475409	GO:0035825	GO:BP	homologous recombination	16175	9273		0.8125	0.8307692307692308	61	16114	5	32	56	16082	16175	0.10261944857490177
R1	cpdb	0	network_modules	21	TRUE	4.135501245144826e-4	61	37	5	0.13513513513513514	0.08196721311475409	GO:1902750	GO:BP	negative regulation of cell cycle G2/M phase transition	16175	22476		0.8125	0.8307692307692308	61	16114	5	32	56	16082	16175	0.10261944857490177
R1	cpdb	0	network_modules	21	TRUE	5.570126977810112e-4	77	29	5	0.1724137931034483	0.06493506493506493	REAC:R-HSA-6781827	REAC	Transcription-Coupled Nucleotide Excision Repair (TC-NER)	10916	2541		0.7878787878787878	0.7910447761194029	77	10839	5	24	72	10815	10916	0.10197617456259611
R1	cpdb	0	network_modules	21	TRUE	6.180949515065011e-4	7	37	3	0.08108108108108109	0.42857142857142855	GO:0045003	GO:BP	double-strand break repair via synthesis-dependent strand annealing	16175	11221		0.84375	0.8461538461538461	7	16168	3	34	4	16134	16175	0.18566858204039244
R1	cpdb	0	network_modules	21	TRUE	6.694289608727712e-4	128	37	6	0.16216216216216217	0.046875	GO:0044839	GO:BP	cell cycle G2/M phase transition	16175	11188		0.859375	0.8769230769230769	128	16047	6	31	122	16016	16175	0.08335659016114183
R1	cpdb	0	network_modules	21	TRUE	6.694289608727712e-4	128	37	6	0.16216216216216217	0.046875	GO:2000779	GO:BP	regulation of double-strand break repair	16175	26035		0.859375	0.8769230769230769	128	16047	6	31	122	16016	16175	0.08335659016114183
R1	cpdb	0	network_modules	21	TRUE	6.965474873951103e-4	435	37	9	0.24324324324324326	0.020689655172413793	GO:0051052	GO:BP	regulation of DNA metabolic process	16175	13462		0.890625	0.8923076923076924	435	15740	9	28	426	15712	16175	0.06403685294919743
R1	cpdb	0	network_modules	21	TRUE	8.592175156268391e-4	84	29	5	0.1724137931034483	0.05952380952380952	REAC:R-HSA-5696399	REAC	Global Genome Nucleotide Excision Repair (GG-NER)	10916	1047		0.803030303030303	0.8059701492537313	84	10832	5	24	79	10808	10916	0.09728754940673602
R1	cpdb	0	network_modules	21	TRUE	0.0010823354514677558	88	29	5	0.1724137931034483	0.056818181818181816	REAC:R-HSA-73884	REAC	Base Excision Repair	10916	205		0.8181818181818182	0.8208955223880597	88	10828	5	24	83	10804	10916	0.09485682007824472
R1	cpdb	0	network_modules	21	TRUE	0.0012761921296067316	12	29	3	0.10344827586206896	0.25	REAC:R-HSA-3371511	REAC	HSF1 activation	10916	1109		0.8333333333333334	0.835820895522388	12	10904	3	26	9	10878	10916	0.15940735486820992
R1	cpdb	0	network_modules	21	TRUE	0.0013289667782807775	41	29	4	0.13793103448275862	0.0975609756097561	REAC:R-HSA-5696400	REAC	Dual Incision in GG-NER	10916	807		0.8484848484848485	0.8507462686567164	41	10875	4	25	37	10850	10916	0.11320711320080645
R1	cpdb	0	network_modules	21	TRUE	0.0021039819774438476	14	29	3	0.10344827586206896	0.21428571428571427	REAC:R-HSA-5358565	REAC	Mismatch repair (MMR) directed by MSH2:MSH6 (MutSalpha)	10916	1459		0.8636363636363636	0.8805970149253731	14	10902	3	26	11	10876	10916	0.14733185457919962
R1	cpdb	0	network_modules	21	TRUE	0.0021039819774438476	14	29	3	0.10344827586206896	0.21428571428571427	REAC:R-HSA-5358606	REAC	Mismatch repair (MMR) directed by MSH2:MSH3 (MutSbeta)	10916	1458		0.8636363636363636	0.8805970149253731	14	10902	3	26	11	10876	10916	0.14733185457919962
R1	cpdb	0	network_modules	21	TRUE	0.002625280473112849	15	29	3	0.10344827586206896	0.2	REAC:R-HSA-5358508	REAC	Mismatch Repair	10916	1457		0.8939393939393939	0.8955223880597015	15	10901	3	26	12	10875	10916	0.14221498861055198
R1	cpdb	0	network_modules	21	TRUE	0.0029023932672743295	39	37	4	0.10810810810810811	0.10256410256410256	GO:0036297	GO:BP	interstrand cross-link repair	16175	9548		0.90625	0.9076923076923077	39	16136	4	33	35	16103	16175	0.10319356773717044
R1	cpdb	0	network_modules	21	TRUE	0.0031054263415334618	109	29	5	0.1724137931034483	0.045871559633027525	REAC:R-HSA-5696398	REAC	Nucleotide Excision Repair	10916	1622		0.9090909090909091	0.9104477611940298	109	10807	5	24	104	10783	10916	0.08431497024566785
R1	cpdb	0	network_modules	21	TRUE	0.003394251696302424	111	29	5	0.1724137931034483	0.04504504504504504	REAC:R-HSA-157579	REAC	Telomere Maintenance	10916	2489		0.9242424242424242	0.9253731343283582	111	10805	5	24	106	10781	10916	0.08346540123337653
R1	cpdb	0	network_modules	21	TRUE	0.003854644282407897	12	37	3	0.08108108108108109	0.25	GO:0042276	GO:BP	error-prone translesion synthesis	16175	10073		0.921875	0.9230769230769231	12	16163	3	34	9	16129	16175	0.1412850353319482
R1	cpdb	0	network_modules	21	TRUE	0.004049636607243689	23	29	3	0.10344827586206896	0.13043478260869565	KEGG:03430	KEGG	Mismatch repair	8484	239		1	1	23	8461	3	26	20	8435	8484	0.11346406868637249
R1	cpdb	0	network_modules	21	TRUE	0.005003140153530381	13	37	3	0.08108108108108109	0.23076923076923078	GO:0006287	GO:BP	base-excision repair, gap-filling	16175	2100		0.9375	0.9384615384615385	13	16162	3	34	10	16128	16175	0.13564200894436634
R1	cpdb	0	network_modules	21	TRUE	0.005168758713804078	121	29	5	0.1724137931034483	0.04132231404958678	REAC:R-HSA-69239	REAC	Synthesis of DNA	10916	2376		0.9393939393939394	0.9402985074626866	121	10795	5	24	116	10771	10916	0.07952748396698277
R1	cpdb	0	network_modules	21	TRUE	0.00555115269947759	19	29	3	0.10344827586206896	0.15789473684210525	REAC:R-HSA-110320	REAC	Translesion Synthesis by POLH	10916	2573		0.9545454545454546	0.9552238805970149	19	10897	3	26	16	10871	10916	0.12593081709305207
R1	cpdb	0	network_modules	21	TRUE	0.007934474510536641	15	37	3	0.08108108108108109	0.2	GO:0031573	GO:BP	mitotic intra-S DNA damage checkpoint signaling	16175	7222		0.953125	1	15	16160	3	34	12	16126	16175	0.12608914305468685
R1	cpdb	0	network_modules	21	TRUE	0.007934474510536641	15	37	3	0.08108108108108109	0.2	GO:0001325	GO:BP	formation of extrachromosomal circular DNA	16175	311		0.953125	1	15	16160	3	34	12	16126	16175	0.12608914305468685
R1	cpdb	0	network_modules	21	TRUE	0.007934474510536641	15	37	3	0.08108108108108109	0.2	GO:0090656	GO:BP	t-circle formation	16175	18390		0.953125	1	15	16160	3	34	12	16126	16175	0.12608914305468685
R1	cpdb	0	network_modules	21	TRUE	0.007934474510536641	15	37	3	0.08108108108108109	0.2	GO:0090737	GO:BP	telomere maintenance via telomere trimming	16175	18437		0.953125	1	15	16160	3	34	12	16126	16175	0.12608914305468685
R1	cpdb	0	network_modules	21	TRUE	0.007993567205893486	64	29	4	0.13793103448275862	0.0625	REAC:R-HSA-6782135	REAC	Dual incision in TC-NER	10916	808		0.9696969696969697	0.9701492537313433	64	10852	4	25	60	10827	10916	0.0892814844357649
R1	cpdb	0	network_modules	21	TRUE	0.009590046573754575	67	29	4	0.13793103448275862	0.05970149253731343	REAC:R-HSA-3371453	REAC	Regulation of HSF1-mediated heat shock response	10916	1977		0.9848484848484849	0.9850746268656716	67	10849	4	25	63	10824	10916	0.0870902110527399
R1	cpdb	0	network_modules	21	TRUE	0.009767773926947491	138	29	5	0.1724137931034483	0.036231884057971016	REAC:R-HSA-73886	REAC	Chromosome Maintenance	10916	357		1	1	138	10778	5	24	133	10754	10916	0.07380740035148178
R1	cpdb	0	network_modules	22	TRUE	3.6529673783226115e-10	23	19	6	0.3157894736842105	0.2608695652173913	REAC:R-HSA-180024	REAC	DARPP-32 events	10916	434		0	0.02631578947368421	23	10893	6	13	17	10880	10916	0.285653426454036
R1	cpdb	0	network_modules	22	TRUE	2.2558450141595767e-9	12	19	5	0.2631578947368421	0.4166666666666667	REAC:R-HSA-442720	REAC	CREB1 phosphorylation through the activation of Adenylate Cyclase	10916	284		0.02702702702702703	0.05263157894736842	12	10904	5	14	7	10890	10916	0.33021873483878256
R1	cpdb	0	network_modules	22	TRUE	1.7531144690278846e-8	17	19	5	0.2631578947368421	0.29411764705882354	REAC:R-HSA-164378	REAC	PKA activation in glucagon signalling	10916	1687		0.05405405405405406	0.07894736842105263	17	10899	5	14	12	10885	10916	0.2770178243011048
R1	cpdb	0	network_modules	22	TRUE	1.8617356249629713e-8	42	19	6	0.3157894736842105	0.14285714285714285	REAC:R-HSA-381676	REAC	Glucagon-like Peptide-1 (GLP1) regulates insulin secretion	10916	1049		0.08108108108108109	0.10526315789473684	42	10874	6	13	36	10861	10916	0.21039783671249643
R1	cpdb	0	network_modules	22	TRUE	2.4247922682629654e-8	18	19	5	0.2631578947368421	0.2777777777777778	REAC:R-HSA-163615	REAC	PKA activation	10916	1686		0.10810810810810811	0.13157894736842105	18	10898	5	14	13	10884	10916	0.2691310070674166
R1	cpdb	0	network_modules	22	TRUE	4.378335092839243e-8	20	19	5	0.2631578947368421	0.25	REAC:R-HSA-111931	REAC	PKA-mediated phosphorylation of CREB	10916	1688		0.13513513513513514	0.15789473684210525	20	10896	5	14	15	10882	10916	0.25516462507024346
R1	cpdb	0	network_modules	22	TRUE	5.822122807697173e-8	169	19	8	0.42105263157894735	0.047337278106508875	REAC:R-HSA-983231	REAC	Factors involved in megakaryocyte development and platelet production	10916	931		0.16216216216216217	0.18421052631578946	169	10747	8	11	161	10736	10916	0.13717233223637917
R1	cpdb	0	network_modules	22	TRUE	1.4549112613660312e-7	8	19	4	0.21052631578947367	0.5	REAC:R-HSA-9010642	REAC	ROBO receptors bind AKAP5	10916	1908		0.1891891891891892	0.21052631578947367	8	10908	4	15	4	10893	10916	0.323713798413934
R1	cpdb	0	network_modules	22	TRUE	2.0104891962627296e-7	6	29	4	0.13793103448275862	0.6666666666666666	GO:2000480	GO:BP	negative regulation of cAMP-dependent protein kinase activity	16175	25792		0	0.25	6	16169	4	25	2	16144	16175	0.30275133374688556
R1	cpdb	0	network_modules	22	TRUE	6.609714550442041e-7	33	19	5	0.2631578947368421	0.15151515151515152	REAC:R-HSA-163359	REAC	Glucagon signaling in metabolic regulation	10916	1048		0.21621621621621623	0.23684210526315788	33	10883	5	14	28	10869	10916	0.19785819267942228
R1	cpdb	0	network_modules	22	TRUE	8.78542723669036e-7	78	19	6	0.3157894736842105	0.07692307692307693	REAC:R-HSA-422356	REAC	Regulation of insulin secretion	10916	2040		0.24324324324324326	0.2631578947368421	78	10838	6	13	72	10825	10916	0.1530110568725536
R1	cpdb	0	network_modules	22	TRUE	9.021523869338925e-7	35	19	5	0.2631578947368421	0.14285714285714285	REAC:R-HSA-111933	REAC	Calmodulin induced events	10916	301		0.2702702702702703	0.3157894736842105	35	10881	5	14	30	10867	10916	0.1920042784755707
R1	cpdb	0	network_modules	22	TRUE	9.021523869338925e-7	35	19	5	0.2631578947368421	0.14285714285714285	REAC:R-HSA-111997	REAC	CaM pathway	10916	297		0.2702702702702703	0.3157894736842105	35	10881	5	14	30	10867	10916	0.1920042784755707
R1	cpdb	0	network_modules	22	TRUE	1.2087649426523044e-6	37	19	5	0.2631578947368421	0.13513513513513514	REAC:R-HSA-111996	REAC	Ca-dependent events	10916	294		0.32432432432432434	0.34210526315789475	37	10879	5	14	32	10865	10916	0.1866284197861487
R1	cpdb	0	network_modules	22	TRUE	1.9653181950674434e-6	89	19	6	0.3157894736842105	0.06741573033707865	REAC:R-HSA-111885	REAC	Opioid Signalling	10916	1642		0.35135135135135137	0.3684210526315789	89	10827	6	13	83	10814	10916	0.14284839507215943
R1	cpdb	0	network_modules	22	TRUE	2.069231306055621e-6	41	19	5	0.2631578947368421	0.12195121951219512	REAC:R-HSA-1489509	REAC	DAG and IP3 signaling	10916	431		0.3783783783783784	0.39473684210526316	41	10875	5	14	36	10861	10916	0.17707347526295206
R1	cpdb	0	network_modules	22	TRUE	2.65222643839286e-6	43	19	5	0.2631578947368421	0.11627906976744186	REAC:R-HSA-9660821	REAC	ADORA2B mediated anti-inflammatory cytokines production	10916	11		0.40540540540540543	0.4473684210526316	43	10873	5	14	38	10859	10916	0.17280022229116218
R1	cpdb	0	network_modules	22	TRUE	2.65222643839286e-6	43	19	5	0.2631578947368421	0.11627906976744186	REAC:R-HSA-432040	REAC	Vasopressin regulates renal water homeostasis via Aquaporins	10916	2643		0.40540540540540543	0.4473684210526316	43	10873	5	14	38	10859	10916	0.17280022229116218
R1	cpdb	0	network_modules	22	TRUE	2.989050161247606e-6	44	19	5	0.2631578947368421	0.11363636363636363	REAC:R-HSA-9634597	REAC	GPER1 signaling	10916	1020		0.4594594594594595	0.47368421052631576	44	10872	5	14	39	10858	10916	0.17077278083940545
R1	cpdb	0	network_modules	22	TRUE	4.3957919143580125e-6	11	29	4	0.13793103448275862	0.36363636363636365	GO:2000479	GO:BP	regulation of cAMP-dependent protein kinase activity	16175	25791		0.3333333333333333	0.5	11	16164	4	25	7	16139	16175	0.22312872387251997
R1	cpdb	0	network_modules	22	TRUE	5.22031596979144e-6	49	19	5	0.2631578947368421	0.10204081632653061	REAC:R-HSA-112043	REAC	PLC beta mediated events	10916	1693		0.4864864864864865	0.5	49	10867	5	14	44	10853	10916	0.16157660618158193
R1	cpdb	0	network_modules	22	TRUE	6.000157720126446e-6	107	19	6	0.3157894736842105	0.056074766355140186	REAC:R-HSA-163685	REAC	Integration of energy metabolism	10916	1213		0.5135135135135135	0.5263157894736842	107	10809	6	13	101	10796	10916	0.1296897565094437
R1	cpdb	0	network_modules	22	TRUE	6.497570094130951e-6	35	29	5	0.1724137931034483	0.14285714285714285	GO:0010737	GO:BP	protein kinase A signaling	16175	4360		0.6666666666666666	0.75	35	16140	5	24	30	16116	16175	0.15527875685056344
R1	cpdb	0	network_modules	22	TRUE	7.0921064741337675e-6	52	19	5	0.2631578947368421	0.09615384615384616	REAC:R-HSA-445717	REAC	Aquaporin-mediated transport	10916	164		0.5405405405405406	0.5526315789473685	52	10864	5	14	47	10850	10916	0.15670149454068713
R1	cpdb	0	network_modules	22	TRUE	8.61144844086449e-6	54	19	5	0.2631578947368421	0.09259259259259259	REAC:R-HSA-112040	REAC	G-protein mediated events	10916	998		0.5675675675675675	0.5789473684210527	54	10862	5	14	49	10848	10916	0.15367734865900495
R1	cpdb	0	network_modules	22	TRUE	4.913311012742477e-5	76	19	5	0.2631578947368421	0.06578947368421052	REAC:R-HSA-438064	REAC	Post NMDA receptor activation events	10916	1772		0.5945945945945946	0.6052631578947368	76	10840	5	14	71	10826	10916	0.1286581034245885
R1	cpdb	0	network_modules	22	TRUE	5.733187058537342e-5	156	19	6	0.3157894736842105	0.038461538461538464	REAC:R-HSA-418555	REAC	G alpha (s) signalling events	10916	989		0.6216216216216216	0.631578947368421	156	10760	6	13	150	10747	10916	0.10607269629205303
R1	cpdb	0	network_modules	22	TRUE	1.0885775150012171e-4	89	19	5	0.2631578947368421	0.056179775280898875	REAC:R-HSA-442755	REAC	Activation of NMDA receptors and postsynaptic events	10916	89		0.6486486486486487	0.6578947368421053	89	10827	5	14	84	10813	10916	0.11840935298129364
R1	cpdb	0	network_modules	22	TRUE	1.3571525636294174e-4	93	19	5	0.2631578947368421	0.053763440860215055	REAC:R-HSA-9664323	REAC	FCGR3A-mediated IL10 synthesis	10916	898		0.6756756756756757	0.6842105263157895	93	10823	5	14	88	10809	10916	0.11568985014172772
R1	cpdb	0	network_modules	22	TRUE	1.7077259598273893e-4	137	15	5	0.3333333333333333	0.0364963503649635	KEGG:04910	KEGG	Insulin signaling pathway	8484	367		0	0.5	137	8347	5	10	132	8337	8484	0.10590531846888233
R1	cpdb	0	network_modules	22	TRUE	2.207814658246444e-4	196	19	6	0.3157894736842105	0.030612244897959183	REAC:R-HSA-112314	REAC	Neurotransmitter receptors and postsynaptic signal transmission	10916	1594		0.7027027027027027	0.7105263157894737	196	10720	6	13	190	10707	10916	0.09365607615625181
R1	cpdb	0	network_modules	22	TRUE	3.587459566341778e-4	113	19	5	0.2631578947368421	0.04424778761061947	REAC:R-HSA-5610787	REAC	Hedgehog 'off' state	10916	1112		0.7297297297297297	0.7368421052631579	113	10803	5	14	108	10789	10916	0.10429488780530728
R1	cpdb	0	network_modules	22	TRUE	7.745682541101659e-4	132	19	5	0.2631578947368421	0.03787878787878788	REAC:R-HSA-9662851	REAC	Anti-inflammatory response favouring Leishmania parasite infection	10916	150		0.7567567567567568	0.7894736842105263	132	10784	5	14	127	10770	10916	0.09591732919986172
R1	cpdb	0	network_modules	22	TRUE	7.745682541101659e-4	132	19	5	0.2631578947368421	0.03787878787878788	REAC:R-HSA-9664433	REAC	Leishmania parasite growth and survival	10916	1311		0.7567567567567568	0.7894736842105263	132	10784	5	14	127	10770	10916	0.09591732919986172
R1	cpdb	0	network_modules	22	TRUE	9.141325869814615e-4	2	19	2	0.10526315789473684	1	REAC:R-HSA-3359469	REAC	Defective MTR causes HMAG	10916	587		0.8108108108108109	0.8421052631578947	2	10914	2	17	0	10897	10916	0.32419006244733173
R1	cpdb	0	network_modules	22	TRUE	9.141325869814615e-4	2	19	2	0.10526315789473684	1	REAC:R-HSA-3359467	REAC	Defective MTRR causes HMAE	10916	588		0.8108108108108109	0.8421052631578947	2	10914	2	17	0	10897	10916	0.32419006244733173
R1	cpdb	0	network_modules	22	TRUE	0.001122334074880342	259	19	6	0.3157894736842105	0.023166023166023165	REAC:R-HSA-112315	REAC	Transmission across Chemical Synapses	10916	2580		0.8648648648648649	0.868421052631579	259	10657	6	13	253	10644	10916	0.08013011793902458
R1	cpdb	0	network_modules	22	TRUE	0.0014060746471670578	149	19	5	0.2631578947368421	0.03355704697986577	REAC:R-HSA-5358351	REAC	Signaling by Hedgehog	10916	2258		0.8918918918918919	0.8947368421052632	149	10767	5	14	144	10753	10916	0.089790666492685
R1	cpdb	0	network_modules	22	TRUE	0.0017277227879804102	105	15	4	0.26666666666666666	0.0380952380952381	KEGG:04928	KEGG	Parathyroid hormone synthesis, secretion and action	8484	385		1	1	105	8379	4	11	101	8368	8484	0.09679869285510245
R1	cpdb	0	network_modules	22	TRUE	0.0032784822466475527	312	19	6	0.3157894736842105	0.019230769230769232	REAC:R-HSA-418594	REAC	G alpha (i) signalling events	10916	987		0.918918918918919	0.9210526315789473	312	10604	6	13	306	10591	10916	0.07197316256759959
R1	cpdb	0	network_modules	22	TRUE	0.007943607957187633	19	29	3	0.10344827586206896	0.15789473684210525	GO:0010738	GO:BP	regulation of protein kinase A signaling	16175	4361		1	1	19	16156	3	26	16	16130	16175	0.12654084640823748
R1	cpdb	0	network_modules	22	TRUE	0.008364712557848777	215	19	5	0.2631578947368421	0.023255813953488372	REAC:R-HSA-9658195	REAC	Leishmania infection	10916	1310		0.9459459459459459	0.9736842105263158	215	10701	5	14	210	10687	10916	0.07316218859739172
R1	cpdb	0	network_modules	22	TRUE	0.008364712557848777	215	19	5	0.2631578947368421	0.023255813953488372	REAC:R-HSA-9824443	REAC	Parasitic Infection Pathways	10916	1717		0.9459459459459459	0.9736842105263158	215	10701	5	14	210	10687	10916	0.07316218859739172
R1	cpdb	0	network_modules	22	TRUE	0.009112879521845849	5	19	2	0.10526315789473684	0.4	REAC:R-HSA-163358	REAC	PKA-mediated phosphorylation of key metabolic factors	10916	1689		1	1	5	10911	2	17	3	10894	10916	0.2045276598933455
R1	cpdb	0	network_modules	23	TRUE	7.782382799961728e-38	116	28	23	0.8214285714285714	0.19827586206896552	KEGG:03082	KEGG	ATP-dependent chromatin remodeling	8484	219		0	0.3333333333333333	116	8368	23	5	93	8363	8484	0.4002556120639356
R1	cpdb	0	network_modules	23	TRUE	1.5571650487614324e-34	27	36	16	0.4444444444444444	0.5925925925925926	GO:2000819	GO:BP	regulation of nucleotide-excision repair	16175	26073		0	0.010309278350515464	27	16148	16	20	11	16128	16175	0.5122704046273692
R1	cpdb	0	network_modules	23	TRUE	2.610868757835407e-32	34	36	16	0.4444444444444444	0.47058823529411764	GO:0070316	GO:BP	regulation of G0 to G1 transition	16175	16055		0.010416666666666666	0.020618556701030927	34	16141	16	20	18	16121	16175	0.45615365191505347
R1	cpdb	0	network_modules	23	TRUE	8.636913407149067e-32	36	36	16	0.4444444444444444	0.4444444444444444	GO:0045023	GO:BP	G0 to G1 transition	16175	11235		0.020833333333333332	0.030927835051546393	36	16139	16	20	20	16119	16175	0.44320521029115106
R1	cpdb	0	network_modules	23	TRUE	7.495200360621112e-30	454	36	26	0.7222222222222222	0.05726872246696035	GO:0006338	GO:BP	chromatin remodeling	16175	2126		0.03125	0.041237113402061855	454	15721	26	10	428	15711	16175	0.1984929948542634
R1	cpdb	0	network_modules	23	TRUE	4.235228729441508e-28	529	36	26	0.7222222222222222	0.04914933837429111	GO:0006325	GO:BP	chromatin organization	16175	2122		0.041666666666666664	0.05154639175257732	529	15646	26	10	503	15636	16175	0.18309352226024206
R1	cpdb	0	network_modules	23	TRUE	5.72077930302187e-28	41	36	15	0.4166666666666667	0.36585365853658536	GO:0045663	GO:BP	positive regulation of myoblast differentiation	16175	11514		0.052083333333333336	0.061855670103092786	41	16134	15	21	26	16113	16175	0.38898508513475
R1	cpdb	0	network_modules	23	TRUE	1.1169015922453403e-27	79	36	17	0.4722222222222222	0.21518987341772153	GO:0006289	GO:BP	nucleotide-excision repair	16175	2102		0.0625	0.07216494845360824	79	16096	17	19	62	16077	16175	0.31660365852113925
R1	cpdb	0	network_modules	23	TRUE	5.5192197938439764e-27	86	36	17	0.4722222222222222	0.19767441860465115	GO:0030071	GO:BP	regulation of mitotic metaphase/anaphase transition	16175	6671		0.07291666666666667	0.08247422680412371	86	16089	17	19	69	16070	16175	0.3032301293821679
R1	cpdb	0	network_modules	23	TRUE	8.483095418035922e-27	88	36	17	0.4722222222222222	0.19318181818181818	GO:1902099	GO:BP	regulation of metaphase/anaphase transition of cell cycle	16175	22013		0.08333333333333333	0.09278350515463918	88	16087	17	19	71	16068	16175	0.2997037720712826
R1	cpdb	0	network_modules	23	TRUE	1.289919269919909e-26	90	36	17	0.4722222222222222	0.18888888888888888	GO:0007091	GO:BP	metaphase/anaphase transition of mitotic cell cycle	16175	2675		0.09375	0.10309278350515463	90	16085	17	19	73	16066	16175	0.2962949377052612
R1	cpdb	0	network_modules	23	TRUE	1.941465506782671e-26	92	36	17	0.4722222222222222	0.18478260869565216	GO:0044784	GO:BP	metaphase/anaphase transition of cell cycle	16175	11156		0.10416666666666667	0.1134020618556701	92	16083	17	19	75	16064	16175	0.2929972110863418
R1	cpdb	0	network_modules	23	TRUE	7.543289924974536e-26	99	36	17	0.4722222222222222	0.1717171717171717	GO:0033045	GO:BP	regulation of sister chromatid segregation	16175	8000		0.11458333333333333	0.12371134020618557	99	16076	17	19	82	16057	16175	0.2822482695300718
R1	cpdb	0	network_modules	23	TRUE	1.5289539211340203e-25	217	36	20	0.5555555555555556	0.09216589861751152	GO:0000819	GO:BP	sister chromatid segregation	16175	237		0.125	0.13402061855670103	217	15958	20	16	197	15942	16175	0.22256117999635847
R1	cpdb	0	network_modules	23	TRUE	3.5198359499198886e-25	59	36	15	0.4166666666666667	0.2542372881355932	GO:0045661	GO:BP	regulation of myoblast differentiation	16175	11512		0.13541666666666666	0.14432989690721648	59	16116	15	21	44	16095	16175	0.323573308944085
R1	cpdb	0	network_modules	23	TRUE	7.137050092515085e-25	84	36	16	0.4444444444444444	0.19047619047619047	GO:2000781	GO:BP	positive regulation of double-strand break repair	16175	26037		0.14583333333333334	0.15463917525773196	84	16091	16	20	68	16071	16175	0.28862840517050947
R1	cpdb	0	network_modules	23	TRUE	4.588254561491831e-24	124	36	17	0.4722222222222222	0.13709677419354838	GO:0051983	GO:BP	regulation of chromosome segregation	16175	14045		0.15625	0.16494845360824742	124	16051	17	19	107	16032	16175	0.2515553039665248
R1	cpdb	0	network_modules	23	TRUE	2.3277367030556815e-23	277	36	20	0.5555555555555556	0.07220216606498195	GO:0098813	GO:BP	nuclear chromosome segregation	16175	18900		0.16666666666666666	0.17525773195876287	277	15898	20	16	257	15882	16175	0.19600883168591673
R1	cpdb	0	network_modules	23	TRUE	4.161137020041866e-23	229	36	19	0.5277777777777778	0.08296943231441048	GO:0033044	GO:BP	regulation of chromosome organization	16175	7999		0.17708333333333334	0.18556701030927836	229	15946	19	17	210	15929	16175	0.20533152933550222
R1	cpdb	0	network_modules	23	TRUE	5.7061828851013e-23	80	36	15	0.4166666666666667	0.1875	GO:0045445	GO:BP	myoblast differentiation	16175	11378		0.1875	0.1958762886597938	80	16095	15	21	65	16074	16175	0.2771848652066694
R1	cpdb	0	network_modules	23	TRUE	8.318386061195635e-23	361	36	21	0.5833333333333334	0.05817174515235457	GO:0007059	GO:BP	chromosome segregation	16175	2658		0.19791666666666666	0.20618556701030927	361	15814	21	15	340	15799	16175	0.17937304807131255
R1	cpdb	0	network_modules	23	TRUE	8.678199024319332e-22	127	36	16	0.4444444444444444	0.12598425196850394	GO:0045739	GO:BP	positive regulation of DNA repair	16175	11579		0.20833333333333334	0.21649484536082475	127	16048	16	20	111	16028	16175	0.2336261764894858
R1	cpdb	0	network_modules	23	TRUE	9.906318270550193e-22	128	36	16	0.4444444444444444	0.125	GO:2000779	GO:BP	regulation of double-strand break repair	16175	26035		0.21875	0.2268041237113402	128	16047	16	20	112	16027	16175	0.23268608142580677
R1	cpdb	0	network_modules	23	TRUE	2.0683163962486433e-21	36	28	12	0.42857142857142855	0.3333333333333333	REAC:R-HSA-8939243	REAC	RUNX1 interacts with co-factors whose precise effect on RUNX1 targets is not known	10916	1916		0	0.125	36	10880	12	16	24	10864	10916	0.37615871445439175
R1	cpdb	0	network_modules	23	TRUE	5.036640471308948e-21	141	36	16	0.4444444444444444	0.11347517730496454	GO:2000045	GO:BP	regulation of G1/S transition of mitotic cell cycle	16175	25406		0.22916666666666666	0.23711340206185566	141	16034	16	20	125	16014	16175	0.2213815849364686
R1	cpdb	0	network_modules	23	TRUE	2.8316091342234244e-20	86	36	14	0.3888888888888889	0.16279069767441862	GO:0045582	GO:BP	positive regulation of T cell differentiation	16175	11433		0.23958333333333334	0.24742268041237114	86	16089	14	22	72	16067	16175	0.24910957564955266
R1	cpdb	0	network_modules	23	TRUE	7.644778302174554e-20	166	36	16	0.4444444444444444	0.0963855421686747	GO:1902806	GO:BP	regulation of cell cycle G1/S phase transition	16175	22525		0.25	0.25773195876288657	166	16009	16	20	150	15989	16175	0.20346634827702845
R1	cpdb	0	network_modules	23	TRUE	2.3319612466350037e-19	99	36	14	0.3888888888888889	0.1414141414141414	GO:0045621	GO:BP	positive regulation of lymphocyte differentiation	16175	11472		0.2604166666666667	0.26804123711340205	99	16076	14	22	85	16054	16175	0.2317856969779397
R1	cpdb	0	network_modules	23	TRUE	3.4733913182067333e-19	166	28	16	0.5714285714285714	0.0963855421686747	KEGG:05225	KEGG	Hepatocellular carcinoma	8484	476		0.5	0.6666666666666666	166	8318	16	12	150	8306	8484	0.22927908286715956
R1	cpdb	0	network_modules	23	TRUE	5.468304117686843e-19	187	36	16	0.4444444444444444	0.0855614973262032	GO:0000082	GO:BP	G1/S transition of mitotic cell cycle	16175	31		0.2708333333333333	0.27835051546391754	187	15988	16	20	171	15968	16175	0.19125389179529848
R1	cpdb	0	network_modules	23	TRUE	8.189854311753121e-19	246	36	17	0.4722222222222222	0.06910569105691057	GO:0051054	GO:BP	positive regulation of DNA metabolic process	16175	13464		0.28125	0.28865979381443296	246	15929	17	19	229	15910	16175	0.17636991757982595
R1	cpdb	0	network_modules	23	TRUE	1.3965248540880495e-18	798	36	23	0.6388888888888888	0.02882205513784461	GO:0006974	GO:BP	DNA damage response	16175	2601		0.2916666666666667	0.29896907216494845	798	15377	23	13	775	15364	16175	0.12857105104506486
R1	cpdb	0	network_modules	23	TRUE	2.8981465745263653e-18	207	36	16	0.4444444444444444	0.07729468599033816	GO:0006282	GO:BP	regulation of DNA repair	16175	2096		0.3020833333333333	0.30927835051546393	207	15968	16	20	191	15948	16175	0.18137416997195877
R1	cpdb	0	network_modules	23	TRUE	4.9922625971121415e-18	214	36	16	0.4444444444444444	0.07476635514018691	GO:0044843	GO:BP	cell cycle G1/S phase transition	16175	11189		0.3125	0.31958762886597936	214	15961	16	20	198	15941	16175	0.1782433343232763
R1	cpdb	0	network_modules	23	TRUE	6.3352967405249625e-18	41	36	11	0.3055555555555556	0.2682926829268293	GO:1902459	GO:BP	positive regulation of stem cell population maintenance	16175	22297		0.3229166666666667	0.32989690721649484	41	16134	11	25	30	16109	16175	0.28462083312367664
R1	cpdb	0	network_modules	23	TRUE	1.0274449710008035e-17	528	36	20	0.5555555555555556	0.03787878787878788	GO:0006281	GO:BP	DNA repair	16175	2095		0.3333333333333333	0.3402061855670103	528	15647	20	16	508	15631	16175	0.1389804850486614
R1	cpdb	0	network_modules	23	TRUE	1.0991986153645907e-17	286	36	17	0.4722222222222222	0.05944055944055944	GO:1901990	GO:BP	regulation of mitotic cell cycle phase transition	16175	21923		0.34375	0.35051546391752575	286	15889	17	19	269	15870	16175	0.16289157588435577
R1	cpdb	0	network_modules	23	TRUE	1.1520721208290234e-17	129	36	14	0.3888888888888889	0.10852713178294573	GO:0045580	GO:BP	regulation of T cell differentiation	16175	11431		0.3541666666666667	0.36082474226804123	129	16046	14	22	115	16024	16175	0.20225789344367895
R1	cpdb	0	network_modules	23	TRUE	1.926764196489585e-17	545	36	20	0.5555555555555556	0.03669724770642202	GO:0051276	GO:BP	chromosome organization	16175	13613		0.3645833333333333	0.3711340206185567	545	15630	20	16	525	15614	16175	0.13659500438036315
R1	cpdb	0	network_modules	23	TRUE	3.416013670316837e-17	139	36	14	0.3888888888888889	0.10071942446043165	GO:1903708	GO:BP	positive regulation of hemopoiesis	16175	23222		0.375	0.3917525773195876	139	16036	14	22	125	16014	16175	0.19459104704094599
R1	cpdb	0	network_modules	23	TRUE	3.416013670316837e-17	139	36	14	0.3888888888888889	0.10071942446043165	GO:1902107	GO:BP	positive regulation of leukocyte differentiation	16175	22021		0.375	0.3917525773195876	139	16036	14	22	125	16014	16175	0.19459104704094599
R1	cpdb	0	network_modules	23	TRUE	6.778223995906614e-17	78	28	12	0.42857142857142855	0.15384615384615385	REAC:R-HSA-3214858	REAC	RMTs methylate histone arginines	10916	1878		0.14285714285714285	0.25	78	10838	12	16	66	10822	10916	0.25372770459883093
R1	cpdb	0	network_modules	23	TRUE	1.2469038086490171e-16	152	36	14	0.3888888888888889	0.09210526315789473	GO:0045619	GO:BP	regulation of lymphocyte differentiation	16175	11470		0.3958333333333333	0.4020618556701031	152	16023	14	22	138	16001	16175	0.18576580209855692
R1	cpdb	0	network_modules	23	TRUE	1.7062558340374706e-16	206	36	15	0.4166666666666667	0.07281553398058252	GO:0030217	GO:BP	T cell differentiation	16175	6725		0.40625	0.41237113402061853	206	15969	15	21	191	15948	16175	0.17013430984006955
R1	cpdb	0	network_modules	23	TRUE	4.163365153729509e-16	437	36	18	0.5	0.041189931350114416	GO:0080135	GO:BP	regulation of cellular response to stress	16175	17817		0.4166666666666667	0.422680412371134	437	15738	18	18	419	15720	16175	0.13778034570338293
R1	cpdb	0	network_modules	23	TRUE	5.470182739337452e-16	59	36	11	0.3055555555555556	0.1864406779661017	GO:2000036	GO:BP	regulation of stem cell population maintenance	16175	25399		0.4270833333333333	0.4329896907216495	59	16116	11	25	48	16091	16175	0.23652505097974263
R1	cpdb	0	network_modules	23	TRUE	8.904069451686977e-16	370	36	17	0.4722222222222222	0.04594594594594595	GO:0044772	GO:BP	mitotic cell cycle phase transition	16175	11148		0.4375	0.44329896907216493	370	15805	17	19	353	15786	16175	0.1419519506602642
R1	cpdb	0	network_modules	23	TRUE	1.0098042624562752e-15	297	36	16	0.4444444444444444	0.05387205387205387	GO:0030098	GO:BP	lymphocyte differentiation	16175	6676		0.4479166666666667	0.4536082474226804	297	15878	16	20	281	15858	16175	0.14989083648930418
R1	cpdb	0	network_modules	23	TRUE	1.0658358156397168e-15	298	36	16	0.4444444444444444	0.053691275167785234	GO:0006302	GO:BP	double-strand break repair	16175	2109		0.4583333333333333	0.4639175257731959	298	15877	16	20	282	15857	16175	0.14962212979492903
R1	cpdb	0	network_modules	23	TRUE	1.1695648949036015e-15	376	36	17	0.4722222222222222	0.04521276595744681	GO:1901987	GO:BP	regulation of cell cycle phase transition	16175	21920		0.46875	0.4742268041237113	376	15799	17	19	359	15780	16175	0.14072526997156956
R1	cpdb	0	network_modules	23	TRUE	4.437242753999376e-15	195	36	14	0.3888888888888889	0.07179487179487179	GO:0050870	GO:BP	positive regulation of T cell activation	16175	13318		0.4791666666666667	0.4845360824742268	195	15980	14	22	181	15958	16175	0.16308001726577415
R1	cpdb	0	network_modules	23	TRUE	5.3329243896023075e-15	271	28	15	0.5357142857142857	0.055350553505535055	REAC:R-HSA-4839726	REAC	Chromatin organization	10916	356		0.2857142857142857	0.5	271	10645	15	13	256	10632	10916	0.16650872716490436
R1	cpdb	0	network_modules	23	TRUE	5.3329243896023075e-15	271	28	15	0.5357142857142857	0.055350553505535055	REAC:R-HSA-3247509	REAC	Chromatin modifying enzymes	10916	355		0.2857142857142857	0.5	271	10645	15	13	256	10632	10916	0.16650872716490436
R1	cpdb	0	network_modules	23	TRUE	1.0028965389285353e-14	427	36	17	0.4722222222222222	0.03981264637002342	GO:0007346	GO:BP	regulation of mitotic cell cycle	16175	2855		0.4895833333333333	0.4948453608247423	427	15748	17	19	410	15729	16175	0.13133893947487627
R1	cpdb	0	network_modules	23	TRUE	1.013577602982481e-14	630	36	19	0.5277777777777778	0.03015873015873016	GO:0010564	GO:BP	regulation of cell cycle process	16175	4217		0.5	0.5051546391752577	630	15545	19	17	611	15528	16175	0.11932964824063186
R1	cpdb	0	network_modules	23	TRUE	1.3707548001337435e-14	435	36	17	0.4722222222222222	0.03908045977011494	GO:0051052	GO:BP	regulation of DNA metabolic process	16175	13462		0.5104166666666666	0.5154639175257731	435	15740	17	19	418	15721	16175	0.13001428904059797
R1	cpdb	0	network_modules	23	TRUE	1.7755763286346036e-14	215	36	14	0.3888888888888889	0.06511627906976744	GO:1903039	GO:BP	positive regulation of leukocyte cell-cell adhesion	16175	22719		0.5208333333333334	0.5257731958762887	215	15960	14	22	201	15938	16175	0.15489714244730085
R1	cpdb	0	network_modules	23	TRUE	1.9160142366449878e-14	357	36	16	0.4444444444444444	0.04481792717086835	GO:1903131	GO:BP	mononuclear cell differentiation	16175	22787		0.53125	0.5360824742268041	357	15818	16	20	341	15798	16175	0.13578251248136156
R1	cpdb	0	network_modules	23	TRUE	2.1006438412763887e-14	283	36	15	0.4166666666666667	0.053003533568904596	GO:0010720	GO:BP	positive regulation of cell development	16175	4346		0.5416666666666666	0.5463917525773195	283	15892	15	21	268	15871	16175	0.14379149674045744
R1	cpdb	0	network_modules	23	TRUE	2.1508948175478342e-14	656	36	19	0.5277777777777778	0.028963414634146343	GO:1903047	GO:BP	mitotic cell cycle process	16175	22727		0.5520833333333334	0.5567010309278351	656	15519	19	17	637	15502	16175	0.11665403504069043
R1	cpdb	0	network_modules	23	TRUE	3.3421104778597624e-14	19	36	8	0.2222222222222222	0.42105263157894735	GO:0006337	GO:BP	nucleosome disassembly	16175	2125		0.5625	0.5670103092783505	19	16156	8	28	11	16128	16175	0.30478897344383216
R1	cpdb	0	network_modules	23	TRUE	4.073427703924448e-14	228	36	14	0.3888888888888889	0.06140350877192982	GO:1902105	GO:BP	regulation of leukocyte differentiation	16175	22019		0.5729166666666666	0.5773195876288659	228	15947	14	22	214	15925	16175	0.150155709753562
R1	cpdb	0	network_modules	23	TRUE	4.202352838172065e-14	465	36	17	0.4722222222222222	0.03655913978494624	GO:0044770	GO:BP	cell cycle phase transition	16175	11146		0.5833333333333334	0.5876288659793815	465	15710	17	19	448	15691	16175	0.12534614275852304
R1	cpdb	0	network_modules	23	TRUE	8.970294925843185e-14	21	36	8	0.2222222222222222	0.38095238095238093	GO:0032986	GO:BP	protein-DNA complex disassembly	16175	7966		0.59375	0.5979381443298969	21	16154	8	28	13	16126	16175	0.2897679094534021
R1	cpdb	0	network_modules	23	TRUE	1.4097007306700639e-13	249	36	14	0.3888888888888889	0.05622489959839357	GO:0051251	GO:BP	positive regulation of lymphocyte activation	16175	13598		0.6041666666666666	0.6082474226804123	249	15926	14	22	235	15904	16175	0.14328103677292406
R1	cpdb	0	network_modules	23	TRUE	2.0087564979826124e-13	414	36	16	0.4444444444444444	0.03864734299516908	GO:0061061	GO:BP	muscle structure development	16175	15177		0.6145833333333334	0.6185567010309279	414	15761	16	20	398	15741	16175	0.12526307292152408
R1	cpdb	0	network_modules	23	TRUE	2.198116726579991e-13	257	36	14	0.3888888888888889	0.054474708171206226	GO:0022409	GO:BP	positive regulation of cell-cell adhesion	16175	6600		0.625	0.6288659793814433	257	15918	14	22	243	15896	16175	0.1408819806900946
R1	cpdb	0	network_modules	23	TRUE	2.3273531995810693e-13	99	36	11	0.3055555555555556	0.1111111111111111	GO:0019827	GO:BP	stem cell population maintenance	16175	6046		0.6354166666666666	0.6391752577319587	99	16076	11	25	88	16051	16175	0.18132312442580756
R1	cpdb	0	network_modules	23	TRUE	2.6112807358499444e-13	100	36	11	0.3055555555555556	0.11	GO:0098727	GO:BP	maintenance of cell number	16175	18856		0.6458333333333334	0.6494845360824743	100	16075	11	25	89	16050	16175	0.1803825914552562
R1	cpdb	0	network_modules	23	TRUE	4.230104807691764e-13	434	36	16	0.4444444444444444	0.03686635944700461	GO:0002521	GO:BP	leukocyte differentiation	16175	1043		0.65625	0.6597938144329897	434	15741	16	20	418	15721	16175	0.12205908923882042
R1	cpdb	0	network_modules	23	TRUE	5.081848773317334e-13	106	36	11	0.3055555555555556	0.10377358490566038	GO:0034728	GO:BP	nucleosome organization	16175	8723		0.6666666666666666	0.6701030927835051	106	16069	11	25	95	16044	16175	0.1750186388572919
R1	cpdb	0	network_modules	23	TRUE	5.67536643890208e-13	275	36	14	0.3888888888888889	0.05090909090909091	GO:0002696	GO:BP	positive regulation of leukocyte activation	16175	1214		0.6770833333333334	0.6804123711340206	275	15900	14	22	261	15878	16175	0.13586378765003645
R1	cpdb	0	network_modules	23	TRUE	7.006383291410611e-13	792	36	19	0.5277777777777778	0.023989898989898988	GO:0000278	GO:BP	mitotic cell cycle	16175	76		0.6875	0.6907216494845361	792	15383	19	17	773	15366	16175	0.10479494822236005
R1	cpdb	0	network_modules	23	TRUE	8.901443957608639e-13	284	36	14	0.3888888888888889	0.04929577464788732	GO:0050863	GO:BP	regulation of T cell activation	16175	13311		0.6979166666666666	0.7010309278350515	284	15891	14	22	270	15869	16175	0.13353145132269184
R1	cpdb	0	network_modules	23	TRUE	1.030794819153655e-12	287	36	14	0.3888888888888889	0.04878048780487805	GO:1903037	GO:BP	regulation of leukocyte cell-cell adhesion	16175	22717		0.7083333333333334	0.711340206185567	287	15888	14	22	273	15866	16175	0.13277790583956198
R1	cpdb	0	network_modules	23	TRUE	1.1917571558095648e-12	290	36	14	0.3888888888888889	0.04827586206896552	GO:0050867	GO:BP	positive regulation of cell activation	16175	13315		0.71875	0.7216494845360825	290	15885	14	22	276	15863	16175	0.1320357957548955
R1	cpdb	0	network_modules	23	TRUE	1.3587553330028128e-12	234	28	13	0.4642857142857143	0.05555555555555555	REAC:R-HSA-8878171	REAC	Transcriptional regulation by RUNX1	10916	2552		0.5714285714285714	0.625	234	10682	13	15	221	10667	10916	0.15505658846716294
R1	cpdb	0	network_modules	23	TRUE	2.8842040772993215e-12	309	36	14	0.3888888888888889	0.045307443365695796	GO:1903706	GO:BP	regulation of hemopoiesis	16175	23220		0.7291666666666666	0.7319587628865979	309	15866	14	22	295	15844	16175	0.12758333400643826
R1	cpdb	0	network_modules	23	TRUE	4.4134565922292086e-12	615	36	17	0.4722222222222222	0.027642276422764227	GO:0045597	GO:BP	positive regulation of cell differentiation	16175	11448		0.7395833333333334	0.7422680412371134	615	15560	17	19	598	15541	16175	0.10722727711887947
R1	cpdb	0	network_modules	23	TRUE	4.544072033585458e-12	406	36	15	0.4166666666666667	0.03694581280788178	GO:0042110	GO:BP	T cell activation	16175	9970		0.75	0.7525773195876289	406	15769	15	21	391	15748	16175	0.11822173680382222
R1	cpdb	0	network_modules	23	TRUE	5.570806293688548e-12	324	36	14	0.3888888888888889	0.043209876543209874	GO:0007159	GO:BP	leukocyte cell-cell adhesion	16175	2723		0.7604166666666666	0.7628865979381443	324	15851	14	22	310	15829	16175	0.1243413478757662
R1	cpdb	0	network_modules	23	TRUE	5.611227560307903e-12	232	28	13	0.4642857142857143	0.05603448275862069	KEGG:04714	KEGG	Thermogenesis	8484	349		1	1	232	8252	13	15	219	8237	8484	0.1541684522711594
R1	cpdb	0	network_modules	23	TRUE	2.932459200784819e-11	569	36	16	0.4444444444444444	0.028119507908611598	GO:0046649	GO:BP	lymphocyte activation	16175	12286		0.7708333333333334	0.7731958762886598	569	15606	16	20	553	15586	16175	0.10492082702745108
R1	cpdb	0	network_modules	23	TRUE	3.3623905914779506e-11	369	36	14	0.3888888888888889	0.037940379403794036	GO:0051249	GO:BP	regulation of lymphocyte activation	16175	13596		0.78125	0.7835051546391752	369	15806	14	22	355	15784	16175	0.11579883836730602
R1	cpdb	0	network_modules	23	TRUE	3.9005828252757216e-11	373	36	14	0.3888888888888889	0.03753351206434316	GO:0045785	GO:BP	positive regulation of cell adhesion	16175	11617		0.7916666666666666	0.7938144329896907	373	15802	14	22	359	15780	16175	0.1151130211118186
R1	cpdb	0	network_modules	23	TRUE	6.24836646875709e-11	386	36	14	0.3888888888888889	0.03626943005181347	GO:0022407	GO:BP	regulation of cell-cell adhesion	16175	6598		0.8020833333333334	0.8041237113402062	386	15789	14	22	372	15767	16175	0.11295585737630673
R1	cpdb	0	network_modules	23	TRUE	1.7241341101606303e-10	638	36	16	0.4444444444444444	0.025078369905956112	GO:0030097	GO:BP	hemopoiesis	16175	6675		0.8125	0.8144329896907216	638	15537	16	20	622	15517	16175	0.09826961411890052
R1	cpdb	0	network_modules	23	TRUE	2.053411234189789e-10	421	36	14	0.3888888888888889	0.0332541567695962	GO:0002694	GO:BP	regulation of leukocyte activation	16175	1212		0.8229166666666666	0.8247422680412371	421	15754	14	22	407	15732	16175	0.10763688854496477
R1	cpdb	0	network_modules	23	TRUE	6.646902760526401e-10	571	36	15	0.4166666666666667	0.02626970227670753	GO:0060284	GO:BP	regulation of cell development	16175	14500		0.8333333333333334	0.8350515463917526	571	15604	15	21	556	15583	16175	0.09760281663506312
R1	cpdb	0	network_modules	23	TRUE	7.019531288098934e-10	699	36	16	0.4444444444444444	0.022889842632331903	GO:0045321	GO:BP	leukocyte activation	16175	11356		0.84375	0.845360824742268	699	15476	16	20	683	15456	16175	0.09319277687627595
R1	cpdb	0	network_modules	23	TRUE	8.577445676589439e-10	206	36	11	0.3055555555555556	0.05339805825242718	GO:0071824	GO:BP	protein-DNA complex organization	16175	16927		0.8541666666666666	0.8556701030927835	206	15969	11	25	195	15944	16175	0.12333469823229733
R1	cpdb	0	network_modules	23	TRUE	8.690546224217045e-10	468	36	14	0.3888888888888889	0.029914529914529916	GO:0050865	GO:BP	regulation of cell activation	16175	13313		0.8645833333333334	0.865979381443299	468	15707	14	22	454	15685	16175	0.1014229673752856
R1	cpdb	0	network_modules	23	TRUE	4.0040210497199156e-8	622	36	14	0.3888888888888889	0.022508038585209004	GO:0030155	GO:BP	regulation of cell adhesion	16175	6688		0.875	0.8762886597938144	622	15553	14	22	608	15531	16175	0.0860719785418269
R1	cpdb	0	network_modules	23	TRUE	4.364109159822544e-7	745	36	14	0.3888888888888889	0.01879194630872483	GO:0098609	GO:BP	cell-cell adhesion	16175	18805		0.8854166666666666	0.8865979381443299	745	15430	14	22	731	15408	16175	0.07724584817564935
R1	cpdb	0	network_modules	23	TRUE	1.0139381600193582e-6	209	36	9	0.25	0.0430622009569378	GO:0040029	GO:BP	epigenetic regulation of gene expression	16175	9916		0.8958333333333334	0.8969072164948454	209	15966	9	27	200	15939	16175	0.09914682018847815
R1	cpdb	0	network_modules	23	TRUE	3.2411749947761733e-5	215	36	8	0.2222222222222222	0.037209302325581395	GO:0032984	GO:BP	protein-containing complex disassembly	16175	7964		0.90625	0.9072164948453608	215	15960	8	28	207	15932	16175	0.08616335032755074
R1	cpdb	0	network_modules	23	TRUE	5.6519325639099065e-5	42	36	5	0.1388888888888889	0.11904761904761904	GO:0141137	GO:BP	positive regulation of gene expression, epigenetic	16175	20039		0.9166666666666666	0.9278350515463918	42	16133	5	31	37	16102	16175	0.12648711963610879
R1	cpdb	0	network_modules	23	TRUE	5.6519325639099065e-5	42	36	5	0.1388888888888889	0.11904761904761904	GO:0045815	GO:BP	transcription initiation-coupled chromatin remodeling	16175	11637		0.9166666666666666	0.9278350515463918	42	16133	5	31	37	16102	16175	0.12648711963610879
R1	cpdb	0	network_modules	23	TRUE	1.0471403536143149e-4	185	28	7	0.25	0.03783783783783784	REAC:R-HSA-212165	REAC	Epigenetic regulation of gene expression	10916	852		0.7142857142857143	0.75	185	10731	7	21	178	10710	10916	0.09156217592883804
R1	cpdb	0	network_modules	23	TRUE	1.2541887913299164e-4	791	36	12	0.3333333333333333	0.015170670037926675	GO:0000122	GO:BP	negative regulation of transcription by RNA polymerase II	16175	48		0.9375	0.9381443298969072	791	15384	12	24	779	15360	16175	0.06228892425603889
R1	cpdb	0	network_modules	23	TRUE	0.002055630592296625	105	28	5	0.17857142857142858	0.047619047619047616	REAC:R-HSA-427413	REAC	NoRC negatively regulates rRNA expression	10916	1602		0.8571428571428571	0.875	105	10811	5	23	100	10788	10916	0.08778202165849712
R1	cpdb	0	network_modules	23	TRUE	0.0022448544574892046	374	36	8	0.2222222222222222	0.0213903743315508	GO:0022411	GO:BP	cellular component disassembly	16175	6602		0.9479166666666666	0.9484536082474226	374	15801	8	28	366	15773	16175	0.06256776814523585
R1	cpdb	0	network_modules	23	TRUE	0.0023604932305418464	108	28	5	0.17857142857142858	0.046296296296296294	REAC:R-HSA-5250941	REAC	Negative epigenetic regulation of rRNA expression	10916	1566		1	1	108	10808	5	23	103	10785	10916	0.08642543965060188
R1	cpdb	0	network_modules	23	TRUE	0.0035321477815915842	173	36	6	0.16666666666666666	0.03468208092485549	GO:0006352	GO:BP	DNA-templated transcription initiation	16175	2129		0.9583333333333334	0.9587628865979382	173	16002	6	30	167	15972	16175	0.07161290898288886
R1	cpdb	0	network_modules	23	TRUE	0.00543888204860753	46	36	4	0.1111111111111111	0.08695652173913043	GO:0006356	GO:BP	regulation of transcription by RNA polymerase I	16175	2133		0.96875	0.9690721649484536	46	16129	4	32	42	16097	16175	0.09602218018051943
R1	cpdb	0	network_modules	23	TRUE	0.008303875390306035	2	36	2	0.05555555555555555	1	GO:1902340	GO:BP	negative regulation of chromosome condensation	16175	22218		0.9791666666666666	1	2	16173	2	34	0	16139	16175	0.23545437524377763
R1	cpdb	0	network_modules	23	TRUE	0.008303875390306035	2	36	2	0.05555555555555555	1	GO:1903379	GO:BP	regulation of mitotic chromosome condensation	16175	22958		0.9791666666666666	1	2	16173	2	34	0	16139	16175	0.23545437524377763
R1	cpdb	0	network_modules	23	TRUE	0.008303875390306035	2	36	2	0.05555555555555555	1	GO:1905213	GO:BP	negative regulation of mitotic chromosome condensation	16175	24448		0.9791666666666666	1	2	16173	2	34	0	16139	16175	0.23545437524377763
R1	cpdb	0	network_modules	24	TRUE	2.633460541679434e-4	791	32	11	0.34375	0.01390644753476612	GO:0000122	GO:BP	negative regulation of transcription by RNA polymerase II	16175	48		NA	1	791	15384	11	21	780	15363	16175	0.0608697530340432
R1	cpdb	0	network_modules	24	TRUE	9.336757639411136e-4	18	18	3	0.16666666666666666	0.16666666666666666	REAC:R-HSA-3232118	REAC	SUMOylation of transcription factors	10916	2178		0	0.2	18	10898	3	15	15	10883	10916	0.16529026732733831
R1	cpdb	0	network_modules	24	TRUE	0.0018292415666832894	168	18	5	0.2777777777777778	0.02976190476190476	REAC:R-HSA-5693532	REAC	DNA Double-Strand Break Repair	10916	443		0.25	0.4	168	10748	5	13	163	10735	10916	0.0866265644536414
R1	cpdb	0	network_modules	24	TRUE	0.0023756679785927656	3	18	2	0.1111111111111111	0.6666666666666666	REAC:R-HSA-9793242	REAC	SUMOylation of nuclear envelope proteins	10916	2176		0.5	0.6	3	10913	2	16	1	10897	10916	0.27175380533553956
R1	cpdb	0	network_modules	24	TRUE	0.0030199574480850484	329	18	6	0.3333333333333333	0.0182370820668693	REAC:R-HSA-73894	REAC	DNA Repair	10916	444		0.75	0.8	329	10587	6	12	323	10575	10916	0.07207135732391656
R1	cpdb	0	network_modules	24	TRUE	0.004133774218085741	29	18	3	0.16666666666666666	0.10344827586206896	REAC:R-HSA-2173795	REAC	Downregulation of SMAD2/3:SMAD4 transcriptional activity	10916	787		1	1	29	10887	3	15	26	10872	10916	0.1294922085460787
R1	cpdb	0	network_modules	25	TRUE	7.78007971082969e-11	182	19	10	0.5263157894736842	0.054945054945054944	KEGG:04621	KEGG	NOD-like receptor signaling pathway	8484	326		0	0.5	182	8302	10	9	172	8293	8484	0.1650862940760568
R1	cpdb	0	network_modules	25	TRUE	1.7320519161450034e-8	5	22	4	0.18181818181818182	0.8	GO:0140639	GO:BP	positive regulation of pyroptotic inflammatory response	16175	19843		0	0.020833333333333332	5	16170	4	18	1	16152	16175	0.38105471123905893
R1	cpdb	0	network_modules	25	TRUE	5.191528593692807e-8	6	22	4	0.18181818181818182	0.6666666666666666	GO:0051715	GO:BP	cytolysis in another organism	16175	13908		0.02127659574468085	0.041666666666666664	6	16169	4	18	2	16151	16175	0.3477460388241569
R1	cpdb	0	network_modules	25	TRUE	2.418400339960156e-7	8	22	4	0.18181818181818182	0.5	GO:0019835	GO:BP	cytolysis	16175	6047		0.0425531914893617	0.0625	8	16167	4	18	4	16149	16175	0.30097029428723465
R1	cpdb	0	network_modules	25	TRUE	2.257364632483355e-6	416	22	9	0.4090909090909091	0.021634615384615384	GO:0002757	GO:BP	immune response-activating signaling pathway	16175	1268		0.06382978723404255	0.08333333333333333	416	15759	9	13	407	15746	16175	0.08937965327567295
R1	cpdb	0	network_modules	25	TRUE	3.4768457693616613e-6	437	22	9	0.4090909090909091	0.020594965675057208	GO:0002764	GO:BP	immune response-regulating signaling pathway	16175	1275		0.0851063829787234	0.10416666666666667	437	15738	9	13	428	15725	16175	0.08696828866784663
R1	cpdb	0	network_modules	25	TRUE	7.207421586601776e-6	475	22	9	0.4090909090909091	0.018947368421052633	GO:0002253	GO:BP	activation of immune response	16175	785		0.10638297872340426	0.125	475	15700	9	13	466	15687	16175	0.0830044046617254
R1	cpdb	0	network_modules	25	TRUE	2.2489641981607927e-5	749	22	10	0.45454545454545453	0.01335113484646195	GO:0070647	GO:BP	protein modification by small protein conjugation or removal	16175	16231		0.1276595744680851	0.14583333333333334	749	15426	10	12	739	15414	16175	0.0716929426277256
R1	cpdb	0	network_modules	25	TRUE	2.9459287822291964e-5	5	22	3	0.13636363636363635	0.6	GO:0097039	GO:BP	protein linear polyubiquitination	16175	18456		0.14893617021276595	0.16666666666666666	5	16170	3	19	2	16151	16175	0.2856287946220628
R1	cpdb	0	network_modules	25	TRUE	3.099332240547711e-5	244	22	7	0.3181818181818182	0.028688524590163935	GO:0042742	GO:BP	defense response to bacterium	16175	10335		0.1702127659574468	0.1875	244	15931	7	15	237	15916	16175	0.0917685706707864
R1	cpdb	0	network_modules	25	TRUE	3.416497439818757e-5	25	20	4	0.2	0.16	REAC:R-HSA-5357786	REAC	TNFR1-induced proapoptotic signaling	10916	2448		0	0.1111111111111111	25	10891	4	16	21	10875	10916	0.17720225955383784
R1	cpdb	0	network_modules	25	TRUE	3.4664891353579595e-5	248	22	7	0.3181818181818182	0.028225806451612902	GO:0000209	GO:BP	protein polyubiquitination	16175	59		0.19148936170212766	0.20833333333333334	248	15927	7	15	241	15912	16175	0.09096264613066457
R1	cpdb	0	network_modules	25	TRUE	3.654806405905453e-5	246	19	7	0.3684210526315789	0.028455284552845527	KEGG:05131	KEGG	Shigellosis	8484	428		1	1	246	8238	7	12	239	8226	8484	0.0958362335088876
R1	cpdb	0	network_modules	25	TRUE	4.1102177786986956e-5	798	22	10	0.45454545454545453	0.012531328320802004	GO:0043687	GO:BP	post-translational protein modification	16175	10838		0.2127659574468085	0.22916666666666666	798	15377	10	12	788	15365	16175	0.06905132232698345
R1	cpdb	0	network_modules	25	TRUE	4.727045705496034e-5	590	22	9	0.4090909090909091	0.015254237288135594	GO:0016567	GO:BP	protein ubiquitination	16175	5254		0.23404255319148937	0.25	590	15585	9	13	581	15572	16175	0.07335163549136033
R1	cpdb	0	network_modules	25	TRUE	5.46751795198848e-5	265	22	7	0.3181818181818182	0.026415094339622643	GO:0002429	GO:BP	immune response-activating cell surface receptor signaling pathway	16175	952		0.2553191489361702	0.2708333333333333	265	15910	7	15	258	15895	16175	0.08773807439024246
R1	cpdb	0	network_modules	25	TRUE	6.998043181360216e-5	158	22	6	0.2727272727272727	0.0379746835443038	GO:0050851	GO:BP	antigen receptor-mediated signaling pathway	16175	13299		0.2765957446808511	0.2916666666666667	158	16017	6	16	152	16001	16175	0.09867295318597577
R1	cpdb	0	network_modules	25	TRUE	7.652570930033521e-5	153	20	6	0.3	0.0392156862745098	REAC:R-HSA-73887	REAC	Death Receptor Signaling	10916	455		0.125	0.2222222222222222	153	10763	6	14	147	10749	10916	0.10422553696791319
R1	cpdb	0	network_modules	25	TRUE	7.974424138096761e-5	280	22	7	0.3181818181818182	0.025	GO:0007249	GO:BP	canonical NF-kappaB signal transduction	16175	2783		0.2978723404255319	0.3125	280	15895	7	15	273	15880	16175	0.08513346357032216
R1	cpdb	0	network_modules	25	TRUE	7.978591725126531e-5	627	22	9	0.4090909090909091	0.014354066985645933	GO:0050778	GO:BP	positive regulation of immune response	16175	13252		0.3191489361702128	0.3333333333333333	627	15548	9	13	618	15535	16175	0.07080172281066009
R1	cpdb	0	network_modules	25	TRUE	9.442251785417886e-5	287	22	7	0.3181818181818182	0.024390243902439025	GO:0002768	GO:BP	immune response-regulating cell surface receptor signaling pathway	16175	1279		0.3404255319148936	0.3541666666666667	287	15888	7	15	280	15873	16175	0.08398638546835129
R1	cpdb	0	network_modules	25	TRUE	1.0948272502263089e-4	33	20	4	0.2	0.12121212121212122	REAC:R-HSA-5357956	REAC	TNFR1-induced NF-kappa-B signaling pathway	10916	2447		0.25	0.3333333333333333	33	10883	4	16	29	10867	10916	0.15371952136857625
R1	cpdb	0	network_modules	25	TRUE	1.1801071881658704e-4	85	22	5	0.22727272727272727	0.058823529411764705	GO:0071346	GO:BP	cellular response to type II interferon	16175	16598		0.3617021276595745	0.375	85	16090	5	17	80	16073	16175	0.11332589446261629
R1	cpdb	0	network_modules	25	TRUE	1.3557559803782713e-4	667	22	9	0.4090909090909091	0.013493253373313344	GO:0032446	GO:BP	protein modification by small protein conjugation	16175	7568		0.3829787234042553	0.3958333333333333	667	15508	9	13	658	15495	16175	0.06827539387423957
R1	cpdb	0	network_modules	25	TRUE	1.3825822138798587e-4	33	22	4	0.18181818181818182	0.12121212121212122	GO:0070269	GO:BP	pyroptotic inflammatory response	16175	16029		0.40425531914893614	0.4166666666666667	33	16142	4	18	29	16124	16175	0.14703811538028944
R1	cpdb	0	network_modules	25	TRUE	1.645363116300115e-4	8	22	3	0.13636363636363635	0.375	GO:1902523	GO:BP	positive regulation of protein K63-linked ubiquitination	16175	22332		0.425531914893617	0.4375	8	16167	3	19	5	16148	16175	0.2255224840135997
R1	cpdb	0	network_modules	25	TRUE	1.7100629940773943e-4	91	20	5	0.25	0.054945054945054944	REAC:R-HSA-877300	REAC	Interferon gamma signaling	10916	1229		0.375	0.4444444444444444	91	10825	5	15	86	10810	10916	0.11387321782098521
R1	cpdb	0	network_modules	25	TRUE	2.2268692050783067e-4	192	22	6	0.2727272727272727	0.03125	GO:0043123	GO:BP	positive regulation of canonical NF-kappaB signal transduction	16175	10542		0.44680851063829785	0.4583333333333333	192	15983	6	16	186	15967	16175	0.0888898013169761
R1	cpdb	0	network_modules	25	TRUE	3.75146040389958e-4	107	22	5	0.22727272727272727	0.04672897196261682	GO:0034341	GO:BP	response to type II interferon	16175	8579		0.46808510638297873	0.4791666666666667	107	16068	5	17	102	16051	16175	0.1004558157243818
R1	cpdb	0	network_modules	25	TRUE	3.940566479187258e-4	756	22	9	0.4090909090909091	0.011904761904761904	GO:0050776	GO:BP	regulation of immune response	16175	13250		0.48936170212765956	0.5	756	15419	9	13	747	15406	16175	0.06335353190105888
R1	cpdb	0	network_modules	25	TRUE	4.2998901919858573e-4	46	20	4	0.2	0.08695652173913043	REAC:R-HSA-5357905	REAC	Regulation of TNFR1 signaling	10916	2011		0.5	0.5555555555555556	46	10870	4	16	42	10854	10916	0.12948901526663226
R1	cpdb	0	network_modules	25	TRUE	5.148675415694598e-4	114	22	5	0.22727272727272727	0.043859649122807015	GO:0050852	GO:BP	T cell receptor signaling pathway	16175	13300		0.5106382978723404	0.5208333333333334	114	16061	5	17	109	16044	16175	0.09715307879583054
R1	cpdb	0	network_modules	25	TRUE	7.827323433297902e-4	124	22	5	0.22727272727272727	0.04032258064516129	GO:0051092	GO:BP	positive regulation of NF-kappaB transcription factor activity	16175	13487		0.5319148936170213	0.5416666666666666	124	16051	5	17	119	16034	16175	0.09292070229959896
R1	cpdb	0	network_modules	25	TRUE	8.366150014992047e-4	13	22	3	0.13636363636363635	0.23076923076923078	GO:1900044	GO:BP	regulation of protein K63-linked ubiquitination	16175	20346		0.5531914893617021	0.5833333333333334	13	16162	3	19	10	16143	16175	0.17653919094160347
R1	cpdb	0	network_modules	25	TRUE	8.366150014992047e-4	13	22	3	0.13636363636363635	0.23076923076923078	GO:1902916	GO:BP	positive regulation of protein polyubiquitination	16175	22613		0.5531914893617021	0.5833333333333334	13	16162	3	19	10	16143	16175	0.17653919094160347
R1	cpdb	0	network_modules	25	TRUE	8.643730391134429e-4	594	22	8	0.36363636363636365	0.013468013468013467	GO:0006954	GO:BP	inflammatory response	16175	2585		0.5957446808510638	0.6041666666666666	594	15581	8	14	586	15567	16175	0.06414611690166307
R1	cpdb	0	network_modules	25	TRUE	8.892179811647424e-4	55	20	4	0.2	0.07272727272727272	REAC:R-HSA-75893	REAC	TNF signaling	10916	2446		0.625	0.6666666666666666	55	10861	4	16	51	10845	10916	0.117971645688509
R1	cpdb	0	network_modules	25	TRUE	0.0011021072915626587	252	22	6	0.2727272727272727	0.023809523809523808	GO:0043122	GO:BP	regulation of canonical NF-kappaB signal transduction	16175	10541		0.6170212765957447	0.625	252	15923	6	16	246	15907	16175	0.07663001605889876
R1	cpdb	0	network_modules	25	TRUE	0.0012700351506034955	625	22	8	0.36363636363636365	0.0128	GO:0034097	GO:BP	response to cytokine	16175	8408		0.6382978723404256	0.6666666666666666	625	15550	8	14	617	15536	16175	0.06223038599849566
R1	cpdb	0	network_modules	25	TRUE	0.0012700351506034955	625	22	8	0.36363636363636365	0.0128	GO:1901652	GO:BP	response to peptide	16175	21619		0.6382978723404256	0.6666666666666666	625	15550	8	14	617	15536	16175	0.06223038599849566
R1	cpdb	0	network_modules	25	TRUE	0.0016084130603633098	60	22	4	0.18181818181818182	0.06666666666666667	GO:0031640	GO:BP	killing of cells of another organism	16175	7250		0.6808510638297872	0.7083333333333334	60	16115	4	18	56	16097	16175	0.10812435201996963
R1	cpdb	0	network_modules	25	TRUE	0.0016084130603633098	60	22	4	0.18181818181818182	0.06666666666666667	GO:0141061	GO:BP	disruption of cell in another organism	16175	19997		0.6808510638297872	0.7083333333333334	60	16115	4	18	56	16097	16175	0.10812435201996963
R1	cpdb	0	network_modules	25	TRUE	0.0017791385190163605	443	22	7	0.3181818181818182	0.01580135440180587	GO:0009617	GO:BP	response to bacterium	16175	3543		0.723404255319149	0.7291666666666666	443	15732	7	15	436	15717	16175	0.0657537391141918
R1	cpdb	0	network_modules	25	TRUE	0.0018212412208955353	263	20	6	0.3	0.022813688212927757	REAC:R-HSA-913531	REAC	Interferon Signaling	10916	1227		0.75	0.7777777777777778	263	10653	6	14	257	10639	10916	0.07708923603044174
R1	cpdb	0	network_modules	25	TRUE	0.0019821535752296933	17	22	3	0.13636363636363635	0.17647058823529413	GO:0042832	GO:BP	defense response to protozoan	16175	10388		0.7446808510638298	0.7708333333333334	17	16158	3	19	14	16139	16175	0.15411649072490274
R1	cpdb	0	network_modules	25	TRUE	0.0019821535752296933	17	22	3	0.13636363636363635	0.17647058823529413	GO:0001562	GO:BP	response to protozoan	16175	351		0.7446808510638298	0.7708333333333334	17	16158	3	19	14	16139	16175	0.15411649072490274
R1	cpdb	0	network_modules	25	TRUE	0.0020882604306510684	64	22	4	0.18181818181818182	0.0625	GO:0070534	GO:BP	protein K63-linked ubiquitination	16175	16168		0.7872340425531915	0.7916666666666666	64	16111	4	18	60	16093	16175	0.10455857281213124
R1	cpdb	0	network_modules	25	TRUE	0.0023864290536104726	2	22	2	0.09090909090909091	1	GO:0140973	GO:BP	positive regulation of AIM2 inflammasome complex assembly	16175	19957		0.8085106382978723	0.8125	2	16173	2	20	0	16153	16175	0.30132485807762605
R1	cpdb	0	network_modules	25	TRUE	0.0028286756272065698	69	22	4	0.18181818181818182	0.057971014492753624	GO:0141060	GO:BP	disruption of anatomical structure in another organism	16175	19996		0.8297872340425532	0.8333333333333334	69	16106	4	18	65	16088	16175	0.10053957371608498
R1	cpdb	0	network_modules	25	TRUE	0.0029817951467792335	299	22	6	0.2727272727272727	0.020066889632107024	GO:0050727	GO:BP	regulation of inflammatory response	16175	13226		0.851063829787234	0.8541666666666666	299	15876	6	16	293	15860	16175	0.06965785787039201
R1	cpdb	0	network_modules	25	TRUE	0.003120096453756118	164	22	5	0.22727272727272727	0.03048780487804878	GO:0071356	GO:BP	cellular response to tumor necrosis factor	16175	16608		0.8723404255319149	0.875	164	16011	5	17	159	15994	16175	0.07998802261936486
R1	cpdb	0	network_modules	25	TRUE	0.003713354764544175	721	22	8	0.36363636363636365	0.011095700416088766	GO:0045087	GO:BP	innate immune response	16175	11270		0.8936170212765957	0.8958333333333334	721	15454	8	14	713	15440	16175	0.05705782550215912
R1	cpdb	0	network_modules	25	TRUE	0.004469255231860193	22	22	3	0.13636363636363635	0.13636363636363635	GO:1902914	GO:BP	regulation of protein polyubiquitination	16175	22611		0.9148936170212766	0.9166666666666666	22	16153	3	19	19	16134	16175	0.1351873842742412
R1	cpdb	0	network_modules	25	TRUE	0.004927070918364304	180	22	5	0.22727272727272727	0.027777777777777776	GO:0034612	GO:BP	response to tumor necrosis factor	16175	8690		0.9361702127659575	0.9375	180	15995	5	17	175	15978	16175	0.07604045951710106
R1	cpdb	0	network_modules	25	TRUE	0.005212682168448437	182	20	5	0.25	0.027472527472527472	REAC:R-HSA-2454202	REAC	Fc epsilon receptor (FCERI) signaling	10916	938		0.875	0.8888888888888888	182	10734	5	15	177	10719	10916	0.07807174851472233
R1	cpdb	0	network_modules	25	TRUE	0.0079305854122889	555	22	7	0.3181818181818182	0.012612612612612612	GO:0071345	GO:BP	cellular response to cytokine stimulus	16175	16597		0.9574468085106383	0.9583333333333334	555	15620	7	15	548	15605	16175	0.05755206684498438
R1	cpdb	0	network_modules	25	TRUE	0.008598391670140124	97	20	4	0.2	0.041237113402061855	REAC:R-HSA-5607764	REAC	CLEC7A (Dectin-1) signaling	10916	275		1	1	97	10819	4	16	93	10803	10916	0.08724849897510957
R1	cpdb	0	network_modules	25	TRUE	0.00975805893646308	94	22	4	0.18181818181818182	0.0425531914893617	GO:0031398	GO:BP	positive regulation of protein ubiquitination	16175	7154		0.9787234042553191	0.9791666666666666	94	16081	4	18	90	16063	16175	0.08545508103456813
R1	cpdb	0	network_modules	25	TRUE	0.00997996102021443	208	22	5	0.22727272727272727	0.02403846153846154	GO:0051091	GO:BP	positive regulation of DNA-binding transcription factor activity	16175	13486		1	1	208	15967	5	17	203	15950	16175	0.07023241122560837
R1	cpdb	0	network_modules	26	TRUE	0.005069597900828473	74	23	4	0.17391304347826086	0.05405405405405406	GO:0060337	GO:BP	type I interferon-mediated signaling pathway	16175	14549		0	0.3333333333333333	74	16101	4	19	70	16082	16175	0.09469071726424708
R1	cpdb	0	network_modules	26	TRUE	0.005350171214803818	75	23	4	0.17391304347826086	0.05333333333333334	GO:0071357	GO:BP	cellular response to type I interferon	16175	16609		0.5	0.6666666666666666	75	16100	4	19	71	16081	16175	0.094025907875107
R1	cpdb	0	network_modules	26	TRUE	0.007282214241927703	81	23	4	0.17391304347826086	0.04938271604938271	GO:0034340	GO:BP	response to type I interferon	16175	8578		1	1	81	16094	4	19	77	16075	16175	0.09029503353239145
R1	cpdb	0	network_modules	27	TRUE	2.4823711077204627e-31	244	36	25	0.6944444444444444	0.10245901639344263	REAC:R-HSA-8951664	REAC	Neddylation	10916	1559		0	0.041666666666666664	244	10672	25	11	219	10661	10916	0.2615237842143136
R1	cpdb	0	network_modules	27	TRUE	9.988983016352294e-20	11	40	9	0.225	0.8181818181818182	GO:0000338	GO:BP	protein deneddylation	16175	95		0	0.018867924528301886	11	16164	9	31	2	16133	16175	0.42843694438925584
R1	cpdb	0	network_modules	27	TRUE	1.7799139227973104e-19	38	36	12	0.3333333333333333	0.3157894736842105	REAC:R-HSA-5696394	REAC	DNA Damage Recognition in GG-NER	10916	439		0.043478260869565216	0.08333333333333333	38	10878	12	24	26	10854	10916	0.32214648376825816
R1	cpdb	0	network_modules	27	TRUE	2.8570251731527653e-19	749	40	24	0.6	0.03204272363150868	GO:0070647	GO:BP	protein modification by small protein conjugation or removal	16175	16231		0.019230769230769232	0.03773584905660377	749	15426	24	16	725	15410	16175	0.13118736932790706
R1	cpdb	0	network_modules	27	TRUE	1.2743364202066046e-18	798	40	24	0.6	0.03007518796992481	GO:0043687	GO:BP	post-translational protein modification	16175	10838		0.038461538461538464	0.05660377358490566	798	15377	24	16	774	15361	16175	0.12660175038814622
R1	cpdb	0	network_modules	27	TRUE	1.318577941555546e-17	52	36	12	0.3333333333333333	0.23076923076923078	REAC:R-HSA-6781823	REAC	Formation of TC-NER Pre-Incision Complex	10916	951		0.08695652173913043	0.125	52	10864	12	24	40	10840	10916	0.2744929970215461
R1	cpdb	0	network_modules	27	TRUE	1.3472067384856603e-17	329	36	19	0.5277777777777778	0.057750759878419454	REAC:R-HSA-73894	REAC	DNA Repair	10916	444		0.13043478260869565	0.16666666666666666	329	10587	19	17	310	10570	10916	0.167428707649463
R1	cpdb	0	network_modules	27	TRUE	6.778919664690395e-17	29	40	10	0.25	0.3448275862068966	GO:0045116	GO:BP	protein neddylation	16175	11286		0.057692307692307696	0.07547169811320754	29	16146	10	30	19	16116	16175	0.2921275689316509
R1	cpdb	0	network_modules	27	TRUE	3.003387231265052e-16	20	40	9	0.225	0.45	GO:2000434	GO:BP	regulation of protein neddylation	16175	25749		0.07692307692307693	0.09433962264150944	20	16155	9	31	11	16124	16175	0.31703748492774186
R1	cpdb	0	network_modules	27	TRUE	5.347991178625257e-16	667	40	21	0.525	0.031484257871064465	GO:0032446	GO:BP	protein modification by small protein conjugation	16175	7568		0.09615384615384616	0.11320754716981132	667	15508	21	19	646	15489	16175	0.12113847615680667
R1	cpdb	0	network_modules	27	TRUE	2.2311184215677074e-15	77	36	12	0.3333333333333333	0.15584415584415584	REAC:R-HSA-6781827	REAC	Transcription-Coupled Nucleotide Excision Repair (TC-NER)	10916	2541		0.17391304347826086	0.20833333333333334	77	10839	12	24	65	10815	10916	0.2242591148975169
R1	cpdb	0	network_modules	27	TRUE	6.762562306801958e-15	84	36	12	0.3333333333333333	0.14285714285714285	REAC:R-HSA-5696399	REAC	Global Genome Nucleotide Excision Repair (GG-NER)	10916	1047		0.21739130434782608	0.25	84	10832	12	24	72	10808	10916	0.2143589967056573
R1	cpdb	0	network_modules	27	TRUE	3.120935535857512e-14	109	40	12	0.3	0.11009174311926606	GO:0070646	GO:BP	protein modification by small protein removal	16175	16230		0.11538461538461539	0.1320754716981132	109	16066	12	28	97	16038	16175	0.17847495676604822
R1	cpdb	0	network_modules	27	TRUE	1.7819199295025328e-13	109	36	12	0.3333333333333333	0.11009174311926606	REAC:R-HSA-5696398	REAC	Nucleotide Excision Repair	10916	1622		0.2608695652173913	0.2916666666666667	109	10807	12	24	97	10783	10916	0.1870702262876043
R1	cpdb	0	network_modules	27	TRUE	2.311087858023994e-10	41	11	6	0.5454545454545454	0.14634146341463414	KEGG:03440	KEGG	Homologous recombination	8484	240		0	0.25	41	8443	6	5	35	8438	8484	0.28088705600968383
R1	cpdb	0	network_modules	27	TRUE	2.697806150576449e-10	104	36	10	0.2777777777777778	0.09615384615384616	REAC:R-HSA-8856825	REAC	Cargo recognition for clathrin-mediated endocytosis	10916	309		0.30434782608695654	0.3333333333333333	104	10812	10	26	94	10786	10916	0.1588441213545931
R1	cpdb	0	network_modules	27	TRUE	5.857758993748452e-9	36	36	7	0.19444444444444445	0.19444444444444445	REAC:R-HSA-5689901	REAC	Metalloprotease DUBs	10916	1444		0.34782608695652173	0.375	36	10880	7	29	29	10851	10916	0.19177900326797387
R1	cpdb	0	network_modules	27	TRUE	7.268405504770848e-9	144	36	10	0.2777777777777778	0.06944444444444445	REAC:R-HSA-8856828	REAC	Clathrin-mediated endocytosis	10916	372		0.391304347826087	0.4166666666666667	144	10772	10	26	134	10746	10916	0.13339452025069168
R1	cpdb	0	network_modules	27	TRUE	2.6412170941153164e-8	47	40	7	0.175	0.14893617021276595	GO:0044818	GO:BP	mitotic G2/M transition checkpoint	16175	11174		0.1346153846153846	0.1509433962264151	47	16128	7	33	40	16095	16175	0.1591904655111265
R1	cpdb	0	network_modules	27	TRUE	7.614364336386757e-8	206	40	10	0.25	0.04854368932038835	GO:1903320	GO:BP	regulation of protein modification by small protein conjugation or removal	16175	22904		0.15384615384615385	0.16981132075471697	206	15969	10	30	196	15939	16175	0.10535368252978075
R1	cpdb	0	network_modules	27	TRUE	8.782348987838982e-8	209	40	10	0.25	0.04784688995215311	GO:1901873	GO:BP	regulation of post-translational protein modification	16175	21817		0.17307692307692307	0.18867924528301888	209	15966	10	30	199	15936	16175	0.1045228784876799
R1	cpdb	0	network_modules	27	TRUE	1.4022642923985265e-7	59	40	7	0.175	0.11864406779661017	GO:0010972	GO:BP	negative regulation of G2/M transition of mitotic cell cycle	16175	4548		0.19230769230769232	0.20754716981132076	59	16116	7	33	52	16083	16175	0.14152245236602565
R1	cpdb	0	network_modules	27	TRUE	1.4812626259622682e-7	300	40	11	0.275	0.03666666666666667	GO:0009314	GO:BP	response to radiation	16175	3460		0.21153846153846154	0.22641509433962265	300	15875	11	29	289	15846	16175	0.09464111570027266
R1	cpdb	0	network_modules	27	TRUE	1.5098642554147336e-7	31	40	6	0.15	0.1935483870967742	GO:0007095	GO:BP	mitotic G2 DNA damage checkpoint signaling	16175	2678		0.23076923076923078	0.24528301886792453	31	16144	6	34	25	16110	16175	0.16858150950890494
R1	cpdb	0	network_modules	27	TRUE	1.7868436642321937e-7	61	40	7	0.175	0.11475409836065574	GO:1902750	GO:BP	negative regulation of cell cycle G2/M phase transition	16175	22476		0.25	0.2641509433962264	61	16114	7	33	54	16081	16175	0.1390912737749791
R1	cpdb	0	network_modules	27	TRUE	4.0323419704052234e-7	172	40	9	0.225	0.05232558139534884	GO:0042770	GO:BP	signal transduction in response to DNA damage	16175	10355		0.2692307692307692	0.2830188679245283	172	16003	9	31	163	15972	16175	0.10405941936937216
R1	cpdb	0	network_modules	27	TRUE	4.203009069047984e-7	114	40	8	0.2	0.07017543859649122	GO:0000077	GO:BP	DNA damage checkpoint signaling	16175	28		0.28846153846153844	0.3018867924528302	114	16061	8	32	106	16029	16175	0.11484195121539126
R1	cpdb	0	network_modules	27	TRUE	7.741150331173344e-7	123	40	8	0.2	0.06504065040650407	GO:0031570	GO:BP	DNA integrity checkpoint signaling	16175	7220		0.3076923076923077	0.32075471698113206	123	16052	8	32	115	16020	16175	0.11027268973248594
R1	cpdb	0	network_modules	27	TRUE	1.03389488586495e-6	465	40	12	0.3	0.025806451612903226	GO:0044770	GO:BP	cell cycle phase transition	16175	11146		0.3269230769230769	0.33962264150943394	465	15710	12	28	453	15682	16175	0.08082543884377696
R1	cpdb	0	network_modules	27	TRUE	1.3712909621107698e-6	370	40	11	0.275	0.02972972972972973	GO:0044772	GO:BP	mitotic cell cycle phase transition	16175	11148		0.34615384615384615	0.3584905660377358	370	15805	11	29	359	15776	16175	0.08396686372883752
R1	cpdb	0	network_modules	27	TRUE	2.10436968812298e-6	86	40	7	0.175	0.08139534883720931	GO:0010389	GO:BP	regulation of G2/M transition of mitotic cell cycle	16175	4098		0.36538461538461536	0.37735849056603776	86	16089	7	33	79	16056	16175	0.11617555990237745
R1	cpdb	0	network_modules	27	TRUE	4.395833333127568e-6	798	40	14	0.35	0.017543859649122806	GO:0006974	GO:BP	DNA damage response	16175	2601		0.38461538461538464	0.39622641509433965	798	15377	14	26	784	15351	16175	0.0691249536965479
R1	cpdb	0	network_modules	27	TRUE	5.302899023225241e-6	98	40	7	0.175	0.07142857142857142	GO:1902749	GO:BP	regulation of cell cycle G2/M phase transition	16175	22475		0.40384615384615385	0.41509433962264153	98	16077	7	33	91	16044	16175	0.10839518834269633
R1	cpdb	0	network_modules	27	TRUE	5.906648682476968e-6	673	40	13	0.325	0.019316493313521546	GO:0051603	GO:BP	proteolysis involved in protein catabolic process	16175	13820		0.4230769230769231	0.4339622641509434	673	15502	13	27	660	15475	16175	0.0706605280359459
R1	cpdb	0	network_modules	27	TRUE	6.48517171248016e-6	547	40	12	0.3	0.021937842778793418	GO:0006511	GO:BP	ubiquitin-dependent protein catabolic process	16175	2235		0.4423076923076923	0.4528301886792453	547	15628	12	28	535	15600	16175	0.07332021670948145
R1	cpdb	0	network_modules	27	TRUE	7.632211333241853e-6	555	40	12	0.3	0.021621621621621623	GO:0019941	GO:BP	modification-dependent protein catabolic process	16175	6072		0.46153846153846156	0.4716981132075472	555	15620	12	28	543	15592	16175	0.07267321774292176
R1	cpdb	0	network_modules	27	TRUE	8.271755846933127e-6	559	40	12	0.3	0.02146690518783542	GO:0043632	GO:BP	modification-dependent macromolecule catabolic process	16175	10812		0.4807692307692308	0.49056603773584906	559	15616	12	28	547	15588	16175	0.07235460449524146
R1	cpdb	0	network_modules	27	TRUE	1.3297948582079667e-5	176	40	8	0.2	0.045454545454545456	GO:0000075	GO:BP	cell cycle checkpoint signaling	16175	26		0.5	0.5094339622641509	176	15999	8	32	168	15967	16175	0.0907657989216888
R1	cpdb	0	network_modules	27	TRUE	1.5326267921329032e-5	114	40	7	0.175	0.06140350877192982	GO:0000086	GO:BP	G2/M transition of mitotic cell cycle	16175	34		0.5192307692307693	0.5283018867924528	114	16061	7	33	107	16028	16175	0.0999623568473285
R1	cpdb	0	network_modules	27	TRUE	2.5813606376181978e-5	68	36	6	0.16666666666666666	0.08823529411764706	REAC:R-HSA-5693571	REAC	Nonhomologous End-Joining (NHEJ)	10916	1605		0.43478260869565216	0.4583333333333333	68	10848	6	30	62	10818	10916	0.1172941417438348
R1	cpdb	0	network_modules	27	TRUE	2.8455370198509537e-5	140	11	5	0.45454545454545453	0.03571428571428571	KEGG:04120	KEGG	Ubiquitin mediated proteolysis	8484	270		0.3333333333333333	0.5	140	8344	5	6	135	8338	8484	0.12389243131415097
R1	cpdb	0	network_modules	27	TRUE	3.433599431473146e-5	128	40	7	0.175	0.0546875	GO:0044839	GO:BP	cell cycle G2/M phase transition	16175	11188		0.5384615384615384	0.5471698113207547	128	16047	7	33	121	16014	16175	0.0938921728161461
R1	cpdb	0	network_modules	27	TRUE	4.4745271967187086e-05	77	40	6	0.15	0.07792207792207792	GO:0044773	GO:BP	mitotic DNA damage checkpoint signaling	16175	11149		0.5576923076923077	0.5660377358490566	77	16098	6	34	71	16064	16175	0.10506145769447325
R1	cpdb	0	network_modules	27	TRUE	4.716726173341549e-5	134	40	7	0.175	0.05223880597014925	GO:0007093	GO:BP	mitotic cell cycle checkpoint signaling	16175	2676		0.5769230769230769	0.5849056603773585	134	16041	7	33	127	16008	16175	0.09157943265211979
R1	cpdb	0	network_modules	27	TRUE	4.895798670968498e-5	656	40	12	0.3	0.018292682926829267	GO:1903047	GO:BP	mitotic cell cycle process	16175	22727		0.5961538461538461	0.6037735849056604	656	15519	12	28	644	15491	16175	0.06548607361767737
R1	cpdb	0	network_modules	27	TRUE	5.4739167476441656e-5	77	36	6	0.16666666666666666	0.07792207792207792	REAC:R-HSA-5693565	REAC	Recruitment and ATM-mediated phosphorylation of repair and signaling proteins at DNA double strand breaks	10916	1949		0.4782608695652174	0.5	77	10839	6	30	71	10809	10916	0.10970541820957612
R1	cpdb	0	network_modules	27	TRUE	5.499466455849821e-5	528	40	11	0.275	0.020833333333333332	GO:0006281	GO:BP	DNA repair	16175	2095		0.6153846153846154	0.6226415094339622	528	15647	11	29	517	15618	16175	0.06790674655719758
R1	cpdb	0	network_modules	27	TRUE	5.916069933952921e-5	78	36	6	0.16666666666666666	0.07692307692307693	REAC:R-HSA-5693606	REAC	DNA Double Strand Break Response	10916	442		0.5217391304347826	0.5416666666666666	78	10838	6	30	72	10808	10916	0.1089423756728603
R1	cpdb	0	network_modules	27	TRUE	6.0807620542457414e-5	81	40	6	0.15	0.07407407407407407	GO:0044774	GO:BP	mitotic DNA integrity checkpoint signaling	16175	11150		0.6346153846153846	0.6415094339622641	81	16094	6	34	75	16060	16175	0.10227280032337308
R1	cpdb	0	network_modules	27	TRUE	8.707999454997376e-5	224	40	8	0.2	0.03571428571428571	GO:1901988	GO:BP	negative regulation of cell cycle phase transition	16175	21921		0.6538461538461539	0.660377358490566	224	15951	8	32	216	15919	16175	0.07931189007252158
R1	cpdb	0	network_modules	27	TRUE	1.0652598833711639e-4	437	40	10	0.25	0.02288329519450801	GO:0080135	GO:BP	regulation of cellular response to stress	16175	17817		0.6730769230769231	0.6792452830188679	437	15738	10	30	427	15708	16175	0.06847721077691574
R1	cpdb	0	network_modules	27	TRUE	1.1477537874424106e-4	90	40	6	0.15	0.06666666666666667	GO:0010212	GO:BP	response to ionizing radiation	16175	3993		0.6923076923076923	0.6981132075471698	90	16085	6	34	84	16051	16175	0.09667919772647575
R1	cpdb	0	network_modules	27	TRUE	1.5319366200502543e-4	159	40	7	0.175	0.0440251572327044	GO:1901991	GO:BP	negative regulation of mitotic cell cycle phase transition	16175	21924		0.7115384615384616	0.71698113207547165	159	16016	7	33	152	15983	16175	0.08335764131210233
R1	cpdb	0	network_modules	27	TRUE	1.6800983957065076e-4	19	40	4	0.1	0.21052631578947367	GO:2000001	GO:BP	regulation of DNA damage checkpoint	16175	25365		0.7307692307692307	0.7358490566037735	19	16156	4	36	15	16120	16175	0.1436529102270431
R1	cpdb	0	network_modules	27	TRUE	1.6986648702813157e-4	590	40	11	0.275	0.01864406779661017	GO:0016567	GO:BP	protein ubiquitination	16175	5254		0.75	0.7547169811320755	590	15585	11	29	579	15556	16175	0.06334938396393311
R1	cpdb	0	network_modules	27	TRUE	1.8057397513270286e-4	94	36	6	0.16666666666666666	0.06382978723404255	REAC:R-HSA-69473	REAC	G2/M DNA damage checkpoint	10916	1006		0.5652173913043478	0.5833333333333334	94	10822	6	30	88	10792	10916	0.09839932608268069
R1	cpdb	0	network_modules	27	TRUE	2.0996704608137657e-4	470	40	10	0.25	0.02127659574468085	GO:0010498	GO:BP	proteasomal protein catabolic process	16175	4177		0.7692307692307693	0.7735849056603774	470	15705	10	30	460	15675	16175	0.06549403986635499
R1	cpdb	0	network_modules	27	TRUE	2.1760319019928736e-4	97	36	6	0.16666666666666666	0.061855670103092786	REAC:R-HSA-5693607	REAC	Processing of DNA double-strand break ends	10916	1798		0.6086956521739131	0.625	97	10819	6	30	91	10789	10916	0.09671071230078135
R1	cpdb	0	network_modules	27	TRUE	2.6871191367953e-4	363	40	9	0.225	0.024793388429752067	GO:0043161	GO:BP	proteasome-mediated ubiquitin-dependent protein catabolic process	16175	10561		0.7884615384615384	0.7924528301886793	363	15812	9	31	354	15781	16175	0.06809142120612009
R1	cpdb	0	network_modules	27	TRUE	2.775144132991446e-4	23	36	4	0.1111111111111111	0.17391304347826086	REAC:R-HSA-9013422	REAC	RHOBTB1 GTPase cycle	10916	1862		0.6521739130434783	0.6666666666666666	23	10893	4	32	19	10861	10916	0.1367431380246217
R1	cpdb	0	network_modules	27	TRUE	2.904690870804517e-4	262	40	8	0.2	0.030534351145038167	GO:0010948	GO:BP	negative regulation of cell cycle process	16175	4526		0.8076923076923077	0.8113207547169812	262	15913	8	32	254	15881	16175	0.07249594960686978
R1	cpdb	0	network_modules	27	TRUE	3.617798730178488e-4	376	40	9	0.225	0.023936170212765957	GO:1901987	GO:BP	regulation of cell cycle phase transition	16175	21920		0.8269230769230769	0.8301886792452831	376	15799	9	31	367	15768	16175	0.0666659037503957
R1	cpdb	0	network_modules	27	TRUE	3.81489908367418e-4	792	40	12	0.3	0.015151515151515152	GO:0000278	GO:BP	mitotic cell cycle	16175	76		0.8461538461538461	0.8490566037735849	792	15383	12	28	780	15355	16175	0.05792178200895969
R1	cpdb	0	network_modules	27	TRUE	5.663323199747995e-4	286	40	8	0.2	0.027972027972027972	GO:1901990	GO:BP	regulation of mitotic cell cycle phase transition	16175	21923		0.8653846153846154	0.8679245283018868	286	15889	8	32	278	15857	16175	0.06887934114100039
R1	cpdb	0	network_modules	27	TRUE	7.796633559327058e-4	202	40	7	0.175	0.034653465346534656	GO:0045930	GO:BP	negative regulation of mitotic cell cycle	16175	11724		0.8846153846153846	0.8867924528301887	202	15973	7	33	195	15940	16175	0.07286269225507806
R1	cpdb	0	network_modules	27	TRUE	8.448698830599997e-4	30	36	4	0.1111111111111111	0.13333333333333333	REAC:R-HSA-110314	REAC	Recognition of DNA damage by PCNA-containing replication complex	10916	1948		0.6956521739130435	0.7083333333333334	30	10886	4	32	26	10854	10916	0.11906550621755053
R1	cpdb	0	network_modules	27	TRUE	9.192913149982706e-4	207	40	7	0.175	0.033816425120772944	GO:0006282	GO:BP	regulation of DNA repair	16175	2096		0.9038461538461539	0.9056603773584906	207	15968	7	33	200	15935	16175	0.07185166504450115
R1	cpdb	0	network_modules	27	TRUE	9.516466010613537e-4	701	40	11	0.275	0.015691868758915834	GO:0009628	GO:BP	response to abiotic stimulus	16175	3549		0.9230769230769231	0.9245283018867925	701	15474	11	29	690	15445	16175	0.05664784414078855
R1	cpdb	0	network_modules	27	TRUE	0.0013271187906477233	132	36	6	0.16666666666666666	0.045454545454545456	REAC:R-HSA-5693567	REAC	HDR through Homologous Recombination (HRR) or Single Strand Annealing (SSA)	10916	1098		0.7391304347826086	0.75	132	10784	6	30	126	10754	10916	0.08135060434390318
R1	cpdb	0	network_modules	27	TRUE	0.0014364264786830574	298	36	8	0.2222222222222222	0.026845637583892617	REAC:R-HSA-5688426	REAC	Deubiquitination	10916	736		0.782608695652174	0.7916666666666666	298	10618	8	28	290	10590	10916	0.06880715147902024
R1	cpdb	0	network_modules	27	TRUE	0.001595374167173331	35	36	4	0.1111111111111111	0.11428571428571428	REAC:R-HSA-9706574	REAC	RHOBTB GTPase Cycle	10916	1861		0.8260869565217391	0.8333333333333334	35	10881	4	32	31	10849	10916	0.10979250664138708
R1	cpdb	0	network_modules	27	TRUE	0.0017170176308898208	138	36	6	0.16666666666666666	0.043478260869565216	REAC:R-HSA-5693538	REAC	Homology Directed Repair	10916	1130		0.8695652173913043	0.875	138	10778	6	30	132	10748	10916	0.07930160789959574
R1	cpdb	0	network_modules	27	TRUE	0.0019950978035329172	338	40	8	0.2	0.023668639053254437	GO:0045786	GO:BP	negative regulation of cell cycle	16175	11618		0.9423076923076923	0.9433962264150944	338	15837	8	32	330	15805	16175	0.062344650908223685
R1	cpdb	0	network_modules	27	TRUE	0.0021866270669938085	148	40	6	0.15	0.04054054054054054	GO:0071478	GO:BP	cellular response to radiation	16175	16711		0.9615384615384616	0.9622641509433962	148	16027	6	34	142	15993	16175	0.07365291054972642
R1	cpdb	0	network_modules	27	TRUE	0.00327967094030669	61	11	3	0.2727272727272727	0.04918032786885246	KEGG:03420	KEGG	Nucleotide excision repair	8484	238		0.6666666666666666	0.75	61	8423	3	8	58	8415	8484	0.11324148713289527
R1	cpdb	0	network_modules	27	TRUE	0.004215364106626255	12	40	3	0.075	0.25	GO:0140627	GO:BP	ubiquitin-dependent protein catabolic process via the C-end degron rule pathway	16175	19838		0.9807692307692307	0.9811320754716981	12	16163	3	37	9	16126	16175	0.1357944772851887
R1	cpdb	0	network_modules	27	TRUE	0.004220953352920287	41	40	4	0.1	0.0975609756097561	GO:1901976	GO:BP	regulation of cell cycle checkpoint	16175	21911		1	1	41	16134	4	36	37	16098	16175	0.09651093680410203
R1	cpdb	0	network_modules	27	TRUE	0.005132826715891954	167	36	6	0.16666666666666666	0.03592814371257485	REAC:R-HSA-69481	REAC	G2/M Checkpoints	10916	1005		0.9130434782608695	0.9166666666666666	167	10749	6	30	161	10719	10916	0.0709401659158936
R1	cpdb	0	network_modules	27	TRUE	0.005310328065048289	168	36	6	0.16666666666666666	0.03571428571428571	REAC:R-HSA-5693532	REAC	DNA Double-Strand Break Repair	10916	443		0.9565217391304348	0.9583333333333334	168	10748	6	30	162	10718	10916	0.07068920224199575
R1	cpdb	0	network_modules	27	TRUE	0.005750578422983599	48	36	4	0.1111111111111111	0.08333333333333333	REAC:R-HSA-73893	REAC	DNA Damage Bypass	10916	438		1	1	48	10868	4	32	44	10836	10916	0.09277391244573845
R1	cpdb	0	network_modules	27	TRUE	0.006148944390659592	210	11	4	0.36363636363636365	0.01904761904761905	KEGG:05170	KEGG	Human immunodeficiency virus 1 infection	8484	451		1	1	210	8274	4	7	206	8267	8484	0.07858902759775921
R1	cpdb	0	network_modules	28	TRUE	5.8668842566725155e-6	26	15	4	0.26666666666666666	0.15384615384615385	KEGG:04950	KEGG	Maturity onset diabetes of the young	8484	395		NA	1	26	8458	4	11	22	8447	8484	0.20070515733287564
R1	cpdb	0	network_modules	28	TRUE	1.2185156868594003e-5	19	21	4	0.19047619047619047	0.21052631578947367	REAC:R-HSA-210745	REAC	Regulation of gene expression in beta cells	10916	2034		0	0.5	19	10897	4	17	15	10880	10916	0.19878479738665622
R1	cpdb	0	network_modules	28	TRUE	2.5220278333946456e-4	39	21	4	0.19047619047619047	0.10256410256410256	REAC:R-HSA-186712	REAC	Regulation of beta-cell development	10916	2022		1	1	39	10877	4	17	35	10860	10916	0.13752764767893022
R1	cpdb	0	network_modules	28	TRUE	0.0066811333727300375	21	26	3	0.11538461538461539	0.14285714285714285	GO:0035883	GO:BP	enteroendocrine cell differentiation	16175	9310		0	0.5	21	16154	3	23	18	16131	16175	0.12712823401015022
R1	cpdb	0	network_modules	28	TRUE	0.007727800711620386	22	26	3	0.11538461538461539	0.13636363636363635	GO:0007263	GO:BP	nitric oxide mediated signal transduction	16175	2791		1	1	22	16153	3	23	19	16130	16175	0.12414189032667687
R1	cpdb	0	network_modules	29	TRUE	6.1836375766133185e-30	28	24	14	0.5833333333333334	0.5	REAC:R-HSA-389957	REAC	Prefoldin mediated transfer of substrate  to CCT/TriC	10916	1788		0	0.07692307692307693	28	10888	14	10	14	10878	10916	0.5389707001691983
R1	cpdb	0	network_modules	29	TRUE	1.2567252882880657e-28	33	24	14	0.5833333333333334	0.42424242424242425	REAC:R-HSA-389958	REAC	Cooperation of Prefoldin and TriC/CCT  in actin and tubulin folding	10916	411		0.08333333333333333	0.15384615384615385	33	10883	14	10	19	10873	10916	0.4961857493699231
R1	cpdb	0	network_modules	29	TRUE	6.667823065375406e-22	10	24	9	0.375	0.9	REAC:R-HSA-390450	REAC	Folding of actin by CCT/TriC	10916	943		0.16666666666666666	0.23076923076923078	10	10906	9	15	1	10891	10916	0.5804323609924376
R1	cpdb	0	network_modules	29	TRUE	1.5597390181089288e-21	91	24	14	0.5833333333333334	0.15384615384615385	REAC:R-HSA-390466	REAC	Chaperonin-mediated protein folding	10916	345		0.25	0.3076923076923077	91	10825	14	10	77	10815	10916	0.29685626651974734
R1	cpdb	0	network_modules	29	TRUE	4.735374243902494e-21	98	24	14	0.5833333333333334	0.14285714285714285	REAC:R-HSA-391251	REAC	Protein folding	10916	1812		0.3333333333333333	0.38461538461538464	98	10818	14	10	84	10808	10916	0.28583126400439446
R1	cpdb	0	network_modules	29	TRUE	2.0151426024482277e-20	66	33	13	0.3939393939393939	0.19696969696969696	GO:0061077	GO:BP	chaperone-mediated protein folding	16175	15193		0	0.017543859649122806	66	16109	13	20	53	16089	16175	0.2765183261878086
R1	cpdb	0	network_modules	29	TRUE	8.137882671281611e-18	10	33	8	0.24242424242424243	0.8	GO:1904851	GO:BP	positive regulation of establishment of protein localization to telomere	16175	24163		0.017857142857142856	0.03508771929824561	10	16165	8	25	2	16140	16175	0.4398471822685656
R1	cpdb	0	network_modules	29	TRUE	2.979788514476185e-17	11	33	8	0.24242424242424243	0.7272727272727273	GO:0070203	GO:BP	regulation of establishment of protein localization to telomere	16175	15986		0.03571428571428571	0.08771929824561403	11	16164	8	25	3	16139	16175	0.4192835778313835
R1	cpdb	0	network_modules	29	TRUE	2.979788514476185e-17	11	33	8	0.24242424242424243	0.7272727272727273	GO:1904869	GO:BP	regulation of protein localization to Cajal body	16175	24177		0.03571428571428571	0.08771929824561403	11	16164	8	25	3	16139	16175	0.4192835778313835
R1	cpdb	0	network_modules	29	TRUE	2.979788514476185e-17	11	33	8	0.24242424242424243	0.7272727272727273	GO:1904871	GO:BP	positive regulation of protein localization to Cajal body	16175	24179		0.03571428571428571	0.08771929824561403	11	16164	8	25	3	16139	16175	0.4192835778313835
R1	cpdb	0	network_modules	29	TRUE	8.927076591552551e-17	12	33	8	0.24242424242424243	0.6666666666666666	GO:1903405	GO:BP	protein localization to nuclear body	16175	22981		0.08928571428571429	0.14035087719298245	12	16163	8	25	4	16138	16175	0.40134321533403366
R1	cpdb	0	network_modules	29	TRUE	8.927076591552551e-17	12	33	8	0.24242424242424243	0.6666666666666666	GO:0070202	GO:BP	regulation of establishment of protein localization to chromosome	16175	15985		0.08928571428571429	0.14035087719298245	12	16163	8	25	4	16138	16175	0.40134321533403366
R1	cpdb	0	network_modules	29	TRUE	8.927076591552551e-17	12	33	8	0.24242424242424243	0.6666666666666666	GO:1904867	GO:BP	protein localization to Cajal body	16175	24175		0.08928571428571429	0.14035087719298245	12	16163	8	25	4	16138	16175	0.40134321533403366
R1	cpdb	0	network_modules	29	TRUE	2.0424919475686036e-16	26	24	9	0.375	0.34615384615384615	REAC:R-HSA-389960	REAC	Formation of tubulin folding intermediates by CCT/TriC	10916	975		0.4166666666666667	0.46153846153846156	26	10890	9	15	17	10875	10916	0.3588217436494781
R1	cpdb	0	network_modules	29	TRUE	2.317849055992838e-16	13	33	8	0.24242424242424243	0.6153846153846154	GO:1904816	GO:BP	positive regulation of protein localization to chromosome, telomeric region	16175	24131		0.14285714285714285	0.15789473684210525	13	16162	8	25	5	16137	16175	0.3855113762903761
R1	cpdb	0	network_modules	29	TRUE	3.2365079355128623e-16	182	33	14	0.42424242424242425	0.07692307692307693	GO:0006457	GO:BP	protein folding	16175	2203		0.16071428571428573	0.17543859649122806	182	15993	14	19	168	15974	16175	0.17703615909509207
R1	cpdb	0	network_modules	29	TRUE	5.400879078782766e-16	14	33	8	0.24242424242424243	0.5714285714285714	GO:1990173	GO:BP	protein localization to nucleoplasm	16175	25107		0.17857142857142858	0.19298245614035087	14	16161	8	25	6	16136	16175	0.37140449454660357
R1	cpdb	0	network_modules	29	TRUE	1.1557400636574782e-15	15	33	8	0.24242424242424243	0.5333333333333333	GO:1904874	GO:BP	positive regulation of telomerase RNA localization to Cajal body	16175	24182		0.19642857142857142	0.22807017543859648	15	16160	8	25	7	16135	16175	0.35873009623353197
R1	cpdb	0	network_modules	29	TRUE	1.1557400636574782e-15	15	33	8	0.24242424242424243	0.5333333333333333	GO:1904814	GO:BP	regulation of protein localization to chromosome, telomeric region	16175	24129		0.19642857142857142	0.22807017543859648	15	16160	8	25	7	16135	16175	0.35873009623353197
R1	cpdb	0	network_modules	29	TRUE	4.354131065510205e-15	17	33	8	0.24242424242424243	0.47058823529411764	GO:0070200	GO:BP	establishment of protein localization to telomere	16175	15983		0.23214285714285715	0.24561403508771928	17	16158	8	25	9	16133	16175	0.33681656414404665
R1	cpdb	0	network_modules	29	TRUE	7.826659304639599e-15	18	33	8	0.24242424242424243	0.4444444444444444	GO:1904872	GO:BP	regulation of telomerase RNA localization to Cajal body	16175	24180		0.25	0.2631578947368421	18	16157	8	25	10	16132	16175	0.32725315121948806
R1	cpdb	0	network_modules	29	TRUE	1.0498486262911155e-14	38	24	9	0.375	0.23684210526315788	REAC:R-HSA-390471	REAC	Association of TriC/CCT with target proteins during biosynthesis	10916	182		0.5	0.6153846153846154	38	10878	9	15	29	10863	10916	0.2960941893336136
R1	cpdb	0	network_modules	29	TRUE	1.0498486262911155e-14	38	24	9	0.375	0.23684210526315788	REAC:R-HSA-6814122	REAC	Cooperation of PDCL (PhLP1) and TRiC/CCT in G-protein beta folding	10916	410		0.5	0.6153846153846154	38	10878	9	15	29	10863	10916	0.2960941893336136
R1	cpdb	0	network_modules	29	TRUE	1.3500185892976922e-14	19	33	8	0.24242424242424243	0.42105263157894735	GO:0090670	GO:BP	RNA localization to Cajal body	16175	18400		0.26785714285714285	0.3333333333333333	19	16156	8	25	11	16131	16175	0.31845307685099833
R1	cpdb	0	network_modules	29	TRUE	1.3500185892976922e-14	19	33	8	0.24242424242424243	0.42105263157894735	GO:0090671	GO:BP	telomerase RNA localization to Cajal body	16175	18401		0.26785714285714285	0.3333333333333333	19	16156	8	25	11	16131	16175	0.31845307685099833
R1	cpdb	0	network_modules	29	TRUE	1.3500185892976922e-14	19	33	8	0.24242424242424243	0.42105263157894735	GO:0090672	GO:BP	telomerase RNA localization	16175	18402		0.26785714285714285	0.3333333333333333	19	16156	8	25	11	16131	16175	0.31845307685099833
R1	cpdb	0	network_modules	29	TRUE	1.3500185892976922e-14	19	33	8	0.24242424242424243	0.42105263157894735	GO:0090685	GO:BP	RNA localization to nucleus	16175	18411		0.26785714285714285	0.3333333333333333	19	16156	8	25	11	16131	16175	0.31845307685099833
R1	cpdb	0	network_modules	29	TRUE	3.9219984365707405e-13	27	33	8	0.24242424242424243	0.2962962962962963	GO:0070199	GO:BP	establishment of protein localization to chromosome	16175	15982		0.3392857142857143	0.3508771929824561	27	16148	8	25	19	16123	16175	0.2666592481281647
R1	cpdb	0	network_modules	29	TRUE	1.3859744880706524e-12	31	33	8	0.24242424242424243	0.25806451612903225	GO:0070198	GO:BP	protein localization to chromosome, telomeric region	16175	15981		0.35714285714285715	0.3684210526315789	31	16144	8	25	23	16119	16175	0.24863665806590488
R1	cpdb	0	network_modules	29	TRUE	2.4326077779330617e-12	33	33	8	0.24242424242424243	0.24242424242424243	GO:0032212	GO:BP	positive regulation of telomere maintenance via telomerase	16175	7404		0.375	0.38596491228070173	33	16142	8	25	25	16117	16175	0.24087548762310254
R1	cpdb	0	network_modules	29	TRUE	5.279982925056581e-12	36	33	8	0.24242424242424243	0.2222222222222222	GO:1904358	GO:BP	positive regulation of telomere maintenance via telomere lengthening	16175	23745		0.39285714285714285	0.40350877192982454	36	16139	8	25	28	16114	16175	0.23046420001210902
R1	cpdb	0	network_modules	29	TRUE	1.2844474111897935e-10	52	33	8	0.24242424242424243	0.15384615384615385	GO:2000573	GO:BP	positive regulation of DNA biosynthetic process	16175	25874		0.4107142857142857	0.42105263157894735	52	16123	8	25	44	16098	16175	0.1910628445618151
R1	cpdb	0	network_modules	29	TRUE	1.7710011187283236e-10	54	33	8	0.24242424242424243	0.14814814814814814	GO:0032210	GO:BP	regulation of telomere maintenance via telomerase	16175	7402		0.42857142857142855	0.43859649122807015	54	16121	8	25	46	16096	16175	0.1874059709508992
R1	cpdb	0	network_modules	29	TRUE	2.744633889239009e-10	483	33	14	0.42424242424242425	0.028985507246376812	GO:0051604	GO:BP	protein maturation	16175	13821		0.44642857142857145	0.45614035087719296	483	15692	14	19	469	15673	16175	0.10476746551047829
R1	cpdb	0	network_modules	29	TRUE	6.510886011508872e-10	63	33	8	0.24242424242424243	0.12698412698412698	GO:1904356	GO:BP	regulation of telomere maintenance via telomere lengthening	16175	23743		0.4642857142857143	0.47368421052631576	63	16112	8	25	55	16087	16175	0.1731487649902346
R1	cpdb	0	network_modules	29	TRUE	1.394100477798443e-9	69	33	8	0.24242424242424243	0.11594202898550725	GO:0032206	GO:BP	positive regulation of telomere maintenance	16175	7398		0.48214285714285715	0.49122807017543857	69	16106	8	25	61	16081	16175	0.16522284616642352
R1	cpdb	0	network_modules	29	TRUE	1.7445215376681408e-9	23	24	6	0.25	0.2608695652173913	REAC:R-HSA-5620922	REAC	BBSome-mediated cargo-targeting to cilium	10916	199		0.6666666666666666	0.6923076923076923	23	10893	6	18	17	10875	10916	0.25377096255148307
R1	cpdb	0	network_modules	29	TRUE	1.7689708279352105e-9	71	33	8	0.24242424242424243	0.11267605633802817	GO:0006278	GO:BP	RNA-templated DNA biosynthetic process	16175	2093		0.5	0.5263157894736842	71	16104	8	25	63	16079	16175	0.16280468564794776
R1	cpdb	0	network_modules	29	TRUE	1.7689708279352105e-9	71	33	8	0.24242424242424243	0.11267605633802817	GO:0007004	GO:BP	telomere maintenance via telomerase	16175	2616		0.5	0.5263157894736842	71	16104	8	25	63	16079	16175	0.16280468564794776
R1	cpdb	0	network_modules	29	TRUE	3.4698447384262026e-9	77	33	8	0.24242424242424243	0.1038961038961039	GO:1900182	GO:BP	positive regulation of protein localization to nucleus	16175	20458		0.5357142857142857	0.543859649122807	77	16098	8	25	69	16073	16175	0.15611848138007942
R1	cpdb	0	network_modules	29	TRUE	7.119779260741981e-9	84	33	8	0.24242424242424243	0.09523809523809523	GO:0010833	GO:BP	telomere maintenance via telomere lengthening	16175	4443		0.5535714285714286	0.5614035087719298	84	16091	8	25	76	16066	16175	0.14923233889809093
R1	cpdb	0	network_modules	29	TRUE	7.848661889344447e-9	85	33	8	0.24242424242424243	0.09411764705882353	GO:2000278	GO:BP	regulation of DNA biosynthetic process	16175	25603		0.5714285714285714	0.5789473684210527	85	16090	8	25	77	16065	16175	0.14831785185136287
R1	cpdb	0	network_modules	29	TRUE	2.5208728286185388e-8	98	33	8	0.24242424242424243	0.08163265306122448	GO:2001252	GO:BP	positive regulation of chromosome organization	16175	26441		0.5892857142857143	0.5964912280701754	98	16077	8	25	90	16052	16175	0.13771814018402384
R1	cpdb	0	network_modules	29	TRUE	3.0576167670478775e-8	12	33	5	0.15151515151515152	0.4166666666666667	GO:1905907	GO:BP	negative regulation of amyloid fibril formation	16175	25005		0.6071428571428571	0.6140350877192983	12	16163	5	28	7	16135	16175	0.25037751253346946
R1	cpdb	0	network_modules	29	TRUE	4.092102140372585e-8	104	33	8	0.24242424242424243	0.07692307692307693	GO:0032204	GO:BP	regulation of telomere maintenance	16175	7396		0.625	0.631578947368421	104	16071	8	25	96	16046	16175	0.13350160054716353
R1	cpdb	0	network_modules	29	TRUE	6.455294471324378e-8	110	33	8	0.24242424242424243	0.07272727272727272	GO:1900180	GO:BP	regulation of protein localization to nucleus	16175	20456		0.6428571428571429	0.6491228070175439	110	16065	8	25	102	16040	16175	0.129629758507935
R1	cpdb	0	network_modules	29	TRUE	1.1399173076722665e-7	118	33	8	0.24242424242424243	0.06779661016949153	GO:0034502	GO:BP	protein localization to chromosome	16175	8668		0.6607142857142857	0.6666666666666666	118	16057	8	25	110	16032	16175	0.12492680689639984
R1	cpdb	0	network_modules	29	TRUE	1.6766086033344148e-7	16	33	5	0.15151515151515152	0.3125	GO:1905906	GO:BP	regulation of amyloid fibril formation	16175	25004		0.6785714285714286	0.6842105263157895	16	16159	5	28	11	16131	16175	0.21650443268254144
R1	cpdb	0	network_modules	29	TRUE	2.991219265803098e-7	51	24	6	0.25	0.11764705882352941	REAC:R-HSA-5620920	REAC	Cargo trafficking to the periciliary membrane	10916	310		0.75	0.7692307692307693	51	10865	6	18	45	10847	10916	0.1688738574838709
R1	cpdb	0	network_modules	29	TRUE	3.178329587850296e-7	205	33	9	0.2727272727272727	0.04390243902439024	GO:0050821	GO:BP	protein stabilization	16175	13283		0.6964285714285714	0.7017543859649122	205	15970	9	24	196	15946	16175	0.10511282884950558
R1	cpdb	0	network_modules	29	TRUE	4.513300193165709e-7	140	33	8	0.24242424242424243	0.05714285714285714	GO:0071897	GO:BP	DNA biosynthetic process	16175	16970		0.7142857142857143	0.7192982456140351	140	16035	8	25	132	16010	16175	0.11410661967330442
R1	cpdb	0	network_modules	29	TRUE	7.430043731012716e-7	149	33	8	0.24242424242424243	0.053691275167785234	GO:0006403	GO:BP	RNA localization	16175	2164		0.7321428571428571	0.7368421052631579	149	16026	8	25	141	16001	16175	0.11037448781921913
R1	cpdb	0	network_modules	29	TRUE	8.075727713874372e-7	435	33	11	0.3333333333333333	0.02528735632183908	GO:0051052	GO:BP	regulation of DNA metabolic process	16175	13462		0.75	0.7543859649122807	435	15740	11	22	424	15718	16175	0.08564874817094367
R1	cpdb	0	network_modules	29	TRUE	8.71193143972236e-7	152	33	8	0.24242424242424243	0.05263157894736842	GO:0000723	GO:BP	telomere maintenance	16175	202		0.7678571428571429	0.7719298245614035	152	16023	8	25	144	15998	16175	0.10920315032575313
R1	cpdb	0	network_modules	29	TRUE	3.6433953999833744e-6	182	33	8	0.24242424242424243	0.04395604395604396	GO:0032200	GO:BP	telomere organization	16175	7392		0.7857142857142857	0.7894736842105263	182	15993	8	25	174	15968	16175	0.09909636830841298
R1	cpdb	0	network_modules	29	TRUE	8.345304457901787e-6	297	33	9	0.2727272727272727	0.030303030303030304	GO:0031647	GO:BP	regulation of protein stability	16175	7257		0.8035714285714286	0.8070175438596491	297	15878	9	24	288	15854	16175	0.08566528181498856
R1	cpdb	0	network_modules	29	TRUE	2.2150949808900858e-5	229	33	8	0.24242424242424243	0.034934497816593885	GO:0033044	GO:BP	regulation of chromosome organization	16175	7999		0.8214285714285714	0.8245614035087719	229	15946	8	25	221	15921	16175	0.08736174920262792
R1	cpdb	0	network_modules	29	TRUE	2.7744630120011427e-5	41	33	5	0.15151515151515152	0.12195121951219512	GO:1990000	GO:BP	amyloid fibril formation	16175	25052		0.8392857142857143	0.8421052631578947	41	16134	5	28	36	16106	16175	0.13396418245720618
R1	cpdb	0	network_modules	29	TRUE	3.298498049174122e-5	241	33	8	0.24242424242424243	0.03319502074688797	GO:0034504	GO:BP	protein localization to nucleus	16175	8670		0.8571428571428571	0.8596491228070176	241	15934	8	25	233	15909	16175	0.08491418040747409
R1	cpdb	0	network_modules	29	TRUE	3.517618852451652e-5	243	33	8	0.24242424242424243	0.03292181069958848	GO:1904951	GO:BP	positive regulation of establishment of protein localization	16175	24241		0.875	0.8771929824561403	243	15932	8	25	235	15907	16175	0.08452336604925827
R1	cpdb	0	network_modules	29	TRUE	3.869851197580264e-5	246	33	8	0.24242424242424243	0.032520325203252036	GO:0051054	GO:BP	positive regulation of DNA metabolic process	16175	13464		0.8928571428571429	0.8947368421052632	246	15929	8	25	238	15904	16175	0.08394578583047471
R1	cpdb	0	network_modules	29	TRUE	1.1690150017111401e-4	5	33	3	0.09090909090909091	0.6	GO:0090666	GO:BP	scaRNA localization to Cajal body	16175	18396		0.9107142857142857	0.9122807017543859	5	16170	3	30	2	16140	16175	0.23302935797773947
R1	cpdb	0	network_modules	29	TRUE	1.656022429743992e-4	420	33	9	0.2727272727272727	0.02142857142857143	GO:0010638	GO:BP	positive regulation of organelle organization	16175	4284		0.9285714285714286	0.9298245614035088	420	15755	9	24	411	15731	16175	0.0701561496526353
R1	cpdb	0	network_modules	29	TRUE	9.424767337194138e-4	373	33	8	0.24242424242424243	0.021447721179624665	GO:0072594	GO:BP	establishment of protein localization to organelle	16175	17458		0.9464285714285714	0.9473684210526315	373	15802	8	25	365	15777	16175	0.06608112514554808
R1	cpdb	0	network_modules	29	TRUE	0.0010012658976065061	376	33	8	0.24242424242424243	0.02127659574468085	GO:1903829	GO:BP	positive regulation of protein localization	16175	23311		0.9642857142857143	0.9649122807017544	376	15799	8	25	368	15774	16175	0.06576757094407518
R1	cpdb	0	network_modules	29	TRUE	0.0011071278388045803	200	24	6	0.25	0.03	REAC:R-HSA-5617833	REAC	Cilium Assembly	10916	361		0.8333333333333334	0.8461538461538461	200	10716	6	18	194	10698	10916	0.08109037028750621
R1	cpdb	0	network_modules	29	TRUE	0.0015956938873041343	400	33	8	0.24242424242424243	0.02	GO:0070201	GO:BP	regulation of establishment of protein localization	16175	15984		0.9821428571428571	0.9824561403508771	400	15775	8	25	392	15750	16175	0.06338052131438278
R1	cpdb	0	network_modules	29	TRUE	0.004959319277248285	23	24	3	0.125	0.13043478260869565	REAC:R-HSA-9013418	REAC	RHOBTB2 GTPase cycle	10916	1863		0.9166666666666666	0.9230769230769231	23	10893	3	21	20	10872	10916	0.1258070015753195
R1	cpdb	0	network_modules	29	TRUE	0.008972899700155421	129	33	5	0.15151515151515152	0.03875968992248062	GO:1902904	GO:BP	negative regulation of supramolecular fiber organization	16175	22603		1	1	129	16046	5	28	124	16018	16175	0.07296539210899045
R1	cpdb	0	network_modules	29	TRUE	0.009627686215629112	292	24	6	0.25	0.02054794520547945	REAC:R-HSA-1852241	REAC	Organelle biogenesis and maintenance	10916	1646		1	1	292	10624	6	18	286	10606	10916	0.0649489114974987
R1	cpdb	0	network_modules	30	TRUE	7.85370502812833e-8	54	19	6	0.3157894736842105	0.1111111111111111	KEGG:03460	KEGG	Fanconi anemia pathway	8484	242		0	0.3333333333333333	54	8430	6	13	48	8417	8484	0.18433511828590587
R1	cpdb	0	network_modules	30	TRUE	1.0736563799221984e-7	528	24	11	0.4583333333333333	0.020833333333333332	GO:0006281	GO:BP	DNA repair	16175	2095		0	0.030303030303030304	528	15647	11	13	517	15634	16175	0.09234460339917719
R1	cpdb	0	network_modules	30	TRUE	2.0627586051792826e-7	281	24	9	0.375	0.03202846975088968	GO:0006310	GO:BP	DNA recombination	16175	2115		0.03125	0.06060606060606061	281	15894	9	15	272	15879	16175	0.10551430876555361
R1	cpdb	0	network_modules	30	TRUE	4.6815433622732615e-7	798	24	12	0.5	0.015037593984962405	GO:0006974	GO:BP	DNA damage response	16175	2601		0.0625	0.09090909090909091	798	15377	12	12	786	15365	16175	0.08021699700102168
R1	cpdb	0	network_modules	30	TRUE	1.1173791930030187e-6	31	22	5	0.22727272727272727	0.16129032258064516	REAC:R-HSA-445095	REAC	Interaction between L1 and Ankyrins	10916	1219		0	0.07692307692307693	31	10885	5	17	26	10868	10916	0.1895276425217482
R1	cpdb	0	network_modules	30	TRUE	1.322579970531721e-6	32	22	5	0.22727272727272727	0.15625	REAC:R-HSA-5576892	REAC	Phase 0 - rapid depolarisation	10916	1732		0.08333333333333333	0.15384615384615385	32	10884	5	17	27	10867	10916	0.18647519185624803
R1	cpdb	0	network_modules	30	TRUE	2.1596692006584825e-6	329	22	9	0.4090909090909091	0.02735562310030395	REAC:R-HSA-73894	REAC	DNA Repair	10916	444		0.16666666666666666	0.23076923076923078	329	10587	9	13	320	10574	10916	0.09960487499923107
R1	cpdb	0	network_modules	30	TRUE	2.193839660700946e-6	79	24	6	0.25	0.0759493670886076	GO:0006289	GO:BP	nucleotide-excision repair	16175	2102		0.09375	0.12121212121212122	79	16096	6	18	73	16078	16175	0.13553429239853798
R1	cpdb	0	network_modules	30	TRUE	3.74713068277752e-6	39	22	5	0.22727272727272727	0.1282051282051282	REAC:R-HSA-6783310	REAC	Fanconi Anemia Pathway	10916	932		0.25	0.3076923076923077	39	10877	5	17	34	10860	10916	0.16848462624797564
R1	cpdb	0	network_modules	30	TRUE	7.863001877529722e-6	15	24	4	0.16666666666666666	0.26666666666666666	GO:0000712	GO:BP	resolution of meiotic recombination intermediates	16175	192		0.125	0.15151515151515152	15	16160	4	20	11	16140	16175	0.20989854079427026
R1	cpdb	0	network_modules	30	TRUE	1.0749764966337207e-5	298	24	8	0.3333333333333333	0.026845637583892617	GO:0006302	GO:BP	double-strand break repair	16175	2109		0.15625	0.18181818181818182	298	15877	8	16	290	15861	16175	0.09027013227927062
R1	cpdb	0	network_modules	30	TRUE	1.0804164302210226e-5	61	19	5	0.2631578947368421	0.08196721311475409	KEGG:03420	KEGG	Nucleotide excision repair	8484	238		0.5	0.6666666666666666	61	8423	5	14	56	8409	8484	0.14353279759459717
R1	cpdb	0	network_modules	30	TRUE	1.792116726740919e-5	4	24	3	0.125	0.75	GO:0072429	GO:BP	response to intra-S DNA damage checkpoint signaling	16175	17397		0.1875	0.21212121212121213	4	16171	3	21	1	16150	16175	0.3058452484972161
R1	cpdb	0	network_modules	30	TRUE	1.971870193720315e-5	53	24	5	0.20833333333333334	0.09433962264150944	GO:0007131	GO:BP	reciprocal meiotic recombination	16175	2702		0.21875	0.2727272727272727	53	16122	5	19	48	16103	16175	0.1383173668521947
R1	cpdb	0	network_modules	30	TRUE	1.971870193720315e-5	53	24	5	0.20833333333333334	0.09433962264150944	GO:0140527	GO:BP	reciprocal homologous recombination	16175	19808		0.21875	0.2727272727272727	53	16122	5	19	48	16103	16175	0.1383173668521947
R1	cpdb	0	network_modules	30	TRUE	4.055932885691725e-5	61	24	5	0.20833333333333334	0.08196721311475409	GO:0035825	GO:BP	homologous recombination	16175	9273		0.28125	0.30303030303030304	61	16114	5	19	56	16095	16175	0.12864968833138613
R1	cpdb	0	network_modules	30	TRUE	5.9188814255005716e-5	132	22	6	0.2727272727272727	0.045454545454545456	REAC:R-HSA-5693567	REAC	HDR through Homologous Recombination (HRR) or Single Strand Annealing (SSA)	10916	1098		0.3333333333333333	0.38461538461538464	132	10784	6	16	126	10768	10916	0.10716103454692487
R1	cpdb	0	network_modules	30	TRUE	7.708612215228507e-5	138	22	6	0.2727272727272727	0.043478260869565216	REAC:R-HSA-5693538	REAC	Homology Directed Repair	10916	1130		0.4166666666666667	0.46153846153846156	138	10778	6	16	132	10762	10916	0.10461364184998727
R1	cpdb	0	network_modules	30	TRUE	1.065845624005219e-4	41	19	4	0.21052631578947367	0.0975609756097561	KEGG:03440	KEGG	Homologous recombination	8484	240		1	1	41	8443	4	15	37	8428	8484	0.14052209780234148
R1	cpdb	0	network_modules	30	TRUE	1.5635251887141397e-4	7	24	3	0.125	0.42857142857142855	GO:0072423	GO:BP	response to DNA damage checkpoint signaling	16175	17395		0.3125	0.3939393939393939	7	16168	3	21	4	16147	16175	0.23087496910088323
R1	cpdb	0	network_modules	30	TRUE	1.5635251887141397e-4	7	24	3	0.125	0.42857142857142855	GO:0072402	GO:BP	response to DNA integrity checkpoint signaling	16175	17391		0.3125	0.3939393939393939	7	16168	3	21	4	16147	16175	0.23087496910088323
R1	cpdb	0	network_modules	30	TRUE	1.5635251887141397e-4	7	24	3	0.125	0.42857142857142855	GO:0072396	GO:BP	response to cell cycle checkpoint signaling	16175	17388		0.3125	0.3939393939393939	7	16168	3	21	4	16147	16175	0.23087496910088323
R1	cpdb	0	network_modules	30	TRUE	2.3771551128922065e-4	172	24	6	0.25	0.03488372093023256	GO:0000724	GO:BP	double-strand break repair via homologous recombination	16175	203		0.40625	0.42424242424242425	172	16003	6	18	166	15985	16175	0.08995976105866788
R1	cpdb	0	network_modules	30	TRUE	2.4642217191063096e-4	168	22	6	0.2727272727272727	0.03571428571428571	REAC:R-HSA-5693532	REAC	DNA Double-Strand Break Repair	10916	443		0.5	0.5384615384615384	168	10748	6	16	162	10732	10916	0.09394311995033798
R1	cpdb	0	network_modules	30	TRUE	2.72379465976678e-4	176	24	6	0.25	0.03409090909090909	GO:0000725	GO:BP	recombinational repair	16175	204		0.4375	0.45454545454545453	176	15999	6	18	170	15981	16175	0.08885084326886196
R1	cpdb	0	network_modules	30	TRUE	3.9768795662299233e-4	41	22	4	0.18181818181818182	0.0975609756097561	REAC:R-HSA-9717207	REAC	Sensory perception of sweet, bitter, and umami (glutamate) taste	10916	2199		0.5833333333333334	0.6153846153846154	41	10875	4	18	37	10857	10916	0.13081164952847205
R1	cpdb	0	network_modules	30	TRUE	4.697701067125454e-4	99	24	5	0.20833333333333334	0.050505050505050504	GO:0007127	GO:BP	meiosis I	16175	2698		0.46875	0.48484848484848486	99	16076	5	19	94	16057	16175	0.09994295794365361
R1	cpdb	0	network_modules	30	TRUE	4.833526415628511e-4	43	22	4	0.18181818181818182	0.09302325581395349	REAC:R-HSA-5696395	REAC	Formation of Incision Complex in GG-NER	10916	948		0.6666666666666666	0.6923076923076923	43	10873	4	18	39	10855	10916	0.1276136009878627
R1	cpdb	0	network_modules	30	TRUE	6.927797419248009e-4	107	24	5	0.20833333333333334	0.04672897196261682	GO:0061982	GO:BP	meiosis I cell cycle process	16175	15766		0.5	0.5151515151515151	107	16068	5	19	102	16049	16175	0.09592293449922787
R1	cpdb	0	network_modules	30	TRUE	6.949082570239449e-4	47	22	4	0.18181818181818182	0.0851063829787234	REAC:R-HSA-9717189	REAC	Sensory perception of taste	10916	2200		0.75	0.7692307692307693	47	10869	4	18	43	10851	10916	0.12183346149379237
R1	cpdb	0	network_modules	30	TRUE	7.256967555315551e-4	108	24	5	0.20833333333333334	0.046296296296296294	GO:0001508	GO:BP	action potential	16175	323		0.53125	0.5454545454545454	108	16067	5	19	103	16048	16175	0.0954515217403917
R1	cpdb	0	network_modules	30	TRUE	9.780113106450366e-4	12	24	3	0.125	0.25	GO:0070914	GO:BP	UV-damage excision repair	16175	16369		0.5625	0.5757575757575758	12	16163	3	21	9	16142	16175	0.17592329514545899
R1	cpdb	0	network_modules	30	TRUE	0.0010709605741957553	119	22	5	0.22727272727272727	0.04201680672268908	REAC:R-HSA-373760	REAC	L1CAM interactions	10916	1294		0.8333333333333334	0.8461538461538461	119	10797	5	17	114	10780	10916	0.09363879176805931
R1	cpdb	0	network_modules	30	TRUE	0.0016545632180237056	130	22	5	0.22727272727272727	0.038461538461538464	REAC:R-HSA-5576891	REAC	Cardiac conduction	10916	306		0.9166666666666666	0.9230769230769231	130	10786	5	17	125	10769	10916	0.08921781978787512
R1	cpdb	0	network_modules	30	TRUE	0.0021882012491437996	251	24	6	0.25	0.02390438247011952	GO:0071214	GO:BP	cellular response to abiotic stimulus	16175	16476		0.59375	0.6363636363636364	251	15924	6	18	245	15906	16175	0.07313027122184383
R1	cpdb	0	network_modules	30	TRUE	0.0021882012491437996	251	24	6	0.25	0.02390438247011952	GO:0104004	GO:BP	cellular response to environmental stimulus	16175	19202		0.59375	0.6363636363636364	251	15924	6	18	245	15906	16175	0.07313027122184383
R1	cpdb	0	network_modules	30	TRUE	0.003022673841357643	144	24	5	0.20833333333333334	0.034722222222222224	GO:0140013	GO:BP	meiotic nuclear division	16175	19632		0.65625	0.6666666666666666	144	16031	5	19	139	16012	16175	0.08184283690197877
R1	cpdb	0	network_modules	30	TRUE	0.0032968362412703106	2	24	2	0.08333333333333333	1	GO:1905764	GO:BP	regulation of protection from non-homologous end joining at telomere	16175	24877		0.6875	0.7878787878787878	2	16173	2	22	0	16151	16175	0.28847872656338225
R1	cpdb	0	network_modules	30	TRUE	0.0032968362412703106	2	24	2	0.08333333333333333	1	GO:1901255	GO:BP	nucleotide-excision repair involved in interstrand cross-link repair	16175	21332		0.6875	0.7878787878787878	2	16173	2	22	0	16151	16175	0.28847872656338225
R1	cpdb	0	network_modules	30	TRUE	0.0032968362412703106	2	24	2	0.08333333333333333	1	GO:0061819	GO:BP	telomeric DNA-containing double minutes formation	16175	15678		0.6875	0.7878787878787878	2	16173	2	22	0	16151	16175	0.28847872656338225
R1	cpdb	0	network_modules	30	TRUE	0.0032968362412703106	2	24	2	0.08333333333333333	1	GO:1905765	GO:BP	negative regulation of protection from non-homologous end joining at telomere	16175	24878		0.6875	0.7878787878787878	2	16173	2	22	0	16151	16175	0.28847872656338225
R1	cpdb	0	network_modules	30	TRUE	0.0034594891506577793	148	24	5	0.20833333333333334	0.033783783783783786	GO:0071478	GO:BP	cellular response to radiation	16175	16711		0.8125	0.8181818181818182	148	16027	5	19	143	16008	16175	0.08063923330672022
R1	cpdb	0	network_modules	30	TRUE	0.004921106233711784	159	24	5	0.20833333333333334	0.031446540880503145	GO:0006814	GO:BP	sodium ion transport	16175	2494		0.84375	0.8484848484848485	159	16016	5	19	154	15997	16175	0.07756082986709648
R1	cpdb	0	network_modules	30	TRUE	0.00502853374470541	20	24	3	0.125	0.15	GO:0006312	GO:BP	mitotic recombination	16175	2117		0.875	0.8787878787878788	20	16155	3	21	17	16134	16175	0.13576080024891163
R1	cpdb	0	network_modules	30	TRUE	0.0052323666896009	161	24	5	0.20833333333333334	0.031055900621118012	GO:1903046	GO:BP	meiotic cell cycle process	16175	22726		0.90625	0.9090909090909091	161	16014	5	19	156	15995	16175	0.07703437853205924
R1	cpdb	0	network_modules	30	TRUE	0.0058609106943852286	21	24	3	0.125	0.14285714285714285	GO:0086012	GO:BP	membrane depolarization during cardiac muscle cell action potential	16175	17886		0.9375	0.9393939393939394	21	16154	3	21	18	16133	16175	0.1324268911233211
R1	cpdb	0	network_modules	30	TRUE	0.007158417078545655	84	22	4	0.18181818181818182	0.047619047619047616	REAC:R-HSA-5696399	REAC	Global Genome Nucleotide Excision Repair (GG-NER)	10916	1047		1	1	84	10832	4	18	80	10814	10916	0.08954544365247666
R1	cpdb	0	network_modules	30	TRUE	0.008977483132726609	81	24	4	0.16666666666666666	0.04938271604938271	GO:0034644	GO:BP	cellular response to UV	16175	8706		0.96875	0.9696969696969697	81	16094	4	20	77	16074	16175	0.08828266137878188
R1	cpdb	0	network_modules	30	TRUE	0.009881539404908083	3	24	2	0.08333333333333333	0.6666666666666666	GO:1904506	GO:BP	negative regulation of telomere maintenance in response to DNA damage	16175	23868		1	1	3	16172	2	22	1	16150	16175	0.23537416597204877
R1	cpdb	0	network_modules	31	TRUE	1.165144201310436e-8	276	16	9	0.5625	0.03260869565217391	REAC:R-HSA-72203	REAC	Processing of Capped Intron-Containing Pre-mRNA	10916	1796		0	0.14285714285714285	276	10640	9	7	267	10633	10916	0.13110941024867537
R1	cpdb	0	network_modules	31	TRUE	1.291787584819535e-8	13	8	4	0.5	0.3076923076923077	KEGG:03450	KEGG	Non-homologous end-joining	8484	241		NA	1	13	8471	4	4	9	8467	8484	0.391514803373688
R1	cpdb	0	network_modules	31	TRUE	4.3505192490213145e-8	202	16	8	0.5	0.039603960396039604	REAC:R-HSA-72163	REAC	mRNA Splicing - Major Pathway	10916	2707		0.16666666666666666	0.2857142857142857	202	10714	8	8	194	10706	10916	0.13688333986522955
R1	cpdb	0	network_modules	31	TRUE	5.714196880208412e-8	209	16	8	0.5	0.03827751196172249	REAC:R-HSA-72172	REAC	mRNA Splicing	10916	2706		0.3333333333333333	0.42857142857142855	209	10707	8	8	201	10699	10916	0.13443621319141047
R1	cpdb	0	network_modules	31	TRUE	3.104634308588128e-6	287	22	8	0.36363636363636365	0.027874564459930314	GO:0000377	GO:BP	RNA splicing, via transesterification reactions with bulged adenosine as nucleophile	16175	109		0	0.16666666666666666	287	15888	8	14	279	15874	16175	0.09669302730081551
R1	cpdb	0	network_modules	31	TRUE	3.104634308588128e-6	287	22	8	0.36363636363636365	0.027874564459930314	GO:0000398	GO:BP	mRNA splicing, via spliceosome	16175	121		0	0.16666666666666666	287	15888	8	14	279	15874	16175	0.09669302730081551
R1	cpdb	0	network_modules	31	TRUE	3.4620775150157613e-6	291	22	8	0.36363636363636365	0.027491408934707903	GO:0000375	GO:BP	RNA splicing, via transesterification reactions	16175	107		0.18181818181818182	0.25	291	15884	8	14	283	15870	16175	0.09596959875650699
R1	cpdb	0	network_modules	31	TRUE	1.5388471243475424e-5	352	22	8	0.36363636363636365	0.022727272727272728	GO:0006397	GO:BP	mRNA processing	16175	2158		0.2727272727272727	0.3333333333333333	352	15823	8	14	344	15809	16175	0.08647286540693636
R1	cpdb	0	network_modules	31	TRUE	2.3755855311914964e-5	62	22	5	0.22727272727272727	0.08064516129032258	GO:0006303	GO:BP	double-strand break repair via nonhomologous end joining	16175	2110		0.36363636363636365	0.4166666666666667	62	16113	5	17	57	16096	16175	0.13344589854894237
R1	cpdb	0	network_modules	31	TRUE	2.8882098118282e-5	7	16	3	0.1875	0.42857142857142855	REAC:R-HSA-164843	REAC	2-LTR circle formation	10916	1		0.5	0.5714285714285714	7	10909	3	13	4	10896	10916	0.28280181556864015
R1	cpdb	0	network_modules	31	TRUE	2.9459287822291964e-5	5	22	3	0.13636363636363635	0.6	GO:0051103	GO:BP	DNA ligation involved in DNA repair	16175	13498		0.45454545454545453	0.5	5	16170	3	19	2	16151	16175	0.2856287946220628
R1	cpdb	0	network_modules	31	TRUE	3.925025315281707e-5	397	22	8	0.36363636363636365	0.020151133501259445	GO:0008380	GO:BP	RNA splicing	16175	3186		0.5454545454545454	0.5833333333333334	397	15778	8	14	389	15764	16175	0.08087713347963102
R1	cpdb	0	network_modules	31	TRUE	5.8866660358647046e-5	6	22	3	0.13636363636363635	0.5	GO:0033152	GO:BP	immunoglobulin V(D)J recombination	16175	8064		0.6363636363636364	0.6666666666666666	6	16169	3	19	3	16150	16175	0.2606317999135396
R1	cpdb	0	network_modules	31	TRUE	6.919322340223276e-5	9	16	3	0.1875	0.3333333333333333	REAC:R-HSA-162592	REAC	Integration of provirus	10916	1214		0.6666666666666666	0.7142857142857143	9	10907	3	13	6	10894	10916	0.24918605401745583
R1	cpdb	0	network_modules	31	TRUE	2.985001294870288e-4	14	16	3	0.1875	0.21428571428571427	REAC:R-HSA-162594	REAC	Early Phase of HIV Life Cycle	10916	831		0.8333333333333334	0.8571428571428571	14	10902	3	13	11	10889	10916	0.199348790673656
R1	cpdb	0	network_modules	31	TRUE	0.00048351415682192865	11	22	3	0.13636363636363635	0.2727272727272727	GO:0033151	GO:BP	V(D)J recombination	16175	8063		0.7272727272727273	0.75	11	16164	3	19	8	16145	16175	0.19208150336741148
R1	cpdb	0	network_modules	31	TRUE	7.593610036227843e-4	68	16	4	0.25	0.058823529411764705	REAC:R-HSA-5693571	REAC	Nonhomologous End-Joining (NHEJ)	10916	1605		1	1	68	10848	4	12	64	10836	10916	0.11870317143066614
R1	cpdb	0	network_modules	31	TRUE	8.212206728230581e-4	590	22	8	0.36363636363636365	0.013559322033898305	GO:0016071	GO:BP	mRNA metabolic process	16175	5098		0.8181818181818182	0.8333333333333334	590	15585	8	14	582	15571	16175	0.06440361555039156
R1	cpdb	0	network_modules	31	TRUE	0.001063844581604754	14	22	3	0.13636363636363635	0.21428571428571427	GO:0006266	GO:BP	DNA ligation	16175	2081		0.9090909090909091	0.9166666666666666	14	16161	3	19	11	16142	16175	0.17004509759073805
R1	cpdb	0	network_modules	31	TRUE	0.008205543522664399	90	22	4	0.18181818181818182	0.044444444444444446	GO:0010212	GO:BP	response to ionizing radiation	16175	3993		1	1	90	16085	4	18	86	16067	16175	0.08744527047370924
R1	cpdb	0	network_modules	32	TRUE	4.1720323104310685e-18	24	22	9	0.4090909090909091	0.375	GO:0042744	GO:BP	hydrogen peroxide catabolic process	16175	10337		0	0.012195121951219513	24	16151	9	13	15	16138	16175	0.39080983487799675
R1	cpdb	0	network_modules	32	TRUE	1.7747715873369034e-15	43	22	9	0.4090909090909091	0.20930232558139536	GO:0042743	GO:BP	hydrogen peroxide metabolic process	16175	10336		0.012345679012345678	0.024390243902439025	43	16132	9	13	34	16119	16175	0.2912990793146938
R1	cpdb	0	network_modules	32	TRUE	6.856303373936731e-15	13	22	7	0.3181818181818182	0.5384615384615384	GO:0015671	GO:BP	oxygen transport	16175	4800		0.024691358024691357	0.036585365853658534	13	16162	7	15	6	16147	16175	0.41332033594713313
R1	cpdb	0	network_modules	32	TRUE	1.2663781872863765e-13	18	22	7	0.3181818181818182	0.3888888888888889	GO:0015669	GO:BP	gas transport	16175	4798		0.037037037037037035	0.04878048780487805	18	16157	7	15	11	16142	16175	0.3509669220887667
R1	cpdb	0	network_modules	32	TRUE	1.370559455706596e-12	24	22	7	0.3181818181818182	0.2916666666666667	GO:0051315	GO:BP	attachment of mitotic spindle microtubules to kinetochore	16175	13643		0.04938271604938271	0.06097560975609756	24	16151	7	15	17	16136	16175	0.3036470658562094
R1	cpdb	0	network_modules	32	TRUE	2.709713625701546e-12	52	22	8	0.36363636363636365	0.15384615384615385	GO:0008608	GO:BP	attachment of spindle microtubules to kinetochore	16175	3205		0.06172839506172839	0.07317073170731707	52	16123	8	14	44	16109	16175	0.23497148165909598
R1	cpdb	0	network_modules	32	TRUE	6.921332461617252e-12	13	22	6	0.2727272727272727	0.46153846153846156	GO:0015670	GO:BP	carbon dioxide transport	16175	4799		0.07407407407407407	0.08536585365853659	13	16162	6	16	7	16146	16175	0.3541250496957507
R1	cpdb	0	network_modules	32	TRUE	7.455912340024533e-11	18	22	6	0.2727272727272727	0.3333333333333333	GO:0019755	GO:BP	one-carbon compound transport	16175	6037		0.08641975308641975	0.0975609756097561	18	16157	6	16	12	16141	16175	0.30065281875730226
R1	cpdb	0	network_modules	32	TRUE	4.6151158522164007e-10	96	22	8	0.36363636363636365	0.08333333333333333	GO:0051310	GO:BP	metaphase chromosome alignment	16175	13641		0.09876543209876543	0.10975609756097561	96	16079	8	14	88	16065	16175	0.17186379272439342
R1	cpdb	0	network_modules	32	TRUE	8.230523109662752e-10	103	22	8	0.36363636363636365	0.07766990291262135	GO:0051303	GO:BP	establishment of chromosome localization	16175	13634		0.1111111111111111	0.12195121951219512	103	16072	8	14	95	16058	16175	0.1657563596549678
R1	cpdb	0	network_modules	32	TRUE	9.839477352186764e-10	175	22	9	0.4090909090909091	0.05142857142857143	GO:0072593	GO:BP	reactive oxygen species metabolic process	16175	17457		0.12345679012345678	0.13414634146341464	175	16000	9	13	166	15987	16175	0.14207887611215095
R1	cpdb	0	network_modules	32	TRUE	1.213890829921488e-9	108	22	8	0.36363636363636365	0.07407407407407407	GO:0050000	GO:BP	chromosome localization	16175	13183		0.13580246913580246	0.14634146341463414	108	16067	8	14	100	16053	16175	0.16175904456011156
R1	cpdb	0	network_modules	32	TRUE	1.3130274673986304e-9	59	22	7	0.3181818181818182	0.11864406779661017	GO:0007080	GO:BP	mitotic metaphase chromosome alignment	16175	2669		0.14814814814814814	0.15853658536585366	59	16116	7	15	52	16101	16175	0.19254945393571302
R1	cpdb	0	network_modules	32	TRUE	1.7736638525601058e-9	11	22	5	0.22727272727272727	0.45454545454545453	GO:0051256	GO:BP	mitotic spindle midzone assembly	16175	13603		0.16049382716049382	0.17073170731707318	11	16164	5	17	6	16147	16175	0.3207776621383197
R1	cpdb	0	network_modules	32	TRUE	3.0379022931221917e-9	12	22	5	0.22727272727272727	0.4166666666666667	GO:0051255	GO:BP	spindle midzone assembly	16175	13602		0.1728395061728395	0.1951219512195122	12	16163	5	17	7	16146	16175	0.3070469319966742
R1	cpdb	0	network_modules	32	TRUE	3.0379022931221917e-9	12	22	5	0.22727272727272727	0.4166666666666667	GO:0000022	GO:BP	mitotic spindle elongation	16175	8		0.1728395061728395	0.1951219512195122	12	16163	5	17	7	16146	16175	0.3070469319966742
R1	cpdb	0	network_modules	32	TRUE	4.932265393535039e-9	13	22	5	0.22727272727272727	0.38461538461538464	GO:0051231	GO:BP	spindle elongation	16175	13582		0.19753086419753085	0.2073170731707317	13	16162	5	17	8	16145	16175	0.2949297634443683
R1	cpdb	0	network_modules	32	TRUE	6.959748749625998e-8	178	22	8	0.36363636363636365	0.0449438202247191	GO:0000070	GO:BP	mitotic sister chromatid segregation	16175	24		0.20987654320987653	0.21951219512195122	178	15997	8	14	170	15983	16175	0.1247444244400944
R1	cpdb	0	network_modules	32	TRUE	1.2102779483552935e-7	7	22	4	0.18181818181818182	0.5714285714285714	GO:1903490	GO:BP	positive regulation of mitotic cytokinesis	16175	23046		0.2222222222222222	0.23170731707317074	7	16168	4	18	3	16150	16175	0.3218505283705509
R1	cpdb	0	network_modules	32	TRUE	2.418400339960156e-7	8	22	4	0.18181818181818182	0.5	GO:1902425	GO:BP	positive regulation of attachment of mitotic spindle microtubules to kinetochore	16175	22273		0.2345679012345679	0.25609756097560976	8	16167	4	18	4	16149	16175	0.30097029428723465
R1	cpdb	0	network_modules	32	TRUE	2.418400339960156e-7	8	22	4	0.18181818181818182	0.5	GO:1902423	GO:BP	regulation of attachment of mitotic spindle microtubules to kinetochore	16175	22271		0.2345679012345679	0.25609756097560976	8	16167	4	18	4	16149	16175	0.30097029428723465
R1	cpdb	0	network_modules	32	TRUE	2.718055340947384e-7	92	14	6	0.42857142857142855	0.06521739130434782	REAC:R-HSA-141424	REAC	Amplification of signal from the kinetochores	10916	144		0	0.14285714285714285	92	10824	6	8	86	10816	10916	0.16469644700403827
R1	cpdb	0	network_modules	32	TRUE	2.718055340947384e-7	92	14	6	0.42857142857142855	0.06521739130434782	REAC:R-HSA-141444	REAC	Amplification  of signal from unattached  kinetochores via a MAD2  inhibitory signal	10916	143		0	0.14285714285714285	92	10824	6	8	86	10816	10916	0.16469644700403827
R1	cpdb	0	network_modules	32	TRUE	3.3912205815657863e-7	217	22	8	0.36363636363636365	0.03686635944700461	GO:0000819	GO:BP	sister chromatid segregation	16175	237		0.25925925925925924	0.2682926829268293	217	15958	8	14	209	15944	16175	0.11234444985773766
R1	cpdb	0	network_modules	32	TRUE	7.24228467250126e-7	10	22	4	0.18181818181818182	0.4	GO:1902412	GO:BP	regulation of mitotic cytokinesis	16175	22263		0.2716049382716049	0.2804878048780488	10	16165	4	18	6	16147	16175	0.26902908675305715
R1	cpdb	0	network_modules	32	TRUE	7.636352076823699e-7	109	14	6	0.42857142857142855	0.05504587155963303	REAC:R-HSA-69618	REAC	Mitotic Spindle Checkpoint	10916	1486		0.15384615384615385	0.21428571428571427	109	10807	6	8	103	10799	10916	0.15086670989134512
R1	cpdb	0	network_modules	32	TRUE	1.057032370073572e-6	115	14	6	0.42857142857142855	0.05217391304347826	REAC:R-HSA-9648025	REAC	EML4 and NUDC in mitotic spindle formation	10916	817		0.23076923076923078	0.2857142857142857	115	10801	6	8	109	10793	10916	0.14672620579933293
R1	cpdb	0	network_modules	32	TRUE	1.1117554000954328e-6	252	22	8	0.36363636363636365	0.031746031746031744	GO:0140014	GO:BP	mitotic nuclear division	16175	19633		0.2839506172839506	0.2926829268292683	252	15923	8	14	244	15909	16175	0.10372092834339786
R1	cpdb	0	network_modules	32	TRUE	1.13705978347731e-6	11	22	4	0.18181818181818182	0.36363636363636365	GO:0051987	GO:BP	positive regulation of attachment of spindle microtubules to kinetochore	16175	14049		0.2962962962962963	0.3048780487804878	11	16164	4	18	7	16146	16175	0.2564295827528656
R1	cpdb	0	network_modules	32	TRUE	1.5883018139700465e-6	123	14	6	0.42857142857142855	0.04878048780487805	REAC:R-HSA-2500257	REAC	Resolution of Sister Chromatid Cohesion	10916	2079		0.3076923076923077	0.35714285714285715	123	10793	6	8	117	10785	10916	0.14167815952507926
R1	cpdb	0	network_modules	32	TRUE	1.7040707240694078e-6	12	22	4	0.18181818181818182	0.3333333333333333	GO:0090267	GO:BP	positive regulation of mitotic cell cycle spindle assembly checkpoint	16175	18156		0.30864197530864196	0.3170731707317073	12	16163	4	18	8	16145	16175	0.2454364306377256
R1	cpdb	0	network_modules	32	TRUE	2.3475927970927897e-6	277	22	8	0.36363636363636365	0.02888086642599278	GO:0098813	GO:BP	nuclear chromosome segregation	16175	18900		0.32098765432098764	0.32926829268292684	277	15898	8	14	269	15884	16175	0.09856781781028161
R1	cpdb	0	network_modules	32	TRUE	2.4592433723697874e-6	13	22	4	0.18181818181818182	0.3076923076923077	GO:0090232	GO:BP	positive regulation of spindle checkpoint	16175	18127		0.3333333333333333	0.35365853658536583	13	16162	4	18	9	16144	16175	0.2357344771929859
R1	cpdb	0	network_modules	32	TRUE	2.4592433723697874e-6	13	22	4	0.18181818181818182	0.3076923076923077	GO:0090235	GO:BP	regulation of metaphase plate congression	16175	18130		0.3333333333333333	0.35365853658536583	13	16162	4	18	9	16144	16175	0.2357344771929859
R1	cpdb	0	network_modules	32	TRUE	2.9131829483025253e-6	136	14	6	0.42857142857142855	0.04411764705882353	REAC:R-HSA-5663220	REAC	RHO GTPases Activate Formins	10916	1848		0.38461538461538464	0.42857142857142855	136	10780	6	8	130	10772	10916	0.13443320189854738
R1	cpdb	0	network_modules	32	TRUE	3.178207135080006e-6	42	22	5	0.22727272727272727	0.11904761904761904	GO:0032467	GO:BP	positive regulation of cytokinesis	16175	7582		0.35802469135802467	0.36585365853658536	42	16133	5	17	37	16116	16175	0.162931010520695
R1	cpdb	0	network_modules	32	TRUE	7.807417627832578e-6	289	14	7	0.5	0.02422145328719723	REAC:R-HSA-69620	REAC	Cell Cycle Checkpoints	10916	321		0.46153846153846156	0.5	289	10627	7	7	282	10620	10916	0.10569713108249174
R1	cpdb	0	network_modules	32	TRUE	7.860590783073501e-6	50	22	5	0.22727272727272727	0.1	GO:0051781	GO:BP	positive regulation of cell division	16175	13931		0.37037037037037035	0.3780487804878049	50	16125	5	17	45	16108	16175	0.14903696984686937
R1	cpdb	0	network_modules	32	TRUE	1.0478088653443934e-5	18	22	4	0.18181818181818182	0.2222222222222222	GO:1901978	GO:BP	positive regulation of cell cycle checkpoint	16175	21913		0.38271604938271603	0.3902439024390244	18	16157	4	18	14	16139	16175	0.20002461209437336
R1	cpdb	0	network_modules	32	TRUE	1.326042455082207e-5	19	22	4	0.18181818181818182	0.21052631578947367	GO:1901970	GO:BP	positive regulation of mitotic sister chromatid separation	16175	21909		0.3950617283950617	0.4024390243902439	19	16156	4	18	15	16138	16175	0.19462907597893775
R1	cpdb	0	network_modules	32	TRUE	1.5097466710393984e-5	318	14	7	0.5	0.0220125786163522	REAC:R-HSA-195258	REAC	RHO GTPase Effectors	10916	1846		0.5384615384615384	0.5714285714285714	318	10598	7	7	311	10591	10916	0.10033409330398697
R1	cpdb	0	network_modules	32	TRUE	1.8738157571731964e-5	361	22	8	0.36363636363636365	0.0221606648199446	GO:0007059	GO:BP	chromosome segregation	16175	2658		0.4074074074074074	0.4146341463414634	361	15814	8	14	353	15800	16175	0.08527342767559912
R1	cpdb	0	network_modules	32	TRUE	2.029078010726278e-5	188	14	6	0.42857142857142855	0.031914893617021274	REAC:R-HSA-2467813	REAC	Separation of Sister Chromatids	10916	2204		0.6153846153846154	0.6428571428571429	188	10728	6	8	182	10720	10916	0.11330435366231058
R1	cpdb	0	network_modules	32	TRUE	2.0439197269921564e-5	21	22	4	0.18181818181818182	0.19047619047619047	GO:1903504	GO:BP	regulation of mitotic spindle checkpoint	16175	23058		0.41975308641975306	0.45121951219512196	21	16154	4	18	17	16136	16175	0.18501391257687402
R1	cpdb	0	network_modules	32	TRUE	2.0439197269921564e-5	21	22	4	0.18181818181818182	0.19047619047619047	GO:0090266	GO:BP	regulation of mitotic cell cycle spindle assembly checkpoint	16175	18155		0.41975308641975306	0.45121951219512196	21	16154	4	18	17	16136	16175	0.18501391257687402
R1	cpdb	0	network_modules	32	TRUE	2.0439197269921564e-5	21	22	4	0.18181818181818182	0.19047619047619047	GO:0051988	GO:BP	regulation of attachment of spindle microtubules to kinetochore	16175	14050		0.41975308641975306	0.45121951219512196	21	16154	4	18	17	16136	16175	0.18501391257687402
R1	cpdb	0	network_modules	32	TRUE	2.4958990331847094e-5	22	22	4	0.18181818181818182	0.18181818181818182	GO:0090231	GO:BP	regulation of spindle checkpoint	16175	18126		0.4567901234567901	0.4634146341463415	22	16153	4	18	18	16135	16175	0.18070383773349166
R1	cpdb	0	network_modules	32	TRUE	2.7370583574156152e-5	379	22	8	0.36363636363636365	0.021108179419525065	GO:0000280	GO:BP	nuclear division	16175	78		0.4691358024691358	0.47560975609756095	379	15796	8	14	371	15782	16175	0.08299974152576586
R1	cpdb	0	network_modules	32	TRUE	2.8469580780312953e-5	199	14	6	0.42857142857142855	0.03015075376884422	REAC:R-HSA-68877	REAC	Mitotic Prometaphase	10916	1484		0.6923076923076923	0.7142857142857143	199	10717	6	8	193	10709	10916	0.10991489276353095
R1	cpdb	0	network_modules	32	TRUE	3.8067220005059824e-5	68	22	5	0.22727272727272727	0.07352941176470588	GO:0090307	GO:BP	mitotic spindle assembly	16175	18189		0.48148148148148145	0.4878048780487805	68	16107	5	17	63	16090	16175	0.12723479687570005
R1	cpdb	0	network_modules	32	TRUE	5.039011776729205e-5	410	22	8	0.36363636363636365	0.01951219512195122	GO:0051656	GO:BP	establishment of organelle localization	16175	13869		0.49382716049382713	0.5	410	15765	8	14	402	15751	16175	0.0794287057752697
R1	cpdb	0	network_modules	32	TRUE	5.46751795198848e-5	265	22	7	0.3181818181818182	0.026415094339622643	GO:0051301	GO:BP	cell division	16175	13632		0.5061728395061729	0.5121951219512195	265	15910	7	15	258	15895	16175	0.08773807439024246
R1	cpdb	0	network_modules	32	TRUE	6.383800391954548e-5	228	14	6	0.42857142857142855	0.02631578947368421	REAC:R-HSA-68882	REAC	Mitotic Anaphase	10916	1479		0.7692307692307693	0.7857142857142857	228	10688	6	8	222	10680	10916	0.1021605393494844
R1	cpdb	0	network_modules	32	TRUE	6.384403358503586e-5	43	14	4	0.2857142857142857	0.09302325581395349	REAC:R-HSA-4615885	REAC	SUMOylation of DNA replication proteins	10916	2170		0.8461538461538461	0.8571428571428571	43	10873	4	10	39	10863	10916	0.16120116203088514
R1	cpdb	0	network_modules	32	TRUE	6.534641453781311e-5	424	22	8	0.36363636363636365	0.018867924528301886	GO:0048285	GO:BP	organelle fission	16175	12627		0.5185185185185185	0.524390243902439	424	15751	8	14	416	15737	16175	0.07794115075400243
R1	cpdb	0	network_modules	32	TRUE	6.551379571397413e-5	229	14	6	0.42857142857142855	0.026200873362445413	REAC:R-HSA-2555396	REAC	Mitotic Metaphase and Anaphase	10916	1482		0.9230769230769231	0.9285714285714286	229	10687	6	8	223	10679	10916	0.10191909961692812
R1	cpdb	0	network_modules	32	TRUE	6.948874823312498e-5	28	22	4	0.18181818181818182	0.14285714285714285	GO:0051984	GO:BP	positive regulation of chromosome segregation	16175	14046		0.5308641975308642	0.5365853658536586	28	16147	4	18	24	16129	16175	0.15987727466736662
R1	cpdb	0	network_modules	32	TRUE	8.0512116345496e-5	406	14	7	0.5	0.017241379310344827	REAC:R-HSA-68886	REAC	M Phase	10916	1343		1	1	406	10510	7	7	399	10503	10916	0.08764151898827671
R1	cpdb	0	network_modules	32	TRUE	8.053514427899928e-5	29	22	4	0.18181818181818182	0.13793103448275862	GO:1905820	GO:BP	positive regulation of chromosome separation	16175	24930		0.5432098765432098	0.5487804878048781	29	16146	4	18	25	16128	16175	0.1570475201682107
R1	cpdb	0	network_modules	32	TRUE	1.251853153955413e-4	86	22	5	0.22727272727272727	0.05813953488372093	GO:0032465	GO:BP	regulation of cytokinesis	16175	7580		0.5555555555555556	0.5609756097560976	86	16089	5	17	81	16072	16175	0.1126372236162707
R1	cpdb	0	network_modules	32	TRUE	3.0937530716024534e-4	519	22	8	0.36363636363636365	0.015414258188824663	GO:0051640	GO:BP	organelle localization	16175	13853		0.5679012345679012	0.573170731707317	519	15656	8	14	511	15642	16175	0.06943104978253545
R1	cpdb	0	network_modules	32	TRUE	3.397343719265837e-4	41	22	4	0.18181818181818182	0.0975609756097561	GO:1901976	GO:BP	regulation of cell cycle checkpoint	16175	21911		0.5802469135802469	0.5853658536585366	41	16134	4	18	37	16116	16175	0.13158493571978835
R1	cpdb	0	network_modules	32	TRUE	4.4930382242496035e-4	545	22	8	0.36363636363636365	0.014678899082568808	GO:0051276	GO:BP	chromosome organization	16175	13613		0.5925925925925926	0.5975609756097561	545	15630	8	14	537	15616	16175	0.06748222770361695
R1	cpdb	0	network_modules	32	TRUE	4.541929382829511e-4	44	22	4	0.18181818181818182	0.09090909090909091	GO:0071173	GO:BP	spindle assembly checkpoint signaling	16175	16469		0.6049382716049383	0.6341463414634146	44	16131	4	18	40	16113	16175	0.1269002935375686
R1	cpdb	0	network_modules	32	TRUE	4.541929382829511e-4	44	22	4	0.18181818181818182	0.09090909090909091	GO:0071174	GO:BP	mitotic spindle checkpoint signaling	16175	16470		0.6049382716049383	0.6341463414634146	44	16131	4	18	40	16113	16175	0.1269002935375686
R1	cpdb	0	network_modules	32	TRUE	4.541929382829511e-4	44	22	4	0.18181818181818182	0.09090909090909091	GO:0007094	GO:BP	mitotic spindle assembly checkpoint signaling	16175	2677		0.6049382716049383	0.6341463414634146	44	16131	4	18	40	16113	16175	0.1269002935375686
R1	cpdb	0	network_modules	32	TRUE	4.927185951592297e-4	113	22	5	0.22727272727272727	0.04424778761061947	GO:0051225	GO:BP	spindle assembly	16175	13578		0.6419753086419753	0.6463414634146342	113	16062	5	17	108	16045	16175	0.09760636846808955
R1	cpdb	0	network_modules	32	TRUE	4.98060283266853e-4	45	22	4	0.18181818181818182	0.08888888888888889	GO:0031577	GO:BP	spindle checkpoint signaling	16175	7223		0.654320987654321	0.7073170731707317	45	16130	4	18	41	16112	16175	0.12544294102667558
R1	cpdb	0	network_modules	32	TRUE	4.98060283266853e-4	45	22	4	0.18181818181818182	0.08888888888888889	GO:2000816	GO:BP	negative regulation of mitotic sister chromatid separation	16175	26071		0.654320987654321	0.7073170731707317	45	16130	4	18	41	16112	16175	0.12544294102667558
R1	cpdb	0	network_modules	32	TRUE	4.98060283266853e-4	45	22	4	0.18181818181818182	0.08888888888888889	GO:0033046	GO:BP	negative regulation of sister chromatid segregation	16175	8001		0.654320987654321	0.7073170731707317	45	16130	4	18	41	16112	16175	0.12544294102667558
R1	cpdb	0	network_modules	32	TRUE	4.98060283266853e-4	45	22	4	0.18181818181818182	0.08888888888888889	GO:0033048	GO:BP	negative regulation of mitotic sister chromatid segregation	16175	8003		0.654320987654321	0.7073170731707317	45	16130	4	18	41	16112	16175	0.12544294102667558
R1	cpdb	0	network_modules	32	TRUE	4.98060283266853e-4	45	22	4	0.18181818181818182	0.08888888888888889	GO:0045841	GO:BP	negative regulation of mitotic metaphase/anaphase transition	16175	11657		0.654320987654321	0.7073170731707317	45	16130	4	18	41	16112	16175	0.12544294102667558
R1	cpdb	0	network_modules	32	TRUE	5.951762488648863e-4	47	22	4	0.18181818181818182	0.0851063829787234	GO:0051985	GO:BP	negative regulation of chromosome segregation	16175	14047		0.7160493827160493	0.7439024390243902	47	16128	4	18	43	16110	16175	0.12266776192006816
R1	cpdb	0	network_modules	32	TRUE	5.951762488648863e-4	47	22	4	0.18181818181818182	0.0851063829787234	GO:1905819	GO:BP	negative regulation of chromosome separation	16175	24929		0.7160493827160493	0.7439024390243902	47	16128	4	18	43	16110	16175	0.12266776192006816
R1	cpdb	0	network_modules	32	TRUE	5.951762488648863e-4	47	22	4	0.18181818181818182	0.0851063829787234	GO:1902100	GO:BP	negative regulation of metaphase/anaphase transition of cell cycle	16175	22014		0.7160493827160493	0.7439024390243902	47	16128	4	18	43	16110	16175	0.12266776192006816
R1	cpdb	0	network_modules	32	TRUE	7.79931865868274e-4	586	22	8	0.36363636363636365	0.013651877133105802	GO:0000226	GO:BP	microtubule cytoskeleton organization	16175	61		0.7530864197530864	0.7560975609756098	586	15589	8	14	578	15575	16175	0.06466359915737403
R1	cpdb	0	network_modules	32	TRUE	7.827323433297902e-4	124	22	5	0.22727272727272727	0.04032258064516129	GO:0007052	GO:BP	mitotic spindle organization	16175	2651		0.7654320987654321	0.7682926829268293	124	16051	5	17	119	16034	16175	0.09292070229959896
R1	cpdb	0	network_modules	32	TRUE	8.309092990642593e-4	51	22	4	0.18181818181818182	0.0784313725490196	GO:0033047	GO:BP	regulation of mitotic sister chromatid segregation	16175	8002		0.7777777777777778	0.7804878048780488	51	16124	4	18	47	16106	16175	0.11761086450014586
R1	cpdb	0	network_modules	32	TRUE	8.993496388428823e-4	52	22	4	0.18181818181818182	0.07692307692307693	GO:0045839	GO:BP	negative regulation of mitotic nuclear division	16175	11655		0.7901234567901234	0.7926829268292683	52	16123	4	18	48	16105	16175	0.11643780788676947
R1	cpdb	0	network_modules	32	TRUE	0.0010282637361388727	131	22	5	0.22727272727272727	0.03816793893129771	GO:0051302	GO:BP	regulation of cell division	16175	13633		0.8024691358024691	0.8048780487804879	131	16044	5	17	126	16027	16175	0.09024553301914881
R1	cpdb	0	network_modules	32	TRUE	0.0012157957158887651	56	22	4	0.18181818181818182	0.07142857142857142	GO:0010965	GO:BP	regulation of mitotic sister chromatid separation	16175	4541		0.8148148148148148	0.8170731707317073	56	16119	4	18	52	16101	16175	0.11206082487634876
R1	cpdb	0	network_modules	32	TRUE	0.0013063886754115476	57	22	4	0.18181818181818182	0.07017543859649122	GO:0051784	GO:BP	negative regulation of nuclear division	16175	13934		0.8271604938271605	0.8292682926829268	57	16118	4	18	53	16100	16175	0.11103842841961223
R1	cpdb	0	network_modules	32	TRUE	0.0014019077855783038	58	22	4	0.18181818181818182	0.06896551724137931	GO:0051306	GO:BP	mitotic sister chromatid separation	16175	13637		0.8395061728395061	0.8414634146341463	58	16117	4	18	54	16099	16175	0.11004228296246932
R1	cpdb	0	network_modules	32	TRUE	0.0018291947659762329	656	22	8	0.36363636363636365	0.012195121951219513	GO:1903047	GO:BP	mitotic cell cycle process	16175	22727		0.8518518518518519	0.8536585365853658	656	15519	8	14	648	15505	16175	0.06044428618735116
R1	cpdb	0	network_modules	32	TRUE	0.002216511703493244	153	22	5	0.22727272727272727	0.032679738562091505	GO:1902850	GO:BP	microtubule cytoskeleton organization involved in mitosis	16175	22560		0.8641975308641975	0.8658536585365854	153	16022	5	17	148	16005	16175	0.08304435526957657
R1	cpdb	0	network_modules	32	TRUE	0.0029974365324174084	70	22	4	0.18181818181818182	0.05714285714285714	GO:1905818	GO:BP	regulation of chromosome separation	16175	24928		0.8765432098765432	0.8780487804878049	70	16105	4	18	66	16087	16175	0.09978719154099222
R1	cpdb	0	network_modules	32	TRUE	0.004171813970803954	76	22	4	0.18181818181818182	0.05263157894736842	GO:0051304	GO:BP	chromosome separation	16175	13635		0.8888888888888888	0.8902439024390244	76	16099	4	18	72	16081	16175	0.09558491164917571
R1	cpdb	0	network_modules	32	TRUE	0.004291682309095553	175	22	5	0.22727272727272727	0.02857142857142857	GO:0000910	GO:BP	cytokinesis	16175	243		0.9012345679012346	0.9024390243902439	175	16000	5	17	170	15983	16175	0.0772173253310173
R1	cpdb	0	network_modules	32	TRUE	0.004413282116061216	176	22	5	0.22727272727272727	0.028409090909090908	GO:0007051	GO:BP	spindle organization	16175	2650		0.9135802469135802	0.9146341463414634	176	15999	5	17	171	15982	16175	0.07697805885467796
R1	cpdb	0	network_modules	32	TRUE	0.005938151642627204	83	22	4	0.18181818181818182	0.04819277108433735	GO:0000281	GO:BP	mitotic cytokinesis	16175	79		0.9259259259259259	0.926829268292683	83	16092	4	18	79	16074	16175	0.0912618137299133
R1	cpdb	0	network_modules	32	TRUE	0.006843796422887718	86	22	4	0.18181818181818182	0.046511627906976744	GO:0030071	GO:BP	regulation of mitotic metaphase/anaphase transition	16175	6671		0.9382716049382716	0.9390243902439024	86	16089	4	18	82	16071	16175	0.08957014472596292
R1	cpdb	0	network_modules	32	TRUE	0.007465049077939548	792	22	8	0.36363636363636365	0.010101010101010102	GO:0000278	GO:BP	mitotic cell cycle	16175	76		0.9506172839506173	0.9512195121951219	792	15383	8	14	784	15369	16175	0.053815069047123444
R1	cpdb	0	network_modules	32	TRUE	0.007501825052160836	88	22	4	0.18181818181818182	0.045454545454545456	GO:1902099	GO:BP	regulation of metaphase/anaphase transition of cell cycle	16175	22013		0.9629629629629629	0.9634146341463414	88	16087	4	18	84	16069	16175	0.08848992149272825
R1	cpdb	0	network_modules	32	TRUE	0.008205543522664399	90	22	4	0.18181818181818182	0.044444444444444446	GO:2001251	GO:BP	negative regulation of chromosome organization	16175	26440		0.9753086419753086	0.9878048780487805	90	16085	4	18	86	16067	16175	0.08744527047370924
R1	cpdb	0	network_modules	32	TRUE	0.008205543522664399	90	22	4	0.18181818181818182	0.044444444444444446	GO:0007091	GO:BP	metaphase/anaphase transition of mitotic cell cycle	16175	2675		0.9753086419753086	0.9878048780487805	90	16085	4	18	86	16067	16175	0.08744527047370924
R1	cpdb	0	network_modules	32	TRUE	0.008956945049579512	92	22	4	0.18181818181818182	0.043478260869565216	GO:0044784	GO:BP	metaphase/anaphase transition of cell cycle	16175	11156		1	1	92	16083	4	18	88	16065	16175	0.08643425445149377
R1	cpdb	0	network_modules	33	TRUE	3.12471761348041e-8	119	23	8	0.34782608695652173	0.06722689075630252	KEGG:04660	KEGG	T cell receptor signaling pathway	8484	338		0	0.1	119	8365	8	15	111	8350	8484	0.14799028229222908
R1	cpdb	0	network_modules	33	TRUE	2.4664217079791745e-7	389	33	11	0.3333333333333333	0.028277634961439587	GO:0007264	GO:BP	small GTPase-mediated signal transduction	16175	2792		0	0.047619047619047616	389	15786	11	22	378	15764	16175	0.09127860934645719
R1	cpdb	0	network_modules	33	TRUE	1.951375639565217e-6	103	33	7	0.21212121212121213	0.06796116504854369	GO:0007265	GO:BP	Ras protein signal transduction	16175	2793		0.05	0.09523809523809523	103	16072	7	26	96	16046	16175	0.11695423449838635
R1	cpdb	0	network_modules	33	TRUE	2.4313723189303673e-6	76	23	6	0.2608695652173913	0.07894736842105263	KEGG:05220	KEGG	Chronic myeloid leukemia	8484	471		0.1111111111111111	0.2	76	8408	6	17	70	8391	8484	0.13939545775453172
R1	cpdb	0	network_modules	33	TRUE	3.9899512592991765e-6	114	33	7	0.21212121212121213	0.06140350877192982	GO:0050852	GO:BP	T cell receptor signaling pathway	16175	13300		0.1	0.14285714285714285	114	16061	7	26	107	16035	16175	0.11083909939293111
R1	cpdb	0	network_modules	33	TRUE	4.458599308495093e-6	84	23	6	0.2608695652173913	0.07142857142857142	KEGG:04012	KEGG	ErbB signaling pathway	8484	245		0.2222222222222222	0.3	84	8400	6	17	78	8383	8484	0.13215810089282717
R1	cpdb	0	network_modules	33	TRUE	6.18838334629562e-6	287	33	9	0.2727272727272727	0.0313588850174216	GO:0002768	GO:BP	immune response-regulating cell surface receptor signaling pathway	16175	1279		0.15	0.19047619047619047	287	15888	9	24	278	15864	16175	0.08732924060090275
R1	cpdb	0	network_modules	33	TRUE	1.8787994767816448e-5	15	29	4	0.13793103448275862	0.26666666666666666	REAC:R-HSA-75892	REAC	Platelet Adhesion to exposed collagen	10916	1760		0	0.0625	15	10901	4	25	11	10876	10916	0.19025815438509427
R1	cpdb	0	network_modules	33	TRUE	3.40777444635017e-5	118	23	6	0.2608695652173913	0.05084745762711865	KEGG:04722	KEGG	Neurotrophin signaling pathway	8484	352		0.3333333333333333	0.4	118	8366	6	17	112	8349	8484	0.10994670715181304
R1	cpdb	0	network_modules	33	TRUE	3.88374345756572e-5	158	33	7	0.21212121212121213	0.04430379746835443	GO:0050851	GO:BP	antigen receptor-mediated signaling pathway	16175	13299		0.2	0.23809523809523808	158	16017	7	26	151	15991	16175	0.09302789933192142
R1	cpdb	0	network_modules	33	TRUE	4.5703272413060757e-5	124	23	6	0.2608695652173913	0.04838709677419355	KEGG:04650	KEGG	Natural killer cell mediated cytotoxicity	8484	334		0.4444444444444444	0.5	124	8360	6	17	118	8343	8484	0.10698495825828812
R1	cpdb	0	network_modules	33	TRUE	5.1141609691906374e-5	67	23	5	0.21739130434782608	0.07462686567164178	KEGG:04664	KEGG	Fc epsilon RI signaling pathway	8484	340		0.5555555555555556	0.6	67	8417	5	18	62	8399	8484	0.12339837279929561
R1	cpdb	0	network_modules	33	TRUE	6.49384009004372e-5	510	33	10	0.30303030303030304	0.0196078431372549	GO:0007169	GO:BP	cell surface receptor protein tyrosine kinase signaling pathway	16175	2733		0.25	0.2857142857142857	510	15665	10	23	500	15642	16175	0.07024936392773658
R1	cpdb	0	network_modules	33	TRUE	6.891897077530409e-5	265	33	8	0.24242424242424243	0.03018867924528302	GO:0002429	GO:BP	immune response-activating cell surface receptor signaling pathway	16175	952		0.3	0.3333333333333333	265	15910	8	25	257	15885	16175	0.08051033908616591
R1	cpdb	0	network_modules	33	TRUE	1.1726880364045056e-4	6	29	3	0.10344827586206896	0.5	REAC:R-HSA-9673221	REAC	Defective F9 activation	10916	546		0.06666666666666667	0.125	6	10910	3	26	3	10884	10916	0.22658438701846975
R1	cpdb	0	network_modules	33	TRUE	1.7095079467592476e-4	25	29	4	0.13793103448275862	0.16	REAC:R-HSA-2424491	REAC	DAP12 signaling	10916	433		0.13333333333333333	0.1875	25	10891	4	25	21	10866	10916	0.1464518736427528
R1	cpdb	0	network_modules	33	TRUE	2.320468748839115e-4	437	33	9	0.2727272727272727	0.020594965675057208	GO:0002764	GO:BP	immune response-regulating signaling pathway	16175	1275		0.35	0.38095238095238093	437	15738	9	24	428	15714	16175	0.06852205988013495
R1	cpdb	0	network_modules	33	TRUE	4.898939357862951e-4	9	29	3	0.10344827586206896	0.3333333333333333	REAC:R-HSA-9668250	REAC	Defective factor IX causes hemophilia B	10916	692		0.2	0.25	9	10907	3	26	6	10881	10916	0.18453663061859446
R1	cpdb	0	network_modules	33	TRUE	6.519201318929016e-4	8	33	3	0.09090909090909091	0.375	GO:0007597	GO:BP	blood coagulation, intrinsic pathway	16175	3056		0.4	0.42857142857142855	8	16167	3	30	5	16137	16175	0.18386580285820447
R1	cpdb	0	network_modules	33	TRUE	6.947253503728571e-4	35	29	4	0.13793103448275862	0.11428571428571428	REAC:R-HSA-2172127	REAC	DAP12 interactions	10916	432		0.26666666666666666	0.375	35	10881	4	25	31	10856	10916	0.12299495980210798
R1	cpdb	0	network_modules	33	TRUE	6.947253503728571e-4	35	29	4	0.13793103448275862	0.11428571428571428	REAC:R-HSA-202433	REAC	Generation of second messenger molecules	10916	1044		0.26666666666666666	0.375	35	10881	4	25	31	10856	10916	0.12299495980210798
R1	cpdb	0	network_modules	33	TRUE	8.095604384182302e-4	83	29	5	0.1724137931034483	0.060240963855421686	REAC:R-HSA-2871809	REAC	FCERI mediated Ca+2 mobilization	10916	894		0.4	0.4375	83	10833	5	24	78	10809	10916	0.09792177599987659
R1	cpdb	0	network_modules	33	TRUE	9.588568045212358e-4	11	29	3	0.10344827586206896	0.2727272727272727	REAC:R-HSA-430116	REAC	GP1b-IX-V activation signalling	10916	1017		0.4666666666666667	0.5	11	10905	3	26	8	10879	10916	0.16663693494509232
R1	cpdb	0	network_modules	33	TRUE	9.740203470415506e-4	38	29	4	0.13793103448275862	0.10526315789473684	REAC:R-HSA-76009	REAC	Platelet Aggregation (Plug Formation)	10916	1761		0.5333333333333333	0.5625	38	10878	4	25	34	10853	10916	0.11781554360083568
R1	cpdb	0	network_modules	33	TRUE	0.0010773294561267168	124	23	5	0.21739130434782608	0.04032258064516129	KEGG:04611	KEGG	Platelet activation	8484	321		0.6666666666666666	0.7	124	8360	5	18	119	8342	8484	0.08809583010829819
R1	cpdb	0	network_modules	33	TRUE	0.0010833477697605035	39	29	4	0.13793103448275862	0.10256410256410256	REAC:R-HSA-1433557	REAC	Signaling by SCF-KIT	10916	2306		0.6	0.625	39	10877	4	25	35	10852	10916	0.11622138267675293
R1	cpdb	0	network_modules	33	TRUE	0.0014257341182090098	507	29	9	0.3103448275862069	0.01775147928994083	REAC:R-HSA-9006934	REAC	Signaling by Receptor Tyrosine Kinases	10916	2302		0.6666666666666666	0.6875	507	10409	9	20	498	10389	10916	0.06471993541192465
R1	cpdb	0	network_modules	33	TRUE	0.0016560865169449608	13	29	3	0.10344827586206896	0.23076923076923078	REAC:R-HSA-428540	REAC	Activation of RAC1	10916	94		0.7333333333333333	0.75	13	10903	3	26	10	10877	10916	0.15302356768846626
R1	cpdb	0	network_modules	33	TRUE	0.0019128320005597909	11	33	3	0.09090909090909091	0.2727272727272727	GO:0035855	GO:BP	megakaryocyte development	16175	9292		0.45	0.47619047619047616	11	16164	3	30	8	16134	16175	0.1564941503252175
R1	cpdb	0	network_modules	33	TRUE	0.0019152417074990906	68	23	4	0.17391304347826086	0.058823529411764705	KEGG:05211	KEGG	Renal cell carcinoma	8484	462		0.7777777777777778	0.8	68	8416	4	19	64	8397	8484	0.09700350938678201
R1	cpdb	0	network_modules	33	TRUE	0.0021039819774438476	14	29	3	0.10344827586206896	0.21428571428571427	REAC:R-HSA-8983432	REAC	Interleukin-15 signaling	10916	1237		0.8	0.8125	14	10902	3	26	11	10876	10916	0.14733185457919962
R1	cpdb	0	network_modules	33	TRUE	0.0021413996905954415	416	33	8	0.24242424242424243	0.019230769230769232	GO:0002757	GO:BP	immune response-activating signaling pathway	16175	1268		0.5	0.5238095238095238	416	15759	8	25	408	15734	16175	0.061898711712382044
R1	cpdb	0	network_modules	33	TRUE	0.0023882722475154785	182	29	6	0.20689655172413793	0.03296703296703297	REAC:R-HSA-2454202	REAC	Fc epsilon receptor (FCERI) signaling	10916	938		0.8666666666666667	0.875	182	10734	6	23	176	10711	10916	0.0766755195567586
R1	cpdb	0	network_modules	33	TRUE	0.002404373114867252	290	33	7	0.21212121212121213	0.02413793103448276	GO:0050867	GO:BP	positive regulation of cell activation	16175	13315		0.55	0.5714285714285714	290	15885	7	26	283	15859	16175	0.06617013276414489
R1	cpdb	0	network_modules	33	TRUE	0.0024526363940725994	147	23	5	0.21739130434782608	0.034013605442176874	KEGG:04072	KEGG	Phospholipase D signaling pathway	8484	261		0.8888888888888888	0.9	147	8337	5	18	142	8319	8484	0.07993930181686769
R1	cpdb	0	network_modules	33	TRUE	0.002468096683686354	756	33	10	0.30303030303030304	0.013227513227513227	GO:0050776	GO:BP	regulation of immune response	16175	13250		0.6	0.6190476190476191	756	15419	10	23	746	15396	16175	0.054899425944586334
R1	cpdb	0	network_modules	33	TRUE	0.002546895490474788	12	33	3	0.09090909090909091	0.25	GO:0010572	GO:BP	positive regulation of platelet activation	16175	4225		0.65	0.6666666666666666	12	16163	3	30	9	16133	16175	0.14973371066642668
R1	cpdb	0	network_modules	33	TRUE	0.003225344102462361	16	29	3	0.10344827586206896	0.1875	REAC:R-HSA-9651496	REAC	Defects of contact activation system (CAS) and kallikrein/kinin system (KKS)	10916	716		0.9333333333333333	1	16	10900	3	26	13	10874	10916	0.13758180026894376
R1	cpdb	0	network_modules	33	TRUE	0.003225344102462361	16	29	3	0.10344827586206896	0.1875	REAC:R-HSA-9671793	REAC	Diseases of hemostasis	10916	766		0.9333333333333333	1	16	10900	3	26	13	10874	10916	0.13758180026894376
R1	cpdb	0	network_modules	33	TRUE	0.0036707228187710843	790	33	10	0.30303030303030304	0.012658227848101266	GO:0007167	GO:BP	enzyme-linked receptor protein signaling pathway	16175	2731		0.7	0.7142857142857143	790	15385	10	23	780	15362	16175	0.05332340791878311
R1	cpdb	0	network_modules	33	TRUE	0.00468818543468647	50	33	4	0.12121212121212122	0.08	GO:0010543	GO:BP	regulation of platelet activation	16175	4202		0.75	0.7619047619047619	50	16125	4	29	46	16096	16175	0.09620875300915999
R1	cpdb	0	network_modules	33	TRUE	0.004729736277734872	627	33	9	0.2727272727272727	0.014354066985645933	GO:0050778	GO:BP	positive regulation of immune response	16175	13252		0.8	0.8095238095238095	627	15548	9	24	618	15524	16175	0.05480246871209632
R1	cpdb	0	network_modules	33	TRUE	0.005147916335180401	468	33	8	0.24242424242424243	0.017094017094017096	GO:0050865	GO:BP	regulation of cell activation	16175	13313		0.85	0.8571428571428571	468	15707	8	25	460	15682	16175	0.05758800142374894
R1	cpdb	0	network_modules	33	TRUE	0.005245497410745556	15	33	3	0.09090909090909091	0.2	GO:0072378	GO:BP	blood coagulation, fibrin clot formation	16175	17375		0.9	0.9047619047619048	15	16160	3	30	12	16130	16175	0.13366282550790537
R1	cpdb	0	network_modules	33	TRUE	0.005745739977049287	475	33	8	0.24242424242424243	0.016842105263157894	GO:0002253	GO:BP	activation of immune response	16175	785		0.95	0.9523809523809523	475	15700	8	25	467	15675	16175	0.05705893654126862
R1	cpdb	0	network_modules	33	TRUE	0.00644701933546483	16	33	3	0.09090909090909091	0.1875	GO:0072376	GO:BP	protein activation cascade	16175	17373		1	1	16	16159	3	30	13	16129	16175	0.12933355639244704
R1	cpdb	0	network_modules	33	TRUE	0.008323333792201395	190	23	5	0.21739130434782608	0.02631578947368421	KEGG:04062	KEGG	Chemokine signaling pathway	8484	255		1	1	190	8294	5	18	185	8276	8484	0.0687101789429745
R1	cpdb	0	network_modules	34	TRUE	9.632961324140789e-36	147	30	23	0.7666666666666667	0.1564625850340136	REAC:R-HSA-453279	REAC	Mitotic G1 phase and G1/S transition	10916	1480		0	0.017543859649122806	147	10769	23	7	124	10762	10916	0.34304734110629986
R1	cpdb	0	network_modules	34	TRUE	9.559982270819944e-33	155	31	23	0.7419354838709677	0.14838709677419354	KEGG:04218	KEGG	Cellular senescence	8484	295		0	0.03571428571428571	155	8329	23	8	132	8321	8484	0.3272290417871601
R1	cpdb	0	network_modules	34	TRUE	2.364841548868528e-29	46	30	16	0.5333333333333333	0.34782608695652173	REAC:R-HSA-69231	REAC	Cyclin D associated events in G1	10916	420		0.017857142857142856	0.05263157894736842	46	10870	16	14	30	10856	10916	0.4287952182796457
R1	cpdb	0	network_modules	34	TRUE	2.364841548868528e-29	46	30	16	0.5333333333333333	0.34782608695652173	REAC:R-HSA-69236	REAC	G1 Phase	10916	1000		0.017857142857142856	0.05263157894736842	46	10870	16	14	30	10856	10916	0.4287952182796457
R1	cpdb	0	network_modules	34	TRUE	1.1635328293857202e-28	26	30	14	0.4666666666666667	0.5384615384615384	REAC:R-HSA-1538133	REAC	G0 and Early G1	10916	999		0.05357142857142857	0.07017543859649122	26	10890	14	16	12	10874	10916	0.5000044624602892
R1	cpdb	0	network_modules	34	TRUE	2.7845269198517765e-28	157	31	21	0.6774193548387096	0.1337579617834395	KEGG:04110	KEGG	Cell cycle	8484	264		0.037037037037037035	0.07142857142857142	157	8327	21	10	136	8317	8484	0.2960810788990238
R1	cpdb	0	network_modules	34	TRUE	2.1551944423399613e-27	15	30	12	0.4	0.8	REAC:R-HSA-1362300	REAC	Transcription of E2F targets under negative control by p107 (RBL1) and p130 (RBL2) in complex with HDAC1	10916	2537		0.07142857142857142	0.08771929824561403	15	10901	12	18	3	10883	10916	0.5649066281539245
R1	cpdb	0	network_modules	34	TRUE	1.5439348582532872e-25	27	30	13	0.43333333333333335	0.48148148148148145	REAC:R-HSA-69205	REAC	G1/S-Specific Transcription	10916	1003		0.08928571428571429	0.10526315789473684	27	10889	13	17	14	10872	10916	0.4553550784835651
R1	cpdb	0	network_modules	34	TRUE	1.7235980558705164e-25	130	30	18	0.6	0.13846153846153847	REAC:R-HSA-69206	REAC	G1/S Transition	10916	1002		0.10714285714285714	0.12280701754385964	130	10786	18	12	112	10774	10916	0.28459846058312993
R1	cpdb	0	network_modules	34	TRUE	3.347715804730248e-23	17	30	11	0.36666666666666664	0.6470588235294118	REAC:R-HSA-9659787	REAC	Aberrant regulation of mitotic G1/S transition in cancer due to RB1 defects	10916	47		0.125	0.15789473684210525	17	10899	11	19	6	10880	10916	0.4860658630162392
R1	cpdb	0	network_modules	34	TRUE	3.347715804730248e-23	17	30	11	0.36666666666666664	0.6470588235294118	REAC:R-HSA-9661069	REAC	Defective binding of RB1 mutants to E2F1,(E2F2, E2F3)	10916	689		0.125	0.15789473684210525	17	10899	11	19	6	10880	10916	0.4860658630162392
R1	cpdb	0	network_modules	34	TRUE	2.4525798547213228e-20	82	30	14	0.4666666666666667	0.17073170731707318	REAC:R-HSA-69202	REAC	Cyclin E associated events during G1/S transition 	10916	421		0.16071428571428573	0.17543859649122806	82	10834	14	16	68	10818	10916	0.27915649458424857
R1	cpdb	0	network_modules	34	TRUE	3.530500400473301e-20	84	30	14	0.4666666666666667	0.16666666666666666	REAC:R-HSA-69656	REAC	Cyclin A:Cdk2-associated events at S phase entry	10916	419		0.17857142857142858	0.19298245614035087	84	10832	14	16	70	10816	10916	0.27572857570516973
R1	cpdb	0	network_modules	34	TRUE	6.430260746482004e-20	18	30	10	0.3333333333333333	0.5555555555555556	REAC:R-HSA-1362277	REAC	Transcription of E2F targets under negative control by DREAM complex	10916	2536		0.19642857142857142	0.21052631578947367	18	10898	10	20	8	10878	10916	0.4291462795255177
R1	cpdb	0	network_modules	34	TRUE	1.5765149768673371e-18	36	30	11	0.36666666666666664	0.3055555555555556	REAC:R-HSA-9687139	REAC	Aberrant regulation of mitotic cell cycle due to RB1 defects	10916	48		0.21428571428571427	0.22807017543859648	36	10880	11	19	25	10861	10916	0.33271461060172
R1	cpdb	0	network_modules	34	TRUE	3.14742469660635e-18	38	30	11	0.36666666666666664	0.2894736842105263	REAC:R-HSA-9675126	REAC	Diseases of mitotic cell cycle	10916	769		0.23214285714285715	0.24561403508771928	38	10878	11	19	27	10859	10916	0.323707089159525
R1	cpdb	0	network_modules	34	TRUE	2.0962745186108273e-17	370	36	18	0.5	0.04864864864864865	GO:0044772	GO:BP	mitotic cell cycle phase transition	16175	11148		0	0.03125	370	15805	18	18	352	15787	16175	0.15072714242778162
R1	cpdb	0	network_modules	34	TRUE	3.872533283191297e-17	792	36	22	0.6111111111111112	0.027777777777777776	GO:0000278	GO:BP	mitotic cell cycle	16175	76		0.03225806451612903	0.0625	792	15383	22	14	770	15369	16175	0.12303360589789893
R1	cpdb	0	network_modules	34	TRUE	5.510611142921275e-16	162	30	14	0.4666666666666667	0.08641975308641975	REAC:R-HSA-69242	REAC	S Phase	10916	2111		0.25	0.2631578947368421	162	10754	14	16	148	10738	10916	0.1961637465975652
R1	cpdb	0	network_modules	34	TRUE	7.483838320151667e-16	656	36	20	0.5555555555555556	0.03048780487804878	GO:1903047	GO:BP	mitotic cell cycle process	16175	22727		0.06451612903225806	0.09375	656	15519	20	16	636	15503	16175	0.12330478992256999
R1	cpdb	0	network_modules	34	TRUE	1.262331497818157e-15	465	36	18	0.5	0.03870967741935484	GO:0044770	GO:BP	cell cycle phase transition	16175	11146		0.0967741935483871	0.125	465	15710	18	18	447	15692	16175	0.1331974172144222
R1	cpdb	0	network_modules	34	TRUE	2.437084675654923e-15	15	30	8	0.26666666666666666	0.5333333333333333	REAC:R-HSA-156711	REAC	Polo-like kinase mediated events	10916	1768		0.26785714285714285	0.2807017543859649	15	10901	8	22	7	10879	10916	0.37595530971454894
R1	cpdb	0	network_modules	34	TRUE	1.1466422693808472e-14	49	30	10	0.3333333333333333	0.20408163265306123	REAC:R-HSA-6791312	REAC	TP53 Regulates Transcription of Cell Cycle Genes	10916	2454		0.2857142857142857	0.2982456140350877	49	10867	10	20	39	10847	10916	0.25824249623959505
R1	cpdb	0	network_modules	34	TRUE	2.8614214389573445e-14	33	30	9	0.3	0.2727272727272727	REAC:R-HSA-2559585	REAC	Oncogene Induced Senescence	10916	1640		0.30357142857142855	0.3157894736842105	33	10883	9	21	24	10862	10916	0.28397584190064146
R1	cpdb	0	network_modules	34	TRUE	1.366784117708435e-13	187	36	13	0.3611111111111111	0.06951871657754011	GO:0000082	GO:BP	G1/S transition of mitotic cell cycle	16175	31		0.12903225806451613	0.15625	187	15988	13	23	174	15965	16175	0.15443606843268656
R1	cpdb	0	network_modules	34	TRUE	8.041566569911926e-13	214	36	13	0.3611111111111111	0.06074766355140187	GO:0044843	GO:BP	cell cycle G1/S phase transition	16175	11189		0.16129032258064516	0.1875	214	15961	13	23	201	15938	16175	0.14379731448211203
R1	cpdb	0	network_modules	34	TRUE	5.672394486321852e-12	18	30	7	0.23333333333333334	0.3888888888888889	REAC:R-HSA-6804114	REAC	TP53 Regulates Transcription of Genes Involved in G2 Cell Cycle Arrest	10916	2460		0.32142857142857145	0.3333333333333333	18	10898	7	23	11	10875	10916	0.29976235058147743
R1	cpdb	0	network_modules	34	TRUE	1.8151732937478822e-11	197	30	12	0.4	0.06091370558375635	REAC:R-HSA-453274	REAC	Mitotic G2-G2/M phases	10916	1481		0.3392857142857143	0.3508771929824561	197	10719	12	18	185	10701	10916	0.1506224737243468
R1	cpdb	0	network_modules	34	TRUE	3.4844231270412805e-11	286	36	13	0.3611111111111111	0.045454545454545456	GO:1901990	GO:BP	regulation of mitotic cell cycle phase transition	16175	21923		0.1935483870967742	0.21875	286	15889	13	23	273	15866	16175	0.1230732111492698
R1	cpdb	0	network_modules	34	TRUE	2.162127498642997e-10	74	31	9	0.2903225806451613	0.12162162162162163	KEGG:04115	KEGG	p53 signaling pathway	8484	269		0.07407407407407407	0.10714285714285714	74	8410	9	22	65	8388	8484	0.18339829614875655
R1	cpdb	0	network_modules	34	TRUE	2.4916071379641646e-10	427	36	14	0.3888888888888889	0.03278688524590164	GO:0007346	GO:BP	regulation of mitotic cell cycle	16175	2855		0.22580645161290322	0.25	427	15748	14	22	413	15726	16175	0.10678906124535516
R1	cpdb	0	network_modules	34	TRUE	5.593714526322001e-10	194	30	11	0.36666666666666664	0.05670103092783505	REAC:R-HSA-2559583	REAC	Cellular Senescence	10916	331		0.35714285714285715	0.3684210526315789	194	10722	11	19	183	10703	10916	0.13862624417146546
R1	cpdb	0	network_modules	34	TRUE	1.1571346874561174e-9	376	36	13	0.3611111111111111	0.034574468085106384	GO:1901987	GO:BP	regulation of cell cycle phase transition	16175	21920		0.25806451612903225	0.28125	376	15799	13	23	363	15776	16175	0.10589907737153456
R1	cpdb	0	network_modules	34	TRUE	1.629011330567616e-9	92	31	9	0.2903225806451613	0.09782608695652174	KEGG:05222	KEGG	Small cell lung cancer	8484	473		0.1111111111111111	0.14285714285714285	92	8392	9	22	83	8370	8484	0.1634173037956635
R1	cpdb	0	network_modules	34	TRUE	5.986109036263325e-9	22	30	6	0.2	0.2727272727272727	REAC:R-HSA-113510	REAC	E2F mediated regulation of DNA replication	10916	809		0.375	0.38596491228070173	22	10894	6	24	16	10870	10916	0.23174821372171284
R1	cpdb	0	network_modules	34	TRUE	1.4128237912162524e-8	25	30	6	0.2	0.24	REAC:R-HSA-69273	REAC	Cyclin A/B1/B2 associated events during G2/M transition	10916	418		0.39285714285714285	0.40350877192982454	25	10891	6	24	19	10867	10916	0.2171272176636654
R1	cpdb	0	network_modules	34	TRUE	1.8911957868104186e-8	195	30	10	0.3333333333333333	0.05128205128205128	REAC:R-HSA-69275	REAC	G2/M Transition	10916	1008		0.4107142857142857	0.42105263157894735	195	10721	10	20	185	10701	10916	0.12502953486183066
R1	cpdb	0	network_modules	34	TRUE	7.55867426598335e-8	5	30	4	0.13333333333333333	0.8	REAC:R-HSA-69478	REAC	G2/M DNA replication checkpoint	10916	1007		0.42857142857142855	0.43859649122807015	5	10911	4	26	1	10885	10916	0.3259995007707719
R1	cpdb	0	network_modules	34	TRUE	1.6173417396419682e-7	153	31	9	0.2903225806451613	0.058823529411764705	KEGG:04934	KEGG	Cushing syndrome	8484	391		0.14814814814814814	0.17857142857142858	153	8331	9	22	144	8309	8484	0.123911411302887
R1	cpdb	0	network_modules	34	TRUE	2.1015230638889248e-7	114	36	8	0.2222222222222222	0.07017543859649122	GO:0000086	GO:BP	G2/M transition of mitotic cell cycle	16175	34		0.2903225806451613	0.3125	114	16061	8	28	106	16033	16175	0.12148115957108623
R1	cpdb	0	network_modules	34	TRUE	2.2632798847441243e-7	6	30	4	0.13333333333333333	0.6666666666666666	REAC:R-HSA-8849470	REAC	PTK6 Regulates Cell Cycle	10916	1707		0.44642857142857145	0.45614035087719296	6	10910	4	26	2	10884	10916	0.2974039238989539
R1	cpdb	0	network_modules	34	TRUE	3.0075615993416176e-7	122	30	8	0.26666666666666666	0.06557377049180328	REAC:R-HSA-2559580	REAC	Oxidative Stress Induced Senescence	10916	1654		0.4642857142857143	0.47368421052631576	122	10794	8	22	114	10772	10916	0.12758319482922142
R1	cpdb	0	network_modules	34	TRUE	3.717012917317729e-7	72	31	7	0.22580645161290322	0.09722222222222222	KEGG:05218	KEGG	Melanoma	8484	469		0.18518518518518517	0.25	72	8412	7	24	65	8388	8484	0.14346952681295302
R1	cpdb	0	network_modules	34	TRUE	3.717012917317729e-7	72	31	7	0.22580645161290322	0.09722222222222222	KEGG:05223	KEGG	Non-small cell lung cancer	8484	474		0.18518518518518517	0.25	72	8412	7	24	65	8388	8484	0.14346952681295302
R1	cpdb	0	network_modules	34	TRUE	4.1384692989142626e-7	41	31	6	0.1935483870967742	0.14634146341463414	KEGG:05219	KEGG	Bladder cancer	8484	470		0.25925925925925924	0.2857142857142857	41	8443	6	25	35	8418	8484	0.16479495870956778
R1	cpdb	0	network_modules	34	TRUE	4.259280604615227e-7	359	30	11	0.36666666666666664	0.03064066852367688	REAC:R-HSA-3700989	REAC	Transcriptional Regulation by TP53	10916	2546		0.48214285714285715	0.49122807017543857	359	10557	11	19	348	10538	10916	0.09824981117435051
R1	cpdb	0	network_modules	34	TRUE	4.97092016669709e-7	75	31	7	0.22580645161290322	0.09333333333333334	KEGG:05214	KEGG	Glioma	8484	465		0.2962962962962963	0.32142857142857145	75	8409	7	24	68	8385	8484	0.14036715931405985
R1	cpdb	0	network_modules	34	TRUE	5.34249099540007e-7	128	36	8	0.2222222222222222	0.0625	GO:0044839	GO:BP	cell cycle G2/M phase transition	16175	11188		0.3225806451612903	0.34375	128	16047	8	28	120	16019	16175	0.1142339706729137
R1	cpdb	0	network_modules	34	TRUE	5.46159291733705e-7	76	31	7	0.22580645161290322	0.09210526315789473	KEGG:05220	KEGG	Chronic myeloid leukemia	8484	471		0.3333333333333333	0.39285714285714285	76	8408	7	24	69	8384	8484	0.13937316826726606
R1	cpdb	0	network_modules	34	TRUE	5.46159291733705e-7	76	31	7	0.22580645161290322	0.09210526315789473	KEGG:05212	KEGG	Pancreatic cancer	8484	463		0.3333333333333333	0.39285714285714285	76	8408	7	24	69	8384	8484	0.13937316826726606
R1	cpdb	0	network_modules	34	TRUE	7.324555214299351e-7	630	36	13	0.3611111111111111	0.020634920634920634	GO:0010564	GO:BP	regulation of cell cycle process	16175	4217		0.3548387096774194	0.375	630	15545	13	23	617	15522	16175	0.07864408425126503
R1	cpdb	0	network_modules	34	TRUE	1.15925412640624e-6	141	36	8	0.2222222222222222	0.05673758865248227	GO:2000045	GO:BP	regulation of G1/S transition of mitotic cell cycle	16175	25406		0.3870967741935484	0.40625	141	16034	8	28	133	16006	16175	0.10847631349671895
R1	cpdb	0	network_modules	34	TRUE	1.1898805179449876e-6	86	36	7	0.19444444444444445	0.08139534883720931	GO:0010389	GO:BP	regulation of G2/M transition of mitotic cell cycle	16175	4098		0.41935483870967744	0.4375	86	16089	7	29	79	16060	16175	0.12282828360678379
R1	cpdb	0	network_modules	34	TRUE	1.5639917836106795e-6	198	31	9	0.2903225806451613	0.045454545454545456	KEGG:05169	KEGG	Epstein-Barr virus infection	8484	450		0.4074074074074074	0.42857142857142855	198	8286	9	22	189	8264	8484	0.10709202097862744
R1	cpdb	0	network_modules	34	TRUE	1.7829101741698864e-6	201	31	9	0.2903225806451613	0.04477611940298507	KEGG:05203	KEGG	Viral carcinogenesis	8484	455		0.4444444444444444	0.4642857142857143	201	8283	9	22	192	8261	8484	0.10616826824828064
R1	cpdb	0	network_modules	34	TRUE	1.871497612949978e-6	224	36	9	0.25	0.04017857142857143	GO:1901988	GO:BP	negative regulation of cell cycle phase transition	16175	21921		0.45161290322580644	0.46875	224	15951	9	27	215	15924	16175	0.09543988612313098
R1	cpdb	0	network_modules	34	TRUE	3.0062477331548973e-6	98	36	7	0.19444444444444445	0.07142857142857142	GO:1902749	GO:BP	regulation of cell cycle G2/M phase transition	16175	22475		0.4838709677419355	0.5	98	16077	7	29	91	16048	16175	0.11465411481579359
R1	cpdb	0	network_modules	34	TRUE	3.017171868596923e-6	159	36	8	0.2222222222222222	0.050314465408805034	GO:1901991	GO:BP	negative regulation of mitotic cell cycle phase transition	16175	21924		0.5161290322580645	0.53125	159	16016	8	28	151	15988	16175	0.10167642720440152
R1	cpdb	0	network_modules	34	TRUE	3.0455827843800094e-6	97	31	7	0.22580645161290322	0.07216494845360824	KEGG:05215	KEGG	Prostate cancer	8484	466		0.48148148148148145	0.5	97	8387	7	24	90	8363	8484	0.12211170759612504
R1	cpdb	0	network_modules	34	TRUE	3.6070365262572296e-6	218	31	9	0.2903225806451613	0.04128440366972477	KEGG:05166	KEGG	Human T-cell leukemia virus 1 infection	8484	447		0.5185185185185185	0.5357142857142857	218	8266	9	22	209	8244	8484	0.10128252759813935
R1	cpdb	0	network_modules	34	TRUE	3.761235363201945e-6	338	36	10	0.2777777777777778	0.029585798816568046	GO:0045786	GO:BP	negative regulation of cell cycle	16175	11618		0.5483870967741935	0.5625	338	15837	10	26	328	15811	16175	0.08481935508461837
R1	cpdb	0	network_modules	34	TRUE	4.245275464736088e-6	166	36	8	0.2222222222222222	0.04819277108433735	GO:1902806	GO:BP	regulation of cell cycle G1/S phase transition	16175	22525		0.5806451612903226	0.59375	166	16009	8	28	158	15981	16175	0.09932850745872211
R1	cpdb	0	network_modules	34	TRUE	4.692568973105812e-6	158	31	8	0.25806451612903225	0.05063291139240506	KEGG:05160	KEGG	Hepatitis C	8484	441		0.5555555555555556	0.5714285714285714	158	8326	8	23	150	8303	8484	0.10725764364241175
R1	cpdb	0	network_modules	34	TRUE	7.412655612478878e-6	262	36	9	0.25	0.03435114503816794	GO:0010948	GO:BP	negative regulation of cell cycle process	16175	4526		0.6129032258064516	0.625	262	15913	9	27	253	15886	16175	0.0874740184831015
R1	cpdb	0	network_modules	34	TRUE	1.0645174268426191e-5	13	30	4	0.13333333333333333	0.3076923076923077	REAC:R-HSA-113501	REAC	Inhibition of replication initiation of damaged DNA by RB1/E2F1	10916	1198		0.5	0.5087719298245614	13	10903	4	26	9	10877	10916	0.20113496126496025
R1	cpdb	0	network_modules	34	TRUE	1.2822282937245815e-5	36	30	5	0.16666666666666666	0.1388888888888889	REAC:R-HSA-2173796	REAC	SMAD2/SMAD3:SMAD4 heterotrimer regulates transcription	10916	2154		0.5178571428571429	0.5263157894736842	36	10880	5	25	31	10855	10916	0.14958680684386044
R1	cpdb	0	network_modules	34	TRUE	1.4653672164753162e-5	69	36	6	0.16666666666666666	0.08695652173913043	GO:1901992	GO:BP	positive regulation of mitotic cell cycle phase transition	16175	21925		0.6451612903225806	0.65625	69	16106	6	30	63	16076	16175	0.11768661337466839
R1	cpdb	0	network_modules	34	TRUE	1.9908426448005096e-5	202	36	8	0.2222222222222222	0.039603960396039604	GO:0045930	GO:BP	negative regulation of mitotic cell cycle	16175	11724		0.6774193548387096	0.6875	202	15973	8	28	194	15945	16175	0.08919833613160316
R1	cpdb	0	network_modules	34	TRUE	2.4304438147358743e-5	131	31	7	0.22580645161290322	0.05343511450381679	KEGG:04068	KEGG	FoxO signaling pathway	8484	258		0.5925925925925926	0.6071428571428571	131	8353	7	24	124	8329	8484	0.10332227310192889
R1	cpdb	0	network_modules	34	TRUE	2.4442071677220695e-5	4	30	3	0.1	0.75	REAC:R-HSA-69200	REAC	Phosphorylation of proteins involved in G1/S transition by active Cyclin E:Cdk2 complexes	10916	1751		0.5357142857142857	0.543859649122807	4	10912	3	27	1	10885	10916	0.27328354770919544
R1	cpdb	0	network_modules	34	TRUE	5.326599908886041e-5	147	31	7	0.22580645161290322	0.047619047619047616	KEGG:05224	KEGG	Breast cancer	8484	475		0.6296296296296297	0.6428571428571429	147	8337	7	24	140	8313	8484	0.09675564602966703
R1	cpdb	0	network_modules	34	TRUE	5.577066026965658e-5	148	31	7	0.22580645161290322	0.0472972972972973	KEGG:05226	KEGG	Gastric cancer	8484	477		0.6666666666666666	0.6785714285714286	148	8336	7	24	141	8312	8484	0.09637947724790073
R1	cpdb	0	network_modules	34	TRUE	5.5934799608821955e-5	86	36	6	0.16666666666666666	0.06976744186046512	GO:1901989	GO:BP	positive regulation of cell cycle phase transition	16175	21922		0.7096774193548387	0.71875	86	16089	6	30	80	16059	16175	0.10478809902924538
R1	cpdb	0	network_modules	34	TRUE	6.099179907906202e-5	5	30	3	0.1	0.6	REAC:R-HSA-9754119	REAC	Drug-mediated inhibition of CDK4/CDK6 activity	10916	804		0.5535714285714286	0.5964912280701754	5	10911	3	27	2	10884	10916	0.24421868194433108
R1	cpdb	0	network_modules	34	TRUE	6.099179907906202e-5	5	30	3	0.1	0.6	REAC:R-HSA-111448	REAC	Activation of NOXA and translocation to mitochondria	10916	90		0.5535714285714286	0.5964912280701754	5	10911	3	27	2	10884	10916	0.24421868194433108
R1	cpdb	0	network_modules	34	TRUE	6.099179907906202e-5	5	30	3	0.1	0.6	REAC:R-HSA-68911	REAC	G2 Phase	10916	1004		0.5535714285714286	0.5964912280701754	5	10911	3	27	2	10884	10916	0.24421868194433108
R1	cpdb	0	network_modules	34	TRUE	6.974586551275855e-5	95	31	6	0.1935483870967742	0.06315789473684211	KEGG:01522	KEGG	Endocrine resistance	8484	196		0.7037037037037037	0.7142857142857143	95	8389	6	25	89	8364	8484	0.10494625314200527
R1	cpdb	0	network_modules	34	TRUE	7.015916513307977e-5	50	30	5	0.16666666666666666	0.1	REAC:R-HSA-2173793	REAC	Transcriptional activity of SMAD2/SMAD3:SMAD4 heterotrimer	10916	2550		0.6071428571428571	0.6140350877192983	50	10866	5	25	45	10841	10916	0.12601326646709482
R1	cpdb	0	network_modules	34	TRUE	8.967864535434117e-5	93	36	6	0.16666666666666666	0.06451612903225806	GO:0045931	GO:BP	positive regulation of mitotic cell cycle	16175	11725		0.7419354838709677	0.75	93	16082	6	30	87	16052	16175	0.10051891596258176
R1	cpdb	0	network_modules	34	TRUE	1.0615455195095075e-4	102	31	6	0.1935483870967742	0.058823529411764705	KEGG:04914	KEGG	Progesterone-mediated oocyte maturation	8484	371		0.7407407407407407	0.75	102	8382	6	25	96	8357	8484	0.10086498143173683
R1	cpdb	0	network_modules	34	TRUE	1.209560852601198e-4	166	31	7	0.22580645161290322	0.04216867469879518	KEGG:05225	KEGG	Hepatocellular carcinoma	8484	476		0.7777777777777778	0.7857142857142857	166	8318	7	24	159	8294	8484	0.0901749501554776
R1	cpdb	0	network_modules	34	TRUE	1.2197117805893614e-4	330	31	9	0.2903225806451613	0.02727272727272727	KEGG:05165	KEGG	Human papillomavirus infection	8484	446		0.8148148148148148	0.8214285714285714	330	8154	9	22	321	8132	8484	0.07874874619729721
R1	cpdb	0	network_modules	34	TRUE	1.7403590754787806e-4	5	36	3	0.08333333333333333	0.6	GO:0070345	GO:BP	negative regulation of fat cell proliferation	16175	16067		0.7741935483870968	0.78125	5	16170	3	33	2	16137	16175	0.2230601506959967
R1	cpdb	0	network_modules	34	TRUE	2.0753327428221153e-4	21	36	4	0.1111111111111111	0.19047619047619047	GO:0010971	GO:BP	positive regulation of G2/M transition of mitotic cell cycle	16175	4547		0.8064516129032258	0.8125	21	16154	4	32	17	16122	16175	0.1440325176618291
R1	cpdb	0	network_modules	34	TRUE	2.1267990379185867e-4	7	30	3	0.1	0.42857142857142855	REAC:R-HSA-2980767	REAC	Activation of NIMA Kinases NEK9, NEK6, NEK7	10916	88		0.625	0.631578947368421	7	10909	3	27	4	10882	10916	0.2060414376901555
R1	cpdb	0	network_modules	34	TRUE	3.420708005301576e-4	194	31	7	0.22580645161290322	0.03608247422680412	KEGG:05167	KEGG	Kaposi sarcoma-associated herpesvirus infection	8484	448		0.8518518518518519	0.8571428571428571	194	8290	7	24	187	8266	8484	0.08221770306850801
R1	cpdb	0	network_modules	34	TRUE	3.667159019966261e-4	24	36	4	0.1111111111111111	0.16666666666666666	GO:1902751	GO:BP	positive regulation of cell cycle G2/M phase transition	16175	22477		0.8387096774193549	0.84375	24	16151	4	32	20	16119	16175	0.13451501842518168
R1	cpdb	0	network_modules	34	TRUE	3.83437069722608e-4	61	36	5	0.1388888888888889	0.08196721311475409	GO:2000134	GO:BP	negative regulation of G1/S transition of mitotic cell cycle	16175	25483		0.8709677419354839	0.875	61	16114	5	31	56	16083	16175	0.10411245158056635
R1	cpdb	0	network_modules	34	TRUE	4.5764495393480045e-4	131	31	6	0.1935483870967742	0.04580152671755725	KEGG:04114	KEGG	Oocyte meiosis	8484	268		0.8888888888888888	0.8928571428571429	131	8353	6	25	125	8328	8484	0.08747854101819465
R1	cpdb	0	network_modules	34	TRUE	5.085396598619778e-4	9	30	3	0.1	0.3333333333333333	REAC:R-HSA-139915	REAC	Activation of PUMA and translocation to mitochondria	10916	93		0.6428571428571429	0.6491228070175439	9	10907	3	27	6	10880	10916	0.1813930210169564
R1	cpdb	0	network_modules	34	TRUE	5.714186068143112e-4	66	36	5	0.1388888888888889	0.07575757575757576	GO:1902807	GO:BP	negative regulation of cell cycle G1/S phase transition	16175	22526		0.9032258064516129	0.90625	66	16109	5	31	61	16078	16175	0.09987764751893267
R1	cpdb	0	network_modules	34	TRUE	6.072629089234312e-4	7	36	3	0.08333333333333333	0.42857142857142855	GO:0043550	GO:BP	regulation of lipid kinase activity	16175	10764		0.9354838709677419	0.96875	7	16168	3	33	4	16135	16175	0.18825111540602296
R1	cpdb	0	network_modules	34	TRUE	6.072629089234312e-4	7	36	3	0.08333333333333333	0.42857142857142855	GO:0070344	GO:BP	regulation of fat cell proliferation	16175	16066		0.9354838709677419	0.96875	7	16168	3	33	4	16135	16175	0.18825111540602296
R1	cpdb	0	network_modules	34	TRUE	6.633460672963554e-4	34	30	4	0.13333333333333333	0.11764705882352941	REAC:R-HSA-8953750	REAC	Transcriptional Regulation by E2F6	10916	2543		0.6607142857142857	0.6666666666666666	34	10882	4	26	30	10856	10916	0.12267874457871261
R1	cpdb	0	network_modules	34	TRUE	8.555470765085383e-4	223	31	7	0.22580645161290322	0.03139013452914798	KEGG:05163	KEGG	Human cytomegalovirus infection	8484	444		0.9259259259259259	0.9285714285714286	223	8261	7	24	216	8237	8484	0.07552616329635733
R1	cpdb	0	network_modules	34	TRUE	9.701339779040485e-4	8	36	3	0.08333333333333333	0.375	GO:0070341	GO:BP	fat cell proliferation	16175	16063		1	1	8	16167	3	33	5	16134	16175	0.17596691334509712
R1	cpdb	0	network_modules	34	TRUE	9.952147011478643e-4	11	30	3	0.1	0.2727272727272727	REAC:R-HSA-2514853	REAC	Condensation of Prometaphase Chromosomes	10916	394		0.6785714285714286	0.6842105263157895	11	10905	3	27	8	10878	10916	0.1637880634428025
R1	cpdb	0	network_modules	34	TRUE	0.0012062380904062928	88	30	5	0.16666666666666666	0.056818181818181816	REAC:R-HSA-9616222	REAC	Transcriptional regulation of granulopoiesis	10916	2559		0.6964285714285714	0.7017543859649122	88	10828	5	25	83	10803	10916	0.09310900664860915
R1	cpdb	0	network_modules	34	TRUE	0.001502631218216259	92	30	5	0.16666666666666666	0.05434782608695652	REAC:R-HSA-1912408	REAC	Pre-NOTCH Transcription and Translation	10916	1786		0.7142857142857143	0.7368421052631579	92	10824	5	25	87	10799	10916	0.0908688037600272
R1	cpdb	0	network_modules	34	TRUE	0.001502631218216259	92	30	5	0.16666666666666666	0.05434782608695652	REAC:R-HSA-170834	REAC	Signaling by TGF-beta Receptor Complex	10916	2308		0.7142857142857143	0.7368421052631579	92	10824	5	25	87	10799	10916	0.0908688037600272
R1	cpdb	0	network_modules	34	TRUE	0.0015468700155954955	162	31	6	0.1935483870967742	0.037037037037037035	KEGG:05161	KEGG	Hepatitis B	8484	442		0.9629629629629629	0.9642857142857143	162	8322	6	25	156	8297	8484	0.07719420451470739
R1	cpdb	0	network_modules	34	TRUE	0.0017186456118868769	13	30	3	0.1	0.23076923076923078	REAC:R-HSA-162658	REAC	Golgi Cisternae Pericentriolar Stack Reorganization	10916	1083		0.75	0.7543859649122807	13	10903	3	27	10	10876	10916	0.15039804678586643
R1	cpdb	0	network_modules	34	TRUE	0.0021833103686978873	14	30	3	0.1	0.21428571428571427	REAC:R-HSA-6804116	REAC	TP53 Regulates Transcription of Genes Involved in G1 Cell Cycle Arrest	10916	2459		0.7678571428571429	0.7719298245614035	14	10902	3	27	11	10875	10916	0.1447994587155795
R1	cpdb	0	network_modules	34	TRUE	0.003303204354280976	108	30	5	0.16666666666666666	0.046296296296296294	REAC:R-HSA-1912422	REAC	Pre-NOTCH Expression and Processing	10916	1783		0.7857142857142857	0.7894736842105263	108	10808	5	25	103	10783	10916	0.08315273269133061
R1	cpdb	0	network_modules	34	TRUE	0.0033464923142724297	16	30	3	0.1	0.1875	REAC:R-HSA-2995383	REAC	Initiation of Nuclear Envelope (NE) Reformation	10916	1201		0.8035714285714286	0.8070175438596491	16	10900	3	27	13	10873	10916	0.1352085064936884
R1	cpdb	0	network_modules	34	TRUE	0.003460419734068625	51	30	4	0.13333333333333333	0.0784313725490196	REAC:R-HSA-9006927	REAC	Signaling by Non-Receptor Tyrosine Kinases	10916	2288		0.8214285714285714	0.8421052631578947	51	10865	4	26	47	10839	10916	0.09904622898951383
R1	cpdb	0	network_modules	34	TRUE	0.003460419734068625	51	30	4	0.13333333333333333	0.0784313725490196	REAC:R-HSA-8848021	REAC	Signaling by PTK6	10916	2295		0.8214285714285714	0.8421052631578947	51	10865	4	26	47	10839	10916	0.09904622898951383
R1	cpdb	0	network_modules	34	TRUE	0.005086368891593861	118	30	5	0.16666666666666666	0.0423728813559322	REAC:R-HSA-8878166	REAC	Transcriptional regulation by RUNX2	10916	2553		0.8571428571428571	0.8596491228070176	118	10798	5	25	113	10773	10916	0.07912308429508753
R1	cpdb	0	network_modules	34	TRUE	0.005980069169300823	122	30	5	0.16666666666666666	0.040983606557377046	REAC:R-HSA-9006936	REAC	Signaling by TGFB family members	10916	2310		0.875	0.8771929824561403	122	10794	5	25	117	10769	10916	0.0776466065963565
R1	cpdb	0	network_modules	34	TRUE	0.0066374537794103875	60	30	4	0.13333333333333333	0.06666666666666667	REAC:R-HSA-187577	REAC	SCF(Skp2)-mediated degradation of p27/p21	10916	2129		0.8928571428571429	0.8947368421052632	60	10856	4	26	56	10830	10916	0.0907685477187666
R1	cpdb	0	network_modules	34	TRUE	0.007146417525407455	3	30	2	0.06666666666666667	0.6666666666666666	REAC:R-HSA-9630750	REAC	Evasion of Oncogene Induced Senescence Due to p16INK4A Defects	10916	877		0.9107142857142857	1	3	10913	2	28	1	10885	10916	0.21026742396583623
R1	cpdb	0	network_modules	34	TRUE	0.007146417525407455	3	30	2	0.06666666666666667	0.6666666666666666	REAC:R-HSA-9632700	REAC	Evasion of Oxidative Stress Induced Senescence Due to Defective p16INK4A binding to CDK4 and CDK6	10916	879		0.9107142857142857	1	3	10913	2	28	1	10885	10916	0.21026742396583623
R1	cpdb	0	network_modules	34	TRUE	0.007146417525407455	3	30	2	0.06666666666666667	0.6666666666666666	REAC:R-HSA-9632693	REAC	Evasion of Oxidative Stress Induced Senescence Due to p16INK4A Defects	10916	881		0.9107142857142857	1	3	10913	2	28	1	10885	10916	0.21026742396583623
R1	cpdb	0	network_modules	34	TRUE	0.007146417525407455	3	30	2	0.06666666666666667	0.6666666666666666	REAC:R-HSA-9630794	REAC	Evasion of Oncogene Induced Senescence Due to Defective p16INK4A binding to CDK4 and CDK6	10916	875		0.9107142857142857	1	3	10913	2	28	1	10885	10916	0.21026742396583623
R1	cpdb	0	network_modules	34	TRUE	0.007146417525407455	3	30	2	0.06666666666666667	0.6666666666666666	REAC:R-HSA-9675132	REAC	Diseases of cellular response to stress	10916	764		0.9107142857142857	1	3	10913	2	28	1	10885	10916	0.21026742396583623
R1	cpdb	0	network_modules	34	TRUE	0.007146417525407455	3	30	2	0.06666666666666667	0.6666666666666666	REAC:R-HSA-9630747	REAC	Diseases of Cellular Senescence	10916	756		0.9107142857142857	1	3	10913	2	28	1	10885	10916	0.21026742396583623
R1	cpdb	0	network_modules	34	TRUE	0.009040838972364242	138	31	5	0.16129032258064516	0.036231884057971016	KEGG:05162	KEGG	Measles	8484	443		1	1	138	8346	5	26	133	8320	8484	0.06942860624284525
R1	cpdb	0	network_modules	35	TRUE	1.0198654562997863e-37	19	32	16	0.5	0.8421052631578947	REAC:R-HSA-77595	REAC	Processing of Intronless Pre-mRNAs	10916	1799		0	0.05263157894736842	19	10897	16	16	3	10881	10916	0.6481410158837951
R1	cpdb	0	network_modules	35	TRUE	3.162252657067195e-33	28	32	16	0.5	0.5714285714285714	REAC:R-HSA-75067	REAC	Processing of Capped Intronless Pre-mRNA	10916	1797		0.05555555555555555	0.10526315789473684	28	10888	16	16	12	10872	10916	0.5332458453340956
R1	cpdb	0	network_modules	35	TRUE	1.422575069502078e-28	96	31	19	0.6129032258064516	0.19791666666666666	KEGG:03015	KEGG	mRNA surveillance pathway	8484	210		0	0.3333333333333333	96	8388	19	12	77	8376	8484	0.34443737547285
R1	cpdb	0	network_modules	35	TRUE	4.164565288396218e-27	56	32	16	0.5	0.2857142857142857	REAC:R-HSA-72187	REAC	mRNA 3'-end processing	10916	2701		0.1111111111111111	0.15789473684210525	56	10860	16	16	40	10844	10916	0.37560068559733323
R1	cpdb	0	network_modules	35	TRUE	6.39953107551116e-26	65	32	16	0.5	0.24615384615384617	REAC:R-HSA-73856	REAC	RNA Polymerase II Transcription Termination	10916	1895		0.16666666666666666	0.21052631578947367	65	10851	16	16	49	10835	10916	0.34819263675361545
R1	cpdb	0	network_modules	35	TRUE	7.712629453540444e-22	33	35	12	0.34285714285714286	0.36363636363636365	GO:0031124	GO:BP	mRNA 3'-end processing	16175	7049		0	0.06666666666666667	33	16142	12	23	21	16119	16175	0.351732176869798
R1	cpdb	0	network_modules	35	TRUE	9.205145857120345e-19	80	35	13	0.37142857142857144	0.1625	GO:0031123	GO:BP	RNA 3'-end processing	16175	7048		0.07142857142857142	0.13333333333333333	80	16095	13	22	67	16073	16175	0.24327053032045398
R1	cpdb	0	network_modules	35	TRUE	5.872401974202526e-17	276	32	17	0.53125	0.06159420289855073	REAC:R-HSA-72203	REAC	Processing of Capped Intron-Containing Pre-mRNA	10916	1796		0.2222222222222222	0.2631578947368421	276	10640	17	15	259	10625	10916	0.17475927724884716
R1	cpdb	0	network_modules	35	TRUE	2.0919807968847402e-16	7	35	7	0.2	1	GO:0180012	GO:BP	co-transcriptional RNA 3'-end processing, cleavage and polyadenylation pathway	16175	20297		0.14285714285714285	0.2	7	16168	7	28	0	16140	16175	0.4468261818799998
R1	cpdb	0	network_modules	35	TRUE	1.1663875001665305e-13	6	35	6	0.17142857142857143	1	GO:0180010	GO:BP	co-transcriptional mRNA 3'-end processing, cleavage and polyadenylation pathway	16175	20295		0.21428571428571427	0.26666666666666666	6	16169	6	29	0	16140	16175	0.4136678676904319
R1	cpdb	0	network_modules	35	TRUE	5.653874201318059e-13	62	31	10	0.3225806451612903	0.16129032258064516	KEGG:03250	KEGG	Viral life cycle - HIV-1	8484	223		0.5	0.6666666666666666	62	8422	10	21	52	8401	8484	0.2241604932485666
R1	cpdb	0	network_modules	35	TRUE	6.914362902586185e-10	96	35	9	0.2571428571428571	0.09375	GO:0032784	GO:BP	regulation of DNA-templated transcription elongation	16175	7819		0.2857142857142857	0.3333333333333333	96	16079	9	26	87	16053	16175	0.15229809958784357
R1	cpdb	0	network_modules	35	TRUE	1.0694996477259736e-9	57	32	8	0.25	0.14035087719298245	REAC:R-HSA-112382	REAC	Formation of RNA Pol II elongation complex 	10916	949		0.2777777777777778	0.3684210526315789	57	10859	8	24	49	10835	10916	0.18415555849882548
R1	cpdb	0	network_modules	35	TRUE	1.0694996477259736e-9	57	32	8	0.25	0.14035087719298245	REAC:R-HSA-75955	REAC	RNA Polymerase II Transcription Elongation	10916	1891		0.2777777777777778	0.3684210526315789	57	10859	8	24	49	10835	10916	0.18415555849882548
R1	cpdb	0	network_modules	35	TRUE	3.6868011188944406e-9	38	32	7	0.21875	0.18421052631578946	REAC:R-HSA-159231	REAC	Transport of Mature mRNA Derived from an Intronless Transcript	10916	2585		0.3888888888888889	0.42105263157894735	38	10878	7	25	31	10853	10916	0.19817969602761865
R1	cpdb	0	network_modules	35	TRUE	4.4842650111061355e-9	39	32	7	0.21875	0.1794871794871795	REAC:R-HSA-159234	REAC	Transport of Mature mRNAs Derived from Intronless Transcripts	10916	2587		0.4444444444444444	0.47368421052631576	39	10877	7	25	32	10852	10916	0.19554817195365712
R1	cpdb	0	network_modules	35	TRUE	4.617923950605896e-9	118	35	9	0.2571428571428571	0.07627118644067797	GO:0006354	GO:BP	DNA-templated transcription elongation	16175	2131		0.35714285714285715	0.4	118	16057	9	26	109	16031	16175	0.13671891566920705
R1	cpdb	0	network_modules	35	TRUE	8.43106888215868e-9	73	32	8	0.25	0.1095890410958904	REAC:R-HSA-6807505	REAC	RNA polymerase II transcribes snRNA genes	10916	1904		0.5	0.5263157894736842	73	10843	8	24	65	10819	10916	0.16187233608756402
R1	cpdb	0	network_modules	35	TRUE	8.898268697353764e-9	352	35	12	0.34285714285714286	0.03409090909090909	GO:0006397	GO:BP	mRNA processing	16175	2158		0.42857142857142855	0.4666666666666667	352	15823	12	23	340	15800	16175	0.10248128585037017
R1	cpdb	0	network_modules	35	TRUE	1.0453727094989556e-8	81	35	8	0.22857142857142856	0.09876543209876543	GO:0034243	GO:BP	regulation of transcription elongation by RNA polymerase II	16175	8519		0.5	0.5333333333333333	81	16094	8	27	73	16067	16175	0.1474868595198856
R1	cpdb	0	network_modules	35	TRUE	1.2945239722994365e-8	590	35	14	0.4	0.023728813559322035	GO:0016071	GO:BP	mRNA metabolic process	16175	5098		0.5714285714285714	0.6	590	15585	14	21	576	15564	16175	0.09029842470622146
R1	cpdb	0	network_modules	35	TRUE	1.7932925379806432e-8	80	32	8	0.25	0.1	REAC:R-HSA-674695	REAC	RNA Polymerase II Pre-transcription Events	10916	1888		0.5555555555555556	0.5789473684210527	80	10836	8	24	72	10812	10916	0.15427060732195486
R1	cpdb	0	network_modules	35	TRUE	7.478287634415739e-8	103	35	8	0.22857142857142856	0.07766990291262135	GO:0006368	GO:BP	transcription elongation by RNA polymerase II	16175	2143		0.6428571428571429	0.6666666666666666	103	16072	8	27	95	16045	16175	0.13008404047689853
R1	cpdb	0	network_modules	35	TRUE	8.528138762638585e-7	80	32	7	0.21875	0.0875	REAC:R-HSA-72202	REAC	Transport of Mature Transcript to Cytoplasm	10916	2584		0.6111111111111112	0.631578947368421	80	10836	7	25	73	10811	10916	0.1344044084081376
R1	cpdb	0	network_modules	35	TRUE	1.3417303512001743e-6	48	35	6	0.17142857142857143	0.125	GO:0032968	GO:BP	positive regulation of transcription elongation by RNA polymerase II	16175	7952		0.7142857142857143	0.7333333333333333	48	16127	6	29	42	16098	16175	0.1442210269172051
R1	cpdb	0	network_modules	35	TRUE	3.913034481200964e-6	57	35	6	0.17142857142857143	0.10526315789473684	GO:0032786	GO:BP	positive regulation of DNA-templated transcription, elongation	16175	7821		0.7857142857142857	0.8	57	16118	6	29	51	16089	16175	0.1319459836934438
R1	cpdb	0	network_modules	35	TRUE	2.1207630900899515e-5	192	31	8	0.25806451612903225	0.041666666666666664	KEGG:05202	KEGG	Transcriptional misregulation in cancer	8484	454		1	1	192	8292	8	23	184	8269	8484	0.09586595548897613
R1	cpdb	0	network_modules	35	TRUE	6.619658099174301e-5	4	35	3	0.08571428571428572	0.75	GO:0110104	GO:BP	mRNA alternative polyadenylation	16175	19416		0.8571428571428571	0.8666666666666667	4	16171	3	32	1	16139	16175	0.25312003612333916
R1	cpdb	0	network_modules	35	TRUE	1.6540792258058472e-4	55	32	5	0.15625	0.09090909090909091	REAC:R-HSA-6784531	REAC	tRNA processing in the nucleus	10916	2745		0.6666666666666666	0.6842105263157895	55	10861	5	27	50	10834	10916	0.11580115459969356
R1	cpdb	0	network_modules	35	TRUE	6.975234742232191e-4	32	32	4	0.125	0.125	REAC:R-HSA-167287	REAC	HIV elongation arrest and recovery	10916	1106		0.7222222222222222	0.7894736842105263	32	10884	4	28	28	10856	10916	0.12242741639103269
R1	cpdb	0	network_modules	35	TRUE	6.975234742232191e-4	32	32	4	0.125	0.125	REAC:R-HSA-167290	REAC	Pausing and recovery of HIV elongation	10916	1719		0.7222222222222222	0.7894736842105263	32	10884	4	28	28	10856	10916	0.12242741639103269
R1	cpdb	0	network_modules	35	TRUE	0.0025690747640400536	44	32	4	0.125	0.09090909090909091	REAC:R-HSA-167152	REAC	Formation of HIV elongation complex in the absence of HIV Tat	10916	946		0.8333333333333334	0.8421052631578947	44	10872	4	28	40	10844	10916	0.10352329059496106
R1	cpdb	0	network_modules	35	TRUE	0.0028127601080061774	2	32	2	0.0625	1	REAC:R-HSA-176034	REAC	Interactions of Tat with host cellular proteins	10916	1222		0.8888888888888888	0.8947368421052632	2	10914	2	30	0	10884	10916	0.2496561681772773
R1	cpdb	0	network_modules	35	TRUE	0.003769251415651854	103	32	5	0.15625	0.04854368932038835	REAC:R-HSA-72306	REAC	tRNA processing	10916	2743		0.9444444444444444	0.9473684210526315	103	10813	5	27	98	10786	10916	0.08234190721195886
R1	cpdb	0	network_modules	35	TRUE	0.004670228387163061	13	35	3	0.08571428571428572	0.23076923076923078	GO:0051290	GO:BP	protein heterotetramerization	16175	13622		0.9285714285714286	0.9333333333333333	13	16162	3	32	10	16130	16175	0.13953048614874553
R1	cpdb	0	network_modules	35	TRUE	0.009103873202138783	16	35	3	0.08571428571428572	0.1875	GO:0042795	GO:BP	snRNA transcription by RNA polymerase II	16175	10372		1	1	16	16159	3	32	13	16127	16175	0.1255080059505054
R1	cpdb	0	network_modules	35	TRUE	0.009537183101091395	61	32	4	0.125	0.06557377049180328	REAC:R-HSA-6796648	REAC	TP53 Regulates Transcription of DNA Repair Genes	10916	2456		1	1	61	10855	4	28	57	10827	10916	0.08685842033101886
R1	cpdb	0	network_modules	36	TRUE	9.488030932498155e-8	6	25	4	0.16	0.6666666666666666	GO:0038173	GO:BP	interleukin-17A-mediated signaling pathway	16175	9749		0	0.1111111111111111	6	16169	4	21	2	16148	16175	0.32615404812435905
R1	cpdb	0	network_modules	36	TRUE	2.3798671330604888e-7	71	17	6	0.35294117647058826	0.08450704225352113	REAC:R-HSA-448424	REAC	Interleukin-17 signaling	10916	1238		0	0.25	71	10845	6	11	65	10834	10916	0.17020602564877604
R1	cpdb	0	network_modules	36	TRUE	1.861853022027406e-5	4	25	3	0.12	0.75	GO:0097398	GO:BP	cellular response to interleukin-17	16175	18645		0.125	0.7777777777777778	4	16171	3	22	1	16149	16175	0.29965044535356145
R1	cpdb	0	network_modules	36	TRUE	1.861853022027406e-5	4	25	3	0.12	0.75	GO:0097400	GO:BP	interleukin-17-mediated signaling pathway	16175	18647		0.125	0.7777777777777778	4	16171	3	22	1	16149	16175	0.29965044535356145
R1	cpdb	0	network_modules	36	TRUE	1.861853022027406e-5	4	25	3	0.12	0.75	GO:2000338	GO:BP	regulation of chemokine (C-X-C motif) ligand 1 production	16175	25657		0.125	0.7777777777777778	4	16171	3	22	1	16149	16175	0.29965044535356145
R1	cpdb	0	network_modules	36	TRUE	1.861853022027406e-5	4	25	3	0.12	0.75	GO:0097396	GO:BP	response to interleukin-17	16175	18643		0.125	0.7777777777777778	4	16171	3	22	1	16149	16175	0.29965044535356145
R1	cpdb	0	network_modules	36	TRUE	1.861853022027406e-5	4	25	3	0.12	0.75	GO:0072566	GO:BP	chemokine (C-X-C motif) ligand 1 production	16175	17444		0.125	0.7777777777777778	4	16171	3	22	1	16149	16175	0.29965044535356145
R1	cpdb	0	network_modules	36	TRUE	1.861853022027406e-5	4	25	3	0.12	0.75	GO:2000340	GO:BP	positive regulation of chemokine (C-X-C motif) ligand 1 production	16175	25659		0.125	0.7777777777777778	4	16171	3	22	1	16149	16175	0.29965044535356145
R1	cpdb	0	network_modules	36	TRUE	6.335379830861127e-5	92	18	5	0.2777777777777778	0.05434782608695652	KEGG:04657	KEGG	IL-17 signaling pathway	8484	335		0	0.5	92	8392	5	13	87	8379	8484	0.11884331488424575
R1	cpdb	0	network_modules	36	TRUE	6.614602175032336e-5	472	17	8	0.47058823529411764	0.01694915254237288	REAC:R-HSA-449147	REAC	Signaling by Interleukins	10916	2261		0.3333333333333333	0.5	472	10444	8	9	464	10435	10916	0.08297989391968859
R1	cpdb	0	network_modules	36	TRUE	2.7405148382537536e-4	120	17	5	0.29411764705882354	0.041666666666666664	REAC:R-HSA-9705671	REAC	SARS-CoV-2 activates/modulates innate and adaptive immune responses	10916	2123		0.6666666666666666	0.75	120	10796	5	12	115	10784	10916	0.10723837403099336
R1	cpdb	0	network_modules	36	TRUE	5.412492777039177e-4	142	18	5	0.2777777777777778	0.035211267605633804	KEGG:04936	KEGG	Alcoholic liver disease	8484	393		1	1	142	8342	5	13	137	8329	8484	0.09382665304730915
R1	cpdb	0	network_modules	36	TRUE	0.001391593848909313	50	25	4	0.16	0.08	GO:0031098	GO:BP	stress-activated protein kinase signaling cascade	16175	7024		0.875	0.8888888888888888	50	16125	4	21	46	16104	16175	0.11120914324016563
R1	cpdb	0	network_modules	36	TRUE	0.00314620450847254	197	17	5	0.29411764705882354	0.025380710659898477	REAC:R-HSA-9705683	REAC	SARS-CoV-2-host interactions	10916	2128		1	1	197	10719	5	12	192	10707	10916	0.08190394067160928
R1	cpdb	0	network_modules	36	TRUE	0.00341389442426915	419	25	7	0.28	0.016706443914081145	GO:0019221	GO:BP	cytokine-mediated signaling pathway	16175	5598		1	1	419	15756	7	18	412	15738	16175	0.06293548238799908
R1	cpdb	0	network_modules	37	TRUE	2.008784941724693e-8	14	24	5	0.20833333333333334	0.35714285714285715	REAC:R-HSA-2032785	REAC	YAP1- and WWTR1 (TAZ)-stimulated gene expression	10916	2678		0	0.2	14	10902	5	19	9	10883	10916	0.2715658549146352
R1	cpdb	0	network_modules	37	TRUE	9.411055575701623e-5	27	24	4	0.16666666666666666	0.14814814814814814	REAC:R-HSA-9733709	REAC	Cardiogenesis	10916	307		0.25	0.4	27	10889	4	20	23	10869	10916	0.15516533568011806
R1	cpdb	0	network_modules	37	TRUE	1.6024980144192498e-4	8	24	3	0.125	0.375	REAC:R-HSA-8951671	REAC	RUNX3 regulates YAP1-mediated transcription	10916	1937		0.5	0.6	8	10908	3	21	5	10887	10916	0.21555298653975913
R1	cpdb	0	network_modules	37	TRUE	1.9196267394968206e-4	62	32	5	0.15625	0.08064516129032258	GO:0003279	GO:BP	cardiac septum development	16175	1703		0	0.043478260869565216	62	16113	5	27	57	16086	16175	0.10981870047798331
R1	cpdb	0	network_modules	37	TRUE	2.183685663875761e-4	211	32	7	0.21875	0.03317535545023697	GO:0048568	GO:BP	embryonic organ development	16175	12840		0.045454545454545456	0.08695652173913043	211	15964	7	25	204	15939	16175	0.08071612258674878
R1	cpdb	0	network_modules	37	TRUE	3.600824481175372e-4	7	32	3	0.09375	0.42857142857142855	GO:0003162	GO:BP	atrioventricular node development	16175	1592		0.09090909090909091	0.13043478260869565	7	16168	3	29	4	16139	16175	0.19976152254110363
R1	cpdb	0	network_modules	37	TRUE	4.180848073375121e-4	140	32	6	0.1875	0.04285714285714286	GO:0048738	GO:BP	cardiac muscle tissue development	16175	12995		0.13636363636363635	0.17391304347826086	140	16035	6	26	134	16009	16175	0.0859616318304591
R1	cpdb	0	network_modules	37	TRUE	5.144535683993714e-4	145	32	6	0.1875	0.041379310344827586	GO:0048732	GO:BP	gland development	16175	12989		0.18181818181818182	0.21739130434782608	145	16030	6	26	139	16004	16175	0.08433368848823677
R1	cpdb	0	network_modules	37	TRUE	6.405621524115073e-4	512	32	9	0.28125	0.017578125	GO:0009790	GO:BP	embryo development	16175	3677		0.22727272727272727	0.2608695652173913	512	15663	9	23	503	15640	16175	0.06347353601775675
R1	cpdb	0	network_modules	37	TRUE	7.290967932555497e-4	33	32	4	0.125	0.12121212121212122	GO:0003161	GO:BP	cardiac conduction system development	16175	1591		0.2727272727272727	0.30434782608695654	33	16142	4	28	29	16114	16175	0.12132623285808623
R1	cpdb	0	network_modules	37	TRUE	7.350725926802669e-4	29	14	3	0.21428571428571427	0.10344827586206896	KEGG:04392	KEGG	Hippo signaling pathway - multiple species	8484	312		0	0.5	29	8455	3	11	26	8444	8484	0.14688479731774942
R1	cpdb	0	network_modules	37	TRUE	8.364655092880647e-4	83	32	5	0.15625	0.060240963855421686	GO:0003206	GO:BP	cardiac chamber morphogenesis	16175	1636		0.3181818181818182	0.34782608695652173	83	16092	5	27	78	16065	16175	0.09416751039677992
R1	cpdb	0	network_modules	37	TRUE	0.0010326379204348781	14	24	3	0.125	0.21428571428571427	REAC:R-HSA-5578768	REAC	Physiological factors	10916	1754		0.75	0.8	14	10902	3	21	11	10881	10916	0.1622666560263468
R1	cpdb	0	network_modules	37	TRUE	0.0019159932204315716	98	32	5	0.15625	0.05102040816326531	GO:0003205	GO:BP	cardiac chamber development	16175	1635		0.36363636363636365	0.391304347826087	98	16077	5	27	93	16050	16175	0.0861700397905369
R1	cpdb	0	network_modules	37	TRUE	0.002382166529198762	44	32	4	0.125	0.09090909090909091	GO:0035329	GO:BP	hippo signaling	16175	8973		0.4090909090909091	0.43478260869565216	44	16131	4	28	40	16103	16175	0.10452609431994424
R1	cpdb	0	network_modules	37	TRUE	0.0026259999991660823	791	32	10	0.3125	0.012642225031605562	GO:0000122	GO:BP	negative regulation of transcription by RNA polymerase II	16175	48		0.45454545454545453	0.4782608695652174	791	15384	10	22	781	15362	16175	0.054418348138486144
R1	cpdb	0	network_modules	37	TRUE	0.003395626883773551	48	32	4	0.125	0.08333333333333333	GO:0060411	GO:BP	cardiac septum morphogenesis	16175	14612		0.5	0.5217391304347826	48	16127	4	28	44	16099	16175	0.09988611011958307
R1	cpdb	0	network_modules	37	TRUE	0.003692340225155554	49	32	4	0.125	0.08163265306122448	GO:0001890	GO:BP	placenta development	16175	516		0.5454545454545454	0.5652173913043478	49	16126	4	28	45	16098	16175	0.09881458875773916
R1	cpdb	0	network_modules	37	TRUE	0.004124970601876365	207	32	6	0.1875	0.028985507246376812	GO:0014706	GO:BP	striated muscle tissue development	16175	4643		0.5909090909090909	0.6086956521739131	207	15968	6	26	201	15942	16175	0.06920154218204039
R1	cpdb	0	network_modules	37	TRUE	0.004959319277248285	23	24	3	0.125	0.13043478260869565	REAC:R-HSA-8940973	REAC	RUNX2 regulates osteoblast differentiation	10916	1930		1	1	23	10893	3	21	20	10872	10916	0.1258070015753195
R1	cpdb	0	network_modules	37	TRUE	0.005576234529139214	2	32	2	0.0625	1	GO:0060717	GO:BP	chorion development	16175	14890		0.6363636363636364	0.8260869565217391	2	16173	2	30	0	16143	16175	0.2497680244466571
R1	cpdb	0	network_modules	37	TRUE	0.005576234529139214	2	32	2	0.0625	1	GO:0060718	GO:BP	chorionic trophoblast cell differentiation	16175	14891		0.6363636363636364	0.8260869565217391	2	16173	2	30	0	16143	16175	0.2497680244466571
R1	cpdb	0	network_modules	37	TRUE	0.005576234529139214	2	32	2	0.0625	1	GO:1902511	GO:BP	negative regulation of apoptotic DNA fragmentation	16175	22323		0.6363636363636364	0.8260869565217391	2	16173	2	30	0	16143	16175	0.2497680244466571
R1	cpdb	0	network_modules	37	TRUE	0.005576234529139214	2	32	2	0.0625	1	GO:0032877	GO:BP	positive regulation of DNA endoreduplication	16175	7874		0.6363636363636364	0.8260869565217391	2	16173	2	30	0	16143	16175	0.2497680244466571
R1	cpdb	0	network_modules	37	TRUE	0.005576234529139214	2	32	2	0.0625	1	GO:1903625	GO:BP	negative regulation of DNA catabolic process	16175	23159		0.6363636363636364	0.8260869565217391	2	16173	2	30	0	16143	16175	0.2497680244466571
R1	cpdb	0	network_modules	37	TRUE	0.006019391427532807	221	32	6	0.1875	0.027149321266968326	GO:0060537	GO:BP	muscle tissue development	16175	14726		0.8636363636363636	0.8695652173913043	221	15954	6	26	215	15928	16175	0.06667120312872003
R1	cpdb	0	network_modules	37	TRUE	0.006338937240410283	56	32	4	0.125	0.07142857142857142	GO:0003151	GO:BP	outflow tract morphogenesis	16175	1583		0.9090909090909091	0.9130434782608695	56	16119	4	28	52	16091	16175	0.09212461892928021
R1	cpdb	0	network_modules	37	TRUE	0.0066791837044600155	60	14	3	0.21428571428571427	0.05	KEGG:04330	KEGG	Notch signaling pathway	8484	301		1	1	60	8424	3	11	57	8413	8484	0.10053247606192928
R1	cpdb	0	network_modules	37	TRUE	0.008610491649824024	701	32	9	0.28125	0.012838801711840228	GO:0060429	GO:BP	epithelium development	16175	14627		0.9545454545454546	0.9565217391304348	701	15474	9	23	692	15451	16175	0.052021433071571296
R1	cpdb	0	network_modules	37	TRUE	0.009440653711777873	239	32	6	0.1875	0.02510460251046025	GO:0060485	GO:BP	mesenchyme development	16175	14679		1	1	239	15936	6	26	233	15910	16175	0.06373698427139998
R1	cpdb	0	network_modules	38	TRUE	7.391451353026307e-56	83	35	29	0.8285714285714286	0.3493975903614458	REAC:R-HSA-9843745	REAC	Adipogenesis	10916	122		0	0.5	83	10833	29	6	54	10827	10916	0.5360137227607473
R1	cpdb	0	network_modules	38	TRUE	7.391451353026307e-56	83	35	29	0.8285714285714286	0.3493975903614458	REAC:R-HSA-381340	REAC	Transcriptional regulation of white adipocyte differentiation	10916	2562		0	0.5	83	10833	29	6	54	10827	10916	0.5360137227607473
R1	cpdb	0	network_modules	38	TRUE	6.3580360130549185e-55	55	39	26	0.6666666666666666	0.4727272727272727	GO:0060261	GO:BP	positive regulation of transcription initiation by RNA polymerase II	16175	14478		0	0.0625	55	16120	26	13	29	16107	16175	0.5601479567990547
R1	cpdb	0	network_modules	38	TRUE	2.1648541560951593e-53	61	39	26	0.6666666666666666	0.4262295081967213	GO:2000144	GO:BP	positive regulation of DNA-templated transcription initiation	16175	25492		0.06666666666666667	0.125	61	16114	26	13	35	16101	16175	0.5316882565227702
R1	cpdb	0	network_modules	38	TRUE	2.928856627653389e-52	66	39	26	0.6666666666666666	0.3939393939393939	GO:0060260	GO:BP	regulation of transcription initiation by RNA polymerase II	16175	14477		0.13333333333333333	0.1875	66	16109	26	13	40	16096	16175	0.5109928705649416
R1	cpdb	0	network_modules	38	TRUE	2.864910190206035e-51	113	35	29	0.8285714285714286	0.25663716814159293	REAC:R-HSA-1989781	REAC	PPARA activates gene expression	10916	1700		0.6666666666666666	0.75	113	10803	29	6	84	10797	10916	0.4584813139348624
R1	cpdb	0	network_modules	38	TRUE	3.8402878478829767e-51	114	35	29	0.8285714285714286	0.2543859649122807	REAC:R-HSA-400206	REAC	Regulation of lipid metabolism by PPARalpha	10916	2041		1	1	114	10802	29	6	85	10796	10916	0.4564360212516234
R1	cpdb	0	network_modules	38	TRUE	4.862609395679216e-51	72	39	26	0.6666666666666666	0.3611111111111111	GO:2000142	GO:BP	regulation of DNA-templated transcription initiation	16175	25490		0.2	0.25	72	16103	26	13	46	16090	16175	0.48905561648373386
R1	cpdb	0	network_modules	38	TRUE	7.160143922875744e-51	48	39	24	0.6153846153846154	0.5	GO:0032968	GO:BP	positive regulation of transcription elongation by RNA polymerase II	16175	7952		0.26666666666666666	0.3125	48	16127	24	15	24	16112	16175	0.5535138955492491
R1	cpdb	0	network_modules	38	TRUE	1.656854632066535e-48	57	39	24	0.6153846153846154	0.42105263157894735	GO:0032786	GO:BP	positive regulation of DNA-templated transcription, elongation	16175	7821		0.3333333333333333	0.375	57	16118	24	15	33	16103	16175	0.5076193592585722
R1	cpdb	0	network_modules	38	TRUE	5.4863177684857715e-47	64	39	24	0.6153846153846154	0.375	GO:0051123	GO:BP	RNA polymerase II preinitiation complex assembly	16175	13507		0.4	0.4375	64	16111	24	15	40	16096	16175	0.4788204173713647
R1	cpdb	0	network_modules	38	TRUE	2.1239609322524943e-46	67	39	24	0.6153846153846154	0.3582089552238806	GO:0070897	GO:BP	transcription preinitiation complex assembly	16175	16360		0.4666666666666667	0.5	67	16108	24	15	43	16093	16175	0.4678794011579127
R1	cpdb	0	network_modules	38	TRUE	4.970205359895561e-44	81	39	24	0.6153846153846154	0.2962962962962963	GO:0034243	GO:BP	regulation of transcription elongation by RNA polymerase II	16175	8519		0.5333333333333333	0.5625	81	16094	24	15	57	16079	16175	0.4251108823390891
R1	cpdb	0	network_modules	38	TRUE	4.0140864105154526e-42	143	39	26	0.6666666666666666	0.18181818181818182	GO:0006367	GO:BP	transcription initiation at RNA polymerase II promoter	16175	2142		0.6	0.625	143	16032	26	13	117	16019	16175	0.3454838284479233
R1	cpdb	0	network_modules	38	TRUE	5.55197507696778e-42	96	39	24	0.6153846153846154	0.25	GO:0032784	GO:BP	regulation of DNA-templated transcription elongation	16175	7819		0.6666666666666666	0.6875	96	16079	24	15	72	16064	16175	0.39007782540784997
R1	cpdb	0	network_modules	38	TRUE	3.7711505631927043e-41	103	39	24	0.6153846153846154	0.23300970873786409	GO:0006368	GO:BP	transcription elongation by RNA polymerase II	16175	2143		0.7333333333333333	0.75	103	16072	24	15	79	16057	16175	0.37640408079165977
R1	cpdb	0	network_modules	38	TRUE	8.634418467803116e-40	173	39	26	0.6666666666666666	0.15028901734104047	GO:0006352	GO:BP	DNA-templated transcription initiation	16175	2129		0.8	0.8125	173	16002	26	13	147	15989	16175	0.3135113038287111
R1	cpdb	0	network_modules	38	TRUE	1.4481017200289161e-39	118	39	24	0.6153846153846154	0.2033898305084746	GO:0006354	GO:BP	DNA-templated transcription elongation	16175	2131		0.8666666666666667	0.875	118	16057	24	15	94	16042	16175	0.35129573789066315
R1	cpdb	0	network_modules	38	TRUE	7.7754173582074e-37	183	39	25	0.6410256410256411	0.1366120218579235	GO:0065004	GO:BP	protein-DNA complex assembly	16175	15888		0.9333333333333333	0.9375	183	15992	25	14	158	15978	16175	0.2927140745709978
R1	cpdb	0	network_modules	38	TRUE	1.7972614736793548e-35	206	39	25	0.6410256410256411	0.12135922330097088	GO:0071824	GO:BP	protein-DNA complex organization	16175	16927		1	1	206	15969	25	14	181	15955	16175	0.2754649098703815
R1	cpdb	0	network_modules	38	TRUE	4.427911458499992e-18	121	16	12	0.75	0.09917355371900827	KEGG:04919	KEGG	Thyroid hormone signaling pathway	8484	376		NA	1	121	8363	12	4	109	8359	8484	0.2697240036050098
R1	cpdb	0	network_modules	39	TRUE	9.367014434614695e-5	34	19	4	0.21052631578947367	0.11764705882352941	REAC:R-HSA-156590	REAC	Glutathione conjugation	10916	1058		0	0.14285714285714285	34	10882	4	15	30	10867	10916	0.15542687671542843
R1	cpdb	0	network_modules	39	TRUE	1.984935016014039e-4	36	22	4	0.18181818181818182	0.1111111111111111	GO:0006749	GO:BP	glutathione metabolic process	16175	2447		0	0.2	36	16139	4	18	32	16121	16175	0.14064611112510816
R1	cpdb	0	network_modules	39	TRUE	3.252727467070485e-4	46	19	4	0.21052631578947367	0.08695652173913043	REAC:R-HSA-69231	REAC	Cyclin D associated events in G1	10916	420		0.16666666666666666	0.42857142857142855	46	10870	4	15	42	10855	10916	0.1329897968704431
R1	cpdb	0	network_modules	39	TRUE	3.252727467070485e-4	46	19	4	0.21052631578947367	0.08695652173913043	REAC:R-HSA-69236	REAC	G1 Phase	10916	1000		0.16666666666666666	0.42857142857142855	46	10870	4	15	42	10855	10916	0.1329897968704431
R1	cpdb	0	network_modules	39	TRUE	3.784267986401175e-4	56	19	4	0.21052631578947367	0.07142857142857142	KEGG:00480	KEGG	Glutathione metabolism	8484	61		0	0.1111111111111111	56	8428	4	15	52	8413	8484	0.11931074831004
R1	cpdb	0	network_modules	39	TRUE	7.774881098938205e-4	67	19	4	0.21052631578947367	0.05970149253731343	KEGG:05204	KEGG	Chemical carcinogenesis - DNA adducts	8484	456		0.125	0.2222222222222222	67	8417	4	15	63	8402	8484	0.10845503635359485
R1	cpdb	0	network_modules	39	TRUE	8.249093121172893e-4	68	19	4	0.21052631578947367	0.058823529411764705	KEGG:00982	KEGG	Drug metabolism - cytochrome P450	8484	156		0.25	0.3333333333333333	68	8416	4	15	64	8401	8484	0.10759838869129934
R1	cpdb	0	network_modules	39	TRUE	9.534406584359109e-4	17	19	3	0.15789473684210525	0.17647058823529413	REAC:R-HSA-9661069	REAC	Defective binding of RB1 mutants to E2F1,(E2F2, E2F3)	10916	689		0.5	0.7142857142857143	17	10899	3	16	14	10883	10916	0.16555104323798445
R1	cpdb	0	network_modules	39	TRUE	9.534406584359109e-4	17	19	3	0.15789473684210525	0.17647058823529413	REAC:R-HSA-9659787	REAC	Aberrant regulation of mitotic G1/S transition in cancer due to RB1 defects	10916	47		0.5	0.7142857142857143	17	10899	3	16	14	10883	10916	0.16555104323798445
R1	cpdb	0	network_modules	39	TRUE	0.0010361842585209233	72	19	4	0.21052631578947367	0.05555555555555555	KEGG:01524	KEGG	Platinum drug resistance	8484	198		0.375	0.4444444444444444	72	8412	4	15	68	8397	8484	0.10434819171944792
R1	cpdb	0	network_modules	39	TRUE	0.001155609782492812	74	19	4	0.21052631578947367	0.05405405405405406	KEGG:00980	KEGG	Metabolism of xenobiotics by cytochrome P450	8484	154		0.5	0.5555555555555556	74	8410	4	15	70	8395	8484	0.10282055028072079
R1	cpdb	0	network_modules	39	TRUE	0.0014983329184208643	79	19	4	0.21052631578947367	0.05063291139240506	KEGG:00983	KEGG	Drug metabolism - other enzymes	8484	157		0.625	0.6666666666666666	79	8405	4	15	75	8390	8484	0.09925244545487512
R1	cpdb	0	network_modules	39	TRUE	0.0015520004266385225	166	19	5	0.2631578947368421	0.030120481927710843	KEGG:05225	KEGG	Hepatocellular carcinoma	8484	476		0.75	0.7777777777777778	166	8318	5	14	161	8304	8484	0.0833226125271863
R1	cpdb	0	network_modules	39	TRUE	0.0018367152956497196	62	22	4	0.18181818181818182	0.06451612903225806	GO:1904029	GO:BP	regulation of cyclin-dependent protein kinase activity	16175	23470		0.25	0.4	62	16113	4	18	58	16095	16175	0.10629886972237569
R1	cpdb	0	network_modules	39	TRUE	0.0027354220788410816	92	19	4	0.21052631578947367	0.043478260869565216	KEGG:05222	KEGG	Small cell lung cancer	8484	473		0.875	0.8888888888888888	92	8392	4	15	88	8377	8484	0.09134337617712722
R1	cpdb	0	network_modules	39	TRUE	0.003314246886999841	20	22	3	0.13636363636363635	0.15	GO:0042178	GO:BP	xenobiotic catabolic process	16175	10006		0.5	0.8	20	16155	3	19	17	16136	16175	0.14190679921914243
R1	cpdb	0	network_modules	39	TRUE	0.003314246886999841	20	22	3	0.13636363636363635	0.15	GO:1904030	GO:BP	negative regulation of cyclin-dependent protein kinase activity	16175	23471		0.5	0.8	20	16155	3	19	17	16136	16175	0.14190679921914243
R1	cpdb	0	network_modules	39	TRUE	0.006104709927597636	221	19	5	0.2631578947368421	0.02262443438914027	KEGG:05208	KEGG	Chemical carcinogenesis - reactive oxygen species	8484	460		1	1	221	8263	5	14	216	8249	8484	0.07052559367360092
R1	cpdb	0	network_modules	39	TRUE	0.007153384906324254	3	22	2	0.09090909090909091	0.6666666666666666	GO:0018916	GO:BP	nitrobenzene metabolic process	16175	5478		1	1	3	16172	2	20	1	16152	16175	0.2458707737811223
R1	cpdb	0	network_modules	39	TRUE	0.009268066854336402	106	19	4	0.21052631578947367	0.03773584905660377	REAC:R-HSA-156580	REAC	Phase II - Conjugation of compounds	10916	1738		0.8333333333333334	0.8571428571428571	106	10810	4	15	102	10795	10916	0.08551040240800872
R1	cpdb	0	network_modules	39	TRUE	0.009804028720571397	36	19	3	0.15789473684210525	0.08333333333333333	REAC:R-HSA-9687139	REAC	Aberrant regulation of mitotic cell cycle due to RB1 defects	10916	48		1	1	36	10880	3	16	33	10864	10916	0.11259567942006121
R1	cpdb	0	network_modules	40	TRUE	1.8309038520968124e-14	298	15	12	0.8	0.040268456375838924	REAC:R-HSA-1474244	REAC	Extracellular matrix organization	10916	889		0	0.07692307692307693	298	10618	12	3	286	10615	10916	0.17589672624490632
R1	cpdb	0	network_modules	40	TRUE	1.109842714625505e-12	30	15	7	0.4666666666666667	0.23333333333333334	REAC:R-HSA-3000157	REAC	Laminin interactions	10916	1303		0.08333333333333333	0.15384615384615385	30	10886	7	8	23	10878	10916	0.3287174801047051
R1	cpdb	0	network_modules	40	TRUE	1.8254311733954374e-10	59	15	7	0.4666666666666667	0.11864406779661017	REAC:R-HSA-3000171	REAC	Non-integrin membrane-ECM interactions	10916	1603		0.16666666666666666	0.23076923076923078	59	10857	7	8	52	10849	10916	0.23336864811790156
R1	cpdb	0	network_modules	40	TRUE	2.180851027000644e-9	15	15	5	0.3333333333333333	0.3333333333333333	REAC:R-HSA-2214320	REAC	Anchoring fibril formation	10916	146		0.25	0.3076923076923077	15	10901	5	10	10	10891	10916	0.332415986300951
R1	cpdb	0	network_modules	40	TRUE	2.914813274284115e-8	89	11	6	0.5454545454545454	0.06741573033707865	KEGG:04512	KEGG	ECM-receptor interaction	8484	314		0	0.14285714285714285	89	8395	6	5	83	8390	8484	0.18918982444075122
R1	cpdb	0	network_modules	40	TRUE	9.11971777322219e-8	140	15	7	0.4666666666666667	0.05	REAC:R-HSA-1474228	REAC	Degradation of the extracellular matrix	10916	726		0.3333333333333333	0.38461538461538464	140	10776	7	8	133	10768	10916	0.14961920449355132
R1	cpdb	0	network_modules	40	TRUE	3.674648545327332e-7	89	15	6	0.4	0.06741573033707865	REAC:R-HSA-1474290	REAC	Collagen formation	10916	387		0.4166666666666667	0.46153846153846156	89	10827	6	9	83	10818	10916	0.16163791996341462
R1	cpdb	0	network_modules	40	TRUE	3.4533366073822875e-6	92	11	5	0.45454545454545453	0.05434782608695652	KEGG:05222	KEGG	Small cell lung cancer	8484	473		0.16666666666666666	0.2857142857142857	92	8392	5	6	87	8386	8484	0.15436280352911164
R1	cpdb	0	network_modules	40	TRUE	3.831991039259252e-6	60	15	5	0.3333333333333333	0.08333333333333333	REAC:R-HSA-2022090	REAC	Assembly of collagen fibrils and other multimeric structures	10916	177		0.5	0.5384615384615384	60	10856	5	10	55	10846	10916	0.16448381308160195
R1	cpdb	0	network_modules	40	TRUE	5.532552337948631e-6	101	11	5	0.45454545454545453	0.04950495049504951	KEGG:05146	KEGG	Amoebiasis	8484	438		0.3333333333333333	0.42857142857142855	101	8383	5	6	96	8377	8484	0.14705145163009448
R1	cpdb	0	network_modules	40	TRUE	1.948123557157042e-5	30	15	4	0.26666666666666666	0.13333333333333333	REAC:R-HSA-8874081	REAC	MET activates PTK2 signaling	10916	1362		0.5833333333333334	0.6153846153846154	30	10886	4	11	26	10875	10916	0.18700399127517345
R1	cpdb	0	network_modules	40	TRUE	2.932956547754276e-5	622	20	9	0.45	0.014469453376205787	GO:0030155	GO:BP	regulation of cell adhesion	16175	6688		0	0.16666666666666666	622	15553	9	11	613	15542	16175	0.07530459640511714
R1	cpdb	0	network_modules	40	TRUE	6.444318907339537e-5	40	15	4	0.26666666666666666	0.1	REAC:R-HSA-8875878	REAC	MET promotes cell motility	10916	1368		0.6666666666666666	0.6923076923076923	40	10876	4	11	36	10865	10916	0.16146223966071696
R1	cpdb	0	network_modules	40	TRUE	1.0821353212881183e-4	11	15	3	0.2	0.2727272727272727	REAC:R-HSA-446107	REAC	Type I hemidesmosome assembly	10916	2612		0.75	0.7692307692307693	11	10905	3	12	8	10893	10916	0.232650018567167
R1	cpdb	0	network_modules	40	TRUE	1.7533636493526563e-4	202	11	5	0.45454545454545453	0.024752475247524754	KEGG:04510	KEGG	Focal adhesion	8484	313		0.5	0.5714285714285714	202	8282	5	6	197	8276	8484	0.10179963064376499
R1	cpdb	0	network_modules	40	TRUE	2.8850843832136465e-4	373	20	7	0.35	0.01876675603217158	GO:0045785	GO:BP	positive regulation of cell adhesion	16175	11617		0.2	0.3333333333333333	373	15802	7	13	366	15789	16175	0.07664133307022142
R1	cpdb	0	network_modules	40	TRUE	4.348860574101986e-4	236	20	6	0.3	0.025423728813559324	GO:0030198	GO:BP	extracellular matrix organization	16175	6707		0.4	0.5	236	15939	6	14	230	15925	16175	0.083750579306198
R1	cpdb	0	network_modules	40	TRUE	4.458477244143321e-4	237	20	6	0.3	0.02531645569620253	GO:0043062	GO:BP	extracellular structure organization	16175	10509		0.6	0.6666666666666666	237	15938	6	14	231	15924	16175	0.08355822151328578
R1	cpdb	0	network_modules	40	TRUE	4.480099090075591e-4	108	11	4	0.36363636363636365	0.037037037037037035	KEGG:05145	KEGG	Toxoplasmosis	8484	437		0.6666666666666666	0.7142857142857143	108	8376	4	7	104	8369	8484	0.11278195638498147
R1	cpdb	0	network_modules	40	TRUE	4.570357979551209e-4	238	20	6	0.3	0.025210084033613446	GO:0045229	GO:BP	external encapsulating structure organization	16175	11340		0.8	0.8333333333333334	238	15937	6	14	232	15923	16175	0.08336704388955249
R1	cpdb	0	network_modules	40	TRUE	8.787274401004924e-4	76	15	4	0.26666666666666666	0.05263157894736842	REAC:R-HSA-6806834	REAC	Signaling by MET	10916	2270		0.8333333333333334	0.8461538461538461	76	10840	4	11	72	10829	10916	0.1158600930317808
R1	cpdb	0	network_modules	40	TRUE	0.0013130128681743023	84	15	4	0.26666666666666666	0.047619047619047616	REAC:R-HSA-216083	REAC	Integrin cell surface interactions	10916	1216		0.9166666666666666	0.9230769230769231	84	10832	4	11	80	10821	10916	0.10993451323266923
R1	cpdb	0	network_modules	40	TRUE	0.0019257680319933915	330	11	5	0.45454545454545453	0.015151515151515152	KEGG:05165	KEGG	Human papillomavirus infection	8484	446		0.8333333333333334	0.8571428571428571	330	8154	5	6	325	8148	8484	0.07745732782413926
R1	cpdb	0	network_modules	40	TRUE	0.0027758769776647036	356	11	5	0.45454545454545453	0.014044943820224719	KEGG:04151	KEGG	PI3K-Akt signaling pathway	8484	285		1	1	356	8128	5	6	351	8122	8484	0.07414366612153757
R1	cpdb	0	network_modules	40	TRUE	0.0031173179234363978	21	20	3	0.15	0.14285714285714285	GO:0071711	GO:BP	basement membrane organization	16175	16875		1	1	21	16154	3	17	18	16137	16175	0.14530215429655982
R1	cpdb	0	network_modules	40	TRUE	0.008452542807022203	44	15	3	0.2	0.06818181818181818	REAC:R-HSA-8948216	REAC	Collagen chain trimerization	10916	385		1	1	44	10872	3	12	41	10860	10916	0.11473153115446968
R1	cpdb	0	network_modules	41	TRUE	4.781681310831042e-6	74	14	5	0.35714285714285715	0.06756756756756757	KEGG:04115	KEGG	p53 signaling pathway	8484	269		0	0.3333333333333333	74	8410	5	9	69	8401	8484	0.1523396258541179
R1	cpdb	0	network_modules	41	TRUE	1.2820316364356766e-5	359	18	8	0.4444444444444444	0.022284122562674095	REAC:R-HSA-3700989	REAC	Transcriptional Regulation by TP53	10916	2546		0	0.25	359	10557	8	10	351	10547	10916	0.09378617461553929
R1	cpdb	0	network_modules	41	TRUE	4.7364683595037214e-5	148	22	6	0.2727272727272727	0.04054054054054054	GO:0072331	GO:BP	signal transduction by p53 class mediator	16175	17354		NA	1	148	16027	6	16	142	16011	16175	0.10215982595082246
R1	cpdb	0	network_modules	41	TRUE	2.0809626382491722e-4	44	18	4	0.2222222222222222	0.09090909090909091	REAC:R-HSA-5633008	REAC	TP53 Regulates Transcription of Cell Death Genes	10916	2455		0.3333333333333333	0.5	44	10872	4	14	40	10858	10916	0.13995326336431607
R1	cpdb	0	network_modules	41	TRUE	0.0013017118112608717	20	18	3	0.16666666666666666	0.15	REAC:R-HSA-6803204	REAC	TP53 Regulates Transcription of Genes Involved in Cytochrome C Release	10916	2458		0.6666666666666666	0.75	20	10896	3	15	17	10881	10916	0.1566483883772208
R1	cpdb	0	network_modules	41	TRUE	0.001440411033446014	160	18	5	0.2777777777777778	0.03125	REAC:R-HSA-5633007	REAC	Regulation of TP53 Activity	10916	2012		1	1	160	10756	5	13	155	10743	10916	0.08898063498755844
R1	cpdb	0	network_modules	41	TRUE	0.003127891090969885	135	14	4	0.2857142857142857	0.02962962962962963	KEGG:04210	KEGG	Apoptosis	8484	287		0.5	0.6666666666666666	135	8349	4	10	131	8339	8484	0.08765647268625237
R1	cpdb	0	network_modules	41	TRUE	0.005364257505533883	155	14	4	0.2857142857142857	0.025806451612903226	KEGG:04218	KEGG	Cellular senescence	8484	295		1	1	155	8329	4	10	151	8319	8484	0.08118850201325158
R1	cpdb	0	network_modules	42	TRUE	4.5165809876597955e-8	157	19	8	0.42105263157894735	0.050955414012738856	KEGG:04390	KEGG	Hippo signaling pathway	8484	310		0	0.14285714285714285	157	8327	8	11	149	8316	8484	0.14150985667314095
R1	cpdb	0	network_modules	42	TRUE	8.14235290824342e-8	31	14	5	0.35714285714285715	0.16129032258064516	REAC:R-HSA-4641262	REAC	Disassembly of the destruction complex and recruitment of AXIN to the membrane	10916	746		0	0.058823529411764705	31	10885	5	9	26	10876	10916	0.2385910830737245
R1	cpdb	0	network_modules	42	TRUE	5.289944355365527e-7	14	14	4	0.2857142857142857	0.2857142857142857	REAC:R-HSA-5467340	REAC	AXIN missense mutants destabilize the destruction complex	10916	42		0.0625	0.4117647058823529	14	10902	4	10	10	10892	10916	0.28479702282674213
R1	cpdb	0	network_modules	42	TRUE	5.289944355365527e-7	14	14	4	0.2857142857142857	0.2857142857142857	REAC:R-HSA-5467337	REAC	APC truncation mutants have impaired AXIN binding	10916	22		0.0625	0.4117647058823529	14	10902	4	10	10	10892	10916	0.28479702282674213
R1	cpdb	0	network_modules	42	TRUE	5.289944355365527e-7	14	14	4	0.2857142857142857	0.2857142857142857	REAC:R-HSA-4839748	REAC	Signaling by AMER1 mutants	10916	2220		0.0625	0.4117647058823529	14	10902	4	10	10	10892	10916	0.28479702282674213
R1	cpdb	0	network_modules	42	TRUE	5.289944355365527e-7	14	14	4	0.2857142857142857	0.2857142857142857	REAC:R-HSA-4839744	REAC	Signaling by APC mutants	10916	2221		0.0625	0.4117647058823529	14	10902	4	10	10	10892	10916	0.28479702282674213
R1	cpdb	0	network_modules	42	TRUE	5.289944355365527e-7	14	14	4	0.2857142857142857	0.2857142857142857	REAC:R-HSA-4839735	REAC	Signaling by AXIN mutants	10916	2222		0.0625	0.4117647058823529	14	10902	4	10	10	10892	10916	0.28479702282674213
R1	cpdb	0	network_modules	42	TRUE	5.289944355365527e-7	14	14	4	0.2857142857142857	0.2857142857142857	REAC:R-HSA-5467348	REAC	Truncations of AMER1 destabilize the destruction complex	10916	2609		0.0625	0.4117647058823529	14	10902	4	10	10	10892	10916	0.28479702282674213
R1	cpdb	0	network_modules	42	TRUE	7.208269529951795e-7	15	14	4	0.2857142857142857	0.26666666666666666	REAC:R-HSA-5358751	REAC	CTNNB1 S45 mutants aren't phosphorylated	10916	291		0.4375	0.7647058823529411	15	10901	4	10	11	10891	10916	0.2750640631766487
R1	cpdb	0	network_modules	42	TRUE	7.208269529951795e-7	15	14	4	0.2857142857142857	0.26666666666666666	REAC:R-HSA-5358749	REAC	CTNNB1 S37 mutants aren't phosphorylated	10916	290		0.4375	0.7647058823529411	15	10901	4	10	11	10891	10916	0.2750640631766487
R1	cpdb	0	network_modules	42	TRUE	7.208269529951795e-7	15	14	4	0.2857142857142857	0.26666666666666666	REAC:R-HSA-5358747	REAC	CTNNB1 S33 mutants aren't phosphorylated	10916	289		0.4375	0.7647058823529411	15	10901	4	10	11	10891	10916	0.2750640631766487
R1	cpdb	0	network_modules	42	TRUE	7.208269529951795e-7	15	14	4	0.2857142857142857	0.26666666666666666	REAC:R-HSA-5339716	REAC	Signaling by GSK3beta mutants	10916	2257		0.4375	0.7647058823529411	15	10901	4	10	11	10891	10916	0.2750640631766487
R1	cpdb	0	network_modules	42	TRUE	7.208269529951795e-7	15	14	4	0.2857142857142857	0.26666666666666666	REAC:R-HSA-4839743	REAC	Signaling by CTNNB1 phospho-site mutants	10916	2228		0.4375	0.7647058823529411	15	10901	4	10	11	10891	10916	0.2750640631766487
R1	cpdb	0	network_modules	42	TRUE	7.208269529951795e-7	15	14	4	0.2857142857142857	0.26666666666666666	REAC:R-HSA-5358752	REAC	CTNNB1 T41 mutants aren't phosphorylated	10916	292		0.4375	0.7647058823529411	15	10901	4	10	11	10891	10916	0.2750640631766487
R1	cpdb	0	network_modules	42	TRUE	1.254983334394844e-6	17	14	4	0.2857142857142857	0.23529411764705882	REAC:R-HSA-196299	REAC	Beta-catenin phosphorylation cascade	10916	217		0.8125	0.8235294117647058	17	10899	4	10	13	10889	10916	0.2582348989999625
R1	cpdb	0	network_modules	42	TRUE	2.4150956720353342e-5	34	14	4	0.2857142857142857	0.11764705882352941	REAC:R-HSA-4791275	REAC	Signaling by WNT in cancer	10916	2315		0.875	0.8823529411764706	34	10882	4	10	30	10872	10916	0.18174068754756642
R1	cpdb	0	network_modules	42	TRUE	4.3589572707915963e-4	58	19	4	0.21052631578947367	0.06896551724137931	KEGG:05213	KEGG	Endometrial cancer	8484	464		0.16666666666666666	0.2857142857142857	58	8426	4	15	54	8411	8484	0.11711399286009172
R1	cpdb	0	network_modules	42	TRUE	6.076601205553569e-4	63	19	4	0.21052631578947367	0.06349206349206349	KEGG:05217	KEGG	Basal cell carcinoma	8484	468		0.3333333333333333	0.42857142857142855	63	8421	4	15	59	8406	8484	0.11207868319741028
R1	cpdb	0	network_modules	42	TRUE	7.526930737194878e-4	143	19	5	0.2631578947368421	0.03496503496503497	KEGG:04550	KEGG	Signaling pathways regulating pluripotency of stem cells	8484	319		0.5	0.5714285714285714	143	8341	5	14	138	8327	8484	0.09064752748558359
R1	cpdb	0	network_modules	42	TRUE	8.897717064986633e-4	148	19	5	0.2631578947368421	0.033783783783783786	KEGG:05226	KEGG	Gastric cancer	8484	477		0.6666666666666666	0.7142857142857143	148	8336	5	14	143	8322	8484	0.08891661498512943
R1	cpdb	0	network_modules	42	TRUE	9.231049130102203e-4	83	14	4	0.2857142857142857	0.04819277108433735	REAC:R-HSA-195253	REAC	Degradation of beta-catenin by the destruction complex	10916	724		0.9375	0.9411764705882353	83	10833	4	10	79	10823	10916	0.11473048844210888
R1	cpdb	0	network_modules	42	TRUE	0.0020705803827586904	29	19	3	0.15789473684210525	0.10344827586206896	KEGG:04392	KEGG	Hippo signaling pathway - multiple species	8484	312		0.8333333333333334	0.8571428571428571	29	8455	3	16	26	8439	8484	0.12539225184182973
R1	cpdb	0	network_modules	42	TRUE	0.002189349184191329	231	14	5	0.35714285714285715	0.021645021645021644	REAC:R-HSA-201681	REAC	TCF dependent signaling in response to WNT	10916	2421		1	1	231	10685	5	9	226	10676	10916	0.08365583849927147
R1	cpdb	0	network_modules	42	TRUE	0.0036060991808399144	330	19	6	0.3157894736842105	0.01818181818181818	KEGG:05165	KEGG	Human papillomavirus infection	8484	446		1	1	330	8154	6	13	324	8141	8484	0.06784739911060997
R1	cpdb	0	network_modules	42	TRUE	0.008997838640903004	146	29	5	0.1724137931034483	0.03424657534246575	GO:0030178	GO:BP	negative regulation of Wnt signaling pathway	16175	6698		NA	1	146	16029	5	24	141	16005	16175	0.07321499673559284
R1	cpdb	0	network_modules	43	TRUE	2.9197899432123135e-6	74	13	5	0.38461538461538464	0.06756756756756757	KEGG:04115	KEGG	p53 signaling pathway	8484	269		NA	1	74	8410	5	8	69	8402	8484	0.15836363888088822
R1	cpdb	0	network_modules	43	TRUE	0.0011369364213339346	160	17	5	0.29411764705882354	0.03125	REAC:R-HSA-5633007	REAC	Regulation of TP53 Activity	10916	2012		0	0.3333333333333333	160	10756	5	12	155	10744	10916	0.09183946335468504
R1	cpdb	0	network_modules	43	TRUE	0.0034466920579501624	92	17	4	0.23529411764705882	0.043478260869565216	REAC:R-HSA-6804756	REAC	Regulation of TP53 Activity through Phosphorylation	10916	2016		0.5	0.6666666666666666	92	10824	4	13	88	10811	10916	0.09801137983849215
R1	cpdb	0	network_modules	43	TRUE	0.0034594891506577793	148	24	5	0.20833333333333334	0.033783783783783786	GO:0072331	GO:BP	signal transduction by p53 class mediator	16175	17354		0	0.25	148	16027	5	19	143	16008	16175	0.08063923330672022
R1	cpdb	0	network_modules	43	TRUE	0.0036812772111765426	359	17	6	0.35294117647058826	0.016713091922005572	REAC:R-HSA-3700989	REAC	Transcriptional Regulation by TP53	10916	2546		1	1	359	10557	6	11	353	10546	10916	0.07087612908396622
R1	cpdb	0	network_modules	43	TRUE	0.005295103282008657	71	24	4	0.16666666666666666	0.056338028169014086	GO:0030330	GO:BP	DNA damage response, signal transduction by p53 class mediator	16175	6779		0.3333333333333333	0.5	71	16104	4	20	67	16084	16175	0.09462624130317772
R1	cpdb	0	network_modules	43	TRUE	0.007232184136919182	172	24	5	0.20833333333333334	0.029069767441860465	GO:0042770	GO:BP	signal transduction in response to DNA damage	16175	10355		0.6666666666666666	0.75	172	16003	5	19	167	15984	16175	0.0743004001417273
R1	cpdb	0	network_modules	43	TRUE	0.008970721099766177	501	24	7	0.2916666666666667	0.013972055888223553	GO:0008285	GO:BP	negative regulation of cell population proliferation	16175	3152		1	1	501	15674	7	17	494	15657	16175	0.05800570243449605
R1	cpdb	0	network_modules	44	TRUE	1.063613513044576e-6	617	61	16	0.26229508196721313	0.02593192868719611	GO:0051093	GO:BP	negative regulation of developmental process	16175	13488		0	0.047619047619047616	617	15558	16	45	601	15513	16175	0.07199899089644304
R1	cpdb	0	network_modules	44	TRUE	1.7376317666335204e-6	236	61	11	0.18032786885245902	0.046610169491525424	GO:0030198	GO:BP	extracellular matrix organization	16175	6707		0.05	0.09523809523809523	236	15939	11	50	225	15889	16175	0.0850436021362077
R1	cpdb	0	network_modules	44	TRUE	1.816997616950288e-6	237	61	11	0.18032786885245902	0.046413502109704644	GO:0043062	GO:BP	extracellular structure organization	16175	10509		0.1	0.14285714285714285	237	15938	11	50	226	15888	16175	0.08483500069524075
R1	cpdb	0	network_modules	44	TRUE	1.8995998087227045e-6	238	61	11	0.18032786885245902	0.046218487394957986	GO:0045229	GO:BP	external encapsulating structure organization	16175	11340		0.15	0.19047619047619047	238	15937	11	50	227	15887	16175	0.08462765264407267
R1	cpdb	0	network_modules	44	TRUE	5.259962453053569e-6	795	61	17	0.2786885245901639	0.021383647798742137	GO:0051241	GO:BP	negative regulation of multicellular organismal process	16175	13591		0.2	0.23809523809523808	795	15380	17	44	778	15336	16175	0.06532832560069092
R1	cpdb	0	network_modules	44	TRUE	5.530858621210765e-6	59	55	7	0.12727272727272726	0.11864406779661017	REAC:R-HSA-3000171	REAC	Non-integrin membrane-ECM interactions	10916	1603		0	0.058823529411764705	59	10857	7	48	52	10809	10916	0.11828184007265855
R1	cpdb	0	network_modules	44	TRUE	7.534070776556056e-6	298	55	12	0.21818181818181817	0.040268456375838924	REAC:R-HSA-1474244	REAC	Extracellular matrix organization	10916	889		0.0625	0.11764705882352941	298	10618	12	43	286	10575	10916	0.08335784004649337
R1	cpdb	0	network_modules	44	TRUE	7.848925266339704e-6	18	55	5	0.09090909090909091	0.2777777777777778	REAC:R-HSA-2243919	REAC	Crosslinking of collagen fibrils	10916	417		0.125	0.17647058823529413	18	10898	5	50	13	10848	10916	0.1565517227518621
R1	cpdb	0	network_modules	44	TRUE	1.1885922711308119e-5	89	40	7	0.175	0.07865168539325842	KEGG:04512	KEGG	ECM-receptor interaction	8484	314		0	0.1111111111111111	89	8395	7	33	82	8362	8484	0.11113289000102688
R1	cpdb	0	network_modules	44	TRUE	2.8474574189545034e-5	101	40	7	0.175	0.06930693069306931	KEGG:05146	KEGG	Amoebiasis	8484	438		0.125	0.2222222222222222	101	8383	7	33	94	8350	8484	0.10349929804316477
R1	cpdb	0	network_modules	44	TRUE	3.319131222872741e-5	76	55	7	0.12727272727272726	0.09210526315789473	REAC:R-HSA-3000178	REAC	ECM proteoglycans	10916	812		0.1875	0.23529411764705882	76	10840	7	48	69	10792	10916	0.10296555178225444
R1	cpdb	0	network_modules	44	TRUE	4.0458543173553646e-5	400	61	12	0.19672131147540983	0.03	GO:0001525	GO:BP	angiogenesis	16175	330		0.25	0.2857142857142857	400	15775	12	49	388	15726	16175	0.06813975465949003
R1	cpdb	0	network_modules	44	TRUE	5.847585085716255e-5	504	61	13	0.21311475409836064	0.025793650793650792	GO:0001944	GO:BP	vasculature development	16175	555		0.3	0.3333333333333333	504	15671	13	48	491	15623	16175	0.06443313006791197
R1	cpdb	0	network_modules	44	TRUE	6.145006897600804e-5	124	55	8	0.14545454545454545	0.06451612903225806	REAC:R-HSA-381426	REAC	Regulation of Insulin-like Growth Factor (IGF) transport and uptake by Insulin-like Growth Factor Binding Proteins (IGFBPs)	10916	1981		0.25	0.29411764705882354	124	10792	8	47	116	10745	10916	0.09004528467398436
R1	cpdb	0	network_modules	44	TRUE	6.6673648041437e-5	84	55	7	0.12727272727272726	0.08333333333333333	REAC:R-HSA-216083	REAC	Integrin cell surface interactions	10916	1216		0.3125	0.35294117647058826	84	10832	7	48	77	10784	10916	0.09737911693191856
R1	cpdb	0	network_modules	44	TRUE	6.95647875990326e-5	126	55	8	0.14545454545454545	0.06349206349206349	REAC:R-HSA-114608	REAC	Platelet degranulation 	10916	1764		0.375	0.4117647058823529	126	10790	8	47	118	10743	10916	0.08921399731614646
R1	cpdb	0	network_modules	44	TRUE	9.39862074578484e-5	131	55	8	0.14545454545454545	0.061068702290076333	REAC:R-HSA-76005	REAC	Response to elevated platelet cytosolic Ca2+	10916	2090		0.4375	0.47058823529411764	131	10785	8	47	123	10738	10916	0.08721581185826242
R1	cpdb	0	network_modules	44	TRUE	9.568225126676855e-5	626	61	14	0.22950819672131148	0.022364217252396165	GO:0035295	GO:BP	tube development	16175	8953		0.35	0.38095238095238093	626	15549	14	47	612	15502	16175	0.060864251606929334
R1	cpdb	0	network_modules	44	TRUE	1.157666350754787e-4	744	61	15	0.2459016393442623	0.020161290322580645	GO:0072359	GO:BP	circulatory system development	16175	17370		0.4	0.42857142857142855	744	15431	15	46	729	15385	16175	0.05871473365459449
R1	cpdb	0	network_modules	44	TRUE	1.3662220225071285e-4	447	61	12	0.19672131147540983	0.026845637583892617	GO:0048514	GO:BP	blood vessel morphogenesis	16175	12799		0.45	0.47619047619047616	447	15728	12	49	435	15679	16175	0.06346362139345327
R1	cpdb	0	network_modules	44	TRUE	1.5669516051357996e-4	140	55	8	0.14545454545454545	0.05714285714285714	REAC:R-HSA-1474228	REAC	Degradation of the extracellular matrix	10916	726		0.5	0.5294117647058824	140	10776	8	47	132	10729	10916	0.08387967652715363
R1	cpdb	0	network_modules	44	TRUE	1.7935171144129318e-4	60	55	6	0.10909090909090909	0.1	REAC:R-HSA-2022090	REAC	Assembly of collagen fibrils and other multimeric structures	10916	177		0.5625	0.5882352941176471	60	10856	6	49	54	10807	10916	0.09970929849221292
R1	cpdb	0	network_modules	44	TRUE	1.8122032311773307e-4	770	61	15	0.2459016393442623	0.01948051948051948	GO:0048646	GO:BP	anatomical structure formation involved in morphogenesis	16175	12904		0.5	0.5238095238095238	770	15405	15	46	755	15359	16175	0.05729914475910211
R1	cpdb	0	network_modules	44	TRUE	2.031572578613303e-4	86	40	6	0.15	0.06976744186046512	KEGG:04610	KEGG	Complement and coagulation cascades	8484	320		0.25	0.3333333333333333	86	8398	6	34	80	8364	8484	0.09609992894892107
R1	cpdb	0	network_modules	44	TRUE	2.6984013644304206e-4	15	55	4	0.07272727272727272	0.26666666666666666	REAC:R-HSA-2214320	REAC	Anchoring fibril formation	10916	146		0.625	0.6470588235294118	15	10901	4	51	11	10850	10916	0.13707058727577448
R1	cpdb	0	network_modules	44	TRUE	2.7556867461306134e-4	202	40	8	0.2	0.039603960396039604	KEGG:04510	KEGG	Focal adhesion	8484	313		0.375	0.4444444444444444	202	8282	8	32	194	8250	8484	0.07954184762696148
R1	cpdb	0	network_modules	44	TRUE	2.953454086923994e-4	480	61	12	0.19672131147540983	0.025	GO:0001568	GO:BP	blood vessel development	16175	353		0.55	0.5714285714285714	480	15695	12	49	468	15646	16175	0.060567832751043625
R1	cpdb	0	network_modules	44	TRUE	3.142092745503067e-4	356	40	10	0.25	0.028089887640449437	KEGG:04151	KEGG	PI3K-Akt signaling pathway	8484	285		0.5	0.5555555555555556	356	8128	10	30	346	8098	8484	0.07141406370354465
R1	cpdb	0	network_modules	44	TRUE	3.51209387098026e-4	107	55	7	0.12727272727272726	0.06542056074766354	REAC:R-HSA-8957275	REAC	Post-translational protein phosphorylation	10916	1777		0.6875	0.7058823529411765	107	10809	7	48	100	10761	10916	0.0848505207101575
R1	cpdb	0	network_modules	44	TRUE	3.6161632945754576e-4	170	61	8	0.13114754098360656	0.047058823529411764	GO:0010721	GO:BP	negative regulation of cell development	16175	4347		0.6	0.6190476190476191	170	16005	8	53	162	15952	16175	0.07278427099965185
R1	cpdb	0	network_modules	44	TRUE	3.7353765116120066e-4	237	61	9	0.14754098360655737	0.0379746835443038	GO:0045765	GO:BP	regulation of angiogenesis	16175	11601		0.65	0.6666666666666666	237	15938	9	52	228	15886	16175	0.06804631867496132
R1	cpdb	0	network_modules	44	TRUE	4.6145140471317826e-4	243	61	9	0.14754098360655737	0.037037037037037035	GO:1901342	GO:BP	regulation of vasculature development	16175	21401		0.7	0.7142857142857143	243	15932	9	52	234	15880	16175	0.06702602401316782
R1	cpdb	0	network_modules	44	TRUE	4.907933926723845e-4	100	40	6	0.15	0.06	KEGG:04933	KEGG	AGE-RAGE signaling pathway in diabetic complications	8484	390		0.625	0.6666666666666666	100	8384	6	34	94	8350	8484	0.08814143937292808
R1	cpdb	0	network_modules	44	TRUE	5.747490411208119e-4	75	61	6	0.09836065573770492	0.08	GO:1902106	GO:BP	negative regulation of leukocyte differentiation	16175	22020		0.75	0.7619047619047619	75	16100	6	55	69	16045	16175	0.08488172035401928
R1	cpdb	0	network_modules	44	TRUE	6.728085152541748e-4	77	61	6	0.09836065573770492	0.07792207792207792	GO:1903707	GO:BP	negative regulation of hemopoiesis	16175	23221		0.8	0.8095238095238095	77	16098	6	55	71	16043	16175	0.08366678603568377
R1	cpdb	0	network_modules	44	TRUE	9.007346820009687e-4	44	55	5	0.09090909090909091	0.11363636363636363	REAC:R-HSA-8948216	REAC	Collagen chain trimerization	10916	385		0.75	0.7647058823529411	44	10872	5	50	39	10822	10916	0.09757538443504782
R1	cpdb	0	network_modules	44	TRUE	0.001309930303800418	552	61	12	0.19672131147540983	0.021739130434782608	GO:0035239	GO:BP	tube morphogenesis	16175	8921		0.85	0.8571428571428571	552	15623	12	49	540	15574	16175	0.05510129640775695
R1	cpdb	0	network_modules	44	TRUE	0.001317771204419273	330	40	9	0.225	0.02727272727272727	KEGG:05165	KEGG	Human papillomavirus infection	8484	446		0.75	0.7777777777777778	330	8154	9	31	321	8123	8484	0.06624730028778661
R1	cpdb	0	network_modules	44	TRUE	0.0018615259992886886	89	55	6	0.10909090909090909	0.06741573033707865	REAC:R-HSA-1474290	REAC	Collagen formation	10916	387		0.8125	0.8235294117647058	89	10827	6	49	83	10778	10916	0.07987566141391304
R1	cpdb	0	network_modules	44	TRUE	0.003323382188159538	56	61	5	0.08196721311475409	0.08928571428571429	GO:0006956	GO:BP	complement activation	16175	2587		0.9	0.9047619047619048	56	16119	5	56	51	16063	16175	0.08223226026853085
R1	cpdb	0	network_modules	44	TRUE	0.005025908466484962	92	40	5	0.125	0.05434782608695652	KEGG:05222	KEGG	Small cell lung cancer	8484	473		0.875	0.8888888888888888	92	8392	5	35	87	8357	8484	0.07586279811574433
R1	cpdb	0	network_modules	44	TRUE	0.0051219645103429	30	55	4	0.07272727272727272	0.13333333333333333	REAC:R-HSA-3000157	REAC	Laminin interactions	10916	1303		0.875	0.8823529411764706	30	10886	4	51	26	10835	10916	0.09512244115018177
R1	cpdb	0	network_modules	44	TRUE	0.005279547360958542	631	61	12	0.19672131147540983	0.01901743264659271	GO:0022603	GO:BP	regulation of anatomical structure morphogenesis	16175	6611		0.95	0.9523809523809523	631	15544	12	49	619	15495	16175	0.05011549694889425
R1	cpdb	0	network_modules	44	TRUE	0.005858651473512728	64	55	5	0.09090909090909091	0.078125	REAC:R-HSA-1442490	REAC	Collagen degradation	10916	386		0.9375	0.9411764705882353	64	10852	5	50	59	10802	10916	0.079271975163730593
R1	cpdb	0	network_modules	44	TRUE	0.0073363896222121494	67	55	5	0.09090909090909091	0.07462686567164178	REAC:R-HSA-1650814	REAC	Collagen biosynthesis and modifying enzymes	10916	384		1	1	67	10849	5	50	62	10799	10916	0.07723721596876998
R1	cpdb	0	network_modules	44	TRUE	0.008614026558983707	103	40	5	0.125	0.04854368932038835	KEGG:04974	KEGG	Protein digestion and absorption	8484	405		1	1	103	8381	5	35	98	8346	8484	0.07092970168547005
R1	cpdb	0	network_modules	44	TRUE	0.008711602888924188	119	61	6	0.09836065573770492	0.05042016806722689	GO:0001936	GO:BP	regulation of endothelial cell proliferation	16175	550		1	1	119	16056	6	55	113	16001	16175	0.06552002443495177
R1	cpdb	0	network_modules	45	TRUE	0.001617277557367746	135	12	4	0.3333333333333333	0.02962962962962963	KEGG:04210	KEGG	Apoptosis	8484	287		NA	1	135	8349	4	8	131	8341	8484	0.09546625542698757
R1	cpdb	0	network_modules	45	TRUE	0.007077170072321803	3	21	2	0.09523809523809523	0.6666666666666666	GO:0003365	GO:BP	establishment of cell polarity involved in ameboidal cell migration	16175	1785		NA	1	3	16172	2	19	1	16153	16175	0.25167235521278336
R1	cpdb	0	network_modules	46	TRUE	1.3682729925989265e-5	17	24	4	0.16666666666666666	0.23529411764705882	GO:0002098	GO:BP	tRNA wobble uridine modification	16175	681		0	0.3333333333333333	17	16158	4	20	13	16138	16175	0.19703044763732533
R1	cpdb	0	network_modules	46	TRUE	2.7771520057808218e-5	20	24	4	0.16666666666666666	0.2	GO:0002097	GO:BP	tRNA wobble base modification	16175	680		0.5	0.6666666666666666	20	16155	4	20	16	16135	16175	0.18146651247757528
R1	cpdb	0	network_modules	46	TRUE	0.009651048672627758	6	16	2	0.125	0.3333333333333333	REAC:R-HSA-9032845	REAC	Activated NTRK2 signals through CDK5	10916	59		NA	1	6	10910	2	14	4	10896	10916	0.20343158583831095
R1	cpdb	0	network_modules	46	TRUE	0.009881539404908083	3	24	2	0.08333333333333333	0.6666666666666666	GO:0002926	GO:BP	tRNA wobble base 5-methoxycarbonylmethyl-2-thiouridinylation	16175	1436		1	1	3	16172	2	22	1	16150	16175	0.23537416597204877
R1	cpdb	0	network_modules	47	TRUE	4.0232369058035397e-28	91	31	17	0.5483870967741935	0.18681318681318682	GO:0008637	GO:BP	apoptotic mitochondrial changes	16175	3220		0	0.014285714285714285	91	16084	17	14	74	16070	16175	0.31798788345362017
R1	cpdb	0	network_modules	47	TRUE	1.752670435365894e-27	52	31	15	0.4838709677419355	0.28846153846153844	GO:0001836	GO:BP	release of cytochrome c from mitochondria	16175	493		0.014492753623188406	0.02857142857142857	52	16123	15	16	37	16107	16175	0.37207410729705986
R1	cpdb	0	network_modules	47	TRUE	3.1662181465383766e-19	364	31	18	0.5806451612903226	0.04945054945054945	GO:0007005	GO:BP	mitochondrion organization	16175	2617		0.028985507246376812	0.04285714285714286	364	15811	18	13	346	15798	16175	0.16490482316052488
R1	cpdb	0	network_modules	47	TRUE	3.527427956588554e-19	24	31	10	0.3225806451612903	0.4166666666666667	GO:0090200	GO:BP	positive regulation of release of cytochrome c from mitochondria	16175	18102		0.043478260869565216	0.05714285714285714	24	16151	10	21	14	16130	16175	0.3655529641704274
R1	cpdb	0	network_modules	47	TRUE	7.253895861678882e-19	41	31	11	0.3548387096774194	0.2682926829268293	GO:0090199	GO:BP	regulation of release of cytochrome c from mitochondria	16175	18101		0.057971014492753624	0.07142857142857142	41	16134	11	20	30	16114	16175	0.30702525422367094
R1	cpdb	0	network_modules	47	TRUE	5.677302367290122e-18	107	31	13	0.41935483870967744	0.12149532710280374	GO:0010821	GO:BP	regulation of mitochondrion organization	16175	4433		0.07246376811594203	0.08571428571428572	107	16068	13	18	94	16050	16175	0.2231120348168994
R1	cpdb	0	network_modules	47	TRUE	2.4424467899092252e-17	463	31	18	0.5806451612903226	0.038876889848812095	GO:0097190	GO:BP	apoptotic signaling pathway	16175	18534		0.08695652173913043	0.1	463	15712	18	13	445	15699	16175	0.14506703234329427
R1	cpdb	0	network_modules	47	TRUE	6.370605363512552e-17	9	17	7	0.4117647058823529	0.7777777777777778	REAC:R-HSA-111453	REAC	BH3-only proteins associate with and inactivate anti-apoptotic BCL-2 members	10916	202		0	0.1	9	10907	7	10	2	10897	10916	0.5654567695235443
R1	cpdb	0	network_modules	47	TRUE	3.4665518854621837e-15	32	24	9	0.375	0.28125	KEGG:04215	KEGG	Apoptosis - multiple species	8484	292		0	0.07142857142857142	32	8452	9	15	23	8437	8484	0.3225576294208168
R1	cpdb	0	network_modules	47	TRUE	6.375692513998574e-15	244	31	14	0.45161290322580644	0.05737704918032787	GO:0097193	GO:BP	intrinsic apoptotic signaling pathway	16175	18537		0.10144927536231885	0.11428571428571428	244	15931	14	17	230	15914	16175	0.1569333087910214
R1	cpdb	0	network_modules	47	TRUE	6.919961209145564e-15	54	17	9	0.5294117647058824	0.16666666666666666	REAC:R-HSA-109606	REAC	Intrinsic Pathway for Apoptosis	10916	1268		0.1111111111111111	0.2	54	10862	9	8	45	10854	10916	0.29522919922779756
R1	cpdb	0	network_modules	47	TRUE	3.5370450748363847e-14	40	31	9	0.2903225806451613	0.225	GO:0046902	GO:BP	regulation of mitochondrial membrane permeability	16175	12429		0.11594202898550725	0.12857142857142856	40	16135	9	22	31	16113	16175	0.2539631789475816
R1	cpdb	0	network_modules	47	TRUE	3.882577794018815e-13	51	31	9	0.2903225806451613	0.17647058823529413	GO:0090559	GO:BP	regulation of membrane permeability	16175	18353		0.13043478260869565	0.14285714285714285	51	16124	9	22	42	16102	16175	0.224458725160034
R1	cpdb	0	network_modules	47	TRUE	1.4075481796661831e-12	135	24	11	0.4583333333333333	0.08148148148148149	KEGG:04210	KEGG	Apoptosis	8484	287		0.07692307692307693	0.14285714285714285	135	8349	11	13	124	8336	8484	0.188309723100756
R1	cpdb	0	network_modules	47	TRUE	3.7805849132201755e-12	385	31	14	0.45161290322580644	0.03636363636363636	GO:0043065	GO:BP	positive regulation of apoptotic process	16175	10511		0.14492753623188406	0.15714285714285714	385	15790	14	17	371	15773	16175	0.12298433993303973
R1	cpdb	0	network_modules	47	TRUE	6.642868303980144e-12	401	31	14	0.45161290322580644	0.034912718204488775	GO:0043068	GO:BP	positive regulation of programmed cell death	16175	10514		0.15942028985507245	0.17142857142857143	401	15774	14	17	387	15757	16175	0.12028813863661982
R1	cpdb	0	network_modules	47	TRUE	1.2228533982716455e-11	170	31	11	0.3548387096774194	0.06470588235294118	GO:0097191	GO:BP	extrinsic apoptotic signaling pathway	16175	18535		0.17391304347826086	0.18571428571428572	170	16005	11	20	159	15985	16175	0.14795867672190732
R1	cpdb	0	network_modules	47	TRUE	1.599331985602566e-11	44	31	8	0.25806451612903225	0.18181818181818182	GO:0097192	GO:BP	extrinsic apoptotic signaling pathway in absence of ligand	16175	18536		0.18840579710144928	0.2	44	16131	8	23	36	16108	16175	0.21482691536760357
R1	cpdb	0	network_modules	47	TRUE	2.3486751653501467e-11	46	31	8	0.25806451612903225	0.17391304347826086	GO:0038034	GO:BP	signal transduction in absence of ligand	16175	9674		0.2028985507246377	0.21428571428571427	46	16129	8	23	38	16106	16175	0.2100161469519209
R1	cpdb	0	network_modules	47	TRUE	2.5377382861257353e-11	79	31	9	0.2903225806451613	0.11392405063291139	GO:0008630	GO:BP	intrinsic apoptotic signaling pathway in response to DNA damage	16175	3218		0.21739130434782608	0.22857142857142856	79	16096	9	22	70	16074	16175	0.17941534533040923
R1	cpdb	0	network_modules	47	TRUE	1.0835094319365676e-10	55	31	8	0.25806451612903225	0.14545454545454545	GO:0070059	GO:BP	intrinsic apoptotic signaling pathway in response to endoplasmic reticulum stress	16175	15896		0.2318840579710145	0.24285714285714285	55	16120	8	23	47	16097	16175	0.1917006597809666
R1	cpdb	0	network_modules	47	TRUE	1.420585219051593e-10	95	31	9	0.2903225806451613	0.09473684210526316	GO:0007006	GO:BP	mitochondrial membrane organization	16175	2618		0.2463768115942029	0.2571428571428571	95	16080	9	22	86	16058	16175	0.16312466620036678
R1	cpdb	0	network_modules	47	TRUE	4.351510483695576e-10	176	17	9	0.5294117647058824	0.05113636363636364	REAC:R-HSA-109581	REAC	Apoptosis	10916	158		0.2222222222222222	0.3	176	10740	9	8	167	10732	10916	0.16095254260483494
R1	cpdb	0	network_modules	47	TRUE	1.0223769871005425e-9	30	17	6	0.35294117647058826	0.2	REAC:R-HSA-114452	REAC	Activation of BH3-only proteins	10916	77		0.3333333333333333	0.4	30	10886	6	11	24	10875	10916	0.2641844351569286
R1	cpdb	0	network_modules	47	TRUE	1.9786808681785177e-9	208	17	9	0.5294117647058824	0.04326923076923077	REAC:R-HSA-5357801	REAC	Programmed Cell Death	10916	1803		0.4444444444444444	0.5	208	10708	9	8	199	10700	10916	0.1474290373412301
R1	cpdb	0	network_modules	47	TRUE	1.0083712142786392e-8	420	31	12	0.3870967741935484	0.02857142857142857	GO:0010638	GO:BP	positive regulation of organelle organization	16175	4284		0.2608695652173913	0.2714285714285714	420	15755	12	19	408	15736	16175	0.09950621696355152
R1	cpdb	0	network_modules	47	TRUE	1.3367959611095228e-8	156	31	9	0.2903225806451613	0.057692307692307696	GO:0006839	GO:BP	mitochondrial transport	16175	2508		0.2753623188405797	0.2857142857142857	156	16019	9	22	147	15997	16175	0.1258484988803184
R1	cpdb	0	network_modules	47	TRUE	1.5057332469509298e-8	28	31	6	0.1935483870967742	0.21428571428571427	GO:0097345	GO:BP	mitochondrial outer membrane permeabilization	16175	18617		0.2898550724637681	0.3	28	16147	6	25	22	16122	16175	0.20220060180622362
R1	cpdb	0	network_modules	47	TRUE	2.3668767169606357e-8	30	31	6	0.1935483870967742	0.2	GO:1902110	GO:BP	positive regulation of mitochondrial membrane permeability involved in apoptotic process	16175	22024		0.30434782608695654	0.3142857142857143	30	16145	6	25	24	16120	16175	0.19523050997486854
R1	cpdb	0	network_modules	47	TRUE	3.25864547732263e-8	13	31	5	0.16129032258064516	0.38461538461538464	GO:1900103	GO:BP	positive regulation of endoplasmic reticulum unfolded protein response	16175	20395		0.3188405797101449	0.32857142857142857	13	16162	5	26	8	16136	16175	0.2481642090033406
R1	cpdb	0	network_modules	47	TRUE	3.602643721375544e-8	32	31	6	0.1935483870967742	0.1875	GO:1905898	GO:BP	positive regulation of response to endoplasmic reticulum stress	16175	24996		0.3333333333333333	0.37142857142857144	32	16143	6	25	26	16118	16175	0.1889209001337318
R1	cpdb	0	network_modules	47	TRUE	3.602643721375544e-8	32	31	6	0.1935483870967742	0.1875	GO:0035794	GO:BP	positive regulation of mitochondrial membrane permeability	16175	9250		0.3333333333333333	0.37142857142857144	32	16143	6	25	26	16118	16175	0.1889209001337318
R1	cpdb	0	network_modules	47	TRUE	3.602643721375544e-8	32	31	6	0.1935483870967742	0.1875	GO:1902686	GO:BP	mitochondrial outer membrane permeabilization involved in programmed cell death	16175	22441		0.3333333333333333	0.37142857142857144	32	16143	6	25	26	16118	16175	0.1889209001337318
R1	cpdb	0	network_modules	47	TRUE	4.397391670464258e-8	33	31	6	0.1935483870967742	0.18181818181818182	GO:1902108	GO:BP	regulation of mitochondrial membrane permeability involved in apoptotic process	16175	22022		0.37681159420289856	0.38571428571428573	33	16142	6	25	27	16117	16175	0.18598216474987458
R1	cpdb	0	network_modules	47	TRUE	4.449611379105524e-8	72	24	7	0.2916666666666667	0.09722222222222222	KEGG:01524	KEGG	Platinum drug resistance	8484	198		0.15384615384615385	0.21428571428571427	72	8412	7	17	65	8395	8484	0.1644250397240465
R1	cpdb	0	network_modules	47	TRUE	6.427370766150772e-8	35	31	6	0.1935483870967742	0.17142857142857143	GO:1905710	GO:BP	positive regulation of membrane permeability	16175	24849		0.391304347826087	0.4	35	16140	6	25	29	16115	16175	0.18048481096002214
R1	cpdb	0	network_modules	47	TRUE	1.1559359962480952e-7	75	31	7	0.22580645161290322	0.09333333333333334	GO:1905897	GO:BP	regulation of response to endoplasmic reticulum stress	16175	24995		0.4057971014492754	0.4142857142857143	75	16100	7	24	68	16076	16175	0.14265978168428828
R1	cpdb	0	network_modules	47	TRUE	1.583371692077489e-7	86	24	7	0.2916666666666667	0.08139534883720931	KEGG:05210	KEGG	Colorectal cancer	8484	461		0.23076923076923078	0.2857142857142857	86	8398	7	17	79	8381	8484	0.14969542381753057
R1	cpdb	0	network_modules	47	TRUE	2.0041863350262417e-7	137	31	8	0.25806451612903225	0.058394160583941604	GO:2001242	GO:BP	regulation of intrinsic apoptotic signaling pathway	16175	26431		0.42028985507246375	0.42857142857142855	137	16038	8	23	129	16015	16175	0.11934918422973763
R1	cpdb	0	network_modules	47	TRUE	2.762042630143082e-7	44	31	6	0.1935483870967742	0.13636363636363635	GO:2001244	GO:BP	positive regulation of intrinsic apoptotic signaling pathway	16175	26433		0.43478260869565216	0.44285714285714284	44	16131	6	25	38	16106	16175	0.1605480351140657
R1	cpdb	0	network_modules	47	TRUE	3.182744391043948e-7	45	31	6	0.1935483870967742	0.13333333333333333	GO:0051881	GO:BP	regulation of mitochondrial membrane potential	16175	13966		0.4492753623188406	0.45714285714285713	45	16130	6	25	39	16105	16175	0.1587076328415127
R1	cpdb	0	network_modules	47	TRUE	1.067250941704309e-6	8	31	4	0.12903225806451613	0.5	GO:1902237	GO:BP	positive regulation of endoplasmic reticulum stress-induced intrinsic apoptotic signaling pathway	16175	22136		0.463768115942029	0.4857142857142857	8	16167	4	27	4	16140	16175	0.2533321240199993
R1	cpdb	0	network_modules	47	TRUE	1.067250941704309e-6	8	31	4	0.12903225806451613	0.5	GO:1903896	GO:BP	positive regulation of IRE1-mediated unfolded protein response	16175	23363		0.463768115942029	0.4857142857142857	8	16167	4	27	4	16140	16175	0.2533321240199993
R1	cpdb	0	network_modules	47	TRUE	1.6367441818820059e-6	26	31	5	0.16129032258064516	0.19230769230769232	GO:1902235	GO:BP	regulation of endoplasmic reticulum stress-induced intrinsic apoptotic signaling pathway	16175	22134		0.4927536231884058	0.5	26	16149	5	26	21	16123	16175	0.1746700690460029
R1	cpdb	0	network_modules	47	TRUE	2.102195571522208e-6	275	31	9	0.2903225806451613	0.03272727272727273	GO:2001233	GO:BP	regulation of apoptotic signaling pathway	16175	26422		0.5072463768115942	0.5142857142857142	275	15900	9	22	266	15878	16175	0.09264622102300676
R1	cpdb	0	network_modules	47	TRUE	2.610111628547126e-6	74	24	6	0.25	0.08108108108108109	KEGG:04115	KEGG	p53 signaling pathway	8484	269		0.3076923076923077	0.35714285714285715	74	8410	6	18	68	8392	8484	0.13820521287767118
R1	cpdb	0	network_modules	47	TRUE	3.5268750102963652e-6	30	31	5	0.16129032258064516	0.16666666666666666	GO:1900101	GO:BP	regulation of endoplasmic reticulum unfolded protein response	16175	20393		0.5217391304347826	0.5285714285714286	30	16145	5	26	25	16119	16175	0.16237726924615964
R1	cpdb	0	network_modules	47	TRUE	4.077768930303923e-6	200	31	8	0.25806451612903225	0.04	GO:0034976	GO:BP	response to endoplasmic reticulum stress	16175	8746		0.5362318840579711	0.5428571428571428	200	15975	8	23	192	15952	16175	0.09742913688999295
R1	cpdb	0	network_modules	47	TRUE	6.402030015981178e-6	20	17	4	0.23529411764705882	0.2	REAC:R-HSA-6803204	REAC	TP53 Regulates Transcription of Genes Involved in Cytochrome C Release	10916	2458		0.5555555555555556	0.6	20	10896	4	13	16	10883	10916	0.2156066814307826
R1	cpdb	0	network_modules	47	TRUE	1.5764343733351776e-5	798	31	12	0.3870967741935484	0.015037593984962405	GO:0006974	GO:BP	DNA damage response	16175	2601		0.5507246376811594	0.5571428571428572	798	15377	12	19	786	15358	16175	0.06834272628567956
R1	cpdb	0	network_modules	47	TRUE	2.0617589172165657e-5	15	31	4	0.12903225806451613	0.26666666666666666	GO:1903894	GO:BP	regulation of IRE1-mediated unfolded protein response	16175	23361		0.5652173913043478	0.5714285714285714	15	16160	4	27	11	16133	16175	0.18442466334161073
R1	cpdb	0	network_modules	47	TRUE	2.2917528322095715e-5	90	31	6	0.1935483870967742	0.06666666666666667	GO:2001235	GO:BP	positive regulation of apoptotic signaling pathway	16175	26424		0.5797101449275363	0.5857142857142857	90	16085	6	25	84	16060	16175	0.11074120037540165
R1	cpdb	0	network_modules	47	TRUE	4.1703828466868936e-5	173	31	7	0.22580645161290322	0.04046242774566474	GO:0031334	GO:BP	positive regulation of protein-containing complex assembly	16175	7125		0.5942028985507246	0.6	173	16002	7	24	166	15978	16175	0.09163721099536466
R1	cpdb	0	network_modules	47	TRUE	8.96781576467535e-5	21	31	4	0.12903225806451613	0.19047619047619047	GO:1901028	GO:BP	regulation of mitochondrial outer membrane permeabilization involved in apoptotic signaling pathway	16175	21150		0.6086956521739131	0.6285714285714286	21	16154	4	27	17	16127	16175	0.15544481683557218
R1	cpdb	0	network_modules	47	TRUE	8.96781576467535e-5	21	31	4	0.12903225806451613	0.19047619047619047	GO:0036498	GO:BP	IRE1-mediated unfolded protein response	16175	9632		0.6086956521739131	0.6285714285714286	21	16154	4	27	17	16127	16175	0.15544481683557218
R1	cpdb	0	network_modules	47	TRUE	1.0765685214621062e-4	138	24	6	0.25	0.043478260869565216	KEGG:05162	KEGG	Measles	8484	443		0.38461538461538464	0.42857142857142855	138	8346	6	18	132	8328	8484	0.09841570777925802
R1	cpdb	0	network_modules	47	TRUE	1.3967983902974813e-4	79	24	5	0.20833333333333334	0.06329113924050633	KEGG:01521	KEGG	EGFR tyrosine kinase inhibitor resistance	8484	195		0.46153846153846156	0.5	79	8405	5	19	74	8386	8484	0.11036696494861853
R1	cpdb	0	network_modules	47	TRUE	1.626164583664616e-4	610	31	10	0.3225806451612903	0.01639344262295082	GO:0043066	GO:BP	negative regulation of apoptotic process	16175	10512		0.6376811594202898	0.6428571428571429	610	15565	10	21	600	15544	16175	0.06552755145689833
R1	cpdb	0	network_modules	47	TRUE	1.7436764597006648e-4	324	31	8	0.25806451612903225	0.024691358024691357	GO:0010506	GO:BP	regulation of autophagy	16175	4181		0.6521739130434783	0.6571428571428571	324	15851	8	23	316	15828	16175	0.07444867903267112
R1	cpdb	0	network_modules	47	TRUE	1.753146673325025e-4	44	17	4	0.23529411764705882	0.09090909090909091	REAC:R-HSA-5633008	REAC	TP53 Regulates Transcription of Cell Death Genes	10916	2455		0.6666666666666666	0.7	44	10872	4	13	40	10859	10916	0.14415190615230372
R1	cpdb	0	network_modules	47	TRUE	2.1075073110937858e-4	66	31	5	0.16129032258064516	0.07575757575757576	GO:0030968	GO:BP	endoplasmic reticulum unfolded protein response	16175	6979		0.6666666666666666	0.6714285714285714	66	16109	5	26	61	16083	16175	0.10806706021861376
R1	cpdb	0	network_modules	47	TRUE	2.1965392571706503e-4	630	31	10	0.3225806451612903	0.015873015873015872	GO:0043069	GO:BP	negative regulation of programmed cell death	16175	10515		0.6811594202898551	0.6857142857142857	630	15545	10	21	620	15524	16175	0.06424045599658096
R1	cpdb	0	network_modules	47	TRUE	3.1403877306488434e-4	491	31	9	0.2903225806451613	0.018329938900203666	GO:0006914	GO:BP	autophagy	16175	2563		0.6956521739130435	0.7142857142857143	491	15684	9	22	482	15662	16175	0.06640010682844955
R1	cpdb	0	network_modules	47	TRUE	3.1403877306488434e-4	491	31	9	0.2903225806451613	0.018329938900203666	GO:0061919	GO:BP	process utilizing autophagic mechanism	16175	15723		0.6956521739130435	0.7142857142857143	491	15684	9	22	482	15662	16175	0.06640010682844955
R1	cpdb	0	network_modules	47	TRUE	3.2434170634920305e-4	657	31	10	0.3225806451612903	0.015220700152207	GO:0061024	GO:BP	membrane organization	16175	15141		0.7246376811594203	0.7285714285714285	657	15518	10	21	647	15497	16175	0.06259075824773726
R1	cpdb	0	network_modules	47	TRUE	3.52095896201409e-4	29	31	4	0.12903225806451613	0.13793103448275862	GO:0008053	GO:BP	mitochondrial fusion	16175	3106		0.7391304347826086	0.7428571428571429	29	16146	4	27	25	16119	16175	0.13179823410204872
R1	cpdb	0	network_modules	47	TRUE	4.6520670181163405e-4	31	31	4	0.12903225806451613	0.12903225806451613	GO:0043276	GO:BP	anoikis	16175	10597		0.7536231884057971	0.7571428571428571	31	16144	4	27	27	16117	16175	0.1273598100962307
R1	cpdb	0	network_modules	47	TRUE	4.925641449442667e-4	8	31	3	0.0967741935483871	0.375	GO:0045837	GO:BP	negative regulation of membrane potential	16175	11653		0.7681159420289855	0.7857142857142857	8	16167	3	28	5	16139	16175	0.18975539861157925
R1	cpdb	0	network_modules	47	TRUE	4.925641449442667e-4	8	31	3	0.0967741935483871	0.375	GO:1901030	GO:BP	positive regulation of mitochondrial outer membrane permeabilization involved in apoptotic signaling pathway	16175	21152		0.7681159420289855	0.7857142857142857	8	16167	3	28	5	16139	16175	0.18975539861157925
R1	cpdb	0	network_modules	47	TRUE	5.222874499782535e-4	79	31	5	0.16129032258064516	0.06329113924050633	GO:0034620	GO:BP	cellular response to unfolded protein	16175	8693		0.7971014492753623	0.8	79	16096	5	26	74	16070	16175	0.09831077423307208
R1	cpdb	0	network_modules	47	TRUE	9.490783089097796e-4	89	31	5	0.16129032258064516	0.056179775280898875	GO:0071456	GO:BP	cellular response to hypoxia	16175	16690		0.8115942028985508	0.8142857142857143	89	16086	5	26	84	16060	16175	0.09228572743829147
R1	cpdb	0	network_modules	47	TRUE	0.0010080265705630187	310	24	7	0.2916666666666667	0.02258064516129032	KEGG:05206	KEGG	MicroRNAs in cancer	8484	458		0.5384615384615384	0.5714285714285714	310	8174	7	17	303	8157	8484	0.07242355950141902
R1	cpdb	0	network_modules	47	TRUE	0.0011199228923433125	92	31	5	0.16129032258064516	0.05434782608695652	GO:0035967	GO:BP	cellular response to topologically incorrect protein	16175	9370		0.8260869565217391	0.8428571428571429	92	16083	5	26	87	16057	16175	0.09066899021501329
R1	cpdb	0	network_modules	47	TRUE	0.0011199228923433125	92	31	5	0.16129032258064516	0.05434782608695652	GO:0036294	GO:BP	cellular response to decreased oxygen levels	16175	9545		0.8260869565217391	0.8428571428571429	92	16083	5	26	87	16057	16175	0.09066899021501329
R1	cpdb	0	network_modules	47	TRUE	0.0011598775077740324	282	31	7	0.22580645161290322	0.024822695035460994	GO:0042391	GO:BP	regulation of membrane potential	16175	10141		0.855072463768116	0.8571428571428571	282	15893	7	24	275	15869	16175	0.06976405514472532
R1	cpdb	0	network_modules	47	TRUE	0.0012163673006587528	210	24	6	0.25	0.02857142857142857	KEGG:05170	KEGG	Human immunodeficiency virus 1 infection	8484	451		0.6153846153846154	0.6428571428571429	210	8274	6	18	204	8256	8484	0.07721714155312011
R1	cpdb	0	network_modules	47	TRUE	0.0016896012225803407	437	31	8	0.25806451612903225	0.018306636155606407	GO:0080135	GO:BP	regulation of cellular response to stress	16175	17817		0.8695652173913043	0.8714285714285714	437	15738	8	23	429	15715	16175	0.06244610772869858
R1	cpdb	0	network_modules	47	TRUE	0.0020608150976369585	104	31	5	0.16129032258064516	0.04807692307692308	GO:0071453	GO:BP	cellular response to oxygen levels	16175	16687		0.8840579710144928	0.9	104	16071	5	26	99	16045	16175	0.08490289743804993
R1	cpdb	0	network_modules	47	TRUE	0.0020608150976369585	104	31	5	0.16129032258064516	0.04807692307692308	GO:0006986	GO:BP	response to unfolded protein	16175	2608		0.8840579710144928	0.9	104	16071	5	26	99	16045	16175	0.08490289743804993
R1	cpdb	0	network_modules	47	TRUE	0.0022807807055670263	3	17	2	0.11764705882352941	0.6666666666666666	REAC:R-HSA-844455	REAC	The NLRP1 inflammasome	10916	2496		0.7777777777777778	0.8	3	10913	2	15	1	10898	10916	0.2796580487130793
R1	cpdb	0	network_modules	47	TRUE	0.0033798010409052687	76	24	4	0.16666666666666666	0.05263157894736842	KEGG:05212	KEGG	Pancreatic cancer	8484	463		0.6923076923076923	0.7857142857142857	76	8408	4	20	72	8388	8484	0.08915042237706879
R1	cpdb	0	network_modules	47	TRUE	0.0033798010409052687	76	24	4	0.16666666666666666	0.05263157894736842	KEGG:05220	KEGG	Chronic myeloid leukemia	8484	471		0.6923076923076923	0.7857142857142857	76	8408	4	20	72	8388	8484	0.08915042237706879
R1	cpdb	0	network_modules	47	TRUE	0.004011160459381154	119	31	5	0.16129032258064516	0.04201680672268908	GO:0035966	GO:BP	response to topologically incorrect protein	16175	9369		0.9130434782608695	0.9142857142857143	119	16056	5	26	114	16030	16175	0.0789332442748376
R1	cpdb	0	network_modules	47	TRUE	0.004526589738520073	346	31	7	0.22580645161290322	0.02023121387283237	GO:0043254	GO:BP	regulation of protein-containing complex assembly	16175	10588		0.927536231884058	0.9285714285714286	346	15829	7	24	339	15805	16175	0.06191108541287626
R1	cpdb	0	network_modules	47	TRUE	0.005054982099406447	165	24	5	0.20833333333333334	0.030303030303030304	KEGG:04140	KEGG	Autophagy - animal	8484	277		0.8461538461538461	0.8571428571428571	165	8319	5	19	160	8300	8484	0.07285191014602095
R1	cpdb	0	network_modules	47	TRUE	0.00564074553738053	57	31	4	0.12903225806451613	0.07017543859649122	GO:0097194	GO:BP	execution phase of apoptosis	16175	18538		0.9420289855072463	0.9428571428571428	57	16118	4	27	53	16091	16175	0.09281090554019938
R1	cpdb	0	network_modules	47	TRUE	0.006077154624048304	701	31	9	0.2903225806451613	0.012838801711840228	GO:0009628	GO:BP	response to abiotic stimulus	16175	3549		0.9565217391304348	0.9571428571428572	701	15474	9	22	692	15452	16175	0.05315305661823428
R1	cpdb	0	network_modules	47	TRUE	0.007084737757149372	18	31	3	0.0967741935483871	0.16666666666666666	GO:2000811	GO:BP	negative regulation of anoikis	16175	26066		0.9710144927536232	0.9714285714285714	18	16157	3	28	15	16129	16175	0.12573017523062804
R1	cpdb	0	network_modules	47	TRUE	0.007141379779441076	92	24	4	0.16666666666666666	0.043478260869565216	KEGG:05222	KEGG	Small cell lung cancer	8484	473		0.9230769230769231	0.9285714285714286	92	8392	4	20	88	8372	8484	0.08013555391582795
R1	cpdb	0	network_modules	47	TRUE	0.007254558418610976	111	17	4	0.23529411764705882	0.036036036036036036	REAC:R-HSA-6785807	REAC	Interleukin-4 and Interleukin-13 signaling	10916	1252		0.8888888888888888	0.9	111	10805	4	13	107	10792	10916	0.08862282467038574
R1	cpdb	0	network_modules	47	TRUE	0.008008474215611178	137	31	5	0.16129032258064516	0.0364963503649635	GO:0051402	GO:BP	neuron apoptotic process	16175	13695		0.9855072463768116	0.9857142857142858	137	16038	5	26	132	16012	16175	0.07307447116055016
R1	cpdb	0	network_modules	47	TRUE	0.008090554401315729	95	24	4	0.16666666666666666	0.042105263157894736	KEGG:01522	KEGG	Endocrine resistance	8484	196		1	1	95	8389	4	20	91	8369	8484	0.07869521659619079
R1	cpdb	0	network_modules	47	TRUE	0.008438175172388712	63	31	4	0.12903225806451613	0.06349206349206349	GO:0008625	GO:BP	extrinsic apoptotic signaling pathway via death domain receptors	16175	3214		1	1	63	16112	4	27	59	16085	16175	0.0880362517940358
R1	cpdb	0	network_modules	47	TRUE	0.008757737804953735	418	17	6	0.35294117647058826	0.014354066985645933	REAC:R-HSA-5663202	REAC	Diseases of signal transduction by growth factor receptors and second messengers	10916	773		1	1	418	10498	6	11	412	10487	10916	0.06475588798770628
R1	cpdb	0	network_modules	48	TRUE	0.0010865225083551563	135	11	4	0.36363636363636365	0.02962962962962963	KEGG:04210	KEGG	Apoptosis	8484	287		0	0.5	135	8349	4	7	131	8342	8484	0.10012188646903361
R1	cpdb	0	network_modules	48	TRUE	0.0066168080323828855	214	11	4	0.36363636363636365	0.018691588785046728	KEGG:05417	KEGG	Lipid and atherosclerosis	8484	494		1	1	214	8270	4	7	210	8263	8484	0.0777615738657559
R1	cpdb	0	network_modules	48	TRUE	0.007184134915296884	6	14	2	0.14285714285714285	0.3333333333333333	REAC:R-HSA-111459	REAC	Activation of caspases through apoptosome-mediated cleavage	10916	100		NA	1	6	10910	2	12	4	10898	10916	0.2175776176442625
R1	cpdb	0	network_modules	49	TRUE	8.976060564123573e-29	280	54	26	0.48148148148148145	0.09285714285714286	GO:0007249	GO:BP	canonical NF-kappaB signal transduction	16175	2783		0	0.006993006993006993	280	15895	26	28	254	15867	16175	0.20597462966800373
R1	cpdb	0	network_modules	49	TRUE	8.360353659963288e-24	164	48	21	0.4375	0.12804878048780488	REAC:R-HSA-168898	REAC	Toll-like Receptor Cascades	10916	2522		0	0.011764705882352941	164	10752	21	27	143	10725	10916	0.2308048913355628
R1	cpdb	0	network_modules	49	TRUE	2.6399157467168024e-23	143	48	20	0.4166666666666667	0.13986013986013987	REAC:R-HSA-166016	REAC	Toll Like Receptor 4 (TLR4) Cascade	10916	2516		0.011904761904761904	0.023529411764705882	143	10773	20	28	123	10745	10916	0.2358784310603096
R1	cpdb	0	network_modules	49	TRUE	2.3815079838255502e-21	252	54	21	0.3888888888888889	0.08333333333333333	GO:0043122	GO:BP	regulation of canonical NF-kappaB signal transduction	16175	10541		0.007042253521126761	0.013986013986013986	252	15923	21	33	231	15890	16175	0.1744621663316994
R1	cpdb	0	network_modules	49	TRUE	4.5131659480549e-21	419	54	24	0.4444444444444444	0.057279236276849645	GO:0019221	GO:BP	cytokine-mediated signaling pathway	16175	5598		0.014084507042253521	0.02097902097902098	419	15756	24	30	395	15726	16175	0.15249388689583648
R1	cpdb	0	network_modules	49	TRUE	1.4410965970643445e-19	555	54	25	0.46296296296296297	0.04504504504504504	GO:0071345	GO:BP	cellular response to cytokine stimulus	16175	16597		0.02112676056338028	0.027972027972027972	555	15620	25	29	530	15591	16175	0.136289301167972
R1	cpdb	0	network_modules	49	TRUE	6.631479662758278e-19	386	54	22	0.4074074074074074	0.05699481865284974	GO:0045088	GO:BP	regulation of innate immune response	16175	11271		0.028169014084507043	0.03496503496503497	386	15789	22	32	364	15757	16175	0.1454416362359717
R1	cpdb	0	network_modules	49	TRUE	1.3939026906745485e-18	102	44	16	0.36363636363636365	0.1568627450980392	KEGG:04064	KEGG	NF-kappa B signaling pathway	8484	256		0	0.027777777777777776	102	8382	16	28	86	8354	8484	0.23294194071591526
R1	cpdb	0	network_modules	49	TRUE	1.5504477247515324e-18	53	54	13	0.24074074074074073	0.24528301886792453	GO:0034142	GO:BP	toll-like receptor 4 signaling pathway	16175	8450		0.035211267605633804	0.04195804195804196	53	16122	13	41	40	16081	16175	0.2404892738529977
R1	cpdb	0	network_modules	49	TRUE	2.6371555500913724e-18	625	54	25	0.46296296296296297	0.04	GO:0034097	GO:BP	response to cytokine	16175	8408		0.04225352112676056	0.055944055944055944	625	15550	25	29	600	15521	16175	0.1274197170815198
R1	cpdb	0	network_modules	49	TRUE	2.6371555500913724e-18	625	54	25	0.46296296296296297	0.04	GO:1901652	GO:BP	response to peptide	16175	21619		0.04225352112676056	0.055944055944055944	625	15550	25	29	600	15521	16175	0.1274197170815198
R1	cpdb	0	network_modules	49	TRUE	9.364864409210123e-18	60	54	13	0.24074074074074073	0.21666666666666667	GO:0140895	GO:BP	cell surface toll-like receptor signaling pathway	16175	19927		0.056338028169014086	0.06293706293706294	60	16115	13	41	47	16074	16175	0.22566287749841696
R1	cpdb	0	network_modules	49	TRUE	1.4033449458578958e-17	153	48	17	0.3541666666666667	0.1111111111111111	REAC:R-HSA-73887	REAC	Death Receptor Signaling	10916	455		0.023809523809523808	0.03529411764705882	153	10763	17	31	136	10732	10916	0.19229505426749482
R1	cpdb	0	network_modules	49	TRUE	1.961673172373518e-17	451	54	22	0.4074074074074074	0.04878048780487805	GO:0002831	GO:BP	regulation of response to biotic stimulus	16175	1341		0.06338028169014084	0.06993006993006994	451	15724	22	32	429	15692	16175	0.13341837136916665
R1	cpdb	0	network_modules	49	TRUE	2.12260295808014e-17	227	54	18	0.3333333333333333	0.07929515418502203	GO:0002221	GO:BP	pattern recognition receptor signaling pathway	16175	755		0.07042253521126761	0.07692307692307693	227	15948	18	36	209	15912	16175	0.1571003475208409
R1	cpdb	0	network_modules	49	TRUE	4.377861488922753e-17	192	54	17	0.3148148148148148	0.08854166666666667	GO:0043123	GO:BP	positive regulation of canonical NF-kappaB signal transduction	16175	10542		0.07746478873239436	0.08391608391608392	192	15983	17	37	175	15946	16175	0.16189323299984704
R1	cpdb	0	network_modules	49	TRUE	4.523130675064214e-17	67	54	13	0.24074074074074073	0.19402985074626866	GO:0002752	GO:BP	cell surface pattern recognition receptor signaling pathway	16175	1263		0.08450704225352113	0.09090909090909091	67	16108	13	41	54	16067	16175	0.2132058122000726
R1	cpdb	0	network_modules	49	TRUE	4.700379961645619e-17	103	48	15	0.3125	0.14563106796116504	REAC:R-HSA-168164	REAC	Toll Like Receptor 3 (TLR3) Cascade	10916	2515		0.03571428571428571	0.047058823529411764	103	10813	15	33	88	10780	10916	0.20833028651399718
R1	cpdb	0	network_modules	49	TRUE	7.324058174292512e-17	243	54	18	0.3333333333333333	0.07407407407407407	GO:0002758	GO:BP	innate immune response-activating signaling pathway	16175	1269		0.09154929577464789	0.0979020979020979	243	15932	18	36	225	15896	16175	0.15144585138592473
R1	cpdb	0	network_modules	49	TRUE	8.436548630195579e-17	721	54	25	0.46296296296296297	0.03467406380027739	GO:0045087	GO:BP	innate immune response	16175	11270		0.09859154929577464	0.1048951048951049	721	15454	25	29	696	15425	16175	0.1173373607372442
R1	cpdb	0	network_modules	49	TRUE	8.582482673529352e-17	107	48	15	0.3125	0.14018691588785046	REAC:R-HSA-166166	REAC	MyD88-independent TLR4 cascade 	10916	1501		0.047619047619047616	0.07058823529411765	107	10809	15	33	92	10776	10916	0.20418980539209267
R1	cpdb	0	network_modules	49	TRUE	8.582482673529352e-17	107	48	15	0.3125	0.14018691588785046	REAC:R-HSA-937061	REAC	TRIF (TICAM1)-mediated TLR4 signaling 	10916	2471		0.047619047619047616	0.07058823529411765	107	10809	15	33	92	10776	10916	0.20418980539209267
R1	cpdb	0	network_modules	49	TRUE	1.276539968977993e-16	423	54	21	0.3888888888888889	0.04964539007092199	GO:0031349	GO:BP	positive regulation of defense response	16175	7140		0.1056338028169014	0.11188811188811189	423	15752	21	33	402	15719	16175	0.13155262106214372
R1	cpdb	0	network_modules	49	TRUE	1.6356456180728902e-16	654	54	24	0.4444444444444444	0.03669724770642202	GO:0031347	GO:BP	regulation of defense response	16175	7138		0.11267605633802817	0.11888111888111888	654	15521	24	30	630	15491	16175	0.11871083918236358
R1	cpdb	0	network_modules	49	TRUE	3.0638377980084765e-16	263	54	18	0.3333333333333333	0.06844106463878327	GO:0002218	GO:BP	activation of innate immune response	16175	753		0.11971830985915492	0.1258741258741259	263	15912	18	36	245	15876	16175	0.14509922907575304
R1	cpdb	0	network_modules	49	TRUE	3.5074176083219065e-16	319	54	19	0.35185185185185186	0.05956112852664577	GO:0045089	GO:BP	positive regulation of innate immune response	16175	11272		0.1267605633802817	0.13286713286713286	319	15856	19	35	300	15821	16175	0.13824874665863668
R1	cpdb	0	network_modules	49	TRUE	3.518461523065698e-16	142	44	16	0.36363636363636365	0.11267605633802817	KEGG:04936	KEGG	Alcoholic liver disease	8484	393		0.02857142857142857	0.05555555555555555	142	8342	16	28	126	8314	8484	0.19524482300374169
R1	cpdb	0	network_modules	49	TRUE	1.1036600327688545e-15	339	54	19	0.35185185185185186	0.05604719764011799	GO:0002833	GO:BP	positive regulation of response to biotic stimulus	16175	1343		0.13380281690140844	0.13986013986013987	339	15836	19	35	320	15801	16175	0.13369369595684655
R1	cpdb	0	network_modules	49	TRUE	1.2621945363467665e-15	85	54	13	0.24074074074074073	0.15294117647058825	GO:0002220	GO:BP	innate immune response activating cell surface receptor signaling pathway	16175	754		0.14084507042253522	0.14685314685314685	85	16090	13	41	72	16049	16175	0.18850473657196123
R1	cpdb	0	network_modules	49	TRUE	3.042252995103122e-15	162	44	16	0.36363636363636365	0.09876543209876543	KEGG:05161	KEGG	Hepatitis B	8484	442		0.05714285714285714	0.08333333333333333	162	8322	16	28	146	8294	8484	0.18177161849785703
R1	cpdb	0	network_modules	49	TRUE	4.649647864674053e-15	756	54	24	0.4444444444444444	0.031746031746031744	GO:0050776	GO:BP	regulation of immune response	16175	13250		0.14788732394366197	0.15384615384615385	756	15419	24	30	732	15389	16175	0.10904805884144807
R1	cpdb	0	network_modules	49	TRUE	6.174134813360958e-15	106	44	14	0.3181818181818182	0.1320754716981132	KEGG:04620	KEGG	Toll-like receptor signaling pathway	8484	325		0.08571428571428572	0.1111111111111111	106	8378	14	30	92	8348	8484	0.198705846254
R1	cpdb	0	network_modules	49	TRUE	1.3525027692093112e-14	531	54	21	0.3888888888888889	0.03954802259887006	GO:0032103	GO:BP	positive regulation of response to external stimulus	16175	7367		0.15492957746478872	0.16083916083916083	531	15644	21	33	510	15611	16175	0.11565056328813138
R1	cpdb	0	network_modules	49	TRUE	1.564677790616298e-14	113	44	14	0.3181818181818182	0.12389380530973451	KEGG:04668	KEGG	TNF signaling pathway	8484	342		0.11428571428571428	0.1388888888888889	113	8371	14	30	99	8341	8484	0.1920136365076994
R1	cpdb	0	network_modules	49	TRUE	6.099409273993828e-14	149	54	14	0.25925925925925924	0.09395973154362416	GO:0002753	GO:BP	cytoplasmic pattern recognition receptor signaling pathway	16175	1264		0.1619718309859155	0.16783216783216784	149	16026	14	40	135	15986	16175	0.15148234368490285
R1	cpdb	0	network_modules	49	TRUE	6.500808413279446e-14	158	44	15	0.3409090909090909	0.0949367088607595	KEGG:05160	KEGG	Hepatitis C	8484	441		0.14285714285714285	0.16666666666666666	158	8326	15	29	143	8297	8484	0.17212747533977898
R1	cpdb	0	network_modules	49	TRUE	7.291757261907437e-14	59	54	11	0.2037037037037037	0.1864406779661017	GO:0002224	GO:BP	toll-like receptor signaling pathway	16175	758		0.16901408450704225	0.17482517482517482	59	16116	11	43	48	16073	16175	0.19206239576970438
R1	cpdb	0	network_modules	49	TRUE	1.37619745044763e-13	55	48	11	0.22916666666666666	0.2	REAC:R-HSA-75893	REAC	TNF signaling	10916	2446		0.07142857142857142	0.08235294117647059	55	10861	11	37	44	10824	10916	0.21037278924609074
R1	cpdb	0	network_modules	49	TRUE	2.684113962283762e-13	214	44	16	0.36363636363636365	0.07476635514018691	KEGG:05417	KEGG	Lipid and atherosclerosis	8484	494		0.17142857142857143	0.19444444444444445	214	8270	16	28	198	8242	8484	0.15582689518007176
R1	cpdb	0	network_modules	49	TRUE	5.502194175301689e-13	182	44	15	0.3409090909090909	0.08241758241758242	KEGG:04621	KEGG	NOD-like receptor signaling pathway	8484	326		0.2	0.2222222222222222	182	8302	15	29	167	8273	8484	0.15919926243945157
R1	cpdb	0	network_modules	49	TRUE	1.0576679361947145e-12	416	54	18	0.3333333333333333	0.04326923076923077	GO:0002757	GO:BP	immune response-activating signaling pathway	16175	1268		0.176056338028169	0.18181818181818182	416	15759	18	36	398	15723	16175	0.11247116040776653
R1	cpdb	0	network_modules	49	TRUE	1.3767718441047575e-12	46	48	10	0.20833333333333334	0.21739130434782608	REAC:R-HSA-5357905	REAC	Regulation of TNFR1 signaling	10916	2011		0.08333333333333333	0.09411764705882353	46	10870	10	38	36	10832	10916	0.20941114376448208
R1	cpdb	0	network_modules	49	TRUE	1.9411226889568146e-12	198	44	15	0.3409090909090909	0.07575757575757576	KEGG:05169	KEGG	Epstein-Barr virus infection	8484	450		0.22857142857142856	0.25	198	8286	15	29	183	8257	8484	0.15187686022191302
R1	cpdb	0	network_modules	49	TRUE	2.4976602245759106e-12	437	54	18	0.3333333333333333	0.041189931350114416	GO:0002764	GO:BP	immune response-regulating signaling pathway	16175	1275		0.18309859154929578	0.1888111888111888	437	15738	18	36	419	15702	16175	0.10934523036569055
R1	cpdb	0	network_modules	49	TRUE	4.063574740683216e-12	101	48	12	0.25	0.1188118811881188	REAC:R-HSA-975138	REAC	TRAF6 mediated induction of NFkB and MAP kinases upon TLR7/8 or 9 activation	10916	2468		0.09523809523809523	0.10588235294117647	101	10815	12	36	89	10779	10916	0.16710799016974934
R1	cpdb	0	network_modules	49	TRUE	4.591265883673138e-12	102	48	12	0.25	0.11764705882352941	REAC:R-HSA-975155	REAC	MyD88 dependent cascade initiated on endosome	10916	1500		0.10714285714285714	0.11764705882352941	102	10814	12	36	90	10778	10916	0.16623122606514187
R1	cpdb	0	network_modules	49	TRUE	5.180774827302299e-12	103	48	12	0.25	0.11650485436893204	REAC:R-HSA-168181	REAC	Toll Like Receptor 7/8 (TLR7/8) Cascade	10916	2518		0.11904761904761904	0.12941176470588237	103	10813	12	36	91	10777	10916	0.16536698628754073
R1	cpdb	0	network_modules	49	TRUE	5.986065950546907e-12	12	48	7	0.14583333333333334	0.5833333333333334	REAC:R-HSA-9013973	REAC	TICAM1-dependent activation of IRF3/IRF7	10916	2442		0.13095238095238096	0.1411764705882353	12	10904	7	41	5	10863	10916	0.2902661816031809
R1	cpdb	0	network_modules	49	TRUE	6.1694055034094825e-12	627	54	20	0.37037037037037035	0.03189792663476874	GO:0050778	GO:BP	positive regulation of immune response	16175	13252		0.19014084507042253	0.1958041958041958	627	15548	20	34	607	15514	16175	0.09942546535664457
R1	cpdb	0	network_modules	49	TRUE	7.387940358881306e-12	106	48	12	0.25	0.11320754716981132	REAC:R-HSA-168138	REAC	Toll Like Receptor 9 (TLR9) Cascade	10916	2519		0.14285714285714285	0.15294117647058825	106	10810	12	36	94	10774	10916	0.16284645722619076
R1	cpdb	0	network_modules	49	TRUE	1.0620478548589319e-11	475	54	18	0.3333333333333333	0.037894736842105266	GO:0002253	GO:BP	activation of immune response	16175	785		0.19718309859154928	0.20279720279720279	475	15700	18	36	457	15664	16175	0.10420175306735079
R1	cpdb	0	network_modules	49	TRUE	1.2501081235010076e-11	41	54	9	0.16666666666666666	0.21951219512195122	GO:0140894	GO:BP	endolysosomal toll-like receptor signaling pathway	16175	19926		0.20422535211267606	0.2097902097902098	41	16134	9	45	32	16089	16175	0.18891880862971341
R1	cpdb	0	network_modules	49	TRUE	1.3877334371432612e-11	170	54	13	0.24074074074074073	0.07647058823529412	GO:0097191	GO:BP	extrinsic apoptotic signaling pathway	16175	18535		0.2112676056338028	0.21678321678321677	170	16005	13	41	157	15964	16175	0.13066404651424732
R1	cpdb	0	network_modules	49	TRUE	1.4801478276038853e-11	82	48	11	0.22916666666666666	0.13414634146341464	REAC:R-HSA-168928	REAC	DDX58/IFIH1-mediated induction of interferon-alpha/beta	10916	436		0.15476190476190477	0.16470588235294117	82	10834	11	37	71	10797	10916	0.17060236459763917
R1	cpdb	0	network_modules	49	TRUE	1.9763688100840623e-11	66	54	10	0.18518518518518517	0.15151515151515152	GO:0032481	GO:BP	positive regulation of type I interferon production	16175	7592		0.21830985915492956	0.22377622377622378	66	16109	10	44	56	16065	16175	0.1644254037274859
R1	cpdb	0	network_modules	49	TRUE	2.037358448973876e-11	132	54	12	0.2222222222222222	0.09090909090909091	GO:0001959	GO:BP	regulation of cytokine-mediated signaling pathway	16175	568		0.22535211267605634	0.23076923076923078	132	16043	12	42	120	16001	16175	0.13770634371853627
R1	cpdb	0	network_modules	49	TRUE	2.4464170943669914e-11	228	54	14	0.25925925925925924	0.06140350877192982	GO:0051607	GO:BP	defense response to virus	16175	13823		0.2323943661971831	0.23776223776223776	228	15947	14	40	214	15907	16175	0.12036326295968983
R1	cpdb	0	network_modules	49	TRUE	2.954692132872675e-11	25	48	8	0.16666666666666666	0.32	REAC:R-HSA-5357786	REAC	TNFR1-induced proapoptotic signaling	10916	2448		0.16666666666666666	0.17647058823529413	25	10891	8	40	17	10851	10916	0.22853096081962845
R1	cpdb	0	network_modules	49	TRUE	5.399798802233713e-11	143	54	12	0.2222222222222222	0.08391608391608392	GO:0060759	GO:BP	regulation of response to cytokine stimulus	16175	14927		0.23943661971830985	0.24475524475524477	143	16032	12	42	131	15990	16175	0.13192888965686214
R1	cpdb	0	network_modules	49	TRUE	8.533339357631057e-11	16	48	7	0.14583333333333334	0.4375	REAC:R-HSA-936964	REAC	Activation of IRF3, IRF7 mediated by TBK1, IKKε (IKBKE)	10916	85		0.17857142857142858	0.18823529411764706	16	10900	7	41	9	10859	10916	0.25078745723256135
R1	cpdb	0	network_modules	49	TRUE	9.989911089904075e-11	167	44	13	0.29545454545454547	0.07784431137724551	KEGG:05164	KEGG	Influenza A	8484	445		0.2571428571428571	0.2777777777777778	167	8317	13	31	154	8286	8484	0.1433381818236528
R1	cpdb	0	network_modules	49	TRUE	1.3450713524113418e-10	32	54	8	0.14814814814814814	0.25	GO:0070266	GO:BP	necroptotic process	16175	16027		0.24647887323943662	0.2517482517482518	32	16143	8	46	24	16097	16175	0.19038629407431032
R1	cpdb	0	network_modules	49	TRUE	1.355956037065747e-10	71	44	10	0.22727272727272727	0.14084507042253522	KEGG:04622	KEGG	RIG-I-like receptor signaling pathway	8484	327		0.2857142857142857	0.3055555555555556	71	8413	10	34	61	8379	8484	0.17350217338783364
R1	cpdb	0	network_modules	49	TRUE	1.695074990586363e-10	101	44	11	0.25	0.10891089108910891	KEGG:05142	KEGG	Chagas disease	8484	434		0.3142857142857143	0.3333333333333333	101	8383	11	33	90	8350	8484	0.15850613065837424
R1	cpdb	0	network_modules	49	TRUE	2.11323574104527e-10	31	48	8	0.16666666666666666	0.25806451612903225	REAC:R-HSA-5675482	REAC	Regulation of necroptotic cell death	10916	2045		0.19047619047619047	0.21176470588235294	31	10885	8	40	23	10845	10916	0.2045969766410241
R1	cpdb	0	network_modules	49	TRUE	2.11323574104527e-10	31	48	8	0.16666666666666666	0.25806451612903225	REAC:R-HSA-5213460	REAC	RIPK1-mediated regulated necrosis	10916	1877		0.19047619047619047	0.21176470588235294	31	10885	8	40	23	10845	10916	0.2045969766410241
R1	cpdb	0	network_modules	49	TRUE	2.2441189348183765e-10	138	44	12	0.2727272727272727	0.08695652173913043	KEGG:05162	KEGG	Measles	8484	443		0.34285714285714286	0.3611111111111111	138	8346	12	32	126	8314	8484	0.14638581098473058
R1	cpdb	0	network_modules	49	TRUE	2.4502661956970956e-10	334	54	15	0.2777777777777778	0.04491017964071856	GO:0009615	GO:BP	response to virus	16175	3541		0.2535211267605634	0.25874125874125875	334	15841	15	39	319	15802	16175	0.10464803601703908
R1	cpdb	0	network_modules	49	TRUE	2.4733384184311413e-10	84	54	10	0.18518518518518517	0.11904761904761904	GO:0033209	GO:BP	tumor necrosis factor-mediated signaling pathway	16175	8075		0.2605633802816901	0.26573426573426573	84	16091	10	44	74	16047	16175	0.1449329687638133
R1	cpdb	0	network_modules	49	TRUE	5.049781691179263e-10	112	48	11	0.22916666666666666	0.09821428571428571	REAC:R-HSA-166058	REAC	MyD88:MAL(TIRAP) cascade initiated on plasma membrane	10916	1502		0.21428571428571427	0.23529411764705882	112	10804	11	37	101	10767	10916	0.1443665856360272
R1	cpdb	0	network_modules	49	TRUE	5.049781691179263e-10	112	48	11	0.22916666666666666	0.09821428571428571	REAC:R-HSA-168188	REAC	Toll Like Receptor TLR6:TLR2 Cascade	10916	2521		0.21428571428571427	0.23529411764705882	112	10804	11	37	101	10767	10916	0.1443665856360272
R1	cpdb	0	network_modules	49	TRUE	5.474982641014268e-10	151	48	12	0.25	0.07947019867549669	REAC:R-HSA-446652	REAC	Interleukin-1 family signaling	10916	1231		0.23809523809523808	0.24705882352941178	151	10765	12	36	139	10729	10916	0.13437956351611233
R1	cpdb	0	network_modules	49	TRUE	5.576856497972877e-10	113	48	11	0.22916666666666666	0.09734513274336283	REAC:R-HSA-9020702	REAC	Interleukin-1 signaling	10916	1233		0.25	0.25882352941176473	113	10803	11	37	102	10766	10916	0.14367287806184947
R1	cpdb	0	network_modules	49	TRUE	6.159376326226789e-10	38	54	8	0.14814814814814814	0.21052631578947367	GO:0097300	GO:BP	programmed necrotic cell death	16175	18585		0.2676056338028169	0.2727272727272727	38	16137	8	46	30	16091	16175	0.17429946820031278
R1	cpdb	0	network_modules	49	TRUE	6.78263634687258e-10	115	48	11	0.22916666666666666	0.09565217391304348	REAC:R-HSA-181438	REAC	Toll Like Receptor 2 (TLR2) Cascade	10916	2514		0.2619047619047619	0.2823529411764706	115	10801	11	37	104	10764	10916	0.14231199406914927
R1	cpdb	0	network_modules	49	TRUE	6.78263634687258e-10	115	48	11	0.22916666666666666	0.09565217391304348	REAC:R-HSA-168179	REAC	Toll Like Receptor TLR1:TLR2 Cascade	10916	2520		0.2619047619047619	0.2823529411764706	115	10801	11	37	104	10764	10916	0.14231199406914927
R1	cpdb	0	network_modules	49	TRUE	7.974765905766053e-10	36	48	8	0.16666666666666666	0.2222222222222222	REAC:R-HSA-168638	REAC	NOD1/2 Signaling Pathway	10916	1529		0.2857142857142857	0.29411764705882354	36	10880	8	40	28	10840	10916	0.18937063395066794
R1	cpdb	0	network_modules	49	TRUE	1.1650045236101503e-9	302	54	14	0.25925925925925924	0.046357615894039736	GO:0030522	GO:BP	intracellular receptor signaling pathway	16175	6836		0.2746478873239437	0.27972027972027974	302	15873	14	40	288	15833	16175	0.10286959091845893
R1	cpdb	0	network_modules	49	TRUE	1.2286492947001143e-9	208	48	13	0.2708333333333333	0.0625	REAC:R-HSA-5357801	REAC	Programmed Cell Death	10916	1803		0.2976190476190476	0.3058823529411765	208	10708	13	35	195	10673	10916	0.12238904008317596
R1	cpdb	0	network_modules	49	TRUE	1.8706257935302417e-9	210	44	13	0.29545454545454547	0.06190476190476191	KEGG:05170	KEGG	Human immunodeficiency virus 1 infection	8484	451		0.37142857142857144	0.3888888888888889	210	8274	13	31	197	8243	8484	0.12579979870886981
R1	cpdb	0	network_modules	49	TRUE	2.919964837167375e-9	95	48	10	0.20833333333333334	0.10526315789473684	REAC:R-HSA-168142	REAC	Toll Like Receptor 10 (TLR10) Cascade	10916	2513		0.30952380952380953	0.3411764705882353	95	10821	10	38	85	10783	10916	0.14283700975527436
R1	cpdb	0	network_modules	49	TRUE	2.919964837167375e-9	95	48	10	0.20833333333333334	0.10526315789473684	REAC:R-HSA-975871	REAC	MyD88 cascade initiated on plasma membrane	10916	1497		0.30952380952380953	0.3411764705882353	95	10821	10	38	85	10783	10916	0.14283700975527436
R1	cpdb	0	network_modules	49	TRUE	2.919964837167375e-9	95	48	10	0.20833333333333334	0.10526315789473684	REAC:R-HSA-168176	REAC	Toll Like Receptor 5 (TLR5) Cascade	10916	2517		0.30952380952380953	0.3411764705882353	95	10821	10	38	85	10783	10916	0.14283700975527436
R1	cpdb	0	network_modules	49	TRUE	3.028751993313982e-9	6	48	5	0.10416666666666667	0.8333333333333334	REAC:R-HSA-9013957	REAC	TLR3-mediated TICAM1-dependent programmed cell death	10916	2444		0.34523809523809523	0.35294117647058826	6	10910	5	43	1	10867	10916	0.29380041599334966
R1	cpdb	0	network_modules	49	TRUE	3.6943576348571864e-9	403	54	15	0.2777777777777778	0.03722084367245657	GO:0001819	GO:BP	positive regulation of cytokine production	16175	476		0.28169014084507044	0.2867132867132867	403	15772	15	39	388	15733	16175	0.09389321083880911
R1	cpdb	0	network_modules	49	TRUE	3.938237288591715e-9	110	54	10	0.18518518518518517	0.09090909090909091	GO:0032606	GO:BP	type I interferon production	16175	7654		0.2887323943661972	0.3006993006993007	110	16065	10	44	100	16021	16175	0.1256220138022198
R1	cpdb	0	network_modules	49	TRUE	3.938237288591715e-9	110	54	10	0.18518518518518517	0.09090909090909091	GO:0032479	GO:BP	regulation of type I interferon production	16175	7590		0.2887323943661972	0.3006993006993007	110	16065	10	44	100	16021	16175	0.1256220138022198
R1	cpdb	0	network_modules	49	TRUE	3.945149217652132e-9	27	54	7	0.12962962962962962	0.25925925925925924	GO:0070498	GO:BP	interleukin-1-mediated signaling pathway	16175	16156		0.3028169014084507	0.3076923076923077	27	16148	7	47	20	16101	16175	0.18141762310011378
R1	cpdb	0	network_modules	49	TRUE	4.114658992179067e-9	75	54	9	0.16666666666666666	0.12	GO:0071357	GO:BP	cellular response to type I interferon	16175	16609		0.30985915492957744	0.3146853146853147	75	16100	9	45	66	16055	16175	0.1380373855033495
R1	cpdb	0	network_modules	49	TRUE	4.2160523373816315e-9	265	54	13	0.24074074074074073	0.04905660377358491	GO:0002429	GO:BP	immune response-activating cell surface receptor signaling pathway	16175	952		0.31690140845070425	0.32167832167832167	265	15910	13	41	252	15869	16175	0.1022886898752432
R1	cpdb	0	network_modules	49	TRUE	4.2216245734117276e-9	135	44	11	0.25	0.08148148148148149	KEGG:04210	KEGG	Apoptosis	8484	287		0.4	0.4166666666666667	135	8349	11	33	124	8316	8484	0.1350673080631528
R1	cpdb	0	network_modules	49	TRUE	8.267260876014405e-9	164	54	11	0.2037037037037037	0.06707317073170732	GO:0071356	GO:BP	cellular response to tumor necrosis factor	16175	16608		0.323943661971831	0.32867132867132864	164	16011	11	43	153	15968	16175	0.11182527175001991
R1	cpdb	0	network_modules	49	TRUE	8.419052206194209e-9	81	54	9	0.16666666666666666	0.1111111111111111	GO:0034340	GO:BP	response to type I interferon	16175	8578		0.33098591549295775	0.3356643356643357	81	16094	9	45	72	16049	16175	0.13254715047164195
R1	cpdb	0	network_modules	49	TRUE	9.696828373685307e-9	15	48	6	0.125	0.4	REAC:R-HSA-937072	REAC	TRAF6-mediated induction of TAK1 complex within TLR4 complex	10916	2469		0.35714285714285715	0.38823529411764707	15	10901	6	42	9	10859	10916	0.2217889441199006
R1	cpdb	0	network_modules	49	TRUE	9.696828373685307e-9	15	48	6	0.125	0.4	REAC:R-HSA-140534	REAC	Caspase activation via Death Receptors in the presence of ligand	10916	313		0.35714285714285715	0.38823529411764707	15	10901	6	42	9	10859	10916	0.2217889441199006
R1	cpdb	0	network_modules	49	TRUE	9.696828373685307e-9	15	48	6	0.125	0.4	REAC:R-HSA-975163	REAC	IRAK2 mediated activation of TAK1 complex upon TLR7/8 or 9 stimulation	10916	1157		0.35714285714285715	0.38823529411764707	15	10901	6	42	9	10859	10916	0.2217889441199006
R1	cpdb	0	network_modules	49	TRUE	1.0857739777827457e-8	7	54	5	0.09259259259259259	0.7142857142857143	GO:0008063	GO:BP	Toll signaling pathway	16175	3112		0.3380281690140845	0.34265734265734266	7	16168	5	49	2	16119	16175	0.25645410553804365
R1	cpdb	0	network_modules	49	TRUE	1.1547210690760166e-8	287	54	13	0.24074074074074073	0.04529616724738676	GO:0002768	GO:BP	immune response-regulating cell surface receptor signaling pathway	16175	1279		0.34507042253521125	0.34965034965034963	287	15888	13	41	274	15847	16175	0.09776181133566683
R1	cpdb	0	network_modules	49	TRUE	1.2676000728953195e-8	194	44	12	0.2727272727272727	0.061855670103092786	KEGG:05167	KEGG	Kaposi sarcoma-associated herpesvirus infection	8484	448		0.42857142857142855	0.4444444444444444	194	8290	12	32	182	8258	8484	0.12069119780772719
R1	cpdb	0	network_modules	49	TRUE	1.8166350208918107e-8	634	54	17	0.3148148148148148	0.026813880126182965	GO:0001817	GO:BP	regulation of cytokine production	16175	474		0.352112676056338	0.35664335664335667	634	15541	17	37	617	15504	16175	0.0821995564573627
R1	cpdb	0	network_modules	49	TRUE	2.006374885710515e-8	638	54	17	0.3148148148148148	0.02664576802507837	GO:0001816	GO:BP	cytokine production	16175	473		0.3591549295774648	0.36363636363636365	638	15537	17	37	621	15500	16175	0.08187848927074015
R1	cpdb	0	network_modules	49	TRUE	2.2829861885426326e-8	180	54	11	0.2037037037037037	0.06111111111111111	GO:0034612	GO:BP	response to tumor necrosis factor	16175	8690		0.36619718309859156	0.3706293706293706	180	15995	11	43	169	15952	16175	0.10624724013002065
R1	cpdb	0	network_modules	49	TRUE	2.3333106335713503e-8	158	44	11	0.25	0.06962025316455696	KEGG:04217	KEGG	Necroptosis	8484	294		0.45714285714285713	0.4722222222222222	158	8326	11	33	147	8293	8484	0.12357444475884721
R1	cpdb	0	network_modules	49	TRUE	3.012989934309821e-8	33	48	7	0.14583333333333334	0.21212121212121213	REAC:R-HSA-5357956	REAC	TNFR1-induced NF-kappa-B signaling pathway	10916	2447		0.39285714285714285	0.4	33	10883	7	41	26	10842	10916	0.17287708041752597
R1	cpdb	0	network_modules	49	TRUE	3.015470009685475e-8	55	48	8	0.16666666666666666	0.14545454545454545	REAC:R-HSA-168643	REAC	Nucleotide-binding domain, leucine rich repeat containing receptor (NLR) signaling pathways	10916	1628		0.40476190476190477	0.4117647058823529	55	10861	8	40	47	10821	10916	0.15170859681590768
R1	cpdb	0	network_modules	49	TRUE	3.4550623107491325e-8	187	54	11	0.2037037037037037	0.058823529411764705	GO:0032496	GO:BP	response to lipopolysaccharide	16175	7607		0.3732394366197183	0.3776223776223776	187	15988	11	43	176	15945	16175	0.10402820131062075
R1	cpdb	0	network_modules	49	TRUE	4.7008499681660124e-8	58	48	8	0.16666666666666666	0.13793103448275862	REAC:R-HSA-5218859	REAC	Regulated Necrosis	10916	1959		0.4166666666666667	0.4235294117647059	58	10858	8	40	50	10818	10916	0.14750218122419262
R1	cpdb	0	network_modules	49	TRUE	5.151025232330139e-8	142	54	10	0.18518518518518517	0.07042253521126761	GO:0071222	GO:BP	cellular response to lipopolysaccharide	16175	16484		0.38028169014084506	0.38461538461538464	142	16033	10	44	132	15989	16175	0.10944790920929212
R1	cpdb	0	network_modules	49	TRUE	5.187583367053965e-8	19	48	6	0.125	0.3157894736842105	REAC:R-HSA-168927	REAC	TICAM1, RIP1-mediated IKK complex recruitment	10916	2440		0.42857142857142855	0.43529411764705883	19	10897	6	42	13	10855	10916	0.19651659472265293
R1	cpdb	0	network_modules	49	TRUE	5.219167352718735e-8	64	54	8	0.14814814814814814	0.125	GO:0070534	GO:BP	protein K63-linked ubiquitination	16175	16168		0.3873239436619718	0.3916083916083916	64	16111	8	46	56	16065	16175	0.13293317502465798
R1	cpdb	0	network_modules	49	TRUE	6.297921445775292e-8	9	48	5	0.10416666666666667	0.5555555555555556	REAC:R-HSA-2562578	REAC	TRIF-mediated programmed cell death	10916	2472		0.44047619047619047	0.4470588235294118	9	10907	5	43	4	10864	10916	0.23928367790700716
R1	cpdb	0	network_modules	49	TRUE	6.994403869772129e-8	175	44	11	0.25	0.06285714285714286	KEGG:05152	KEGG	Tuberculosis	8484	440		0.4857142857142857	0.5	175	8309	11	33	164	8276	8484	0.11652109226438422
R1	cpdb	0	network_modules	49	TRUE	7.194148439732774e-8	176	48	11	0.22916666666666666	0.0625	REAC:R-HSA-109581	REAC	Apoptosis	10916	158		0.4523809523809524	0.4588235294117647	176	10740	11	37	165	10703	10916	0.11241369820914122
R1	cpdb	0	network_modules	49	TRUE	8.224635643314901e-8	21	54	6	0.1111111111111111	0.2857142857142857	GO:0034138	GO:BP	toll-like receptor 3 signaling pathway	16175	8446		0.39436619718309857	0.3986013986013986	21	16154	6	48	15	16106	16175	0.17650154181186528
R1	cpdb	0	network_modules	49	TRUE	8.394808484746523e-8	203	54	11	0.2037037037037037	0.054187192118226604	GO:0002237	GO:BP	response to molecule of bacterial origin	16175	770		0.4014084507042254	0.40559440559440557	203	15972	11	43	192	15929	16175	0.09938016213270787
R1	cpdb	0	network_modules	49	TRUE	1.0141426092489782e-7	152	54	10	0.18518518518518517	0.06578947368421052	GO:0071219	GO:BP	cellular response to molecule of bacterial origin	16175	16481		0.4084507042253521	0.4125874125874126	152	16023	10	44	142	15979	16175	0.10544855045511743
R1	cpdb	0	network_modules	49	TRUE	1.0306799334631646e-7	21	48	6	0.125	0.2857142857142857	REAC:R-HSA-1606322	REAC	ZBP1(DAI) mediated induction of type I IFNs	10916	2680		0.4642857142857143	0.47058823529411764	21	10895	6	42	15	10853	10916	0.18666384608116257
R1	cpdb	0	network_modules	49	TRUE	1.1529841471567194e-7	345	54	13	0.24074074074074073	0.03768115942028986	GO:0051090	GO:BP	regulation of DNA-binding transcription factor activity	16175	13485		0.4154929577464789	0.4195804195804196	345	15830	13	41	332	15789	16175	0.08789306697290379
R1	cpdb	0	network_modules	49	TRUE	1.4125078318820056e-7	22	48	6	0.125	0.2727272727272727	REAC:R-HSA-937041	REAC	IKK complex recruitment mediated by RIP1	10916	1145		0.47619047619047616	0.4823529411764706	22	10894	6	42	16	10852	10916	0.1822447693189519
R1	cpdb	0	network_modules	49	TRUE	1.7326697528517866e-7	74	54	8	0.14814814814814814	0.10810810810810811	GO:0060337	GO:BP	type I interferon-mediated signaling pathway	16175	14549		0.4225352112676056	0.42657342657342656	74	16101	8	46	66	16055	16175	0.12313350322534729
R1	cpdb	0	network_modules	49	TRUE	1.9704351695805588e-7	443	54	14	0.25925925925925924	0.03160270880361174	GO:0009617	GO:BP	response to bacterium	16175	3543		0.4295774647887324	0.43356643356643354	443	15732	14	40	429	15692	16175	0.08222395697948869
R1	cpdb	0	network_modules	49	TRUE	2.2521852370808928e-7	249	44	12	0.2727272727272727	0.04819277108433735	KEGG:05132	KEGG	Salmonella infection	8484	429		0.5142857142857142	0.5277777777777778	249	8235	12	32	237	8203	8484	0.10411311856747742
R1	cpdb	0	network_modules	49	TRUE	2.294096088460668e-7	11	48	5	0.10416666666666667	0.45454545454545453	REAC:R-HSA-9014325	REAC	TICAM1,TRAF6-dependent induction of TAK1 complex	10916	2441		0.4880952380952381	0.49411764705882355	11	10905	5	43	6	10862	10916	0.21607631115945858
R1	cpdb	0	network_modules	49	TRUE	3.099508518588145e-7	472	48	15	0.3125	0.03177966101694915	REAC:R-HSA-449147	REAC	Signaling by Interleukins	10916	2261		0.5	0.5058823529411764	472	10444	15	33	457	10411	10916	0.08797877280087303
R1	cpdb	0	network_modules	49	TRUE	3.100613062466328e-7	48	54	7	0.12962962962962962	0.14583333333333334	GO:0071260	GO:BP	cellular response to mechanical stimulus	16175	16518		0.43661971830985913	0.44755244755244755	48	16127	7	47	41	16080	16175	0.13477036625366492
R1	cpdb	0	network_modules	49	TRUE	3.100613062466328e-7	48	54	7	0.12962962962962962	0.14583333333333334	GO:0071496	GO:BP	cellular response to external stimulus	16175	16729		0.43661971830985913	0.44755244755244755	48	16127	7	47	41	16080	16175	0.13477036625366492
R1	cpdb	0	network_modules	49	TRUE	3.3196161725531553e-7	25	48	6	0.125	0.24	REAC:R-HSA-5357769	REAC	Caspase activation via extrinsic apoptotic signalling pathway	10916	315		0.5119047619047619	0.5176470588235295	25	10891	6	42	19	10849	10916	0.17060220435698997
R1	cpdb	0	network_modules	49	TRUE	3.442520203282983e-7	172	54	10	0.18518518518518517	0.05813953488372093	GO:0071216	GO:BP	cellular response to biotic stimulus	16175	16478		0.4507042253521127	0.45454545454545453	172	16003	10	44	162	15959	16175	0.09849264887510481
R1	cpdb	0	network_modules	49	TRUE	3.519381762954171e-7	463	54	14	0.25925925925925924	0.03023758099352052	GO:0097190	GO:BP	apoptotic signaling pathway	16175	18534		0.45774647887323944	0.46153846153846156	463	15712	14	40	449	15672	16175	0.08005046525414579
R1	cpdb	0	network_modules	49	TRUE	4.0434799289773376e-7	12	54	5	0.09259259259259259	0.4166666666666667	GO:0035666	GO:BP	TRIF-dependent toll-like receptor signaling pathway	16175	9146		0.4647887323943662	0.46853146853146854	12	16163	5	49	7	16114	16175	0.19524327062855287
R1	cpdb	0	network_modules	49	TRUE	6.25978717059116e-7	5	48	4	0.08333333333333333	0.8	REAC:R-HSA-75157	REAC	FasL/ CD95L signaling	10916	933		0.5238095238095238	0.5294117647058824	5	10911	4	44	1	10867	10916	0.25740507924272843
R1	cpdb	0	network_modules	49	TRUE	6.348793512762742e-7	13	48	5	0.10416666666666667	0.38461538461538464	REAC:R-HSA-975110	REAC	TRAF6 mediated IRF7 activation in TLR7/8 or 9 signaling	10916	2466		0.5357142857142857	0.5411764705882353	13	10903	5	43	8	10860	10916	0.19842648090760318
R1	cpdb	0	network_modules	49	TRUE	7.816188655334064e-7	89	54	8	0.14814814814814814	0.0898876404494382	GO:0071347	GO:BP	cellular response to interleukin-1	16175	16599		0.47183098591549294	0.4755244755244755	89	16086	8	46	81	16040	16175	0.11160540411528212
R1	cpdb	0	network_modules	49	TRUE	9.843471239845475e-7	14	48	5	0.10416666666666667	0.35714285714285715	REAC:R-HSA-975144	REAC	IRAK1 recruits IKK complex upon TLR7/8 or 9 stimulation	10916	1155		0.5476190476190477	0.5647058823529412	14	10902	5	43	9	10859	10916	0.19104720106759526
R1	cpdb	0	network_modules	49	TRUE	9.843471239845475e-7	14	48	5	0.10416666666666667	0.35714285714285715	REAC:R-HSA-937039	REAC	IRAK1 recruits IKK complex	10916	1154		0.5476190476190477	0.5647058823529412	14	10902	5	43	9	10859	10916	0.19104720106759526
R1	cpdb	0	network_modules	49	TRUE	1.441677990237866e-6	96	54	8	0.14814814814814814	0.08333333333333333	GO:0140888	GO:BP	interferon-mediated signaling pathway	16175	19923		0.4788732394366197	0.4825174825174825	96	16079	8	46	88	16033	16175	0.10715675091953014
R1	cpdb	0	network_modules	49	TRUE	2.1335852474391804e-6	16	48	5	0.10416666666666667	0.3125	REAC:R-HSA-5676594	REAC	TNF receptor superfamily (TNFSF) members mediating non-canonical NF-kB pathway	10916	2445		0.5714285714285714	0.5764705882352941	16	10900	5	43	11	10857	10916	0.17840641225475376
R1	cpdb	0	network_modules	49	TRUE	2.2076036792175644e-6	16	54	5	0.09259259259259259	0.3125	GO:0002756	GO:BP	MyD88-independent toll-like receptor signaling pathway	16175	1267		0.4859154929577465	0.48951048951048953	16	16159	5	49	11	16110	16175	0.16865126291530805
R1	cpdb	0	network_modules	49	TRUE	2.6408858095087713e-6	95	48	8	0.16666666666666666	0.08421052631578947	REAC:R-HSA-9692914	REAC	SARS-CoV-1-host interactions	10916	2119		0.5833333333333334	0.5882352941176471	95	10821	8	40	87	10781	10916	0.11302422202126719
R1	cpdb	0	network_modules	49	TRUE	2.9629498434090717e-6	105	54	8	0.14814814814814814	0.0761904761904762	GO:0070555	GO:BP	response to interleukin-1	16175	16175		0.49295774647887325	0.4965034965034965	105	16070	8	46	97	16024	16175	0.10208914253382186
R1	cpdb	0	network_modules	49	TRUE	3.548524932735424e-6	197	44	10	0.22727272727272727	0.050761421319796954	KEGG:05130	KEGG	Pathogenic Escherichia coli infection	8484	427		0.5428571428571428	0.5555555555555556	197	8287	10	34	187	8253	8484	0.09782863968759833
R1	cpdb	0	network_modules	49	TRUE	3.955537450395106e-6	64	48	7	0.14583333333333334	0.109375	REAC:R-HSA-1834949	REAC	Cytosolic sensors of pathogen-associated DNA 	10916	428		0.5952380952380952	0.6	64	10852	7	41	57	10811	10916	0.12184300250651572
R1	cpdb	0	network_modules	49	TRUE	3.9773540176059265e-6	100	48	8	0.16666666666666666	0.08	REAC:R-HSA-5668541	REAC	TNFR2 non-canonical NF-kB pathway	10916	2450		0.6071428571428571	0.611764705882353	100	10816	8	40	92	10776	10916	0.10986833615098013
R1	cpdb	0	network_modules	49	TRUE	4.011270843778864e-6	197	48	10	0.20833333333333334	0.050761421319796954	REAC:R-HSA-9705683	REAC	SARS-CoV-2-host interactions	10916	2128		0.6190476190476191	0.6235294117647059	197	10719	10	38	187	10681	10916	0.09499634584264911
R1	cpdb	0	network_modules	49	TRUE	4.308461860291712e-6	18	54	5	0.09259259259259259	0.2777777777777778	GO:0002755	GO:BP	MyD88-dependent toll-like receptor signaling pathway	16175	1266		0.5	0.5034965034965035	18	16157	5	49	13	16108	16175	0.15880113476434085
R1	cpdb	0	network_modules	49	TRUE	4.72339893991824e-6	39	54	6	0.1111111111111111	0.15384615384615385	GO:0031663	GO:BP	lipopolysaccharide-mediated signaling pathway	16175	7267		0.5070422535211268	0.5104895104895105	39	16136	6	48	33	16088	16175	0.1282757048272253
R1	cpdb	0	network_modules	49	TRUE	5.042830227740912e-6	108	44	8	0.18181818181818182	0.07407407407407407	KEGG:05145	KEGG	Toxoplasmosis	8484	437		0.5714285714285714	0.5833333333333334	108	8376	8	36	100	8340	8484	0.10890284275960528
R1	cpdb	0	network_modules	49	TRUE	5.328621151229485e-6	113	54	8	0.14814814814814814	0.07079646017699115	GO:2001236	GO:BP	regulation of extrinsic apoptotic signaling pathway	16175	26425		0.5140845070422535	0.5174825174825175	113	16062	8	46	105	16016	16175	0.0980898635937985
R1	cpdb	0	network_modules	49	TRUE	6.846681113970806e-6	40	48	6	0.125	0.15	REAC:R-HSA-9692916	REAC	SARS-CoV-1 activates/modulates innate immune responses	10916	2115		0.6309523809523809	0.6352941176470588	40	10876	6	42	34	10834	10916	0.13345448427443818
R1	cpdb	0	network_modules	49	TRUE	8.048927060059488e-6	76	44	7	0.1590909090909091	0.09210526315789473	KEGG:05133	KEGG	Pertussis	8484	430		0.6	0.6111111111111112	76	8408	7	37	69	8371	8484	0.11504782566944961
R1	cpdb	0	network_modules	49	TRUE	8.679175184637106e-6	8	48	4	0.08333333333333333	0.5	REAC:R-HSA-75158	REAC	TRAIL  signaling	10916	2470		0.6428571428571429	0.6470588235294118	8	10908	4	44	4	10864	10916	0.20284964892787405
R1	cpdb	0	network_modules	49	TRUE	9.405414895369887e-6	77	54	7	0.12962962962962962	0.09090909090909091	GO:0032088	GO:BP	negative regulation of NF-kappaB transcription factor activity	16175	7355		0.5211267605633803	0.5244755244755245	77	16098	7	47	70	16051	16175	0.10499513458319232
R1	cpdb	0	network_modules	49	TRUE	1.0155294089184442e-5	21	54	5	0.09259259259259259	0.23809523809523808	GO:0060544	GO:BP	regulation of necroptotic process	16175	14733		0.528169014084507	0.5314685314685315	21	16154	5	49	16	16105	16175	0.14673682644835012
R1	cpdb	0	network_modules	49	TRUE	1.1148141830146361e-5	124	54	8	0.14814814814814814	0.06451612903225806	GO:0051092	GO:BP	positive regulation of NF-kappaB transcription factor activity	16175	13487		0.5352112676056338	0.5384615384615384	124	16051	8	46	116	16005	16175	0.09321889735961658
R1	cpdb	0	network_modules	49	TRUE	1.1648746594598116e-5	8	54	4	0.07407407407407407	0.5	GO:0038172	GO:BP	interleukin-33-mediated signaling pathway	16175	9748		0.5422535211267606	0.5524475524475524	8	16167	4	50	4	16117	16175	0.19153237919467886
R1	cpdb	0	network_modules	49	TRUE	1.1648746594598116e-5	8	54	4	0.07407407407407407	0.5	GO:0097527	GO:BP	necroptotic signaling pathway	16175	18687		0.5422535211267606	0.5524475524475524	8	16167	4	50	4	16117	16175	0.19153237919467886
R1	cpdb	0	network_modules	49	TRUE	1.2426097337745743e-5	44	48	6	0.125	0.13636363636363635	REAC:R-HSA-445989	REAC	TAK1-dependent IKK and NF-kappa-B activation  	10916	2417		0.6547619047619048	0.6588235294117647	44	10872	6	42	38	10830	10916	0.12688291549977154
R1	cpdb	0	network_modules	49	TRUE	1.2611718605364382e-5	22	48	5	0.10416666666666667	0.22727272727272727	REAC:R-HSA-450321	REAC	JNK (c-Jun kinases) phosphorylation and  activation mediated by activated human TAK1	10916	1279		0.6666666666666666	0.6705882352941176	22	10894	5	43	17	10851	10916	0.15137289002215365
R1	cpdb	0	network_modules	49	TRUE	1.591324730937134e-5	231	44	10	0.22727272727272727	0.04329004329004329	KEGG:05171	KEGG	Coronavirus disease - COVID-19	8484	452		0.6285714285714286	0.6388888888888888	231	8253	10	34	221	8219	8484	0.08875065623523191
R1	cpdb	0	network_modules	49	TRUE	1.60620645230569e-5	23	48	5	0.10416666666666667	0.21739130434782608	REAC:R-HSA-450302	REAC	activated TAK1 mediates p38 MAPK activation	10916	2685		0.6785714285714286	0.6823529411764706	23	10893	5	43	18	10850	10916	0.14791962979714735
R1	cpdb	0	network_modules	49	TRUE	1.670806402946839e-5	23	54	5	0.09259259259259259	0.21739130434782608	GO:0062098	GO:BP	regulation of programmed necrotic cell death	16175	15819		0.5563380281690141	0.5594405594405595	23	16152	5	49	18	16103	16175	0.14003066048366503
R1	cpdb	0	network_modules	49	TRUE	1.6819619184265563e-5	120	48	8	0.16666666666666666	0.06666666666666667	REAC:R-HSA-9705671	REAC	SARS-CoV-2 activates/modulates innate and adaptive immune responses	10916	2123		0.6904761904761905	0.6941176470588235	120	10796	8	40	112	10756	10916	0.09922070745084971
R1	cpdb	0	network_modules	49	TRUE	2.0350733792498888e-5	749	54	15	0.2777777777777778	0.020026702269692925	GO:0070647	GO:BP	protein modification by small protein conjugation or removal	16175	16231		0.5633802816901409	0.5664335664335665	749	15426	15	39	734	15387	16175	0.06374932679246562
R1	cpdb	0	network_modules	49	TRUE	2.5869856742010075e-5	10	48	4	0.08333333333333333	0.4	REAC:R-HSA-3371378	REAC	Regulation by c-FLIP	10916	1962		0.7023809523809523	0.7411764705882353	10	10906	4	44	6	10862	10916	0.1810483982688122
R1	cpdb	0	network_modules	49	TRUE	2.5869856742010075e-5	10	48	4	0.08333333333333333	0.4	REAC:R-HSA-937042	REAC	IRAK2 mediated activation of TAK1 complex	10916	1156		0.7023809523809523	0.7411764705882353	10	10906	4	44	6	10862	10916	0.1810483982688122
R1	cpdb	0	network_modules	49	TRUE	2.5869856742010075e-5	10	48	4	0.08333333333333333	0.4	REAC:R-HSA-5218900	REAC	CASP8 activity is inhibited	10916	263		0.7023809523809523	0.7411764705882353	10	10906	4	44	6	10862	10916	0.1810483982688122
R1	cpdb	0	network_modules	49	TRUE	2.5869856742010075e-5	10	48	4	0.08333333333333333	0.4	REAC:R-HSA-69416	REAC	Dimerization of procaspase-8	10916	745		0.7023809523809523	0.7411764705882353	10	10906	4	44	6	10862	10916	0.1810483982688122
R1	cpdb	0	network_modules	49	TRUE	2.6136476530406205e-5	89	54	7	0.12962962962962962	0.07865168539325842	GO:0002761	GO:BP	regulation of myeloid leukocyte differentiation	16175	1272		0.5704225352112676	0.5734265734265734	89	16086	7	47	82	16039	16175	0.09711660520390045
R1	cpdb	0	network_modules	49	TRUE	3.0303569628818728e-5	136	44	8	0.18181818181818182	0.058823529411764705	KEGG:05135	KEGG	Yersinia infection	8484	432		0.6571428571428571	0.6666666666666666	136	8348	8	36	128	8312	8484	0.0953121381251132
R1	cpdb	0	network_modules	49	TRUE	3.0332440790768425e-5	92	44	7	0.1590909090909091	0.07608695652173914	KEGG:04657	KEGG	IL-17 signaling pathway	8484	335		0.6857142857142857	0.6944444444444444	92	8392	7	37	85	8355	8484	0.10335106160410129
R1	cpdb	0	network_modules	49	TRUE	3.045961566591159e-5	3	48	3	0.0625	1	REAC:R-HSA-5602571	REAC	TRAF3 deficiency - HSE	10916	2463		0.75	0.7529411764705882	3	10913	3	45	0	10868	10916	0.2494840272436705
R1	cpdb	0	network_modules	49	TRUE	3.2146722422338016e-5	275	54	10	0.18518518518518517	0.03636363636363636	GO:2001233	GO:BP	regulation of apoptotic signaling pathway	16175	26422		0.5774647887323944	0.5804195804195804	275	15900	10	44	265	15856	16175	0.07529463248206698
R1	cpdb	0	network_modules	49	TRUE	3.477361041517505e-5	10	54	4	0.07407407407407407	0.4	GO:0060546	GO:BP	negative regulation of necroptotic process	16175	14735		0.5845070422535211	0.5874125874125874	10	16165	4	50	6	16115	16175	0.17103446437123598
R1	cpdb	0	network_modules	49	TRUE	3.63218097906033e-5	206	54	9	0.16666666666666666	0.043689320388349516	GO:1903320	GO:BP	regulation of protein modification by small protein conjugation or removal	16175	22904		0.5915492957746479	0.5944055944055944	206	15969	9	45	197	15924	16175	0.07945087731896247
R1	cpdb	0	network_modules	49	TRUE	3.8224921169710076e-5	667	54	14	0.25925925925925924	0.020989505247376312	GO:0032446	GO:BP	protein modification by small protein conjugation	16175	7568		0.5985915492957746	0.6013986013986014	667	15508	14	40	653	15468	16175	0.06346090286442724
R1	cpdb	0	network_modules	49	TRUE	3.9490381014189664e-5	208	54	9	0.16666666666666666	0.04326923076923077	GO:0051091	GO:BP	positive regulation of DNA-binding transcription factor activity	16175	13486		0.6056338028169014	0.6083916083916084	208	15967	9	45	199	15922	16175	0.07900941445718784
R1	cpdb	0	network_modules	49	TRUE	4.034024301133706e-5	146	54	8	0.14814814814814814	0.0547945205479452	GO:0062207	GO:BP	regulation of pattern recognition receptor signaling pathway	16175	15863		0.6126760563380281	0.6153846153846154	146	16029	8	46	138	15983	16175	0.0851355515538066
R1	cpdb	0	network_modules	49	TRUE	4.1163451537410474e-5	209	54	9	0.16666666666666666	0.0430622009569378	GO:1901873	GO:BP	regulation of post-translational protein modification	16175	21817		0.6197183098591549	0.6223776223776224	209	15966	9	45	200	15921	16175	0.07879095516874719
R1	cpdb	0	network_modules	49	TRUE	4.733228595264803e-5	798	54	15	0.2777777777777778	0.018796992481203006	GO:0043687	GO:BP	post-translational protein modification	16175	10838		0.6267605633802817	0.6293706293706294	798	15377	15	39	783	15338	16175	0.0610498513061366
R1	cpdb	0	network_modules	49	TRUE	5.450912109187232e-5	11	54	4	0.07407407407407407	0.36363636363636365	GO:0062099	GO:BP	negative regulation of programmed necrotic cell death	16175	15820		0.6338028169014085	0.6363636363636364	11	16164	4	50	7	16114	16175	0.16294275194190885
R1	cpdb	0	network_modules	49	TRUE	5.597009506124988e-5	140	48	8	0.16666666666666666	0.05714285714285714	REAC:R-HSA-9678108	REAC	SARS-CoV-1 Infection	10916	2114		0.7619047619047619	0.7647058823529411	140	10776	8	40	132	10736	10916	0.09086359237797564
R1	cpdb	0	network_modules	49	TRUE	6.647607820403696e-5	30	48	5	0.10416666666666667	0.16666666666666666	REAC:R-HSA-5260271	REAC	Diseases of Immune System	10916	759		0.7738095238095238	0.788235294117647	30	10886	5	43	25	10843	10916	0.128745282389906
R1	cpdb	0	network_modules	49	TRUE	6.647607820403696e-5	30	48	5	0.10416666666666667	0.16666666666666666	REAC:R-HSA-5602358	REAC	Diseases associated with the TLR signaling cascade	10916	753		0.7738095238095238	0.788235294117647	30	10886	5	43	25	10843	10916	0.128745282389906
R1	cpdb	0	network_modules	49	TRUE	6.776572222961631e-5	102	54	7	0.12962962962962962	0.06862745098039216	GO:0038061	GO:BP	non-canonical NF-kappaB signal transduction	16175	9680		0.6408450704225352	0.6433566433566433	102	16073	7	47	95	16026	16175	0.0901660038785652
R1	cpdb	0	network_modules	49	TRUE	7.528504385901064e-5	590	54	13	0.24074074074074073	0.022033898305084745	GO:0016567	GO:BP	protein ubiquitination	16175	5254		0.647887323943662	0.6503496503496503	590	15585	13	41	577	15544	16175	0.06306074341275868
R1	cpdb	0	network_modules	49	TRUE	7.755730060614894e-5	104	54	7	0.12962962962962962	0.0673076923076923	GO:0009612	GO:BP	response to mechanical stimulus	16175	3540		0.6549295774647887	0.6573426573426573	104	16071	7	47	97	16024	16175	0.08921083544001202
R1	cpdb	0	network_modules	49	TRUE	8.147870749749429e-5	594	54	13	0.24074074074074073	0.021885521885521887	GO:0006954	GO:BP	inflammatory response	16175	2585		0.6619718309859155	0.6643356643356644	594	15581	13	41	581	15540	16175	0.0627800283382088
R1	cpdb	0	network_modules	49	TRUE	8.7231404938511e-5	13	48	4	0.08333333333333333	0.3076923076923077	REAC:R-HSA-933543	REAC	NF-kB activation through FADD/RIP-1 pathway mediated by caspase-8 and -10	10916	1515		0.7976190476190477	0.8117647058823529	13	10903	4	44	9	10859	10916	0.15828222511422715
R1	cpdb	0	network_modules	49	TRUE	8.7231404938511e-5	13	48	4	0.08333333333333333	0.3076923076923077	REAC:R-HSA-209543	REAC	p75NTR recruits signalling complexes	10916	2723		0.7976190476190477	0.8117647058823529	13	10903	4	44	9	10859	10916	0.15828222511422715
R1	cpdb	0	network_modules	49	TRUE	9.253212369758928e-5	63	54	6	0.1111111111111111	0.09523809523809523	GO:0008625	GO:BP	extrinsic apoptotic signaling pathway via death domain receptors	16175	3214		0.6690140845070423	0.6713286713286714	63	16112	6	48	57	16064	16175	0.09962323416329044
R1	cpdb	0	network_modules	49	TRUE	1.0464859411103868e-4	165	54	8	0.14814814814814814	0.048484848484848485	GO:0002573	GO:BP	myeloid leukocyte differentiation	16175	1094		0.676056338028169	0.6783216783216783	165	16010	8	46	157	15964	16175	0.07945486560746773
R1	cpdb	0	network_modules	49	TRUE	1.271525116232324e-4	223	44	9	0.20454545454545456	0.04035874439461883	KEGG:05163	KEGG	Human cytomegalovirus infection	8484	444		0.7142857142857143	0.7222222222222222	223	8261	9	35	214	8226	8484	0.08045306590824056
R1	cpdb	0	network_modules	49	TRUE	1.4896479362038923e-4	35	48	5	0.10416666666666667	0.14285714285714285	REAC:R-HSA-936440	REAC	Negative regulators of DDX58/IFIH1 signaling	10916	1581		0.8214285714285714	0.8235294117647058	35	10881	5	43	30	10838	10916	0.11868390059606819
R1	cpdb	0	network_modules	49	TRUE	1.633054518594436e-4	292	48	10	0.20833333333333334	0.03424657534246575	REAC:R-HSA-9694516	REAC	SARS-CoV-2 Infection	10916	2122		0.8333333333333334	0.8352941176470589	292	10624	10	38	282	10586	10916	0.07479120244337284
R1	cpdb	0	network_modules	49	TRUE	1.7888140144722286e-4	248	54	9	0.16666666666666666	0.036290322580645164	GO:0000209	GO:BP	protein polyubiquitination	16175	59		0.6830985915492958	0.6853146853146853	248	15927	9	45	239	15882	16175	0.07128364602826158
R1	cpdb	0	network_modules	49	TRUE	2.0891619869875338e-4	37	54	5	0.09259259259259259	0.13513513513513514	GO:0043330	GO:BP	response to exogenous dsRNA	16175	10636		0.6901408450704225	0.6923076923076923	37	16138	5	49	32	16089	16175	0.10940364656480042
R1	cpdb	0	network_modules	49	TRUE	2.1990295423602452e-4	16	48	4	0.08333333333333333	0.25	REAC:R-HSA-193639	REAC	p75NTR signals via NF-kB	10916	2725		0.8452380952380952	0.8470588235294118	16	10900	4	44	12	10856	10916	0.14221588976584992
R1	cpdb	0	network_modules	49	TRUE	2.607474469809099e-4	39	48	5	0.10416666666666667	0.1282051282051282	REAC:R-HSA-5689896	REAC	Ovarian tumor domain proteases	10916	1653		0.8571428571428571	0.8588235294117647	39	10877	5	43	34	10834	10916	0.11204545277401506
R1	cpdb	0	network_modules	49	TRUE	2.863904317870274e-4	246	44	9	0.20454545454545456	0.036585365853658534	KEGG:05131	KEGG	Shigellosis	8484	428		0.7428571428571429	0.75	246	8238	9	35	237	8203	8484	0.07554007534511824
R1	cpdb	0	network_modules	49	TRUE	2.866384311517645e-4	17	48	4	0.08333333333333333	0.23529411764705882	REAC:R-HSA-1810476	REAC	RIP-mediated NFkB activation via ZBP1	10916	1876		0.8690476190476191	0.8705882352941177	17	10899	4	44	13	10855	10916	0.13782161503165288
R1	cpdb	0	network_modules	49	TRUE	3.159832077844359e-4	791	54	14	0.25925925925925924	0.017699115044247787	GO:1901701	GO:BP	cellular response to oxygen-containing compound	16175	21654		0.6971830985915493	0.6993006993006993	791	15384	14	40	777	15344	16175	0.05645189318661453
R1	cpdb	0	network_modules	49	TRUE	3.555587554518903e-4	41	54	5	0.09259259259259259	0.12195121951219512	GO:0043331	GO:BP	response to dsRNA	16175	10637		0.704225352112676	0.7062937062937062	41	16134	5	49	36	16085	16175	0.10365819438774762
R1	cpdb	0	network_modules	49	TRUE	4.1345787670462973e-4	330	44	10	0.22727272727272727	0.030303030303030304	KEGG:05165	KEGG	Human papillomavirus infection	8484	446		0.7714285714285715	0.7777777777777778	330	8154	10	34	320	8120	8484	0.07034593023703649
R1	cpdb	0	network_modules	49	TRUE	4.516253977249188e-4	89	44	6	0.13636363636363635	0.06741573033707865	KEGG:05235	KEGG	PD-L1 expression and PD-1 checkpoint pathway in cancer	8484	480		0.8	0.8055555555555556	89	8395	6	38	83	8357	8484	0.08920394165346851
R1	cpdb	0	network_modules	49	TRUE	5.738460273139927e-4	45	54	5	0.09259259259259259	0.1111111111111111	GO:0002763	GO:BP	positive regulation of myeloid leukocyte differentiation	16175	1274		0.7112676056338029	0.7132867132867133	45	16130	5	49	40	16081	16175	0.09868450291288697
R1	cpdb	0	network_modules	49	TRUE	6.908005393965076e-4	143	54	7	0.12962962962962962	0.04895104895104895	GO:0043433	GO:BP	negative regulation of DNA-binding transcription factor activity	16175	10690		0.7183098591549296	0.7202797202797203	143	16032	7	47	136	15985	16175	0.07468099048958529
R1	cpdb	0	network_modules	49	TRUE	6.915977008126652e-4	291	54	9	0.16666666666666666	0.030927835051546393	GO:0030099	GO:BP	myeloid cell differentiation	16175	6677		0.7253521126760564	0.7272727272727273	291	15884	9	45	282	15839	16175	0.06473802414502754
R1	cpdb	0	network_modules	49	TRUE	8.866362184332e-4	49	54	5	0.09259259259259259	0.10204081632653061	GO:0140374	GO:BP	antiviral innate immune response	16175	19754		0.7323943661971831	0.7342657342657343	49	16126	5	49	44	16077	16175	0.09432211752027826
R1	cpdb	0	network_modules	49	TRUE	0.0010529621267703698	7	48	3	0.0625	0.42857142857142855	REAC:R-HSA-9693928	REAC	Defective RIPK1-mediated regulated necrosis	10916	613		0.8809523809523809	0.8823529411764706	7	10909	3	45	4	10864	10916	0.16239359860749447
R1	cpdb	0	network_modules	49	TRUE	0.0010583317504518038	6	54	3	0.05555555555555555	0.5	GO:0006924	GO:BP	activation-induced cell death of T cells	16175	2566		0.7394366197183099	0.7412587412587412	6	16169	3	51	3	16118	16175	0.16586164707534398
R1	cpdb	0	network_modules	49	TRUE	0.001256850872708328	408	54	10	0.18518518518518517	0.024509803921568627	GO:0071396	GO:BP	cellular response to lipid	16175	16648		0.7464788732394366	0.7482517482517482	408	15767	10	44	398	15723	16175	0.05904115923959968
R1	cpdb	0	network_modules	49	TRUE	0.0013158686905782575	632	54	12	0.2222222222222222	0.0189873417721519	GO:0031401	GO:BP	positive regulation of protein modification process	16175	7157		0.7535211267605634	0.7552447552447552	632	15543	12	42	620	15501	16175	0.05470476326025093
R1	cpdb	0	network_modules	49	TRUE	0.0013559251437194183	459	48	11	0.22916666666666666	0.023965141612200435	REAC:R-HSA-9679506	REAC	SARS-CoV Infections	10916	2112		0.8928571428571429	0.8941176470588236	459	10457	11	37	448	10420	10916	0.06196061088896979
R1	cpdb	0	network_modules	49	TRUE	0.0014137281224467803	520	54	11	0.2037037037037037	0.021153846153846155	GO:0033993	GO:BP	response to lipid	16175	8371		0.7605633802816901	0.7622377622377622	520	15655	11	43	509	15612	16175	0.056288694909310946
R1	cpdb	0	network_modules	49	TRUE	0.0014598187312235317	97	48	6	0.125	0.061855670103092786	REAC:R-HSA-5607764	REAC	CLEC7A (Dectin-1) signaling	10916	275		0.9047619047619048	0.9058823529411765	97	10819	6	42	91	10777	10916	0.08222698082063096
R1	cpdb	0	network_modules	49	TRUE	0.0014689096526236585	301	44	9	0.20454545454545456	0.029900332225913623	KEGG:04010	KEGG	MAPK signaling pathway	8484	243		0.8285714285714286	0.8333333333333334	301	8183	9	35	292	8148	8484	0.06598950309515629
R1	cpdb	0	network_modules	49	TRUE	0.0015184847193894086	165	44	7	0.1590909090909091	0.04242424242424243	KEGG:04140	KEGG	Autophagy - animal	8484	277		0.8571428571428571	0.8611111111111112	165	8319	7	37	158	8282	8484	0.07301228944474712
R1	cpdb	0	network_modules	49	TRUE	0.0015387802958150229	161	54	7	0.12962962962962962	0.043478260869565216	GO:0045637	GO:BP	regulation of myeloid cell differentiation	16175	11488		0.7676056338028169	0.7692307692307693	161	16014	7	47	154	15967	16175	0.06977331963893399
R1	cpdb	0	network_modules	49	TRUE	0.0015954801953071995	32	44	4	0.09090909090909091	0.125	KEGG:04215	KEGG	Apoptosis - multiple species	8484	292		0.8857142857142857	0.8888888888888888	32	8452	4	40	28	8412	8484	0.1026372639641341
R1	cpdb	0	network_modules	49	TRUE	0.0017585750645796971	103	54	6	0.1111111111111111	0.05825242718446602	GO:0039531	GO:BP	regulation of cytoplasmic pattern recognition receptor signaling pathway	16175	9804		0.7746478873239436	0.7832167832167832	103	16072	6	48	97	16024	16175	0.07621100531894248
R1	cpdb	0	network_modules	49	TRUE	0.0017585750645796971	103	54	6	0.1111111111111111	0.05825242718446602	GO:0052547	GO:BP	regulation of peptidase activity	16175	14133		0.7746478873239436	0.7832167832167832	103	16072	6	48	97	16024	16175	0.07621100531894248
R1	cpdb	0	network_modules	49	TRUE	0.0020475145607116558	168	54	7	0.12962962962962962	0.041666666666666664	GO:0031396	GO:BP	regulation of protein ubiquitination	16175	7152		0.7887323943661971	0.7902097902097902	168	16007	7	47	161	15960	16175	0.06807212396758255
R1	cpdb	0	network_modules	49	TRUE	0.002289963421163972	118	44	6	0.13636363636363635	0.05084745762711865	KEGG:04722	KEGG	Neurotrophin signaling pathway	8484	352		0.9142857142857143	0.9166666666666666	118	8366	6	38	112	8328	8484	0.07549752728032377
R1	cpdb	0	network_modules	49	TRUE	0.0024108648406029154	249	54	8	0.14814814814814814	0.0321285140562249	GO:0051251	GO:BP	positive regulation of lymphocyte activation	16175	13598		0.795774647887324	0.7972027972027972	249	15926	8	46	241	15880	16175	0.06240793846897981
R1	cpdb	0	network_modules	49	TRUE	0.002516720361980812	72	44	5	0.11363636363636363	0.06944444444444445	KEGG:01524	KEGG	Platinum drug resistance	8484	198		0.9428571428571428	0.9444444444444444	72	8412	5	39	67	8373	8484	0.08276531044571916
R1	cpdb	0	network_modules	49	TRUE	0.0025594917946215796	251	54	8	0.14814814814814814	0.03187250996015936	GO:0104004	GO:BP	cellular response to environmental stimulus	16175	19202		0.8028169014084507	0.8111888111888111	251	15924	8	46	243	15878	16175	0.06210480874783251
R1	cpdb	0	network_modules	49	TRUE	0.0025594917946215796	251	54	8	0.14814814814814814	0.03187250996015936	GO:0071214	GO:BP	cellular response to abiotic stimulus	16175	16476		0.8028169014084507	0.8111888111888111	251	15924	8	46	243	15878	16175	0.06210480874783251
R1	cpdb	0	network_modules	49	TRUE	0.00294174699891548	63	48	5	0.10416666666666667	0.07936507936507936	REAC:R-HSA-450294	REAC	MAP kinase activation	10916	1345		0.9166666666666666	0.9176470588235294	63	10853	5	43	58	10810	10916	0.0863254011605372
R1	cpdb	0	network_modules	49	TRUE	0.0031649455210940036	30	48	4	0.08333333333333333	0.13333333333333333	REAC:R-HSA-933541	REAC	TRAF6 mediated IRF7 activation	10916	2465		0.9285714285714286	0.9294117647058824	30	10886	4	44	26	10842	10916	0.10229847202919441
R1	cpdb	0	network_modules	49	TRUE	0.0032427135342294375	28	54	4	0.07407407407407407	0.14285714285714285	GO:0034143	GO:BP	regulation of toll-like receptor 4 signaling pathway	16175	8451		0.8169014084507042	0.8181818181818182	28	16147	4	50	24	16097	16175	0.10072025166801711
R1	cpdb	0	network_modules	49	TRUE	0.0035305133970060746	116	54	6	0.1111111111111111	0.05172413793103448	GO:1901875	GO:BP	positive regulation of post-translational protein modification	16175	21819		0.823943661971831	0.8251748251748252	116	16059	6	48	110	16011	16175	0.07129150271836826
R1	cpdb	0	network_modules	49	TRUE	0.0037635841528445473	575	54	11	0.2037037037037037	0.019130434782608695	GO:0044092	GO:BP	negative regulation of molecular function	16175	10914		0.8309859154929577	0.8321678321678322	575	15600	11	43	564	15557	16175	0.05256041543318632
R1	cpdb	0	network_modules	49	TRUE	0.004318829811798957	30	54	4	0.07407407407407407	0.13333333333333333	GO:0002260	GO:BP	lymphocyte homeostasis	16175	792		0.8380281690140845	0.8391608391608392	30	16145	4	50	26	16095	16175	0.09714471169511268
R1	cpdb	0	network_modules	49	TRUE	0.004723197388321275	82	44	5	0.11363636363636363	0.06097560975609756	KEGG:04623	KEGG	Cytosolic DNA-sensing pathway	8484	328		0.9714285714285714	0.9722222222222222	82	8402	5	39	77	8363	8484	0.076730883066622
R1	cpdb	0	network_modules	49	TRUE	0.004812858888805732	253	48	8	0.16666666666666666	0.03162055335968379	REAC:R-HSA-1257604	REAC	PIP3 activates AKT signaling	10916	1679		0.9404761904761905	0.9411764705882353	253	10663	8	40	245	10623	10916	0.06337675939766278
R1	cpdb	0	network_modules	49	TRUE	0.004902886397081955	11	48	3	0.0625	0.2727272727272727	REAC:R-HSA-9645460	REAC	Alpha-protein kinase 1 signaling pathway	10916	135		0.9523809523809523	0.9529411764705882	11	10905	3	45	8	10860	10916	0.12880150124986597
R1	cpdb	0	network_modules	49	TRUE	0.004941428577970345	369	54	9	0.16666666666666666	0.024390243902439025	GO:0051249	GO:BP	regulation of lymphocyte activation	16175	13596		0.8450704225352113	0.8461538461538461	369	15806	9	45	360	15761	16175	0.0557624691203956
R1	cpdb	0	network_modules	49	TRUE	0.004946407729963901	31	54	4	0.07407407407407407	0.12903225806451613	GO:0070231	GO:BP	T cell apoptotic process	16175	16001		0.852112676056338	0.8531468531468531	31	16144	4	50	27	16094	16175	0.09548616581071
R1	cpdb	0	network_modules	49	TRUE	0.004966766313106516	123	54	6	0.1111111111111111	0.04878048780487805	GO:0002700	GO:BP	regulation of production of molecular mediator of immune response	16175	1218		0.8591549295774648	0.8601398601398601	123	16052	6	48	117	16004	16175	0.06895993790616395
R1	cpdb	0	network_modules	49	TRUE	0.005048876182618904	275	54	8	0.14814814814814814	0.02909090909090909	GO:0002696	GO:BP	positive regulation of leukocyte activation	16175	1214		0.8661971830985915	0.8671328671328671	275	15900	8	46	267	15854	16175	0.058713411510012074
R1	cpdb	0	network_modules	49	TRUE	0.005307781414081827	71	48	5	0.10416666666666667	0.07042253521126761	REAC:R-HSA-448424	REAC	Interleukin-17 signaling	10916	1238		0.9642857142857143	0.9647058823529412	71	10845	5	43	66	10802	10916	0.0807407919919149
R1	cpdb	0	network_modules	49	TRUE	0.005636127922132529	375	54	9	0.16666666666666666	0.024	GO:0030162	GO:BP	regulation of proteolysis	16175	6690		0.8732394366197183	0.8741258741258742	375	15800	9	45	366	15755	16175	0.055182410431576776
R1	cpdb	0	network_modules	49	TRUE	0.006138462967857684	72	54	5	0.09259259259259259	0.06944444444444445	GO:2001237	GO:BP	negative regulation of extrinsic apoptotic signaling pathway	16175	26426		0.8802816901408451	0.8811188811188811	72	16103	5	49	67	16054	16175	0.07663106881787066
R1	cpdb	0	network_modules	49	TRUE	0.006258965230316267	128	54	6	0.1111111111111111	0.046875	GO:0032640	GO:BP	tumor necrosis factor production	16175	7687		0.8873239436619719	0.8951048951048951	128	16047	6	48	122	15999	16175	0.0674082632123286
R1	cpdb	0	network_modules	49	TRUE	0.006258965230316267	128	54	6	0.1111111111111111	0.046875	GO:0032680	GO:BP	regulation of tumor necrosis factor production	16175	7726		0.8873239436619719	0.8951048951048951	128	16047	6	48	122	15999	16175	0.0674082632123286
R1	cpdb	0	network_modules	49	TRUE	0.006290156553333039	10	54	3	0.05555555555555555	0.3	GO:0034139	GO:BP	regulation of toll-like receptor 3 signaling pathway	16175	8447		0.9014084507042254	0.9230769230769231	10	16165	3	51	7	16114	16175	0.1279159721454763
R1	cpdb	0	network_modules	49	TRUE	0.006290156553333039	10	54	3	0.05555555555555555	0.3	GO:0070673	GO:BP	response to interleukin-18	16175	16254		0.9014084507042254	0.9230769230769231	10	16165	3	51	7	16114	16175	0.1279159721454763
R1	cpdb	0	network_modules	49	TRUE	0.006290156553333039	10	54	3	0.05555555555555555	0.3	GO:0071351	GO:BP	cellular response to interleukin-18	16175	16603		0.9014084507042254	0.9230769230769231	10	16165	3	51	7	16114	16175	0.1279159721454763
R1	cpdb	0	network_modules	49	TRUE	0.006290156553333039	10	54	3	0.05555555555555555	0.3	GO:0035655	GO:BP	interleukin-18-mediated signaling pathway	16175	9141		0.9014084507042254	0.9230769230769231	10	16165	3	51	7	16114	16175	0.1279159721454763
R1	cpdb	0	network_modules	49	TRUE	0.006573203058185004	73	54	5	0.09259259259259259	0.0684931506849315	GO:0071887	GO:BP	leukocyte apoptotic process	16175	16965		0.9295774647887324	0.9300699300699301	73	16102	5	49	68	16053	16175	0.07605336914556152
R1	cpdb	0	network_modules	49	TRUE	0.006692143933199852	383	54	9	0.16666666666666666	0.02349869451697128	GO:0002683	GO:BP	negative regulation of immune system process	16175	1201		0.9366197183098591	0.9370629370629371	383	15792	9	45	374	15747	16175	0.05442861385407489
R1	cpdb	0	network_modules	49	TRUE	0.006981295555212607	385	54	9	0.16666666666666666	0.023376623376623377	GO:0043065	GO:BP	positive regulation of apoptotic process	16175	10511		0.9436619718309859	0.9440559440559441	385	15790	9	45	376	15745	16175	0.05424354753389642
R1	cpdb	0	network_modules	49	TRUE	0.007226874899516492	2	48	2	0.041666666666666664	1	REAC:R-HSA-5602566	REAC	TICAM1 deficiency - HSE	10916	2439		0.9761904761904762	0.9764705882352941	2	10914	2	46	0	10868	10916	0.20369352284537695
R1	cpdb	0	network_modules	49	TRUE	0.007408864840283131	76	48	5	0.10416666666666667	0.06578947368421052	REAC:R-HSA-909733	REAC	Interferon alpha/beta signaling	10916	1228		0.9880952380952381	0.9882352941176471	76	10840	5	43	71	10797	10916	0.07769156316541301
R1	cpdb	0	network_modules	49	TRUE	0.007472247277451869	290	54	8	0.14814814814814814	0.027586206896551724	GO:0050867	GO:BP	positive regulation of cell activation	16175	13315		0.9507042253521126	0.951048951048951	290	15885	8	46	282	15839	16175	0.05679730726407519
R1	cpdb	0	network_modules	49	TRUE	0.00764075507001822	619	54	11	0.2037037037037037	0.017770597738287562	GO:1901698	GO:BP	response to nitrogen compound	16175	21651		0.9577464788732394	0.958041958041958	619	15556	11	43	608	15513	16175	0.049908863557038816
R1	cpdb	0	network_modules	49	TRUE	0.007812495546593084	133	54	6	0.1111111111111111	0.045112781954887216	GO:0071706	GO:BP	tumor necrosis factor superfamily cytokine production	16175	16870		0.9647887323943662	0.972027972027972	133	16042	6	48	127	15994	16175	0.06594124328282297
R1	cpdb	0	network_modules	49	TRUE	0.007812495546593084	133	54	6	0.1111111111111111	0.045112781954887216	GO:1903555	GO:BP	regulation of tumor necrosis factor superfamily cytokine production	16175	23102		0.9647887323943662	0.972027972027972	133	16042	6	48	127	15994	16175	0.06594124328282297
R1	cpdb	0	network_modules	49	TRUE	0.008192388474925	92	44	5	0.11363636363636363	0.05434782608695652	KEGG:05222	KEGG	Small cell lung cancer	8484	473		1	1	92	8392	5	39	87	8353	8484	0.07166221423694569
R1	cpdb	0	network_modules	49	TRUE	0.008445912928065442	13	48	3	0.0625	0.23076923076923078	REAC:R-HSA-209560	REAC	NF-kB is activated and signals survival	10916	1516		1	1	13	10903	3	45	10	10858	10916	0.11813796932085115
R1	cpdb	0	network_modules	49	TRUE	0.008628524340423471	11	54	3	0.05555555555555555	0.2727272727272727	GO:0140052	GO:BP	cellular response to oxidised low-density lipoprotein particle stimulus	16175	19652		0.9788732394366197	0.9790209790209791	11	16164	3	51	8	16113	16175	0.121829611008761
R1	cpdb	0	network_modules	49	TRUE	0.009037096663440273	630	54	11	0.2037037037037037	0.01746031746031746	GO:0043069	GO:BP	negative regulation of programmed cell death	16175	10515		0.9859154929577465	0.986013986013986	630	15545	11	43	619	15502	16175	0.049285296885298265
R1	cpdb	0	network_modules	49	TRUE	0.009707605379314622	401	54	9	0.16666666666666666	0.022443890274314215	GO:0043068	GO:BP	positive regulation of programmed cell death	16175	10514		0.9929577464788732	0.993006993006993	401	15774	9	45	392	15729	16175	0.05280912065171918
R1	cpdb	0	network_modules	49	TRUE	0.009714596873677471	79	54	5	0.09259259259259259	0.06329113924050633	GO:0045639	GO:BP	positive regulation of myeloid cell differentiation	16175	11490		1	1	79	16096	5	49	74	16047	16175	0.07281391746333994
R1	cpdb	0	network_modules	50	TRUE	1.1942015008297727e-14	248	19	13	0.6842105263157895	0.05241935483870968	KEGG:04144	KEGG	Endocytosis	8484	280		NA	1	248	8236	13	6	235	8230	8484	0.1842075246344187
R1	cpdb	0	network_modules	50	TRUE	8.872713796397983e-11	64	22	8	0.36363636363636365	0.125	REAC:R-HSA-8873719	REAC	RAB geranylgeranylation	10916	1835		0	0.2	64	10852	8	14	56	10838	10916	0.2105932092713627
R1	cpdb	0	network_modules	50	TRUE	1.5795115755472842e-8	120	22	8	0.36363636363636365	0.06666666666666667	REAC:R-HSA-9007101	REAC	Rab regulation of trafficking	10916	1939		0.25	0.4	120	10796	8	14	112	10782	10916	0.15198292195412766
R1	cpdb	0	network_modules	50	TRUE	6.528413463144219e-8	137	27	8	0.2962962962962963	0.058394160583941604	GO:0098876	GO:BP	vesicle-mediated transport to the plasma membrane	16175	18924		0	0.05555555555555555	137	16038	8	19	129	16019	16175	0.12842870165211087
R1	cpdb	0	network_modules	50	TRUE	7.131960549961749e-8	44	22	6	0.2727272727272727	0.13636363636363635	REAC:R-HSA-8854214	REAC	TBC/RABGAPs	10916	2420		0.5	0.6	44	10872	6	16	38	10856	10916	0.19057332822537604
R1	cpdb	0	network_modules	50	TRUE	4.960069250357971e-7	270	27	9	0.3333333333333333	0.03333333333333333	GO:0016197	GO:BP	endosomal transport	16175	5169		0.058823529411764705	0.1111111111111111	270	15905	9	18	261	15887	16175	0.10106135173098506
R1	cpdb	0	network_modules	50	TRUE	5.669603375073741e-7	533	27	11	0.4074074074074074	0.020637898686679174	GO:0006897	GO:BP	endocytosis	16175	2551		0.11764705882352941	0.16666666666666666	533	15642	11	16	522	15626	16175	0.08577427617839047
R1	cpdb	0	network_modules	50	TRUE	4.769029740738181e-6	79	27	6	0.2222222222222222	0.0759493670886076	GO:0032456	GO:BP	endocytic recycling	16175	7571		0.17647058823529413	0.2222222222222222	79	16096	6	21	73	16075	16175	0.12747652714138644
R1	cpdb	0	network_modules	50	TRUE	1.776327173187361e-5	740	27	11	0.4074074074074074	0.014864864864864866	GO:0098657	GO:BP	import into cell	16175	18813		0.23529411764705882	0.2777777777777778	740	15435	11	16	729	15419	16175	0.07077753821892818
R1	cpdb	0	network_modules	50	TRUE	1.8936604578257506e-5	409	27	9	0.3333333333333333	0.022004889975550123	GO:0060627	GO:BP	regulation of vesicle-mediated transport	16175	14803		0.29411764705882354	0.3333333333333333	409	15766	9	18	400	15748	16175	0.08023464419487025
R1	cpdb	0	network_modules	50	TRUE	1.1448258815321243e-4	504	27	9	0.3333333333333333	0.017857142857142856	GO:0072657	GO:BP	protein localization to membrane	16175	17478		0.35294117647058826	0.3888888888888889	504	15671	9	18	495	15653	16175	0.07111487778807946
R1	cpdb	0	network_modules	50	TRUE	2.3920101448248604e-4	88	22	5	0.22727272727272727	0.056818181818181816	REAC:R-HSA-8876198	REAC	RAB GEFs exchange GTP for GDP on RABs	10916	1834		0.75	0.8	88	10828	5	17	83	10811	10916	0.11016113325025677
R1	cpdb	0	network_modules	50	TRUE	4.6293491950489467e-4	594	27	9	0.3333333333333333	0.015151515151515152	GO:0051668	GO:BP	localization within membrane	16175	13880		0.4117647058823529	0.4444444444444444	594	15581	9	18	585	15563	16175	0.06448544425069544
R1	cpdb	0	network_modules	50	TRUE	5.025012175170223e-4	285	27	7	0.25925925925925924	0.02456140350877193	GO:1990778	GO:BP	protein localization to cell periphery	16175	25286		0.47058823529411764	0.5	285	15890	7	20	278	15870	16175	0.07510179325837583
R1	cpdb	0	network_modules	50	TRUE	0.0017036341637934823	503	27	8	0.2962962962962963	0.015904572564612324	GO:0120031	GO:BP	plasma membrane bounded cell projection assembly	16175	19467		0.5294117647058824	0.5555555555555556	503	15672	8	19	495	15653	16175	0.062472998961895884
R1	cpdb	0	network_modules	50	TRUE	0.0020042897316805055	514	27	8	0.2962962962962963	0.01556420233463035	GO:0030031	GO:BP	cell projection assembly	16175	6655		0.5882352941176471	0.6111111111111112	514	15661	8	19	506	15642	16175	0.06166406380975378
R1	cpdb	0	network_modules	50	TRUE	0.0035772253304888753	16	27	3	0.1111111111111111	0.1875	GO:0097494	GO:BP	regulation of vesicle size	16175	18677		0.6470588235294118	0.6666666666666666	16	16159	3	24	13	16135	16175	0.14324299225971948
R1	cpdb	0	network_modules	50	TRUE	0.004192715654658986	2	27	2	0.07407407407407407	1	GO:0043324	GO:BP	pigment metabolic process involved in developmental pigmentation	16175	10632		0.7058823529411765	0.8333333333333334	2	16173	2	25	0	16148	16175	0.27195509076604235
R1	cpdb	0	network_modules	50	TRUE	0.004192715654658986	2	27	2	0.07407407407407407	1	GO:0006726	GO:BP	eye pigment biosynthetic process	16175	2430		0.7058823529411765	0.8333333333333334	2	16173	2	25	0	16148	16175	0.27195509076604235
R1	cpdb	0	network_modules	50	TRUE	0.004192715654658986	2	27	2	0.07407407407407407	1	GO:0042441	GO:BP	eye pigment metabolic process	16175	10181		0.7058823529411765	0.8333333333333334	2	16173	2	25	0	16148	16175	0.27195509076604235
R1	cpdb	0	network_modules	50	TRUE	0.004338940416778568	17	27	3	0.1111111111111111	0.17647058823529413	GO:2001135	GO:BP	regulation of endocytic recycling	16175	26355		0.8823529411764706	0.8888888888888888	17	16158	3	24	14	16134	16175	0.13889239510379298
R1	cpdb	0	network_modules	50	TRUE	0.004845262257271754	253	27	6	0.2222222222222222	0.023715415019762844	GO:0072659	GO:BP	protein localization to plasma membrane	16175	17480		0.9411764705882353	0.9444444444444444	253	15922	6	21	247	15901	16175	0.06807657317218993
R1	cpdb	0	network_modules	50	TRUE	0.005944791171019307	169	22	5	0.22727272727272727	0.029585798816568046	REAC:R-HSA-983231	REAC	Factors involved in megakaryocyte development and platelet production	10916	931		1	1	169	10747	5	17	164	10730	10916	0.07709060090457986
R1	cpdb	0	network_modules	50	TRUE	0.006059652159880835	263	27	6	0.2222222222222222	0.022813688212927757	GO:0006887	GO:BP	exocytosis	16175	2543		1	1	263	15912	6	21	257	15891	16175	0.06659089128279888
R1	cpdb	0	network_modules	51	TRUE	3.838150636954787e-36	84	28	21	0.75	0.25	KEGG:03083	KEGG	Polycomb repressive complex	8484	220		0	0.5	84	8400	21	7	63	8393	8484	0.4301379148922059
R1	cpdb	0	network_modules	51	TRUE	4.4504478702780695e-23	36	22	12	0.5454545454545454	0.3333333333333333	REAC:R-HSA-8939243	REAC	RUNX1 interacts with co-factors whose precise effect on RUNX1 targets is not known	10916	1916		0	0.0625	36	10880	12	10	24	10870	10916	0.4249523745040487
R1	cpdb	0	network_modules	51	TRUE	1.3643336803605617e-16	15	22	8	0.36363636363636365	0.5333333333333333	REAC:R-HSA-4655427	REAC	SUMOylation of DNA methylation proteins	10916	2169		0.06666666666666667	0.125	15	10901	8	14	7	10887	10916	0.43946616461826515
R1	cpdb	0	network_modules	51	TRUE	1.9556167520296332e-15	59	22	10	0.45454545454545453	0.1694915254237288	REAC:R-HSA-8943724	REAC	Regulation of PTEN gene transcription	10916	1999		0.13333333333333333	0.1875	59	10857	10	12	49	10845	10916	0.27528498124977935
R1	cpdb	0	network_modules	51	TRUE	1.8389292644091011e-13	138	22	11	0.5	0.07971014492753623	REAC:R-HSA-6807070	REAC	PTEN Regulation	10916	1703		0.2	0.25	138	10778	11	11	127	10767	10916	0.1960291489292749
R1	cpdb	0	network_modules	51	TRUE	3.7667566398480156e-13	34	22	8	0.36363636363636365	0.23529411764705882	REAC:R-HSA-8953750	REAC	Transcriptional Regulation by E2F6	10916	2543		0.26666666666666666	0.3125	34	10882	8	14	26	10868	10916	0.2907493391543058
R1	cpdb	0	network_modules	51	TRUE	1.2678421580681517e-12	234	22	12	0.5454545454545454	0.05128205128205128	REAC:R-HSA-8878171	REAC	Transcriptional regulation by RUNX1	10916	2552		0.3333333333333333	0.375	234	10682	12	10	222	10672	10916	0.16258979094474185
R1	cpdb	0	network_modules	51	TRUE	1.96647349807155e-12	41	22	8	0.36363636363636365	0.1951219512195122	REAC:R-HSA-3899300	REAC	SUMOylation of transcription cofactors	10916	2177		0.4	0.4375	41	10875	8	14	33	10861	10916	0.26438257383068436
R1	cpdb	0	network_modules	51	TRUE	2.9775914780253833e-12	43	22	8	0.36363636363636365	0.18604651162790697	REAC:R-HSA-4570464	REAC	SUMOylation of RNA binding proteins	10916	2171		0.4666666666666667	0.5	43	10873	8	14	35	10859	10916	0.2580532347144893
R1	cpdb	0	network_modules	51	TRUE	4.026212137827649e-12	122	22	10	0.45454545454545453	0.08196721311475409	REAC:R-HSA-2559580	REAC	Oxidative Stress Induced Senescence	10916	1654		0.5333333333333333	0.5625	122	10794	10	12	112	10782	10916	0.18952895998737457
R1	cpdb	0	network_modules	51	TRUE	1.1487237088392913e-10	66	22	8	0.36363636363636365	0.12121212121212122	REAC:R-HSA-4551638	REAC	SUMOylation of chromatin organization proteins	10916	2173		0.6	0.625	66	10850	8	14	58	10836	10916	0.2072907603642666
R1	cpdb	0	network_modules	51	TRUE	1.5676622757712525e-10	253	22	11	0.5	0.043478260869565216	REAC:R-HSA-1257604	REAC	PIP3 activates AKT signaling	10916	1679		0.6666666666666666	0.6875	253	10663	11	11	242	10652	10916	0.14240932357324185
R1	cpdb	0	network_modules	51	TRUE	2.377415868348928e-10	72	22	8	0.36363636363636365	0.1111111111111111	REAC:R-HSA-3108214	REAC	SUMOylation of DNA damage response and repair proteins	10916	2168		0.7333333333333333	0.75	72	10844	8	14	64	10830	10916	0.19821554510906747
R1	cpdb	0	network_modules	51	TRUE	4.46439790990873e-10	194	22	10	0.45454545454545453	0.05154639175257732	REAC:R-HSA-2559583	REAC	Cellular Senescence	10916	331		0.8	0.8125	194	10722	10	12	184	10710	10916	0.14855886544118369
R1	cpdb	0	network_modules	51	TRUE	7.821624386692025e-10	293	22	11	0.5	0.03754266211604096	REAC:R-HSA-9006925	REAC	Intracellular signaling by second messengers	10916	1266		0.8666666666666667	0.875	293	10623	11	11	282	10612	10916	0.13156203419958112
R1	cpdb	0	network_modules	51	TRUE	2.721824869460415e-7	171	22	8	0.36363636363636365	0.04678362573099415	REAC:R-HSA-3108232	REAC	SUMO E3 ligases SUMOylate target proteins	10916	2163		0.9333333333333333	0.9375	171	10745	8	14	163	10731	10916	0.12592829508401826
R1	cpdb	0	network_modules	51	TRUE	3.5822123741583074e-7	177	22	8	0.36363636363636365	0.04519774011299435	REAC:R-HSA-2990846	REAC	SUMOylation	10916	2167		1	1	177	10739	8	14	169	10725	10916	0.12361451943068993
R1	cpdb	0	network_modules	51	TRUE	7.828903491066179e-5	454	37	10	0.2702702702702703	0.022026431718061675	GO:0006338	GO:BP	chromatin remodeling	16175	2126		0	0.3333333333333333	454	15721	10	27	444	15694	16175	0.07021509440660027
R1	cpdb	0	network_modules	51	TRUE	1.6596367927847162e-4	791	37	12	0.32432432432432434	0.015170670037926675	GO:0000122	GO:BP	negative regulation of transcription by RNA polymerase II	16175	48		0.5	0.6666666666666666	791	15384	12	25	779	15359	16175	0.06114987421057653
R1	cpdb	0	network_modules	51	TRUE	3.260924314642375e-4	529	37	10	0.2702702702702703	0.01890359168241966	GO:0006325	GO:BP	chromatin organization	16175	2122		1	1	529	15646	10	27	519	15619	16175	0.06395494497311473
R1	cpdb	0	network_modules	51	TRUE	0.005743284510053106	143	28	5	0.17857142857142858	0.03496503496503497	KEGG:04550	KEGG	Signaling pathways regulating pluripotency of stem cells	8484	319		1	1	143	8341	5	23	138	8318	8484	0.07228922363252593
R1	cpdb	0	network_modules	52	TRUE	1.165144201310436e-8	276	16	9	0.5625	0.03260869565217391	REAC:R-HSA-72203	REAC	Processing of Capped Intron-Containing Pre-mRNA	10916	1796		0	0.3333333333333333	276	10640	9	7	267	10633	10916	0.13110941024867537
R1	cpdb	0	network_modules	52	TRUE	1.53210976161638e-7	287	23	9	0.391304347826087	0.0313588850174216	GO:0000377	GO:BP	RNA splicing, via transesterification reactions with bulged adenosine as nucleophile	16175	109		0	0.25	287	15888	9	14	278	15874	16175	0.10677778873551474
R1	cpdb	0	network_modules	52	TRUE	1.53210976161638e-7	287	23	9	0.391304347826087	0.0313588850174216	GO:0000398	GO:BP	mRNA splicing, via spliceosome	16175	121		0	0.25	287	15888	9	14	278	15874	16175	0.10677778873551474
R1	cpdb	0	network_modules	52	TRUE	1.7329281424788115e-7	291	23	9	0.391304347826087	0.030927835051546393	GO:0000375	GO:BP	RNA splicing, via transesterification reactions	16175	107		0.2857142857142857	0.375	291	15884	9	14	282	15870	16175	0.10598452490818375
R1	cpdb	0	network_modules	52	TRUE	9.356992169687925e-7	352	23	9	0.391304347826087	0.02556818181818182	GO:0006397	GO:BP	mRNA processing	16175	2158		0.42857142857142855	0.5	352	15823	9	14	343	15809	16175	0.09557483297635795
R1	cpdb	0	network_modules	52	TRUE	2.1325828579983724e-6	202	16	7	0.4375	0.034653465346534656	REAC:R-HSA-72163	REAC	mRNA Splicing - Major Pathway	10916	2707		0.5	0.6666666666666666	202	10714	7	9	195	10705	10916	0.1191153302337507
R1	cpdb	0	network_modules	52	TRUE	2.697546617564151e-6	397	23	9	0.391304347826087	0.022670025188916875	GO:0008380	GO:BP	RNA splicing	16175	3186		0.5714285714285714	0.625	397	15778	9	14	388	15764	16175	0.08944501526161204
R1	cpdb	0	network_modules	52	TRUE	2.7026454892528223e-6	209	16	7	0.4375	0.03349282296650718	REAC:R-HSA-72172	REAC	mRNA Splicing	10916	2706		1	1	209	10707	7	9	202	10698	10916	0.11696257888966922
R1	cpdb	0	network_modules	52	TRUE	8.426608544481813e-5	590	23	9	0.391304347826087	0.015254237288135594	GO:0016071	GO:BP	mRNA metabolic process	16175	5098		0.7142857142857143	0.75	590	15585	9	14	581	15571	16175	0.07142231147023624
R1	cpdb	0	network_modules	52	TRUE	0.0014198590109452266	54	23	4	0.17391304347826086	0.07407407407407407	GO:0000381	GO:BP	regulation of alternative mRNA splicing, via spliceosome	16175	113		0.8571428571428571	0.875	54	16121	4	19	50	16102	16175	0.11158772937064303
R1	cpdb	0	network_modules	52	TRUE	0.003399392148099341	67	23	4	0.17391304347826086	0.05970149253731343	GO:0000380	GO:BP	alternative mRNA splicing, via spliceosome	16175	112		1	1	67	16108	4	19	63	16089	16175	0.09974702749516456
R1	cpdb	0	network_modules	53	TRUE	1.305222402646334e-5	124	21	6	0.2857142857142857	0.04838709677419355	GO:0007052	GO:BP	mitotic spindle organization	16175	2651		0	0.16666666666666666	124	16051	6	15	118	16036	16175	0.11494021170398086
R1	cpdb	0	network_modules	53	TRUE	4.607519389372212e-5	153	21	6	0.2857142857142857	0.0392156862745098	GO:1902850	GO:BP	microtubule cytoskeleton organization involved in mitosis	16175	22560		0.2	0.3333333333333333	153	16022	6	15	147	16007	16175	0.1029011785927283
R1	cpdb	0	network_modules	53	TRUE	1.0619244706697872e-4	176	21	6	0.2857142857142857	0.03409090909090909	GO:0007051	GO:BP	spindle organization	16175	2650		0.4	0.5	176	15999	6	15	170	15984	16175	0.09551695992040522
R1	cpdb	0	network_modules	53	TRUE	3.92719048980252e-4	792	21	9	0.42857142857142855	0.011363636363636364	GO:0000278	GO:BP	mitotic cell cycle	16175	76		0.6	0.6666666666666666	792	15383	9	12	783	15371	16175	0.06342565674888169
R1	cpdb	0	network_modules	53	TRUE	9.213032502611694e-4	23	14	3	0.21428571428571427	0.13043478260869565	REAC:R-HSA-180024	REAC	DARPP-32 events	10916	434		NA	1	23	10893	3	11	20	10882	10916	0.16582064566761434
R1	cpdb	0	network_modules	53	TRUE	0.0013132735108980916	656	21	8	0.38095238095238093	0.012195121951219513	GO:1903047	GO:BP	mitotic cell cycle process	16175	22727		0.8	0.8333333333333334	656	15519	8	13	648	15506	16175	0.062217780837008595
R1	cpdb	0	network_modules	53	TRUE	0.0022576159144596045	69	9	3	0.3333333333333333	0.043478260869565216	KEGG:05031	KEGG	Amphetamine addiction	8484	419		0	0.5	69	8415	3	6	66	8409	8484	0.11799171027984004
R1	cpdb	0	network_modules	53	TRUE	0.004531722494916724	251	9	4	0.4444444444444444	0.01593625498007968	KEGG:04020	KEGG	Calcium signaling pathway	8484	250		1	1	251	8233	4	5	247	8228	8484	0.07978789693319173
R1	cpdb	0	network_modules	53	TRUE	0.008676491836998769	586	21	7	0.3333333333333333	0.011945392491467578	GO:0000226	GO:BP	microtubule cytoskeleton organization	16175	61		1	1	586	15589	7	14	579	15575	16175	0.05732780522725141
R1	cpdb	0	network_modules	54	TRUE	4.1381934555812424e-27	41	32	15	0.46875	0.36585365853658536	REAC:R-HSA-383280	REAC	Nuclear Receptor transcription pathway	10916	1616		0	0.02631578947368421	41	10875	15	17	26	10858	10916	0.4121782584599249
R1	cpdb	0	network_modules	54	TRUE	9.65676502102006e-18	113	32	14	0.4375	0.12389380530973451	REAC:R-HSA-1989781	REAC	PPARA activates gene expression	10916	1700		0.02702702702702703	0.05263157894736842	113	10803	14	18	99	10785	10916	0.22882920068490942
R1	cpdb	0	network_modules	54	TRUE	1.0991613977729468e-17	114	32	14	0.4375	0.12280701754385964	REAC:R-HSA-400206	REAC	Regulation of lipid metabolism by PPARalpha	10916	2041		0.05405405405405406	0.07894736842105263	114	10802	14	18	100	10784	10916	0.22778503579649012
R1	cpdb	0	network_modules	54	TRUE	5.720702216543451e-15	178	40	14	0.35	0.07865168539325842	GO:0009755	GO:BP	hormone-mediated signaling pathway	16175	3652		0	0.02631578947368421	178	15997	14	26	164	15971	16175	0.16179097214297417
R1	cpdb	0	network_modules	54	TRUE	5.957578464181196e-15	539	40	19	0.475	0.03525046382189239	GO:0009725	GO:BP	response to hormone	16175	3623		0.02702702702702703	0.05263157894736842	539	15636	19	21	520	15615	16175	0.12252856353133557
R1	cpdb	0	network_modules	54	TRUE	6.6427256365320426e-15	451	40	18	0.45	0.03991130820399113	GO:0032870	GO:BP	cellular response to hormone stimulus	16175	7867		0.05405405405405406	0.07894736842105263	451	15724	18	22	433	15702	16175	0.12765955705214943
R1	cpdb	0	network_modules	54	TRUE	1.8899499056528755e-12	152	40	12	0.3	0.07894736842105263	GO:0141193	GO:BP	nuclear receptor-mediated signaling pathway	16175	20078		0.08108108108108109	0.10526315789473684	152	16023	12	28	140	15995	16175	0.1499670530875619
R1	cpdb	0	network_modules	54	TRUE	6.389363994385777e-12	53	32	9	0.28125	0.16981132075471697	REAC:R-HSA-2151201	REAC	Transcriptional activation of mitochondrial biogenesis	10916	2548		0.08108108108108109	0.10526315789473684	53	10863	9	23	44	10840	10916	0.21560617823359834
R1	cpdb	0	network_modules	54	TRUE	6.623689924771988e-12	290	32	14	0.4375	0.04827586206896552	REAC:R-HSA-9006931	REAC	Signaling by Nuclear Receptors	10916	2289		0.10810810810810811	0.13157894736842105	290	10626	14	18	276	10608	10916	0.1385580886075494
R1	cpdb	0	network_modules	54	TRUE	1.2074087069986026e-10	791	40	18	0.45	0.022756005056890013	GO:0000122	GO:BP	negative regulation of transcription by RNA polymerase II	16175	48		0.10810810810810811	0.13157894736842105	791	15384	18	22	773	15362	16175	0.0926012266805974
R1	cpdb	0	network_modules	54	TRUE	2.075620072307051e-10	47	32	8	0.25	0.1702127659574468	REAC:R-HSA-9707616	REAC	Heme signaling	10916	1117		0.13513513513513514	0.15789473684210525	47	10869	8	24	39	10845	10916	0.2034678391127925
R1	cpdb	0	network_modules	54	TRUE	2.7558372863439095e-10	302	40	13	0.325	0.04304635761589404	GO:0030522	GO:BP	intracellular receptor signaling pathway	16175	6836		0.13513513513513514	0.15789473684210525	302	15873	13	27	289	15846	16175	0.11267958372894213
R1	cpdb	0	network_modules	54	TRUE	3.3091252811651233e-10	171	32	11	0.34375	0.06432748538011696	REAC:R-HSA-3108232	REAC	SUMO E3 ligases SUMOylate target proteins	10916	2163		0.16216216216216217	0.18421052631578946	171	10745	11	21	160	10724	10916	0.1432614211924323
R1	cpdb	0	network_modules	54	TRUE	4.838806716489917e-10	177	32	11	0.34375	0.062146892655367235	REAC:R-HSA-2990846	REAC	SUMOylation	10916	2167		0.1891891891891892	0.21052631578947367	177	10739	11	21	166	10718	10916	0.14061568516614958
R1	cpdb	0	network_modules	54	TRUE	1.1627527034210376e-9	92	32	9	0.28125	0.09782608695652174	REAC:R-HSA-1592230	REAC	Mitochondrial biogenesis	10916	1464		0.21621621621621623	0.23684210526315788	92	10824	9	23	83	10801	10916	0.16182135726179478
R1	cpdb	0	network_modules	54	TRUE	2.3631411705325275e-9	18	32	6	0.1875	0.3333333333333333	REAC:R-HSA-1368082	REAC	RORA activates gene expression	10916	1909		0.24324324324324326	0.2631578947368421	18	10898	6	26	12	10872	10916	0.24837026523963182
R1	cpdb	0	network_modules	54	TRUE	4.139414633714101e-9	67	32	8	0.25	0.11940298507462686	REAC:R-HSA-400253	REAC	Circadian Clock	10916	363		0.2702702702702703	0.2894736842105263	67	10849	8	24	59	10825	10916	0.16929982835353666
R1	cpdb	0	network_modules	54	TRUE	6.588126887147208e-9	9	32	5	0.15625	0.5555555555555556	REAC:R-HSA-9623433	REAC	NR1H2 & NR1H3 regulate gene expression to control bile acid homeostasis	10916	1544		0.2972972972972973	0.3157894736842105	9	10907	5	27	4	10880	10916	0.29362475906228885
R1	cpdb	0	network_modules	54	TRUE	7.928305358573794e-9	40	40	7	0.175	0.175	GO:0042789	GO:BP	mRNA transcription by RNA polymerase II	16175	10367		0.16216216216216217	0.18421052631578946	40	16135	7	33	33	16102	16175	0.17295475674000615
R1	cpdb	0	network_modules	54	TRUE	1.6924629050664444e-8	24	32	6	0.1875	0.25	REAC:R-HSA-4090294	REAC	SUMOylation of intracellular receptors	10916	2175		0.32432432432432434	0.34210526315789475	24	10892	6	26	18	10866	10916	0.21451787946587764
R1	cpdb	0	network_modules	54	TRUE	1.912613494720492e-8	45	40	7	0.175	0.15555555555555556	GO:0009299	GO:BP	mRNA transcription	16175	3446		0.1891891891891892	0.21052631578947367	45	16130	7	33	38	16097	16175	0.1627963717955712
R1	cpdb	0	network_modules	54	TRUE	2.4257770094889618e-8	83	32	8	0.25	0.0963855421686747	REAC:R-HSA-9843745	REAC	Adipogenesis	10916	122		0.35135135135135137	0.39473684210526316	83	10833	8	24	75	10809	10916	0.15130634647816488
R1	cpdb	0	network_modules	54	TRUE	2.4257770094889618e-8	83	32	8	0.25	0.0963855421686747	REAC:R-HSA-381340	REAC	Transcriptional regulation of white adipocyte differentiation	10916	2562		0.35135135135135137	0.39473684210526316	83	10833	8	24	75	10809	10916	0.15130634647816488
R1	cpdb	0	network_modules	54	TRUE	4.764035654048605e-8	26	40	6	0.15	0.23076923076923078	GO:0048384	GO:BP	retinoic acid receptor signaling pathway	16175	12719		0.21621621621621623	0.23684210526315788	26	16149	6	34	20	16115	16175	0.18443464235588194
R1	cpdb	0	network_modules	54	TRUE	2.548950341078268e-7	520	40	13	0.325	0.025	GO:0033993	GO:BP	response to lipid	16175	8371		0.24324324324324326	0.2631578947368421	520	15655	13	27	507	15628	16175	0.08266263165613932
R1	cpdb	0	network_modules	54	TRUE	7.373516510272052e-7	43	32	6	0.1875	0.13953488372093023	REAC:R-HSA-5362517	REAC	Signaling by Retinoic Acid	10916	2303		0.40540540540540543	0.42105263157894735	43	10873	6	26	37	10847	10916	0.15889686770919925
R1	cpdb	0	network_modules	54	TRUE	9.810995970392464e-7	45	32	6	0.1875	0.13333333333333333	REAC:R-HSA-9024446	REAC	NR1H2 and NR1H3-mediated signaling	10916	1546		0.43243243243243246	0.4473684210526316	45	10871	6	26	39	10845	10916	0.15518493370533834
R1	cpdb	0	network_modules	54	TRUE	1.4264357437680047e-6	8	32	4	0.125	0.5	REAC:R-HSA-9029558	REAC	NR1H2 & NR1H3 regulate gene expression linked to lipogenesis	10916	1542		0.4594594594594595	0.47368421052631576	8	10908	4	28	4	10880	10916	0.24899060621447086
R1	cpdb	0	network_modules	54	TRUE	4.067105807710632e-6	27	32	5	0.15625	0.18518518518518517	REAC:R-HSA-1368108	REAC	BMAL1:CLOCK,NPAS2 activates circadian gene expression	10916	203		0.4864864864864865	0.5	27	10889	5	27	22	10862	10916	0.1678643713834265
R1	cpdb	0	network_modules	54	TRUE	6.557476806206252e-6	101	40	7	0.175	0.06930693069306931	GO:0010565	GO:BP	regulation of ketone metabolic process	16175	4218		0.2702702702702703	0.2894736842105263	101	16074	7	33	94	16041	16175	0.10666595573250057
R1	cpdb	0	network_modules	54	TRUE	7.151399682661242e-6	62	32	6	0.1875	0.0967741935483871	REAC:R-HSA-9707564	REAC	Cytoprotection by HMOX1	10916	426		0.5135135135135135	0.5263157894736842	62	10854	6	26	56	10828	10916	0.13118850406319246
R1	cpdb	0	network_modules	54	TRUE	8.204629778504386e-6	72	29	6	0.20689655172413793	0.08333333333333333	KEGG:05223	KEGG	Non-small cell lung cancer	8484	474		0	0.1	72	8412	6	23	66	8389	8484	0.1266748810519413
R1	cpdb	0	network_modules	54	TRUE	8.50983519075609e-6	243	40	9	0.225	0.037037037037037035	GO:0019216	GO:BP	regulation of lipid metabolic process	16175	5593		0.2972972972972973	0.3157894736842105	243	15932	9	31	234	15901	16175	0.08594544421287684
R1	cpdb	0	network_modules	54	TRUE	8.745771164794452e-6	37	29	5	0.1724137931034483	0.13513513513513514	KEGG:05216	KEGG	Thyroid cancer	8484	467		0.1111111111111111	0.2	37	8447	5	24	32	8423	8484	0.14936061392052713
R1	cpdb	0	network_modules	54	TRUE	9.249878250809616e-6	10	40	4	0.1	0.4	GO:0010887	GO:BP	negative regulation of cholesterol storage	16175	4473		0.32432432432432434	0.34210526315789475	10	16165	4	36	6	16129	16175	0.19907129329534576
R1	cpdb	0	network_modules	54	TRUE	1.473243364535691e-5	120	32	7	0.21875	0.058333333333333334	REAC:R-HSA-5617472	REAC	Activation of anterior HOX genes in hindbrain development during early embryogenesis	10916	99		0.5405405405405406	0.5789473684210527	120	10796	7	25	113	10771	10916	0.10803830829444241
R1	cpdb	0	network_modules	54	TRUE	1.473243364535691e-5	120	32	7	0.21875	0.058333333333333334	REAC:R-HSA-5619507	REAC	Activation of HOX genes during differentiation	10916	84		0.5405405405405406	0.5789473684210527	120	10796	7	25	113	10771	10916	0.10803830829444241
R1	cpdb	0	network_modules	54	TRUE	1.8642757620003583e-5	36	32	5	0.15625	0.1388888888888889	REAC:R-HSA-9029569	REAC	NR1H3 & NR1H2 regulate gene expression linked to cholesterol transport and efflux	10916	1547		0.5945945945945946	0.6052631578947368	36	10880	5	27	31	10853	10916	0.14465517116684337
R1	cpdb	0	network_modules	54	TRUE	1.9009232948711804e-5	32	40	5	0.125	0.15625	GO:0045923	GO:BP	positive regulation of fatty acid metabolic process	16175	11717		0.35135135135135137	0.3684210526315789	32	16143	5	35	27	16108	16175	0.13784918221046308
R1	cpdb	0	network_modules	54	TRUE	2.0994943366612037e-5	68	40	6	0.15	0.08823529411764706	GO:0032922	GO:BP	circadian regulation of gene expression	16175	7913		0.3783783783783784	0.39473684210526316	68	16107	6	34	62	16073	16175	0.11219501687153506
R1	cpdb	0	network_modules	54	TRUE	2.7418281680419492e-5	15	32	4	0.125	0.26666666666666666	REAC:R-HSA-193807	REAC	Synthesis of bile acids and bile salts via 27-hydroxycholesterol	10916	2403		0.6216216216216216	0.631578947368421	15	10901	4	28	11	10873	10916	0.18095676019452273
R1	cpdb	0	network_modules	54	TRUE	3.227163615764729e-5	40	32	5	0.15625	0.125	REAC:R-HSA-2426168	REAC	Activation of gene expression by SREBF (SREBP)	10916	101		0.6486486486486487	0.6578947368421053	40	10876	5	27	35	10849	10916	0.13692834473270632
R1	cpdb	0	network_modules	54	TRUE	3.42190927676505e-5	292	32	9	0.28125	0.030821917808219176	REAC:R-HSA-1852241	REAC	Organelle biogenesis and maintenance	10916	1646		0.6756756756756757	0.6842105263157895	292	10624	9	23	283	10601	10916	0.08552578095601254
R1	cpdb	0	network_modules	54	TRUE	3.573532987016663e-5	92	29	6	0.20689655172413793	0.06521739130434782	KEGG:05222	KEGG	Small cell lung cancer	8484	473		0.2222222222222222	0.3	92	8392	6	23	86	8369	8484	0.11086356254243149
R1	cpdb	0	network_modules	54	TRUE	3.6677966321561934e-5	41	32	5	0.15625	0.12195121951219512	REAC:R-HSA-3899300	REAC	SUMOylation of transcription cofactors	10916	2177		0.7027027027027027	0.7105263157894737	41	10875	5	27	36	10848	10916	0.13517319348661117
R1	cpdb	0	network_modules	54	TRUE	5.5931055437894215e-5	408	40	10	0.25	0.024509803921568627	GO:0071396	GO:BP	cellular response to lipid	16175	16648		0.40540540540540543	0.42105263157894735	408	15767	10	30	398	15737	16175	0.07137315719672578
R1	cpdb	0	network_modules	54	TRUE	6.108745487944204e-5	18	32	4	0.125	0.2222222222222222	REAC:R-HSA-159418	REAC	Recycling of bile acids and salts	10916	1952		0.7297297297297297	0.7368421052631579	18	10898	4	28	14	10870	10916	0.1648456252101857
R1	cpdb	0	network_modules	54	TRUE	7.700823948426322e-5	5	32	3	0.09375	0.6	REAC:R-HSA-9031528	REAC	NR1H2 & NR1H3 regulate gene expression linked to triglyceride lipolysis in adipose	10916	1543		0.7567567567567568	0.8157894736842105	5	10911	3	29	2	10882	10916	0.23641290081458052
R1	cpdb	0	network_modules	54	TRUE	7.700823948426322e-5	5	32	3	0.09375	0.6	REAC:R-HSA-9031525	REAC	NR1H2 & NR1H3 regulate gene expression to limit cholesterol uptake 	10916	1545		0.7567567567567568	0.8157894736842105	5	10911	3	29	2	10882	10916	0.23641290081458052
R1	cpdb	0	network_modules	54	TRUE	7.700823948426322e-5	5	32	3	0.09375	0.6	REAC:R-HSA-9632974	REAC	NR1H2 & NR1H3 regulate gene expression linked to gluconeogenesis 	10916	1541		0.7567567567567568	0.8157894736842105	5	10911	3	29	2	10882	10916	0.23641290081458052
R1	cpdb	0	network_modules	54	TRUE	7.931294915673895e-5	16	40	4	0.1	0.25	GO:0010885	GO:BP	regulation of cholesterol storage	16175	4471		0.43243243243243246	0.4473684210526316	16	16159	4	36	12	16123	16175	0.15682136221288778
R1	cpdb	0	network_modules	54	TRUE	1.1265468362686797e-4	45	40	5	0.125	0.1111111111111111	GO:0038066	GO:BP	p38MAPK cascade	16175	9683		0.4594594594594595	0.47368421052631576	45	16130	5	35	40	16095	16175	0.11553173075822115
R1	cpdb	0	network_modules	54	TRUE	1.3287591796518354e-4	18	40	4	0.1	0.2222222222222222	GO:0010878	GO:BP	cholesterol storage	16175	4464		0.4864864864864865	0.5	18	16157	4	36	14	16121	16175	0.147677094844667
R1	cpdb	0	network_modules	54	TRUE	1.3701261770086064e-4	53	32	5	0.15625	0.09433962264150944	REAC:R-HSA-1655829	REAC	Regulation of cholesterol biosynthesis by SREBP (SREBF)	10916	2023		0.8378378378378378	0.8421052631578947	53	10863	5	27	48	10836	10916	0.11809791119138269
R1	cpdb	0	network_modules	54	TRUE	1.58021585732298e-4	242	40	8	0.2	0.03305785123966942	GO:0062012	GO:BP	regulation of small molecule metabolic process	16175	15781		0.5135135135135135	0.5263157894736842	242	15933	8	32	234	15901	16175	0.07589195955134216
R1	cpdb	0	network_modules	54	TRUE	1.741083947565883e-4	162	40	7	0.175	0.043209876543209874	GO:0007623	GO:BP	circadian rhythm	16175	3080		0.5405405405405406	0.5526315789473685	162	16013	7	33	155	15980	16175	0.08249719873122525
R1	cpdb	0	network_modules	54	TRUE	1.7496763552749957e-4	23	32	4	0.125	0.17391304347826086	REAC:R-HSA-193368	REAC	Synthesis of bile acids and bile salts via 7alpha-hydroxycholesterol	10916	2404		0.8648648648648649	0.868421052631579	23	10893	4	28	19	10865	10916	0.14532279088828948
R1	cpdb	0	network_modules	54	TRUE	1.7996848411507135e-4	121	29	6	0.20689655172413793	0.049586776859504134	KEGG:04919	KEGG	Thyroid hormone signaling pathway	8484	376		0.3333333333333333	0.4	121	8363	6	23	115	8340	8484	0.09514872851699113
R1	cpdb	0	network_modules	54	TRUE	2.0323176355381594e-4	99	40	6	0.15	0.06060606060606061	GO:0045834	GO:BP	positive regulation of lipid metabolic process	16175	11650		0.5675675675675675	0.5789473684210527	99	16076	6	34	93	16042	16175	0.09185059071493977
R1	cpdb	0	network_modules	54	TRUE	2.3246632811600753e-4	169	40	7	0.175	0.04142011834319527	GO:0042180	GO:BP	ketone metabolic process	16175	10008		0.5945945945945946	0.6052631578947368	169	16006	7	33	162	15973	16175	0.08057635533737577
R1	cpdb	0	network_modules	54	TRUE	2.5850405067516556e-4	21	40	4	0.1	0.19047619047619047	GO:0010888	GO:BP	negative regulation of lipid storage	16175	4474		0.6216216216216216	0.631578947368421	21	16154	4	36	17	16118	16175	0.1364786591376327
R1	cpdb	0	network_modules	54	TRUE	2.9358481787701356e-4	26	32	4	0.125	0.15384615384615385	REAC:R-HSA-211976	REAC	Endogenous sterols	10916	840		0.8918918918918919	0.8947368421052632	26	10890	4	28	22	10862	10916	0.13639501071663865
R1	cpdb	0	network_modules	54	TRUE	3.055136378596109e-4	106	40	6	0.15	0.05660377358490566	GO:0062013	GO:BP	positive regulation of small molecule metabolic process	16175	15782		0.6486486486486487	0.6578947368421053	106	16069	6	34	100	16035	16175	0.08851827339102529
R1	cpdb	0	network_modules	54	TRUE	3.165212838244531e-4	75	29	5	0.1724137931034483	0.06666666666666667	KEGG:03320	KEGG	PPAR signaling pathway	8484	236		0.4444444444444444	0.5	75	8409	5	24	70	8385	8484	0.10234186309504885
R1	cpdb	0	network_modules	54	TRUE	4.1466117839784964e-4	184	40	7	0.175	0.03804347826086957	GO:0048511	GO:BP	rhythmic process	16175	12796		0.6756756756756757	0.6842105263157895	184	15991	7	33	177	15958	16175	0.07682298858430293
R1	cpdb	0	network_modules	54	TRUE	5.424983740821144e-4	25	40	4	0.1	0.16	GO:1902894	GO:BP	negative regulation of miRNA transcription	16175	22594		0.7027027027027027	0.7105263157894737	25	16150	4	36	21	16114	16175	0.12478681040376198
R1	cpdb	0	network_modules	54	TRUE	5.789911227876264e-4	148	29	6	0.20689655172413793	0.04054054054054054	KEGG:05226	KEGG	Gastric cancer	8484	477		0.5555555555555556	0.6	148	8336	6	23	142	8313	8484	0.0847485394206212
R1	cpdb	0	network_modules	54	TRUE	7.499589716010583e-4	27	40	4	0.1	0.14814814814814814	GO:2000629	GO:BP	negative regulation of miRNA metabolic process	16175	25911		0.7297297297297297	0.7368421052631579	27	16148	4	36	23	16112	16175	0.11993278861516482
R1	cpdb	0	network_modules	54	TRUE	7.92104707884057e-4	33	32	4	0.125	0.12121212121212122	REAC:R-HSA-192105	REAC	Synthesis of bile acids and bile salts	10916	2401		0.918918918918919	0.9210526315789473	33	10883	4	28	29	10855	10916	0.12047324512294029
R1	cpdb	0	network_modules	54	TRUE	0.0011454739959249642	71	40	5	0.125	0.07042253521126761	GO:0019217	GO:BP	regulation of fatty acid metabolic process	16175	5594		0.7567567567567568	0.7631578947368421	71	16104	5	35	66	16069	16175	0.09084037092236633
R1	cpdb	0	network_modules	54	TRUE	0.0012750383245891464	437	40	9	0.225	0.020594965675057208	GO:0014070	GO:BP	response to organic cyclic compound	16175	4635		0.7837837837837838	0.7894736842105263	437	15738	9	31	428	15707	16175	0.060799808099182236
R1	cpdb	0	network_modules	54	TRUE	0.0014990808104313462	152	32	6	0.1875	0.039473684210526314	REAC:R-HSA-8957322	REAC	Metabolism of steroids	10916	1438		0.9459459459459459	0.9473684210526315	152	10764	6	26	146	10738	10916	0.08032005548769479
R1	cpdb	0	network_modules	54	TRUE	0.001890582319223924	108	29	5	0.1724137931034483	0.046296296296296294	KEGG:04931	KEGG	Insulin resistance	8484	388		0.6666666666666666	0.7	108	8376	5	24	103	8352	8484	0.08342071428143112
R1	cpdb	0	network_modules	54	TRUE	0.0021866270669938085	148	40	6	0.15	0.04054054054054054	GO:0120161	GO:BP	regulation of cold-induced thermogenesis	16175	19527		0.8108108108108109	0.8157894736842105	148	16027	6	34	142	15993	16175	0.07365291054972642
R1	cpdb	0	network_modules	54	TRUE	0.002274258268614273	149	40	6	0.15	0.040268456375838924	GO:0106106	GO:BP	cold-induced thermogenesis	16175	19254		0.8378378378378378	0.8421052631578947	149	16026	6	34	143	15992	16175	0.0733754061413608
R1	cpdb	0	network_modules	54	TRUE	0.0023254816861777777	345	40	8	0.2	0.02318840579710145	GO:0071407	GO:BP	cellular response to organic cyclic compound	16175	16659		0.8648648648648649	0.868421052631579	345	15830	8	32	337	15798	16175	0.06157343022343438
R1	cpdb	0	network_modules	54	TRUE	0.0025489144584721936	192	29	6	0.20689655172413793	0.03125	KEGG:05202	KEGG	Transcriptional misregulation in cancer	8484	454		0.7777777777777778	0.8	192	8292	6	23	186	8269	8484	0.07256164731742556
R1	cpdb	0	network_modules	54	TRUE	0.0025690747640400536	44	32	4	0.125	0.09090909090909091	REAC:R-HSA-194068	REAC	Bile acid and bile salt metabolism	10916	222		0.972972972972973	0.9736842105263158	44	10872	4	28	40	10844	10916	0.10352329059496106
R1	cpdb	0	network_modules	54	TRUE	0.0034404713003980993	39	40	4	0.1	0.10256410256410256	GO:1905953	GO:BP	negative regulation of lipid localization	16175	25043		0.8918918918918919	0.8947368421052632	39	16136	4	36	35	16100	16175	0.09907403499792901
R1	cpdb	0	network_modules	54	TRUE	0.0035693782360673096	161	40	6	0.15	0.037267080745341616	GO:1990845	GO:BP	adaptive thermogenesis	16175	25314		0.918918918918919	0.9210526315789473	161	16014	6	34	155	15980	16175	0.07024231232220374
R1	cpdb	0	network_modules	54	TRUE	0.004115316320442992	165	40	6	0.15	0.03636363636363636	GO:0001659	GO:BP	temperature homeostasis	16175	373		0.9459459459459459	0.9473684210526315	165	16010	6	34	159	15976	16175	0.06927179678495696
R1	cpdb	0	network_modules	54	TRUE	0.005470575630931979	13	40	3	0.075	0.23076923076923078	GO:0010745	GO:BP	negative regulation of macrophage derived foam cell differentiation	16175	4366		0.972972972972973	0.9736842105263158	13	16162	3	37	10	16125	16175	0.13036252571258025
R1	cpdb	0	network_modules	54	TRUE	0.005759014398597355	70	29	4	0.13793103448275862	0.05714285714285714	KEGG:04920	KEGG	Adipocytokine signaling pathway	8484	377		0.8888888888888888	0.9	70	8414	4	25	66	8389	8484	0.08395881148166426
R1	cpdb	0	network_modules	54	TRUE	0.0067412864993200245	46	40	4	0.1	0.08695652173913043	GO:0010883	GO:BP	regulation of lipid storage	16175	4469		1	1	46	16129	4	36	42	16093	16175	0.09084002798719058
R1	cpdb	0	network_modules	54	TRUE	0.008257498254259843	147	29	5	0.1724137931034483	0.034013605442176874	KEGG:05224	KEGG	Breast cancer	8484	475		1	1	147	8337	5	24	142	8313	8484	0.06960730974152052
R1	cpdb	0	network_modules	54	TRUE	0.009771845822972716	211	32	6	0.1875	0.02843601895734597	REAC:R-HSA-9711123	REAC	Cellular response to chemical stress	10916	333		1	1	211	10705	6	26	205	10679	10916	0.06623075350401218
R1	cpdb	0	network_modules	55	TRUE	2.243100384222427e-33	72	24	18	0.75	0.25	REAC:R-HSA-774815	REAC	Nucleosome assembly	10916	1621		0	0.11764705882352941	72	10844	18	6	54	10838	10916	0.4311012935768022
R1	cpdb	0	network_modules	55	TRUE	2.243100384222427e-33	72	24	18	0.75	0.25	REAC:R-HSA-606279	REAC	Deposition of new CENPA-containing nucleosomes at the centromere	10916	730		0	0.11764705882352941	72	10844	18	6	54	10838	10916	0.4311012935768022
R1	cpdb	0	network_modules	55	TRUE	2.9688703230315107e-30	138	24	19	0.7916666666666666	0.13768115942028986	REAC:R-HSA-73886	REAC	Chromosome Maintenance	10916	357		0.125	0.17647058823529413	138	10778	19	5	119	10773	10916	0.32730897309710905
R1	cpdb	0	network_modules	55	TRUE	8.830749209517543e-24	92	24	15	0.625	0.16304347826086957	REAC:R-HSA-141424	REAC	Amplification of signal from the kinetochores	10916	144		0.1875	0.29411764705882354	92	10824	15	9	77	10815	10916	0.3166003040775676
R1	cpdb	0	network_modules	55	TRUE	8.830749209517543e-24	92	24	15	0.625	0.16304347826086957	REAC:R-HSA-141444	REAC	Amplification  of signal from unattached  kinetochores via a MAD2  inhibitory signal	10916	143		0.1875	0.29411764705882354	92	10824	15	9	77	10815	10916	0.3166003040775676
R1	cpdb	0	network_modules	55	TRUE	1.35064189875457e-22	109	24	15	0.625	0.13761467889908258	REAC:R-HSA-69618	REAC	Mitotic Spindle Checkpoint	10916	1486		0.3125	0.35294117647058826	109	10807	15	9	94	10798	10916	0.2903587867591902
R1	cpdb	0	network_modules	55	TRUE	3.1731687758142115e-22	115	24	15	0.625	0.13043478260869565	REAC:R-HSA-9648025	REAC	EML4 and NUDC in mitotic spindle formation	10916	817		0.375	0.4117647058823529	115	10801	15	9	100	10792	10916	0.28250854125719993
R1	cpdb	0	network_modules	55	TRUE	9.225483060356739e-22	123	24	15	0.625	0.12195121951219512	REAC:R-HSA-2500257	REAC	Resolution of Sister Chromatid Cohesion	10916	2079		0.4375	0.47058823529411764	123	10793	15	9	108	10784	10916	0.2729421144959595
R1	cpdb	0	network_modules	55	TRUE	4.502131363159365e-21	136	24	15	0.625	0.11029411764705882	REAC:R-HSA-5663220	REAC	RHO GTPases Activate Formins	10916	1848		0.5	0.5294117647058824	136	10780	15	9	121	10771	10916	0.2592219772022288
R1	cpdb	0	network_modules	55	TRUE	6.259198546172604e-19	361	27	17	0.6296296296296297	0.04709141274238227	GO:0007059	GO:BP	chromosome segregation	16175	2658		0	0.08333333333333333	361	15814	17	10	344	15804	16175	0.16811391026409175
R1	cpdb	0	network_modules	55	TRUE	6.979898869309181e-19	188	24	15	0.625	0.0797872340425532	REAC:R-HSA-2467813	REAC	Separation of Sister Chromatids	10916	2204		0.5625	0.5882352941176471	188	10728	15	9	173	10719	10916	0.21929144832556496
R1	cpdb	0	network_modules	55	TRUE	1.6774167556395974e-18	199	24	15	0.625	0.07537688442211055	REAC:R-HSA-68877	REAC	Mitotic Prometaphase	10916	1484		0.625	0.6470588235294118	199	10717	15	9	184	10708	10916	0.2129002599011171
R1	cpdb	0	network_modules	55	TRUE	1.3536171914792499e-17	228	24	15	0.625	0.06578947368421052	REAC:R-HSA-68882	REAC	Mitotic Anaphase	10916	1479		0.6875	0.7058823529411765	228	10688	15	9	213	10679	10916	0.19829786167005936
R1	cpdb	0	network_modules	55	TRUE	1.4473555140848676e-17	229	24	15	0.625	0.06550218340611354	REAC:R-HSA-2555396	REAC	Mitotic Metaphase and Anaphase	10916	1482		0.75	0.7647058823529411	229	10687	15	9	214	10678	10916	0.19784367436891317
R1	cpdb	0	network_modules	55	TRUE	4.999106135325747e-16	289	24	15	0.625	0.05190311418685121	REAC:R-HSA-69620	REAC	Cell Cycle Checkpoints	10916	321		0.8125	0.8235294117647058	289	10627	15	9	274	10618	10916	0.17500217176739719
R1	cpdb	0	network_modules	55	TRUE	2.1218073529028533e-15	318	24	15	0.625	0.04716981132075472	REAC:R-HSA-195258	REAC	RHO GTPase Effectors	10916	1846		0.875	0.8823529411764706	318	10598	15	9	303	10589	10916	0.1663183642233512
R1	cpdb	0	network_modules	55	TRUE	8.311301727424822e-14	406	24	15	0.625	0.03694581280788178	REAC:R-HSA-68886	REAC	M Phase	10916	1343		0.9375	0.9411764705882353	406	10510	15	9	391	10501	10916	0.14580943540716532
R1	cpdb	0	network_modules	55	TRUE	2.768540640153109e-12	21	27	7	0.25925925925925924	0.3333333333333333	GO:0034508	GO:BP	centromere complex assembly	16175	8672		0.09090909090909091	0.16666666666666666	21	16154	7	20	14	16134	16175	0.2929348876563031
R1	cpdb	0	network_modules	55	TRUE	2.866270878655075e-10	7	27	5	0.18518518518518517	0.7142857142857143	GO:0031055	GO:BP	chromatin remodeling at centromere	16175	7017		0.18181818181818182	0.3333333333333333	7	16168	5	22	2	16146	16175	0.36322837115875317
R1	cpdb	0	network_modules	55	TRUE	2.866270878655075e-10	7	27	5	0.18518518518518517	0.7142857142857143	GO:0034080	GO:BP	CENP-A containing chromatin assembly	16175	8395		0.18181818181818182	0.3333333333333333	7	16168	5	22	2	16146	16175	0.36322837115875317
R1	cpdb	0	network_modules	55	TRUE	5.901276030053369e-8	16	27	5	0.18518518518518517	0.3125	GO:0051383	GO:BP	kinetochore organization	16175	13687		0.36363636363636365	0.4166666666666667	16	16159	5	22	11	16137	16175	0.23959611640672476
R1	cpdb	0	network_modules	55	TRUE	7.178844379452539e-7	545	27	11	0.4074074074074074	0.02018348623853211	GO:0051276	GO:BP	chromosome organization	16175	13613		0.45454545454545453	0.5	545	15630	11	16	534	15614	16175	0.08468914964598749
R1	cpdb	0	network_modules	55	TRUE	9.51879431394285e-6	14	27	4	0.14814814814814814	0.2857142857142857	GO:0051382	GO:BP	kinetochore assembly	16175	13686		0.5454545454545454	0.5833333333333334	14	16161	4	23	10	16138	16175	0.20479537960909444
R1	cpdb	0	network_modules	55	TRUE	2.424213366881889e-5	183	27	7	0.25925925925925924	0.03825136612021858	GO:0065004	GO:BP	protein-DNA complex assembly	16175	15888		0.6363636363636364	0.6666666666666666	183	15992	7	20	176	15972	16175	0.09586191540360112
R1	cpdb	0	network_modules	55	TRUE	3.587417723651674e-5	792	27	11	0.4074074074074074	0.013888888888888888	GO:0000278	GO:BP	mitotic cell cycle	16175	76		0.7272727272727273	0.75	792	15383	11	16	781	15367	16175	0.06792094825726011
R1	cpdb	0	network_modules	55	TRUE	5.486332599299876e-5	206	27	7	0.25925925925925924	0.03398058252427184	GO:0071824	GO:BP	protein-DNA complex organization	16175	16927		0.8181818181818182	0.8333333333333334	206	15969	7	20	199	15949	16175	0.08989856389762567
R1	cpdb	0	network_modules	55	TRUE	0.0010673736434694307	656	27	9	0.3333333333333333	0.013719512195121951	GO:1903047	GO:BP	mitotic cell cycle process	16175	22727		0.9090909090909091	0.9166666666666666	656	15519	9	18	647	15501	16175	0.06069037922545565
R1	cpdb	0	network_modules	55	TRUE	0.001724412376341752	131	5	3	0.6	0.022900763358778626	KEGG:04068	KEGG	FoxO signaling pathway	8484	258		NA	1	131	8353	3	2	128	8351	8484	0.1151290533524099
R1	cpdb	0	network_modules	55	TRUE	0.0037351589066344894	21	24	3	0.125	0.14285714285714285	REAC:R-HSA-6804115	REAC	TP53 regulates transcription of additional cell cycle genes whose exact role in the p53 pathway remain uncertain	10916	2461		1	1	21	10895	3	21	18	10874	10916	0.1318457729520745
R1	cpdb	0	network_modules	55	TRUE	0.007562544439891168	153	27	5	0.18518518518518517	0.032679738562091505	GO:1902850	GO:BP	microtubule cytoskeleton organization involved in mitosis	16175	22560		1	1	153	16022	5	22	148	16000	16175	0.07423335685137603
R1	cpdb	0	network_modules	56	TRUE	0.0016709430887432131	2	18	2	0.1111111111111111	1	GO:0099044	GO:BP	vesicle tethering to endoplasmic reticulum	16175	19017		NA	1	2	16173	2	16	0	16157	16175	0.33316840867318687
R1	cpdb	0	network_modules	57	TRUE	1.1302927770882121e-10	18	23	6	0.2608695652173913	0.3333333333333333	GO:0097502	GO:BP	mannosylation	16175	18684		0	0.1	18	16157	6	17	12	16140	16175	0.2939985978231436
R1	cpdb	0	network_modules	57	TRUE	3.1977227770732924e-10	23	19	6	0.3157894736842105	0.2608695652173913	KEGG:00515	KEGG	Mannose type O-glycan biosynthesis	8484	68		NA	1	23	8461	6	13	17	8448	8484	0.2852610271970296
R1	cpdb	0	network_modules	57	TRUE	3.383525536876909e-8	17	23	5	0.21739130434782608	0.29411764705882354	GO:0035269	GO:BP	protein O-linked mannosylation	16175	8933		0.1111111111111111	0.3	17	16158	5	18	12	16140	16175	0.25194991653765114
R1	cpdb	0	network_modules	57	TRUE	3.383525536876909e-8	17	23	5	0.21739130434782608	0.29411764705882354	GO:0035268	GO:BP	protein mannosylation	16175	8932		0.1111111111111111	0.3	17	16158	5	18	12	16140	16175	0.25194991653765114
R1	cpdb	0	network_modules	57	TRUE	3.5032165254327755e-7	315	23	9	0.391304347826087	0.02857142857142857	GO:0009100	GO:BP	glycoprotein metabolic process	16175	3272		0.3333333333333333	0.4	315	15860	9	14	306	15846	16175	0.10153889610004077
R1	cpdb	0	network_modules	57	TRUE	1.1505258435771395e-6	514	23	10	0.43478260869565216	0.019455252918287938	GO:1901137	GO:BP	carbohydrate derivative biosynthetic process	16175	21245		0.4444444444444444	0.5	514	15661	10	13	504	15648	16175	0.08669905671914052
R1	cpdb	0	network_modules	57	TRUE	2.80506565062024e-6	265	23	8	0.34782608695652173	0.03018867924528302	GO:0009101	GO:BP	glycoprotein biosynthetic process	16175	3273		0.5555555555555556	0.6	265	15910	8	15	257	15895	16175	0.09852480631105372
R1	cpdb	0	network_modules	57	TRUE	2.7941145902101626e-4	94	23	5	0.21739130434782608	0.05319148936170213	GO:0006493	GO:BP	protein O-linked glycosylation	16175	2225		0.6666666666666666	0.7	94	16081	5	18	89	16063	16175	0.10503860402481022
R1	cpdb	0	network_modules	57	TRUE	4.782398520478345e-4	204	23	6	0.2608695652173913	0.029411764705882353	GO:0070085	GO:BP	glycosylation	16175	15903		0.7777777777777778	0.8	204	15971	6	17	198	15954	16175	0.0839491513609207
R1	cpdb	0	network_modules	57	TRUE	5.542489865897746e-4	2	15	2	0.13333333333333333	1	REAC:R-HSA-5083627	REAC	Defective LARGE causes MDDGA6 and MDDGB6	10916	574		0	0.5	2	10914	2	13	0	10901	10916	0.36493083716272035
R1	cpdb	0	network_modules	57	TRUE	0.0075838896366716155	183	23	5	0.21739130434782608	0.0273224043715847	GO:0006486	GO:BP	protein glycosylation	16175	2220		0.8888888888888888	1	183	15992	5	18	178	15974	16175	0.07352733045721499
R1	cpdb	0	network_modules	57	TRUE	0.0075838896366716155	183	23	5	0.21739130434782608	0.0273224043715847	GO:0043413	GO:BP	macromolecule glycosylation	16175	10680		0.8888888888888888	1	183	15992	5	18	178	15974	16175	0.07352733045721499
R1	cpdb	0	network_modules	57	TRUE	0.009968841263040932	140	15	4	0.26666666666666666	0.02857142857142857	REAC:R-HSA-3781865	REAC	Diseases of glycosylation	10916	765		1	1	140	10776	4	11	136	10765	10916	0.08368463526173386
R1	cpdb	0	network_modules	58	TRUE	1.5302243611768655e-23	23	19	11	0.5789473684210527	0.4782608695652174	KEGG:03430	KEGG	Mismatch repair	8484	239		0	0.25	23	8461	11	8	12	8453	8484	0.5250369753155624
R1	cpdb	0	network_modules	58	TRUE	6.881506928064962e-23	528	28	21	0.75	0.03977272727272727	GO:0006281	GO:BP	DNA repair	16175	2095		0	0.038461538461538464	528	15647	21	7	507	15640	16175	0.1681048486584913
R1	cpdb	0	network_modules	58	TRUE	2.542921338935865e-21	29	28	11	0.39285714285714285	0.3793103448275862	GO:0006298	GO:BP	mismatch repair	16175	2107		0.04	0.07692307692307693	29	16146	11	17	18	16129	16175	0.3849408739799172
R1	cpdb	0	network_modules	58	TRUE	4.109260982568364e-19	798	28	21	0.75	0.02631578947368421	GO:0006974	GO:BP	DNA damage response	16175	2601		0.08	0.11538461538461539	798	15377	21	7	777	15370	16175	0.1347256566901316
R1	cpdb	0	network_modules	58	TRUE	4.1528905733113116e-19	9	28	8	0.2857142857142857	0.8888888888888888	GO:1900262	GO:BP	regulation of DNA-directed DNA polymerase activity	16175	20524		0.12	0.19230769230769232	9	16166	8	20	1	16146	16175	0.5035472224658931
R1	cpdb	0	network_modules	58	TRUE	4.1528905733113116e-19	9	28	8	0.2857142857142857	0.8888888888888888	GO:1900264	GO:BP	positive regulation of DNA-directed DNA polymerase activity	16175	20525		0.12	0.19230769230769232	9	16166	8	20	1	16146	16175	0.5035472224658931
R1	cpdb	0	network_modules	58	TRUE	1.3624545711323626e-16	26	23	9	0.391304347826087	0.34615384615384615	REAC:R-HSA-174411	REAC	Polymerase switching on the C-strand of the telomere	10916	1770		0	0.018518518518518517	26	10890	9	14	17	10876	10916	0.36662001743465217
R1	cpdb	0	network_modules	58	TRUE	8.347737668874249e-16	36	19	9	0.47368421052631576	0.25	KEGG:03030	KEGG	DNA replication	8484	214		0.3333333333333333	0.5	36	8448	9	10	27	8438	8484	0.34215014452717485
R1	cpdb	0	network_modules	58	TRUE	2.2660451811809314e-15	34	23	9	0.391304347826087	0.2647058823529412	REAC:R-HSA-174417	REAC	Telomere C-strand (Lagging Strand) Synthesis	10916	2486		0.018867924528301886	0.037037037037037035	34	10882	9	14	25	10868	10916	0.3201133822509812
R1	cpdb	0	network_modules	58	TRUE	1.288731106883741e-13	51	23	9	0.391304347826087	0.17647058823529413	REAC:R-HSA-180786	REAC	Extension of Telomeres	10916	887		0.03773584905660377	0.05555555555555555	51	10865	9	14	42	10851	10916	0.2605264852279909
R1	cpdb	0	network_modules	58	TRUE	1.195420650172495e-12	44	19	8	0.42105263157894735	0.18181818181818182	KEGG:03410	KEGG	Base excision repair	8484	237		0.6666666666666666	0.75	44	8440	8	11	36	8429	8484	0.2742964892354744
R1	cpdb	0	network_modules	58	TRUE	6.4453042001551186e-12	43	28	8	0.2857142857142857	0.18604651162790697	GO:0090329	GO:BP	regulation of DNA-templated DNA replication	16175	18209		0.2	0.23076923076923078	43	16132	8	20	35	16112	16175	0.22891339250345197
R1	cpdb	0	network_modules	58	TRUE	1.6491606397974357e-11	50	23	8	0.34782608695652173	0.16	REAC:R-HSA-9675135	REAC	Diseases of DNA repair	10916	758		0.05660377358490566	0.07407407407407407	50	10866	8	15	42	10851	10916	0.23358173959726292
R1	cpdb	0	network_modules	58	TRUE	3.3118523198975884e-11	52	28	8	0.2857142857142857	0.15384615384615385	GO:2000573	GO:BP	positive regulation of DNA biosynthetic process	16175	25874		0.24	0.2692307692307692	52	16123	8	20	44	16103	16175	0.20781188757781285
R1	cpdb	0	network_modules	58	TRUE	4.2041583423499245e-11	14	23	6	0.2608695652173913	0.42857142857142855	REAC:R-HSA-69091	REAC	Polymerase switching	10916	1769		0.07547169811320754	0.1111111111111111	14	10902	6	17	8	10885	10916	0.33328794056439576
R1	cpdb	0	network_modules	58	TRUE	4.2041583423499245e-11	14	23	6	0.2608695652173913	0.42857142857142855	REAC:R-HSA-69109	REAC	Leading Strand Synthesis	10916	1308		0.07547169811320754	0.1111111111111111	14	10902	6	17	8	10885	10916	0.33328794056439576
R1	cpdb	0	network_modules	58	TRUE	1.1181148487014713e-10	16	23	6	0.2608695652173913	0.375	REAC:R-HSA-110312	REAC	Translesion synthesis by REV1	10916	2576		0.11320754716981132	0.12962962962962962	16	10900	6	17	10	10883	10916	0.31157085897430253
R1	cpdb	0	network_modules	58	TRUE	1.187778938496854e-10	231	28	11	0.39285714285714285	0.047619047619047616	GO:0006260	GO:BP	DNA replication	16175	2077		0.28	0.3076923076923077	231	15944	11	17	220	15927	16175	0.1328696066961765
R1	cpdb	0	network_modules	58	TRUE	1.5215596261394987e-10	329	23	12	0.5217391304347826	0.0364741641337386	REAC:R-HSA-73894	REAC	DNA Repair	10916	444		0.1320754716981132	0.14814814814814814	329	10587	12	11	317	10576	10916	0.13212380141481997
R1	cpdb	0	network_modules	58	TRUE	1.725686551978204e-10	17	23	6	0.2608695652173913	0.35294117647058826	REAC:R-HSA-5656121	REAC	Translesion synthesis by POLI	10916	2574		0.1509433962264151	0.18518518518518517	17	10899	6	17	11	10882	10916	0.30217524745751934
R1	cpdb	0	network_modules	58	TRUE	1.725686551978204e-10	17	23	6	0.2608695652173913	0.35294117647058826	REAC:R-HSA-5655862	REAC	Translesion synthesis by POLK	10916	2575		0.1509433962264151	0.18518518518518517	17	10899	6	17	11	10882	10916	0.30217524745751934
R1	cpdb	0	network_modules	58	TRUE	1.7732528299225857e-10	36	23	7	0.30434782608695654	0.19444444444444445	REAC:R-HSA-73933	REAC	Resolution of Abasic Sites (AP sites)	10916	2075		0.18867924528301888	0.2037037037037037	36	10880	7	16	29	10864	10916	0.24128287759018133
R1	cpdb	0	network_modules	58	TRUE	1.9963476291061836e-10	111	23	9	0.391304347826087	0.08108108108108109	REAC:R-HSA-157579	REAC	Telomere Maintenance	10916	2489		0.20754716981132076	0.2222222222222222	111	10805	9	14	102	10791	10916	0.1745659548487659
R1	cpdb	0	network_modules	58	TRUE	3.7731307789253305e-10	19	23	6	0.2608695652173913	0.3157894736842105	REAC:R-HSA-110320	REAC	Translesion Synthesis by POLH	10916	2573		0.22641509433962265	0.24074074074074073	19	10897	6	17	13	10880	10916	0.285653426454036
R1	cpdb	0	network_modules	58	TRUE	5.382982783270656e-10	20	23	6	0.2608695652173913	0.3	REAC:R-HSA-69186	REAC	Lagging Strand Synthesis	10916	1302		0.24528301886792453	0.25925925925925924	20	10896	6	17	14	10879	10916	0.27833486292877846
R1	cpdb	0	network_modules	58	TRUE	7.526103188957408e-10	21	23	6	0.2608695652173913	0.2857142857142857	REAC:R-HSA-5651801	REAC	PCNA-Dependent Long Patch Base Excision Repair	10916	1658		0.2641509433962264	0.2777777777777778	21	10895	6	17	15	10878	10916	0.2715434130439799
R1	cpdb	0	network_modules	58	TRUE	1.467140940589743e-9	138	23	9	0.391304347826087	0.06521739130434782	REAC:R-HSA-73886	REAC	Chromosome Maintenance	10916	357		0.2830188679245283	0.2962962962962963	138	10778	9	14	129	10764	10916	0.15573893168259112
R1	cpdb	0	network_modules	58	TRUE	2.0422119190720092e-9	85	28	8	0.2857142857142857	0.09411764705882353	GO:2000278	GO:BP	regulation of DNA biosynthetic process	16175	25603		0.32	0.34615384615384615	85	16090	8	20	77	16070	16175	0.16153241467294155
R1	cpdb	0	network_modules	58	TRUE	2.177603977471193e-9	140	28	9	0.32142857142857145	0.06428571428571428	GO:0071897	GO:BP	DNA biosynthetic process	16175	16970		0.36	0.38461538461538464	140	16035	9	19	131	16016	16175	0.14060749468800832
R1	cpdb	0	network_modules	58	TRUE	2.4431672075709462e-9	25	23	6	0.2608695652173913	0.24	REAC:R-HSA-5696397	REAC	Gap-filling DNA repair synthesis and ligation in GG-NER	10916	1037		0.3018867924528302	0.3333333333333333	25	10891	6	17	19	10874	10916	0.2485671012128539
R1	cpdb	0	network_modules	58	TRUE	2.4431672075709462e-9	25	23	6	0.2608695652173913	0.24	REAC:R-HSA-110373	REAC	Resolution of AP sites via the multiple-nucleotide patch replacement pathway	10916	2073		0.3018867924528302	0.3333333333333333	25	10891	6	17	19	10874	10916	0.2485671012128539
R1	cpdb	0	network_modules	58	TRUE	3.3961220868687686e-9	147	28	9	0.32142857142857145	0.061224489795918366	GO:0006261	GO:BP	DNA-templated DNA replication	16175	2078		0.4	0.4230769230769231	147	16028	9	19	138	16009	16175	0.13705892181592633
R1	cpdb	0	network_modules	58	TRUE	8.13675400665911e-9	30	23	6	0.2608695652173913	0.2	REAC:R-HSA-110314	REAC	Recognition of DNA damage by PCNA-containing replication complex	10916	1948		0.33962264150943394	0.35185185185185186	30	10886	6	17	24	10869	10916	0.2265597486973775
R1	cpdb	0	network_modules	58	TRUE	1.2384747288283655e-8	32	23	6	0.2608695652173913	0.1875	REAC:R-HSA-69190	REAC	DNA strand elongation	10916	449		0.3584905660377358	0.3888888888888889	32	10884	6	17	26	10867	10916	0.21922996500944902
R1	cpdb	0	network_modules	58	TRUE	1.2384747288283655e-8	32	23	6	0.2608695652173913	0.1875	REAC:R-HSA-5656169	REAC	Termination of translesion DNA synthesis	10916	2492		0.3584905660377358	0.3888888888888889	32	10884	6	17	26	10867	10916	0.21922996500944902
R1	cpdb	0	network_modules	58	TRUE	1.6960793815059027e-8	14	23	5	0.21739130434782608	0.35714285714285715	REAC:R-HSA-5358565	REAC	Mismatch repair (MMR) directed by MSH2:MSH6 (MutSalpha)	10916	1459		0.39622641509433965	0.4074074074074074	14	10902	5	18	9	10884	10916	0.2774655089321353
R1	cpdb	0	network_modules	58	TRUE	1.9585146504978038e-8	112	28	8	0.2857142857142857	0.07142857142857142	GO:0006275	GO:BP	regulation of DNA replication	16175	2090		0.44	0.46153846153846156	112	16063	8	20	104	16043	16175	0.14000136311617997
R1	cpdb	0	network_modules	58	TRUE	2.4596622675212864e-8	5	23	4	0.17391304347826086	0.8	REAC:R-HSA-5423599	REAC	Diseases of Mismatch Repair (MMR)	10916	760		0.41509433962264153	0.42592592592592593	5	10911	4	19	1	10892	10916	0.3724973925153196
R1	cpdb	0	network_modules	58	TRUE	2.540620288170366e-8	15	23	5	0.21739130434782608	0.3333333333333333	REAC:R-HSA-5358508	REAC	Mismatch Repair	10916	1457		0.4339622641509434	0.4444444444444444	15	10901	5	18	10	10883	10916	0.26795580825286075
R1	cpdb	0	network_modules	58	TRUE	4.417378668305927e-8	39	23	6	0.2608695652173913	0.15384615384615385	REAC:R-HSA-110313	REAC	Translesion synthesis by Y family DNA polymerases bypasses lesions on DNA template	10916	2577		0.4528301886792453	0.46296296296296297	39	10877	6	17	33	10860	10916	0.19815327633882887
R1	cpdb	0	network_modules	58	TRUE	6.071536611794008e-8	41	23	6	0.2608695652173913	0.14634146341463414	REAC:R-HSA-5696400	REAC	Dual Incision in GG-NER	10916	807		0.4716981132075472	0.48148148148148145	41	10875	6	17	35	10858	10916	0.19313998762013437
R1	cpdb	0	network_modules	58	TRUE	1.1512760079612374e-7	435	28	11	0.39285714285714285	0.02528735632183908	GO:0051052	GO:BP	regulation of DNA metabolic process	16175	13462		0.48	0.5	435	15740	11	17	424	15723	16175	0.09420381809964364
R1	cpdb	0	network_modules	58	TRUE	1.2611521953693785e-7	88	23	7	0.30434782608695654	0.07954545454545454	REAC:R-HSA-73884	REAC	Base Excision Repair	10916	205		0.49056603773584906	0.5	88	10828	7	16	81	10812	10916	0.1522473538068621
R1	cpdb	0	network_modules	58	TRUE	1.6415791130871416e-7	48	23	6	0.2608695652173913	0.125	REAC:R-HSA-73893	REAC	DNA Damage Bypass	10916	438		0.5094339622641509	0.5185185185185185	48	10868	6	17	42	10851	10916	0.17811430925831984
R1	cpdb	0	network_modules	58	TRUE	1.672921660660788e-7	61	19	6	0.3157894736842105	0.09836065573770492	KEGG:03420	KEGG	Nucleotide excision repair	8484	238		1	1	61	8423	6	13	55	8410	8484	0.1730457094191424
R1	cpdb	0	network_modules	58	TRUE	3.4819301094063375e-7	246	28	9	0.32142857142857145	0.036585365853658534	GO:0051054	GO:BP	positive regulation of DNA metabolic process	16175	13464		0.52	0.5384615384615384	246	15929	9	19	237	15910	16175	0.10419551027105114
R1	cpdb	0	network_modules	58	TRUE	8.908319922352741e-7	63	23	6	0.2608695652173913	0.09523809523809523	REAC:R-HSA-6782210	REAC	Gap-filling DNA repair synthesis and ligation in TC-NER	10916	1038		0.5283018867924528	0.5370370370370371	63	10853	6	17	57	10836	10916	0.15474475790364622
R1	cpdb	0	network_modules	58	TRUE	9.816702419415917e-7	64	23	6	0.2608695652173913	0.09375	REAC:R-HSA-6782135	REAC	Dual incision in TC-NER	10916	808		0.5471698113207547	0.5555555555555556	64	10852	6	17	58	10835	10916	0.15348299121241307
R1	cpdb	0	network_modules	58	TRUE	1.4254530141496898e-6	68	23	6	0.2608695652173913	0.08823529411764706	REAC:R-HSA-5685942	REAC	HDR through Homologous Recombination (HRR)	10916	1097		0.5660377358490566	0.5740740740740741	68	10848	6	17	62	10831	10916	0.14871381893464636
R1	cpdb	0	network_modules	58	TRUE	3.0507186101861984e-6	77	23	6	0.2608695652173913	0.07792207792207792	REAC:R-HSA-6781827	REAC	Transcription-Coupled Nucleotide Excision Repair (TC-NER)	10916	2541		0.5849056603773585	0.5925925925925926	77	10839	6	17	71	10822	10916	0.13935809583723313
R1	cpdb	0	network_modules	58	TRUE	4.862847617212969e-6	14	23	4	0.17391304347826086	0.2857142857142857	REAC:R-HSA-5358606	REAC	Mismatch repair (MMR) directed by MSH2:MSH3 (MutSbeta)	10916	1458		0.6037735849056604	0.6111111111111112	14	10902	4	19	10	10883	10916	0.2216430772998748
R1	cpdb	0	network_modules	58	TRUE	5.181364139654606e-6	84	23	6	0.2608695652173913	0.07142857142857142	REAC:R-HSA-5696399	REAC	Global Genome Nucleotide Excision Repair (GG-NER)	10916	1047		0.6226415094339622	0.6296296296296297	84	10832	6	17	78	10815	10916	0.13313111841216888
R1	cpdb	0	network_modules	58	TRUE	1.1827586907788634e-5	168	23	7	0.30434782608695654	0.041666666666666664	REAC:R-HSA-5693532	REAC	DNA Double-Strand Break Repair	10916	443		0.6415094339622641	0.6481481481481481	168	10748	7	16	161	10732	10916	0.10786220761858613
R1	cpdb	0	network_modules	58	TRUE	2.4960568416247296e-5	109	23	6	0.2608695652173913	0.05504587155963303	REAC:R-HSA-5696398	REAC	Nucleotide Excision Repair	10916	1622		0.660377358490566	0.6666666666666666	109	10807	6	17	103	10790	10916	0.11594745463125063
R1	cpdb	0	network_modules	58	TRUE	2.681832306162122e-5	47	28	5	0.17857142857142858	0.10638297872340426	GO:0016445	GO:BP	somatic diversification of immunoglobulins	16175	5224		0.56	0.5769230769230769	47	16128	5	23	42	16105	16175	0.1359017944034759
R1	cpdb	0	network_modules	58	TRUE	3.910531419467494e-5	577	28	10	0.35714285714285715	0.01733102253032929	GO:0043085	GO:BP	positive regulation of catalytic activity	16175	10518		0.6	0.6153846153846154	577	15598	10	18	567	15580	16175	0.07217655927181987
R1	cpdb	0	network_modules	58	TRUE	4.516952943905554e-5	52	28	5	0.17857142857142858	0.09615384615384616	GO:0002200	GO:BP	somatic diversification of immune receptors	16175	738		0.64	0.6538461538461539	52	16123	5	23	47	16100	16175	0.12899559416262052
R1	cpdb	0	network_modules	58	TRUE	4.661512517787952e-5	121	23	6	0.2608695652173913	0.049586776859504134	REAC:R-HSA-69239	REAC	Synthesis of DNA	10916	2376		0.6792452830188679	0.6851851851851852	121	10795	6	17	115	10778	10916	0.10962658822167733
R1	cpdb	0	network_modules	58	TRUE	5.081576233166083e-5	301	28	8	0.2857142857142857	0.026578073089700997	GO:0051347	GO:BP	positive regulation of transferase activity	16175	13674		0.68	0.6923076923076923	301	15874	8	20	293	15854	16175	0.08230637729654347
R1	cpdb	0	network_modules	58	TRUE	7.824467637150144e-5	132	23	6	0.2608695652173913	0.045454545454545456	REAC:R-HSA-5693567	REAC	HDR through Homologous Recombination (HRR) or Single Strand Annealing (SSA)	10916	1098		0.6981132075471698	0.7037037037037037	132	10784	6	17	126	10767	10916	0.10458933576963649
R1	cpdb	0	network_modules	58	TRUE	1.018557928973368e-4	138	23	6	0.2608695652173913	0.043478260869565216	REAC:R-HSA-5693538	REAC	Homology Directed Repair	10916	1130		0.71698113207547165	0.7222222222222222	138	10778	6	17	132	10761	10916	0.10209279163061369
R1	cpdb	0	network_modules	58	TRUE	1.3249472420949235e-4	359	23	8	0.34782608695652173	0.022284122562674095	REAC:R-HSA-3700989	REAC	Transcriptional Regulation by TP53	10916	2546		0.7358490566037735	0.7407407407407407	359	10557	8	15	351	10542	10916	0.08114505826019427
R1	cpdb	0	network_modules	58	TRUE	2.2123662634952504e-4	71	28	5	0.17857142857142858	0.07042253521126761	GO:0002377	GO:BP	immunoglobulin production	16175	907		0.72	0.7307692307692307	71	16104	5	23	66	16081	16175	0.10971965843520481
R1	cpdb	0	network_modules	58	TRUE	2.4702376305987963e-4	35	23	4	0.17391304347826086	0.11428571428571428	REAC:R-HSA-9709570	REAC	Impaired BRCA2 binding to RAD51	10916	1173		0.7547169811320755	0.7592592592592593	35	10881	4	19	31	10862	10916	0.13875094081242184
R1	cpdb	0	network_modules	58	TRUE	2.623841064093131e-4	162	23	6	0.2608695652173913	0.037037037037037035	REAC:R-HSA-69242	REAC	S Phase	10916	2111		0.7735849056603774	0.7777777777777778	162	10754	6	17	156	10737	10916	0.09349694232610249
R1	cpdb	0	network_modules	58	TRUE	3.1071885369840806e-4	37	23	4	0.17391304347826086	0.10810810810810811	REAC:R-HSA-176187	REAC	Activation of ATR in response to replication stress	10916	75		0.7924528301886793	0.8148148148148148	37	10879	4	19	33	10860	10916	0.1348163734968643
R1	cpdb	0	network_modules	58	TRUE	3.1071885369840806e-4	37	23	4	0.17391304347826086	0.10810810810810811	REAC:R-HSA-5685938	REAC	HDR through Single Strand Annealing (SSA)	10916	1100		0.7924528301886793	0.8148148148148148	37	10879	4	19	33	10860	10916	0.1348163734968643
R1	cpdb	0	network_modules	58	TRUE	4.281629750083448e-4	40	23	4	0.17391304347826086	0.1	REAC:R-HSA-5693616	REAC	Presynaptic phase of homologous DNA pairing and strand exchange	10916	1793		0.8301886792452831	0.8333333333333334	40	10876	4	19	36	10857	10916	0.12947111740992998
R1	cpdb	0	network_modules	58	TRUE	4.7378955040302796e-4	41	23	4	0.17391304347826086	0.0975609756097561	REAC:R-HSA-9701190	REAC	Defective homologous recombination repair (HRR) due to BRCA2 loss of function	10916	698		0.8490566037735849	0.8703703703703703	41	10875	4	19	37	10856	10916	0.12781951901723793
R1	cpdb	0	network_modules	58	TRUE	4.7378955040302796e-4	41	23	4	0.17391304347826086	0.0975609756097561	REAC:R-HSA-9675136	REAC	Diseases of DNA Double-Strand Break Repair	10916	757		0.8490566037735849	0.8703703703703703	41	10875	4	19	37	10856	10916	0.12781951901723793
R1	cpdb	0	network_modules	58	TRUE	5.757626134054003e-4	43	23	4	0.17391304347826086	0.09302325581395349	REAC:R-HSA-5693579	REAC	Homologous DNA Pairing and Strand Exchange	10916	1129		0.8867924528301887	0.8888888888888888	43	10873	4	19	39	10854	10916	0.12468865438829621
R1	cpdb	0	network_modules	58	TRUE	6.07788075865782e-4	187	23	6	0.2608695652173913	0.03208556149732621	REAC:R-HSA-69306	REAC	DNA Replication	10916	445		0.9056603773584906	0.9074074074074074	187	10729	6	17	181	10712	10916	0.08631332427774631
R1	cpdb	0	network_modules	58	TRUE	6.619616744104138e-4	281	28	7	0.25	0.02491103202846975	GO:0006310	GO:BP	DNA recombination	16175	2115		0.76	0.7692307692307693	281	15894	7	21	274	15873	16175	0.07414275049836082
R1	cpdb	0	network_modules	58	TRUE	6.681460795650107e-4	9	28	3	0.10714285714285714	0.3333333333333333	GO:0016446	GO:BP	somatic hypermutation of immunoglobulin genes	16175	5225		0.8	0.8461538461538461	9	16166	3	25	6	16141	16175	0.18821611693635254
R1	cpdb	0	network_modules	58	TRUE	6.681460795650107e-4	9	28	3	0.10714285714285714	0.3333333333333333	GO:0002566	GO:BP	somatic diversification of immune receptors via somatic mutation	16175	1087		0.8	0.8461538461538461	9	16166	3	25	6	16141	16175	0.18821611693635254
R1	cpdb	0	network_modules	58	TRUE	0.0013969783197711086	2	23	2	0.08695652173913043	1	REAC:R-HSA-5632968	REAC	Defective Mismatch Repair Associated With MSH6	10916	595		0.9245283018867925	0.9629629629629629	2	10914	2	21	0	10893	10916	0.29460007760859136
R1	cpdb	0	network_modules	58	TRUE	0.0013969783197711086	2	23	2	0.08695652173913043	1	REAC:R-HSA-5632987	REAC	Defective Mismatch Repair Associated With PMS2	10916	596		0.9245283018867925	0.9629629629629629	2	10914	2	21	0	10893	10916	0.29460007760859136
R1	cpdb	0	network_modules	58	TRUE	0.0013969783197711086	2	23	2	0.08695652173913043	1	REAC:R-HSA-5545483	REAC	Defective Mismatch Repair Associated With MLH1	10916	592		0.9245283018867925	0.9629629629629629	2	10914	2	21	0	10893	10916	0.29460007760859136
R1	cpdb	0	network_modules	58	TRUE	0.0014320365038861767	103	28	5	0.17857142857142858	0.04854368932038835	GO:0002520	GO:BP	immune system development	16175	1042		0.88	0.8846153846153846	103	16072	5	23	98	16049	16175	0.09015005092045059
R1	cpdb	0	network_modules	58	TRUE	0.002924147059387561	512	28	8	0.2857142857142857	0.015625	GO:0051338	GO:BP	regulation of transferase activity	16175	13665		0.92	0.9230769230769231	512	15663	8	20	504	15643	16175	0.0604285362704774
R1	cpdb	0	network_modules	58	TRUE	0.003594027106055537	15	28	3	0.10714285714285714	0.2	GO:0006271	GO:BP	DNA strand elongation involved in DNA replication	16175	2086		0.96	0.9615384615384616	15	16160	3	25	12	16135	16175	0.14531116107917666
R1	cpdb	0	network_modules	58	TRUE	0.004185559011958507	3	23	2	0.08695652173913043	0.6666666666666666	REAC:R-HSA-5632928	REAC	Defective Mismatch Repair Associated With MSH2	10916	593		0.9811320754716981	0.9814814814814815	3	10913	2	21	1	10892	10916	0.24029702124942165
R1	cpdb	0	network_modules	58	TRUE	0.009151805391389774	150	28	5	0.17857142857142858	0.03333333333333333	GO:0002440	GO:BP	production of molecular mediator of immune response	16175	963		1	1	150	16025	5	23	145	16002	16175	0.07355025753181645
R1	cpdb	0	network_modules	58	TRUE	0.00933035749886343	86	23	4	0.17391304347826086	0.046511627906976744	REAC:R-HSA-912446	REAC	Meiotic recombination	10916	1411		1	1	86	10830	4	19	82	10811	10916	0.08629568897083932
R1	cpdb	0	network_modules	59	TRUE	6.278698714465287e-14	124	27	11	0.4074074074074074	0.08870967741935484	GO:0031109	GO:BP	microtubule polymerization or depolymerization	16175	7034		0	0.030303030303030304	124	16051	11	16	113	16035	16175	0.1874061693981556
R1	cpdb	0	network_modules	59	TRUE	1.854692270888823e-11	88	27	9	0.3333333333333333	0.10227272727272728	GO:0031110	GO:BP	regulation of microtubule polymerization or depolymerization	16175	7035		0.03125	0.06060606060606061	88	16087	9	18	79	16069	16175	0.1822719608833347
R1	cpdb	0	network_modules	59	TRUE	3.25764071204658e-11	147	27	10	0.37037037037037035	0.06802721088435375	GO:0070507	GO:BP	regulation of microtubule cytoskeleton organization	16175	16162		0.0625	0.09090909090909091	147	16028	10	17	137	16011	16175	0.15567365334477193
R1	cpdb	0	network_modules	59	TRUE	1.1689486781893095e-10	586	27	14	0.5185185185185185	0.023890784982935155	GO:0000226	GO:BP	microtubule cytoskeleton organization	16175	61		0.09375	0.12121212121212122	586	15589	14	13	572	15576	16175	0.10553995750770047
R1	cpdb	0	network_modules	59	TRUE	2.655922130875153e-9	440	27	12	0.4444444444444444	0.02727272727272727	GO:0051493	GO:BP	regulation of cytoskeleton organization	16175	13748		0.125	0.15151515151515152	440	15735	12	15	428	15720	16175	0.10488057942170674
R1	cpdb	0	network_modules	59	TRUE	2.785978411364173e-9	93	27	8	0.2962962962962963	0.08602150537634409	GO:0051261	GO:BP	protein depolymerization	16175	13608		0.15625	0.18181818181818182	93	16082	8	19	85	16063	16175	0.15713438103074173
R1	cpdb	0	network_modules	59	TRUE	3.2321061911899168e-9	232	27	10	0.37037037037037035	0.04310344827586207	GO:0032886	GO:BP	regulation of microtubule-based process	16175	7882		0.1875	0.21212121212121213	232	15943	10	17	222	15926	16175	0.12243935220515546
R1	cpdb	0	network_modules	59	TRUE	3.2499131363709745e-9	748	27	14	0.5185185185185185	0.01871657754010695	GO:0097435	GO:BP	supramolecular fiber organization	16175	18657		0.21875	0.24242424242424243	748	15427	14	13	734	15414	16175	0.09195378040870808
R1	cpdb	0	network_modules	59	TRUE	4.061733355529453e-8	15	27	5	0.18518518518518517	0.3333333333333333	GO:0035372	GO:BP	protein localization to microtubule	16175	9007		0.25	0.2727272727272727	15	16160	5	22	10	16138	16175	0.24752920165780984
R1	cpdb	0	network_modules	59	TRUE	8.048590393983234e-8	41	27	6	0.2222222222222222	0.14634146341463414	GO:0007019	GO:BP	microtubule depolymerization	16175	2627		0.28125	0.30303030303030304	41	16134	6	21	35	16113	16175	0.17865249549605722
R1	cpdb	0	network_modules	59	TRUE	2.179535520536731e-7	48	27	6	0.2222222222222222	0.125	GO:0072698	GO:BP	protein localization to microtubule cytoskeleton	16175	17509		0.3125	0.3333333333333333	48	16127	6	21	42	16106	16175	0.16482316941051525
R1	cpdb	0	network_modules	59	TRUE	2.4808882725831675e-7	49	27	6	0.2222222222222222	0.12244897959183673	GO:1901880	GO:BP	negative regulation of protein depolymerization	16175	21824		0.34375	0.36363636363636365	49	16126	6	21	43	16105	16175	0.16309168830953102
R1	cpdb	0	network_modules	59	TRUE	2.816048625589743e-7	50	27	6	0.2222222222222222	0.12	GO:0044380	GO:BP	protein localization to cytoskeleton	16175	10982		0.375	0.3939393939393939	50	16125	6	21	44	16104	16175	0.16141200102885592
R1	cpdb	0	network_modules	59	TRUE	8.773579044124616e-7	60	27	6	0.2222222222222222	0.1	GO:0043242	GO:BP	negative regulation of protein-containing complex disassembly	16175	10580		0.40625	0.42424242424242425	60	16115	6	21	54	16094	16175	0.1469781887866602
R1	cpdb	0	network_modules	59	TRUE	1.1867510054717618e-6	63	27	6	0.2222222222222222	0.09523809523809523	GO:1901879	GO:BP	regulation of protein depolymerization	16175	21823		0.4375	0.45454545454545453	63	16112	6	21	57	16091	16175	0.14332761983592937
R1	cpdb	0	network_modules	59	TRUE	1.8962334704657792e-6	127	27	7	0.25925925925925924	0.05511811023622047	GO:0051494	GO:BP	negative regulation of cytoskeleton organization	16175	13749		0.46875	0.48484848484848486	127	16048	7	20	120	16028	16175	0.11647506132201062
R1	cpdb	0	network_modules	59	TRUE	2.102789282398646e-6	318	27	9	0.3333333333333333	0.02830188679245283	GO:1902903	GO:BP	regulation of supramolecular fiber organization	16175	22602		0.5	0.5151515151515151	318	15857	9	18	309	15839	16175	0.09238902200546505
R1	cpdb	0	network_modules	59	TRUE	2.116417587257159e-6	129	27	7	0.25925925925925924	0.05426356589147287	GO:1902904	GO:BP	negative regulation of supramolecular fiber organization	16175	22603		0.53125	0.5454545454545454	129	16046	7	20	122	16026	16175	0.11551898629952469
R1	cpdb	0	network_modules	59	TRUE	2.351526454791582e-6	289	18	8	0.4444444444444444	0.02768166089965398	REAC:R-HSA-69620	REAC	Cell Cycle Checkpoints	10916	321		0	0.07692307692307693	289	10627	8	10	281	10617	10916	0.10580757349521958
R1	cpdb	0	network_modules	59	TRUE	2.388304343778085e-6	215	27	8	0.2962962962962963	0.037209302325581395	GO:0032984	GO:BP	protein-containing complex disassembly	16175	7964		0.5625	0.5757575757575758	215	15960	8	19	207	15941	16175	0.10104712837070359
R1	cpdb	0	network_modules	59	TRUE	3.6832917105377877e-6	34	27	5	0.18518518518518517	0.14705882352941177	GO:0031111	GO:BP	negative regulation of microtubule polymerization or depolymerization	16175	7036		0.59375	0.6060606060606061	34	16141	5	22	29	16119	16175	0.16345964870227397
R1	cpdb	0	network_modules	59	TRUE	8.699952437293771e-6	374	27	9	0.3333333333333333	0.02406417112299465	GO:0022411	GO:BP	cellular component disassembly	16175	6602		0.625	0.6363636363636364	374	15801	9	18	365	15783	16175	0.08440073544837609
R1	cpdb	0	network_modules	59	TRUE	9.968234171991943e-6	161	27	7	0.25925925925925924	0.043478260869565216	GO:0032271	GO:BP	regulation of protein polymerization	16175	7452		0.65625	0.6666666666666666	161	16014	7	20	154	15994	16175	0.10269186284276634
R1	cpdb	0	network_modules	59	TRUE	1.661678790942042e-5	97	27	6	0.2222222222222222	0.061855670103092786	GO:0043244	GO:BP	regulation of protein-containing complex disassembly	16175	10582		0.6875	0.696969696969697	97	16078	6	21	91	16057	16175	0.114517394141244
R1	cpdb	0	network_modules	59	TRUE	3.3706698366814186e-5	52	27	5	0.18518518518518517	0.09615384615384616	GO:0031122	GO:BP	cytoplasmic microtubule organization	16175	7047		0.71875	0.7272727272727273	52	16123	5	22	47	16101	16175	0.1314446234454337
R1	cpdb	0	network_modules	59	TRUE	5.9023324184277425e-5	58	27	5	0.18518518518518517	0.08620689655172414	GO:0031113	GO:BP	regulation of microtubule polymerization	16175	7038		0.75	0.7575757575757576	58	16117	5	22	53	16095	16175	0.12422960997814253
R1	cpdb	0	network_modules	59	TRUE	6.892971385004336e-5	22	27	4	0.14814814814814814	0.18181818181818182	GO:0007026	GO:BP	negative regulation of microtubule depolymerization	16175	2631		0.78125	0.7878787878787878	22	16153	4	23	18	16130	16175	0.1628618972634233
R1	cpdb	0	network_modules	59	TRUE	9.241555214245444e-5	92	18	5	0.2777777777777778	0.05434782608695652	REAC:R-HSA-141424	REAC	Amplification of signal from the kinetochores	10916	144		0.08333333333333333	0.23076923076923078	92	10824	5	13	87	10811	10916	0.11974439689494511
R1	cpdb	0	network_modules	59	TRUE	9.241555214245444e-5	92	18	5	0.2777777777777778	0.05434782608695652	REAC:R-HSA-141444	REAC	Amplification  of signal from unattached  kinetochores via a MAD2  inhibitory signal	10916	143		0.08333333333333333	0.23076923076923078	92	10824	5	13	87	10811	10916	0.11974439689494511
R1	cpdb	0	network_modules	59	TRUE	1.242326341413162e-4	318	18	7	0.3888888888888889	0.0220125786163522	REAC:R-HSA-195258	REAC	RHO GTPase Effectors	10916	1846		0.25	0.3076923076923077	318	10598	7	11	311	10587	10916	0.08693817560109016
R1	cpdb	0	network_modules	59	TRUE	1.4023468172726382e-4	26	27	4	0.14814814814814814	0.15384615384615385	GO:0031114	GO:BP	regulation of microtubule depolymerization	16175	7039		0.8125	0.8181818181818182	26	16149	4	23	22	16126	16175	0.14957728925477215
R1	cpdb	0	network_modules	59	TRUE	1.4762185541952573e-4	238	27	7	0.25925925925925924	0.029411764705882353	GO:0051258	GO:BP	protein polymerization	16175	13605		0.84375	0.8484848484848485	238	15937	7	20	231	15917	16175	0.08304895439356283
R1	cpdb	0	network_modules	59	TRUE	2.1585442634404348e-4	109	18	5	0.2777777777777778	0.045871559633027525	REAC:R-HSA-69618	REAC	Mitotic Spindle Checkpoint	10916	1486		0.3333333333333333	0.38461538461538464	109	10807	5	13	104	10794	10916	0.10946086041269518
R1	cpdb	0	network_modules	59	TRUE	2.8187180479304785e-4	115	18	5	0.2777777777777778	0.043478260869565216	REAC:R-HSA-9648025	REAC	EML4 and NUDC in mitotic spindle formation	10916	817		0.4166666666666667	0.46153846153846156	115	10801	5	13	110	10788	10916	0.10637791176933098
R1	cpdb	0	network_modules	59	TRUE	3.936743651875599e-4	123	18	5	0.2777777777777778	0.04065040650406504	REAC:R-HSA-2500257	REAC	Resolution of Sister Chromatid Cohesion	10916	2079		0.5	0.5384615384615384	123	10793	5	13	118	10780	10916	0.10261624126239476
R1	cpdb	0	network_modules	59	TRUE	4.8772437184415473e-4	88	27	5	0.18518518518518517	0.056818181818181816	GO:0046785	GO:BP	microtubule polymerization	16175	12369		0.875	0.8787878787878788	88	16087	5	22	83	16065	16175	0.09991806267767854
R1	cpdb	0	network_modules	59	TRUE	6.436781744247591e-4	406	18	7	0.3888888888888889	0.017241379310344827	REAC:R-HSA-68886	REAC	M Phase	10916	1343		0.5833333333333334	0.6153846153846154	406	10510	7	11	399	10499	10916	0.0755316822683099
R1	cpdb	0	network_modules	59	TRUE	6.473193044368571e-4	136	18	5	0.2777777777777778	0.03676470588235294	REAC:R-HSA-5663220	REAC	RHO GTPases Activate Formins	10916	1848		0.6666666666666666	0.6923076923076923	136	10780	5	13	131	10767	10916	0.09721110899556636
R1	cpdb	0	network_modules	59	TRUE	7.768477492887339e-4	304	27	7	0.25925925925925924	0.023026315789473683	GO:0010639	GO:BP	negative regulation of organelle organization	16175	4285		0.90625	0.9090909090909091	304	15871	7	20	297	15851	16175	0.07240681054966588
R1	cpdb	0	network_modules	59	TRUE	0.001698533435572907	113	27	5	0.18518518518518517	0.04424778761061947	GO:0051225	GO:BP	spindle assembly	16175	13578		0.9375	0.9393939393939394	113	16062	5	22	108	16040	16175	0.0874849330785834
R1	cpdb	0	network_modules	59	TRUE	0.0018512128816373487	346	27	7	0.25925925925925924	0.02023121387283237	GO:0043254	GO:BP	regulation of protein-containing complex assembly	16175	10588		0.96875	0.9696969696969697	346	15829	7	20	339	15809	16175	0.06722618117398899
R1	cpdb	0	network_modules	59	TRUE	0.0031667152233077795	188	18	5	0.2777777777777778	0.026595744680851064	REAC:R-HSA-2467813	REAC	Separation of Sister Chromatids	10916	2204		0.75	0.7692307692307693	188	10728	5	13	183	10715	10916	0.0813931898345619
R1	cpdb	0	network_modules	59	TRUE	0.004174383169339849	199	18	5	0.2777777777777778	0.02512562814070352	REAC:R-HSA-68877	REAC	Mitotic Prometaphase	10916	1484		0.8333333333333334	0.8461538461538461	199	10717	5	13	194	10704	10916	0.07884612182547963
R1	cpdb	0	network_modules	59	TRUE	0.008057059161707125	228	18	5	0.2777777777777778	0.021929824561403508	REAC:R-HSA-68882	REAC	Mitotic Anaphase	10916	1479		0.9166666666666666	0.9230769230769231	228	10688	5	13	223	10675	10916	0.07300618107833846
R1	cpdb	0	network_modules	59	TRUE	0.008228635564087206	229	18	5	0.2777777777777778	0.021834061135371178	REAC:R-HSA-2555396	REAC	Mitotic Metaphase and Anaphase	10916	1482		1	1	229	10687	5	13	224	10674	10916	0.07282403395600308
R1	cpdb	0	network_modules	59	TRUE	0.00844875176401832	21	27	3	0.1111111111111111	0.14285714285714285	GO:0034453	GO:BP	microtubule anchoring	16175	8642		1	1	21	16154	3	24	18	16130	16175	0.12470105400611571
R1	cpdb	0	network_modules	60	TRUE	1.3484849869956754e-42	33	27	19	0.7037037037037037	0.5757575757575758	REAC:R-HSA-68962	REAC	Activation of the pre-replicative complex	10916	107		0	0.05	33	10883	19	8	14	10875	10916	0.6355361082248377
R1	cpdb	0	network_modules	60	TRUE	9.686271867982268e-38	231	36	26	0.7222222222222222	0.11255411255411256	GO:0006260	GO:BP	DNA replication	16175	2077		0	0.029411764705882353	231	15944	26	10	205	15934	16175	0.2818055969789936
R1	cpdb	0	network_modules	60	TRUE	6.629725569477451e-36	147	36	23	0.6388888888888888	0.1564625850340136	GO:0006261	GO:BP	DNA-templated DNA replication	16175	2078		0.030303030303030304	0.058823529411764705	147	16028	23	13	124	16015	16175	0.31344554075978437
R1	cpdb	0	network_modules	60	TRUE	3.430887391883034e-35	37	27	17	0.6296296296296297	0.4594594594594595	REAC:R-HSA-176187	REAC	Activation of ATR in response to replication stress	10916	75		0.05263157894736842	0.1	37	10879	17	10	20	10869	10916	0.5365336188775193
R1	cpdb	0	network_modules	60	TRUE	7.13718452386751e-33	32	36	16	0.4444444444444444	0.5	GO:0006270	GO:BP	DNA replication initiation	16175	2085		0.06060606060606061	0.08823529411764706	32	16143	16	20	16	16123	16175	0.47029471882605095
R1	cpdb	0	network_modules	60	TRUE	1.0458158271111519e-32	147	27	21	0.7777777777777778	0.14285714285714285	REAC:R-HSA-453279	REAC	Mitotic G1 phase and G1/S transition	10916	1480		0.10526315789473684	0.15	147	10769	21	6	126	10763	10916	0.33019868434976474
R1	cpdb	0	network_modules	60	TRUE	1.9097000463097674e-31	130	27	20	0.7407407407407407	0.15384615384615385	REAC:R-HSA-69206	REAC	G1/S Transition	10916	1002		0.15789473684210525	0.2	130	10786	20	7	110	10779	10916	0.3345620911464695
R1	cpdb	0	network_modules	60	TRUE	5.15077540420825e-30	157	21	19	0.9047619047619048	0.12101910828025478	KEGG:04110	KEGG	Cell cycle	8484	264		0	0.5	157	8327	19	2	138	8325	8484	0.32757703919482584
R1	cpdb	0	network_modules	60	TRUE	4.317535660371702e-28	187	27	20	0.7407407407407407	0.10695187165775401	REAC:R-HSA-69306	REAC	DNA Replication	10916	445		0.21052631578947367	0.25	187	10729	20	7	167	10722	10916	0.2776869679062214
R1	cpdb	0	network_modules	60	TRUE	2.7124694563233878e-27	159	27	19	0.7037037037037037	0.11949685534591195	REAC:R-HSA-69002	REAC	DNA Replication Pre-Initiation	10916	446		0.2631578947368421	0.3	159	10757	19	8	140	10749	10916	0.2864266456065892
R1	cpdb	0	network_modules	60	TRUE	4.429829426019747e-25	121	27	17	0.6296296296296297	0.14049586776859505	REAC:R-HSA-69239	REAC	Synthesis of DNA	10916	2376		0.3157894736842105	0.35	121	10795	17	10	104	10785	10916	0.29418375736484165
R1	cpdb	0	network_modules	60	TRUE	6.221636857459636e-25	162	27	18	0.6666666666666666	0.1111111111111111	REAC:R-HSA-69242	REAC	S Phase	10916	2111		0.3684210526315789	0.4	162	10754	18	9	144	10745	10916	0.268435908207253
R1	cpdb	0	network_modules	60	TRUE	6.378072289054092e-25	92	27	16	0.5925925925925926	0.17391304347826086	REAC:R-HSA-69052	REAC	Switching of origins to a post-replicative state	10916	2365		0.42105263157894735	0.45	92	10824	16	11	76	10813	10916	0.318199020130732
R1	cpdb	0	network_modules	60	TRUE	1.705467931059588e-24	71	27	15	0.5555555555555556	0.2112676056338028	REAC:R-HSA-68949	REAC	Orc1 removal from chromatin	10916	1644		0.47368421052631576	0.5	71	10845	15	12	56	10833	10916	0.34011079356792345
R1	cpdb	0	network_modules	60	TRUE	1.4247602288759134e-22	167	27	17	0.6296296296296297	0.10179640718562874	REAC:R-HSA-69481	REAC	G2/M Checkpoints	10916	1005		0.5263157894736842	0.55	167	10749	17	10	150	10739	10916	0.2492364540681278
R1	cpdb	0	network_modules	60	TRUE	3.5275187623758336e-22	289	27	19	0.7037037037037037	0.0657439446366782	REAC:R-HSA-69620	REAC	Cell Cycle Checkpoints	10916	321		0.5789473684210527	0.6	289	10627	19	8	270	10619	10916	0.2100547806487231
R1	cpdb	0	network_modules	60	TRUE	1.184779219873091e-19	142	27	15	0.5555555555555556	0.1056338028169014	REAC:R-HSA-68867	REAC	Assembly of the pre-replicative complex	10916	181		0.631578947368421	0.65	142	10774	15	12	127	10762	10916	0.23842743182611778
R1	cpdb	0	network_modules	60	TRUE	1.42672279011813e-19	8	27	8	0.2962962962962963	1	REAC:R-HSA-68689	REAC	CDC6 association with the ORC:origin complex	10916	270		0.6842105263157895	0.7	8	10908	8	19	0	10889	10916	0.5438567783005751
R1	cpdb	0	network_modules	60	TRUE	1.4501020812164918e-18	112	36	14	0.3888888888888889	0.125	GO:0006275	GO:BP	regulation of DNA replication	16175	2090		0.09090909090909091	0.11764705882352941	112	16063	14	22	98	16041	16175	0.21754946971780775
R1	cpdb	0	network_modules	60	TRUE	2.3766522077606567e-15	43	36	10	0.2777777777777778	0.23255813953488372	GO:0090329	GO:BP	regulation of DNA-templated DNA replication	16175	18209		0.12121212121212122	0.14705882352941177	43	16132	10	26	33	16106	16175	0.25234809931691626
R1	cpdb	0	network_modules	60	TRUE	2.792560009901337e-15	9	27	7	0.25925925925925924	0.7777777777777778	REAC:R-HSA-113507	REAC	E2F-enabled inhibition of pre-replication complex formation	10916	810		0.7368421052631579	0.75	9	10907	7	20	2	10887	10916	0.4483616530050056
R1	cpdb	0	network_modules	60	TRUE	6.114108003041347e-14	12	27	7	0.25925925925925924	0.5833333333333334	REAC:R-HSA-176974	REAC	Unwinding of DNA	10916	2625		0.7894736842105263	0.8	12	10904	7	20	5	10884	10916	0.38793301632695815
R1	cpdb	0	network_modules	60	TRUE	1.9703187687573356e-13	12	36	7	0.19444444444444445	0.5833333333333334	GO:0000727	GO:BP	double-strand break repair via break-induced replication	16175	205		0.15151515151515152	0.17647058823529413	12	16163	7	29	5	16134	16175	0.3360013151257156
R1	cpdb	0	network_modules	60	TRUE	4.2623229392216505e-13	13	36	7	0.19444444444444445	0.5384615384615384	GO:0030174	GO:BP	regulation of DNA-templated DNA replication initiation	16175	6696		0.18181818181818182	0.20588235294117646	13	16162	7	29	6	16133	16175	0.32272657132310073
R1	cpdb	0	network_modules	60	TRUE	4.386401870323872e-13	435	36	16	0.4444444444444444	0.0367816091954023	GO:0051052	GO:BP	regulation of DNA metabolic process	16175	13462		0.21212121212121213	0.23529411764705882	435	15740	16	20	419	15720	16175	0.1219045340120355
R1	cpdb	0	network_modules	60	TRUE	1.0153572087854127e-11	35	36	8	0.2222222222222222	0.22857142857142856	GO:0033260	GO:BP	nuclear DNA replication	16175	8103		0.24242424242424243	0.2647058823529412	35	16140	8	28	27	16112	16175	0.22367084121334166
R1	cpdb	0	network_modules	60	TRUE	1.0663669236613014e-11	60	36	9	0.25	0.15	GO:0071103	GO:BP	DNA conformation change	16175	16453		0.2727272727272727	0.29411764705882354	60	16115	9	27	51	16088	16175	0.1913437301021223
R1	cpdb	0	network_modules	60	TRUE	1.295591831894259e-11	22	27	7	0.25925925925925924	0.3181818181818182	REAC:R-HSA-113510	REAC	E2F mediated regulation of DNA replication	10916	809		0.8421052631578947	0.85	22	10894	7	20	15	10874	10916	0.2856218429944991
R1	cpdb	0	network_modules	60	TRUE	2.637868308328259e-11	39	36	8	0.2222222222222222	0.20512820512820512	GO:0044786	GO:BP	cell cycle DNA replication	16175	11158		0.30303030303030304	0.3235294117647059	39	16136	8	28	31	16108	16175	0.2116784225455912
R1	cpdb	0	network_modules	60	TRUE	7.540574896560512e-11	44	36	8	0.2222222222222222	0.18181818181818182	GO:0032508	GO:BP	DNA duplex unwinding	16175	7615		0.3333333333333333	0.35294117647058826	44	16131	8	28	36	16103	16175	0.1990392273669805
R1	cpdb	0	network_modules	60	TRUE	1.1720406741680242e-10	172	36	11	0.3055555555555556	0.06395348837209303	GO:0000724	GO:BP	double-strand break repair via homologous recombination	16175	203		0.36363636363636365	0.38235294117647056	172	16003	11	25	161	15978	16175	0.13579984348927998
R1	cpdb	0	network_modules	60	TRUE	1.512079886522109e-10	176	36	11	0.3055555555555556	0.0625	GO:0000725	GO:BP	recombinational repair	16175	204		0.3939393939393939	0.4117647058823529	176	15999	11	25	165	15974	16175	0.13415199296442132
R1	cpdb	0	network_modules	60	TRUE	2.516211944302067e-10	32	27	7	0.25925925925925924	0.21875	REAC:R-HSA-69190	REAC	DNA strand elongation	10916	449		0.8947368421052632	0.9	32	10884	7	20	25	10864	10916	0.23609013197697343
R1	cpdb	0	network_modules	60	TRUE	3.162487190359671e-10	52	36	8	0.2222222222222222	0.15384615384615385	GO:0032392	GO:BP	DNA geometric change	16175	7543		0.42424242424242425	0.4411764705882353	52	16123	8	28	44	16095	16175	0.18272223080727576
R1	cpdb	0	network_modules	60	TRUE	7.16021409739257e-9	21	36	6	0.16666666666666666	0.2857142857142857	GO:0006268	GO:BP	DNA unwinding involved in DNA replication	16175	2083		0.45454545454545453	0.47058823529411764	21	16154	6	30	15	16124	16175	0.2169002135576156
R1	cpdb	0	network_modules	60	TRUE	2.5220802199325283e-8	281	36	11	0.3055555555555556	0.03914590747330961	GO:0006310	GO:BP	DNA recombination	16175	2115		0.48484848484848486	0.5	281	15894	11	25	270	15869	16175	0.10417318053364805
R1	cpdb	0	network_modules	60	TRUE	4.750347182084004e-8	298	36	11	0.3055555555555556	0.03691275167785235	GO:0006302	GO:BP	double-strand break repair	16175	2109		0.5151515151515151	0.5294117647058824	298	15877	11	25	287	15852	16175	0.10084318760409378
R1	cpdb	0	network_modules	60	TRUE	1.225378492815929e-7	545	36	13	0.3611111111111111	0.023853211009174313	GO:0051276	GO:BP	chromosome organization	16175	13613		0.5454545454545454	0.5588235294117647	545	15630	13	23	532	15607	16175	0.08570001500637797
R1	cpdb	0	network_modules	60	TRUE	1.0669888613611438e-6	20	36	5	0.1388888888888889	0.25	GO:0000076	GO:BP	DNA replication checkpoint signaling	16175	27		0.5757575757575758	0.5882352941176471	20	16155	5	31	15	16124	16175	0.18500036202228937
R1	cpdb	0	network_modules	60	TRUE	1.0736321636321497e-6	798	36	14	0.3888888888888889	0.017543859649122806	GO:0006974	GO:BP	DNA damage response	16175	2601		0.6060606060606061	0.6176470588235294	798	15377	14	22	784	15355	16175	0.07405053162344068
R1	cpdb	0	network_modules	60	TRUE	1.285016621141145e-6	36	21	5	0.23809523809523808	0.1388888888888889	KEGG:03030	KEGG	DNA replication	8484	214		1	1	36	8448	5	16	31	8432	8484	0.17920946435953686
R1	cpdb	0	network_modules	60	TRUE	1.3655953690325506e-6	528	36	12	0.3333333333333333	0.022727272727272728	GO:0006281	GO:BP	DNA repair	16175	2095		0.6363636363636364	0.6470588235294118	528	15647	12	24	516	15623	16175	0.07991793245188782
R1	cpdb	0	network_modules	60	TRUE	1.5599266860103886e-6	27	27	5	0.18518518518518517	0.18518518518518517	REAC:R-HSA-69205	REAC	G1/S-Specific Transcription	10916	1003		0.9473684210526315	0.95	27	10889	5	22	22	10867	10916	0.18316479763811933
R1	cpdb	0	network_modules	60	TRUE	3.993980673460933e-6	68	27	6	0.2222222222222222	0.08823529411764706	REAC:R-HSA-68616	REAC	Assembly of the ORC complex at the origin of replication	10916	178		1	1	68	10848	6	21	62	10827	10916	0.13669777908526318
R1	cpdb	0	network_modules	60	TRUE	1.745698159094821e-5	3	36	3	0.08333333333333333	1	GO:0071163	GO:BP	DNA replication preinitiation complex assembly	16175	16462		0.6666666666666666	0.6764705882352942	3	16172	3	33	0	16139	16175	0.2883804541547979
R1	cpdb	0	network_modules	60	TRUE	2.5109216033831086e-5	13	36	4	0.1111111111111111	0.3076923076923077	GO:1902969	GO:BP	mitotic DNA replication	16175	22654		0.696969696969697	0.7058823529411765	13	16162	4	32	9	16130	16175	0.1838411196575415
R1	cpdb	0	network_modules	60	TRUE	1.2716702369933787e-4	792	36	12	0.3333333333333333	0.015151515151515152	GO:0000278	GO:BP	mitotic cell cycle	16175	76		0.7272727272727273	0.7352941176470589	792	15383	12	24	780	15359	16175	0.06223808031276933
R1	cpdb	0	network_modules	60	TRUE	1.842162632570322e-4	656	36	11	0.3055555555555556	0.01676829268292683	GO:1903047	GO:BP	mitotic cell cycle process	16175	22727		0.7575757575757576	0.7647058823529411	656	15519	11	25	645	15494	16175	0.06344799598565395
R1	cpdb	0	network_modules	60	TRUE	2.5325032962937653e-4	22	36	4	0.1111111111111111	0.18181818181818182	GO:0008156	GO:BP	negative regulation of DNA replication	16175	3128		0.7878787878787878	0.7941176470588235	22	16153	4	32	18	16121	16175	0.14064611112510816
R1	cpdb	0	network_modules	60	TRUE	0.0010099726612115328	465	36	9	0.25	0.01935483870967742	GO:0044770	GO:BP	cell cycle phase transition	16175	11146		0.8181818181818182	0.8235294117647058	465	15710	9	27	456	15683	16175	0.06253594711133006
R1	cpdb	0	network_modules	60	TRUE	0.0014529744823829867	9	36	3	0.08333333333333333	0.3333333333333333	GO:2000104	GO:BP	negative regulation of DNA-templated DNA replication	16175	25455		0.8484848484848485	0.8529411764705882	9	16166	3	33	6	16133	16175	0.16578450819462554
R1	cpdb	0	network_modules	60	TRUE	0.0023363493795320856	376	36	8	0.2222222222222222	0.02127659574468085	GO:1901987	GO:BP	regulation of cell cycle phase transition	16175	21920		0.8787878787878788	0.8823529411764706	376	15799	8	28	368	15771	16175	0.062366336621490805
R1	cpdb	0	network_modules	60	TRUE	0.0028453308736827525	11	36	3	0.08333333333333333	0.2727272727272727	GO:2000105	GO:BP	positive regulation of DNA-templated DNA replication	16175	25456		0.9090909090909091	0.9117647058823529	11	16164	3	33	8	16131	16175	0.14974299444876987
R1	cpdb	0	network_modules	60	TRUE	0.004893664661869628	183	36	6	0.16666666666666666	0.03278688524590164	GO:0065004	GO:BP	protein-DNA complex assembly	16175	15888		0.9393939393939394	0.9411764705882353	183	15992	6	30	177	15962	16175	0.06937447165350853
R1	cpdb	0	network_modules	60	TRUE	0.007798317540910174	15	36	3	0.08333333333333333	0.2	GO:0006271	GO:BP	DNA strand elongation involved in DNA replication	16175	2086		0.9696969696969697	0.9705882352941176	15	16160	3	33	12	16127	16175	0.12786439562882096
R1	cpdb	0	network_modules	60	TRUE	0.009687806250289373	206	36	6	0.16666666666666666	0.02912621359223301	GO:0071824	GO:BP	protein-DNA complex organization	16175	16927		1	1	206	15969	6	30	200	15939	16175	0.06483518372258203
R1	cpdb	0	network_modules	61	TRUE	1.2240379260267238e-39	41	35	20	0.5714285714285714	0.4878048780487805	REAC:R-HSA-9772755	REAC	Formation of WDR5-containing histone-modifying complexes	10916	952		0	0.15384615384615385	41	10875	20	15	21	10860	10916	0.526325641277426
R1	cpdb	0	network_modules	61	TRUE	1.2240379260267238e-39	41	35	20	0.5714285714285714	0.4878048780487805	REAC:R-HSA-9917777	REAC	Epigenetic regulation by WDR5-containing histone modifying complexes	10916	850		0	0.15384615384615385	41	10875	20	15	21	10860	10916	0.526325641277426
R1	cpdb	0	network_modules	61	TRUE	5.368650741054952e-35	185	35	25	0.7142857142857143	0.13513513513513514	REAC:R-HSA-212165	REAC	Epigenetic regulation of gene expression	10916	852		0.16666666666666666	0.23076923076923078	185	10731	25	10	160	10721	10916	0.30640834246082943
R1	cpdb	0	network_modules	61	TRUE	3.065198436093939e-21	271	35	20	0.5714285714285714	0.07380073800738007	REAC:R-HSA-4839726	REAC	Chromatin organization	10916	356		0.25	0.38461538461538464	271	10645	20	15	251	10630	10916	0.19924038900003735
R1	cpdb	0	network_modules	61	TRUE	3.065198436093939e-21	271	35	20	0.5714285714285714	0.07380073800738007	REAC:R-HSA-3247509	REAC	Chromatin modifying enzymes	10916	355		0.25	0.38461538461538464	271	10645	20	15	251	10630	10916	0.19924038900003735
R1	cpdb	0	network_modules	61	TRUE	1.9518194553045306e-15	84	22	11	0.5	0.13095238095238096	KEGG:03083	KEGG	Polycomb repressive complex	8484	220		0	0.3333333333333333	84	8400	11	11	73	8389	8484	0.25239458252809166
R1	cpdb	0	network_modules	61	TRUE	4.1131552074671764e-14	70	35	11	0.3142857142857143	0.15714285714285714	REAC:R-HSA-3214841	REAC	PKMTs methylate histone lysines	10916	1691		0.4166666666666667	0.46153846153846156	70	10846	11	24	59	10822	10916	0.21875152091817054
R1	cpdb	0	network_modules	61	TRUE	1.6235387096250636e-10	529	42	16	0.38095238095238093	0.030245746691871456	GO:0006325	GO:BP	chromatin organization	16175	2122		0	0.14285714285714285	529	15646	16	26	513	15620	16175	0.09990103503581413
R1	cpdb	0	network_modules	61	TRUE	3.2371452365642176e-10	454	42	15	0.35714285714285715	0.03303964757709251	GO:0006338	GO:BP	chromatin remodeling	16175	2126		0.16666666666666666	0.2857142857142857	454	15721	15	27	439	15694	16175	0.1016571782574051
R1	cpdb	0	network_modules	61	TRUE	4.384595021509555e-9	141	35	10	0.2857142857142857	0.07092198581560284	REAC:R-HSA-3214847	REAC	HATs acetylate histones	10916	1087		0.5	0.5384615384615384	141	10775	10	25	131	10750	10916	0.13702041568657788
R1	cpdb	0	network_modules	61	TRUE	6.065892821001894e-9	209	42	11	0.2619047619047619	0.05263157894736842	GO:0040029	GO:BP	epigenetic regulation of gene expression	16175	9916		0.3333333333333333	0.42857142857142855	209	15966	11	31	198	15935	16175	0.11248921391491343
R1	cpdb	0	network_modules	61	TRUE	1.853971609604968e-8	42	42	7	0.16666666666666666	0.16666666666666666	GO:0141137	GO:BP	positive regulation of gene expression, epigenetic	16175	20039		0.5	0.7142857142857143	42	16133	7	35	35	16098	16175	0.16449720035537924
R1	cpdb	0	network_modules	61	TRUE	1.853971609604968e-8	42	42	7	0.16666666666666666	0.16666666666666666	GO:0045815	GO:BP	transcription initiation-coupled chromatin remodeling	16175	11637		0.5	0.7142857142857143	42	16133	7	35	35	16098	16175	0.16449720035537924
R1	cpdb	0	network_modules	61	TRUE	3.226736925557665e-8	120	35	9	0.2571428571428571	0.075	REAC:R-HSA-5619507	REAC	Activation of HOX genes during differentiation	10916	84		0.5833333333333334	0.6923076923076923	120	10796	9	26	111	10770	10916	0.13388767640386906
R1	cpdb	0	network_modules	61	TRUE	3.226736925557665e-8	120	35	9	0.2571428571428571	0.075	REAC:R-HSA-5617472	REAC	Activation of anterior HOX genes in hindbrain development during early embryogenesis	10916	99		0.5833333333333334	0.6923076923076923	120	10796	9	26	111	10770	10916	0.13388767640386906
R1	cpdb	0	network_modules	61	TRUE	1.588466751528859e-7	95	35	8	0.22857142857142856	0.08421052631578947	REAC:R-HSA-8936459	REAC	RUNX1 regulates genes involved in megakaryocyte differentiation and platelet function	10916	1919		0.75	0.7692307692307693	95	10821	8	27	87	10794	10916	0.13425512331407438
R1	cpdb	0	network_modules	61	TRUE	5.928108613315901e-7	63	22	6	0.2727272727272727	0.09523809523809523	KEGG:00310	KEGG	Lysine degradation	8484	34		0.5	0.6666666666666666	63	8421	6	16	57	8405	8484	0.15756622715741672
R1	cpdb	0	network_modules	61	TRUE	4.385279517293538e-6	143	42	8	0.19047619047619047	0.055944055944055944	GO:0006367	GO:BP	transcription initiation at RNA polymerase II promoter	16175	2142		0.8333333333333334	0.8571428571428571	143	16032	8	34	135	15998	16175	0.09900336587956825
R1	cpdb	0	network_modules	61	TRUE	1.9697835290362656e-5	173	42	8	0.19047619047619047	0.046242774566473986	GO:0006352	GO:BP	DNA-templated transcription initiation	16175	2129		1	1	173	16002	8	34	165	15968	16175	0.08917521891801745
R1	cpdb	0	network_modules	61	TRUE	6.596720638604832e-5	42	35	5	0.14285714285714285	0.11904761904761904	REAC:R-HSA-3769402	REAC	Deactivation of the beta-catenin transactivating complex	10916	452		0.8333333333333334	0.8461538461538461	42	10874	5	30	37	10844	10916	0.12734695487609995
R1	cpdb	0	network_modules	61	TRUE	1.215490487326115e-4	153	22	6	0.2727272727272727	0.0392156862745098	KEGG:04934	KEGG	Cushing syndrome	8484	391		1	1	153	8331	6	16	147	8315	8484	0.0975885292340694
R1	cpdb	0	network_modules	61	TRUE	1.8958471090055126e-4	234	35	8	0.22857142857142856	0.03418803418803419	REAC:R-HSA-8878171	REAC	Transcriptional regulation by RUNX1	10916	2552		0.9166666666666666	0.9230769230769231	234	10682	8	27	226	10655	10916	0.08111149900780908
R1	cpdb	0	network_modules	61	TRUE	0.0010128118688611356	72	35	5	0.14285714285714285	0.06944444444444445	REAC:R-HSA-212300	REAC	PRC2 methylates histones and DNA	10916	1701		1	1	72	10844	5	30	67	10814	10916	0.09547171713726142
R1	cpdb	0	network_modules	62	TRUE	1.1951692770896568e-22	92	27	15	0.5555555555555556	0.16304347826086957	REAC:R-HSA-141444	REAC	Amplification  of signal from unattached  kinetochores via a MAD2  inhibitory signal	10916	143		0	0.13333333333333333	92	10824	15	12	77	10812	10916	0.2980246566816981
R1	cpdb	0	network_modules	62	TRUE	1.1951692770896568e-22	92	27	15	0.5555555555555556	0.16304347826086957	REAC:R-HSA-141424	REAC	Amplification of signal from the kinetochores	10916	144		0	0.13333333333333333	92	10824	15	12	77	10812	10916	0.2980246566816981
R1	cpdb	0	network_modules	62	TRUE	1.819921248654998e-21	109	27	15	0.5555555555555556	0.13761467889908258	REAC:R-HSA-69618	REAC	Mitotic Spindle Checkpoint	10916	1486		0.14285714285714285	0.2	109	10807	15	12	94	10795	10916	0.273234941285208
R1	cpdb	0	network_modules	62	TRUE	4.269012839515337e-21	115	27	15	0.5555555555555556	0.13043478260869565	REAC:R-HSA-9648025	REAC	EML4 and NUDC in mitotic spindle formation	10916	817		0.21428571428571427	0.26666666666666666	115	10801	15	12	100	10789	10916	0.2658173924318232
R1	cpdb	0	network_modules	62	TRUE	1.2385649374265933e-20	123	27	15	0.5555555555555556	0.12195121951219512	REAC:R-HSA-2500257	REAC	Resolution of Sister Chromatid Cohesion	10916	2079		0.2857142857142857	0.3333333333333333	123	10793	15	12	108	10781	10916	0.25677709398837145
R1	cpdb	0	network_modules	62	TRUE	6.023883772519909e-20	136	27	15	0.5555555555555556	0.11029411764705882	REAC:R-HSA-5663220	REAC	RHO GTPases Activate Formins	10916	1848		0.35714285714285715	0.4	136	10780	15	12	121	10768	10916	0.2438090391962359
R1	cpdb	0	network_modules	62	TRUE	6.322064966441449e-19	52	36	12	0.3333333333333333	0.23076923076923078	GO:0008608	GO:BP	attachment of spindle microtubules to kinetochore	16175	3205		0	0.013157894736842105	52	16123	12	24	40	16099	16175	0.2754244478359341
R1	cpdb	0	network_modules	62	TRUE	9.21313156330756e-18	188	27	15	0.5555555555555556	0.0797872340425532	REAC:R-HSA-2467813	REAC	Separation of Sister Chromatids	10916	2204		0.42857142857142855	0.4666666666666667	188	10728	15	12	173	10716	10916	0.20604601087103463
R1	cpdb	0	network_modules	62	TRUE	1.7376120418000283e-17	96	36	13	0.3611111111111111	0.13541666666666666	GO:0051310	GO:BP	metaphase chromosome alignment	16175	13641		0.013333333333333334	0.02631578947368421	96	16079	13	23	83	16056	16175	0.21839150372041818
R1	cpdb	0	network_modules	62	TRUE	2.207739541989193e-17	199	27	15	0.5555555555555556	0.07537688442211055	REAC:R-HSA-68877	REAC	Mitotic Prometaphase	10916	1484		0.5	0.5333333333333333	199	10717	15	12	184	10705	10916	0.1999980011829655
R1	cpdb	0	network_modules	62	TRUE	4.5653690203930486e-17	103	36	13	0.3611111111111111	0.1262135922330097	GO:0051303	GO:BP	establishment of chromosome localization	16175	13634		0.02666666666666667	0.039473684210526314	103	16072	13	23	90	16049	16175	0.21062882587614762
R1	cpdb	0	network_modules	62	TRUE	8.724959357304595e-17	108	36	13	0.3611111111111111	0.12037037037037036	GO:0050000	GO:BP	chromosome localization	16175	13183		0.04	0.05263157894736842	108	16067	13	23	95	16044	16175	0.2055481169482861
R1	cpdb	0	network_modules	62	TRUE	1.7680664898458837e-16	228	27	15	0.5555555555555556	0.06578947368421052	REAC:R-HSA-68882	REAC	Mitotic Anaphase	10916	1479		0.5714285714285714	0.6	228	10688	15	12	213	10676	10916	0.18617467014553327
R1	cpdb	0	network_modules	62	TRUE	1.8900090300054945e-16	229	27	15	0.5555555555555556	0.06550218340611354	REAC:R-HSA-2555396	REAC	Mitotic Metaphase and Anaphase	10916	1482		0.6428571428571429	0.6666666666666666	229	10687	15	12	214	10675	10916	0.18574459117016962
R1	cpdb	0	network_modules	62	TRUE	3.288059973744756e-16	277	36	16	0.4444444444444444	0.05776173285198556	GO:0098813	GO:BP	nuclear chromosome segregation	16175	18900		0.05333333333333334	0.06578947368421052	277	15898	16	20	261	15878	16175	0.15556022291707053
R1	cpdb	0	network_modules	62	TRUE	5.791752213325991e-16	318	27	16	0.5925925925925926	0.050314465408805034	REAC:R-HSA-195258	REAC	RHO GTPase Effectors	10916	1846		0.7142857142857143	0.7333333333333333	318	10598	16	11	302	10587	10916	0.16683600702644713
R1	cpdb	0	network_modules	62	TRUE	1.2067962420256419e-15	178	36	14	0.3888888888888889	0.07865168539325842	GO:0000070	GO:BP	mitotic sister chromatid segregation	16175	24		0.06666666666666667	0.07894736842105263	178	15997	14	22	164	15975	16175	0.17107507888874904
R1	cpdb	0	network_modules	62	TRUE	3.0711637363759522e-15	44	36	10	0.2777777777777778	0.22727272727272727	GO:0007094	GO:BP	mitotic spindle assembly checkpoint signaling	16175	2677		0.08	0.11842105263157894	44	16131	10	26	34	16105	16175	0.2494156982729846
R1	cpdb	0	network_modules	62	TRUE	3.0711637363759522e-15	44	36	10	0.2777777777777778	0.22727272727272727	GO:0071173	GO:BP	spindle assembly checkpoint signaling	16175	16469		0.08	0.11842105263157894	44	16131	10	26	34	16105	16175	0.2494156982729846
R1	cpdb	0	network_modules	62	TRUE	3.0711637363759522e-15	44	36	10	0.2777777777777778	0.22727272727272727	GO:0071174	GO:BP	mitotic spindle checkpoint signaling	16175	16470		0.08	0.11842105263157894	44	16131	10	26	34	16105	16175	0.2494156982729846
R1	cpdb	0	network_modules	62	TRUE	3.942856677930074e-15	45	36	10	0.2777777777777778	0.2222222222222222	GO:0045841	GO:BP	negative regulation of mitotic metaphase/anaphase transition	16175	11657		0.12	0.18421052631578946	45	16130	10	26	35	16104	16175	0.24658105244698802
R1	cpdb	0	network_modules	62	TRUE	3.942856677930074e-15	45	36	10	0.2777777777777778	0.2222222222222222	GO:0033048	GO:BP	negative regulation of mitotic sister chromatid segregation	16175	8003		0.12	0.18421052631578946	45	16130	10	26	35	16104	16175	0.24658105244698802
R1	cpdb	0	network_modules	62	TRUE	3.942856677930074e-15	45	36	10	0.2777777777777778	0.2222222222222222	GO:2000816	GO:BP	negative regulation of mitotic sister chromatid separation	16175	26071		0.12	0.18421052631578946	45	16130	10	26	35	16104	16175	0.24658105244698802
R1	cpdb	0	network_modules	62	TRUE	3.942856677930074e-15	45	36	10	0.2777777777777778	0.2222222222222222	GO:0033046	GO:BP	negative regulation of sister chromatid segregation	16175	8001		0.12	0.18421052631578946	45	16130	10	26	35	16104	16175	0.24658105244698802
R1	cpdb	0	network_modules	62	TRUE	3.942856677930074e-15	45	36	10	0.2777777777777778	0.2222222222222222	GO:0031577	GO:BP	spindle checkpoint signaling	16175	7223		0.12	0.18421052631578946	45	16130	10	26	35	16104	16175	0.24658105244698802
R1	cpdb	0	network_modules	62	TRUE	6.381010678040947e-15	47	36	10	0.2777777777777778	0.2127659574468085	GO:1902100	GO:BP	negative regulation of metaphase/anaphase transition of cell cycle	16175	22014		0.18666666666666668	0.2236842105263158	47	16128	10	26	37	16102	16175	0.2411840803898357
R1	cpdb	0	network_modules	62	TRUE	6.381010678040947e-15	47	36	10	0.2777777777777778	0.2127659574468085	GO:0051985	GO:BP	negative regulation of chromosome segregation	16175	14047		0.18666666666666668	0.2236842105263158	47	16128	10	26	37	16102	16175	0.2411840803898357
R1	cpdb	0	network_modules	62	TRUE	6.381010678040947e-15	47	36	10	0.2777777777777778	0.2127659574468085	GO:1905819	GO:BP	negative regulation of chromosome separation	16175	24929		0.18666666666666668	0.2236842105263158	47	16128	10	26	37	16102	16175	0.2411840803898357
R1	cpdb	0	network_modules	62	TRUE	6.425691636163906e-15	289	27	15	0.5555555555555556	0.05190311418685121	REAC:R-HSA-69620	REAC	Cell Cycle Checkpoints	10916	321		0.7857142857142857	0.8	289	10627	15	12	274	10615	10916	0.16410394902841133
R1	cpdb	0	network_modules	62	TRUE	1.565411822380371e-14	51	36	10	0.2777777777777778	0.19607843137254902	GO:0033047	GO:BP	regulation of mitotic sister chromatid segregation	16175	8002		0.22666666666666666	0.23684210526315788	51	16124	10	26	41	16098	16175	0.2313531636434702
R1	cpdb	0	network_modules	62	TRUE	1.9352898320269995e-14	52	36	10	0.2777777777777778	0.19230769230769232	GO:0045839	GO:BP	negative regulation of mitotic nuclear division	16175	11655		0.24	0.25	52	16123	10	26	42	16097	16175	0.22907333932160492
R1	cpdb	0	network_modules	62	TRUE	2.0243676811716738e-14	217	36	14	0.3888888888888889	0.06451612903225806	GO:0000819	GO:BP	sister chromatid segregation	16175	237		0.25333333333333335	0.2631578947368421	217	15958	14	22	203	15936	16175	0.15414057953436247
R1	cpdb	0	network_modules	62	TRUE	2.2878365216310103e-14	361	36	16	0.4444444444444444	0.0443213296398892	GO:0007059	GO:BP	chromosome segregation	16175	2658		0.26666666666666666	0.27631578947368424	361	15814	16	20	345	15794	16175	0.13496616773077214
R1	cpdb	0	network_modules	62	TRUE	2.881282545681799e-14	406	27	16	0.5925925925925926	0.03940886699507389	REAC:R-HSA-68886	REAC	M Phase	10916	1343		0.8571428571428571	0.8666666666666667	406	10510	16	11	390	10499	10916	0.14614787510959612
R1	cpdb	0	network_modules	62	TRUE	4.3303999499943036e-14	56	36	10	0.2777777777777778	0.17857142857142858	GO:0010965	GO:BP	regulation of mitotic sister chromatid separation	16175	4541		0.28	0.2894736842105263	56	16119	10	26	46	16093	16175	0.22056913747922122
R1	cpdb	0	network_modules	62	TRUE	4.601424680523664e-14	86	36	11	0.3055555555555556	0.12790697674418605	GO:0030071	GO:BP	regulation of mitotic metaphase/anaphase transition	16175	6671		0.29333333333333333	0.3026315789473684	86	16089	11	25	75	16064	16175	0.19498902191693743
R1	cpdb	0	network_modules	62	TRUE	5.2440668279812536e-14	57	36	10	0.2777777777777778	0.17543859649122806	GO:0051784	GO:BP	negative regulation of nuclear division	16175	13934		0.30666666666666664	0.3157894736842105	57	16118	10	26	47	16092	16175	0.21858326687110285
R1	cpdb	0	network_modules	62	TRUE	6.002790729350357e-14	88	36	11	0.3055555555555556	0.125	GO:1902099	GO:BP	regulation of metaphase/anaphase transition of cell cycle	16175	22013		0.32	0.32894736842105265	88	16087	11	25	77	16062	16175	0.19269309508534047
R1	cpdb	0	network_modules	62	TRUE	6.327296061643894e-14	58	36	10	0.2777777777777778	0.1724137931034483	GO:0051306	GO:BP	mitotic sister chromatid separation	16175	13637		0.3333333333333333	0.34210526315789475	58	16117	10	26	48	16091	16175	0.21664860862532295
R1	cpdb	0	network_modules	62	TRUE	7.780852577238157e-14	90	36	11	0.3055555555555556	0.12222222222222222	GO:0007091	GO:BP	metaphase/anaphase transition of mitotic cell cycle	16175	2675		0.3466666666666667	0.35526315789473684	90	16085	11	25	79	16060	16175	0.19047336998562406
R1	cpdb	0	network_modules	62	TRUE	1.002407819138571e-13	92	36	11	0.3055555555555556	0.11956521739130435	GO:0044784	GO:BP	metaphase/anaphase transition of cell cycle	16175	11156		0.36	0.3684210526315789	92	16083	11	25	81	16058	16175	0.18832569035687377
R1	cpdb	0	network_modules	62	TRUE	1.6681181311384656e-13	252	36	14	0.3888888888888889	0.05555555555555555	GO:0140014	GO:BP	mitotic nuclear division	16175	19633		0.37333333333333335	0.3815789473684211	252	15923	14	22	238	15901	16175	0.14236830339009662
R1	cpdb	0	network_modules	62	TRUE	2.3273531995810693e-13	99	36	11	0.3055555555555556	0.1111111111111111	GO:0033045	GO:BP	regulation of sister chromatid segregation	16175	8000		0.38666666666666666	0.39473684210526316	99	16076	11	25	88	16051	16175	0.18132312442580756
R1	cpdb	0	network_modules	62	TRUE	4.726520264395404e-13	70	36	10	0.2777777777777778	0.14285714285714285	GO:1905818	GO:BP	regulation of chromosome separation	16175	24928		0.4	0.40789473684210525	70	16105	10	26	60	16079	16175	0.1967460171084335
R1	cpdb	0	network_modules	62	TRUE	1.127298494320504e-12	76	36	10	0.2777777777777778	0.13157894736842105	GO:0051304	GO:BP	chromosome separation	16175	13635		0.41333333333333333	0.42105263157894735	76	16099	10	26	66	16073	16175	0.18859907348839278
R1	cpdb	0	network_modules	62	TRUE	3.0131016462686847e-12	124	36	11	0.3055555555555556	0.08870967741935484	GO:0051983	GO:BP	regulation of chromosome segregation	16175	14045		0.4266666666666667	0.4342105263157895	124	16051	11	25	113	16026	16175	0.16130595273884374
R1	cpdb	0	network_modules	62	TRUE	6.618663731759394e-12	90	36	10	0.2777777777777778	0.1111111111111111	GO:2001251	GO:BP	negative regulation of chromosome organization	16175	26440		0.44	0.4473684210526316	90	16085	10	26	80	16059	16175	0.1728364420323512
R1	cpdb	0	network_modules	62	TRUE	1.5003246321705532e-11	545	36	16	0.4444444444444444	0.029357798165137616	GO:0051276	GO:BP	chromosome organization	16175	13613		0.4533333333333333	0.4605263157894737	545	15630	16	20	529	15610	16175	0.10751215330951447
R1	cpdb	0	network_modules	62	TRUE	3.599772919349364e-11	106	36	10	0.2777777777777778	0.09433962264150944	GO:0007088	GO:BP	regulation of mitotic nuclear division	16175	2673		0.4666666666666667	0.47368421052631576	106	16069	10	26	96	16043	16175	0.1587591319764489
R1	cpdb	0	network_modules	62	TRUE	4.8584415307498904e-11	379	36	14	0.3888888888888889	0.036939313984168866	GO:0000280	GO:BP	nuclear division	16175	78		0.48	0.4868421052631579	379	15796	14	22	365	15774	16175	0.11410407112234949
R1	cpdb	0	network_modules	62	TRUE	7.7707274285752e-11	229	36	12	0.3333333333333333	0.05240174672489083	GO:0033044	GO:BP	regulation of chromosome organization	16175	7999		0.49333333333333335	0.5	229	15946	12	24	217	15922	16175	0.12759786384350427
R1	cpdb	0	network_modules	62	TRUE	1.1796240076838675e-10	119	36	10	0.2777777777777778	0.08403361344537816	GO:0051783	GO:BP	regulation of nuclear division	16175	13933		0.5066666666666667	0.5131578947368421	119	16056	10	26	109	16030	16175	0.1494531503107342
R1	cpdb	0	network_modules	62	TRUE	1.429319097971814e-10	410	36	14	0.3888888888888889	0.03414634146341464	GO:0051656	GO:BP	establishment of organelle localization	16175	13869		0.52	0.5263157894736842	410	15765	14	22	396	15743	16175	0.10923752854325741
R1	cpdb	0	network_modules	62	TRUE	2.262741283301684e-10	424	36	14	0.3888888888888889	0.0330188679245283	GO:0048285	GO:BP	organelle fission	16175	12627		0.5333333333333333	0.5394736842105263	424	15751	14	22	410	15729	16175	0.107210808027607
R1	cpdb	0	network_modules	62	TRUE	3.95460745581329e-10	134	36	10	0.2777777777777778	0.07462686567164178	GO:0007093	GO:BP	mitotic cell cycle checkpoint signaling	16175	2676		0.5466666666666666	0.5526315789473685	134	16041	10	26	124	16015	16175	0.14042266954993154
R1	cpdb	0	network_modules	62	TRUE	2.2285639209777458e-9	159	36	10	0.2777777777777778	0.06289308176100629	GO:1901991	GO:BP	negative regulation of mitotic cell cycle phase transition	16175	21924		0.56	0.5657894736842105	159	16016	10	26	149	15990	16175	0.12827198673141071
R1	cpdb	0	network_modules	62	TRUE	3.5279503396247117e-9	519	36	14	0.3888888888888889	0.02697495183044316	GO:0051640	GO:BP	organelle localization	16175	13853		0.5733333333333334	0.5789473684210527	519	15656	14	22	505	15634	16175	0.09562266255811276
R1	cpdb	0	network_modules	62	TRUE	6.175102466430939e-9	176	36	10	0.2777777777777778	0.056818181818181816	GO:0000075	GO:BP	cell cycle checkpoint signaling	16175	26		0.5866666666666667	0.5921052631578947	176	15999	10	26	166	15973	16175	0.12150602797715805
R1	cpdb	0	network_modules	62	TRUE	1.7675511203087103e-8	24	36	6	0.16666666666666666	0.25	GO:0051315	GO:BP	attachment of mitotic spindle microtubules to kinetochore	16175	13643		0.6	0.6052631578947368	24	16151	6	30	18	16121	16175	0.2026828366790608
R1	cpdb	0	network_modules	62	TRUE	2.43876402826029e-8	202	36	10	0.2777777777777778	0.04950495049504951	GO:0045930	GO:BP	negative regulation of mitotic cell cycle	16175	11724		0.6133333333333333	0.618421052631579	202	15973	10	26	192	15947	16175	0.11282572848927186
R1	cpdb	0	network_modules	62	TRUE	3.050837254672244e-8	286	36	11	0.3055555555555556	0.038461538461538464	GO:1901990	GO:BP	regulation of mitotic cell cycle phase transition	16175	21923		0.6266666666666667	0.631578947368421	286	15889	11	25	275	15864	16175	0.10316402878172683
R1	cpdb	0	network_modules	62	TRUE	6.78929538554077e-8	224	36	10	0.2777777777777778	0.044642857142857144	GO:1901988	GO:BP	negative regulation of cell cycle phase transition	16175	21921		0.64	0.6447368421052632	224	15951	10	26	214	15925	16175	0.10666618916828113
R1	cpdb	0	network_modules	62	TRUE	8.12874208917273e-8	656	36	14	0.3888888888888889	0.021341463414634148	GO:1903047	GO:BP	mitotic cell cycle process	16175	22727		0.6533333333333333	0.6578947368421053	656	15519	14	22	642	15497	16175	0.08340026063129263
R1	cpdb	0	network_modules	62	TRUE	3.1692384688449805e-7	262	36	10	0.2777777777777778	0.03816793893129771	GO:0010948	GO:BP	negative regulation of cell cycle process	16175	4526		0.6666666666666666	0.6710526315789473	262	15913	10	26	252	15887	16175	0.09786671035094757
R1	cpdb	0	network_modules	62	TRUE	4.802414513248951e-7	370	36	11	0.3055555555555556	0.02972972972972973	GO:0044772	GO:BP	mitotic cell cycle phase transition	16175	11148		0.68	0.6842105263157895	370	15805	11	25	359	15780	16175	0.08930080005515961
R1	cpdb	0	network_modules	62	TRUE	5.696347730868021e-7	376	36	11	0.3055555555555556	0.02925531914893617	GO:1901987	GO:BP	regulation of cell cycle phase transition	16175	21920		0.6933333333333334	0.6973684210526315	376	15799	11	25	365	15774	16175	0.08848598107151706
R1	cpdb	0	network_modules	62	TRUE	6.624593995657205e-7	157	17	7	0.4117647058823529	0.044585987261146494	KEGG:04110	KEGG	Cell cycle	8484	264		NA	1	157	8327	7	10	150	8317	8484	0.13075105933829936
R1	cpdb	0	network_modules	62	TRUE	9.72837816246628e-7	792	36	14	0.3888888888888889	0.017676767676767676	GO:0000278	GO:BP	mitotic cell cycle	16175	76		0.7066666666666667	0.7105263157894737	792	15383	14	22	778	15361	16175	0.07439718542979525
R1	cpdb	0	network_modules	62	TRUE	1.3496060159568595e-6	304	36	10	0.2777777777777778	0.03289473684210526	GO:0010639	GO:BP	negative regulation of organelle organization	16175	4285		0.72	0.7236842105263158	304	15871	10	26	294	15845	16175	0.09007206551311292
R1	cpdb	0	network_modules	62	TRUE	1.8065252199697338e-6	22	36	5	0.1388888888888889	0.22727272727272727	GO:0090231	GO:BP	regulation of spindle checkpoint	16175	18126		0.7333333333333333	0.7368421052631579	22	16153	5	31	17	16122	16175	0.17624338920373095
R1	cpdb	0	network_modules	62	TRUE	2.1824974715631326e-6	427	36	11	0.3055555555555556	0.02576112412177986	GO:0007346	GO:BP	regulation of mitotic cell cycle	16175	2855		0.7466666666666667	0.75	427	15748	11	25	416	15723	16175	0.08223918301583404
R1	cpdb	0	network_modules	62	TRUE	3.761235363201945e-6	338	36	10	0.2777777777777778	0.029585798816568046	GO:0045786	GO:BP	negative regulation of cell cycle	16175	11618		0.76	0.7631578947368421	338	15837	10	26	328	15811	16175	0.08481935508461837
R1	cpdb	0	network_modules	62	TRUE	5.333063644585368e-6	465	36	11	0.3055555555555556	0.023655913978494623	GO:0044770	GO:BP	cell cycle phase transition	16175	11146		0.7733333333333333	0.7763157894736842	465	15710	11	25	454	15685	16175	0.07823849602312831
R1	cpdb	0	network_modules	62	TRUE	5.5962380748444086e-6	59	36	6	0.16666666666666666	0.1016949152542373	GO:0007080	GO:BP	mitotic metaphase chromosome alignment	16175	2669		0.7866666666666666	0.7894736842105263	59	16116	6	30	53	16086	16175	0.1277147285243147
R1	cpdb	0	network_modules	62	TRUE	2.5109216033831086e-5	13	36	4	0.1111111111111111	0.3076923076923077	GO:0090232	GO:BP	positive regulation of spindle checkpoint	16175	18127		0.8	0.8026315789473685	13	16162	4	32	9	16130	16175	0.1838411196575415
R1	cpdb	0	network_modules	62	TRUE	4.98705278573693e-5	41	36	5	0.1388888888888889	0.12195121951219512	GO:1901976	GO:BP	regulation of cell cycle checkpoint	16175	21911		0.8133333333333334	0.8157894736842105	41	16134	5	31	36	16103	16175	0.12807445510706664
R1	cpdb	0	network_modules	62	TRUE	6.361134804000323e-5	16	36	4	0.1111111111111111	0.25	GO:0051383	GO:BP	kinetochore organization	16175	13687		0.8266666666666667	0.8289473684210527	16	16159	4	32	12	16127	16175	0.16544887272219416
R1	cpdb	0	network_modules	62	TRUE	1.0661265418420681e-4	18	36	4	0.1111111111111111	0.2222222222222222	GO:1901978	GO:BP	positive regulation of cell cycle checkpoint	16175	21913		0.84	0.8421052631578947	18	16157	4	32	14	16125	16175	0.15582119073258077
R1	cpdb	0	network_modules	62	TRUE	1.2221211799255823e-4	630	36	11	0.3055555555555556	0.01746031746031746	GO:0010564	GO:BP	regulation of cell cycle process	16175	4217		0.8533333333333334	0.8552631578947368	630	15545	11	25	619	15520	16175	0.06508222958814275
R1	cpdb	0	network_modules	62	TRUE	2.0753327428221153e-4	21	36	4	0.1111111111111111	0.19047619047619047	GO:1903504	GO:BP	regulation of mitotic spindle checkpoint	16175	23058		0.8666666666666667	0.881578947368421	21	16154	4	32	17	16122	16175	0.1440325176618291
R1	cpdb	0	network_modules	62	TRUE	2.0753327428221153e-4	21	36	4	0.1111111111111111	0.19047619047619047	GO:0090266	GO:BP	regulation of mitotic cell cycle spindle assembly checkpoint	16175	18155		0.8666666666666667	0.881578947368421	21	16154	4	32	17	16122	16175	0.1440325176618291
R1	cpdb	0	network_modules	62	TRUE	6.437275113794164e-4	583	36	10	0.2777777777777778	0.017152658662092625	GO:0051129	GO:BP	negative regulation of cellular component organization	16175	13513		0.8933333333333333	0.8947368421052632	583	15592	10	26	573	15566	16175	0.06125064652527311
R1	cpdb	0	network_modules	62	TRUE	0.003787970877251623	12	36	3	0.08333333333333333	0.25	GO:0090267	GO:BP	positive regulation of mitotic cell cycle spindle assembly checkpoint	16175	18156		0.9066666666666666	0.9078947368421053	12	16163	3	33	9	16130	16175	0.14326519596376586
R1	cpdb	0	network_modules	62	TRUE	0.005584733688895644	21	27	3	0.1111111111111111	0.14285714285714285	REAC:R-HSA-141430	REAC	Inactivation of APC/C via direct inhibition of the APC/C complex	10916	1176		0.9285714285714286	1	21	10895	3	24	18	10871	10916	0.12407960141264007
R1	cpdb	0	network_modules	62	TRUE	0.005584733688895644	21	27	3	0.1111111111111111	0.14285714285714285	REAC:R-HSA-141405	REAC	Inhibition of the proteolytic activity of APC/C required for the onset of anaphase by mitotic spindle checkpoint components	10916	1199		0.9285714285714286	1	21	10895	3	24	18	10871	10916	0.12407960141264007
R1	cpdb	0	network_modules	62	TRUE	0.00624821086171651	14	36	3	0.08333333333333333	0.21428571428571427	GO:0051382	GO:BP	kinetochore assembly	16175	13686		0.92	0.9210526315789473	14	16161	3	33	11	16128	16175	0.13244742079327596
R1	cpdb	0	network_modules	62	TRUE	0.007798317540910174	15	36	3	0.08333333333333333	0.2	GO:1903083	GO:BP	protein localization to condensed chromosome	16175	22757		0.9333333333333333	0.9473684210526315	15	16160	3	33	12	16127	16175	0.12786439562882096
R1	cpdb	0	network_modules	62	TRUE	0.007798317540910174	15	36	3	0.08333333333333333	0.2	GO:0034501	GO:BP	protein localization to kinetochore	16175	8667		0.9333333333333333	0.9473684210526315	15	16160	3	33	12	16127	16175	0.12786439562882096
R1	cpdb	0	network_modules	62	TRUE	0.008303875390306035	2	36	2	0.05555555555555555	1	GO:0031619	GO:BP	homologous chromosome orientation in meiotic metaphase I	16175	7236		0.96	1	2	16173	2	34	0	16139	16175	0.23545437524377763
R1	cpdb	0	network_modules	62	TRUE	0.008303875390306035	2	36	2	0.05555555555555555	1	GO:1905318	GO:BP	meiosis I spindle assembly checkpoint signaling	16175	24534		0.96	1	2	16173	2	34	0	16139	16175	0.23545437524377763
R1	cpdb	0	network_modules	62	TRUE	0.008303875390306035	2	36	2	0.05555555555555555	1	GO:0110029	GO:BP	negative regulation of meiosis I	16175	19360		0.96	1	2	16173	2	34	0	16139	16175	0.23545437524377763
R1	cpdb	0	network_modules	62	TRUE	0.008303875390306035	2	36	2	0.05555555555555555	1	GO:1905325	GO:BP	regulation of meiosis I spindle assembly checkpoint	16175	24541		0.96	1	2	16173	2	34	0	16139	16175	0.23545437524377763
R1	cpdb	0	network_modules	63	TRUE	7.926640268529954e-4	2	18	2	0.1111111111111111	1	REAC:R-HSA-5652227	REAC	Fructose biosynthesis	10916	981		NA	1	2	10914	2	16	0	10898	10916	0.3330889092246938
R1	cpdb	0	network_modules	63	TRUE	0.0032968362412703106	2	24	2	0.08333333333333333	1	GO:0046370	GO:BP	fructose biosynthetic process	16175	12099		0	1	2	16173	2	22	0	16151	16175	0.28847872656338225
R1	cpdb	0	network_modules	63	TRUE	0.0032968362412703106	2	24	2	0.08333333333333333	1	GO:0070488	GO:BP	neutrophil aggregation	16175	16149		0	1	2	16173	2	22	0	16151	16175	0.28847872656338225
R1	cpdb	0	network_modules	63	TRUE	0.0032968362412703106	2	24	2	0.08333333333333333	1	GO:0032119	GO:BP	sequestering of zinc ion	16175	7374		0	1	2	16173	2	22	0	16151	16175	0.28847872656338225
R1	cpdb	0	network_modules	64	TRUE	3.9991882288500555e-4	44	8	3	0.375	0.06818181818181818	KEGG:03410	KEGG	Base excision repair	8484	237		NA	1	44	8440	3	5	41	8435	8484	0.1581742166846865
R1	cpdb	0	network_modules	64	TRUE	5.542489865897746e-4	2	15	2	0.13333333333333333	1	REAC:R-HSA-73930	REAC	Abasic sugar-phosphate removal via the single-nucleotide replacement pathway	10916	46		0	0.5	2	10914	2	13	0	10901	10916	0.36493083716272035
R1	cpdb	0	network_modules	64	TRUE	0.003320214633681867	4	15	2	0.13333333333333333	0.5	REAC:R-HSA-110381	REAC	Resolution of AP sites via the single-nucleotide replacement pathway	10916	2074		1	1	4	10912	2	13	2	10899	10916	0.25771360850700775
R1	cpdb	0	network_modules	66	TRUE	5.645289528413684e-5	210	15	6	0.4	0.02857142857142857	KEGG:04015	KEGG	Rap1 signaling pathway	8484	248		NA	1	210	8274	6	9	204	8265	8484	0.1016437439461089
R1	cpdb	0	network_modules	66	TRUE	1.0564020782475484e-4	35	19	4	0.21052631578947367	0.11428571428571428	REAC:R-HSA-202433	REAC	Generation of second messenger molecules	10916	1044		0	0.3333333333333333	35	10881	4	15	31	10866	10916	0.1531297778015592
R1	cpdb	0	network_modules	66	TRUE	3.5509381795393745e-4	153	28	6	0.21428571428571427	0.0392156862745098	GO:0008154	GO:BP	actin polymerization or depolymerization	16175	3127		0	0.2	153	16022	6	22	147	16000	16175	0.08811702236681171
R1	cpdb	0	network_modules	66	TRUE	0.0012257414981339295	632	28	9	0.32142857142857145	0.014240506329113924	GO:0030036	GO:BP	actin cytoskeleton organization	16175	6660		0.25	0.4	632	15543	9	19	623	15524	16175	0.060680385408461567
R1	cpdb	0	network_modules	66	TRUE	0.0013247408446841475	42	28	4	0.14285714285714285	0.09523809523809523	GO:0030838	GO:BP	positive regulation of actin filament polymerization	16175	6923		0.5	0.6	42	16133	4	24	38	16109	16175	0.11477060914533443
R1	cpdb	0	network_modules	66	TRUE	0.0031545067260000453	708	28	9	0.32142857142857145	0.012711864406779662	GO:0030029	GO:BP	actin filament-based process	16175	6653		0.75	0.8	708	15467	9	19	699	15448	16175	0.05651540412109361
R1	cpdb	0	network_modules	66	TRUE	0.005473410724453834	4	19	2	0.10526315789473684	0.5	REAC:R-HSA-8866906	REAC	TFAP2 (AP-2) family regulates transcription of other transcription factors	10916	2426		0.5	0.6666666666666666	4	10912	2	17	2	10895	10916	0.22885826432368842
R1	cpdb	0	network_modules	66	TRUE	0.009112879521845849	5	19	2	0.10526315789473684	0.4	REAC:R-HSA-8866911	REAC	TFAP2 (AP-2) family regulates transcription of cell cycle factors	10916	2424		1	1	5	10911	2	17	3	10894	10916	0.2045276598933455
R1	cpdb	0	network_modules	66	TRUE	0.009151805391389774	150	28	5	0.17857142857142858	0.03333333333333333	GO:1902905	GO:BP	positive regulation of supramolecular fiber organization	16175	22604		1	1	150	16025	5	23	145	16002	16175	0.07355025753181645
R1	cpdb	0	network_modules	67	TRUE	2.418798763803228e-5	19	25	4	0.16	0.21052631578947367	GO:0006098	GO:BP	pentose-phosphate shunt	16175	1958		0	0.125	19	16156	4	21	15	16135	16175	0.18243330355913667
R1	cpdb	0	network_modules	67	TRUE	4.5506754176941995e-5	22	25	4	0.16	0.18181818181818182	GO:0006740	GO:BP	NADPH regeneration	16175	2439		0.14285714285714285	0.25	22	16153	4	21	18	16132	16175	0.1693567286406019
R1	cpdb	0	network_modules	67	TRUE	5.171248014634429e-5	74	21	5	0.23809523809523808	0.06756756756756757	KEGG:01230	KEGG	Biosynthesis of amino acids	8484	188		0	0.3333333333333333	74	8410	5	16	69	8394	8484	0.12287865671633551
R1	cpdb	0	network_modules	67	TRUE	5.3793301826130676e-5	31	21	4	0.19047619047619047	0.12903225806451613	KEGG:00030	KEGG	Pentose phosphate pathway	8484	4		0.5	0.6666666666666666	31	8453	4	17	27	8436	8484	0.15423767218906545
R1	cpdb	0	network_modules	67	TRUE	9.290279180855125e-5	6	25	3	0.12	0.5	GO:0009052	GO:BP	pentose-phosphate shunt, non-oxidative branch	16175	3231		0.2857142857142857	0.375	6	16169	3	22	3	16147	16175	0.2444260585285185
R1	cpdb	0	network_modules	67	TRUE	1.1556525929689107e-4	558	25	9	0.36	0.016129032258064516	GO:0055086	GO:BP	nucleobase-containing small molecule metabolic process	16175	14237		0.42857142857142855	0.5	558	15617	9	16	549	15601	16175	0.07017238087060834
R1	cpdb	0	network_modules	67	TRUE	1.2658331460761645e-4	28	25	4	0.16	0.14285714285714285	GO:0051156	GO:BP	glucose 6-phosphate metabolic process	16175	13539		0.5714285714285714	0.625	28	16147	4	21	24	16126	16175	0.14979550036812672
R1	cpdb	0	network_modules	67	TRUE	2.595973150559093e-4	8	25	3	0.12	0.375	GO:0019682	GO:BP	glyceraldehyde-3-phosphate metabolic process	16175	6000		0.7142857142857143	0.75	8	16167	3	22	5	16145	16175	0.2114734655362776
R1	cpdb	0	network_modules	67	TRUE	4.61757313058842e-4	115	21	5	0.23809523809523808	0.043478260869565216	KEGG:01200	KEGG	Carbon metabolism	8484	184		1	1	115	8369	5	16	110	8353	8484	0.09672901221541243
R1	cpdb	0	network_modules	67	TRUE	5.027209148184389e-4	39	25	4	0.16	0.10256410256410256	GO:0006739	GO:BP	NADP metabolic process	16175	2438		0.8571428571428571	0.875	39	16136	4	21	35	16115	16175	0.12642219612928213
R1	cpdb	0	network_modules	67	TRUE	8.705733528521941e-4	15	21	3	0.14285714285714285	0.2	REAC:R-HSA-71336	REAC	Pentose phosphate pathway	10916	1721		NA	1	15	10901	3	18	12	10883	10916	0.1676814643799777
R1	cpdb	0	network_modules	67	TRUE	0.00719083753928257	469	25	7	0.28	0.014925373134328358	GO:0072521	GO:BP	purine-containing compound metabolic process	16175	17423		1	1	469	15706	7	18	462	15688	16175	0.058855974742900684
R1	cpdb	0	network_modules	68	TRUE	1.0713031092392468e-6	169	17	7	0.4117647058823529	0.04142011834319527	REAC:R-HSA-983231	REAC	Factors involved in megakaryocyte development and platelet production	10916	931		0	0.3333333333333333	169	10747	7	10	162	10737	10916	0.12676896840033494
R1	cpdb	0	network_modules	68	TRUE	7.646952407606995e-5	192	17	6	0.35294117647058826	0.03125	KEGG:05202	KEGG	Transcriptional misregulation in cancer	8484	454		NA	1	192	8292	6	11	186	8281	8484	0.09951814016965825
R1	cpdb	0	network_modules	68	TRUE	0.00288749753486914	88	17	4	0.23529411764705882	0.045454545454545456	REAC:R-HSA-9616222	REAC	Transcriptional regulation of granulopoiesis	10916	2559		0.5	0.6666666666666666	88	10828	4	13	84	10815	10916	0.10035748209352402
R1	cpdb	0	network_modules	68	TRUE	0.0037544808606781903	94	17	4	0.23529411764705882	0.0425531914893617	REAC:R-HSA-3214815	REAC	HDACs deacetylate histones	10916	1092		1	1	94	10822	4	13	90	10809	10916	0.0968937443196543
R1	cpdb	0	network_modules	69	TRUE	1.8224485712032522e-7	124	18	7	0.3888888888888889	0.056451612903225805	REAC:R-HSA-381426	REAC	Regulation of Insulin-like Growth Factor (IGF) transport and uptake by Insulin-like Growth Factor Binding Proteins (IGFBPs)	10916	1981		0	0.1	124	10792	7	11	117	10781	10916	0.14478226407211248
R1	cpdb	0	network_modules	69	TRUE	7.84168117201655e-7	12	18	4	0.2222222222222222	0.3333333333333333	REAC:R-HSA-209822	REAC	Glycoprotein hormones	10916	1075		0.1111111111111111	0.2	12	10904	4	14	8	10890	10916	0.27119182331547365
R1	cpdb	0	network_modules	69	TRUE	1.582507707079242e-6	14	18	4	0.2222222222222222	0.2857142857142857	REAC:R-HSA-209952	REAC	Peptide hormone biosynthesis	10916	1724		0.2222222222222222	0.3	14	10902	4	14	10	10888	10916	0.2508898161847943
R1	cpdb	0	network_modules	69	TRUE	1.58687407514039e-6	107	16	6	0.375	0.056074766355140186	KEGG:04350	KEGG	TGF-beta signaling pathway	8484	304		0	0.2	107	8377	6	10	101	8367	8484	0.14115878691192082
R1	cpdb	0	network_modules	69	TRUE	2.3773595789946704e-6	3	20	3	0.15	1	GO:0046880	GO:BP	regulation of follicle-stimulating hormone secretion	16175	12415		0	0.2222222222222222	3	16172	3	17	0	16155	16175	0.38709471716798444
R1	cpdb	0	network_modules	69	TRUE	2.3773595789946704e-6	3	20	3	0.15	1	GO:0046882	GO:BP	negative regulation of follicle-stimulating hormone secretion	16175	12417		0	0.2222222222222222	3	16172	3	17	0	16155	16175	0.38709471716798444
R1	cpdb	0	network_modules	69	TRUE	2.3773595789946704e-6	3	20	3	0.15	1	GO:0046881	GO:BP	positive regulation of follicle-stimulating hormone secretion	16175	12416		0	0.2222222222222222	3	16172	3	17	0	16155	16175	0.38709471716798444
R1	cpdb	0	network_modules	69	TRUE	2.3773595789946704e-6	3	20	3	0.15	1	GO:0032278	GO:BP	positive regulation of gonadotropin secretion	16175	7459		0	0.2222222222222222	3	16172	3	17	0	16155	16175	0.38709471716798444
R1	cpdb	0	network_modules	69	TRUE	3.751027631181343e-6	17	18	4	0.2222222222222222	0.23529411764705882	REAC:R-HSA-1502540	REAC	Signaling by Activin	10916	2223		0.3333333333333333	0.4	17	10899	4	14	13	10885	10916	0.2274268832846812
R1	cpdb	0	network_modules	69	TRUE	9.038340156363431e-6	143	16	6	0.375	0.04195804195804196	KEGG:04550	KEGG	Signaling pathways regulating pluripotency of stem cells	8484	319		0.25	0.4	143	8341	6	10	137	8331	8484	0.12093492177001457
R1	cpdb	0	network_modules	69	TRUE	9.501941077632904e-6	4	20	3	0.15	0.75	GO:0046884	GO:BP	follicle-stimulating hormone secretion	16175	12419		0.23529411764705882	0.2777777777777778	4	16171	3	17	1	16154	16175	0.3351058789798762
R1	cpdb	0	network_modules	69	TRUE	1.1955581863862317e-5	20	20	4	0.2	0.2	GO:0043567	GO:BP	regulation of insulin-like growth factor receptor signaling pathway	16175	10772		0.29411764705882354	0.3333333333333333	20	16155	4	16	16	16139	16175	0.19900959455277004
R1	cpdb	0	network_modules	69	TRUE	1.2699155364867056e-5	790	20	10	0.5	0.012658227848101266	GO:0007167	GO:BP	enzyme-linked receptor protein signaling pathway	16175	2731		0.35294117647058826	0.3888888888888889	790	15385	10	10	780	15375	16175	0.07365009720634341
R1	cpdb	0	network_modules	69	TRUE	2.373612443413537e-5	5	20	3	0.15	0.6	GO:0032277	GO:BP	negative regulation of gonadotropin secretion	16175	7458		0.4117647058823529	0.5	5	16170	3	17	2	16153	16175	0.2996133346554642
R1	cpdb	0	network_modules	69	TRUE	2.373612443413537e-5	5	20	3	0.15	0.6	GO:0032276	GO:BP	regulation of gonadotropin secretion	16175	7457		0.4117647058823529	0.5	5	16170	3	17	2	16153	16175	0.2996133346554642
R1	cpdb	0	network_modules	69	TRUE	4.888247341492835e-5	31	18	4	0.2222222222222222	0.12903225806451613	REAC:R-HSA-201451	REAC	Signaling by BMP	10916	2224		0.4444444444444444	0.5	31	10885	4	14	27	10871	10916	0.16754559210936695
R1	cpdb	0	network_modules	69	TRUE	6.474012089189847e-5	8	18	3	0.16666666666666666	0.375	REAC:R-HSA-8939242	REAC	RUNX1 regulates transcription of genes involved in differentiation of keratinocytes	10916	1923		0.5555555555555556	0.6	8	10908	3	15	5	10893	10916	0.2491974947902711
R1	cpdb	0	network_modules	69	TRUE	6.709133987647596e-5	30	20	4	0.2	0.13333333333333333	GO:0048009	GO:BP	insulin-like growth factor receptor signaling pathway	16175	12465		0.5294117647058824	0.5555555555555556	30	16145	4	16	26	16129	16175	0.16203539735527922
R1	cpdb	0	network_modules	69	TRUE	7.391493483585682e-5	88	18	5	0.2777777777777778	0.056818181818181816	REAC:R-HSA-2980736	REAC	Peptide hormone metabolism	10916	1725		0.6666666666666666	0.7	88	10828	5	13	83	10815	10916	0.12257953723523478
R1	cpdb	0	network_modules	69	TRUE	1.326081599088824e-4	8	20	3	0.15	0.375	GO:0032274	GO:BP	gonadotropin secretion	16175	7455		0.5882352941176471	0.6111111111111112	8	16167	3	17	5	16150	16175	0.23659360431701468
R1	cpdb	0	network_modules	69	TRUE	3.2893626725219796e-4	13	18	3	0.16666666666666666	0.23076923076923078	REAC:R-HSA-1679131	REAC	Trafficking and processing of endosomal TLR	10916	2531		0.7777777777777778	0.8	13	10903	3	15	10	10888	10916	0.1949916727240632
R1	cpdb	0	network_modules	69	TRUE	3.7804888981575127e-4	122	18	5	0.2777777777777778	0.040983606557377046	REAC:R-HSA-9006936	REAC	Signaling by TGFB family members	10916	2310		0.8888888888888888	0.9	122	10794	5	13	117	10781	10916	0.1030665837632039
R1	cpdb	0	network_modules	69	TRUE	5.8197282662664e-4	291	16	6	0.375	0.020618556701030927	KEGG:04060	KEGG	Cytokine-cytokine receptor interaction	8484	253		0.5	0.6	291	8193	6	10	285	8183	8484	0.08137192093500145
R1	cpdb	0	network_modules	69	TRUE	0.002136057581726714	2	20	2	0.1	1	GO:0060279	GO:BP	positive regulation of ovulation	16175	14495		0.6470588235294118	0.7222222222222222	2	16173	2	18	0	16155	16175	0.316051741641375
R1	cpdb	0	network_modules	69	TRUE	0.002136057581726714	2	20	2	0.1	1	GO:0060278	GO:BP	regulation of ovulation	16175	14494		0.6470588235294118	0.7222222222222222	2	16173	2	18	0	16155	16175	0.316051741641375
R1	cpdb	0	network_modules	69	TRUE	0.0026740949295893583	20	20	3	0.15	0.15	GO:0042104	GO:BP	positive regulation of activated T cell proliferation	16175	9969		0.7647058823529411	0.7777777777777778	20	16155	3	17	17	16138	16175	0.14894769421231815
R1	cpdb	0	network_modules	69	TRUE	0.004144412674470078	23	20	3	0.15	0.13043478260869565	GO:0044060	GO:BP	regulation of endocrine process	16175	10895		0.8235294117647058	0.8888888888888888	23	16152	3	17	20	16135	16175	0.13873415606930908
R1	cpdb	0	network_modules	69	TRUE	0.004144412674470078	23	20	3	0.15	0.13043478260869565	GO:0001541	GO:BP	ovarian follicle development	16175	332		0.8235294117647058	0.8888888888888888	23	16152	3	17	20	16135	16175	0.13873415606930908
R1	cpdb	0	network_modules	69	TRUE	0.004746692544996373	4	18	2	0.1111111111111111	0.5	REAC:R-HSA-2473224	REAC	Antagonism of Activin by Follistatin	10916	149		1	1	4	10912	2	16	2	10896	10916	0.23516195519816133
R1	cpdb	0	network_modules	69	TRUE	0.005374937441689823	131	16	4	0.25	0.030534351145038167	KEGG:04142	KEGG	Lysosome	8484	279		0.75	0.8	131	8353	4	12	127	8341	8484	0.08269243004513013
R1	cpdb	0	network_modules	69	TRUE	0.005964926348183441	90	20	4	0.2	0.044444444444444446	GO:2001235	GO:BP	positive regulation of apoptotic signaling pathway	16175	26424		0.9411764705882353	0.9444444444444444	90	16085	4	16	86	16069	16175	0.09197088786869284
R1	cpdb	0	network_modules	69	TRUE	0.006042864359410408	135	16	4	0.25	0.02962962962962963	KEGG:04210	KEGG	Apoptosis	8484	287		1	1	135	8349	4	12	131	8337	8484	0.0813138821608762
R1	cpdb	0	network_modules	69	TRUE	0.0094487187219463	30	20	3	0.15	0.1	GO:0060986	GO:BP	endocrine hormone secretion	16175	15113		1	1	30	16145	3	17	27	16128	16175	0.12114737001952819
R1	cpdb	0	network_modules	70	TRUE	2.520880465826822e-10	12	13	5	0.38461538461538464	0.4166666666666667	REAC:R-HSA-4641265	REAC	Repression of WNT target genes	10916	2063		0	0.09090909090909091	12	10904	5	8	7	10896	10916	0.39963381720782476
R1	cpdb	0	network_modules	70	TRUE	2.6583587761169604e-7	42	13	5	0.38461538461538464	0.11904761904761904	REAC:R-HSA-3769402	REAC	Deactivation of the beta-catenin transactivating complex	10916	452		0.1	0.18181818181818182	42	10874	5	8	37	10866	10916	0.21237487033531866
R1	cpdb	0	network_modules	70	TRUE	8.848006207588172e-6	83	13	5	0.38461538461538464	0.060240963855421686	REAC:R-HSA-195253	REAC	Degradation of beta-catenin by the destruction complex	10916	724		0.2	0.2727272727272727	83	10833	5	8	78	10825	10916	0.14986623593758525
R1	cpdb	0	network_modules	70	TRUE	9.567839740564562e-6	327	13	7	0.5384615384615384	0.021406727828746176	REAC:R-HSA-195721	REAC	Signaling by WNT	10916	2314		0.3	0.36363636363636365	327	10589	7	6	320	10583	10916	0.10300457399560199
R1	cpdb	0	network_modules	70	TRUE	1.0319557309477812e-5	174	14	6	0.42857142857142855	0.034482758620689655	KEGG:04310	KEGG	Wnt signaling pathway	8484	299		0	0.1111111111111111	174	8310	6	8	168	8302	8484	0.117050760620754
R1	cpdb	0	network_modules	70	TRUE	1.3335736169261945e-5	90	13	5	0.38461538461538464	0.05555555555555555	REAC:R-HSA-201722	REAC	Formation of the beta-catenin:TCF transactivating complex	10916	968		0.4	0.45454545454545453	90	10826	5	8	85	10818	10916	0.14372179401666071
R1	cpdb	0	network_modules	70	TRUE	1.520654477389479e-5	4	23	3	0.13043478260869565	0.75	GO:0045586	GO:BP	regulation of gamma-delta T cell differentiation	16175	11437		0	0.14285714285714285	4	16171	3	20	1	16151	16175	0.31243945056984906
R1	cpdb	0	network_modules	70	TRUE	1.8742239302501017e-5	97	14	5	0.35714285714285715	0.05154639175257732	KEGG:05215	KEGG	Prostate cancer	8484	466		0.125	0.2222222222222222	97	8387	5	9	92	8378	8484	0.13220418006915488
R1	cpdb	0	network_modules	70	TRUE	2.3604051444141078e-5	8	13	3	0.23076923076923078	0.375	REAC:R-HSA-4411364	REAC	Binding of TCF/LEF:CTNNB1 to target gene promoters	10916	225		0.5	0.6363636363636364	8	10908	3	10	5	10898	10916	0.29352231826464087
R1	cpdb	0	network_modules	70	TRUE	2.3604051444141078e-5	8	13	3	0.23076923076923078	0.375	REAC:R-HSA-8951430	REAC	RUNX3 regulates WNT signaling	10916	1936		0.5	0.6363636363636364	8	10908	3	10	5	10898	10916	0.29352231826464087
R1	cpdb	0	network_modules	70	TRUE	3.7981101092723623e-5	5	23	3	0.13043478260869565	0.6	GO:0046643	GO:BP	regulation of gamma-delta T cell activation	16175	12280		0.16666666666666666	0.2857142857142857	5	16170	3	20	2	16150	16175	0.2793302689624588
R1	cpdb	0	network_modules	70	TRUE	4.089323956685179e-5	231	13	6	0.46153846153846156	0.025974025974025976	REAC:R-HSA-201681	REAC	TCF dependent signaling in response to WNT	10916	2421		0.7	0.7272727272727273	231	10685	6	7	225	10678	10916	0.1056558232346147
R1	cpdb	0	network_modules	70	TRUE	7.58917467893925e-5	6	23	3	0.13043478260869565	0.5	GO:0042492	GO:BP	gamma-delta T cell differentiation	16175	10221		0.3333333333333333	0.42857142857142855	6	16169	3	20	3	16149	16175	0.2548792144510706
R1	cpdb	0	network_modules	70	TRUE	1.3268737583468042e-4	7	23	3	0.13043478260869565	0.42857142857142855	GO:0003357	GO:BP	noradrenergic neuron differentiation	16175	1777		0.5	0.5714285714285714	7	16168	3	20	4	16148	16175	0.23586742795786067
R1	cpdb	0	network_modules	70	TRUE	7.182380637721543e-4	93	14	4	0.2857142857142857	0.043010752688172046	KEGG:04520	KEGG	Adherens junction	8484	316		0.25	0.3333333333333333	93	8391	4	10	89	8381	8484	0.107279379120662
R1	cpdb	0	network_modules	70	TRUE	9.967801480072896e-4	101	14	4	0.2857142857142857	0.039603960396039604	KEGG:04916	KEGG	Melanogenesis	8484	373		0.375	0.4444444444444444	101	8383	4	10	97	8373	8484	0.10263869049543425
R1	cpdb	0	network_modules	70	TRUE	0.0011617579827982417	95	13	4	0.3076923076923077	0.042105263157894736	REAC:R-HSA-8878159	REAC	Transcriptional regulation by RUNX3	10916	2554		0.8	0.8181818181818182	95	10821	4	9	91	10812	10916	0.11115336446032696
R1	cpdb	0	network_modules	70	TRUE	0.001258091079065584	3	13	2	0.15384615384615385	0.6666666666666666	REAC:R-HSA-5339700	REAC	Signaling by TCF7L2 mutants	10916	2307		0.9	0.9090909090909091	3	10913	2	11	1	10902	10916	0.3199187039314686
R1	cpdb	0	network_modules	70	TRUE	0.001371014783691421	14	23	3	0.13043478260869565	0.21428571428571427	GO:0046629	GO:BP	gamma-delta T cell activation	16175	12266		0.6666666666666666	0.7142857142857143	14	16161	3	20	11	16141	16175	0.16626424487184172
R1	cpdb	0	network_modules	70	TRUE	0.0015509523018571762	37	14	3	0.21428571428571427	0.08108108108108109	KEGG:05216	KEGG	Thyroid cancer	8484	467		0.5	0.5555555555555556	37	8447	3	11	34	8436	8484	0.12951919098189807
R1	cpdb	0	network_modules	70	TRUE	0.0024046107838899735	114	13	4	0.3076923076923077	0.03508771929824561	REAC:R-HSA-9758941	REAC	Gastrulation	10916	1040		1	1	114	10802	4	9	110	10793	10916	0.10096665606567103
R1	cpdb	0	network_modules	70	TRUE	0.0036328697091528943	19	23	3	0.13043478260869565	0.15789473684210525	GO:0060563	GO:BP	neuroepithelial cell differentiation	16175	14747		0.8333333333333334	0.8571428571428571	19	16156	3	20	16	16136	16175	0.14240194503174
R1	cpdb	0	network_modules	70	TRUE	0.006034338897131623	58	14	3	0.21428571428571427	0.05172413793103448	KEGG:05213	KEGG	Endometrial cancer	8484	464		0.625	0.6666666666666666	58	8426	3	11	55	8415	8484	0.10235528132961785
R1	cpdb	0	network_modules	70	TRUE	0.0066791837044600155	60	14	3	0.21428571428571427	0.05	KEGG:04330	KEGG	Notch signaling pathway	8484	301		0.75	0.7777777777777778	60	8424	3	11	57	8413	8484	0.10053247606192928
R1	cpdb	0	network_modules	70	TRUE	0.007728302029765521	63	14	3	0.21428571428571427	0.047619047619047616	KEGG:05217	KEGG	Basal cell carcinoma	8484	468		0.875	0.8888888888888888	63	8421	3	11	60	8410	8484	0.09795967262527557
R1	cpdb	0	network_modules	70	TRUE	0.008783952978863854	3	23	2	0.08695652173913043	0.6666666666666666	GO:0045588	GO:BP	positive regulation of gamma-delta T cell differentiation	16175	11439		1	1	3	16172	2	21	1	16151	16175	0.24045145819458102
R1	cpdb	0	network_modules	70	TRUE	0.009286679312582806	67	14	3	0.21428571428571427	0.04477611940298507	KEGG:05221	KEGG	Acute myeloid leukemia	8484	472		1	1	67	8417	3	11	64	8406	8484	0.09479651983172357
R1	cpdb	0	network_modules	71	TRUE	1.725686551978204e-10	17	23	6	0.2608695652173913	0.35294117647058826	REAC:R-HSA-9617828	REAC	FOXO-mediated transcription of cell cycle genes	10916	924		0	0.07142857142857142	17	10899	6	17	11	10882	10916	0.30217524745751934
R1	cpdb	0	network_modules	71	TRUE	1.7299823071918324e-10	66	23	8	0.34782608695652173	0.12121212121212122	REAC:R-HSA-9614085	REAC	FOXO-mediated transcription	10916	923		0.07692307692307693	0.14285714285714285	66	10850	8	15	58	10835	10916	0.2025878499288305
R1	cpdb	0	network_modules	71	TRUE	8.13675400665911e-9	30	23	6	0.2608695652173913	0.2	REAC:R-HSA-9615017	REAC	FOXO-mediated transcription of oxidative stress, metabolic and neuronal genes	10916	926		0.15384615384615385	0.21428571428571427	30	10886	6	17	24	10869	10916	0.2265597486973775
R1	cpdb	0	network_modules	71	TRUE	6.761942374554202e-8	131	23	8	0.34782608695652173	0.061068702290076333	KEGG:04068	KEGG	FoxO signaling pathway	8484	258		0	0.5	131	8353	8	15	123	8338	8484	0.1405525063301424
R1	cpdb	0	network_modules	71	TRUE	1.025882725756924e-6	10	23	4	0.17391304347826086	0.4	REAC:R-HSA-198693	REAC	AKT phosphorylates targets in the nucleus	10916	15		0.23076923076923078	0.2857142857142857	10	10906	4	19	6	10887	10916	0.2627600951804227
R1	cpdb	0	network_modules	71	TRUE	1.4012755067999842e-6	192	23	8	0.34782608695652173	0.041666666666666664	KEGG:05202	KEGG	Transcriptional misregulation in cancer	8484	454		1	1	192	8292	8	15	184	8277	8484	0.11400336381212911
R1	cpdb	0	network_modules	71	TRUE	2.4114192501951717e-6	12	23	4	0.17391304347826086	0.3333333333333333	REAC:R-HSA-9614399	REAC	Regulation of localization of FOXO transcription factors	10916	2042		0.3076923076923077	0.35714285714285715	12	10904	4	19	8	10885	10916	0.2396339890267564
R1	cpdb	0	network_modules	71	TRUE	8.816921745393555e-6	16	23	4	0.17391304347826086	0.25	REAC:R-HSA-9614657	REAC	FOXO-mediated transcription of cell death genes	10916	925		0.38461538461538464	0.42857142857142855	16	10900	4	19	12	10881	10916	0.20712707146160486
R1	cpdb	0	network_modules	71	TRUE	2.149573836724444e-5	44	29	5	0.1724137931034483	0.11363636363636363	GO:0140467	GO:BP	integrated stress response signaling	16175	19788		0	0.3333333333333333	44	16131	5	24	39	16107	16175	0.1380763044649795
R1	cpdb	0	network_modules	71	TRUE	2.6805895441094708e-5	5	23	3	0.13043478260869565	0.6	REAC:R-HSA-8952158	REAC	RUNX3 regulates BCL2L11 (BIM) transcription	10916	1932		0.46153846153846156	0.5	5	10911	3	20	2	10891	10916	0.27912713058744004
R1	cpdb	0	network_modules	71	TRUE	7.142187012693155e-5	26	23	4	0.17391304347826086	0.15384615384615385	REAC:R-HSA-5674400	REAC	Constitutive Signaling by AKT1 E17K in Cancer	10916	400		0.5384615384615384	0.5714285714285714	26	10890	4	19	22	10871	10916	0.16169487404338867
R1	cpdb	0	network_modules	71	TRUE	3.194662832627674e-4	10	23	3	0.13043478260869565	0.3	REAC:R-HSA-9617629	REAC	Regulation of FOXO transcriptional activity by acetylation	10916	1973		0.6153846153846154	0.6428571428571429	10	10906	3	20	7	10886	10916	0.19672221704372114
R1	cpdb	0	network_modules	71	TRUE	0.001434856792041729	42	29	4	0.13793103448275862	0.09523809523809523	GO:0043502	GO:BP	regulation of muscle adaptation	16175	10740		0.5	0.6666666666666666	42	16133	4	25	38	16108	16175	0.11270337345688733
R1	cpdb	0	network_modules	71	TRUE	0.004185559011958507	3	23	2	0.08695652173913043	0.6666666666666666	REAC:R-HSA-3315487	REAC	SMAD2/3 MH2 Domain Mutants in Cancer	10916	2152		0.6923076923076923	0.8571428571428571	3	10913	2	21	1	10892	10916	0.24029702124942165
R1	cpdb	0	network_modules	71	TRUE	0.004185559011958507	3	23	2	0.08695652173913043	0.6666666666666666	REAC:R-HSA-3304347	REAC	Loss of Function of SMAD4 in Cancer	10916	1324		0.6923076923076923	0.8571428571428571	3	10913	2	21	1	10892	10916	0.24029702124942165
R1	cpdb	0	network_modules	71	TRUE	0.004185559011958507	3	23	2	0.08695652173913043	0.6666666666666666	REAC:R-HSA-3311021	REAC	SMAD4 MH2 Domain Mutants in Cancer	10916	2155		0.6923076923076923	0.8571428571428571	3	10913	2	21	1	10892	10916	0.24029702124942165
R1	cpdb	0	network_modules	71	TRUE	0.004302289848425808	55	29	4	0.13793103448275862	0.07272727272727272	GO:0043500	GO:BP	muscle adaptation	16175	10738		1	1	55	16120	4	25	51	16095	16175	0.09794187966130652
R1	cpdb	0	network_modules	71	TRUE	0.0046312547772817065	23	23	3	0.13043478260869565	0.13043478260869565	REAC:R-HSA-1181150	REAC	Signaling by NODAL	10916	2273		0.9230769230769231	0.9285714285714286	23	10893	3	20	20	10873	10916	0.12859874111415787
R1	cpdb	0	network_modules	71	TRUE	0.009476895262138284	29	23	3	0.13043478260869565	0.10344827586206896	REAC:R-HSA-2173795	REAC	Downregulation of SMAD2/3:SMAD4 transcriptional activity	10916	787		1	1	29	10887	3	20	26	10867	10916	0.1140662376418621
R1	cpdb	0	network_modules	72	TRUE	5.049825515586983e-14	519	24	15	0.625	0.028901734104046242	GO:0070848	GO:BP	response to growth factor	16175	16340		0	0.02564102564102564	519	15656	15	9	504	15647	16175	0.12969326277088397
R1	cpdb	0	network_modules	72	TRUE	7.339220909385717e-14	107	17	10	0.5882352941176471	0.09345794392523364	KEGG:04350	KEGG	TGF-beta signaling pathway	8484	304		0	0.25	107	8377	10	7	97	8370	8484	0.23113332826388516
R1	cpdb	0	network_modules	72	TRUE	1.483454047803962e-12	502	24	14	0.5833333333333334	0.027888446215139442	GO:0071363	GO:BP	cellular response to growth factor stimulus	16175	16615		0.02631578947368421	0.05128205128205128	502	15673	14	10	488	15663	16175	0.12277093898743756
R1	cpdb	0	network_modules	72	TRUE	2.1045692338933998e-12	122	21	10	0.47619047619047616	0.08196721311475409	REAC:R-HSA-9006936	REAC	Signaling by TGFB family members	10916	2310		0	0.25	122	10794	10	11	112	10783	10916	0.19420243439570922
R1	cpdb	0	network_modules	72	TRUE	2.5751677021886795e-11	31	21	7	0.3333333333333333	0.22580645161290322	REAC:R-HSA-201451	REAC	Signaling by BMP	10916	2224		0.3333333333333333	0.5	31	10885	7	14	24	10871	10916	0.27266372918177395
R1	cpdb	0	network_modules	72	TRUE	9.011833624140398e-11	275	24	11	0.4583333333333333	0.04	GO:0141091	GO:BP	transforming growth factor beta receptor superfamily signaling pathway	16175	20020		0.05263157894736842	0.07692307692307693	275	15900	11	13	264	15887	16175	0.1315983675534827
R1	cpdb	0	network_modules	72	TRUE	1.6153474088592657e-10	290	24	11	0.4583333333333333	0.03793103448275862	GO:0007178	GO:BP	cell surface receptor protein serine/threonine kinase signaling pathway	16175	2740		0.07894736842105263	0.10256410256410256	290	15885	11	13	279	15872	16175	0.12794086206231686
R1	cpdb	0	network_modules	72	TRUE	6.1359136207028344e-9	117	24	8	0.3333333333333333	0.06837606837606838	GO:0030509	GO:BP	BMP signaling pathway	16175	6825		0.10526315789473684	0.1282051282051282	117	16058	8	16	109	16042	16175	0.1483413660918434
R1	cpdb	0	network_modules	72	TRUE	9.217649256366282e-9	123	24	8	0.3333333333333333	0.06504065040650407	GO:0071773	GO:BP	cellular response to BMP stimulus	16175	16902		0.13157894736842105	0.1794871794871795	123	16052	8	16	115	16036	16175	0.14454048376162235
R1	cpdb	0	network_modules	72	TRUE	9.217649256366282e-9	123	24	8	0.3333333333333333	0.06504065040650407	GO:0071772	GO:BP	response to BMP	16175	16901		0.13157894736842105	0.1794871794871795	123	16052	8	16	115	16036	16175	0.14454048376162235
R1	cpdb	0	network_modules	72	TRUE	1.3977981278285404e-8	208	24	9	0.375	0.04326923076923077	GO:0071559	GO:BP	response to transforming growth factor beta	16175	16761		0.18421052631578946	0.20512820512820512	208	15967	9	15	199	15952	16175	0.12390366342995154
R1	cpdb	0	network_modules	72	TRUE	6.795031572330045e-8	291	17	9	0.5294117647058824	0.030927835051546393	KEGG:04060	KEGG	Cytokine-cytokine receptor interaction	8484	253		0.3333333333333333	0.5	291	8193	9	8	282	8185	8484	0.12189776386169733
R1	cpdb	0	network_modules	72	TRUE	8.24498683462835e-8	93	24	7	0.2916666666666667	0.07526881720430108	GO:0051216	GO:BP	cartilage development	16175	13573		0.21052631578947367	0.23076923076923078	93	16082	7	17	86	16065	16175	0.14577355912224807
R1	cpdb	0	network_modules	72	TRUE	3.449178017144247e-7	143	17	7	0.4117647058823529	0.04895104895104895	KEGG:04550	KEGG	Signaling pathways regulating pluripotency of stem cells	8484	319		0.6666666666666666	0.75	143	8341	7	10	136	8331	8484	0.137461407508005
R1	cpdb	0	network_modules	72	TRUE	3.6248914317564115e-7	59	24	6	0.25	0.1016949152542373	GO:0002062	GO:BP	chondrocyte differentiation	16175	653		0.23684210526315788	0.2564102564102564	59	16116	6	18	53	16098	16175	0.15752604031419593
R1	cpdb	0	network_modules	72	TRUE	4.986143484839469e-7	202	24	8	0.3333333333333333	0.039603960396039604	GO:0071560	GO:BP	cellular response to transforming growth factor beta stimulus	16175	16762		0.2631578947368421	0.28205128205128205	202	15973	8	16	194	15957	16175	0.11137210948558825
R1	cpdb	0	network_modules	72	TRUE	5.461373729609663e-7	615	24	11	0.4583333333333333	0.01788617886178862	GO:0045597	GO:BP	positive regulation of cell differentiation	16175	11448		0.2894736842105263	0.3076923076923077	615	15560	11	13	604	15547	16175	0.08471870755154082
R1	cpdb	0	network_modules	72	TRUE	8.414012269299446e-7	129	24	7	0.2916666666666667	0.05426356589147287	GO:0061448	GO:BP	connective tissue development	16175	15483		0.3157894736842105	0.3333333333333333	129	16046	7	17	122	16029	16175	0.12294705127987891
R1	cpdb	0	network_modules	72	TRUE	2.3694498099424634e-6	80	24	6	0.25	0.075	GO:0090100	GO:BP	positive regulation of transmembrane receptor protein serine/threonine kinase signaling pathway	16175	18018		0.34210526315789475	0.358974358974359	80	16095	6	18	74	16077	16175	0.13465475167072405
R1	cpdb	0	network_modules	72	TRUE	2.6340018313575056e-6	36	24	5	0.20833333333333334	0.1388888888888889	GO:0061035	GO:BP	regulation of cartilage development	16175	15152		0.3684210526315789	0.38461538461538464	36	16139	5	19	31	16120	16175	0.16859892755212125
R1	cpdb	0	network_modules	72	TRUE	5.210356241338641e-6	41	24	5	0.20833333333333334	0.12195121951219512	GO:0032924	GO:BP	activin receptor signaling pathway	16175	7915		0.39473684210526316	0.41025641025641024	41	16134	5	19	36	16115	16175	0.1577718700475088
R1	cpdb	0	network_modules	72	TRUE	7.65844759452921e-6	790	24	11	0.4583333333333333	0.013924050632911392	GO:0007167	GO:BP	enzyme-linked receptor protein signaling pathway	16175	2731		0.42105263157894735	0.4358974358974359	790	15385	11	13	779	15372	16175	0.07323756374553499
R1	cpdb	0	network_modules	72	TRUE	1.3154433062148297e-5	49	24	5	0.20833333333333334	0.10204081632653061	GO:0045669	GO:BP	positive regulation of osteoblast differentiation	16175	11520		0.4473684210526316	0.46153846153846156	49	16126	5	19	44	16107	16175	0.14400785283410297
R1	cpdb	0	network_modules	72	TRUE	1.7574672977911386e-5	18	24	4	0.16666666666666666	0.2222222222222222	GO:0061036	GO:BP	positive regulation of cartilage development	16175	15153		0.47368421052631576	0.48717948717948717	18	16157	4	20	14	16137	16175	0.19141362170433107
R1	cpdb	0	network_modules	72	TRUE	3.1633231919559736e-5	217	24	7	0.2916666666666667	0.03225806451612903	GO:0090092	GO:BP	regulation of transmembrane receptor protein serine/threonine kinase signaling pathway	16175	18013		0.5	0.5128205128205128	217	15958	7	17	210	15941	16175	0.09323257614853692
R1	cpdb	0	network_modules	72	TRUE	3.4272046626523965e-5	21	24	4	0.16666666666666666	0.19047619047619047	GO:0032925	GO:BP	regulation of activin receptor signaling pathway	16175	7916		0.5263157894736842	0.5384615384615384	21	16154	4	20	17	16134	16175	0.1770324795933596
R1	cpdb	0	network_modules	72	TRUE	8.372345634060319e-5	250	24	7	0.2916666666666667	0.028	GO:0007389	GO:BP	pattern specification process	16175	2889		0.5526315789473685	0.5641025641025641	250	15925	7	17	243	15908	16175	0.08631395176715487
R1	cpdb	0	network_modules	72	TRUE	8.789881571425708e-5	71	24	5	0.20833333333333334	0.07042253521126761	GO:0060395	GO:BP	SMAD protein signal transduction	16175	14598		0.5789473684210527	0.5897435897435898	71	16104	5	19	66	16085	16175	0.11892269588884824
R1	cpdb	0	network_modules	72	TRUE	9.334110522361476e-5	254	24	7	0.2916666666666667	0.027559055118110236	GO:0001503	GO:BP	ossification	16175	320		0.6052631578947368	0.6153846153846154	254	15921	7	17	247	15904	16175	0.08556569694360706
R1	cpdb	0	network_modules	72	TRUE	1.1643667176113948e-4	28	24	4	0.16666666666666666	0.14285714285714285	GO:0032330	GO:BP	regulation of chondrocyte differentiation	16175	7489		0.631578947368421	0.6410256410256411	28	16147	4	20	24	16127	16175	0.1529465441689966
R1	cpdb	0	network_modules	72	TRUE	1.9532935805735744e-4	283	24	7	0.2916666666666667	0.024734982332155476	GO:0001501	GO:BP	skeletal system development	16175	318		0.6578947368421053	0.6666666666666666	283	15892	7	17	276	15875	16175	0.08060991780069245
R1	cpdb	0	network_modules	72	TRUE	2.601035927679577e-4	88	24	5	0.20833333333333334	0.056818181818181816	GO:0048705	GO:BP	skeletal system morphogenesis	16175	12962		0.6842105263157895	0.6923076923076923	88	16087	5	19	83	16068	16175	0.10632565167258048
R1	cpdb	0	network_modules	72	TRUE	2.72379465976678e-4	176	24	6	0.25	0.03409090909090909	GO:0007179	GO:BP	transforming growth factor beta receptor signaling pathway	16175	2741		0.7105263157894737	0.717948717948718	176	15999	6	18	170	15981	16175	0.08885084326886196
R1	cpdb	0	network_modules	72	TRUE	3.252271387951704e-4	92	24	5	0.20833333333333334	0.05434782608695652	GO:0045667	GO:BP	regulation of osteoblast differentiation	16175	11518		0.7368421052631579	0.7435897435897436	92	16083	5	19	87	16064	16175	0.10387470762965521
R1	cpdb	0	network_modules	72	TRUE	4.6267562207770246e-4	39	24	4	0.16666666666666666	0.10256410256410256	GO:0030501	GO:BP	positive regulation of bone mineralization	16175	6822		0.7631578947368421	0.7692307692307693	39	16136	4	20	35	16116	16175	0.12910408307256965
R1	cpdb	0	network_modules	72	TRUE	6.914575069080787e-4	43	24	4	0.16666666666666666	0.09302325581395349	GO:0045778	GO:BP	positive regulation of ossification	16175	11612		0.7894736842105263	0.7948717948717948	43	16132	4	20	39	16112	16175	0.12278280302522317
R1	cpdb	0	network_modules	72	TRUE	7.342234578881337e-4	11	24	3	0.125	0.2727272727272727	GO:0032332	GO:BP	positive regulation of chondrocyte differentiation	16175	7491		0.8157894736842105	0.8205128205128205	11	16164	3	21	8	16143	16175	0.18383162391620309
R1	cpdb	0	network_modules	72	TRUE	0.0010701495720102417	16	21	3	0.14285714285714285	0.1875	REAC:R-HSA-2173791	REAC	TGF-beta receptor signaling in EMT (epithelial to mesenchymal transition)	10916	2429		0.6666666666666666	0.75	16	10900	3	18	13	10882	10916	0.16225919808324704
R1	cpdb	0	network_modules	72	TRUE	0.001084833005377294	48	24	4	0.16666666666666666	0.08333333333333333	GO:0070169	GO:BP	positive regulation of biomineral tissue development	16175	15962		0.8421052631578947	0.8461538461538461	48	16127	4	20	44	16107	16175	0.11601099343237364
R1	cpdb	0	network_modules	72	TRUE	0.002630547770549604	140	24	5	0.20833333333333334	0.03571428571428571	GO:0048738	GO:BP	cardiac muscle tissue development	16175	12995		0.868421052631579	0.8717948717948718	140	16035	5	19	135	16016	16175	0.0830963450481795
R1	cpdb	0	network_modules	72	TRUE	0.003272011310529916	63	24	4	0.16666666666666666	0.06349206349206349	GO:0030500	GO:BP	regulation of bone mineralization	16175	6821		0.8947368421052632	0.8974358974358975	63	16112	4	20	59	16092	16175	0.10073590181751142
R1	cpdb	0	network_modules	72	TRUE	0.004346571905437383	25	21	3	0.14285714285714285	0.12	REAC:R-HSA-2173788	REAC	Downregulation of TGF-beta receptor signaling	10916	788		1	1	25	10891	3	18	22	10873	10916	0.1291037399356338
R1	cpdb	0	network_modules	72	TRUE	0.004921106233711784	159	24	5	0.20833333333333334	0.031446540880503145	GO:0001649	GO:BP	osteoblast differentiation	16175	367		0.9210526315789473	0.9230769230769231	159	16016	5	19	154	15997	16175	0.07756082986709648
R1	cpdb	0	network_modules	72	TRUE	0.008280692081214873	138	17	4	0.23529411764705882	0.028985507246376812	KEGG:05418	KEGG	Fluid shear stress and atherosclerosis	8484	495		1	1	138	8346	4	13	134	8333	8484	0.07758569448500334
R1	cpdb	0	network_modules	72	TRUE	0.008542609148804024	80	24	4	0.16666666666666666	0.05	GO:0030278	GO:BP	regulation of ossification	16175	6755		0.9473684210526315	0.9487179487179487	80	16095	4	20	76	16075	16175	0.08886392631018665
R1	cpdb	0	network_modules	72	TRUE	0.009881539404908083	3	24	2	0.08333333333333333	0.6666666666666666	GO:1902731	GO:BP	negative regulation of chondrocyte proliferation	16175	22461		0.9736842105263158	0.9743589743589743	3	16172	2	22	1	16150	16175	0.23537416597204877
R1	cpdb	0	network_modules	72	TRUE	0.009896106765312565	83	24	4	0.16666666666666666	0.04819277108433735	GO:0070167	GO:BP	regulation of biomineral tissue development	16175	15960		1	1	83	16092	4	20	79	16072	16175	0.08715123827766873
R1	cpdb	0	network_modules	73	TRUE	3.5291781903343664e-17	24	22	9	0.4090909090909091	0.375	REAC:R-HSA-6783589	REAC	Interleukin-6 family signaling	10916	1253		0	0.16666666666666666	24	10892	9	13	15	10879	10916	0.390392277174438
R1	cpdb	0	network_modules	73	TRUE	2.9866331018876604e-13	17	22	7	0.3181818181818182	0.4117647058823529	REAC:R-HSA-6788467	REAC	IL-6-type cytokine receptor ligand interactions	10916	1146		0.2	0.3333333333333333	17	10899	7	15	10	10884	10916	0.36083434870532477
R1	cpdb	0	network_modules	73	TRUE	1.7318943767174883e-10	162	16	9	0.5625	0.05555555555555555	KEGG:04630	KEGG	JAK-STAT signaling pathway	8484	332		0	0.5	162	8322	9	7	153	8315	8484	0.1725928022801001
R1	cpdb	0	network_modules	73	TRUE	1.271611269107039e-9	419	21	11	0.5238095238095238	0.026252983293556086	GO:0019221	GO:BP	cytokine-mediated signaling pathway	16175	5598		0	0.027777777777777776	419	15756	11	10	408	15746	16175	0.11301359580744019
R1	cpdb	0	network_modules	73	TRUE	3.0870981423997082e-9	4	21	4	0.19047619047619047	1	GO:0038165	GO:BP	oncostatin-M-mediated signaling pathway	16175	9743		0.02857142857142857	0.05555555555555555	4	16171	4	17	0	16154	16175	0.43620631540383864
R1	cpdb	0	network_modules	73	TRUE	1.54225092839061e-8	5	21	4	0.19047619047619047	0.8	GO:0070120	GO:BP	ciliary neurotrophic factor-mediated signaling pathway	16175	15922		0.05714285714285714	0.08333333333333333	5	16170	4	17	1	16153	16175	0.39004005033238803
R1	cpdb	0	network_modules	73	TRUE	2.6731875439061785e-8	555	21	11	0.5238095238095238	0.01981981981981982	GO:0071345	GO:BP	cellular response to cytokine stimulus	16175	16597		0.08571428571428572	0.1111111111111111	555	15620	11	10	544	15610	16175	0.09695656120613022
R1	cpdb	0	network_modules	73	TRUE	3.3831896588031496e-8	291	16	9	0.5625	0.030927835051546393	KEGG:04060	KEGG	Cytokine-cytokine receptor interaction	8484	253		1	1	291	8193	9	7	282	8186	8484	0.12615392516518778
R1	cpdb	0	network_modules	73	TRUE	9.584622804643796e-8	625	21	11	0.5238095238095238	0.0176	GO:0034097	GO:BP	response to cytokine	16175	8408		0.11428571428571428	0.16666666666666666	625	15550	11	10	614	15540	16175	0.09076163596313429
R1	cpdb	0	network_modules	73	TRUE	9.584622804643796e-8	625	21	11	0.5238095238095238	0.0176	GO:1901652	GO:BP	response to peptide	16175	21619		0.11428571428571428	0.16666666666666666	625	15550	11	10	614	15540	16175	0.09076163596313429
R1	cpdb	0	network_modules	73	TRUE	2.5961929579471964e-7	686	21	11	0.5238095238095238	0.016034985422740525	GO:0008284	GO:BP	positive regulation of cell population proliferation	16175	3151		0.17142857142857143	0.19444444444444445	686	15489	11	10	675	15479	16175	0.0861280844212235
R1	cpdb	0	network_modules	73	TRUE	3.025678710665865e-7	131	21	7	0.3333333333333333	0.05343511450381679	GO:0050731	GO:BP	positive regulation of peptidyl-tyrosine phosphorylation	16175	13230		0.2	0.2222222222222222	131	16044	7	14	124	16030	16175	0.13083333682078713
R1	cpdb	0	network_modules	73	TRUE	2.315492382703854e-6	175	21	7	0.3333333333333333	0.04	GO:0050730	GO:BP	regulation of peptidyl-tyrosine phosphorylation	16175	13229		0.22857142857142856	0.25	175	16000	7	14	168	15986	16175	0.11240449520311835
R1	cpdb	0	network_modules	73	TRUE	2.805835579354838e-6	472	22	10	0.45454545454545453	0.0211864406779661	REAC:R-HSA-449147	REAC	Signaling by Interleukins	10916	2261		0.4	0.5	472	10444	10	12	462	10432	10916	0.09087448828638567
R1	cpdb	0	network_modules	73	TRUE	9.39829718428273e-6	214	21	7	0.3333333333333333	0.03271028037383177	GO:0018108	GO:BP	peptidyl-tyrosine phosphorylation	16175	5327		0.2571428571428571	0.2777777777777778	214	15961	7	14	207	15947	16175	0.10101055565442998
R1	cpdb	0	network_modules	73	TRUE	9.70716002074161e-6	215	21	7	0.3333333333333333	0.03255813953488372	GO:0018212	GO:BP	peptidyl-tyrosine modification	16175	5371		0.2857142857142857	0.3055555555555556	215	15960	7	14	208	15946	16175	0.10075906659060752
R1	cpdb	0	network_modules	73	TRUE	9.856608968914304e-6	54	21	5	0.23809523809523808	0.09259259259259259	GO:0042531	GO:BP	positive regulation of tyrosine phosphorylation of STAT protein	16175	10227		0.3142857142857143	0.3333333333333333	54	16121	5	16	49	16105	16175	0.14673682644835012
R1	cpdb	0	network_modules	73	TRUE	1.4756966507089437e-5	20	21	4	0.19047619047619047	0.2	GO:0002675	GO:BP	positive regulation of acute inflammatory response	16175	1193		0.34285714285714286	0.3611111111111111	20	16155	4	17	16	16138	16175	0.19415907864427537
R1	cpdb	0	network_modules	73	TRUE	1.8434812014258036e-5	61	21	5	0.23809523809523808	0.08196721311475409	GO:0002526	GO:BP	acute inflammatory response	16175	1048		0.37142857142857144	0.3888888888888889	61	16114	5	16	56	16098	16175	0.1378364397423631
R1	cpdb	0	network_modules	73	TRUE	2.1744549124135144e-5	63	21	5	0.23809523809523808	0.07936507936507936	GO:0042509	GO:BP	regulation of tyrosine phosphorylation of STAT protein	16175	10226		0.4	0.4166666666666667	63	16112	5	16	58	16096	16175	0.1355677582633078
R1	cpdb	0	network_modules	73	TRUE	2.5510721268880828e-5	65	21	5	0.23809523809523808	0.07692307692307693	GO:0007260	GO:BP	tyrosine phosphorylation of STAT protein	16175	2790		0.42857142857142855	0.4444444444444444	65	16110	5	16	60	16094	16175	0.13340362112544418
R1	cpdb	0	network_modules	73	TRUE	1.2327840912413786e-4	33	21	4	0.19047619047619047	0.12121212121212122	GO:0002673	GO:BP	regulation of acute inflammatory response	16175	1191		0.45714285714285713	0.4722222222222222	33	16142	4	17	29	16125	16175	0.15057128067402714
R1	cpdb	0	network_modules	73	TRUE	3.8674432545441717e-4	11	22	3	0.13636363636363635	0.2727272727272727	REAC:R-HSA-1059683	REAC	Interleukin-6 signaling	10916	1254		0.6	0.6666666666666666	11	10905	3	19	8	10886	10916	0.19171201310844765
R1	cpdb	0	network_modules	73	TRUE	0.0010609180744789936	15	22	3	0.13636363636363635	0.2	REAC:R-HSA-2691232	REAC	Constitutive Signaling by NOTCH1 HD Domain Mutants	10916	404		0.8	1	15	10901	3	19	12	10882	10916	0.1637579498907437
R1	cpdb	0	network_modules	73	TRUE	0.0010609180744789936	15	22	3	0.13636363636363635	0.2	REAC:R-HSA-2691230	REAC	Signaling by NOTCH1 HD Domain Mutants in Cancer	10916	2276		0.8	1	15	10901	3	19	12	10882	10916	0.1637579498907437
R1	cpdb	0	network_modules	73	TRUE	0.0012984707621220394	142	21	5	0.23809523809523808	0.035211267605633804	GO:0007259	GO:BP	cell surface receptor signaling pathway via JAK-STAT	16175	2789		0.4857142857142857	0.5	142	16033	5	16	137	16017	16175	0.08863335231605717
R1	cpdb	0	network_modules	73	TRUE	0.0016476727992623878	149	21	5	0.23809523809523808	0.03355704697986577	GO:0097696	GO:BP	cell surface receptor signaling pathway via STAT	16175	18727		0.5142857142857142	0.5277777777777778	149	16026	5	16	144	16010	16175	0.08638188243227739
R1	cpdb	0	network_modules	73	TRUE	0.0022350730008551182	18	21	3	0.14285714285714285	0.16666666666666666	GO:0070102	GO:BP	interleukin-6-mediated signaling pathway	16175	15914		0.5428571428571428	0.5833333333333334	18	16157	3	18	15	16139	16175	0.1532861548213182
R1	cpdb	0	network_modules	73	TRUE	0.0022350730008551182	18	21	3	0.14285714285714285	0.16666666666666666	GO:0072540	GO:BP	T-helper 17 cell lineage commitment	16175	17438		0.5428571428571428	0.5833333333333334	18	16157	3	18	15	16139	16175	0.1532861548213182
R1	cpdb	0	network_modules	73	TRUE	0.0023609057482242633	2	21	2	0.09523809523809523	1	GO:0002384	GO:BP	hepatic immune response	16175	911		0.6	0.6111111111111112	2	16173	2	19	0	16154	16175	0.3084253714623902
R1	cpdb	0	network_modules	73	TRUE	0.0030347000134801705	500	21	7	0.3333333333333333	0.014	GO:0001934	GO:BP	positive regulation of protein phosphorylation	16175	548		0.6285714285714286	0.6388888888888888	500	15675	7	14	493	15661	16175	0.06299958467498575
R1	cpdb	0	network_modules	73	TRUE	0.003117317923436404	20	21	3	0.14285714285714285	0.15	GO:0002295	GO:BP	T-helper cell lineage commitment	16175	827		0.6571428571428571	0.6666666666666666	20	16155	3	18	17	16137	16175	0.14530215429655982
R1	cpdb	0	network_modules	73	TRUE	0.004040130215028523	522	21	7	0.3333333333333333	0.013409961685823755	GO:0042327	GO:BP	positive regulation of phosphorylation	16175	10095		0.6857142857142857	0.6944444444444444	522	15653	7	14	515	15639	16175	0.06142353377292546
R1	cpdb	0	network_modules	73	TRUE	0.004525151590821575	531	21	7	0.3333333333333333	0.013182674199623353	GO:0032103	GO:BP	positive regulation of response to external stimulus	16175	7367		0.7142857142857143	0.7222222222222222	531	15644	7	14	524	15630	16175	0.06080569868686791
R1	cpdb	0	network_modules	73	TRUE	0.0048306643420380204	23	21	3	0.14285714285714285	0.13043478260869565	GO:0002363	GO:BP	alpha-beta T cell lineage commitment	16175	895		0.7428571428571429	0.7777777777777778	23	16152	3	18	20	16134	16175	0.13533007461701302
R1	cpdb	0	network_modules	73	TRUE	0.0048306643420380204	23	21	3	0.14285714285714285	0.13043478260869565	GO:0043373	GO:BP	CD4-positive, alpha-beta T cell lineage commitment	16175	10650		0.7428571428571429	0.7777777777777778	23	16152	3	18	20	16134	16175	0.13533007461701302
R1	cpdb	0	network_modules	73	TRUE	0.0055161512417743344	24	21	3	0.14285714285714285	0.125	GO:0002360	GO:BP	T cell lineage commitment	16175	892		0.8	0.8333333333333334	24	16151	3	18	21	16133	16175	0.1324268911233211
R1	cpdb	0	network_modules	73	TRUE	0.0055161512417743344	24	21	3	0.14285714285714285	0.125	GO:0043369	GO:BP	CD4-positive or CD8-positive, alpha-beta T cell lineage commitment	16175	10646		0.8	0.8333333333333334	24	16151	3	18	21	16133	16175	0.1324268911233211
R1	cpdb	0	network_modules	73	TRUE	0.006742519006720087	564	21	7	0.3333333333333333	0.012411347517730497	GO:0045937	GO:BP	positive regulation of phosphate metabolic process	16175	11731		0.8571428571428571	0.8888888888888888	564	15611	7	14	557	15597	16175	0.05866133876545872
R1	cpdb	0	network_modules	73	TRUE	0.006742519006720087	564	21	7	0.3333333333333333	0.012411347517730497	GO:0010562	GO:BP	positive regulation of phosphorus metabolic process	16175	4215		0.8571428571428571	0.8888888888888888	564	15611	7	14	557	15597	16175	0.05866133876545872
R1	cpdb	0	network_modules	73	TRUE	0.007074141218184746	26	21	3	0.14285714285714285	0.11538461538461539	GO:0002446	GO:BP	neutrophil mediated immunity	16175	969		0.9142857142857143	0.9166666666666666	26	16149	3	18	23	16131	16175	0.12712823401015022
R1	cpdb	0	network_modules	73	TRUE	0.007077170072321803	3	21	2	0.09523809523809523	0.6666666666666666	GO:0048861	GO:BP	leukemia inhibitory factor signaling pathway	16175	13105		0.9428571428571428	0.9444444444444444	3	16172	2	19	1	16153	16175	0.25167235521278336
R1	cpdb	0	network_modules	73	TRUE	0.00991701611104576	29	21	3	0.14285714285714285	0.10344827586206896	GO:0072539	GO:BP	T-helper 17 cell differentiation	16175	17437		0.9714285714285714	1	29	16146	3	18	26	16128	16175	0.12022627641589377
R1	cpdb	0	network_modules	73	TRUE	0.00991701611104576	29	21	3	0.14285714285714285	0.10344827586206896	GO:0071354	GO:BP	cellular response to interleukin-6	16175	16606		0.9714285714285714	1	29	16146	3	18	26	16128	16175	0.12022627641589377
R1	cpdb	0	network_modules	74	TRUE	1.4576430394241768e-13	315	24	13	0.5416666666666666	0.04126984126984127	GO:0009100	GO:BP	glycoprotein metabolic process	16175	3272		0	0.05263157894736842	315	15860	13	11	302	15849	16175	0.14567119667080378
R1	cpdb	0	network_modules	74	TRUE	5.994312001461503e-11	265	24	11	0.4583333333333333	0.04150943396226415	GO:0009101	GO:BP	glycoprotein biosynthetic process	16175	3273		0.05555555555555555	0.10526315789473684	265	15910	11	13	254	15897	16175	0.13420396231632695
R1	cpdb	0	network_modules	74	TRUE	8.21908998457261e-11	514	24	13	0.5416666666666666	0.02529182879377432	GO:1901137	GO:BP	carbohydrate derivative biosynthetic process	16175	21245		0.1111111111111111	0.15789473684210525	514	15661	13	11	501	15650	16175	0.11205590260021778
R1	cpdb	0	network_modules	74	TRUE	7.260846010199753e-7	66	24	6	0.25	0.09090909090909091	GO:0006024	GO:BP	glycosaminoglycan biosynthetic process	16175	1897		0.16666666666666666	0.21052631578947367	66	16109	6	18	60	16091	16175	0.14870896061174754
R1	cpdb	0	network_modules	74	TRUE	7.967402183090154e-7	67	24	6	0.25	0.08955223880597014	GO:0006023	GO:BP	aminoglycan biosynthetic process	16175	1896		0.2222222222222222	0.2631578947368421	67	16108	6	18	61	16090	16175	0.1475624951729999
R1	cpdb	0	network_modules	74	TRUE	2.7557525207937187e-6	82	24	6	0.25	0.07317073170731707	GO:0030203	GO:BP	glycosaminoglycan metabolic process	16175	6712		0.2777777777777778	0.3157894736842105	82	16093	6	18	76	16075	16175	0.13294363432417433
R1	cpdb	0	network_modules	74	TRUE	4.862559473508524e-6	90	24	6	0.25	0.06666666666666667	GO:0006022	GO:BP	aminoglycan metabolic process	16175	1895		0.3333333333333333	0.3684210526315789	90	16085	6	18	84	16067	16175	0.12667278818425615
R1	cpdb	0	network_modules	74	TRUE	1.531478440538954e-5	21	23	4	0.17391304347826086	0.19047619047619047	KEGG:00532	KEGG	Glycosaminoglycan biosynthesis - chondroitin sulfate / dermatan sulfate	8484	76		0	0.25	21	8463	4	19	17	8444	8484	0.17988232291147999
R1	cpdb	0	network_modules	74	TRUE	4.055932885691725e-5	61	24	5	0.20833333333333334	0.08196721311475409	GO:1903510	GO:BP	mucopolysaccharide metabolic process	16175	23060		0.3888888888888889	0.42105263157894735	61	16114	5	19	56	16095	16175	0.12864968833138613
R1	cpdb	0	network_modules	74	TRUE	1.4362580485016165e-4	158	24	6	0.25	0.0379746835443038	GO:0044272	GO:BP	sulfur compound biosynthetic process	16175	10944		0.4444444444444444	0.47368421052631576	158	16017	6	18	152	15999	16175	0.09415895646347816
R1	cpdb	0	network_modules	74	TRUE	1.7840356932660563e-4	31	24	4	0.16666666666666666	0.12903225806451613	GO:0019082	GO:BP	viral protein processing	16175	5572		0.5	0.5263157894736842	31	16144	4	20	27	16124	16175	0.14520766540677896
R1	cpdb	0	network_modules	74	TRUE	2.7581697967637146e-4	42	23	4	0.17391304347826086	0.09523809523809523	KEGG:00513	KEGG	Various types of N-glycan biosynthesis	8484	66		0.3333333333333333	0.5	42	8442	4	19	38	8423	8484	0.12551535608231365
R1	cpdb	0	network_modules	74	TRUE	3.1071885369840806e-4	37	23	4	0.17391304347826086	0.10810810810810811	REAC:R-HSA-9694548	REAC	Maturation of spike protein	10916	1408		0	0.125	37	10879	4	19	33	10860	10916	0.1348163734968643
R1	cpdb	0	network_modules	74	TRUE	3.194662832627674e-4	10	23	3	0.13043478260869565	0.3	REAC:R-HSA-975578	REAC	Reactions specific to the complex N-glycan synthesis pathway	10916	1942		0.14285714285714285	0.25	10	10906	3	20	7	10886	10916	0.19672221704372114
R1	cpdb	0	network_modules	74	TRUE	3.4302917808644653e-4	183	24	6	0.25	0.03278688524590164	GO:0006486	GO:BP	protein glycosylation	16175	2220		0.5555555555555556	0.631578947368421	183	15992	6	18	177	15974	16175	0.08699627491153701
R1	cpdb	0	network_modules	74	TRUE	3.4302917808644653e-4	183	24	6	0.25	0.03278688524590164	GO:0043413	GO:BP	macromolecule glycosylation	16175	10680		0.5555555555555556	0.631578947368421	183	15992	6	18	177	15974	16175	0.08699627491153701
R1	cpdb	0	network_modules	74	TRUE	6.122191528667337e-4	16	23	3	0.13043478260869565	0.1875	KEGG:00603	KEGG	Glycosphingolipid biosynthesis - globo and isoglobo series	8484	97		0.6666666666666666	0.75	16	8468	3	20	13	8448	8484	0.15447976872054858
R1	cpdb	0	network_modules	74	TRUE	6.506977152863269e-4	204	24	6	0.25	0.029411764705882353	GO:0070085	GO:BP	glycosylation	16175	15903		0.6666666666666666	0.6842105263157895	204	15971	6	18	198	15953	16175	0.08200261894290357
R1	cpdb	0	network_modules	74	TRUE	7.074629780428618e-4	53	23	4	0.17391304347826086	0.07547169811320754	KEGG:00510	KEGG	N-Glycan biosynthesis	8484	63		1	1	53	8431	4	19	49	8412	8484	0.11094844736667987
R1	cpdb	0	network_modules	74	TRUE	9.802569887068795e-4	49	23	4	0.17391304347826086	0.08163265306122448	REAC:R-HSA-1793185	REAC	Chondroitin sulfate/dermatan sulfate metabolism	10916	353		0.2857142857142857	0.375	49	10867	4	19	45	10848	10916	0.11645987345303656
R1	cpdb	0	network_modules	74	TRUE	0.0017049067610828803	125	23	5	0.21739130434782608	0.04	REAC:R-HSA-1630316	REAC	Glycosaminoglycan metabolism	10916	1076		0.42857142857142855	0.5	125	10791	5	18	120	10773	10916	0.08894243598254462
R1	cpdb	0	network_modules	74	TRUE	0.0018072537244092478	57	23	4	0.17391304347826086	0.07017543859649122	REAC:R-HSA-9694635	REAC	Translation of Structural Proteins	10916	2571		0.5714285714285714	0.625	57	10859	4	19	53	10840	10916	0.10755092848969919
R1	cpdb	0	network_modules	74	TRUE	0.0028722542402923744	61	24	4	0.16666666666666666	0.06557377049180328	GO:0030166	GO:BP	proteoglycan biosynthetic process	16175	6693		0.7222222222222222	0.7368421052631579	61	16114	4	20	57	16094	16175	0.10244540040200391
R1	cpdb	0	network_modules	74	TRUE	0.0030082549124477594	17	24	3	0.125	0.17647058823529413	GO:0006491	GO:BP	N-glycan processing	16175	2224		0.7777777777777778	0.7894736842105263	17	16158	3	21	14	16137	16175	0.1474602446488705
R1	cpdb	0	network_modules	74	TRUE	0.004119577280125139	70	23	4	0.17391304347826086	0.05714285714285714	REAC:R-HSA-9772573	REAC	Late SARS-CoV-2 Infection Events	10916	1305		0.7142857142857143	0.75	70	10846	4	19	66	10827	10916	0.09642415029557862
R1	cpdb	0	network_modules	74	TRUE	0.004954465325629897	289	24	6	0.25	0.020761245674740483	GO:0006790	GO:BP	sulfur compound metabolic process	16175	2476		0.8333333333333334	0.8421052631578947	289	15886	6	18	283	15868	16175	0.06755083749438652
R1	cpdb	0	network_modules	74	TRUE	0.005601029017068555	72	24	4	0.16666666666666666	0.05555555555555555	GO:0006029	GO:BP	proteoglycan metabolic process	16175	1902		0.8888888888888888	0.8947368421052632	72	16103	4	20	68	16083	16175	0.09393393432165546
R1	cpdb	0	network_modules	74	TRUE	0.0058609106943852286	21	24	3	0.125	0.14285714285714285	GO:0050650	GO:BP	chondroitin sulfate proteoglycan biosynthetic process	16175	13191		0.9444444444444444	0.9473684210526315	21	16154	3	21	18	16133	16175	0.1324268911233211
R1	cpdb	0	network_modules	74	TRUE	0.006771145096469051	26	23	3	0.13043478260869565	0.11538461538461539	REAC:R-HSA-975576	REAC	N-glycan antennae elongation in the medial/trans-Golgi	10916	1506		0.8571428571428571	0.875	26	10890	3	20	23	10870	10916	0.12070984536513597
R1	cpdb	0	network_modules	74	TRUE	0.007280364192344955	288	23	6	0.2608695652173913	0.020833333333333332	REAC:R-HSA-71387	REAC	Metabolism of carbohydrates	10916	1422		1	1	288	10628	6	17	282	10611	10916	0.06722783157125577
R1	cpdb	0	network_modules	74	TRUE	0.007789075887658279	23	24	3	0.125	0.13043478260869565	GO:0050654	GO:BP	chondroitin sulfate proteoglycan metabolic process	16175	13195		1	1	23	16152	3	21	20	16131	16175	0.12641961913648028
R1	cpdb	0	network_modules	76	TRUE	1.405500405251967e-15	68	18	10	0.5555555555555556	0.14705882352941177	KEGG:05211	KEGG	Renal cell carcinoma	8484	462		0	0.5	68	8416	10	8	58	8408	8484	0.28314355704527006
R1	cpdb	0	network_modules	76	TRUE	7.72528933873077e-12	75	24	9	0.375	0.12	REAC:R-HSA-1234174	REAC	Cellular response to hypoxia	10916	335		0	0.14285714285714285	75	10841	9	15	66	10826	10916	0.20919460168927637
R1	cpdb	0	network_modules	76	TRUE	2.098359240075522e-8	66	24	7	0.2916666666666667	0.10606060606060606	REAC:R-HSA-1234176	REAC	Oxygen-dependent proline hydroxylation of Hypoxia-inducible Factor Alpha	10916	1655		0.16666666666666666	0.2857142857142857	66	10850	7	17	59	10833	10916	0.17294892364892767
R1	cpdb	0	network_modules	76	TRUE	8.290056139146409e-8	109	18	7	0.3888888888888889	0.06422018348623854	KEGG:04066	KEGG	HIF-1 signaling pathway	8484	257		1	1	109	8375	7	11	102	8364	8484	0.15396695653812392
R1	cpdb	0	network_modules	76	TRUE	6.835721745620487e-7	23	29	5	0.1724137931034483	0.21739130434782608	GO:1902455	GO:BP	negative regulation of stem cell population maintenance	16175	22293		0	0.034482758620689655	23	16152	5	24	18	16128	16175	0.19231322164853548
R1	cpdb	0	network_modules	76	TRUE	1.19239041167897e-5	152	29	7	0.2413793103448276	0.046052631578947366	GO:0001666	GO:BP	response to hypoxia	16175	377		0.03571428571428571	0.06896551724137931	152	16023	7	22	145	16001	16175	0.10189938555034311
R1	cpdb	0	network_modules	76	TRUE	1.3660611323301882e-5	155	29	7	0.2413793103448276	0.04516129032258064	GO:0036293	GO:BP	response to decreased oxygen levels	16175	9544		0.07142857142857142	0.10344827586206896	155	16020	7	22	148	15998	16175	0.10083720746774351
R1	cpdb	0	network_modules	76	TRUE	1.4888309560595558e-5	41	29	5	0.1724137931034483	0.12195121951219512	GO:1902459	GO:BP	positive regulation of stem cell population maintenance	16175	22297		0.10714285714285714	0.13793103448275862	41	16134	5	24	36	16110	16175	0.14318172798843334
R1	cpdb	0	network_modules	76	TRUE	1.8330149793095624e-5	256	29	8	0.27586206896551724	0.03125	GO:0090287	GO:BP	regulation of cellular response to growth factor stimulus	16175	18171		0.14285714285714285	0.1724137931034483	256	15919	8	21	248	15898	16175	0.08830088172722213
R1	cpdb	0	network_modules	76	TRUE	2.700557537076237e-5	171	29	7	0.2413793103448276	0.04093567251461988	GO:0070482	GO:BP	response to oxygen levels	16175	16143		0.17857142857142858	0.20689655172413793	171	16004	7	22	164	15982	16175	0.0956419213435513
R1	cpdb	0	network_modules	76	TRUE	3.33896446904446e-5	4	29	3	0.10344827586206896	0.75	GO:0018401	GO:BP	peptidyl-proline hydroxylation to 4-hydroxy-L-proline	16175	5421		0.21428571428571427	0.2413793103448276	4	16171	3	26	1	16145	16175	0.278160977676875
R1	cpdb	0	network_modules	76	TRUE	6.803410489069673e-5	25	24	4	0.16666666666666666	0.16	REAC:R-HSA-9705462	REAC	Inactivation of CSF3 (G-CSF) signaling	10916	1178		0.3333333333333333	0.42857142857142855	25	10891	4	20	21	10871	10916	0.1614176596342234
R1	cpdb	0	network_modules	76	TRUE	9.726908892916916e-5	59	29	5	0.1724137931034483	0.0847457627118644	GO:2000036	GO:BP	regulation of stem cell population maintenance	16175	25399		0.25	0.27586206896551724	59	16116	5	24	54	16092	16175	0.11864286401415046
R1	cpdb	0	network_modules	76	TRUE	1.1355964145813704e-4	123	29	6	0.20689655172413793	0.04878048780487805	GO:0017015	GO:BP	regulation of transforming growth factor beta receptor signaling pathway	16175	5276		0.2857142857142857	0.3103448275862069	123	16052	6	23	117	16029	16175	0.09722636224399356
R1	cpdb	0	network_modules	76	TRUE	1.25044195589787e-4	125	29	6	0.20689655172413793	0.048	GO:1903844	GO:BP	regulation of cellular response to transforming growth factor beta stimulus	16175	23323		0.32142857142857145	0.3448275862068966	125	16050	6	23	119	16027	16175	0.09639158212364698
R1	cpdb	0	network_modules	76	TRUE	1.463115313691589e-4	30	24	4	0.16666666666666666	0.13333333333333333	REAC:R-HSA-9674555	REAC	Signaling by CSF3 (G-CSF)	10916	2227		0.5	0.5714285714285714	30	10886	4	20	26	10866	10916	0.1469766229989503
R1	cpdb	0	network_modules	76	TRUE	1.665458766514154e-4	6	29	3	0.10344827586206896	0.5	GO:0019511	GO:BP	peptidyl-proline hydroxylation	16175	5850		0.35714285714285715	0.3793103448275862	6	16169	3	26	3	16143	16175	0.22685940145051087
R1	cpdb	0	network_modules	76	TRUE	3.4240208275171076e-4	10	24	3	0.125	0.3	REAC:R-HSA-1234158	REAC	Regulation of gene expression by Hypoxia-inducible Factor	10916	2033		0.6666666666666666	0.7142857142857143	10	10906	3	21	7	10885	10916	0.19252984767093345
R1	cpdb	0	network_modules	76	TRUE	4.6520466850329475e-4	8	29	3	0.10344827586206896	0.375	GO:0019471	GO:BP	4-hydroxyproline metabolic process	16175	5811		0.39285714285714285	0.41379310344827586	8	16167	3	26	5	16141	16175	0.196242469013387
R1	cpdb	0	network_modules	76	TRUE	5.47581719684523e-4	83	29	5	0.1724137931034483	0.060240963855421686	GO:0030512	GO:BP	negative regulation of transforming growth factor beta receptor signaling pathway	16175	6828		0.42857142857142855	0.4482758620689655	83	16092	5	24	78	16068	16175	0.09922407346691844
R1	cpdb	0	network_modules	76	TRUE	7.770246699171793e-4	89	29	5	0.1724137931034483	0.056179775280898875	GO:0071456	GO:BP	cellular response to hypoxia	16175	16690		0.4642857142857143	0.4827586206896552	89	16086	5	24	84	16062	16175	0.09562643667667507
R1	cpdb	0	network_modules	76	TRUE	9.171810790353649e-4	92	29	5	0.1724137931034483	0.05434782608695652	GO:0036294	GO:BP	cellular response to decreased oxygen levels	16175	9545		0.5	0.5172413793103449	92	16083	5	24	87	16059	16175	0.09395863721800024
R1	cpdb	0	network_modules	76	TRUE	9.485044073296373e-4	176	29	6	0.20689655172413793	0.03409090909090909	GO:0007179	GO:BP	transforming growth factor beta receptor signaling pathway	16175	2741		0.5357142857142857	0.5517241379310345	176	15999	6	23	170	15976	16175	0.08007530737214404
R1	cpdb	0	network_modules	76	TRUE	0.0010104308416858869	790	29	10	0.3448275862068966	0.012658227848101266	GO:0007167	GO:BP	enzyme-linked receptor protein signaling pathway	16175	2731		0.5714285714285714	0.5862068965517241	790	15385	10	19	780	15366	16175	0.05819971206442692
R1	cpdb	0	network_modules	76	TRUE	0.001322422708479238	99	29	5	0.1724137931034483	0.050505050505050504	GO:0019827	GO:BP	stem cell population maintenance	16175	6046		0.6071428571428571	0.6206896551724138	99	16076	5	24	94	16052	16175	0.09036053727925747
R1	cpdb	0	network_modules	76	TRUE	0.0013902994150203941	100	29	5	0.1724137931034483	0.05	GO:0098727	GO:BP	maintenance of cell number	16175	18856		0.6428571428571429	0.6551724137931034	100	16075	5	24	95	16051	16175	0.0898769693535218
R1	cpdb	0	network_modules	76	TRUE	0.0016898288178615406	104	29	5	0.1724137931034483	0.04807692307692308	GO:0071453	GO:BP	cellular response to oxygen levels	16175	16687		0.6785714285714286	0.6896551724137931	104	16071	5	24	99	16047	16175	0.0880114605642145
R1	cpdb	0	network_modules	76	TRUE	0.002123656643320758	202	29	6	0.20689655172413793	0.0297029702970297	GO:0071560	GO:BP	cellular response to transforming growth factor beta stimulus	16175	16762		0.7142857142857143	0.7241379310344828	202	15973	6	23	196	15950	16175	0.07419187333087111
R1	cpdb	0	network_modules	76	TRUE	0.002518295308981323	208	29	6	0.20689655172413793	0.028846153846153848	GO:0071559	GO:BP	response to transforming growth factor beta	16175	16761		0.75	0.7586206896551724	208	15967	6	23	202	15944	16175	0.0729881717083502
R1	cpdb	0	network_modules	76	TRUE	0.0031710291982392073	502	29	8	0.27586206896551724	0.01593625498007968	GO:0071363	GO:BP	cellular response to growth factor stimulus	16175	16615		0.7857142857142857	0.7931034482758621	502	15673	8	21	494	15652	16175	0.05983307854537144
R1	cpdb	0	network_modules	76	TRUE	0.0032211493206338515	217	29	6	0.20689655172413793	0.027649769585253458	GO:0090092	GO:BP	regulation of transmembrane receptor protein serine/threonine kinase signaling pathway	16175	18013		0.8214285714285714	0.8275862068965517	217	15958	6	23	211	15935	16175	0.07127374212473354
R1	cpdb	0	network_modules	76	TRUE	0.0034753401331417406	244	24	6	0.25	0.02459016393442623	REAC:R-HSA-8951664	REAC	Neddylation	10916	1559		0.8333333333333334	0.8571428571428571	244	10672	6	18	238	10654	10916	0.0722870290904974
R1	cpdb	0	network_modules	76	TRUE	0.0037351589066344894	21	24	3	0.125	0.14285714285714285	REAC:R-HSA-9768919	REAC	NPAS4 regulates expression of target genes	10916	1539		1	1	21	10895	3	21	18	10874	10916	0.1318457729520745
R1	cpdb	0	network_modules	76	TRUE	0.004064488824481644	519	29	8	0.27586206896551724	0.015414258188824663	GO:0070848	GO:BP	response to growth factor	16175	16340		0.8571428571428571	0.8620689655172413	519	15656	8	21	511	15635	16175	0.05862418426552583
R1	cpdb	0	network_modules	76	TRUE	0.00436687783094755	126	29	5	0.1724137931034483	0.03968253968253968	GO:0090101	GO:BP	negative regulation of transmembrane receptor protein serine/threonine kinase signaling pathway	16175	18019		0.8928571428571429	0.896551724137931	126	16049	5	24	121	16025	16175	0.07935872601603752
R1	cpdb	0	network_modules	76	TRUE	0.005587923194680785	17	29	3	0.10344827586206896	0.17647058823529413	GO:0018126	GO:BP	protein hydroxylation	16175	5332		0.9285714285714286	0.9310344827586207	17	16158	3	26	14	16132	16175	0.133930945548822
R1	cpdb	0	network_modules	76	TRUE	0.006809954320250525	247	29	6	0.20689655172413793	0.024291497975708502	GO:0030336	GO:BP	negative regulation of cell migration	16175	6782		0.9642857142857143	0.9655172413793104	247	15928	6	23	241	15905	16175	0.06622718761701105
R1	cpdb	0	network_modules	76	TRUE	0.008945392926871992	259	29	6	0.20689655172413793	0.023166023166023165	GO:2000146	GO:BP	negative regulation of cell motility	16175	25494		1	1	259	15916	6	23	253	15893	16175	0.06444866406476979
R1	cpdb	0	network_modules	77	TRUE	1.285421946608491e-5	791	20	10	0.5	0.012642225031605562	GO:0000122	GO:BP	negative regulation of transcription by RNA polymerase II	16175	48		NA	1	791	15384	10	10	781	15374	16175	0.07359583314242918
R1	cpdb	0	network_modules	77	TRUE	0.0057536135917111274	174	13	4	0.3076923076923077	0.022988505747126436	KEGG:03040	KEGG	Spliceosome	8484	215		NA	1	174	8310	4	9	170	8301	8484	0.07937591768685763
R1	cpdb	0	network_modules	78	TRUE	2.1714408048214906e-5	175	17	6	0.35294117647058826	0.03428571428571429	GO:0043484	GO:BP	regulation of RNA splicing	16175	10730		0	0.5	175	16000	6	11	169	15989	16175	0.10726967102634725
R1	cpdb	0	network_modules	78	TRUE	1.0534809935544502e-4	397	17	7	0.4117647058823529	0.017632241813602016	GO:0008380	GO:BP	RNA splicing	16175	3186		1	1	397	15778	7	10	390	15768	16175	0.08117311939165318
R1	cpdb	0	network_modules	80	TRUE	1.9764282966745514e-4	31	9	3	0.3333333333333333	0.0967741935483871	KEGG:03060	KEGG	Protein export	8484	217		NA	1	31	8453	3	6	28	8447	8484	0.17805639910683008
R1	cpdb	0	network_modules	80	TRUE	0.0036622703357273682	29	16	3	0.1875	0.10344827586206896	GO:0045047	GO:BP	protein targeting to ER	16175	11246		0	0.5	29	16146	3	13	26	16133	16175	0.1381319357800513
R1	cpdb	0	network_modules	80	TRUE	0.005455170206931775	33	16	3	0.1875	0.09090909090909091	GO:0072599	GO:BP	establishment of protein localization to endoplasmic reticulum	16175	17463		1	1	33	16142	3	13	30	16129	16175	0.12933355639244704
R1	cpdb	0	network_modules	81	TRUE	5.009186650391148e-13	48	26	9	0.34615384615384615	0.1875	KEGG:00280	KEGG	Valine, leucine and isoleucine degradation	8484	31		0	0.09090909090909091	48	8436	9	17	39	8419	8484	0.2516962696507411
R1	cpdb	0	network_modules	81	TRUE	3.997972210015634e-11	115	26	10	0.38461538461538464	0.08695652173913043	KEGG:01200	KEGG	Carbon metabolism	8484	184		0.1	0.18181818181818182	115	8369	10	16	105	8353	8484	0.17791495915197486
R1	cpdb	0	network_modules	81	TRUE	1.3103296206695883e-10	30	26	7	0.2692307692307692	0.23333333333333334	KEGG:00020	KEGG	Citrate cycle (TCA cycle)	8484	3		0.2	0.2727272727272727	30	8454	7	19	23	8435	8484	0.24816734692305
R1	cpdb	0	network_modules	81	TRUE	2.157907821399647e-10	32	26	7	0.2692307692307692	0.21875	KEGG:00640	KEGG	Propanoate metabolism	8484	109		0.3	0.36363636363636365	32	8452	7	19	25	8433	8484	0.24010220827022505
R1	cpdb	0	network_modules	81	TRUE	9.377251053070468e-10	19	30	6	0.2	0.3157894736842105	GO:0009083	GO:BP	branched-chain amino acid catabolic process	16175	3256		0	0.045454545454545456	19	16156	6	24	13	16132	16175	0.2502153333658911
R1	cpdb	0	network_modules	81	TRUE	1.4452143785974519e-9	271	30	11	0.36666666666666664	0.04059040590405904	GO:0044248	GO:BP	cellular catabolic process	16175	10939		0.047619047619047616	0.09090909090909091	271	15904	11	19	260	15885	16175	0.11751881843864904
R1	cpdb	0	network_modules	81	TRUE	3.7378358720506655e-9	21	29	6	0.20689655172413793	0.2857142857142857	REAC:R-HSA-70895	REAC	Branched-chain amino acid catabolism	10916	254		0	0.25	21	10895	6	23	15	10872	10916	0.2414244886879024
R1	cpdb	0	network_modules	81	TRUE	5.130231342261409e-9	22	29	6	0.20689655172413793	0.2727272727272727	REAC:R-HSA-71403	REAC	Citric acid cycle (TCA cycle)	10916	364		0.3333333333333333	0.5	22	10894	6	23	16	10871	10916	0.23577915998177965
R1	cpdb	0	network_modules	81	TRUE	7.886488688022475e-9	26	30	6	0.2	0.23076923076923078	GO:0009081	GO:BP	branched-chain amino acid metabolic process	16175	3254		0.09523809523809523	0.18181818181818182	26	16149	6	24	20	16125	16175	0.21347736252124527
R1	cpdb	0	network_modules	81	TRUE	7.886488688022475e-9	26	30	6	0.2	0.23076923076923078	GO:0006099	GO:BP	tricarboxylic acid cycle	16175	1959		0.09523809523809523	0.18181818181818182	26	16149	6	24	20	16125	16175	0.21347736252124527
R1	cpdb	0	network_modules	81	TRUE	3.0677069769260415e-7	742	30	13	0.43333333333333335	0.01752021563342318	GO:0019752	GO:BP	carboxylic acid metabolic process	16175	6036		0.19047619047619047	0.22727272727272727	742	15433	13	17	729	15416	16175	0.07983360047217626
R1	cpdb	0	network_modules	81	TRUE	4.191108661055888e-7	761	30	13	0.43333333333333335	0.017082785808147174	GO:0043436	GO:BP	oxoacid metabolic process	16175	10693		0.23809523809523808	0.2727272727272727	761	15414	13	17	748	15397	16175	0.07864012634664701
R1	cpdb	0	network_modules	81	TRUE	4.43851868431775e-7	93	30	7	0.23333333333333334	0.07526881720430108	GO:0009063	GO:BP	amino acid catabolic process	16175	3239		0.2857142857142857	0.3181818181818182	93	16082	7	23	86	16059	16175	0.12975245397791926
R1	cpdb	0	network_modules	81	TRUE	4.6171049663778433e-7	767	30	13	0.43333333333333335	0.01694915254237288	GO:0006082	GO:BP	organic acid metabolic process	16175	1947		0.3333333333333333	0.36363636363636365	767	15408	13	17	754	15391	16175	0.07827194863540608
R1	cpdb	0	network_modules	81	TRUE	1.855834929619687e-6	31	26	5	0.19230769230769232	0.16129032258064516	KEGG:00410	KEGG	beta-Alanine metabolism	8484	55		0.4	0.45454545454545453	31	8453	5	21	26	8432	8484	0.17335352098429488
R1	cpdb	0	network_modules	81	TRUE	4.939168185501022e-6	211	30	8	0.26666666666666666	0.037914691943127965	GO:0046395	GO:BP	carboxylic acid catabolic process	16175	12121		0.38095238095238093	0.45454545454545453	211	15964	8	22	203	15942	16175	0.0963519395487342
R1	cpdb	0	network_modules	81	TRUE	4.939168185501022e-6	211	30	8	0.26666666666666666	0.037914691943127965	GO:0016054	GO:BP	organic acid catabolic process	16175	5086		0.38095238095238093	0.45454545454545453	211	15964	8	22	203	15942	16175	0.0963519395487342
R1	cpdb	0	network_modules	81	TRUE	7.054455224251269e-6	40	26	5	0.19230769230769232	0.125	KEGG:00380	KEGG	Tryptophan metabolism	8484	48		0.5	0.5454545454545454	40	8444	5	21	35	8423	8484	0.15183289190615196
R1	cpdb	0	network_modules	81	TRUE	8.466736746244199e-6	3	30	3	0.1	1	GO:0006574	GO:BP	valine catabolic process	16175	2293		0.47619047619047616	0.5	3	16172	3	27	0	16145	16175	0.31596367634387357
R1	cpdb	0	network_modules	81	TRUE	1.7000715489997504e-5	247	30	8	0.26666666666666666	0.032388663967611336	GO:0006520	GO:BP	amino acid metabolic process	16175	2241		0.5238095238095238	0.5454545454545454	247	15928	8	22	239	15906	16175	0.0883721618201383
R1	cpdb	0	network_modules	81	TRUE	7.185217732486043e-5	63	26	5	0.19230769230769232	0.07936507936507936	KEGG:00310	KEGG	Lysine degradation	8484	34		0.6	0.6363636363636364	63	8421	5	21	58	8400	8484	0.11939768257124633
R1	cpdb	0	network_modules	81	TRUE	7.701340959942262e-5	300	30	8	0.26666666666666666	0.02666666666666667	GO:0044282	GO:BP	small molecule catabolic process	16175	10949		0.5714285714285714	0.5909090909090909	300	15875	8	22	292	15853	16175	0.07927373864797198
R1	cpdb	0	network_modules	81	TRUE	1.68699448068997e-4	6	30	3	0.1	0.5	GO:1901289	GO:BP	succinyl-CoA catabolic process	16175	21364		0.6190476190476191	0.6818181818181818	6	16169	3	27	3	16142	16175	0.2230255950735871
R1	cpdb	0	network_modules	81	TRUE	1.68699448068997e-4	6	30	3	0.1	0.5	GO:0006573	GO:BP	valine metabolic process	16175	2292		0.6190476190476191	0.6818181818181818	6	16169	3	27	3	16142	16175	0.2230255950735871
R1	cpdb	0	network_modules	81	TRUE	1.7115799558683868e-4	33	26	4	0.15384615384615385	0.12121212121212122	KEGG:01210	KEGG	2-Oxocarboxylic acid metabolism	8484	185		0.7	0.7272727272727273	33	8451	4	22	29	8429	8484	0.13356962530707944
R1	cpdb	0	network_modules	81	TRUE	5.055751330020074e-4	43	26	4	0.15384615384615385	0.09302325581395349	KEGG:00071	KEGG	Fatty acid degradation	8484	11		0.8	0.8181818181818182	43	8441	4	22	39	8419	8484	0.11616102039749893
R1	cpdb	0	network_modules	81	TRUE	5.279355181953937e-4	81	30	5	0.16666666666666666	0.06172839506172839	GO:1901606	GO:BP	alpha-amino acid catabolic process	16175	21590		0.7142857142857143	0.7272727272727273	81	16094	5	25	76	16069	16175	0.09872135493888862
R1	cpdb	0	network_modules	81	TRUE	6.583119160830756e-4	162	30	6	0.2	0.037037037037037035	GO:0009060	GO:BP	aerobic respiration	16175	3236		0.7619047619047619	0.7727272727272727	162	16013	6	24	156	15989	16175	0.08224515129359662
R1	cpdb	0	network_modules	81	TRUE	7.05879759773734e-4	9	30	3	0.1	0.3333333333333333	GO:0006104	GO:BP	succinyl-CoA metabolic process	16175	1963		0.8095238095238095	0.8181818181818182	9	16166	3	27	6	16139	16175	0.1817774998860541
R1	cpdb	0	network_modules	81	TRUE	7.246599674585565e-4	47	26	4	0.15384615384615385	0.0851063829787234	KEGG:00620	KEGG	Pyruvate metabolism	8484	99		0.9	0.9090909090909091	47	8437	4	22	43	8415	8484	0.11078224999022235
R1	cpdb	0	network_modules	81	TRUE	0.0011074776404206325	177	30	6	0.2	0.03389830508474576	GO:1901605	GO:BP	alpha-amino acid metabolic process	16175	21589		0.8571428571428571	0.8636363636363636	177	15998	6	24	171	15974	16175	0.07833567759044105
R1	cpdb	0	network_modules	81	TRUE	0.0012978153562815912	370	29	8	0.27586206896551724	0.021621621621621623	REAC:R-HSA-71291	REAC	Metabolism of amino acids and derivatives	10916	1421		0.6666666666666666	0.75	370	10546	8	21	362	10525	10916	0.06901119921642275
R1	cpdb	0	network_modules	81	TRUE	0.0015759035847330352	188	30	6	0.2	0.031914893617021274	GO:0045333	GO:BP	cellular respiration	16175	11360		0.9047619047619048	0.9090909090909091	188	15987	6	24	182	15963	16175	0.07576203732193998
R1	cpdb	0	network_modules	81	TRUE	0.0020343146722587974	177	29	6	0.20689655172413793	0.03389830508474576	REAC:R-HSA-1428517	REAC	Aerobic respiration and respiratory electron transport	10916	127		1	1	177	10739	6	23	171	10716	10916	0.07792003716270335
R1	cpdb	0	network_modules	81	TRUE	0.005547251227341671	153	26	5	0.19230769230769232	0.032679738562091505	KEGG:01240	KEGG	Biosynthesis of cofactors	8484	190		1	1	153	8331	5	21	148	8310	8484	0.07260912067981255
R1	cpdb	0	network_modules	81	TRUE	0.00838973961572868	558	30	8	0.26666666666666666	0.014336917562724014	GO:0055086	GO:BP	nucleobase-containing small molecule metabolic process	16175	14237		0.9523809523809523	0.9545454545454546	558	15617	8	22	550	15595	16175	0.054837063472022884
R1	cpdb	0	network_modules	81	TRUE	0.008597101006377245	252	30	6	0.2	0.023809523809523808	GO:0015980	GO:BP	energy derivation by oxidation of organic compounds	16175	5060		1	1	252	15923	6	24	246	15899	16175	0.06419218196585827
R1	cpdb	0	network_modules	83	TRUE	4.28555508222406e-6	21	15	4	0.26666666666666666	0.19047619047619047	REAC:R-HSA-5686938	REAC	Regulation of TLR by endogenous ligand	10916	2010		0	0.07142857142857142	21	10895	4	11	17	10884	10916	0.22411814508086372
R1	cpdb	0	network_modules	83	TRUE	1.2804549629892678e-5	76	15	5	0.3333333333333333	0.06578947368421052	REAC:R-HSA-3000178	REAC	ECM proteoglycans	10916	812		0.07692307692307693	0.14285714285714285	76	10840	5	10	71	10830	10916	0.14560162194568635
R1	cpdb	0	network_modules	83	TRUE	1.689737894212423e-5	29	15	4	0.26666666666666666	0.13793103448275862	REAC:R-HSA-5683826	REAC	Surfactant metabolism	10916	2364		0.15384615384615385	0.21428571428571427	29	10887	4	11	25	10876	10916	0.19025815438509427
R1	cpdb	0	network_modules	83	TRUE	1.766967525316107e-5	298	15	7	0.4666666666666667	0.02348993288590604	REAC:R-HSA-1474244	REAC	Extracellular matrix organization	10916	889		0.23076923076923078	0.2857142857142857	298	10618	7	8	291	10610	10916	0.10001709014646505
R1	cpdb	0	network_modules	83	TRUE	2.035880641194137e-5	502	17	8	0.47058823529411764	0.01593625498007968	GO:0071363	GO:BP	cellular response to growth factor stimulus	16175	16615		0	0.03125	502	15673	8	9	494	15664	16175	0.08221630632409203
R1	cpdb	0	network_modules	83	TRUE	2.303027194167216e-5	7	15	3	0.2	0.42857142857142855	REAC:R-HSA-5688849	REAC	Defective CSF2RB causes SMDP5	10916	512		0.3076923076923077	0.42857142857142855	7	10909	3	12	4	10897	10916	0.2921257058626122
R1	cpdb	0	network_modules	83	TRUE	2.303027194167216e-5	7	15	3	0.2	0.42857142857142855	REAC:R-HSA-5688890	REAC	Defective CSF2RA causes SMDP4	10916	511		0.3076923076923077	0.42857142857142855	7	10909	3	12	4	10897	10916	0.2921257058626122
R1	cpdb	0	network_modules	83	TRUE	2.639464832205262e-5	519	17	8	0.47058823529411764	0.015414258188824663	GO:0070848	GO:BP	response to growth factor	16175	16340		0.03225806451612903	0.0625	519	15656	8	9	511	15647	16175	0.08070902974758279
R1	cpdb	0	network_modules	83	TRUE	3.395468612332479e-5	790	17	9	0.5294117647058824	0.01139240506329114	GO:0007167	GO:BP	enzyme-linked receptor protein signaling pathway	16175	2731		0.06451612903225806	0.09375	790	15385	9	8	781	15377	16175	0.07232195821820352
R1	cpdb	0	network_modules	83	TRUE	4.668431073915964e-5	37	15	4	0.26666666666666666	0.10810810810810811	REAC:R-HSA-2129379	REAC	Molecules associated with elastic fibres	10916	1490		0.46153846153846156	0.5	37	10879	4	11	33	10868	10916	0.16803269731353737
R1	cpdb	0	network_modules	83	TRUE	5.518151557000285e-5	9	15	3	0.2	0.3333333333333333	REAC:R-HSA-5687613	REAC	Diseases associated with surfactant metabolism	10916	752		0.5384615384615384	0.5714285714285714	9	10907	3	12	6	10895	10916	0.25741748318742463
R1	cpdb	0	network_modules	83	TRUE	5.637592885688868e-5	35	17	4	0.23529411764705882	0.11428571428571428	GO:0060391	GO:BP	positive regulation of SMAD protein signal transduction	16175	14596		0.0967741935483871	0.125	35	16140	4	13	31	16127	16175	0.1627375803989863
R1	cpdb	0	network_modules	83	TRUE	9.541521410566976e-5	44	15	4	0.26666666666666666	0.09090909090909091	REAC:R-HSA-1566948	REAC	Elastic fibre formation	10916	836		0.6153846153846154	0.6428571428571429	44	10872	4	11	40	10861	10916	0.15376199095508647
R1	cpdb	0	network_modules	83	TRUE	1.597365928349906e-4	245	15	6	0.4	0.024489795918367346	REAC:R-HSA-5668914	REAC	Diseases of metabolism	10916	767		0.6923076923076923	0.7142857142857143	245	10671	6	9	239	10662	10916	0.09455219696396953
R1	cpdb	0	network_modules	83	TRUE	1.6335673667280715e-4	121	17	5	0.29411764705882354	0.04132231404958678	GO:0033002	GO:BP	muscle cell proliferation	16175	7971		0.12903225806451613	0.15625	121	16054	5	12	116	16042	16175	0.10790034503049922
R1	cpdb	0	network_modules	83	TRUE	2.381353664577551e-4	14	15	3	0.2	0.21428571428571427	REAC:R-HSA-391160	REAC	Signal regulatory protein family interactions	10916	2215		0.7692307692307693	0.7857142857142857	14	10902	3	12	11	10890	10916	0.2059657220886868
R1	cpdb	0	network_modules	83	TRUE	3.116507693496662e-4	53	17	4	0.23529411764705882	0.07547169811320754	GO:0060390	GO:BP	regulation of SMAD protein signal transduction	16175	14595		0.16129032258064516	0.1875	53	16122	4	13	49	16109	16175	0.1316886106439967
R1	cpdb	0	network_modules	83	TRUE	8.524313257800524e-4	107	13	4	0.3076923076923077	0.037383177570093455	KEGG:04350	KEGG	TGF-beta signaling pathway	8484	304		NA	1	107	8377	4	9	103	8368	8484	0.1035879198989004
R1	cpdb	0	network_modules	83	TRUE	0.0010221790280842819	71	17	4	0.23529411764705882	0.056338028169014086	GO:0060395	GO:BP	SMAD protein signal transduction	16175	14598		0.1935483870967742	0.21875	71	16104	4	13	67	16091	16175	0.11329520505326621
R1	cpdb	0	network_modules	83	TRUE	0.001025305395298596	18	17	3	0.17647058823529413	0.16666666666666666	GO:0062009	GO:BP	secondary palate development	16175	15779		0.22580645161290322	0.25	18	16157	3	14	15	16143	16175	0.170601687161713
R1	cpdb	0	network_modules	83	TRUE	0.0010553078840393672	176	17	5	0.29411764705882354	0.028409090909090908	GO:0007179	GO:BP	transforming growth factor beta receptor signaling pathway	16175	2741		0.25806451612903225	0.28125	176	15999	5	12	171	15987	16175	0.08855674724437064
R1	cpdb	0	network_modules	83	TRUE	0.0013680235814271934	2	17	2	0.11764705882352941	1	GO:0042704	GO:BP	uterine wall breakdown	16175	10314		0.2903225806451613	0.34375	2	16173	2	15	0	16158	16175	0.342838073300585
R1	cpdb	0	network_modules	83	TRUE	0.0013680235814271934	2	17	2	0.11764705882352941	1	GO:0070483	GO:BP	detection of hypoxia	16175	16144		0.2903225806451613	0.34375	2	16173	2	15	0	16158	16175	0.342838073300585
R1	cpdb	0	network_modules	83	TRUE	0.001654230542270148	80	17	4	0.23529411764705882	0.05	GO:0090100	GO:BP	positive regulation of transmembrane receptor protein serine/threonine kinase signaling pathway	16175	18018		0.3548387096774194	0.375	80	16095	4	13	76	16082	16175	0.10650483219289804
R1	cpdb	0	network_modules	83	TRUE	0.001667893992958556	21	17	3	0.17647058823529413	0.14285714285714285	GO:0061384	GO:BP	heart trabecula morphogenesis	16175	15455		0.3870967741935484	0.40625	21	16154	3	14	18	16140	16175	0.15779406522265696
R1	cpdb	0	network_modules	83	TRUE	0.00208338718137462	202	17	5	0.29411764705882354	0.024752475247524754	GO:0071560	GO:BP	cellular response to transforming growth factor beta stimulus	16175	16762		0.41935483870967744	0.4375	202	15973	5	12	197	15961	16175	0.08225906319773577
R1	cpdb	0	network_modules	83	TRUE	0.00229338599737792	626	17	7	0.4117647058823529	0.011182108626198083	GO:0035295	GO:BP	tube development	16175	8953		0.45161290322580644	0.46875	626	15549	7	10	619	15539	16175	0.06273627587513013
R1	cpdb	0	network_modules	83	TRUE	0.0024062233175956315	208	17	5	0.29411764705882354	0.02403846153846154	GO:0071559	GO:BP	response to transforming growth factor beta	16175	16761		0.4838709677419355	0.5	208	15967	5	12	203	15955	16175	0.0809723902594397
R1	cpdb	0	network_modules	83	TRUE	0.002533267294692851	24	17	3	0.17647058823529413	0.125	GO:0060317	GO:BP	cardiac epithelial to mesenchymal transition	16175	14529		0.5161290322580645	0.53125	24	16151	3	14	21	16137	16175	0.1474602446488705
R1	cpdb	0	network_modules	83	TRUE	0.0028768435353760946	25	17	3	0.17647058823529413	0.12	GO:0060038	GO:BP	cardiac muscle cell proliferation	16175	14301		0.5483870967741935	0.59375	25	16150	3	14	22	16136	16175	0.14443436822943198
R1	cpdb	0	network_modules	83	TRUE	0.0028768435353760946	25	17	3	0.17647058823529413	0.12	GO:0061383	GO:BP	trabecula morphogenesis	16175	15454		0.5483870967741935	0.59375	25	16150	3	14	22	16136	16175	0.14443436822943198
R1	cpdb	0	network_modules	83	TRUE	0.004472092402923805	236	17	5	0.29411764705882354	0.0211864406779661	GO:0030198	GO:BP	extracellular matrix organization	16175	6707		0.6129032258064516	0.625	236	15939	5	12	231	15927	16175	0.07561579660992382
R1	cpdb	0	network_modules	83	TRUE	0.004565625486404774	237	17	5	0.29411764705882354	0.02109704641350211	GO:0043062	GO:BP	extracellular structure organization	16175	10509		0.6451612903225806	0.65625	237	15938	5	12	232	15926	16175	0.07544177876247031
R1	cpdb	0	network_modules	83	TRUE	0.004587820240655234	115	15	4	0.26666666666666666	0.034782608695652174	REAC:R-HSA-168179	REAC	Toll Like Receptor TLR1:TLR2 Cascade	10916	2520		0.8461538461538461	0.9285714285714286	115	10801	4	11	111	10790	10916	0.09305899720434238
R1	cpdb	0	network_modules	83	TRUE	0.004587820240655234	115	15	4	0.26666666666666666	0.034782608695652174	REAC:R-HSA-181438	REAC	Toll Like Receptor 2 (TLR2) Cascade	10916	2514		0.8461538461538461	0.9285714285714286	115	10801	4	11	111	10790	10916	0.09305899720434238
R1	cpdb	0	network_modules	83	TRUE	0.004660692656383113	238	17	5	0.29411764705882354	0.02100840336134454	GO:0045229	GO:BP	external encapsulating structure organization	16175	11340		0.6774193548387096	0.6875	238	15937	5	12	233	15925	16175	0.07526882787835135
R1	cpdb	0	network_modules	83	TRUE	0.006175829868523712	32	17	3	0.17647058823529413	0.09375	GO:0055017	GO:BP	cardiac muscle tissue growth	16175	14206		0.7096774193548387	0.71875	32	16143	3	14	29	16129	16175	0.12737491874836507
R1	cpdb	0	network_modules	83	TRUE	0.0066556023522150315	256	17	5	0.29411764705882354	0.01953125	GO:0090287	GO:BP	regulation of cellular response to growth factor stimulus	16175	18171		0.7419354838709677	0.75	256	15919	5	12	251	15907	16175	0.07232623382995247
R1	cpdb	0	network_modules	83	TRUE	0.007441166122930399	34	17	3	0.17647058823529413	0.08823529411764706	GO:0014855	GO:BP	striated muscle cell proliferation	16175	4732		0.7741935483870968	0.78125	34	16141	3	14	31	16127	16175	0.12349190753907653
R1	cpdb	0	network_modules	83	TRUE	0.008133490203624773	35	17	3	0.17647058823529413	0.08571428571428572	GO:0055010	GO:BP	ventricular cardiac muscle tissue morphogenesis	16175	14199		0.8064516129032258	0.8125	35	16140	3	14	32	16126	16175	0.1216755670934157
R1	cpdb	0	network_modules	83	TRUE	0.008197994358362042	4	17	2	0.11764705882352941	0.5	GO:1905005	GO:BP	regulation of epithelial to mesenchymal transition involved in endocardial cushion formation	16175	24290		0.8387096774193549	0.90625	4	16171	2	15	2	16156	16175	0.2421830455760906
R1	cpdb	0	network_modules	83	TRUE	0.008197994358362042	4	17	2	0.11764705882352941	0.5	GO:1905007	GO:BP	positive regulation of epithelial to mesenchymal transition involved in endocardial cushion formation	16175	24292		0.8387096774193549	0.90625	4	16171	2	15	2	16156	16175	0.2421830455760906
R1	cpdb	0	network_modules	83	TRUE	0.008197994358362042	4	17	2	0.11764705882352941	0.5	GO:0003032	GO:BP	detection of oxygen	16175	1483		0.8387096774193549	0.90625	4	16171	2	15	2	16156	16175	0.2421830455760906
R1	cpdb	0	network_modules	83	TRUE	0.009433770365645851	275	17	5	0.29411764705882354	0.01818181818181818	GO:0141091	GO:BP	transforming growth factor beta receptor superfamily signaling pathway	16175	20020		0.9354838709677419	0.9375	275	15900	5	12	270	15888	16175	0.0695299312043102
R1	cpdb	0	network_modules	83	TRUE	0.009643264396870422	37	17	3	0.17647058823529413	0.08108108108108109	GO:0060021	GO:BP	roof of mouth development	16175	14284		0.967741935483871	0.96875	37	16138	3	14	34	16124	16175	0.1182647355350957
R1	cpdb	0	network_modules	83	TRUE	0.00967214551340109	46	15	3	0.2	0.06521739130434782	REAC:R-HSA-2173789	REAC	TGF-beta receptor signaling activates SMADs	10916	2428		1	1	46	10870	3	12	43	10858	10916	0.11211505578003038
R1	cpdb	0	network_modules	83	TRUE	0.009960529489760346	781	17	7	0.4117647058823529	0.008962868117797696	GO:0030334	GO:BP	regulation of cell migration	16175	6780		1	1	781	15394	7	10	774	15384	16175	0.05499897395476611
R1	cpdb	0	network_modules	84	TRUE	2.0067498570341592e-22	15	28	10	0.35714285714285715	0.6666666666666666	GO:1904507	GO:BP	positive regulation of telomere maintenance in response to DNA damage	16175	23869		0	0.02040816326530612	15	16160	10	18	5	16142	16175	0.48733083082639167
R1	cpdb	0	network_modules	84	TRUE	1.296978906994594e-21	17	28	10	0.35714285714285715	0.5882352941176471	GO:0060382	GO:BP	regulation of DNA strand elongation	16175	14590		0.020833333333333332	0.04081632653061224	17	16158	10	18	7	16140	16175	0.4576370282626229
R1	cpdb	0	network_modules	84	TRUE	2.915247481060028e-21	18	28	10	0.35714285714285715	0.5555555555555556	GO:1904505	GO:BP	regulation of telomere maintenance in response to DNA damage	16175	23867		0.041666666666666664	0.061224489795918366	18	16157	10	18	8	16139	16175	0.44467979484719716
R1	cpdb	0	network_modules	84	TRUE	1.3196467763683907e-18	29	28	10	0.35714285714285715	0.3448275862068966	GO:0043247	GO:BP	telomere maintenance in response to DNA damage	16175	10583		0.0625	0.08163265306122448	29	16146	10	18	19	16128	16175	0.3497858111859656
R1	cpdb	0	network_modules	84	TRUE	2.6079792059859307e-18	116	16	12	0.75	0.10344827586206896	KEGG:03082	KEGG	ATP-dependent chromatin remodeling	8484	219		NA	1	116	8368	12	4	104	8364	8484	0.2756139797850986
R1	cpdb	0	network_modules	84	TRUE	2.2763808791475894e-17	37	28	10	0.35714285714285715	0.2702702702702703	GO:0022616	GO:BP	DNA strand elongation	16175	6623		0.08333333333333333	0.10204081632653061	37	16138	10	18	27	16120	16175	0.3093164765474533
R1	cpdb	0	network_modules	84	TRUE	4.200596588818047e-17	38	24	10	0.4166666666666667	0.2631578947368421	REAC:R-HSA-5696394	REAC	DNA Damage Recognition in GG-NER	10916	439		0	0.125	38	10878	10	14	28	10864	10916	0.32930181037053596
R1	cpdb	0	network_modules	84	TRUE	3.1699118672991135e-16	112	28	12	0.42857142857142855	0.10714285714285714	GO:0006275	GO:BP	regulation of DNA replication	16175	2090		0.10416666666666667	0.12244897959183673	112	16063	12	16	100	16047	16175	0.21174064108628107
R1	cpdb	0	network_modules	84	TRUE	2.1511465788428334e-14	69	28	10	0.35714285714285715	0.14492753623188406	GO:0032206	GO:BP	positive regulation of telomere maintenance	16175	7398		0.125	0.16326530612244897	69	16106	10	18	59	16088	16175	0.22546667509750765
R1	cpdb	0	network_modules	84	TRUE	2.1511465788428334e-14	69	28	10	0.35714285714285715	0.14492753623188406	GO:0045995	GO:BP	regulation of embryonic development	16175	11787		0.125	0.16326530612244897	69	16106	10	18	59	16088	16175	0.22546667509750765
R1	cpdb	0	network_modules	84	TRUE	2.3246074995718924e-13	84	24	10	0.4166666666666667	0.11904761904761904	REAC:R-HSA-5696399	REAC	Global Genome Nucleotide Excision Repair (GG-NER)	10916	1047		0.14285714285714285	0.25	84	10832	10	14	74	10818	10916	0.2196921049125949
R1	cpdb	0	network_modules	84	TRUE	8.603021008534121e-13	98	28	10	0.35714285714285715	0.10204081632653061	GO:2001252	GO:BP	positive regulation of chromosome organization	16175	26441		0.16666666666666666	0.1836734693877551	98	16077	10	18	88	16059	16175	0.1883965868322302
R1	cpdb	0	network_modules	84	TRUE	1.5935110030616193e-12	104	28	10	0.35714285714285715	0.09615384615384616	GO:0032204	GO:BP	regulation of telomere maintenance	16175	7396		0.1875	0.20408163265306123	104	16071	10	18	94	16053	16175	0.1827222151316314
R1	cpdb	0	network_modules	84	TRUE	1.7558684351522895e-12	102	24	10	0.4166666666666667	0.09803921568627451	REAC:R-HSA-5689603	REAC	UCH proteinases	10916	2615		0.2857142857142857	0.375	102	10814	10	14	92	10800	10916	0.19872868273824354
R1	cpdb	0	network_modules	84	TRUE	2.3179303635440875e-12	231	28	12	0.42857142857142855	0.05194805194805195	GO:0006260	GO:BP	DNA replication	16175	2077		0.20833333333333334	0.22448979591836735	231	15944	12	16	219	15928	16175	0.14540432903653389
R1	cpdb	0	network_modules	84	TRUE	3.4856041716876667e-12	109	24	10	0.4166666666666667	0.09174311926605505	REAC:R-HSA-5696398	REAC	Nucleotide Excision Repair	10916	1622		0.42857142857142855	0.5	109	10807	10	14	99	10793	10916	0.1920011083170177
R1	cpdb	0	network_modules	84	TRUE	1.2471926217723781e-11	127	28	10	0.35714285714285715	0.07874015748031496	GO:0045739	GO:BP	positive regulation of DNA repair	16175	11579		0.22916666666666666	0.24489795918367346	127	16048	10	18	117	16030	16175	0.16479830892494
R1	cpdb	0	network_modules	84	TRUE	7.794683149608967e-11	152	28	10	0.35714285714285715	0.06578947368421052	GO:0000723	GO:BP	telomere maintenance	16175	202		0.25	0.2653061224489796	152	16023	10	18	142	16005	16175	0.15008779063780575
R1	cpdb	0	network_modules	84	TRUE	2.373727270152873e-10	246	28	11	0.39285714285714285	0.044715447154471545	GO:0051054	GO:BP	positive regulation of DNA metabolic process	16175	13464		0.2708333333333333	0.2857142857142857	246	15929	11	17	235	15912	16175	0.12850005761340122
R1	cpdb	0	network_modules	84	TRUE	2.4910186670669806e-10	454	28	13	0.4642857142857143	0.028634361233480177	GO:0006338	GO:BP	chromatin remodeling	16175	2126		0.2916666666666667	0.30612244897959184	454	15721	13	15	441	15706	16175	0.10997973369002847
R1	cpdb	0	network_modules	84	TRUE	4.817492575826309e-10	182	28	10	0.35714285714285715	0.054945054945054944	GO:0032200	GO:BP	telomere organization	16175	7392		0.3125	0.32653061224489793	182	15993	10	18	172	15975	16175	0.13655760385314536
R1	cpdb	0	network_modules	84	TRUE	1.7439030683065303e-9	529	28	13	0.4642857142857143	0.024574669187145556	GO:0006325	GO:BP	chromatin organization	16175	2122		0.3333333333333333	0.3469387755102041	529	15646	13	15	516	15631	16175	0.10104390522536749
R1	cpdb	0	network_modules	84	TRUE	1.7543854506117358e-9	207	28	10	0.35714285714285715	0.04830917874396135	GO:0006282	GO:BP	regulation of DNA repair	16175	2096		0.3541666666666667	0.3673469387755102	207	15968	10	18	197	15950	16175	0.12757369817379935
R1	cpdb	0	network_modules	84	TRUE	4.375019968871867e-9	435	28	12	0.42857142857142855	0.027586206896551724	GO:0051052	GO:BP	regulation of DNA metabolic process	16175	13462		0.375	0.3877551020408163	435	15740	12	16	423	15724	16175	0.10339713770362406
R1	cpdb	0	network_modules	84	TRUE	4.617228058337034e-9	437	28	12	0.42857142857142855	0.02745995423340961	GO:0080135	GO:BP	regulation of cellular response to stress	16175	17817		0.3958333333333333	0.40816326530612246	437	15738	12	16	425	15722	16175	0.10313505669199358
R1	cpdb	0	network_modules	84	TRUE	4.8122189067804076e-9	229	28	10	0.35714285714285715	0.043668122270742356	GO:0033044	GO:BP	regulation of chromosome organization	16175	7999		0.4166666666666667	0.42857142857142855	229	15946	10	18	219	15928	16175	0.12089522556364228
R1	cpdb	0	network_modules	84	TRUE	8.572617068659613e-9	329	24	11	0.4583333333333333	0.03343465045592705	REAC:R-HSA-73894	REAC	DNA Repair	10916	444		0.5714285714285714	0.625	329	10587	11	13	318	10574	10916	0.11756325256206353
R1	cpdb	0	network_modules	84	TRUE	1.4433938821616081e-8	12	28	5	0.17857142857142858	0.4166666666666667	GO:0032933	GO:BP	SREBP signaling pathway	16175	7923		0.4375	0.4489795918367347	12	16163	5	23	7	16140	16175	0.2719754382024817
R1	cpdb	0	network_modules	84	TRUE	2.3427344955964454e-8	13	28	5	0.17857142857142858	0.38461538461538464	GO:0071501	GO:BP	cellular response to sterol depletion	16175	16734		0.4583333333333333	0.46938775510204084	13	16162	5	23	8	16139	16175	0.2612227849363993
R1	cpdb	0	network_modules	84	TRUE	3.639933385192927e-8	14	28	5	0.17857142857142858	0.35714285714285715	GO:0006991	GO:BP	response to sterol depletion	16175	2609		0.4791666666666667	0.4897959183673469	14	16161	5	23	9	16138	16175	0.251640816132933
R1	cpdb	0	network_modules	84	TRUE	8.538740435786727e-8	298	24	10	0.4166666666666667	0.03355704697986577	REAC:R-HSA-5688426	REAC	Deubiquitination	10916	736		0.7142857142857143	0.75	298	10618	10	14	288	10604	10916	0.11216188591491319
R1	cpdb	0	network_modules	84	TRUE	1.5261570500596998e-7	43	28	6	0.21428571428571427	0.13953488372093023	GO:0006695	GO:BP	cholesterol biosynthetic process	16175	2403		0.5	0.5306122448979592	43	16132	6	22	37	16110	16175	0.1711475632460128
R1	cpdb	0	network_modules	84	TRUE	1.5261570500596998e-7	43	28	6	0.21428571428571427	0.13953488372093023	GO:1902653	GO:BP	secondary alcohol biosynthetic process	16175	22419		0.5	0.5306122448979592	43	16132	6	22	37	16110	16175	0.1711475632460128
R1	cpdb	0	network_modules	84	TRUE	2.675460650047641e-7	47	28	6	0.21428571428571427	0.1276595744680851	GO:0016126	GO:BP	sterol biosynthetic process	16175	5144		0.5416666666666666	0.5510204081632653	47	16128	6	22	41	16106	16175	0.16353174858183692
R1	cpdb	0	network_modules	84	TRUE	6.533296852226088e-7	512	28	11	0.39285714285714285	0.021484375	GO:0009790	GO:BP	embryo development	16175	3677		0.5625	0.5714285714285714	512	15663	11	17	501	15646	16175	0.08591256883083438
R1	cpdb	0	network_modules	84	TRUE	9.050903476654908e-7	528	28	11	0.39285714285714285	0.020833333333333332	GO:0006281	GO:BP	DNA repair	16175	2095		0.5833333333333334	0.5918367346938775	528	15647	11	17	517	15630	16175	0.08441228939858268
R1	cpdb	0	network_modules	84	TRUE	1.2653104467838872e-6	545	28	11	0.39285714285714285	0.02018348623853211	GO:0051276	GO:BP	chromosome organization	16175	13613		0.6041666666666666	0.6122448979591837	545	15630	11	17	534	15613	16175	0.08288795770043557
R1	cpdb	0	network_modules	84	TRUE	1.8657230902080426e-6	420	28	10	0.35714285714285715	0.023809523809523808	GO:0010638	GO:BP	positive regulation of organelle organization	16175	4284		0.625	0.6326530612244898	420	15755	10	18	410	15737	16175	0.08671685482820897
R1	cpdb	0	network_modules	84	TRUE	1.319558994688134e-5	41	28	5	0.17857142857142858	0.12195121951219512	GO:0006984	GO:BP	ER-nucleus signaling pathway	16175	2607		0.6458333333333334	0.6530612244897959	41	16134	5	23	36	16111	16175	0.1457865738344135
R1	cpdb	0	network_modules	84	TRUE	1.920295720830298e-5	94	28	6	0.21428571428571427	0.06382978723404255	GO:0008203	GO:BP	cholesterol metabolic process	16175	3130		0.6666666666666666	0.673469387755102	94	16081	6	22	88	16059	16175	0.11421138700346073
R1	cpdb	0	network_modules	84	TRUE	3.33689161497643e-5	103	28	6	0.21428571428571427	0.05825242718446602	GO:1902652	GO:BP	secondary alcohol metabolic process	16175	22418		0.6875	0.6938775510204082	103	16072	6	22	97	16050	16175	0.10884678610320614
R1	cpdb	0	network_modules	84	TRUE	4.1979637061950446e-5	107	28	6	0.21428571428571427	0.056074766355140186	GO:0016125	GO:BP	sterol metabolic process	16175	5143		0.7083333333333334	0.7142857142857143	107	16068	6	22	101	16046	16175	0.10667914630343617
R1	cpdb	0	network_modules	84	TRUE	4.957764957982886e-5	110	28	6	0.21428571428571427	0.05454545454545454	GO:0046165	GO:BP	alcohol biosynthetic process	16175	11935		0.7291666666666666	0.7346938775510204	110	16065	6	22	104	16043	16175	0.10513022188465886
R1	cpdb	0	network_modules	84	TRUE	6.734855028665951e-5	798	28	11	0.39285714285714285	0.013784461152882205	GO:0006974	GO:BP	DNA damage response	16175	2601		0.75	0.7551020408163265	798	15377	11	17	787	15360	16175	0.06605327684186973
R1	cpdb	0	network_modules	84	TRUE	1.7644795066953258e-4	136	28	6	0.21428571428571427	0.04411764705882353	GO:0006694	GO:BP	steroid biosynthetic process	16175	2402		0.7708333333333334	0.7755102040816326	136	16039	6	22	130	16017	16175	0.09389199007481464
R1	cpdb	0	network_modules	84	TRUE	2.7904078941657794e-4	7	28	3	0.10714285714285714	0.42857142857142855	GO:0106120	GO:BP	positive regulation of sterol biosynthetic process	16175	19268		0.7916666666666666	0.8163265306122449	7	16168	3	25	4	16143	16175	0.2136513790804247
R1	cpdb	0	network_modules	84	TRUE	2.7904078941657794e-4	7	28	3	0.10714285714285714	0.42857142857142855	GO:0045542	GO:BP	positive regulation of cholesterol biosynthetic process	16175	11421		0.7916666666666666	0.8163265306122449	7	16168	3	25	4	16143	16175	0.2136513790804247
R1	cpdb	0	network_modules	84	TRUE	0.0012715972653504718	190	28	6	0.21428571428571427	0.031578947368421054	GO:1901617	GO:BP	organic hydroxy compound biosynthetic process	16175	21599		0.8333333333333334	0.8367346938775511	190	15985	6	22	184	15963	16175	0.078280453759346
R1	cpdb	0	network_modules	84	TRUE	0.0015114436073934555	53	24	4	0.16666666666666666	0.07547169811320754	REAC:R-HSA-1655829	REAC	Regulation of cholesterol biosynthesis by SREBP (SREBF)	10916	2023		0.8571428571428571	0.875	53	10863	4	20	49	10843	10916	0.10927269261079192
R1	cpdb	0	network_modules	84	TRUE	0.001743828060791088	12	28	3	0.10714285714285714	0.25	GO:0090205	GO:BP	positive regulation of cholesterol metabolic process	16175	18105		0.8541666666666666	0.8571428571428571	12	16163	3	25	9	16138	16175	0.16273140207277706
R1	cpdb	0	network_modules	84	TRUE	0.004418291146288086	16	28	3	0.10714285714285714	0.1875	GO:0045540	GO:BP	regulation of cholesterol biosynthetic process	16175	11419		0.875	0.8979591836734694	16	16159	3	25	13	16134	16175	0.14061938357001555
R1	cpdb	0	network_modules	84	TRUE	0.004418291146288086	16	28	3	0.10714285714285714	0.1875	GO:0106118	GO:BP	regulation of sterol biosynthetic process	16175	19266		0.875	0.8979591836734694	16	16159	3	25	13	16134	16175	0.14061938357001555
R1	cpdb	0	network_modules	84	TRUE	0.004982325234183615	2	28	2	0.07142857142857142	1	GO:0036316	GO:BP	SREBP-SCAP complex retention in endoplasmic reticulum	16175	9561		0.9166666666666666	0.9183673469387755	2	16173	2	26	0	16147	16175	0.2670463285603229
R1	cpdb	0	network_modules	84	TRUE	0.005192423754733805	152	24	5	0.20833333333333334	0.03289473684210526	REAC:R-HSA-8957322	REAC	Metabolism of steroids	10916	1438		1	1	152	10764	5	19	147	10745	10916	0.07787941035360384
R1	cpdb	0	network_modules	84	TRUE	0.005196405351359643	242	28	6	0.21428571428571427	0.024793388429752067	GO:0008202	GO:BP	steroid metabolic process	16175	3129		0.9375	0.9387755102040817	242	15933	6	22	236	15911	16175	0.06837247276369113
R1	cpdb	0	network_modules	84	TRUE	0.005358849775277653	17	28	3	0.10714285714285714	0.17647058823529413	GO:0010893	GO:BP	positive regulation of steroid biosynthetic process	16175	4479		0.9583333333333334	0.9795918367346939	17	16158	3	25	14	16133	16175	0.13634560791566383
R1	cpdb	0	network_modules	84	TRUE	0.005358849775277653	17	28	3	0.10714285714285714	0.17647058823529413	GO:1902932	GO:BP	positive regulation of alcohol biosynthetic process	16175	22628		0.9583333333333334	0.9795918367346939	17	16158	3	25	14	16133	16175	0.13634560791566383
R1	cpdb	0	network_modules	84	TRUE	0.00735103991612486	257	28	6	0.21428571428571427	0.023346303501945526	GO:0006066	GO:BP	alcohol metabolic process	16175	1933		1	1	257	15918	6	22	251	15896	16175	0.0660695981069518
R1	cpdb	0	network_modules	85	TRUE	6.059900074365747e-30	103	24	17	0.7083333333333334	0.1650485436893204	GO:0006368	GO:BP	transcription elongation by RNA polymerase II	16175	2143		0	0.0625	103	16072	17	7	86	16065	16175	0.34018282562842644
R1	cpdb	0	network_modules	85	TRUE	7.322590586374228e-29	118	24	17	0.7083333333333334	0.1440677966101695	GO:0006354	GO:BP	DNA-templated transcription elongation	16175	2131		0.06666666666666667	0.125	118	16057	17	7	101	16050	16175	0.31755476308062214
R1	cpdb	0	network_modules	85	TRUE	5.615672272708214e-24	81	24	14	0.5833333333333334	0.1728395061728395	GO:0034243	GO:BP	regulation of transcription elongation by RNA polymerase II	16175	8519		0.13333333333333333	0.1875	81	16094	14	10	67	16084	16175	0.3158261708124292
R1	cpdb	0	network_modules	85	TRUE	7.306396819640944e-23	96	24	14	0.5833333333333334	0.14583333333333334	GO:0032784	GO:BP	regulation of DNA-templated transcription elongation	16175	7819		0.2	0.25	96	16079	14	10	82	16069	16175	0.2897747431259883
R1	cpdb	0	network_modules	85	TRUE	6.190770337636361e-21	73	23	13	0.5652173913043478	0.1780821917808219	REAC:R-HSA-6807505	REAC	RNA polymerase II transcribes snRNA genes	10916	1904		0	0.043478260869565216	73	10843	13	10	60	10833	10916	0.3148937263452677
R1	cpdb	0	network_modules	85	TRUE	1.1983815559749838e-17	57	23	11	0.4782608695652174	0.19298245614035087	REAC:R-HSA-75955	REAC	RNA Polymerase II Transcription Elongation	10916	1891		0.045454545454545456	0.13043478260869565	57	10859	11	12	46	10847	10916	0.3015910566448451
R1	cpdb	0	network_modules	85	TRUE	1.1983815559749838e-17	57	23	11	0.4782608695652174	0.19298245614035087	REAC:R-HSA-112382	REAC	Formation of RNA Pol II elongation complex 	10916	949		0.045454545454545456	0.13043478260869565	57	10859	11	12	46	10847	10916	0.3015910566448451
R1	cpdb	0	network_modules	85	TRUE	6.648387054396661e-16	80	23	11	0.4782608695652174	0.1375	REAC:R-HSA-674695	REAC	RNA Polymerase II Pre-transcription Events	10916	1888		0.13636363636363635	0.17391304347826086	80	10836	11	12	69	10824	10916	0.2537070685717122
R1	cpdb	0	network_modules	85	TRUE	8.472875818717068e-14	57	24	9	0.375	0.15789473684210525	GO:0016073	GO:BP	snRNA metabolic process	16175	5100		0.26666666666666666	0.3125	57	16118	9	15	48	16103	16175	0.24165067308859692
R1	cpdb	0	network_modules	85	TRUE	1.7578648341210213e-13	34	24	8	0.3333333333333333	0.23529411764705882	GO:0016180	GO:BP	snRNA processing	16175	5161		0.3333333333333333	0.375	34	16141	8	16	26	16125	16175	0.2787898286852164
R1	cpdb	0	network_modules	85	TRUE	2.1423569140370074e-12	80	24	9	0.375	0.1125	GO:0031123	GO:BP	RNA 3'-end processing	16175	7048		0.4	0.4375	80	16095	9	15	71	16080	16175	0.20334098971153014
R1	cpdb	0	network_modules	85	TRUE	4.358042259155101e-11	30	23	7	0.30434782608695654	0.23333333333333334	REAC:R-HSA-167238	REAC	Pausing and recovery of Tat-mediated HIV elongation	10916	1720		0.18181818181818182	0.2608695652173913	30	10886	7	16	23	10870	10916	0.26472174321610376
R1	cpdb	0	network_modules	85	TRUE	4.358042259155101e-11	30	23	7	0.30434782608695654	0.23333333333333334	REAC:R-HSA-167243	REAC	Tat-mediated HIV elongation arrest and recovery	10916	2484		0.18181818181818182	0.2608695652173913	30	10886	7	16	23	10870	10916	0.26472174321610376
R1	cpdb	0	network_modules	85	TRUE	7.186788143274099e-11	32	23	7	0.30434782608695654	0.21875	REAC:R-HSA-167287	REAC	HIV elongation arrest and recovery	10916	1106		0.2727272727272727	0.34782608695652173	32	10884	7	16	25	10868	10916	0.2561835520700288
R1	cpdb	0	network_modules	85	TRUE	7.186788143274099e-11	32	23	7	0.30434782608695654	0.21875	REAC:R-HSA-167290	REAC	Pausing and recovery of HIV elongation	10916	1719		0.2727272727272727	0.34782608695652173	32	10884	7	16	25	10868	10916	0.2561835520700288
R1	cpdb	0	network_modules	85	TRUE	5.686790307806048e-10	42	23	7	0.30434782608695654	0.16666666666666666	REAC:R-HSA-167246	REAC	Tat-mediated elongation of the HIV-1 transcript	10916	2485		0.36363636363636365	0.4782608695652174	42	10874	7	16	35	10858	10916	0.22303819404313482
R1	cpdb	0	network_modules	85	TRUE	5.686790307806048e-10	42	23	7	0.30434782608695654	0.16666666666666666	REAC:R-HSA-167169	REAC	HIV Transcription Elongation	10916	1104		0.36363636363636365	0.4782608695652174	42	10874	7	16	35	10858	10916	0.22303819404313482
R1	cpdb	0	network_modules	85	TRUE	5.686790307806048e-10	42	23	7	0.30434782608695654	0.16666666666666666	REAC:R-HSA-167200	REAC	Formation of HIV-1 elongation complex containing HIV-1 Tat	10916	947		0.36363636363636365	0.4782608695652174	42	10874	7	16	35	10858	10916	0.22303819404313482
R1	cpdb	0	network_modules	85	TRUE	6.218717916120661e-10	22	24	6	0.25	0.2727272727272727	GO:0034472	GO:BP	snRNA 3'-end processing	16175	8649		0.4666666666666667	0.5	22	16153	6	18	16	16135	16175	0.26006568134531566
R1	cpdb	0	network_modules	85	TRUE	8.056868723900011e-10	44	23	7	0.30434782608695654	0.1590909090909091	REAC:R-HSA-167152	REAC	Formation of HIV elongation complex in the absence of HIV Tat	10916	946		0.5	0.5217391304347826	44	10872	7	16	37	10856	10916	0.2177973623706132
R1	cpdb	0	network_modules	85	TRUE	1.0334559701315694e-9	22	23	6	0.2608695652173913	0.2727272727272727	REAC:R-HSA-167242	REAC	Abortive elongation of HIV-1 transcript in the absence of Tat	10916	51		0.5454545454545454	0.5652173913043478	22	10894	6	17	16	10877	10916	0.26521851635400495
R1	cpdb	0	network_modules	85	TRUE	8.973944509880099e-9	61	23	7	0.30434782608695654	0.11475409836065574	REAC:R-HSA-6796648	REAC	TP53 Regulates Transcription of DNA Repair Genes	10916	2456		0.5909090909090909	0.6086956521739131	61	10855	7	16	54	10839	10916	0.18416024089597488
R1	cpdb	0	network_modules	85	TRUE	1.2384747288283655e-8	32	23	6	0.2608695652173913	0.1875	REAC:R-HSA-113418	REAC	Formation of the Early Elongation Complex	10916	963		0.6363636363636364	0.6956521739130435	32	10884	6	17	26	10867	10916	0.21922996500944902
R1	cpdb	0	network_modules	85	TRUE	1.2384747288283655e-8	32	23	6	0.2608695652173913	0.1875	REAC:R-HSA-167158	REAC	Formation of the HIV-1 Early Elongation Complex	10916	965		0.6363636363636364	0.6956521739130435	32	10884	6	17	26	10867	10916	0.21922996500944902
R1	cpdb	0	network_modules	85	TRUE	1.7829292460399833e-8	62	7	5	0.7142857142857143	0.08064516129032258	KEGG:03250	KEGG	Viral life cycle - HIV-1	8484	223		NA	1	62	8422	5	2	57	8420	8484	0.23852336443804945
R1	cpdb	0	network_modules	85	TRUE	2.1964939074812553e-8	69	23	7	0.30434782608695654	0.10144927536231885	REAC:R-HSA-167172	REAC	Transcription of the HIV genome	10916	2540		0.7272727272727273	0.7391304347826086	69	10847	7	16	62	10831	10916	0.17279441061667558
R1	cpdb	0	network_modules	85	TRUE	8.260869432525275e-8	19	24	5	0.20833333333333334	0.2631578947368421	GO:0032785	GO:BP	negative regulation of DNA-templated transcription, elongation	16175	7820		0.5333333333333333	0.5625	19	16156	5	19	14	16137	16175	0.2331361478429518
R1	cpdb	0	network_modules	85	TRUE	2.2118042059321357e-6	132	23	7	0.30434782608695654	0.05303030303030303	REAC:R-HSA-162599	REAC	Late Phase of HIV Life Cycle	10916	1304		0.7727272727272727	0.782608695652174	132	10784	7	16	125	10768	10916	0.12286818926405454
R1	cpdb	0	network_modules	85	TRUE	2.8598996174343425e-6	12	24	4	0.16666666666666666	0.3333333333333333	GO:0001711	GO:BP	endodermal cell fate commitment	16175	403		0.6	0.625	12	16163	4	20	8	16143	16175	0.23491451141052108
R1	cpdb	0	network_modules	85	TRUE	4.259834774302657e-6	145	23	7	0.30434782608695654	0.04827586206896552	REAC:R-HSA-162587	REAC	HIV Life Cycle	10916	1103		0.8181818181818182	0.8260869565217391	145	10771	7	16	138	10755	10916	0.11682371864126634
R1	cpdb	0	network_modules	85	TRUE	2.7771520057808218e-5	20	24	4	0.16666666666666666	0.2	GO:0060795	GO:BP	cell fate commitment involved in formation of primary germ layer	16175	14961		0.6666666666666666	0.6875	20	16155	4	20	16	16135	16175	0.18146651247757528
R1	cpdb	0	network_modules	85	TRUE	8.768454265754849e-5	225	23	7	0.30434782608695654	0.03111111111111111	REAC:R-HSA-162906	REAC	HIV Infection	10916	1102		0.8636363636363636	0.8695652173913043	225	10691	7	16	218	10675	10916	0.09176298407359613
R1	cpdb	0	network_modules	85	TRUE	6.914575069080787e-4	43	24	4	0.16666666666666666	0.09302325581395349	GO:0035987	GO:BP	endodermal cell differentiation	16175	9378		0.7333333333333333	0.75	43	16132	4	20	39	16112	16175	0.12278280302522317
R1	cpdb	0	network_modules	85	TRUE	0.001281440419746232	50	24	4	0.16666666666666666	0.08	GO:0001706	GO:BP	endoderm formation	16175	398		0.8	0.8125	50	16125	4	20	46	16105	16175	0.11358828228005226
R1	cpdb	0	network_modules	85	TRUE	0.0019384179527215171	58	23	4	0.17391304347826086	0.06896551724137931	REAC:R-HSA-8866654	REAC	E3 ubiquitin ligases ubiquitinate target proteins	10916	811		0.9090909090909091	0.9130434782608695	58	10858	4	19	54	10839	10916	0.10656674068658986
R1	cpdb	0	network_modules	85	TRUE	0.002007461275118735	359	23	7	0.30434782608695654	0.019498607242339833	REAC:R-HSA-3700989	REAC	Transcriptional Regulation by TP53	10916	2546		0.9545454545454546	0.9565217391304348	359	10557	7	16	352	10541	10916	0.06994272800044948
R1	cpdb	0	network_modules	85	TRUE	0.0020168021160694542	15	24	3	0.125	0.2	GO:0034244	GO:BP	negative regulation of transcription elongation by RNA polymerase II	16175	8520		0.8666666666666667	0.875	15	16160	3	21	12	16139	16175	0.15713029557594074
R1	cpdb	0	network_modules	85	TRUE	0.0021827384827985113	57	24	4	0.16666666666666666	0.07017543859649122	GO:0007492	GO:BP	endoderm development	16175	2978		0.9333333333333333	0.9375	57	16118	4	20	53	16098	16175	0.10612675132307738
R1	cpdb	0	network_modules	85	TRUE	0.0063377216963188075	78	23	4	0.17391304347826086	0.05128205128205128	REAC:R-HSA-8852135	REAC	Protein ubiquitination	10916	1818		1	1	78	10838	4	19	74	10819	10916	0.09097947290342397
R1	cpdb	0	network_modules	85	TRUE	0.008542609148804024	80	24	4	0.16666666666666666	0.05	GO:0001704	GO:BP	formation of primary germ layer	16175	396		1	1	80	16095	4	20	76	16075	16175	0.08886392631018665
R1	cpdb	0	network_modules	86	TRUE	7.533488730606725e-53	111	35	28	0.8	0.25225225225225223	GO:0006413	GO:BP	translational initiation	16175	2171		0	0.045454545454545456	111	16064	28	7	83	16057	16175	0.4473904660551382
R1	cpdb	0	network_modules	86	TRUE	8.777009917499432e-37	59	32	20	0.625	0.3389830508474576	REAC:R-HSA-72702	REAC	Ribosomal scanning and start codon recognition	10916	2106		0	0.05	59	10857	20	12	39	10845	10916	0.4582170998259922
R1	cpdb	0	network_modules	86	TRUE	3.6622827026422927e-34	59	32	19	0.59375	0.3220338983050847	REAC:R-HSA-72649	REAC	Translation initiation complex formation	10916	2566		0.05263157894736842	0.1	59	10857	19	13	40	10844	10916	0.43510638670731966
R1	cpdb	0	network_modules	86	TRUE	5.353343429803318e-34	60	32	19	0.59375	0.31666666666666665	REAC:R-HSA-72662	REAC	Activation of the mRNA upon binding of the cap-binding complex and eIFs, and subsequent binding to 43S	10916	105		0.10526315789473684	0.15	60	10856	19	13	41	10843	10916	0.43141795214136186
R1	cpdb	0	network_modules	86	TRUE	7.018187442812072e-34	566	35	29	0.8285714285714286	0.05123674911660778	GO:0006412	GO:BP	translation	16175	2170		0.047619047619047616	0.09090909090909091	566	15609	29	6	537	15603	16175	0.20110415467562592
R1	cpdb	0	network_modules	86	TRUE	3.354038600418923e-33	43	35	17	0.4857142857142857	0.3953488372093023	GO:0002183	GO:BP	cytoplasmic translational initiation	16175	731		0.09523809523809523	0.13636363636363635	43	16132	17	18	26	16114	16175	0.43686330680740165
R1	cpdb	0	network_modules	86	TRUE	1.1574499537294434e-32	113	32	21	0.65625	0.18584070796460178	REAC:R-HSA-72706	REAC	GTP hydrolysis and joining of the 60S ribosomal subunit	10916	1027		0.15789473684210525	0.2	113	10803	21	11	92	10792	10916	0.3460165960171657
R1	cpdb	0	network_modules	86	TRUE	4.5937249153352215e-32	120	32	21	0.65625	0.175	REAC:R-HSA-72613	REAC	Eukaryotic Translation Initiation	10916	871		0.21052631578947367	0.3	120	10796	21	11	99	10785	10916	0.3355481802394056
R1	cpdb	0	network_modules	86	TRUE	4.5937249153352215e-32	120	32	21	0.65625	0.175	REAC:R-HSA-72737	REAC	Cap-dependent Translation Initiation	10916	304		0.21052631578947367	0.3	120	10796	21	11	99	10785	10916	0.3355481802394056
R1	cpdb	0	network_modules	86	TRUE	3.330333892427086e-31	15	35	13	0.37142857142857144	0.8666666666666667	GO:0001732	GO:BP	formation of cytoplasmic translation initiation complex	16175	411		0.14285714285714285	0.18181818181818182	15	16160	13	22	2	16138	16175	0.5668261455281581
R1	cpdb	0	network_modules	86	TRUE	3.462070501433946e-28	112	32	19	0.59375	0.16964285714285715	REAC:R-HSA-156827	REAC	L13a-mediated translational silencing of Ceruloplasmin expression	10916	1293		0.3157894736842105	0.35	112	10804	19	13	93	10791	10916	0.3139613894804552
R1	cpdb	0	network_modules	86	TRUE	1.9589784568931676e-25	292	32	22	0.6875	0.07534246575342465	REAC:R-HSA-72766	REAC	Translation	10916	2565		0.3684210526315789	0.4	292	10624	22	10	270	10614	10916	0.2220476316186203
R1	cpdb	0	network_modules	86	TRUE	1.7041287550302442e-24	158	35	18	0.5142857142857142	0.11392405063291139	GO:0002181	GO:BP	cytoplasmic translation	16175	729		0.19047619047619047	0.22727272727272727	158	16017	18	17	140	16000	16175	0.23888214836353286
R1	cpdb	0	network_modules	86	TRUE	1.1959511184020637e-23	75	35	15	0.42857142857142855	0.2	GO:0006446	GO:BP	regulation of translational initiation	16175	2196		0.23809523809523808	0.2727272727272727	75	16100	15	20	60	16080	16175	0.2905908160979814
R1	cpdb	0	network_modules	86	TRUE	2.0374995917324983e-21	290	35	19	0.5428571428571428	0.06551724137931035	GO:0006417	GO:BP	regulation of translation	16175	2174		0.2857142857142857	0.3181818181818182	290	15885	19	16	271	15869	16175	0.1842187688198755
R1	cpdb	0	network_modules	86	TRUE	1.4040312225113426e-20	52	32	13	0.40625	0.25	REAC:R-HSA-72695	REAC	Formation of the ternary complex, and subsequently, the 43S complex	10916	973		0.42105263157894735	0.45	52	10864	13	19	39	10845	10916	0.3161684164816825
R1	cpdb	0	network_modules	86	TRUE	4.612343209838148e-18	434	35	19	0.5428571428571428	0.04377880184331797	GO:0010608	GO:BP	post-transcriptional regulation of gene expression	16175	4255		0.3333333333333333	0.36363636363636365	434	15741	19	16	415	15725	16175	0.1487088380699264
R1	cpdb	0	network_modules	86	TRUE	1.9063625141010663e-16	102	32	13	0.40625	0.12745098039215685	REAC:R-HSA-72689	REAC	Formation of a pool of free 40S subunits	10916	953		0.47368421052631576	0.5	102	10814	13	19	89	10795	10916	0.22368587226931516
R1	cpdb	0	network_modules	86	TRUE	4.7603031738961916e-14	178	35	13	0.37142857142857144	0.07303370786516854	GO:0022618	GO:BP	protein-RNA complex assembly	16175	6625		0.38095238095238093	0.4090909090909091	178	15997	13	22	165	15975	16175	0.16088327420353
R1	cpdb	0	network_modules	86	TRUE	9.801550682541656e-14	188	35	13	0.37142857142857144	0.06914893617021277	GO:0071826	GO:BP	protein-RNA complex organization	16175	16929		0.42857142857142855	0.45454545454545453	188	15987	13	22	175	15965	16175	0.15632634330454012
R1	cpdb	0	network_modules	86	TRUE	1.549354503191904e-12	390	35	15	0.42857142857142855	0.038461538461538464	GO:0022613	GO:BP	ribonucleoprotein complex biogenesis	16175	6620		0.47619047619047616	0.5	390	15785	15	20	375	15765	16175	0.12278566980919621
R1	cpdb	0	network_modules	86	TRUE	1.190748342792395e-10	12	32	6	0.1875	0.5	REAC:R-HSA-9820865	REAC	Z-decay: degradation of maternal mRNAs by zygotically expressed factors	10916	2679		0.5263157894736842	0.55	12	10904	6	26	6	10878	10916	0.3050058964536322
R1	cpdb	0	network_modules	86	TRUE	6.184870079757882e-9	21	35	6	0.17142857142857143	0.2857142857142857	GO:0019081	GO:BP	viral translation	16175	5571		0.5238095238095238	0.5454545454545454	21	16154	6	29	15	16125	16175	0.2200181228078403
R1	cpdb	0	network_modules	86	TRUE	2.2223729060568888e-8	25	32	6	0.1875	0.24	REAC:R-HSA-9820841	REAC	M-decay: degradation of maternal mRNAs by maternally stored factors	10916	1344		0.5789473684210527	0.65	25	10891	6	26	19	10865	10916	0.2100894726955362
R1	cpdb	0	network_modules	86	TRUE	2.2223729060568888e-8	25	32	6	0.1875	0.24	REAC:R-HSA-429947	REAC	Deadenylation of mRNA	10916	453		0.5789473684210527	0.65	25	10891	6	26	19	10865	10916	0.2100894726955362
R1	cpdb	0	network_modules	86	TRUE	3.279493732560961e-8	4	35	4	0.11428571428571428	1	GO:1902416	GO:BP	positive regulation of mRNA binding	16175	22267		0.5714285714285714	0.6363636363636364	4	16171	4	31	0	16140	16175	0.3377375122894033
R1	cpdb	0	network_modules	86	TRUE	3.279493732560961e-8	4	35	4	0.11428571428571428	1	GO:1902415	GO:BP	regulation of mRNA binding	16175	22266		0.5714285714285714	0.6363636363636364	4	16171	4	31	0	16140	16175	0.3377375122894033
R1	cpdb	0	network_modules	86	TRUE	1.6372321348301227e-7	5	35	4	0.11428571428571428	0.8	GO:1905216	GO:BP	positive regulation of RNA binding	16175	24451		0.6666666666666666	0.7272727272727273	5	16170	4	31	1	16139	16175	0.3019271820948009
R1	cpdb	0	network_modules	86	TRUE	1.6372321348301227e-7	5	35	4	0.11428571428571428	0.8	GO:0075525	GO:BP	viral translational termination-reinitiation	16175	17758		0.6666666666666666	0.7272727272727273	5	16170	4	31	1	16139	16175	0.3019271820948009
R1	cpdb	0	network_modules	86	TRUE	3.6354955383899976e-7	71	32	7	0.21875	0.09859154929577464	REAC:R-HSA-1169408	REAC	ISG15 antiviral mechanism	10916	1166		0.6842105263157895	0.7	71	10845	7	25	64	10820	10916	0.1431658293485691
R1	cpdb	0	network_modules	86	TRUE	1.142550030879125e-6	7	35	4	0.11428571428571428	0.5714285714285714	GO:1905214	GO:BP	regulation of RNA binding	16175	24449		0.7619047619047619	0.7727272727272727	7	16168	4	31	3	16137	16175	0.2549139808202813
R1	cpdb	0	network_modules	86	TRUE	3.823805952720998e-6	56	32	6	0.1875	0.10714285714285714	REAC:R-HSA-429914	REAC	Deadenylation-dependent mRNA decay	10916	454		0.7368421052631579	0.75	56	10860	6	26	50	10834	10916	0.13841670952478546
R1	cpdb	0	network_modules	86	TRUE	9.318030666307367e-6	118	35	7	0.2	0.059322033898305086	GO:0045727	GO:BP	positive regulation of translation	16175	11569		0.8095238095238095	0.8181818181818182	118	16057	7	28	111	16029	16175	0.10544982222724128
R1	cpdb	0	network_modules	86	TRUE	1.0706686216852734e-5	11	35	4	0.11428571428571428	0.36363636363636365	GO:0075522	GO:BP	IRES-dependent viral translational initiation	16175	17755		0.8571428571428571	0.8636363636363636	11	16164	4	31	7	16133	16175	0.20293442399345693
R1	cpdb	0	network_modules	86	TRUE	5.9700814767361016e-5	147	32	7	0.21875	0.047619047619047616	REAC:R-HSA-1169410	REAC	Antiviral mechanism by IFN-stimulated genes	10916	157		0.7894736842105263	0.8	147	10769	7	25	140	10744	10916	0.09657217178452375
R1	cpdb	0	network_modules	86	TRUE	1.3547361421727345e-4	102	35	6	0.17142857142857143	0.058823529411764705	GO:0019080	GO:BP	viral gene expression	16175	5570		0.9047619047619048	0.9090909090909091	102	16073	6	29	96	16044	16175	0.09713692655203388
R1	cpdb	0	network_modules	86	TRUE	2.095302384678718e-4	24	32	4	0.125	0.16666666666666666	REAC:R-HSA-166208	REAC	mTORC1-mediated signalling	10916	2711		0.8421052631578947	0.85	24	10892	4	28	20	10864	10916	0.14216349891188185
R1	cpdb	0	network_modules	86	TRUE	3.5914117999227385e-4	119	32	6	0.1875	0.05042016806722689	REAC:R-HSA-9816359	REAC	Maternal to zygotic transition (MZT)	10916	1394		0.8947368421052632	0.9	119	10797	6	26	113	10771	10916	0.09221602608933532
R1	cpdb	0	network_modules	86	TRUE	5.766453956058552e-4	7	35	3	0.08571428571428572	0.42857142857142855	GO:0002191	GO:BP	cap-dependent translational initiation	16175	735		0.9523809523809523	0.9545454545454546	7	16168	3	32	4	16136	16175	0.19094324713370853
R1	cpdb	0	network_modules	86	TRUE	0.0019283716481207772	41	32	4	0.125	0.0975609756097561	REAC:R-HSA-165159	REAC	MTOR signalling	10916	1387		0.9473684210526315	0.95	41	10875	4	28	37	10847	10916	0.1074726869892798
R1	cpdb	0	network_modules	86	TRUE	0.002953746739492405	263	32	7	0.21875	0.026615969581749048	REAC:R-HSA-913531	REAC	Interferon Signaling	10916	1227		1	1	263	10653	7	25	256	10628	10916	0.06883356639664248
R1	cpdb	0	network_modules	86	TRUE	0.005364257505533883	155	14	4	0.2857142857142857	0.025806451612903226	KEGG:04150	KEGG	mTOR signaling pathway	8484	284		0	0.5	155	8329	4	10	151	8319	8484	0.08118850201325158
R1	cpdb	0	network_modules	86	TRUE	0.007728302029765521	63	14	3	0.21428571428571427	0.047619047619047616	KEGG:05416	KEGG	Viral myocarditis	8484	493		1	1	63	8421	3	11	60	8410	8484	0.09795967262527557
R1	cpdb	0	network_modules	86	TRUE	0.008491529700209274	116	35	5	0.14285714285714285	0.04310344827586207	GO:0051099	GO:BP	positive regulation of binding	16175	13494		1	1	116	16059	5	30	111	16029	16175	0.07488106350100752
R1	cpdb	0	network_modules	88	TRUE	3.8899871601792674e-4	9	25	3	0.12	0.3333333333333333	GO:0015889	GO:BP	cobalamin transport	16175	4995		0	0.5	9	16166	3	22	6	16144	16175	0.19928211379297658
R1	cpdb	0	network_modules	88	TRUE	0.00080662298290763235	24	17	3	0.17647058823529413	0.125	KEGG:04977	KEGG	Vitamin digestion and absorption	8484	408		NA	1	24	8460	3	14	21	8446	8484	0.1464952867411154
R1	cpdb	0	network_modules	88	TRUE	0.0010008661079990483	22	15	3	0.2	0.13636363636363635	REAC:R-HSA-196741	REAC	Cobalamin (Cbl, vitamin B12) transport and metabolism	10916	381		0	0.3333333333333333	22	10894	3	12	19	10882	10916	0.1637579498907437
R1	cpdb	0	network_modules	88	TRUE	0.001081142484452315	47	25	4	0.16	0.0851063829787234	GO:0051180	GO:BP	vitamin transport	16175	13559		1	1	47	16128	4	21	43	16107	16175	0.1148283752051561
R1	cpdb	0	network_modules	88	TRUE	0.001661426593849282	3	15	2	0.13333333333333333	0.6666666666666666	REAC:R-HSA-3359463	REAC	Defective CUBN causes MGA1	10916	513		0.5	1	3	10913	2	13	1	10900	10916	0.29777342010998115
R1	cpdb	0	network_modules	88	TRUE	0.001661426593849282	3	15	2	0.13333333333333333	0.6666666666666666	REAC:R-HSA-3359462	REAC	Defective AMN causes MGA1	10916	486		0.5	1	3	10913	2	13	1	10900	10916	0.29777342010998115
R1	cpdb	0	network_modules	89	TRUE	2.2325542512481886e-17	211	32	15	0.46875	0.07109004739336493	GO:0016054	GO:BP	organic acid catabolic process	16175	5086		0	0.1	211	15964	15	17	196	15947	16175	0.1788129758990936
R1	cpdb	0	network_modules	89	TRUE	2.2325542512481886e-17	211	32	15	0.46875	0.07109004739336493	GO:0046395	GO:BP	carboxylic acid catabolic process	16175	12121		0	0.1	211	15964	15	17	196	15947	16175	0.1788129758990936
R1	cpdb	0	network_modules	89	TRUE	3.4983971262403544e-16	60	28	11	0.39285714285714285	0.18333333333333332	REAC:R-HSA-9033241	REAC	Peroxisomal protein import	10916	1728		0	0.09090909090909091	60	10856	11	17	49	10839	10916	0.2656889030513149
R1	cpdb	0	network_modules	89	TRUE	1.006855324253896e-15	271	32	15	0.46875	0.055350553505535055	GO:0044248	GO:BP	cellular catabolic process	16175	10939		0.10526315789473684	0.15	271	15904	15	17	256	15887	16175	0.156791919545953
R1	cpdb	0	network_modules	89	TRUE	4.6716959316221005e-15	300	32	15	0.46875	0.05	GO:0044282	GO:BP	small molecule catabolic process	16175	10949		0.15789473684210525	0.2	300	15875	15	17	285	15858	16175	0.14856547976338189
R1	cpdb	0	network_modules	89	TRUE	8.637537367609982e-15	742	32	19	0.59375	0.025606469002695417	GO:0019752	GO:BP	carboxylic acid metabolic process	16175	6036		0.21052631578947367	0.25	742	15433	19	13	723	15420	16175	0.1165957945680423
R1	cpdb	0	network_modules	89	TRUE	1.3835038871440404e-14	761	32	19	0.59375	0.024967148488830485	GO:0043436	GO:BP	oxoacid metabolic process	16175	10693		0.2631578947368421	0.3	761	15414	19	13	742	15401	16175	0.11495500398678564
R1	cpdb	0	network_modules	89	TRUE	1.601322894124467e-14	767	32	19	0.59375	0.024771838331160364	GO:0006082	GO:BP	organic acid metabolic process	16175	1947		0.3157894736842105	0.35	767	15408	19	13	748	15395	16175	0.11444907752068509
R1	cpdb	0	network_modules	89	TRUE	2.4400640939260352e-14	83	19	10	0.5263157894736842	0.12048192771084337	KEGG:04146	KEGG	Peroxisome	8484	282		0	0.16666666666666666	83	8401	10	9	73	8392	8484	0.24863212076378396
R1	cpdb	0	network_modules	89	TRUE	4.60685650602545e-13	158	28	12	0.42857142857142855	0.0759493670886076	REAC:R-HSA-9609507	REAC	Protein localization	10916	1815		0.1	0.18181818181818182	158	10758	12	16	146	10742	10916	0.17582334263452595
R1	cpdb	0	network_modules	89	TRUE	1.6369367278054039e-12	91	32	10	0.3125	0.10989010989010989	GO:0019395	GO:BP	fatty acid oxidation	16175	5752		0.3684210526315789	0.4	91	16084	10	22	81	16062	16175	0.18267098437967982
R1	cpdb	0	network_modules	89	TRUE	2.2942469711975688e-12	94	32	10	0.3125	0.10638297872340426	GO:0009062	GO:BP	fatty acid catabolic process	16175	3238		0.42105263157894735	0.45	94	16081	10	22	84	16059	16175	0.1796405112572998
R1	cpdb	0	network_modules	89	TRUE	2.8552102029184927e-12	96	32	10	0.3125	0.10416666666666667	GO:0034440	GO:BP	lipid oxidation	16175	8634		0.47368421052631576	0.5	96	16079	10	22	86	16057	16175	0.17769879027631758
R1	cpdb	0	network_modules	89	TRUE	5.888930624233892e-12	65	32	9	0.28125	0.13846153846153847	GO:0006635	GO:BP	fatty acid beta-oxidation	16175	2346		0.5263157894736842	0.55	65	16110	9	23	56	16087	16175	0.19510356611142327
R1	cpdb	0	network_modules	89	TRUE	9.65649315017269e-12	108	32	10	0.3125	0.09259259259259259	GO:0072329	GO:BP	monocarboxylic acid catabolic process	16175	17352		0.5789473684210527	0.6	108	16067	10	22	98	16045	16175	0.16719299073895616
R1	cpdb	0	network_modules	89	TRUE	1.2236878813092102e-11	163	32	11	0.34375	0.06748466257668712	GO:0030258	GO:BP	lipid modification	16175	6747		0.631578947368421	0.65	163	16012	11	21	152	15991	16175	0.1487411942437956
R1	cpdb	0	network_modules	89	TRUE	1.953285811540711e-11	319	32	13	0.40625	0.04075235109717868	GO:0006631	GO:BP	fatty acid metabolic process	16175	2343		0.6842105263157895	0.7	319	15856	13	19	306	15837	16175	0.1237702269578108
R1	cpdb	0	network_modules	89	TRUE	1.2596699362973057e-9	248	32	11	0.34375	0.04435483870967742	GO:0016042	GO:BP	lipid catabolic process	16175	5076		0.7368421052631579	0.75	248	15927	11	21	237	15906	16175	0.1190038127901553
R1	cpdb	0	network_modules	89	TRUE	6.657471423575233e-9	504	32	13	0.40625	0.025793650793650792	GO:0032787	GO:BP	monocarboxylic acid metabolic process	16175	7822		0.7894736842105263	0.8	504	15671	13	19	491	15652	16175	0.09611694265484569
R1	cpdb	0	network_modules	89	TRUE	9.102847268467495e-8	173	28	9	0.32142857142857145	0.05202312138728324	REAC:R-HSA-8978868	REAC	Fatty acid metabolism	10916	935		0.2	0.2727272727272727	173	10743	9	19	164	10724	10916	0.1240817657324296
R1	cpdb	0	network_modules	89	TRUE	3.662395535597352e-7	19	32	5	0.15625	0.2631578947368421	GO:0009083	GO:BP	branched-chain amino acid catabolic process	16175	3256		0.8421052631578947	0.85	19	16156	5	27	14	16129	16175	0.20157013939426174
R1	cpdb	0	network_modules	89	TRUE	3.806530367788901e-7	32	19	5	0.2631578947368421	0.15625	KEGG:00640	KEGG	Propanoate metabolism	8484	109		0.2	0.3333333333333333	32	8452	5	14	27	8438	8484	0.20047301717312008
R1	cpdb	0	network_modules	89	TRUE	5.022602441419961e-7	21	28	5	0.17857142857142858	0.23809523809523808	REAC:R-HSA-70895	REAC	Branched-chain amino acid catabolism	10916	254		0.3	0.36363636363636365	21	10895	5	23	16	10872	10916	0.2044339776340523
R1	cpdb	0	network_modules	89	TRUE	1.0435751653136742e-6	24	28	5	0.17857142857142858	0.20833333333333334	REAC:R-HSA-390918	REAC	Peroxisomal lipid metabolism	10916	1727		0.4	0.45454545454545453	24	10892	5	23	19	10869	10916	0.1909592545922574
R1	cpdb	0	network_modules	89	TRUE	2.051729322631509e-6	26	32	5	0.15625	0.19230769230769232	GO:0009081	GO:BP	branched-chain amino acid metabolic process	16175	3254		0.8947368421052632	0.9	26	16149	5	27	21	16122	16175	0.171868684863401
R1	cpdb	0	network_modules	89	TRUE	4.208629904206275e-6	19	19	4	0.21052631578947367	0.21052631578947367	KEGG:00785	KEGG	Lipoic acid metabolism	8484	124		0.4	0.5	19	8465	4	15	15	8450	8484	0.20875431342680387
R1	cpdb	0	network_modules	89	TRUE	9.080197008833807e-6	12	32	4	0.125	0.3333333333333333	GO:0033540	GO:BP	fatty acid beta-oxidation using acyl-CoA oxidase	16175	8277		0.9473684210526315	0.95	12	16163	4	28	8	16135	16175	0.20318905219685054
R1	cpdb	0	network_modules	89	TRUE	2.0276827905241034e-4	48	19	4	0.21052631578947367	0.08333333333333333	KEGG:00280	KEGG	Valine, leucine and isoleucine degradation	8484	31		0.6	0.6666666666666666	48	8436	4	15	44	8421	8484	0.1294048309333325
R1	cpdb	0	network_modules	89	TRUE	2.797415131694286e-4	8	28	3	0.10714285714285714	0.375	REAC:R-HSA-389887	REAC	Beta-oxidation of pristanoyl-CoA	10916	219		0.5	0.5454545454545454	8	10908	3	25	5	10883	10916	0.19940375049129044
R1	cpdb	0	network_modules	89	TRUE	3.4631813863488414e-4	31	28	4	0.14285714285714285	0.12903225806451613	REAC:R-HSA-389661	REAC	Glyoxylate metabolism and glycine degradation	10916	1081		0.6	0.6363636363636364	31	10885	4	24	27	10861	10916	0.13343047850167372
R1	cpdb	0	network_modules	89	TRUE	0.0014765398463209333	93	32	5	0.15625	0.053763440860215055	GO:0009063	GO:BP	amino acid catabolic process	16175	3239		1	1	93	16082	5	27	88	16055	16175	0.08862439162040034
R1	cpdb	0	network_modules	89	TRUE	0.0021150141328265793	2	28	2	0.07142857142857142	1	REAC:R-HSA-3359475	REAC	Defective MMAA causes MMA, cblA type	10916	580		0.7	1	2	10914	2	26	0	10888	10916	0.26694270903326517
R1	cpdb	0	network_modules	89	TRUE	0.0021150141328265793	2	28	2	0.07142857142857142	1	REAC:R-HSA-9759785	REAC	Diseases of propionyl-CoA catabolism	10916	772		0.7	1	2	10914	2	26	0	10888	10916	0.26694270903326517
R1	cpdb	0	network_modules	89	TRUE	0.0021150141328265793	2	28	2	0.07142857142857142	1	REAC:R-HSA-9759774	REAC	Diseases of mitochondrial beta oxidation	10916	768		0.7	1	2	10914	2	26	0	10888	10916	0.26694270903326517
R1	cpdb	0	network_modules	89	TRUE	0.0021150141328265793	2	28	2	0.07142857142857142	1	REAC:R-HSA-3359478	REAC	Defective MUT causes MMAM	10916	589		0.7	1	2	10914	2	26	0	10888	10916	0.26694270903326517
R1	cpdb	0	network_modules	89	TRUE	0.0030742434334985113	33	19	3	0.15789473684210525	0.09090909090909091	KEGG:01210	KEGG	2-Oxocarboxylic acid metabolism	8484	185		0.8	0.8333333333333334	33	8451	3	16	30	8435	8484	0.11721628547133392
R1	cpdb	0	network_modules	89	TRUE	0.006855911110203827	43	19	3	0.15789473684210525	0.06976744186046512	KEGG:00071	KEGG	Fatty acid degradation	8484	11		1	1	43	8441	3	16	40	8425	8484	0.10196030055270738
R1	cpdb	0	network_modules	90	TRUE	3.0611805131431765e-31	196	25	21	0.84	0.10714285714285714	REAC:R-HSA-112314	REAC	Neurotransmitter receptors and postsynaptic signal transmission	10916	1594		0	0.09090909090909091	196	10720	21	4	175	10716	10916	0.2965989848406684
R1	cpdb	0	network_modules	90	TRUE	1.3761867338602894e-28	259	25	21	0.84	0.08108108108108109	REAC:R-HSA-112315	REAC	Transmission across Chemical Synapses	10916	2580		0.1	0.18181818181818182	259	10657	21	4	238	10653	10916	0.2569614122872279
R1	cpdb	0	network_modules	90	TRUE	1.6232703449138626e-24	400	25	21	0.84	0.0525	REAC:R-HSA-112316	REAC	Neuronal System	10916	1590		0.2	0.2727272727272727	400	10516	21	4	379	10512	10916	0.20485789316313543
R1	cpdb	0	network_modules	90	TRUE	2.9136109876288542e-22	487	27	20	0.7407407407407407	0.04106776180698152	GO:0007268	GO:BP	chemical synaptic transmission	16175	2796		0	0.06060606060606061	487	15688	20	7	467	15681	16175	0.17004490572964648
R1	cpdb	0	network_modules	90	TRUE	2.9136109876288542e-22	487	27	20	0.7407407407407407	0.04106776180698152	GO:0098916	GO:BP	anterograde trans-synaptic signaling	16175	18949		0	0.06060606060606061	487	15688	20	7	467	15681	16175	0.17004490572964648
R1	cpdb	0	network_modules	90	TRUE	3.580981338444434e-22	492	27	20	0.7407407407407407	0.04065040650406504	GO:0099537	GO:BP	trans-synaptic signaling	16175	19116		0.0625	0.09090909090909091	492	15683	20	7	472	15676	16175	0.16913201328724659
R1	cpdb	0	network_modules	90	TRUE	8.112882053442846e-22	365	25	20	0.8	0.0547945205479452	KEGG:04080	KEGG	Neuroactive ligand-receptor interaction	8484	263		0	0.14285714285714285	365	8119	20	5	345	8114	8484	0.2028133857356365
R1	cpdb	0	network_modules	90	TRUE	9.359992974041878e-22	516	27	20	0.7407407407407407	0.03875968992248062	GO:0099536	GO:BP	synaptic signaling	16175	19115		0.09375	0.12121212121212122	516	15659	20	7	496	15652	16175	0.16493314717524443
R1	cpdb	0	network_modules	90	TRUE	6.35170476537799e-21	40	25	12	0.48	0.3	KEGG:05033	KEGG	Nicotine addiction	8484	421		0.16666666666666666	0.2857142857142857	40	8444	12	13	28	8431	8484	0.3771910452444577
R1	cpdb	0	network_modules	90	TRUE	1.347714291493827e-20	54	27	12	0.4444444444444444	0.2222222222222222	GO:1902476	GO:BP	chloride transmembrane transport	16175	22306		0.125	0.15151515151515152	54	16121	12	15	42	16106	16175	0.31269206249834136
R1	cpdb	0	network_modules	90	TRUE	2.5013834521488025e-20	22	27	10	0.37037037037037035	0.45454545454545453	GO:0007214	GO:BP	gamma-aminobutyric acid signaling pathway	16175	2768		0.15625	0.18181818181818182	22	16153	10	17	12	16136	16175	0.40941833705712793
R1	cpdb	0	network_modules	90	TRUE	1.5676882782746227e-19	65	27	12	0.4444444444444444	0.18461538461538463	GO:0098656	GO:BP	monoatomic anion transmembrane transport	16175	18812		0.1875	0.21212121212121213	65	16110	12	15	53	16095	16175	0.2846657387690237
R1	cpdb	0	network_modules	90	TRUE	2.330105085172735e-19	67	27	12	0.4444444444444444	0.1791044776119403	GO:0098661	GO:BP	inorganic anion transmembrane transport	16175	18817		0.21875	0.24242424242424243	67	16108	12	15	55	16093	16175	0.28032349145609914
R1	cpdb	0	network_modules	90	TRUE	5.014417073172535e-18	34	27	10	0.37037037037037035	0.29411764705882354	GO:0051932	GO:BP	synaptic transmission, GABAergic	16175	14002		0.25	0.2727272727272727	34	16141	10	17	24	16124	16175	0.3287960056040638
R1	cpdb	0	network_modules	90	TRUE	5.033492502522015e-18	85	27	12	0.4444444444444444	0.1411764705882353	GO:0006821	GO:BP	chloride transport	16175	2498		0.28125	0.30303030303030304	85	16090	12	15	73	16075	16175	0.24838832959989454
R1	cpdb	0	network_modules	90	TRUE	1.6440328338335027e-17	61	27	11	0.4074074074074074	0.18032786885245902	GO:0060078	GO:BP	regulation of postsynaptic membrane potential	16175	14337		0.3125	0.3333333333333333	61	16114	11	16	50	16098	16175	0.2692714226532809
R1	cpdb	0	network_modules	90	TRUE	1.6509936673836725e-16	112	27	12	0.4444444444444444	0.10714285714285714	GO:0006820	GO:BP	monoatomic anion transport	16175	2497		0.34375	0.36363636363636365	112	16063	12	15	100	16048	16175	0.21574589825350018
R1	cpdb	0	network_modules	90	TRUE	2.2990331745526694e-16	115	27	12	0.4444444444444444	0.10434782608695652	GO:0015698	GO:BP	inorganic anion transport	16175	4818		0.375	0.3939393939393939	115	16060	12	15	103	16045	16175	0.21284284484037452
R1	cpdb	0	network_modules	90	TRUE	1.661211027043437e-15	9	25	7	0.28	0.7777777777777778	REAC:R-HSA-629597	REAC	Highly calcium permeable nicotinic acetylcholine receptors	10916	1124		0.3	0.36363636363636365	9	10907	7	18	2	10889	10916	0.46601841467900734
R1	cpdb	0	network_modules	90	TRUE	1.5183822519903407e-14	11	25	7	0.28	0.6363636363636364	REAC:R-HSA-629594	REAC	Highly calcium permeable postsynaptic nicotinic acetylcholine receptors	10916	1125		0.4	0.45454545454545453	11	10905	7	18	4	10887	10916	0.42129150261854775
R1	cpdb	0	network_modules	90	TRUE	2.322080732495498e-14	89	25	11	0.44	0.12359550561797752	KEGG:04727	KEGG	GABAergic synapse	8484	357		0.3333333333333333	0.42857142857142855	89	8395	11	14	78	8381	8484	0.2291810682139601
R1	cpdb	0	network_modules	90	TRUE	3.638854934894794e-14	12	25	7	0.28	0.5833333333333334	REAC:R-HSA-622323	REAC	Presynaptic nicotinic acetylcholine receptors	10916	1792		0.5	0.5454545454545454	12	10904	7	18	5	10886	10916	0.4032419500388099
R1	cpdb	0	network_modules	90	TRUE	1.5722858068121916e-13	14	25	7	0.28	0.5	REAC:R-HSA-622327	REAC	Postsynaptic nicotinic acetylcholine receptors	10916	1779		0.6	0.7272727272727273	14	10902	7	18	7	10884	10916	0.373118472388342
R1	cpdb	0	network_modules	90	TRUE	1.5722858068121916e-13	14	25	7	0.28	0.5	REAC:R-HSA-181431	REAC	Acetylcholine binding and downstream events	10916	54		0.6	0.7272727272727273	14	10902	7	18	7	10884	10916	0.373118472388342
R1	cpdb	0	network_modules	90	TRUE	1.6444568364753735e-12	60	25	9	0.36	0.15	REAC:R-HSA-977443	REAC	GABA receptor activation	10916	1011		0.8	0.8181818181818182	60	10856	9	16	51	10840	10916	0.22972571610446987
R1	cpdb	0	network_modules	90	TRUE	1.8101805330860525e-12	89	25	10	0.4	0.11235955056179775	KEGG:05032	KEGG	Morphine addiction	8484	420		0.5	0.5714285714285714	89	8395	10	15	79	8380	8484	0.2078375607909671
R1	cpdb	0	network_modules	90	TRUE	5.824370667938543e-12	23	27	7	0.25925925925925924	0.30434782608695654	GO:0007271	GO:BP	synaptic transmission, cholinergic	16175	2799		0.40625	0.42424242424242425	23	16152	7	20	16	16132	16175	0.27979213013039206
R1	cpdb	0	network_modules	90	TRUE	1.0765725009072709e-11	630	27	15	0.5555555555555556	0.023809523809523808	GO:0098660	GO:BP	inorganic ion transmembrane transport	16175	18816		0.4375	0.45454545454545453	630	15545	15	12	615	15533	16175	0.1091845227068335
R1	cpdb	0	network_modules	90	TRUE	1.3438016012231876e-11	282	27	12	0.4444444444444444	0.0425531914893617	GO:0042391	GO:BP	regulation of membrane potential	16175	10141		0.46875	0.48484848484848486	282	15893	12	15	270	15878	16175	0.13340665207931432
R1	cpdb	0	network_modules	90	TRUE	3.293237907069252e-10	148	25	10	0.4	0.06756756756756757	KEGG:04723	KEGG	Retrograde endocannabinoid signaling	8484	353		0.6666666666666666	0.7142857142857143	148	8336	10	15	138	8321	8484	0.15885312978285537
R1	cpdb	0	network_modules	90	TRUE	3.4092716548710776e-10	18	27	6	0.2222222222222222	0.3333333333333333	GO:0035094	GO:BP	response to nicotine	16175	8806		0.5	0.5151515151515151	18	16157	6	21	12	16136	16175	0.27117982734165513
R1	cpdb	0	network_modules	90	TRUE	4.478734413405591e-9	85	25	8	0.32	0.09411764705882353	KEGG:04742	KEGG	Taste transduction	8484	361		0.8333333333333334	0.8571428571428571	85	8399	8	17	77	8382	8484	0.1692088877237429
R1	cpdb	0	network_modules	90	TRUE	4.8036118426015603e-8	5	27	4	0.14814814814814814	0.8	GO:0035095	GO:BP	behavioral response to nicotine	16175	8807		0.53125	0.5454545454545454	5	16170	4	23	1	16147	16175	0.34388710479424905
R1	cpdb	0	network_modules	90	TRUE	1.5656328617772332e-7	19	27	5	0.18518518518518517	0.2631578947368421	GO:1904862	GO:BP	inhibitory synapse assembly	16175	24170		0.5625	0.5757575757575758	19	16156	5	22	14	16134	16175	0.2196674767675112
R1	cpdb	0	network_modules	90	TRUE	2.624391510619664e-7	7	25	4	0.16	0.5714285714285714	REAC:R-HSA-629587	REAC	Highly sodium permeable postsynaptic acetylcholine nicotinic receptors	10916	1126		0.9	0.9090909090909091	7	10909	4	21	3	10888	10916	0.30160188201565996
R1	cpdb	0	network_modules	90	TRUE	3.611835208207157e-7	671	27	12	0.4444444444444444	0.01788375558867362	GO:0034220	GO:BP	monoatomic ion transmembrane transport	16175	8508		0.59375	0.6060606060606061	671	15504	12	15	659	15489	16175	0.08263163089889336
R1	cpdb	0	network_modules	90	TRUE	6.481041944381045e-6	3	27	3	0.1111111111111111	1	GO:0060084	GO:BP	synaptic transmission involved in micturition	16175	14343		0.625	0.6363636363636364	3	16172	3	24	0	16148	16175	0.3330859004154061
R1	cpdb	0	network_modules	90	TRUE	2.589531327467998e-5	4	27	3	0.1111111111111111	0.75	GO:0060073	GO:BP	micturition	16175	14334		0.65625	0.6666666666666666	4	16171	3	24	1	16147	16175	0.2883089932851915
R1	cpdb	0	network_modules	90	TRUE	4.253603332260096e-5	54	25	5	0.2	0.09259259259259259	REAC:R-HSA-1236394	REAC	Signaling by ERBB4	10916	2237		1	1	54	10862	5	20	49	10842	10916	0.13319895071995738
R1	cpdb	0	network_modules	90	TRUE	7.644638865950136e-5	125	27	6	0.2222222222222222	0.048	GO:0007416	GO:BP	synapse assembly	16175	2911		0.6875	0.696969696969697	125	16050	6	21	119	16029	16175	0.10015898722460266
R1	cpdb	0	network_modules	90	TRUE	2.2582828282020372e-4	7	27	3	0.1111111111111111	0.42857142857142855	GO:0007210	GO:BP	serotonin receptor signaling pathway	16175	2764		0.71875	0.7575757575757576	7	16168	3	24	4	16144	16175	0.21759669023535055
R1	cpdb	0	network_modules	90	TRUE	2.2582828282020372e-4	7	27	3	0.1111111111111111	0.42857142857142855	GO:0071420	GO:BP	cellular response to histamine	16175	16671		0.71875	0.7575757575757576	7	16168	3	24	4	16144	16175	0.21759669023535055
R1	cpdb	0	network_modules	90	TRUE	4.791250549794294e-4	283	27	7	0.25925925925925924	0.024734982332155476	GO:0050808	GO:BP	synapse organization	16175	13274		0.78125	0.7878787878787878	283	15892	7	20	276	15872	16175	0.0754005237538936
R1	cpdb	0	network_modules	90	TRUE	5.295274779527838e-4	431	27	8	0.2962962962962963	0.018561484918793503	GO:1901699	GO:BP	cellular response to nitrogen compound	16175	21652		0.8125	0.8181818181818182	431	15744	8	19	423	15725	16175	0.0684654445921453
R1	cpdb	0	network_modules	90	TRUE	8.4370384305119e-4	40	27	4	0.14814814814814814	0.1	GO:0030534	GO:BP	adult behavior	16175	6837		0.84375	0.8484848484848485	40	16135	4	23	36	16112	16175	0.11993278861516482
R1	cpdb	0	network_modules	90	TRUE	0.00103379366846047	112	25	5	0.2	0.044642857142857144	KEGG:04726	KEGG	Serotonergic synapse	8484	356		1	1	112	8372	5	20	107	8352	8484	0.08897363485119454
R1	cpdb	0	network_modules	90	TRUE	0.0010598877697315923	11	27	3	0.1111111111111111	0.2727272727272727	GO:0034776	GO:BP	response to histamine	16175	8739		0.875	0.8787878787878788	11	16164	3	24	8	16140	16175	0.17321569325514452
R1	cpdb	0	network_modules	90	TRUE	0.0035772253304888753	16	27	3	0.1111111111111111	0.1875	GO:0007588	GO:BP	excretion	16175	3049		0.90625	0.9090909090909091	16	16159	3	24	13	16135	16175	0.14324299225971948
R1	cpdb	0	network_modules	90	TRUE	0.005200935261179129	18	27	3	0.1111111111111111	0.16666666666666666	GO:0007274	GO:BP	neuromuscular synaptic transmission	16175	2801		0.9375	0.9393939393939394	18	16157	3	24	15	16133	16175	0.13490749891953285
R1	cpdb	0	network_modules	90	TRUE	0.00799901220021734	619	27	8	0.2962962962962963	0.012924071082390954	GO:1901698	GO:BP	response to nitrogen compound	16175	21651		0.96875	0.9696969696969697	619	15556	8	19	611	15537	16175	0.054996907913630405
R1	cpdb	0	network_modules	90	TRUE	0.008698254698956834	437	27	7	0.25925925925925924	0.016018306636155607	GO:0014070	GO:BP	response to organic cyclic compound	16175	4635		1	1	437	15738	7	20	430	15718	16175	0.058572337594367085
R1	cpdb	0	network_modules	91	TRUE	2.041805459981765e-52	251	58	38	0.6551724137931034	0.15139442231075698	GO:0042254	GO:BP	ribosome biogenesis	16175	10060		0	0.07692307692307693	251	15924	38	20	213	15904	16175	0.31045509539182864
R1	cpdb	0	network_modules	91	TRUE	1.1274813499544812e-50	390	58	41	0.7068965517241379	0.10512820512820513	GO:0022613	GO:BP	ribonucleoprotein complex biogenesis	16175	6620		0.08333333333333333	0.15384615384615385	390	15785	41	17	349	15768	16175	0.2670211913053755
R1	cpdb	0	network_modules	91	TRUE	4.786911141617695e-46	169	58	32	0.5517241379310345	0.1893491124260355	GO:0006364	GO:BP	rRNA processing	16175	2140		0.16666666666666666	0.23076923076923078	169	16006	32	26	137	15980	16175	0.31933765199660036
R1	cpdb	0	network_modules	91	TRUE	3.909425591916802e-43	205	58	32	0.5517241379310345	0.15609756097560976	GO:0016072	GO:BP	rRNA metabolic process	16175	5099		0.25	0.3076923076923077	205	15970	32	26	173	15944	16175	0.2890786735020863
R1	cpdb	0	network_modules	91	TRUE	2.728394599744389e-35	59	36	20	0.5555555555555556	0.3389830508474576	REAC:R-HSA-6790901	REAC	rRNA modification in the nucleus and cytosol	10916	2731		0	0.25	59	10857	20	16	39	10841	10916	0.43161947454418953
R1	cpdb	0	network_modules	91	TRUE	4.5532357120151175e-34	192	36	25	0.6944444444444444	0.13020833333333334	REAC:R-HSA-8868773	REAC	rRNA processing in the nucleus and cytosol	10916	2734		0.3333333333333333	0.5	192	10724	25	11	167	10713	10916	0.2961879111363064
R1	cpdb	0	network_modules	91	TRUE	1.7456585984765308e-33	202	36	25	0.6944444444444444	0.12376237623762376	REAC:R-HSA-72312	REAC	rRNA processing	10916	2732		0.6666666666666666	0.75	202	10714	25	11	177	10703	10916	0.2885071951050605
R1	cpdb	0	network_modules	91	TRUE	2.1354753168109547e-28	182	36	22	0.6111111111111112	0.12087912087912088	REAC:R-HSA-6791226	REAC	Major pathway of rRNA processing in the nucleolus and cytosol	10916	1389		1	1	182	10734	22	14	160	10720	10916	0.2670488123759474
R1	cpdb	0	network_modules	91	TRUE	5.608965054997731e-24	94	58	18	0.3103448275862069	0.19148936170212766	GO:0042274	GO:BP	ribosomal small subunit biogenesis	16175	10071		0.3333333333333333	0.38461538461538464	94	16081	18	40	76	16041	16175	0.24034254058670057
R1	cpdb	0	network_modules	91	TRUE	6.488143082873808e-23	65	58	16	0.27586206896551724	0.24615384615384617	GO:0042273	GO:BP	ribosomal large subunit biogenesis	16175	10070		0.4166666666666667	0.46153846153846156	65	16110	16	42	49	16068	16175	0.2577690213106737
R1	cpdb	0	network_modules	91	TRUE	3.286538933057349e-20	27	58	12	0.20689655172413793	0.4444444444444444	GO:0000470	GO:BP	maturation of LSU-rRNA	16175	159		0.5	0.5384615384615384	27	16148	12	46	15	16102	16175	0.30158523909684515
R1	cpdb	0	network_modules	91	TRUE	3.4540347431193834e-20	139	19	14	0.7368421052631579	0.10071942446043165	KEGG:03008	KEGG	Ribosome biogenesis in eukaryotes	8484	207		NA	1	139	8345	14	5	125	8340	8484	0.26887614444838714
R1	cpdb	0	network_modules	91	TRUE	8.218092719708789e-15	46	58	11	0.1896551724137931	0.2391304347826087	GO:0030490	GO:BP	maturation of SSU-rRNA	16175	6815		0.5833333333333334	0.6153846153846154	46	16129	11	47	35	16082	16175	0.21044404299520175
R1	cpdb	0	network_modules	91	TRUE	8.606526296604075e-9	28	58	7	0.1206896551724138	0.25	GO:0000462	GO:BP	maturation of SSU-rRNA from tricistronic rRNA transcript (SSU-rRNA, 5.8S rRNA, LSU-rRNA)	16175	152		0.6666666666666666	0.6923076923076923	28	16147	7	51	21	16096	16175	0.1716670910934904
R1	cpdb	0	network_modules	91	TRUE	3.062629350319199e-8	33	58	7	0.1206896551724138	0.21212121212121213	GO:0000460	GO:BP	maturation of 5.8S rRNA	16175	150		0.75	0.7692307692307693	33	16142	7	51	26	16091	16175	0.15774163690297768
R1	cpdb	0	network_modules	91	TRUE	2.13532336164577e-6	15	58	5	0.08620689655172414	0.3333333333333333	GO:0000463	GO:BP	maturation of LSU-rRNA from tricistronic rRNA transcript (SSU-rRNA, 5.8S rRNA, LSU-rRNA)	16175	153		0.8333333333333334	0.8461538461538461	15	16160	5	53	10	16107	16175	0.16807174999990443
R1	cpdb	0	network_modules	91	TRUE	2.1327913085242834e-4	14	58	4	0.06896551724137931	0.2857142857142857	GO:0000479	GO:BP	endonucleolytic cleavage of tricistronic rRNA transcript (SSU-rRNA, 5.8S rRNA, LSU-rRNA)	16175	167		0.9166666666666666	0.9230769230769231	14	16161	4	54	10	16107	16175	0.1389200913250304
R1	cpdb	0	network_modules	91	TRUE	0.00559468909660053	30	58	4	0.06896551724137931	0.13333333333333333	GO:0000154	GO:BP	rRNA modification	16175	52		1	1	30	16145	4	54	26	16091	16175	0.09356834923613137
R1	cpdb	0	network_modules	92	TRUE	3.9776707489558303e-28	132	22	18	0.8181818181818182	0.13636363636363635	KEGG:05322	KEGG	Systemic lupus erythematosus	8484	484		0	0.16666666666666666	132	8352	18	4	114	8348	8484	0.3306777292622214
R1	cpdb	0	network_modules	92	TRUE	7.687397909220109e-27	79	25	16	0.64	0.20253164556962025	REAC:R-HSA-2559586	REAC	DNA Damage/Telomere Stress Induced Senescence	10916	441		0	0.010638297872340425	79	10837	16	9	63	10828	10916	0.35766182588276146
R1	cpdb	0	network_modules	92	TRUE	2.963819483069493e-25	187	22	18	0.8181818181818182	0.0962566844919786	KEGG:05034	KEGG	Alcoholism	8484	422		0.2	0.3333333333333333	187	8297	18	4	169	8293	8484	0.2764927608177137
R1	cpdb	0	network_modules	92	TRUE	3.2761405240537196e-25	188	22	18	0.8181818181818182	0.09574468085106383	KEGG:04613	KEGG	Neutrophil extracellular trap formation	8484	323		0.4	0.5	188	8296	18	4	170	8292	8484	0.2757322182774079
R1	cpdb	0	network_modules	92	TRUE	2.9142062021112626e-22	194	25	17	0.68	0.08762886597938144	REAC:R-HSA-2559583	REAC	Cellular Senescence	10916	331		0.010752688172043012	0.02127659574468085	194	10722	17	8	177	10714	10916	0.24014213884203378
R1	cpdb	0	network_modules	92	TRUE	1.4597774569738804e-21	529	39	23	0.5897435897435898	0.043478260869565216	GO:0006325	GO:BP	chromatin organization	16175	2122		0	0.07692307692307693	529	15646	23	16	506	15630	16175	0.15396946354439664
R1	cpdb	0	network_modules	92	TRUE	9.55929956707797e-19	64	25	12	0.48	0.1875	REAC:R-HSA-5334118	REAC	DNA methylation	10916	447		0.021505376344086023	0.031914893617021274	64	10852	12	13	52	10839	10916	0.29754911499409276
R1	cpdb	0	network_modules	92	TRUE	1.4297277660737542e-18	66	25	12	0.48	0.18181818181818182	REAC:R-HSA-9670095	REAC	Inhibition of DNA recombination at telomere	10916	1189		0.03225806451612903	0.0425531914893617	66	10850	12	13	54	10837	10916	0.29291988292613785
R1	cpdb	0	network_modules	92	TRUE	3.0761634770080595e-18	70	25	12	0.48	0.17142857142857143	REAC:R-HSA-9821002	REAC	Chromatin modifications during the maternal to zygotic transition (MZT)	10916	354		0.043010752688172046	0.05319148936170213	70	10846	12	13	58	10833	10916	0.2842601406740422
R1	cpdb	0	network_modules	92	TRUE	4.4323715343486675e-18	72	25	12	0.48	0.16666666666666666	REAC:R-HSA-2299718	REAC	Condensation of Prophase Chromosomes	10916	395		0.053763440860215055	0.06382978723404255	72	10844	12	13	60	10831	10916	0.2802016804201662
R1	cpdb	0	network_modules	92	TRUE	1.0908552362002061e-17	51	25	11	0.44	0.21568627450980393	REAC:R-HSA-171306	REAC	Packaging Of Telomere Ends	10916	1712		0.06451612903225806	0.07446808510638298	51	10865	11	14	40	10851	10916	0.3058554753750566
R1	cpdb	0	network_modules	92	TRUE	2.1847386656069977e-17	54	25	11	0.44	0.2037037037037037	REAC:R-HSA-73927	REAC	Depurination	10916	731		0.07526881720430108	0.10638297872340426	54	10862	11	14	43	10848	10916	0.2970914638958794
R1	cpdb	0	network_modules	92	TRUE	2.1847386656069977e-17	54	25	11	0.44	0.2037037037037037	REAC:R-HSA-110331	REAC	Cleavage of the damaged purine	10916	373		0.07526881720430108	0.10638297872340426	54	10862	11	14	43	10848	10916	0.2970914638958794
R1	cpdb	0	network_modules	92	TRUE	2.1847386656069977e-17	54	25	11	0.44	0.2037037037037037	REAC:R-HSA-110330	REAC	Recognition and association of DNA glycosylase with site containing an affected purine	10916	1946		0.07526881720430108	0.10638297872340426	54	10862	11	14	43	10848	10916	0.2970914638958794
R1	cpdb	0	network_modules	92	TRUE	4.343460768677385e-17	86	25	12	0.48	0.13953488372093023	REAC:R-HSA-912446	REAC	Meiotic recombination	10916	1411		0.10752688172043011	0.11702127659574468	86	10830	12	13	74	10817	10916	0.2558527683347311
R1	cpdb	0	network_modules	92	TRUE	6.350050448463907e-17	59	25	11	0.44	0.1864406779661017	REAC:R-HSA-73928	REAC	Depyrimidination	10916	732		0.11827956989247312	0.14893617021276595	59	10857	11	14	48	10843	10916	0.2839903237150346
R1	cpdb	0	network_modules	92	TRUE	6.350050448463907e-17	59	25	11	0.44	0.1864406779661017	REAC:R-HSA-110329	REAC	Cleavage of the damaged pyrimidine 	10916	374		0.11827956989247312	0.14893617021276595	59	10857	11	14	48	10843	10916	0.2839903237150346
R1	cpdb	0	network_modules	92	TRUE	6.350050448463907e-17	59	25	11	0.44	0.1864406779661017	REAC:R-HSA-110328	REAC	Recognition and association of DNA glycosylase with site containing an affected pyrimidine	10916	1947		0.11827956989247312	0.14893617021276595	59	10857	11	14	48	10843	10916	0.2839903237150346
R1	cpdb	0	network_modules	92	TRUE	7.74615004335537e-17	90	25	12	0.48	0.13333333333333333	REAC:R-HSA-201722	REAC	Formation of the beta-catenin:TCF transactivating complex	10916	968		0.15053763440860216	0.1595744680851064	90	10826	12	13	78	10813	10916	0.24995458187048494
R1	cpdb	0	network_modules	92	TRUE	7.766387794379488e-17	60	25	11	0.44	0.18333333333333332	REAC:R-HSA-73929	REAC	Base-Excision Repair, AP Site Formation	10916	206		0.16129032258064516	0.1702127659574468	60	10856	11	14	49	10842	10916	0.2815673996609983
R1	cpdb	0	network_modules	92	TRUE	1.1491421391342026e-16	62	25	11	0.44	0.1774193548387097	REAC:R-HSA-73728	REAC	RNA Polymerase I Promoter Opening	10916	1883		0.17204301075268819	0.18085106382978725	62	10854	11	14	51	10840	10916	0.27689747240530915
R1	cpdb	0	network_modules	92	TRUE	1.344575253209518e-16	94	25	12	0.48	0.1276595744680851	REAC:R-HSA-3214815	REAC	HDACs deacetylate histones	10916	1092		0.1827956989247312	0.19148936170212766	94	10822	12	13	82	10809	10916	0.244433771333284
R1	cpdb	0	network_modules	92	TRUE	1.9944378120258966e-16	106	39	13	0.3333333333333333	0.12264150943396226	GO:0034728	GO:BP	nucleosome organization	16175	8723		0.08333333333333333	0.15384615384615385	106	16069	13	26	93	16043	16175	0.19910711259711406
R1	cpdb	0	network_modules	92	TRUE	2.416919024931755e-16	66	25	11	0.44	0.16666666666666666	REAC:R-HSA-5625886	REAC	Activated PKN1 stimulates transcription of AR (androgen receptor) regulated genes KLK2 and KLK3	10916	68		0.1935483870967742	0.20212765957446807	66	10850	11	14	55	10836	10916	0.2681984974363378
R1	cpdb	0	network_modules	92	TRUE	2.8882536230024005e-16	67	25	11	0.44	0.16417910447761194	REAC:R-HSA-427359	REAC	SIRT1 negatively regulates rRNA expression	10916	2142		0.20430107526881722	0.2127659574468085	67	10849	11	14	56	10835	10916	0.26614556348336377
R1	cpdb	0	network_modules	92	TRUE	3.4415635647326274e-16	68	25	11	0.44	0.16176470588235295	REAC:R-HSA-68616	REAC	Assembly of the ORC complex at the origin of replication	10916	178		0.21505376344086022	0.22340425531914893	68	10848	11	14	57	10834	10916	0.26413775532107714
R1	cpdb	0	network_modules	92	TRUE	6.752707412964803e-16	72	25	11	0.44	0.1527777777777778	REAC:R-HSA-212300	REAC	PRC2 methylates histones and DNA	10916	1701		0.22580645161290322	0.24468085106382978	72	10844	11	14	61	10830	10916	0.25652620869229964
R1	cpdb	0	network_modules	92	TRUE	6.752707412964803e-16	72	25	11	0.44	0.1527777777777778	REAC:R-HSA-9710421	REAC	Defective pyroptosis	10916	702		0.22580645161290322	0.24468085106382978	72	10844	11	14	61	10830	10916	0.25652620869229964
R1	cpdb	0	network_modules	92	TRUE	1.0896459383889573e-15	111	25	12	0.48	0.10810810810810811	REAC:R-HSA-157579	REAC	Telomere Maintenance	10916	2489		0.24731182795698925	0.2553191489361702	111	10805	12	13	99	10792	10916	0.22437158338320956
R1	cpdb	0	network_modules	92	TRUE	1.090536205284569e-15	75	25	11	0.44	0.14666666666666667	REAC:R-HSA-427389	REAC	ERCC6 (CSB) and EHMT2 (G9a) positively regulate rRNA expression	10916	827		0.25806451612903225	0.26595744680851063	75	10841	11	14	64	10827	10916	0.25121869976589983
R1	cpdb	0	network_modules	92	TRUE	1.1761606416028092e-15	86	39	12	0.3076923076923077	0.13953488372093023	GO:0006334	GO:BP	nucleosome assembly	16175	2123		0.16666666666666666	0.23076923076923078	86	16089	12	27	74	16062	16175	0.20441437900114634
R1	cpdb	0	network_modules	92	TRUE	1.2735805577010483e-15	76	25	11	0.44	0.14473684210526316	REAC:R-HSA-1221632	REAC	Meiotic synapsis	10916	1412		0.26881720430107525	0.2765957446808511	76	10840	11	14	65	10826	10916	0.24951919772536055
R1	cpdb	0	network_modules	92	TRUE	1.3623746140912155e-15	113	25	12	0.48	0.10619469026548672	REAC:R-HSA-9610379	REAC	HCMV Late Events	10916	1090		0.27956989247311825	0.2872340425531915	113	10803	12	13	101	10790	10916	0.22231098646239955
R1	cpdb	0	network_modules	92	TRUE	1.8899062905086286e-15	116	25	12	0.48	0.10344827586206896	REAC:R-HSA-1500620	REAC	Meiosis	10916	1410		0.2903225806451613	0.2978723404255319	116	10800	12	13	104	10787	10916	0.21931950194451488
R1	cpdb	0	network_modules	92	TRUE	2.598541150090825e-15	119	25	12	0.48	0.10084033613445378	REAC:R-HSA-9816359	REAC	Maternal to zygotic transition (MZT)	10916	1394		0.3010752688172043	0.30851063829787234	119	10797	12	13	107	10784	10916	0.21644060081430944
R1	cpdb	0	network_modules	92	TRUE	7.016954699795983e-15	88	25	11	0.44	0.125	REAC:R-HSA-73884	REAC	Base Excision Repair	10916	205		0.3118279569892473	0.32978723404255317	88	10828	11	14	77	10814	10916	0.23142274845713012
R1	cpdb	0	network_modules	92	TRUE	7.016954699795983e-15	88	25	11	0.44	0.125	REAC:R-HSA-9616222	REAC	Transcriptional regulation of granulopoiesis	10916	2559		0.3118279569892473	0.32978723404255317	88	10828	11	14	77	10814	10916	0.23142274845713012
R1	cpdb	0	network_modules	92	TRUE	7.997047223530669e-15	89	25	11	0.44	0.12359550561797752	REAC:R-HSA-5250924	REAC	B-WICH complex positively regulates rRNA expression	10916	198		0.3333333333333333	0.3404255319148936	89	10827	11	14	78	10813	10916	0.23008076723686524
R1	cpdb	0	network_modules	92	TRUE	9.099774349531507e-15	90	25	11	0.44	0.12222222222222222	REAC:R-HSA-73772	REAC	RNA Polymerase I Promoter Escape	10916	1882		0.34408602150537637	0.35106382978723405	90	10826	11	14	79	10812	10916	0.22876099923468457
R1	cpdb	0	network_modules	92	TRUE	1.1347743832435734e-14	134	25	12	0.48	0.08955223880597014	REAC:R-HSA-68875	REAC	Mitotic Prophase	10916	1485		0.3548387096774194	0.3617021276595745	134	10782	12	13	122	10769	10916	0.20351089028557523
R1	cpdb	0	network_modules	92	TRUE	1.1728860129182066e-14	92	25	11	0.44	0.11956521739130435	REAC:R-HSA-1912408	REAC	Pre-NOTCH Transcription and Translation	10916	1786		0.3655913978494624	0.3723404255319149	92	10824	11	14	81	10810	10916	0.22618568293790844
R1	cpdb	0	network_modules	92	TRUE	1.2441001558175101e-14	135	25	12	0.48	0.08888888888888889	REAC:R-HSA-9609690	REAC	HCMV Early Events	10916	1088		0.3763440860215054	0.3829787234042553	135	10781	12	13	123	10768	10916	0.20272543475427915
R1	cpdb	0	network_modules	92	TRUE	1.328649196771399e-14	93	25	11	0.44	0.11827956989247312	REAC:R-HSA-5625740	REAC	RHO GTPases activate PKNs	10916	1857		0.3870967741935484	0.39361702127659576	93	10823	11	14	82	10809	10916	0.2249289817463068
R1	cpdb	0	network_modules	92	TRUE	1.6324614185076468e-14	138	25	12	0.48	0.08695652173913043	REAC:R-HSA-73886	REAC	Chromosome Maintenance	10916	357		0.3978494623655914	0.40425531914893614	138	10778	12	13	126	10765	10916	0.2004198379917345
R1	cpdb	0	network_modules	92	TRUE	1.6977554887684397e-14	95	25	11	0.44	0.11578947368421053	REAC:R-HSA-8936459	REAC	RUNX1 regulates genes involved in megakaryocyte differentiation and platelet function	10916	1919		0.40860215053763443	0.4148936170212766	95	10821	11	14	84	10807	10916	0.22247477086647882
R1	cpdb	0	network_modules	92	TRUE	2.1288859330789153e-14	141	25	12	0.48	0.0851063829787234	REAC:R-HSA-3214847	REAC	HATs acetylate histones	10916	1087		0.41935483870967744	0.425531914893617	141	10775	12	13	129	10762	10916	0.19818723811267072
R1	cpdb	0	network_modules	92	TRUE	2.974914967743503e-14	271	25	14	0.56	0.05166051660516605	REAC:R-HSA-3247509	REAC	Chromatin modifying enzymes	10916	355		0.43010752688172044	0.44680851063829785	271	10645	14	11	257	10634	10916	0.16479241793298438
R1	cpdb	0	network_modules	92	TRUE	2.974914967743503e-14	271	25	14	0.56	0.05166051660516605	REAC:R-HSA-4839726	REAC	Chromatin organization	10916	356		0.43010752688172044	0.44680851063829785	271	10645	14	11	257	10634	10916	0.16479241793298438
R1	cpdb	0	network_modules	92	TRUE	3.8415283183236566e-14	102	25	11	0.44	0.10784313725490197	REAC:R-HSA-5578749	REAC	Transcriptional regulation by small RNAs	10916	2555		0.45161290322580644	0.4574468085106383	102	10814	11	14	91	10800	10916	0.21445530965863616
R1	cpdb	0	network_modules	92	TRUE	4.2957447427204e-14	103	25	11	0.44	0.10679611650485436	REAC:R-HSA-9645723	REAC	Diseases of programmed cell death	10916	771		0.46236559139784944	0.46808510638297873	103	10813	11	14	92	10799	10916	0.21337619457825333
R1	cpdb	0	network_modules	92	TRUE	4.7981503160667864e-14	104	25	11	0.44	0.10576923076923077	REAC:R-HSA-5250913	REAC	Positive epigenetic regulation of rRNA expression	10916	1771		0.4731182795698925	0.4787234042553192	104	10812	11	14	93	10798	10916	0.21231250726210213
R1	cpdb	0	network_modules	92	TRUE	5.353283540403266e-14	105	25	11	0.44	0.10476190476190476	REAC:R-HSA-427413	REAC	NoRC negatively regulates rRNA expression	10916	1602		0.4838709677419355	0.48936170212765956	105	10811	11	14	94	10797	10916	0.21126388029077814
R1	cpdb	0	network_modules	92	TRUE	6.303741759637625e-14	154	25	12	0.48	0.07792207792207792	REAC:R-HSA-1474165	REAC	Reproduction	10916	2064		0.4946236559139785	0.5	154	10762	12	13	142	10749	10916	0.18926848296635929
R1	cpdb	0	network_modules	92	TRUE	7.386210676141564e-14	108	25	11	0.44	0.10185185185185185	REAC:R-HSA-1912422	REAC	Pre-NOTCH Expression and Processing	10916	1783		0.5053763440860215	0.5212765957446809	108	10808	11	14	97	10794	10916	0.2082048664452398
R1	cpdb	0	network_modules	92	TRUE	7.386210676141564e-14	108	25	11	0.44	0.10185185185185185	REAC:R-HSA-5250941	REAC	Negative epigenetic regulation of rRNA expression	10916	1566		0.5053763440860215	0.5212765957446809	108	10808	11	14	97	10794	10916	0.2082048664452398
R1	cpdb	0	network_modules	92	TRUE	8.205535084505593e-14	109	25	11	0.44	0.10091743119266056	REAC:R-HSA-73854	REAC	RNA Polymerase I Promoter Clearance	10916	1881		0.5268817204301075	0.5319148936170213	109	10807	11	14	98	10793	10916	0.20721304212098127
R1	cpdb	0	network_modules	92	TRUE	8.660750191308366e-14	72	25	10	0.4	0.1388888888888889	REAC:R-HSA-606279	REAC	Deposition of new CENPA-containing nucleosomes at the centromere	10916	730		0.5376344086021505	0.5531914893617021	72	10844	10	15	62	10829	10916	0.2328507369644331
R1	cpdb	0	network_modules	92	TRUE	8.660750191308366e-14	72	25	10	0.4	0.1388888888888889	REAC:R-HSA-774815	REAC	Nucleosome assembly	10916	1621		0.5376344086021505	0.5531914893617021	72	10844	10	15	62	10829	10916	0.2328507369644331
R1	cpdb	0	network_modules	92	TRUE	9.10645092282077e-14	110	25	11	0.44	0.1	REAC:R-HSA-977225	REAC	Amyloid fiber formation	10916	145		0.5591397849462365	0.574468085106383	110	10806	11	14	99	10792	10916	0.20623461342803184
R1	cpdb	0	network_modules	92	TRUE	9.10645092282077e-14	110	25	11	0.44	0.1	REAC:R-HSA-73864	REAC	RNA Polymerase I Transcription	10916	1884		0.5591397849462365	0.574468085106383	110	10806	11	14	99	10792	10916	0.20623461342803184
R1	cpdb	0	network_modules	92	TRUE	9.329394555332066e-14	159	25	12	0.48	0.07547169811320754	REAC:R-HSA-9609646	REAC	HCMV Infection	10916	1089		0.5806451612903226	0.5851063829787234	159	10757	12	13	147	10744	10916	0.1861289044651353
R1	cpdb	0	network_modules	92	TRUE	1.0096174419008877e-13	111	25	11	0.44	0.0990990990990991	REAC:R-HSA-2559582	REAC	Senescence-Associated Secretory Phenotype (SASP)	10916	2194		0.5913978494623656	0.5957446808510638	111	10805	11	14	100	10791	10916	0.2052692786637799
R1	cpdb	0	network_modules	92	TRUE	2.4499059533177324e-13	120	25	11	0.44	0.09166666666666666	REAC:R-HSA-5617472	REAC	Activation of anterior HOX genes in hindbrain development during early embryogenesis	10916	99		0.6021505376344086	0.6170212765957447	120	10796	11	14	109	10782	10916	0.19712510227152985
R1	cpdb	0	network_modules	92	TRUE	2.4499059533177324e-13	120	25	11	0.44	0.09166666666666666	REAC:R-HSA-5619507	REAC	Activation of HOX genes during differentiation	10916	84		0.6021505376344086	0.6170212765957447	120	10796	11	14	109	10782	10916	0.19712510227152985
R1	cpdb	0	network_modules	92	TRUE	2.9549323850183647e-13	122	25	11	0.44	0.09016393442622951	REAC:R-HSA-2559580	REAC	Oxidative Stress Induced Senescence	10916	1654		0.6236559139784946	0.6276595744680851	122	10794	11	14	111	10780	10916	0.1954372555372783
R1	cpdb	0	network_modules	92	TRUE	5.555486938864032e-13	129	25	11	0.44	0.08527131782945736	REAC:R-HSA-8939236	REAC	RUNX1 regulates transcription of genes involved in differentiation of HSCs	10916	1922		0.6344086021505376	0.6382978723404256	129	10787	11	14	118	10773	10916	0.18983808992018011
R1	cpdb	0	network_modules	92	TRUE	5.93047720063251e-13	185	25	12	0.48	0.06486486486486487	REAC:R-HSA-212165	REAC	Epigenetic regulation of gene expression	10916	852		0.6451612903225806	0.648936170212766	185	10731	12	13	173	10718	10916	0.17187940052828413
R1	cpdb	0	network_modules	92	TRUE	6.310186865058645e-13	42	39	9	0.23076923076923078	0.21428571428571427	GO:0045910	GO:BP	negative regulation of DNA recombination	16175	11704		0.25	0.3076923076923077	42	16133	9	30	33	16103	16175	0.22042456300335928
R1	cpdb	0	network_modules	92	TRUE	8.533123723268196e-13	134	25	11	0.44	0.08208955223880597	REAC:R-HSA-211000	REAC	Gene Silencing by RNA	10916	1041		0.6559139784946236	0.6595744680851063	134	10782	11	14	123	10768	10916	0.1861065494075152
R1	cpdb	0	network_modules	92	TRUE	1.4151094050221928e-12	206	39	13	0.3333333333333333	0.06310679611650485	GO:0071824	GO:BP	protein-DNA complex organization	16175	16927		0.3333333333333333	0.38461538461538464	206	15969	13	26	193	15943	16175	0.14056153372246583
R1	cpdb	0	network_modules	92	TRUE	1.6390015763908552e-12	142	25	11	0.44	0.07746478873239436	REAC:R-HSA-68867	REAC	Assembly of the pre-replicative complex	10916	181		0.6666666666666666	0.6702127659574468	142	10774	11	14	131	10760	10916	0.18054534582752907
R1	cpdb	0	network_modules	92	TRUE	2.4172962538230495e-12	147	25	11	0.44	0.07482993197278912	REAC:R-HSA-9018519	REAC	Estrogen-dependent gene expression	10916	866		0.6774193548387096	0.6808510638297872	147	10769	11	14	136	10755	10916	0.17729907594744646
R1	cpdb	0	network_modules	92	TRUE	5.423996100095946e-12	68	25	9	0.36	0.1323529411764706	REAC:R-HSA-5693571	REAC	Nonhomologous End-Joining (NHEJ)	10916	1605		0.6881720430107527	0.6914893617021277	68	10848	9	16	59	10832	10916	0.21542302028889362
R1	cpdb	0	network_modules	92	TRUE	5.819155048262572e-12	159	25	11	0.44	0.06918238993710692	REAC:R-HSA-69002	REAC	DNA Replication Pre-Initiation	10916	446		0.6989247311827957	0.7021276595744681	159	10757	11	14	148	10743	10916	0.17013275338975628
R1	cpdb	0	network_modules	92	TRUE	8.597377848684959e-12	42	25	8	0.32	0.19047619047619047	REAC:R-HSA-9821993	REAC	Replacement of protamines by nucleosomes in the male pronucleus	10916	2060		0.7096774193548387	0.7127659574468085	42	10874	8	17	34	10857	10916	0.2446678334751242
R1	cpdb	0	network_modules	92	TRUE	8.711394406339682e-12	231	25	12	0.48	0.05194805194805195	REAC:R-HSA-201681	REAC	TCF dependent signaling in response to WNT	10916	2421		0.7204301075268817	0.723404255319149	231	10685	12	13	219	10672	10916	0.15274470287445707
R1	cpdb	0	network_modules	92	TRUE	1.3480859349636797e-11	183	39	12	0.3076923076923077	0.06557377049180328	GO:0065004	GO:BP	protein-DNA complex assembly	16175	15888		0.4166666666666667	0.46153846153846156	183	15992	12	27	171	15965	16175	0.13776804214102745
R1	cpdb	0	network_modules	92	TRUE	1.7529489323023596e-11	35	39	8	0.20512820512820512	0.22857142857142856	GO:0030261	GO:BP	chromosome condensation	16175	6749		0.5	0.5384615384615384	35	16140	8	31	27	16109	16175	0.21473986330990735
R1	cpdb	0	network_modules	92	TRUE	1.7545128153882835e-11	77	25	9	0.36	0.11688311688311688	REAC:R-HSA-5693565	REAC	Recruitment and ATM-mediated phosphorylation of repair and signaling proteins at DNA double strand breaks	10916	1949		0.7311827956989247	0.7340425531914894	77	10839	9	16	68	10823	10916	0.20205430635369398
R1	cpdb	0	network_modules	92	TRUE	1.9807312790950405e-11	78	25	9	0.36	0.11538461538461539	REAC:R-HSA-5693606	REAC	DNA Double Strand Break Response	10916	442		0.7419354838709677	0.7446808510638298	78	10838	9	16	69	10822	10916	0.2007120604954579
R1	cpdb	0	network_modules	92	TRUE	3.537577935525635e-11	187	25	11	0.44	0.058823529411764705	REAC:R-HSA-69306	REAC	DNA Replication	10916	445		0.7526881720430108	0.7553191489361702	187	10729	11	14	176	10715	10916	0.1561367958998991
R1	cpdb	0	network_modules	92	TRUE	8.38663862183837e-11	454	39	15	0.38461538461538464	0.03303964757709251	GO:0006338	GO:BP	chromatin remodeling	16175	2126		0.5833333333333334	0.6153846153846154	454	15721	15	24	439	15697	16175	0.10612748868413285
R1	cpdb	0	network_modules	92	TRUE	1.1310072302180881e-10	94	25	9	0.36	0.09574468085106383	REAC:R-HSA-69473	REAC	G2/M DNA damage checkpoint	10916	1006		0.7634408602150538	0.7659574468085106	94	10822	9	16	85	10806	10916	0.18220901469375428
R1	cpdb	0	network_modules	92	TRUE	1.513560917610306e-10	97	25	9	0.36	0.09278350515463918	REAC:R-HSA-5693607	REAC	Processing of DNA double-strand break ends	10916	1798		0.7741935483870968	0.776595744680851	97	10819	9	16	88	10803	10916	0.17925378025799485
R1	cpdb	0	network_modules	92	TRUE	1.7384578829694235e-10	216	25	11	0.44	0.05092592592592592	REAC:R-HSA-8939211	REAC	ESR-mediated signaling	10916	830		0.7849462365591398	0.7872340425531915	216	10700	11	14	205	10686	10916	0.14456058205509542
R1	cpdb	0	network_modules	92	TRUE	2.2360167731638036e-10	221	25	11	0.44	0.049773755656108594	REAC:R-HSA-5689880	REAC	Ub-specific processing proteases	10916	2617		0.7956989247311828	0.7978723404255319	221	10695	11	14	210	10681	10916	0.1427935103506291
R1	cpdb	0	network_modules	92	TRUE	3.811515389204049e-10	232	25	11	0.44	0.047413793103448273	REAC:R-HSA-157118	REAC	Signaling by NOTCH	10916	2274		0.8064516129032258	0.8085106382978723	232	10684	11	14	221	10670	10916	0.13910419102299895
R1	cpdb	0	network_modules	92	TRUE	4.187658734907806e-10	234	25	11	0.44	0.04700854700854701	REAC:R-HSA-8878171	REAC	Transcriptional regulation by RUNX1	10916	2552		0.8172043010752689	0.8191489361702128	234	10682	11	14	223	10668	10916	0.13846081064076549
R1	cpdb	0	network_modules	92	TRUE	5.519799142979801e-10	327	25	12	0.48	0.03669724770642202	REAC:R-HSA-195721	REAC	Signaling by WNT	10916	2314		0.8279569892473119	0.8297872340425532	327	10589	12	13	315	10576	10916	0.1264891432586461
R1	cpdb	0	network_modules	92	TRUE	5.932886115432271e-10	329	25	12	0.48	0.0364741641337386	REAC:R-HSA-73894	REAC	DNA Repair	10916	444		0.8387096774193549	0.8404255319148937	329	10587	12	13	317	10574	10916	0.1260646593027901
R1	cpdb	0	network_modules	92	TRUE	1.4923457152768296e-9	201	22	10	0.45454545454545453	0.04975124378109453	KEGG:05203	KEGG	Viral carcinogenesis	8484	455		0.6	0.6666666666666666	201	8283	10	12	191	8271	8484	0.14444867339586945
R1	cpdb	0	network_modules	92	TRUE	2.5646331621001856e-9	132	25	9	0.36	0.06818181818181818	REAC:R-HSA-5693567	REAC	HDR through Homologous Recombination (HRR) or Single Strand Annealing (SSA)	10916	1098		0.8494623655913979	0.851063829787234	132	10784	9	16	123	10768	10916	0.1525059317834281
R1	cpdb	0	network_modules	92	TRUE	3.84304470093665e-9	138	25	9	0.36	0.06521739130434782	REAC:R-HSA-5693538	REAC	Homology Directed Repair	10916	1130		0.8602150537634409	0.8617021276595744	138	10778	9	16	129	10762	10916	0.14895954370002415
R1	cpdb	0	network_modules	92	TRUE	4.345513784902081e-9	290	25	11	0.44	0.03793103448275862	REAC:R-HSA-9006931	REAC	Signaling by Nuclear Receptors	10916	2289		0.8709677419354839	0.8723404255319149	290	10626	11	14	279	10612	10916	0.12317466884744246
R1	cpdb	0	network_modules	92	TRUE	5.836148437703765e-9	298	25	11	0.44	0.03691275167785235	REAC:R-HSA-5688426	REAC	Deubiquitination	10916	736		0.8817204301075269	0.8829787234042553	298	10618	11	14	287	10604	10916	0.12134036141974389
R1	cpdb	0	network_modules	92	TRUE	7.05070986852704e-9	406	25	12	0.48	0.029556650246305417	REAC:R-HSA-68886	REAC	M Phase	10916	1343		0.8924731182795699	0.8936170212765957	406	10510	12	13	394	10497	10916	0.1121113665488414
R1	cpdb	0	network_modules	92	TRUE	7.500855655392508e-9	113	39	9	0.23076923076923078	0.07964601769911504	GO:0000018	GO:BP	regulation of DNA recombination	16175	6		0.6666666666666666	0.6923076923076923	113	16062	9	30	104	16032	16175	0.1320891006545632
R1	cpdb	0	network_modules	92	TRUE	1.1779877881324142e-8	318	25	11	0.44	0.03459119496855346	REAC:R-HSA-195258	REAC	RHO GTPase Effectors	10916	1846		0.9032258064516129	0.9042553191489362	318	10598	11	14	307	10584	10916	0.11705148515103199
R1	cpdb	0	network_modules	92	TRUE	1.2984335403096089e-8	120	39	9	0.23076923076923078	0.075	GO:0051053	GO:BP	negative regulation of DNA metabolic process	16175	13463		0.75	0.7692307692307693	120	16055	9	30	111	16025	16175	0.1279586228331595
R1	cpdb	0	network_modules	92	TRUE	1.8431034843563592e-8	13	25	5	0.2	0.38461538461538464	REAC:R-HSA-140342	REAC	Apoptosis induced DNA fragmentation	10916	159		0.9139784946236559	0.9148936170212766	13	10903	5	20	8	10883	10916	0.27617934943760347
R1	cpdb	0	network_modules	92	TRUE	2.1569970568662042e-8	167	25	9	0.36	0.05389221556886228	REAC:R-HSA-69481	REAC	G2/M Checkpoints	10916	1005		0.9247311827956989	0.925531914893617	167	10749	9	16	158	10733	10916	0.13455516616933216
R1	cpdb	0	network_modules	92	TRUE	2.276048785386652e-8	168	25	9	0.36	0.05357142857142857	REAC:R-HSA-5693532	REAC	DNA Double-Strand Break Repair	10916	443		0.9354838709677419	0.9361702127659575	168	10748	9	16	159	10732	10916	0.13412469263023086
R1	cpdb	0	network_modules	92	TRUE	6.226750866022801e-8	16	25	5	0.2	0.3125	REAC:R-HSA-2559584	REAC	Formation of Senescence-Associated Heterochromatin Foci (SAHF)	10916	950		0.946236559139785	0.9468085106382979	16	10900	5	20	11	10880	10916	0.24863477867486725
R1	cpdb	0	network_modules	92	TRUE	9.950868838992948e-7	58	25	6	0.24	0.10344827586206896	REAC:R-HSA-8866654	REAC	E3 ubiquitin ligases ubiquitinate target proteins	10916	811		0.956989247311828	0.9574468085106383	58	10858	6	19	52	10839	10916	0.154667552153016
R1	cpdb	0	network_modules	92	TRUE	1.2794889229237784e-6	281	39	10	0.2564102564102564	0.03558718861209965	GO:0006310	GO:BP	DNA recombination	16175	2115		0.8333333333333334	0.8461538461538461	281	15894	10	29	271	15865	16175	0.0899446654813211
R1	cpdb	0	network_modules	92	TRUE	2.7990883243739515e-6	289	25	9	0.36	0.031141868512110725	REAC:R-HSA-69620	REAC	Cell Cycle Checkpoints	10916	321		0.967741935483871	0.9680851063829787	289	10627	9	16	280	10611	10916	0.0995345631493745
R1	cpdb	0	network_modules	92	TRUE	4.757270012160489e-6	545	39	12	0.3076923076923077	0.022018348623853212	GO:0051276	GO:BP	chromosome organization	16175	13613		0.9166666666666666	0.9230769230769231	545	15630	12	27	533	15603	16175	0.07465326983058844
R1	cpdb	0	network_modules	92	TRUE	5.868308209889412e-6	435	39	11	0.28205128205128205	0.02528735632183908	GO:0051052	GO:BP	regulation of DNA metabolic process	16175	13462		1	1	435	15740	11	28	424	15712	16175	0.07754266534536271
R1	cpdb	0	network_modules	92	TRUE	6.128274752969109e-6	78	25	6	0.24	0.07692307692307693	REAC:R-HSA-8852135	REAC	Protein ubiquitination	10916	1818		0.978494623655914	0.9787234042553191	78	10838	6	19	72	10819	10916	0.13245320161426846
R1	cpdb	0	network_modules	92	TRUE	2.374787927319442e-5	116	22	6	0.2727272727272727	0.05172413793103448	KEGG:03082	KEGG	ATP-dependent chromatin remodeling	8484	219		0.8	0.8333333333333334	116	8368	6	16	110	8352	8484	0.11374354546200105
R1	cpdb	0	network_modules	92	TRUE	3.1740524667609195e-5	51	25	5	0.2	0.09803921568627451	REAC:R-HSA-75153	REAC	Apoptotic execution phase	10916	162		0.989247311827957	0.9893617021276596	51	10865	5	20	46	10845	10916	0.1372347548831019
R1	cpdb	0	network_modules	92	TRUE	1.4668103340408192e-4	158	22	6	0.2727272727272727	0.0379746835443038	KEGG:04217	KEGG	Necroptosis	8484	294		1	1	158	8326	6	16	152	8310	8484	0.09583854539779507
R1	cpdb	0	network_modules	92	TRUE	2.7369645721549623e-4	78	25	5	0.2	0.0641025641025641	REAC:R-HSA-3214858	REAC	RMTs methylate histone arginines	10916	1878		1	1	78	10838	5	20	73	10818	10916	0.10970024865387198
R1	cpdb	0	network_modules	93	TRUE	0.00748343660852168	103	9	3	0.3333333333333333	0.02912621359223301	KEGG:04137	KEGG	Mitophagy - animal	8484	274		NA	1	103	8381	3	6	100	8375	8484	0.09557655557955741
R1	cpdb	0	network_modules	94	TRUE	5.185407458075696e-13	369	23	13	0.5652173913043478	0.03523035230352303	GO:0051249	GO:BP	regulation of lymphocyte activation	16175	13596		0	0.015625	369	15806	13	10	356	15796	16175	0.13708631205272498
R1	cpdb	0	network_modules	94	TRUE	1.5919394864115845e-12	699	23	15	0.6521739130434783	0.02145922746781116	GO:0045321	GO:BP	leukocyte activation	16175	11356		0.015873015873015872	0.03125	699	15476	15	8	684	15468	16175	0.11300956757993998
R1	cpdb	0	network_modules	94	TRUE	1.8033975473686278e-12	153	22	11	0.5	0.0718954248366013	KEGG:04514	KEGG	Cell adhesion molecules	8484	315		0	0.08333333333333333	153	8331	11	11	142	8320	8484	0.184670556456696
R1	cpdb	0	network_modules	94	TRUE	2.8670614106071443e-12	421	23	13	0.5652173913043478	0.030878859857482184	GO:0002694	GO:BP	regulation of leukocyte activation	16175	1212		0.031746031746031744	0.046875	421	15754	13	10	408	15744	16175	0.12779094127695215
R1	cpdb	0	network_modules	94	TRUE	3.5129818519984297e-12	569	23	14	0.6086956521739131	0.02460456942003515	GO:0046649	GO:BP	lymphocyte activation	16175	12286		0.047619047619047616	0.0625	569	15606	14	9	555	15597	16175	0.11747355284969319
R1	cpdb	0	network_modules	94	TRUE	1.125090986110288e-11	468	23	13	0.5652173913043478	0.027777777777777776	GO:0050865	GO:BP	regulation of cell activation	16175	13313		0.06349206349206349	0.078125	468	15707	13	10	455	15697	16175	0.12073139702721562
R1	cpdb	0	network_modules	94	TRUE	4.805388786986587e-11	275	23	11	0.4782608695652174	0.04	GO:0002696	GO:BP	positive regulation of leukocyte activation	16175	1214		0.07936507936507936	0.09375	275	15900	11	12	264	15888	16175	0.1346403721774146
R1	cpdb	0	network_modules	94	TRUE	6.850078401698858e-11	284	23	11	0.4782608695652174	0.03873239436619718	GO:0050863	GO:BP	regulation of T cell activation	16175	13311		0.09523809523809523	0.109375	284	15891	11	12	273	15879	16175	0.13236745710147693
R1	cpdb	0	network_modules	94	TRUE	8.620962555299463e-11	290	23	11	0.4782608695652174	0.03793103448275862	GO:0050867	GO:BP	positive regulation of cell activation	16175	13315		0.1111111111111111	0.125	290	15885	11	12	279	15873	16175	0.13091022840747532
R1	cpdb	0	network_modules	94	TRUE	1.6936467176839243e-10	42	23	7	0.30434782608695654	0.16666666666666666	GO:0031294	GO:BP	lymphocyte costimulation	16175	7116		0.12698412698412698	0.140625	42	16133	7	16	35	16117	16175	0.22374940347336666
R1	cpdb	0	network_modules	94	TRUE	9.073785465065035e-10	249	23	10	0.43478260869565216	0.040160642570281124	GO:0051251	GO:BP	positive regulation of lymphocyte activation	16175	13598		0.14285714285714285	0.15625	249	15926	10	13	239	15913	16175	0.12854598723680544
R1	cpdb	0	network_modules	94	TRUE	1.3080812843654831e-9	169	23	9	0.391304347826087	0.05325443786982249	GO:0050670	GO:BP	regulation of lymphocyte proliferation	16175	13204		0.15873015873015872	0.171875	169	16006	9	14	160	15992	16175	0.14134200265640087
R1	cpdb	0	network_modules	94	TRUE	1.4556478889580659e-9	171	23	9	0.391304347826087	0.05263157894736842	GO:0032944	GO:BP	regulation of mononuclear cell proliferation	16175	7929		0.1746031746031746	0.1875	171	16004	9	14	162	15990	16175	0.14047616836552615
R1	cpdb	0	network_modules	94	TRUE	1.5236316760078108e-9	104	23	8	0.34782608695652173	0.07692307692307693	GO:0050671	GO:BP	positive regulation of lymphocyte proliferation	16175	13205		0.19047619047619047	0.203125	104	16071	8	15	96	16056	16175	0.1611817571717648
R1	cpdb	0	network_modules	94	TRUE	1.6479258751083928e-9	105	23	8	0.34782608695652173	0.0761904761904762	GO:0032946	GO:BP	positive regulation of mononuclear cell proliferation	16175	7931		0.20634920634920634	0.21875	105	16070	8	15	97	16055	16175	0.16038832962004096
R1	cpdb	0	network_modules	94	TRUE	3.4047661910533055e-9	406	23	11	0.4782608695652174	0.027093596059113302	GO:0042110	GO:BP	T cell activation	16175	9970		0.2222222222222222	0.234375	406	15769	11	12	395	15757	16175	0.10931554343797102
R1	cpdb	0	network_modules	94	TRUE	3.78292542579056e-9	190	23	9	0.391304347826087	0.04736842105263158	GO:0070663	GO:BP	regulation of leukocyte proliferation	16175	16244		0.23809523809523808	0.25	190	15985	9	14	181	15971	16175	0.13293516635754196
R1	cpdb	0	network_modules	94	TRUE	4.581702330589405e-9	119	23	8	0.34782608695652173	0.06722689075630252	GO:0070665	GO:BP	positive regulation of leukocyte proliferation	16175	16246		0.25396825396825395	0.265625	119	16056	8	15	111	16041	16175	0.15034207451464518
R1	cpdb	0	network_modules	94	TRUE	5.848575217670914e-9	67	20	7	0.35	0.1044776119402985	REAC:R-HSA-388841	REAC	Regulation of T cell activation by CD28 family	10916	2007		0	0.07142857142857142	67	10849	7	13	60	10836	10916	0.18862410192624307
R1	cpdb	0	network_modules	94	TRUE	8.566330925392304e-9	208	23	9	0.391304347826087	0.04326923076923077	GO:0046651	GO:BP	lymphocyte proliferation	16175	12287		0.2698412698412698	0.28125	208	15967	9	14	199	15953	16175	0.1267519042097148
R1	cpdb	0	network_modules	94	TRUE	9.74629811126229e-9	211	23	9	0.391304347826087	0.04265402843601896	GO:0032943	GO:BP	mononuclear cell proliferation	16175	7928		0.2857142857142857	0.296875	211	15964	9	14	202	15950	16175	0.12579774050935616
R1	cpdb	0	network_modules	94	TRUE	2.2911112776472345e-8	40	23	6	0.2608695652173913	0.15	GO:0031295	GO:BP	T cell costimulation	16175	7117		0.30158730158730157	0.3125	40	16135	6	17	34	16118	16175	0.19632128625721898
R1	cpdb	0	network_modules	94	TRUE	2.66689900898805e-8	236	23	9	0.391304347826087	0.038135593220338986	GO:0070661	GO:BP	leukocyte proliferation	16175	16242		0.31746031746031744	0.328125	236	15939	9	14	227	15925	16175	0.11855508817613991
R1	cpdb	0	network_modules	94	TRUE	1.0709379125745111e-7	403	23	10	0.43478260869565216	0.02481389578163772	GO:0001819	GO:BP	positive regulation of cytokine production	16175	476		0.3333333333333333	0.34375	403	15772	10	13	393	15759	16175	0.09922994559484986
R1	cpdb	0	network_modules	94	TRUE	1.0720751958524146e-7	745	23	12	0.5217391304347826	0.016107382550335572	GO:0098609	GO:BP	cell-cell adhesion	16175	18805		0.3492063492063492	0.359375	745	15430	12	11	733	15419	16175	0.08563458749362997
R1	cpdb	0	network_modules	94	TRUE	1.53210976161638e-7	287	23	9	0.391304347826087	0.0313588850174216	GO:1903037	GO:BP	regulation of leukocyte cell-cell adhesion	16175	22717		0.36507936507936506	0.375	287	15888	9	14	278	15874	16175	0.10677778873551474
R1	cpdb	0	network_modules	94	TRUE	2.0777749726069914e-7	297	23	9	0.391304347826087	0.030303030303030304	GO:0030098	GO:BP	lymphocyte differentiation	16175	6676		0.38095238095238093	0.390625	297	15878	9	14	288	15864	16175	0.1048240696666284
R1	cpdb	0	network_modules	94	TRUE	2.458894927828396e-7	195	23	8	0.34782608695652173	0.041025641025641026	GO:0050870	GO:BP	positive regulation of T cell activation	16175	13318		0.3968253968253968	0.40625	195	15980	8	15	187	15965	16175	0.11609989531905658
R1	cpdb	0	network_modules	94	TRUE	3.5668428102161756e-7	26	23	5	0.21739130434782608	0.19230769230769232	GO:0032743	GO:BP	positive regulation of interleukin-2 production	16175	7787		0.4126984126984127	0.421875	26	16149	5	18	21	16131	16175	0.20326124063993475
R1	cpdb	0	network_modules	94	TRUE	3.8092569035768724e-7	206	23	8	0.34782608695652173	0.038834951456310676	GO:0030217	GO:BP	T cell differentiation	16175	6725		0.42857142857142855	0.4375	206	15969	8	15	198	15954	16175	0.11276765478443447
R1	cpdb	0	network_modules	94	TRUE	4.4966281408620583e-7	324	23	9	0.391304347826087	0.027777777777777776	GO:0007159	GO:BP	leukocyte cell-cell adhesion	16175	2723		0.4444444444444444	0.453125	324	15851	9	14	315	15837	16175	0.09999725846251456
R1	cpdb	0	network_modules	94	TRUE	5.354106277085961e-7	215	23	8	0.34782608695652173	0.037209302325581395	GO:1903039	GO:BP	positive regulation of leukocyte cell-cell adhesion	16175	22719		0.4603174603174603	0.46875	215	15960	8	15	207	15945	16175	0.11022994854980296
R1	cpdb	0	network_modules	94	TRUE	9.060317968028182e-7	11	20	4	0.2	0.36363636363636365	REAC:R-HSA-389359	REAC	CD28 dependent Vav1 pathway	10916	268		0.07692307692307693	0.14285714285714285	11	10905	4	16	7	10889	10916	0.26870273217481694
R1	cpdb	0	network_modules	94	TRUE	1.059684918519224e-6	357	23	9	0.391304347826087	0.025210084033613446	GO:1903131	GO:BP	mononuclear cell differentiation	16175	22787		0.47619047619047616	0.484375	357	15818	9	14	348	15804	16175	0.09483878122856969
R1	cpdb	0	network_modules	94	TRUE	1.3686867563660787e-6	77	23	6	0.2608695652173913	0.07792207792207792	GO:0042102	GO:BP	positive regulation of T cell proliferation	16175	9967		0.49206349206349204	0.5	77	16098	6	17	71	16081	16175	0.14040701136747682
R1	cpdb	0	network_modules	94	TRUE	2.1076373221481452e-6	386	23	9	0.391304347826087	0.023316062176165803	GO:0022407	GO:BP	regulation of cell-cell adhesion	16175	6598		0.5079365079365079	0.515625	386	15789	9	14	377	15775	16175	0.0908470747715835
R1	cpdb	0	network_modules	94	TRUE	2.202339182155785e-6	257	23	8	0.34782608695652173	0.0311284046692607	GO:0022409	GO:BP	positive regulation of cell-cell adhesion	16175	6600		0.5238095238095238	0.53125	257	15918	8	15	249	15903	16175	0.10017062671801369
R1	cpdb	0	network_modules	94	TRUE	5.886913527997513e-6	434	23	9	0.391304347826087	0.020737327188940093	GO:0002521	GO:BP	leukocyte differentiation	16175	1043		0.5396825396825397	0.546875	434	15741	9	14	425	15727	16175	0.08511364202349113
R1	cpdb	0	network_modules	94	TRUE	7.833196975216614e-6	627	23	10	0.43478260869565216	0.01594896331738437	GO:0050778	GO:BP	positive regulation of immune response	16175	13252		0.5555555555555556	0.5625	627	15548	10	13	617	15535	16175	0.07741767664236743
R1	cpdb	0	network_modules	94	TRUE	8.713828068955464e-6	634	23	10	0.43478260869565216	0.015772870662460567	GO:0001817	GO:BP	regulation of cytokine production	16175	474		0.5714285714285714	0.578125	634	15541	10	13	624	15528	16175	0.07692229051662422
R1	cpdb	0	network_modules	94	TRUE	9.096961108398377e-6	48	23	5	0.21739130434782608	0.10416666666666667	GO:0032623	GO:BP	interleukin-2 production	16175	7670		0.5873015873015873	0.609375	48	16127	5	18	43	16109	16175	0.14875465111616545
R1	cpdb	0	network_modules	94	TRUE	9.096961108398377e-6	48	23	5	0.21739130434782608	0.10416666666666667	GO:0032663	GO:BP	regulation of interleukin-2 production	16175	7709		0.5873015873015873	0.609375	48	16127	5	18	43	16109	16175	0.14875465111616545
R1	cpdb	0	network_modules	94	TRUE	9.255644773144163e-6	638	23	10	0.43478260869565216	0.01567398119122257	GO:0001816	GO:BP	cytokine production	16175	473		0.6190476190476191	0.625	638	15537	10	13	628	15524	16175	0.07664270368477451
R1	cpdb	0	network_modules	94	TRUE	1.3162375710644989e-5	20	20	4	0.2	0.2	REAC:R-HSA-389513	REAC	Co-inhibition by CTLA4	10916	376		0.15384615384615385	0.21428571428571427	20	10896	4	16	16	10880	10916	0.19853157121879586
R1	cpdb	0	network_modules	94	TRUE	1.836179940515229e-5	55	23	5	0.21739130434782608	0.09090909090909091	GO:0050853	GO:BP	B cell receptor signaling pathway	16175	13301		0.6349206349206349	0.640625	55	16120	5	18	50	16102	16175	0.13871604229510412
R1	cpdb	0	network_modules	94	TRUE	1.9825990907359984e-5	22	20	4	0.2	0.18181818181818182	REAC:R-HSA-389357	REAC	CD28 dependent PI3K/Akt signaling	10916	267		0.23076923076923078	0.2857142857142857	22	10894	4	16	18	10878	10916	0.18913477343345228
R1	cpdb	0	network_modules	94	TRUE	2.9897534220539752e-5	128	23	6	0.2608695652173913	0.046875	GO:0042129	GO:BP	regulation of T cell proliferation	16175	9983		0.6507936507936508	0.65625	128	16047	6	17	122	16030	16175	0.10773041476687523
R1	cpdb	0	network_modules	94	TRUE	4.072908010931541e-5	373	23	8	0.34782608695652173	0.021447721179624665	GO:0045785	GO:BP	positive regulation of cell adhesion	16175	11617		0.6666666666666666	0.671875	373	15802	8	15	365	15787	16175	0.08164975958808147
R1	cpdb	0	network_modules	94	TRUE	4.671169175536237e-5	756	23	10	0.43478260869565216	0.013227513227513227	GO:0050776	GO:BP	regulation of immune response	16175	13250		0.6825396825396826	0.6875	756	15419	10	13	746	15406	16175	0.06937241559997945
R1	cpdb	0	network_modules	94	TRUE	5.115754554055161e-5	140	23	6	0.2608695652173913	0.04285714285714286	GO:0042098	GO:BP	T cell proliferation	16175	9965		0.6984126984126984	0.703125	140	16035	6	17	134	16018	16175	0.10274628910287421
R1	cpdb	0	network_modules	94	TRUE	8.43835791398879e-5	31	20	4	0.2	0.12903225806451613	REAC:R-HSA-389356	REAC	Co-stimulation by CD28	10916	378		0.3076923076923077	0.35714285714285715	31	10885	4	16	27	10869	10916	0.15873365411296622
R1	cpdb	0	network_modules	94	TRUE	1.0530193102324046e-4	158	23	6	0.2608695652173913	0.0379746835443038	GO:0050851	GO:BP	antigen receptor-mediated signaling pathway	16175	13299		0.7142857142857143	0.71875	158	16017	6	17	152	16000	16175	0.09634408687544392
R1	cpdb	0	network_modules	94	TRUE	1.325317553082424e-4	622	23	9	0.391304347826087	0.014469453376205787	GO:0030155	GO:BP	regulation of cell adhesion	16175	6688		0.7301587301587301	0.734375	622	15553	9	14	613	15539	16175	0.06924410838747647
R1	cpdb	0	network_modules	94	TRUE	1.4041084296065385e-4	37	22	4	0.18181818181818182	0.10810810810810811	KEGG:05340	KEGG	Primary immunodeficiency	8484	488		0.09090909090909091	0.16666666666666666	37	8447	4	18	33	8429	8484	0.1373145610049259
R1	cpdb	0	network_modules	94	TRUE	1.6468155575819277e-4	638	23	9	0.391304347826087	0.014106583072100314	GO:0030097	GO:BP	hemopoiesis	16175	6675		0.746031746031746	0.75	638	15537	9	14	629	15523	16175	0.06821375720743471
R1	cpdb	0	network_modules	94	TRUE	2.0288220585922492e-4	92	22	5	0.22727272727272727	0.05434782608695652	KEGG:04640	KEGG	Hematopoietic cell lineage	8484	333		0.18181818181818182	0.25	92	8392	5	17	87	8375	8484	0.10655255336306409
R1	cpdb	0	network_modules	94	TRUE	2.628000647512518e-4	475	23	8	0.34782608695652173	0.016842105263157894	GO:0002253	GO:BP	activation of immune response	16175	785		0.7619047619047619	0.765625	475	15700	8	15	467	15685	16175	0.07117918571182458
R1	cpdb	0	network_modules	94	TRUE	2.8619121243440864e-4	187	23	6	0.2608695652173913	0.03208556149732621	GO:0032496	GO:BP	response to lipopolysaccharide	16175	7607		0.7777777777777778	0.78125	187	15988	6	17	181	15971	16175	0.08800640724400871
R1	cpdb	0	network_modules	94	TRUE	3.0558222361424235e-4	686	23	9	0.391304347826087	0.013119533527696793	GO:0008284	GO:BP	positive regulation of cell population proliferation	16175	3151		0.7936507936507936	0.796875	686	15489	9	14	677	15475	16175	0.06533017717755436
R1	cpdb	0	network_modules	94	TRUE	3.8928332929338296e-4	197	23	6	0.2608695652173913	0.030456852791878174	GO:0042113	GO:BP	B cell activation	16175	9971		0.8095238095238095	0.8125	197	15978	6	17	191	15961	16175	0.08555778596943853
R1	cpdb	0	network_modules	94	TRUE	4.413428590720678e-4	49	22	4	0.18181818181818182	0.08163265306122448	KEGG:05320	KEGG	Autoimmune thyroid disease	8484	482		0.2727272727272727	0.3333333333333333	49	8435	4	18	45	8417	8484	0.11845480738832914
R1	cpdb	0	network_modules	94	TRUE	4.6459555602453733e-4	203	23	6	0.2608695652173913	0.029556650246305417	GO:0002237	GO:BP	response to molecule of bacterial origin	16175	770		0.8253968253968254	0.828125	203	15972	6	17	197	15955	16175	0.08417399084388594
R1	cpdb	0	network_modules	94	TRUE	7.200452064244141e-4	119	22	5	0.22727272727272727	0.04201680672268908	KEGG:04660	KEGG	T cell receptor signaling pathway	8484	338		0.36363636363636365	0.4166666666666667	119	8365	5	17	114	8348	8484	0.09245929787094238
R1	cpdb	0	network_modules	94	TRUE	8.060897483566439e-4	47	23	4	0.17391304347826086	0.0851063829787234	GO:0030888	GO:BP	regulation of B cell proliferation	16175	6953		0.8412698412698413	0.84375	47	16128	4	19	43	16109	16175	0.11988658268773313
R1	cpdb	0	network_modules	94	TRUE	0.0015777130688236533	133	23	5	0.21739130434782608	0.03759398496240601	GO:0071706	GO:BP	tumor necrosis factor superfamily cytokine production	16175	16870		0.8571428571428571	0.875	133	16042	5	18	128	16024	16175	0.0874050962533271
R1	cpdb	0	network_modules	94	TRUE	0.0015777130688236533	133	23	5	0.21739130434782608	0.03759398496240601	GO:1903555	GO:BP	regulation of tumor necrosis factor superfamily cytokine production	16175	23102		0.8571428571428571	0.875	133	16042	5	18	128	16024	16175	0.0874050962533271
R1	cpdb	0	network_modules	94	TRUE	0.0017445892058575066	65	20	4	0.2	0.06153846153846154	REAC:R-HSA-2219530	REAC	Constitutive Signaling by Aberrant PI3K in Cancer	10916	401		0.38461538461538464	0.42857142857142855	65	10851	4	16	61	10835	10916	0.10805798235495745
R1	cpdb	0	network_modules	94	TRUE	0.0018407742641852534	416	23	7	0.30434782608695654	0.016826923076923076	GO:0002757	GO:BP	immune response-activating signaling pathway	16175	1268		0.8888888888888888	0.890625	416	15759	7	16	409	15743	16175	0.06642178942459889
R1	cpdb	0	network_modules	94	TRUE	0.0021811597977939236	142	23	5	0.21739130434782608	0.035211267605633804	GO:0071222	GO:BP	cellular response to lipopolysaccharide	16175	16484		0.9047619047619048	0.90625	142	16033	5	18	137	16015	16175	0.08438853511066824
R1	cpdb	0	network_modules	94	TRUE	0.002211739048194457	265	23	6	0.2608695652173913	0.022641509433962263	GO:0002429	GO:BP	immune response-activating cell surface receptor signaling pathway	16175	952		0.9206349206349206	0.921875	265	15910	6	17	259	15893	16175	0.07267607767748177
R1	cpdb	0	network_modules	94	TRUE	0.002314230743942589	21	20	3	0.15	0.14285714285714285	REAC:R-HSA-164938	REAC	Nef-mediates down modulation of cell surface receptors by recruiting them to clathrin adapters	10916	1565		0.46153846153846156	0.5	21	10895	3	17	18	10878	10916	0.14477948506952504
R1	cpdb	0	network_modules	94	TRUE	0.0025460995112355353	4	22	2	0.09090909090909091	0.5	KEGG:03267	KEGG	Virion - Adenovirus	8484	233		0.45454545454545453	0.5	4	8480	2	20	2	8460	8484	0.21242061877326804
R1	cpdb	0	network_modules	94	TRUE	0.002557081955544068	437	23	7	0.30434782608695654	0.016018306636155607	GO:0002764	GO:BP	immune response-regulating signaling pathway	16175	1275		0.9365079365079365	0.9375	437	15738	7	16	430	15722	16175	0.06454724467342222
R1	cpdb	0	network_modules	94	TRUE	0.003051212635880357	152	23	5	0.21739130434782608	0.03289473684210526	GO:0071219	GO:BP	cellular response to molecule of bacterial origin	16175	16481		0.9523809523809523	0.953125	152	16023	5	18	147	16005	16175	0.08134902115096028
R1	cpdb	0	network_modules	94	TRUE	0.0030743851977927056	23	20	3	0.15	0.13043478260869565	REAC:R-HSA-202427	REAC	Phosphorylation of CD3 and TCR zeta chains	10916	1749		0.5384615384615384	0.5714285714285714	23	10893	3	17	20	10876	10916	0.13818309942561657
R1	cpdb	0	network_modules	94	TRUE	0.0035094784688445447	24	20	3	0.15	0.125	REAC:R-HSA-389948	REAC	Co-inhibition by PD-1	10916	377		0.6153846153846154	0.6428571428571429	24	10892	3	17	21	10875	10916	0.13519606957514896
R1	cpdb	0	network_modules	94	TRUE	0.003513697667159134	287	23	6	0.2608695652173913	0.020905923344947737	GO:0002768	GO:BP	immune response-regulating cell surface receptor signaling pathway	16175	1279		0.9682539682539683	0.96875	287	15888	6	17	281	15871	16175	0.06949461203778098
R1	cpdb	0	network_modules	94	TRUE	0.004236830037700827	5	22	2	0.09090909090909091	0.4	KEGG:03260	KEGG	Virion - Human immunodeficiency virus	8484	226		0.5454545454545454	0.5833333333333334	5	8479	2	20	3	8459	8484	0.18975834274624442
R1	cpdb	0	network_modules	94	TRUE	0.004545359991512413	88	22	4	0.18181818181818182	0.045454545454545456	KEGG:05323	KEGG	Rheumatoid arthritis	8484	485		0.6363636363636364	0.6666666666666666	88	8396	4	18	84	8378	8484	0.08628286878992067
R1	cpdb	0	network_modules	94	TRUE	0.004751160156549044	89	22	4	0.18181818181818182	0.0449438202247191	KEGG:05235	KEGG	PD-L1 expression and PD-1 checkpoint pathway in cancer	8484	480		0.7272727272727273	0.75	89	8395	4	18	85	8377	8484	0.08574288530385946
R1	cpdb	0	network_modules	94	TRUE	0.0050539975353607975	27	20	3	0.15	0.1111111111111111	REAC:R-HSA-164952	REAC	The role of Nef in HIV-1 replication and disease pathogenesis	10916	2504		0.6923076923076923	0.7142857142857143	27	10889	3	17	24	10872	10916	0.1272445913898661
R1	cpdb	0	network_modules	94	TRUE	0.005600003077087296	172	23	5	0.21739130434782608	0.029069767441860465	GO:0071216	GO:BP	cellular response to biotic stimulus	16175	16478		0.9841269841269841	0.984375	172	16003	5	18	167	15985	16175	0.07606618449147032
R1	cpdb	0	network_modules	94	TRUE	0.005642090175856925	76	23	4	0.17391304347826086	0.05263157894736842	GO:0042100	GO:BP	B cell proliferation	16175	9966		1	1	76	16099	4	19	72	16080	16175	0.09337405402441767
R1	cpdb	0	network_modules	94	TRUE	0.00570138057034724	34	22	3	0.13636363636363635	0.08823529411764706	KEGG:05330	KEGG	Allograft rejection	8484	486		0.8181818181818182	0.8333333333333334	34	8450	3	19	31	8431	8484	0.10681976415154498
R1	cpdb	0	network_modules	94	TRUE	0.006450603655071502	4	20	2	0.1	0.5	REAC:R-HSA-173107	REAC	Binding and entry of HIV virion	10916	224		0.7692307692307693	0.7857142857142857	4	10912	2	18	2	10894	10916	0.22303266570648034
R1	cpdb	0	network_modules	94	TRUE	0.006974921103044978	92	20	4	0.2	0.043478260869565216	REAC:R-HSA-6811558	REAC	PI5P, PP2A and IER3 Regulate PI3K/AKT Signaling	10916	1677		0.8461538461538461	0.9285714285714286	92	10824	4	16	88	10808	10916	0.08978198753849509
R1	cpdb	0	network_modules	94	TRUE	0.006974921103044978	92	20	4	0.2	0.043478260869565216	REAC:R-HSA-2219528	REAC	PI3K/AKT Signaling in Cancer	10916	1674		0.8461538461538461	0.9285714285714286	92	10824	4	16	88	10808	10916	0.08978198753849509
R1	cpdb	0	network_modules	94	TRUE	0.007365798362256934	37	22	3	0.13636363636363635	0.08108108108108109	KEGG:05332	KEGG	Graft-versus-host disease	8484	487		0.9090909090909091	0.9166666666666666	37	8447	3	19	34	8428	8484	0.10214226659137021
R1	cpdb	0	network_modules	94	TRUE	0.009318934236953316	40	22	3	0.13636363636363635	0.075	KEGG:04940	KEGG	Type I diabetes mellitus	8484	394		1	1	40	8444	3	19	37	8425	8484	0.09799153206191212
R1	cpdb	0	network_modules	94	TRUE	0.009319766633021967	99	20	4	0.2	0.04040404040404041	REAC:R-HSA-199418	REAC	Negative regulation of the PI3K/AKT network	10916	1580		1	1	99	10817	4	16	95	10801	10916	0.08628788615561417
R1	cpdb	0	network_modules	95	TRUE	1.5528732974810387e-4	9	19	3	0.15789473684210525	0.3333333333333333	GO:0050915	GO:BP	sensory perception of sour taste	16175	13357		0	0.3333333333333333	9	16166	3	16	6	16150	16175	0.2288053323123006
R1	cpdb	0	network_modules	95	TRUE	0.0030706922176114773	192	19	5	0.2631578947368421	0.026041666666666668	GO:0043123	GO:BP	positive regulation of canonical NF-kappaB signal transduction	16175	10542		0.5	0.6666666666666666	192	15983	5	14	187	15969	16175	0.07956932566859212
R1	cpdb	0	network_modules	95	TRUE	0.0072588319955501765	102	19	4	0.21052631578947367	0.0392156862745098	GO:0038061	GO:BP	non-canonical NF-kappaB signal transduction	16175	9680		1	1	102	16073	4	15	98	16058	16175	0.08847172468690633
R1	cpdb	0	network_modules	96	TRUE	7.3586065262195555e-6	140	9	5	0.5555555555555556	0.03571428571428571	KEGG:04120	KEGG	Ubiquitin mediated proteolysis	8484	270		NA	1	140	8344	5	4	135	8340	8484	0.13789010185098058
R1	cpdb	0	network_modules	96	TRUE	1.6033789223663246e-4	749	26	10	0.38461538461538464	0.01335113484646195	GO:0070647	GO:BP	protein modification by small protein conjugation or removal	16175	16231		0	0.125	749	15426	10	16	739	15410	16175	0.0645958449098927
R1	cpdb	0	network_modules	96	TRUE	2.8971346856383897e-4	798	26	10	0.38461538461538464	0.012531328320802004	GO:0043687	GO:BP	post-translational protein modification	16175	10838		0.14285714285714285	0.25	798	15377	10	16	788	15361	16175	0.06211958257056334
R1	cpdb	0	network_modules	96	TRUE	3.686730556648346e-4	35	26	4	0.15384615384615385	0.11428571428571428	GO:0006301	GO:BP	postreplication repair	16175	2108		0.2857142857142857	0.375	35	16140	4	22	31	16118	16175	0.13098070495541675
R1	cpdb	0	network_modules	96	TRUE	7.54470860924323e-4	667	26	9	0.34615384615384615	0.013493253373313344	GO:0032446	GO:BP	protein modification by small protein conjugation	16175	7568		0.42857142857142855	0.5	667	15508	9	17	658	15491	16175	0.061531782789402696
R1	cpdb	0	network_modules	96	TRUE	0.001102287269551903	58	20	4	0.2	0.06896551724137931	REAC:R-HSA-8866654	REAC	E3 ubiquitin ligases ubiquitinate target proteins	10916	811		0	0.3333333333333333	58	10858	4	16	54	10842	10916	0.11473405483915587
R1	cpdb	0	network_modules	96	TRUE	0.002300329022634316	15	26	3	0.11538461538461539	0.2	GO:0034501	GO:BP	protein localization to kinetochore	16175	8667		0.5714285714285714	0.75	15	16160	3	23	12	16137	16175	0.15088121656469844
R1	cpdb	0	network_modules	96	TRUE	0.002300329022634316	15	26	3	0.11538461538461539	0.2	GO:1903083	GO:BP	protein localization to condensed chromosome	16175	22757		0.5714285714285714	0.75	15	16160	3	23	12	16137	16175	0.15088121656469844
R1	cpdb	0	network_modules	96	TRUE	0.0033627878579465826	798	26	9	0.34615384615384615	0.011278195488721804	GO:0006974	GO:BP	DNA damage response	16175	2601		0.8571428571428571	0.875	798	15377	9	17	789	15360	16175	0.05499355422998049
R1	cpdb	0	network_modules	96	TRUE	0.003619839765319459	78	20	4	0.2	0.05128205128205128	REAC:R-HSA-8852135	REAC	Protein ubiquitination	10916	1818		0.5	0.6666666666666666	78	10838	4	16	74	10822	10916	0.09809637007923251
R1	cpdb	0	network_modules	96	TRUE	0.006558062695185423	329	20	6	0.3	0.0182370820668693	REAC:R-HSA-73894	REAC	DNA Repair	10916	444		1	1	329	10587	6	14	323	10573	10916	0.06762391387676078
R1	cpdb	0	network_modules	96	TRUE	0.0066811333727300375	21	26	3	0.11538461538461539	0.14285714285714285	GO:0051988	GO:BP	regulation of attachment of spindle microtubules to kinetochore	16175	14050		1	1	21	16154	3	23	18	16131	16175	0.12712823401015022
R1	cpdb	0	network_modules	97	TRUE	1.986045904735523e-18	7	20	7	0.35	1	GO:0035654	GO:BP	clathrin-coated vesicle cargo loading, AP-3-mediated	16175	9140		0	0.05	7	16168	7	13	0	16155	16175	0.5913700870951584
R1	cpdb	0	network_modules	97	TRUE	1.986045904735523e-18	7	20	7	0.35	1	GO:0035652	GO:BP	clathrin-coated vesicle cargo loading	16175	9138		0	0.05	7	16168	7	13	0	16155	16175	0.5913700870951584
R1	cpdb	0	network_modules	97	TRUE	6.271639704100332e-14	18	20	7	0.35	0.3888888888888889	GO:0099517	GO:BP	synaptic vesicle transport along microtubule	16175	19106		0.05128205128205128	0.125	18	16157	7	13	11	16144	16175	0.3681918676225529
R1	cpdb	0	network_modules	97	TRUE	6.271639704100332e-14	18	20	7	0.35	0.3888888888888889	GO:0099514	GO:BP	synaptic vesicle cytoskeletal transport	16175	19104		0.05128205128205128	0.125	18	16157	7	13	11	16144	16175	0.3681918676225529
R1	cpdb	0	network_modules	97	TRUE	6.271639704100332e-14	18	20	7	0.35	0.3888888888888889	GO:0048490	GO:BP	anterograde synaptic vesicle transport	16175	12783		0.05128205128205128	0.125	18	16157	7	13	11	16144	16175	0.3681918676225529
R1	cpdb	0	network_modules	97	TRUE	2.4726529699924906e-12	5	20	5	0.25	1	GO:0016183	GO:BP	synaptic vesicle coating	16175	5163		0.1282051282051282	0.15	5	16170	5	15	0	16155	16175	0.49976803524615626
R1	cpdb	0	network_modules	97	TRUE	8.330556399086442e-12	33	20	7	0.35	0.21212121212121213	GO:0048489	GO:BP	synaptic vesicle transport	16175	12782		0.15384615384615385	0.175	33	16142	7	13	26	16129	16175	0.27133089992410014
R1	cpdb	0	network_modules	97	TRUE	1.048294139761722e-11	34	20	7	0.35	0.20588235294117646	GO:0035459	GO:BP	vesicle cargo loading	16175	9047		0.1794871794871795	0.2	34	16141	7	13	27	16128	16175	0.2672717450458439
R1	cpdb	0	network_modules	97	TRUE	3.617632290224942e-11	40	20	7	0.35	0.175	GO:0097479	GO:BP	synaptic vesicle localization	16175	18670		0.20512820512820512	0.225	40	16135	7	13	33	16122	16175	0.24619540143672167
R1	cpdb	0	network_modules	97	TRUE	5.184546121994684e-11	7	20	5	0.25	0.7142857142857143	GO:0070142	GO:BP	synaptic vesicle budding	16175	15937		0.23076923076923078	0.275	7	16168	5	15	2	16153	16175	0.422198027869546
R1	cpdb	0	network_modules	97	TRUE	5.184546121994684e-11	7	20	5	0.25	0.7142857142857143	GO:0016185	GO:BP	synaptic vesicle budding from presynaptic endocytic zone membrane	16175	5164		0.23076923076923078	0.275	7	16168	5	15	2	16153	16175	0.422198027869546
R1	cpdb	0	network_modules	97	TRUE	5.2275524427180277e-11	42	20	7	0.35	0.16666666666666666	GO:0047496	GO:BP	vesicle transport along microtubule	16175	12458		0.28205128205128205	0.325	42	16133	7	13	35	16120	16175	0.24019151353181872
R1	cpdb	0	network_modules	97	TRUE	5.2275524427180277e-11	42	20	7	0.35	0.16666666666666666	GO:0008089	GO:BP	anterograde axonal transport	16175	3120		0.28205128205128205	0.325	42	16133	7	13	35	16120	16175	0.24019151353181872
R1	cpdb	0	network_modules	97	TRUE	3.402741227719031e-10	54	20	7	0.35	0.12962962962962962	GO:0098930	GO:BP	axonal transport	16175	18959		0.3333333333333333	0.35	54	16121	7	13	47	16108	16175	0.21145529630610088
R1	cpdb	0	network_modules	97	TRUE	8.34105212316964e-10	61	20	7	0.35	0.11475409836065574	GO:0008088	GO:BP	axo-dendritic transport	16175	3119		0.358974358974359	0.375	61	16114	7	13	54	16101	16175	0.1987478019214421
R1	cpdb	0	network_modules	97	TRUE	1.6556549726253234e-9	67	20	7	0.35	0.1044776119402985	GO:0099518	GO:BP	vesicle cytoskeletal trafficking	16175	19107		0.38461538461538464	0.4	67	16108	7	13	60	16095	16175	0.18947205932420302
R1	cpdb	0	network_modules	97	TRUE	3.0888817731886204e-9	73	20	7	0.35	0.0958904109589041	GO:0072384	GO:BP	organelle transport along microtubule	16175	17378		0.41025641025641024	0.425	73	16102	7	13	66	16089	16175	0.18135770119103042
R1	cpdb	0	network_modules	97	TRUE	7.785355005118735e-9	131	12	7	0.5833333333333334	0.05343511450381679	KEGG:04142	KEGG	Lysosome	8484	279		NA	1	131	8353	7	5	124	8348	8484	0.17334349816227396
R1	cpdb	0	network_modules	97	TRUE	2.8442336685861744e-8	19	20	5	0.25	0.2631578947368421	GO:1903232	GO:BP	melanosome assembly	16175	22844		0.4358974358974359	0.45	19	16156	5	15	14	16141	16175	0.2555975596256606
R1	cpdb	0	network_modules	97	TRUE	1.0356426958932522e-7	24	20	5	0.25	0.20833333333333334	GO:0060155	GO:BP	platelet dense granule organization	16175	14393		0.46153846153846156	0.475	24	16151	5	15	19	16136	16175	0.22717222470623896
R1	cpdb	0	network_modules	97	TRUE	3.9608363657346385e-7	144	20	7	0.35	0.04861111111111111	GO:0010970	GO:BP	transport along microtubule	16175	4546		0.48717948717948717	0.5	144	16031	7	13	137	16018	16175	0.12776815598837402
R1	cpdb	0	network_modules	97	TRUE	9.100787346903916e-7	36	20	5	0.25	0.1388888888888889	GO:0006901	GO:BP	vesicle coating	16175	2554		0.5128205128205128	0.525	36	16139	5	15	31	16124	16175	0.18500036202228937
R1	cpdb	0	network_modules	97	TRUE	1.0315070003524783e-6	165	20	7	0.35	0.04242424242424243	GO:0099111	GO:BP	microtubule-based transport	16175	19044		0.5384615384615384	0.55	165	16010	7	13	158	15997	16175	0.1189844910347604
R1	cpdb	0	network_modules	97	TRUE	1.3866839803069322e-6	39	20	5	0.25	0.1282051282051282	GO:0032438	GO:BP	melanosome organization	16175	7566		0.5641025641025641	0.6	39	16136	5	15	34	16121	16175	0.17762605916545768
R1	cpdb	0	network_modules	97	TRUE	1.3866839803069322e-6	39	20	5	0.25	0.1282051282051282	GO:0048753	GO:BP	pigment granule organization	16175	13004		0.5641025641025641	0.6	39	16136	5	15	34	16121	16175	0.17762605916545768
R1	cpdb	0	network_modules	97	TRUE	1.754544628399391e-6	178	20	7	0.35	0.03932584269662921	GO:0051650	GO:BP	establishment of vesicle localization	16175	13863		0.6153846153846154	0.625	178	15997	7	13	171	15984	16175	0.11433265545377533
R1	cpdb	0	network_modules	97	TRUE	2.297506929207622e-6	185	20	7	0.35	0.03783783783783784	GO:0030705	GO:BP	cytoskeleton-dependent intracellular transport	16175	6886		0.6410256410256411	0.65	185	15990	7	13	178	15977	16175	0.11203009049049306
R1	cpdb	0	network_modules	97	TRUE	2.3856608134568382e-6	186	20	7	0.35	0.03763440860215054	GO:0051648	GO:BP	vesicle localization	16175	13861		0.6666666666666666	0.675	186	15989	7	13	179	15976	16175	0.11171161930855909
R1	cpdb	0	network_modules	97	TRUE	4.557220115811483e-6	49	20	5	0.25	0.10204081632653061	GO:0140238	GO:BP	presynaptic endocytosis	16175	19709		0.6923076923076923	0.725	49	16126	5	15	44	16111	16175	0.15812107356619148
R1	cpdb	0	network_modules	97	TRUE	4.557220115811483e-6	49	20	5	0.25	0.10204081632653061	GO:0048488	GO:BP	synaptic vesicle endocytosis	16175	12781		0.6923076923076923	0.725	49	16126	5	15	44	16111	16175	0.15812107356619148
R1	cpdb	0	network_modules	97	TRUE	6.065242815013173e-6	519	20	9	0.45	0.017341040462427744	GO:0051640	GO:BP	organelle localization	16175	13853		0.7435897435897436	0.75	519	15656	9	11	510	15645	16175	0.08343880313863593
R1	cpdb	0	network_modules	97	TRUE	6.19678406400031e-6	52	20	5	0.25	0.09615384615384616	GO:0033363	GO:BP	secretory granule organization	16175	8173		0.7692307692307693	0.775	52	16123	5	15	47	16108	16175	0.15339113176422645
R1	cpdb	0	network_modules	97	TRUE	1.0874633797340766e-5	58	20	5	0.25	0.08620689655172414	GO:0033059	GO:BP	cellular pigmentation	16175	8013		0.7948717948717948	0.8	58	16117	5	15	53	16102	16175	0.14504924469982958
R1	cpdb	0	network_modules	97	TRUE	1.1872344474259014e-5	59	20	5	0.25	0.0847457627118644	GO:0036465	GO:BP	synaptic vesicle recycling	16175	9613		0.8205128205128205	0.825	59	16116	5	15	54	16101	16175	0.1437831390341632
R1	cpdb	0	network_modules	97	TRUE	3.7759573816618376e-5	74	20	5	0.25	0.06756756756756757	GO:0006900	GO:BP	vesicle budding from membrane	16175	2553		0.8461538461538461	0.85	74	16101	5	15	69	16086	16175	0.12796240361427896
R1	cpdb	0	network_modules	97	TRUE	5.9733071619191486e-5	81	20	5	0.25	0.06172839506172839	GO:0043473	GO:BP	pigmentation	16175	10719		0.8717948717948718	0.875	81	16094	5	15	76	16079	16175	0.12211912486091774
R1	cpdb	0	network_modules	97	TRUE	9.115937146301349e-5	315	20	7	0.35	0.022222222222222223	GO:0016050	GO:BP	vesicle organization	16175	5082		0.8974358974358975	0.9	315	15860	7	13	308	15847	16175	0.0841596482266056
R1	cpdb	0	network_modules	97	TRUE	1.7998390274384483e-4	348	20	7	0.35	0.020114942528735632	GO:0007018	GO:BP	microtubule-based movement	16175	2626		0.9230769230769231	0.925	348	15827	7	13	341	15814	16175	0.07965863209510453
R1	cpdb	0	network_modules	97	TRUE	3.798629011684806e-4	117	20	5	0.25	0.042735042735042736	GO:0099504	GO:BP	synaptic vesicle cycle	16175	19100		0.9487179487179487	0.95	117	16058	5	15	112	16043	16175	0.1007989739564291
R1	cpdb	0	network_modules	97	TRUE	4.492987814835498e-4	121	20	5	0.25	0.04132231404958678	GO:0099003	GO:BP	vesicle-mediated transport in synapse	16175	18999		0.9743589743589743	0.975	121	16054	5	15	116	16039	16175	0.09903024038488864
R1	cpdb	0	network_modules	97	TRUE	5.475381378563882e-4	410	20	7	0.35	0.01707317073170732	GO:0051656	GO:BP	establishment of organelle localization	16175	13869		1	1	410	15765	7	13	403	15752	16175	0.072675042647863
R1	cpdb	0	network_modules	98	TRUE	2.9286805157217947e-4	16	14	3	0.21428571428571427	0.1875	REAC:R-HSA-399956	REAC	CRMPs in Sema3A signaling	10916	287		NA	1	16	10900	3	11	13	10889	10916	0.199348790673656
R1	cpdb	0	network_modules	99	TRUE	6.629017017977517e-14	34	22	8	0.36363636363636365	0.23529411764705882	GO:0006891	GO:BP	intra-Golgi vesicle-mediated transport	16175	2546		0	0.25	34	16141	8	14	26	16127	16175	0.291322432662058
R1	cpdb	0	network_modules	99	TRUE	9.96640753217108e-13	99	16	9	0.5625	0.09090909090909091	REAC:R-HSA-6811434	REAC	COPI-dependent Golgi-to-ER retrograde traffic	10916	277		0	0.14285714285714285	99	10817	9	7	90	10810	10916	0.22366732222717753
R1	cpdb	0	network_modules	99	TRUE	1.3164061337007898e-12	102	16	9	0.5625	0.08823529411764706	REAC:R-HSA-6807878	REAC	COPI-mediated anterograde transport	10916	279		0.16666666666666666	0.2857142857142857	102	10814	9	7	93	10807	10916	0.22027467233582984
R1	cpdb	0	network_modules	99	TRUE	1.5360045722427096e-11	133	16	9	0.5625	0.06766917293233082	REAC:R-HSA-8856688	REAC	Golgi-to-ER retrograde transport	10916	1084		0.3333333333333333	0.42857142857142855	133	10783	9	7	124	10776	10916	0.19218824694528394
R1	cpdb	0	network_modules	99	TRUE	3.237676148183921e-11	284	22	11	0.5	0.03873239436619718	GO:0048193	GO:BP	Golgi vesicle transport	16175	12570		0.3333333333333333	0.5	284	15891	11	11	273	15880	16175	0.13556244549209337
R1	cpdb	0	network_modules	99	TRUE	6.25908451896772e-11	155	16	9	0.5625	0.05806451612903226	REAC:R-HSA-199977	REAC	ER to Golgi Anterograde Transport	10916	823		0.5	0.5714285714285714	155	10761	9	7	146	10754	10916	0.1775566215415299
R1	cpdb	0	network_modules	99	TRUE	3.3011255535285324e-10	186	16	9	0.5625	0.04838709677419355	REAC:R-HSA-948021	REAC	Transport to the Golgi and subsequent modification	10916	2604		0.6666666666666666	0.7142857142857143	186	10730	9	7	177	10723	10916	0.1614795292239983
R1	cpdb	0	network_modules	99	TRUE	5.178560034417289e-10	52	22	7	0.3181818181818182	0.1346153846153846	GO:0006890	GO:BP	retrograde vesicle-mediated transport, Golgi to endoplasmic reticulum	16175	2545		0.6666666666666666	0.75	52	16123	7	15	45	16108	16175	0.20533806321601436
R1	cpdb	0	network_modules	99	TRUE	6.982232327078487e-10	202	16	9	0.5625	0.04455445544554455	REAC:R-HSA-6811442	REAC	Intra-Golgi and retrograde Golgi-to-ER traffic	10916	1262		0.8333333333333334	0.8571428571428571	202	10714	9	7	193	10707	10916	0.15465134949670842
R1	cpdb	0	network_modules	99	TRUE	2.8507016137055893e-8	305	16	9	0.5625	0.029508196721311476	REAC:R-HSA-446203	REAC	Asparagine N-linked glycosylation	10916	169		1	1	305	10611	9	7	296	10604	10916	0.12427338635881446
R1	cpdb	0	network_modules	99	TRUE	3.076925693316427e-7	126	22	7	0.3181818181818182	0.05555555555555555	GO:0006888	GO:BP	endoplasmic reticulum to Golgi vesicle-mediated transport	16175	2544		1	1	126	16049	7	15	119	16034	16175	0.13029577042249474
R1	cpdb	0	network_modules	99	TRUE	0.0017165932300530783	63	9	3	0.3333333333333333	0.047619047619047616	KEGG:00310	KEGG	Lysine degradation	8484	34		NA	1	63	8421	3	6	60	8415	8484	0.12370704372469311
R1	cpdb	0	network_modules	100	TRUE	6.019459598275814e-9	128	28	9	0.32142857142857145	0.0703125	REAC:R-HSA-6809371	REAC	Formation of the cornified envelope	10916	969		0	0.2	128	10788	9	19	119	10769	10916	0.14589418243676128
R1	cpdb	0	network_modules	100	TRUE	2.2930880151345687e-7	6	31	4	0.12903225806451613	0.6666666666666666	GO:0086073	GO:BP	bundle of His cell-Purkinje myocyte adhesion involved in cell communication	16175	17927		0	0.05263157894736842	6	16169	4	27	2	16142	16175	0.2927860245112031
R1	cpdb	0	network_modules	100	TRUE	5.343391917015291e-7	7	31	4	0.12903225806451613	0.5714285714285714	GO:0002934	GO:BP	desmosome organization	16175	1442		0.05555555555555555	0.15789473684210525	7	16168	4	27	3	16141	16175	0.27094531301580005
R1	cpdb	0	network_modules	100	TRUE	5.343391917015291e-7	7	31	4	0.12903225806451613	0.5714285714285714	GO:0086042	GO:BP	cardiac muscle cell-cardiac muscle cell adhesion	16175	17904		0.05555555555555555	0.15789473684210525	7	16168	4	27	3	16141	16175	0.27094531301580005
R1	cpdb	0	network_modules	100	TRUE	6.279498147769236e-7	215	28	9	0.32142857142857145	0.04186046511627907	REAC:R-HSA-6805567	REAC	Keratinization	10916	1288		0.25	0.4	215	10701	9	19	206	10682	10916	0.11011829312419426
R1	cpdb	0	network_modules	100	TRUE	3.762345087607769e-6	11	28	4	0.14285714285714285	0.36363636363636365	REAC:R-HSA-351906	REAC	Apoptotic cleavage of cell adhesion  proteins	10916	160		0.5	0.6	11	10905	4	24	7	10881	10916	0.22671849934644367
R1	cpdb	0	network_modules	100	TRUE	7.506747674011778e-6	12	31	4	0.12903225806451613	0.3333333333333333	GO:0098911	GO:BP	regulation of ventricular cardiac muscle cell action potential	16175	18944		0.16666666666666666	0.21052631578947367	12	16163	4	27	8	16136	16175	0.20647240583862217
R1	cpdb	0	network_modules	100	TRUE	2.0617589172165657e-5	15	31	4	0.12903225806451613	0.26666666666666666	GO:0086069	GO:BP	bundle of His cell to Purkinje myocyte communication	16175	17923		0.2222222222222222	0.2631578947368421	15	16160	4	27	11	16133	16175	0.18442466334161073
R1	cpdb	0	network_modules	100	TRUE	9.283981555438426e-5	745	31	11	0.3548387096774194	0.01476510067114094	GO:0098609	GO:BP	cell-cell adhesion	16175	18805		0.2777777777777778	0.3157894736842105	745	15430	11	20	734	15410	16175	0.06455168646131511
R1	cpdb	0	network_modules	100	TRUE	3.0393687704302434e-4	28	31	4	0.12903225806451613	0.14285714285714285	GO:0086004	GO:BP	regulation of cardiac muscle cell contraction	16175	17881		0.3333333333333333	0.42105263157894735	28	16147	4	27	24	16120	16175	0.13419214421092165
R1	cpdb	0	network_modules	100	TRUE	3.0393687704302434e-4	28	31	4	0.12903225806451613	0.14285714285714285	GO:0098901	GO:BP	regulation of cardiac muscle cell action potential	16175	18934		0.3333333333333333	0.42105263157894735	28	16147	4	27	24	16120	16175	0.13419214421092165
R1	cpdb	0	network_modules	100	TRUE	3.52095896201409e-4	29	31	4	0.12903225806451613	0.13793103448275862	GO:0086005	GO:BP	ventricular cardiac muscle cell action potential	16175	17882		0.4444444444444444	0.47368421052631576	29	16146	4	27	25	16119	16175	0.13179823410204872
R1	cpdb	0	network_modules	100	TRUE	5.309547314726977e-4	32	31	4	0.12903225806451613	0.125	GO:1903115	GO:BP	regulation of actin filament-based movement	16175	22777		0.5	0.5263157894736842	32	16143	4	27	28	16116	16175	0.12529693212142443
R1	cpdb	0	network_modules	100	TRUE	7.19280316581485e-4	37	28	4	0.14285714285714285	0.10810810810810811	REAC:R-HSA-111465	REAC	Apoptotic cleavage of cellular proteins	10916	161		0.75	0.8	37	10879	4	24	33	10855	10916	0.12168765860815779
R1	cpdb	0	network_modules	100	TRUE	7.4069547693325e-4	22	18	3	0.16666666666666666	0.13636363636363635	KEGG:00900	KEGG	Terpenoid backbone biosynthesis	8484	129		0	0.5	22	8462	3	15	19	8447	8484	0.1487607998710018
R1	cpdb	0	network_modules	100	TRUE	0.0013350369281456265	40	31	4	0.12903225806451613	0.1	GO:0086091	GO:BP	regulation of heart rate by cardiac conduction	16175	17929		0.5555555555555556	0.5789473684210527	40	16135	4	27	36	16108	16175	0.11166039654978716
R1	cpdb	0	network_modules	100	TRUE	0.001372565877042677	179	31	6	0.1935483870967742	0.0335195530726257	GO:0045216	GO:BP	cell-cell junction organization	16175	11328		0.6111111111111112	0.631578947368421	179	15996	6	25	173	15971	16175	0.07643762874053239
R1	cpdb	0	network_modules	100	TRUE	0.0015141414832118205	84	18	4	0.2222222222222222	0.047619047619047616	KEGG:05412	KEGG	Arrhythmogenic right ventricular cardiomyopathy	8484	490		1	1	84	8400	4	14	80	8386	8484	0.09888078829971911
R1	cpdb	0	network_modules	100	TRUE	0.002364789853520494	46	31	4	0.12903225806451613	0.08695652173913043	GO:0098900	GO:BP	regulation of action potential	16175	18933		0.6666666666666666	0.6842105263157895	46	16129	4	27	42	16102	16175	0.10383798023220218
R1	cpdb	0	network_modules	100	TRUE	0.0026553149772324774	51	28	4	0.14285714285714285	0.0784313725490196	REAC:R-HSA-75153	REAC	Apoptotic execution phase	10916	162		1	1	51	10865	4	24	47	10841	10916	0.10276133935237525
R1	cpdb	0	network_modules	100	TRUE	0.002812223153376912	48	31	4	0.12903225806451613	0.08333333333333333	GO:0086002	GO:BP	cardiac muscle cell action potential involved in contraction	16175	17879		0.7222222222222222	0.7368421052631579	48	16127	4	27	44	16100	16175	0.1015583645103453
R1	cpdb	0	network_modules	100	TRUE	0.004534207085800236	54	31	4	0.12903225806451613	0.07407407407407407	GO:0034113	GO:BP	heterotypic cell-cell adhesion	16175	8421		0.7777777777777778	0.7894736842105263	54	16121	4	27	50	16094	16175	0.09548616581071
R1	cpdb	0	network_modules	100	TRUE	0.0048833012831647725	55	31	4	0.12903225806451613	0.07272727272727272	GO:0086065	GO:BP	cell communication involved in cardiac conduction	16175	17919		0.8333333333333334	0.8421052631578947	55	16120	4	27	51	16093	16175	0.09457052400565402
R1	cpdb	0	network_modules	100	TRUE	0.007412367525694025	61	31	4	0.12903225806451613	0.06557377049180328	GO:0055117	GO:BP	regulation of cardiac muscle contraction	16175	14257		0.8888888888888888	0.8947368421052632	61	16114	4	27	57	16087	16175	0.08955067431143506
R1	cpdb	0	network_modules	100	TRUE	0.007912984557869233	62	31	4	0.12903225806451613	0.06451612903225806	GO:0086003	GO:BP	cardiac muscle cell contraction	16175	17880		0.9444444444444444	0.9473684210526315	62	16113	4	27	58	16086	16175	0.08878446990468865
R1	cpdb	0	network_modules	100	TRUE	0.00987212164066852	20	31	3	0.0967741935483871	0.15	GO:0015740	GO:BP	C4-dicarboxylate transport	16175	4859		1	1	20	16155	3	28	17	16127	16175	0.11913131732422176
R1	cpdb	0	network_modules	101	TRUE	4.16850309895469e-9	667	30	14	0.4666666666666667	0.020989505247376312	GO:0032446	GO:BP	protein modification by small protein conjugation	16175	7568		0	0.16666666666666666	667	15508	14	16	653	15492	16175	0.09223024987139342
R1	cpdb	0	network_modules	101	TRUE	4.199201781045237e-9	308	24	11	0.4583333333333333	0.03571428571428571	REAC:R-HSA-983168	REAC	Antigen processing: Ubiquitination & Proteasome degradation	10916	154		0	0.5	308	10608	11	13	297	10595	10916	0.12193003654941831
R1	cpdb	0	network_modules	101	TRUE	1.7681417851787395e-8	590	30	13	0.43333333333333335	0.022033898305084745	GO:0016567	GO:BP	protein ubiquitination	16175	5254		0.2	0.3333333333333333	590	15585	13	17	577	15568	16175	0.09125167506998316
R1	cpdb	0	network_modules	101	TRUE	1.9830861108119732e-8	749	30	14	0.4666666666666667	0.018691588785046728	GO:0070647	GO:BP	protein modification by small protein conjugation or removal	16175	16231		0.4	0.5	749	15426	14	16	735	15410	16175	0.08622642156284464
R1	cpdb	0	network_modules	101	TRUE	2.0218005392921102e-8	248	30	10	0.3333333333333333	0.04032258064516129	GO:0000209	GO:BP	protein polyubiquitination	16175	59		0.6	0.6666666666666666	248	15927	10	20	238	15907	16175	0.11156336081262981
R1	cpdb	0	network_modules	101	TRUE	4.0424906339947207e-8	380	24	11	0.4583333333333333	0.02894736842105263	REAC:R-HSA-983169	REAC	Class I MHC mediated antigen processing & presentation	10916	368		1	1	380	10536	11	13	369	10523	10916	0.10845802092011815
R1	cpdb	0	network_modules	101	TRUE	4.628156933085012e-8	798	30	14	0.4666666666666667	0.017543859649122806	GO:0043687	GO:BP	post-translational protein modification	16175	10838		0.8	0.8333333333333334	798	15377	14	16	784	15361	16175	0.08306719944571679
R1	cpdb	0	network_modules	101	TRUE	4.9161455990560154e-8	140	21	8	0.38095238095238093	0.05714285714285714	KEGG:04120	KEGG	Ubiquitin mediated proteolysis	8484	270		0	0.5	140	8344	8	13	132	8331	8484	0.1425068684321709
R1	cpdb	0	network_modules	101	TRUE	1.68699448068997e-4	6	30	3	0.1	0.5	GO:0032020	GO:BP	ISG15-protein conjugation	16175	7320		1	1	6	16169	3	27	3	16142	16175	0.2230255950735871
R1	cpdb	0	network_modules	101	TRUE	0.0036163000335957215	31	21	3	0.14285714285714285	0.0967741935483871	KEGG:00030	KEGG	Pentose phosphate pathway	8484	4		1	1	31	8453	3	18	28	8435	8484	0.11492409517683679
R1	cpdb	0	network_modules	102	TRUE	2.477165140123802e-49	54	25	23	0.92	0.42592592592592593	KEGG:03460	KEGG	Fanconi anemia pathway	8484	242		0	0.5	54	8430	23	2	31	8428	8484	0.6245586819750586
R1	cpdb	0	network_modules	102	TRUE	7.420455483716115e-39	39	31	19	0.6129032258064516	0.48717948717948717	REAC:R-HSA-6783310	REAC	Fanconi Anemia Pathway	10916	932		0	0.03571428571428571	39	10877	19	12	20	10865	10916	0.5449996188263869
R1	cpdb	0	network_modules	102	TRUE	7.454860205924193e-34	39	36	17	0.4722222222222222	0.4358974358974359	GO:0036297	GO:BP	interstrand cross-link repair	16175	9548		0	0.03225806451612903	39	16136	17	19	22	16117	16175	0.4524288081988494
R1	cpdb	0	network_modules	102	TRUE	5.2960625306423406e-33	329	31	26	0.8387096774193549	0.0790273556231003	REAC:R-HSA-73894	REAC	DNA Repair	10916	444		0.037037037037037035	0.07142857142857142	329	10587	26	5	303	10582	10916	0.25238503943011575
R1	cpdb	0	network_modules	102	TRUE	9.333420113032985e-31	798	36	30	0.8333333333333334	0.03759398496240601	GO:0006974	GO:BP	DNA damage response	16175	2601		0.03333333333333333	0.06451612903225806	798	15377	30	6	768	15371	16175	0.17097589948410588
R1	cpdb	0	network_modules	102	TRUE	4.783185676695171e-30	528	36	27	0.75	0.05113636363636364	GO:0006281	GO:BP	DNA repair	16175	2095		0.06666666666666667	0.0967741935483871	528	15647	27	9	501	15638	16175	0.1906602185708383
R1	cpdb	0	network_modules	102	TRUE	1.868793644776669e-16	75	31	12	0.3870967741935484	0.16	REAC:R-HSA-9833482	REAC	PKR-mediated signaling	10916	1692		0.07407407407407407	0.10714285714285714	75	10841	12	19	63	10822	10916	0.2456443658708141
R1	cpdb	0	network_modules	102	TRUE	4.1427826544069257e-16	281	36	16	0.4444444444444444	0.05693950177935943	GO:0006310	GO:BP	DNA recombination	16175	2115		0.1	0.12903225806451613	281	15894	16	20	265	15874	16175	0.15437910498143562
R1	cpdb	0	network_modules	102	TRUE	4.561752973643972e-14	298	36	15	0.4166666666666667	0.050335570469798654	GO:0006302	GO:BP	double-strand break repair	16175	2109		0.13333333333333333	0.16129032258064516	298	15877	15	21	283	15856	16175	0.139866341356762
R1	cpdb	0	network_modules	102	TRUE	8.530999203672188e-13	147	31	12	0.3870967741935484	0.08163265306122448	REAC:R-HSA-1169410	REAC	Antiviral mechanism by IFN-stimulated genes	10916	157		0.1111111111111111	0.14285714285714285	147	10769	12	19	135	10750	10916	0.17299194971073834
R1	cpdb	0	network_modules	102	TRUE	3.2054528310358836e-11	263	31	13	0.41935483870967744	0.049429657794676805	REAC:R-HSA-913531	REAC	Interferon Signaling	10916	1227		0.14814814814814814	0.17857142857142858	263	10653	13	18	250	10635	10916	0.13756283716075887
R1	cpdb	0	network_modules	102	TRUE	1.1720406741680242e-10	172	36	11	0.3055555555555556	0.06395348837209303	GO:0000724	GO:BP	double-strand break repair via homologous recombination	16175	203		0.16666666666666666	0.1935483870967742	172	16003	11	25	161	15978	16175	0.13579984348927998
R1	cpdb	0	network_modules	102	TRUE	1.512079886522109e-10	176	36	11	0.3055555555555556	0.0625	GO:0000725	GO:BP	recombinational repair	16175	204		0.2	0.22580645161290322	176	15999	11	25	165	15974	16175	0.13415199296442132
R1	cpdb	0	network_modules	102	TRUE	3.718963839461451e-10	53	36	8	0.2222222222222222	0.1509433962264151	GO:0007131	GO:BP	reciprocal meiotic recombination	16175	2702		0.23333333333333334	0.2903225806451613	53	16122	8	28	45	16094	16175	0.18094474701498353
R1	cpdb	0	network_modules	102	TRUE	3.718963839461451e-10	53	36	8	0.2222222222222222	0.1509433962264151	GO:0140527	GO:BP	reciprocal homologous recombination	16175	19808		0.23333333333333334	0.2903225806451613	53	16122	8	28	45	16094	16175	0.18094474701498353
R1	cpdb	0	network_modules	102	TRUE	1.2204716701177206e-9	61	36	8	0.2222222222222222	0.13114754098360656	GO:0035825	GO:BP	homologous recombination	16175	9273		0.3	0.3225806451612903	61	16114	8	28	53	16086	16175	0.1683234445132038
R1	cpdb	0	network_modules	102	TRUE	1.2238487848958817e-9	34	31	7	0.22580645161290322	0.20588235294117646	REAC:R-HSA-5693568	REAC	Resolution of D-loop Structures through Holliday Junction Intermediates	10916	2077		0.18518518518518517	0.21428571428571427	34	10882	7	24	27	10858	10916	0.2132752603874797
R1	cpdb	0	network_modules	102	TRUE	1.5268620376663864e-9	35	31	7	0.22580645161290322	0.2	REAC:R-HSA-5693537	REAC	Resolution of D-Loop Structures	10916	2076		0.2222222222222222	0.25	35	10881	7	24	28	10857	10916	0.21012957420038617
R1	cpdb	0	network_modules	102	TRUE	1.3587149771592688e-8	24	31	6	0.1935483870967742	0.25	REAC:R-HSA-9709603	REAC	Impaired BRCA2 binding to PALB2	10916	1172		0.25925925925925924	0.2857142857142857	24	10892	6	25	18	10867	10916	0.2180211801999324
R1	cpdb	0	network_modules	102	TRUE	1.784268974879337e-8	25	31	6	0.1935483870967742	0.24	REAC:R-HSA-9701192	REAC	Defective homologous recombination repair (HRR) due to BRCA1 loss of function	10916	697		0.2962962962962963	0.42857142857142855	25	10891	6	25	19	10866	10916	0.2135237912145628
R1	cpdb	0	network_modules	102	TRUE	1.784268974879337e-8	25	31	6	0.1935483870967742	0.24	REAC:R-HSA-9704646	REAC	Defective HDR through Homologous Recombination Repair (HRR) due to PALB2 loss of BRCA2/RAD51/RAD51C binding function	10916	563		0.2962962962962963	0.42857142857142855	25	10891	6	25	19	10866	10916	0.2135237912145628
R1	cpdb	0	network_modules	102	TRUE	1.784268974879337e-8	25	31	6	0.1935483870967742	0.24	REAC:R-HSA-9704331	REAC	Defective HDR through Homologous Recombination Repair (HRR) due to PALB2 loss of BRCA1 binding function	10916	562		0.2962962962962963	0.42857142857142855	25	10891	6	25	19	10866	10916	0.2135237912145628
R1	cpdb	0	network_modules	102	TRUE	1.784268974879337e-8	25	31	6	0.1935483870967742	0.24	REAC:R-HSA-9701193	REAC	Defective homologous recombination repair (HRR) due to PALB2 loss of function	10916	699		0.2962962962962963	0.42857142857142855	25	10891	6	25	19	10866	10916	0.2135237912145628
R1	cpdb	0	network_modules	102	TRUE	2.9705656399617986e-8	27	31	6	0.1935483870967742	0.2222222222222222	REAC:R-HSA-5693554	REAC	Resolution of D-loop Structures through Synthesis-Dependent Strand Annealing (SDSA)	10916	2078		0.4444444444444444	0.4642857142857143	27	10889	6	25	21	10864	10916	0.20528538857026796
R1	cpdb	0	network_modules	102	TRUE	6.690858021802891e-8	99	36	8	0.2222222222222222	0.08080808080808081	GO:0007127	GO:BP	meiosis I	16175	2698		0.3333333333333333	0.3548387096774194	99	16076	8	28	91	16048	16175	0.13086055187367543
R1	cpdb	0	network_modules	102	TRUE	1.2582160788011583e-7	107	36	8	0.2222222222222222	0.07476635514018691	GO:0061982	GO:BP	meiosis I cell cycle process	16175	15766		0.36666666666666664	0.3870967741935484	107	16068	8	28	99	16040	16175	0.12561671649814343
R1	cpdb	0	network_modules	102	TRUE	2.0653052633693251e-7	68	31	7	0.22580645161290322	0.10294117647058823	REAC:R-HSA-5685942	REAC	HDR through Homologous Recombination (HRR)	10916	1097		0.48148148148148145	0.5	68	10848	7	24	61	10824	10916	0.14893193616020423
R1	cpdb	0	network_modules	102	TRUE	2.0832610494084035e-7	15	36	5	0.1388888888888889	0.3333333333333333	GO:0000712	GO:BP	resolution of meiotic recombination intermediates	16175	192		0.4	0.41935483870967744	15	16160	5	31	10	16129	16175	0.2140666087911083
R1	cpdb	0	network_modules	102	TRUE	3.754646559459357e-7	40	31	6	0.1935483870967742	0.15	REAC:R-HSA-5693616	REAC	Presynaptic phase of homologous DNA pairing and strand exchange	10916	1793		0.5185185185185185	0.5357142857142857	40	10876	6	25	34	10851	10916	0.16770809587170335
R1	cpdb	0	network_modules	102	TRUE	4.389650043408392e-7	41	31	6	0.1935483870967742	0.14634146341463414	REAC:R-HSA-9675136	REAC	Diseases of DNA Double-Strand Break Repair	10916	757		0.5555555555555556	0.6071428571428571	41	10875	6	25	35	10850	10916	0.16557794497322229
R1	cpdb	0	network_modules	102	TRUE	4.389650043408392e-7	41	31	6	0.1935483870967742	0.14634146341463414	REAC:R-HSA-9701190	REAC	Defective homologous recombination repair (HRR) due to BRCA2 loss of function	10916	698		0.5555555555555556	0.6071428571428571	41	10875	6	25	35	10850	10916	0.16557794497322229
R1	cpdb	0	network_modules	102	TRUE	5.326408785371659e-7	6	36	4	0.1111111111111111	0.6666666666666666	GO:0071139	GO:BP	resolution of DNA recombination intermediates	16175	16460		0.43333333333333335	0.45161290322580644	6	16169	4	32	2	16137	16175	0.27160965407504334
R1	cpdb	0	network_modules	102	TRUE	5.928343641987456e-7	43	31	6	0.1935483870967742	0.13953488372093023	REAC:R-HSA-5693579	REAC	Homologous DNA Pairing and Strand Exchange	10916	1129		0.6296296296296297	0.6428571428571429	43	10873	6	25	37	10848	10916	0.16154022229493373
R1	cpdb	0	network_modules	102	TRUE	7.831351501351645e-7	203	36	9	0.25	0.04433497536945813	GO:0051321	GO:BP	meiotic cell cycle	16175	13648		0.4666666666666667	0.4838709677419355	203	15972	9	27	194	15945	16175	0.10073985214130021
R1	cpdb	0	network_modules	102	TRUE	1.371421700409998e-6	144	36	8	0.2222222222222222	0.05555555555555555	GO:0140013	GO:BP	meiotic nuclear division	16175	19632		0.5	0.5161290322580645	144	16031	8	28	136	16003	16175	0.10725719268960587
R1	cpdb	0	network_modules	102	TRUE	1.5240979871191046e-6	50	31	6	0.1935483870967742	0.12	REAC:R-HSA-9675135	REAC	Diseases of DNA repair	10916	758		0.6666666666666666	0.6785714285714286	50	10866	6	25	44	10841	10916	0.14934767540889932
R1	cpdb	0	network_modules	102	TRUE	1.5510946253310532e-6	48	36	6	0.16666666666666666	0.125	GO:0031297	GO:BP	replication fork processing	16175	7119		0.5333333333333333	0.5483870967741935	48	16127	6	30	42	16097	16175	0.14213668197107956
R1	cpdb	0	network_modules	102	TRUE	3.3316959770921177e-6	161	36	8	0.2222222222222222	0.049689440993788817	GO:1903046	GO:BP	meiotic cell cycle process	16175	22726		0.5666666666666667	0.5806451612903226	161	16014	8	28	153	15986	16175	0.10099040505461533
R1	cpdb	0	network_modules	102	TRUE	4.521466440039965e-6	57	36	6	0.16666666666666666	0.10526315789473684	GO:0045005	GO:BP	DNA-templated DNA replication maintenance of fidelity	16175	11223		0.6	0.6129032258064516	57	16118	6	30	51	16088	16175	0.13002650744668706
R1	cpdb	0	network_modules	102	TRUE	1.342292443825015e-5	35	31	5	0.16129032258064516	0.14285714285714285	REAC:R-HSA-9709570	REAC	Impaired BRCA2 binding to RAD51	10916	1173		0.7037037037037037	0.7142857142857143	35	10881	5	26	30	10855	10916	0.1492277878031736
R1	cpdb	0	network_modules	102	TRUE	1.7951967535386368e-5	37	31	5	0.16129032258064516	0.13513513513513514	REAC:R-HSA-5685938	REAC	HDR through Single Strand Annealing (SSA)	10916	1100		0.7407407407407407	0.75	37	10879	5	26	32	10853	10916	0.1449836884985761
R1	cpdb	0	network_modules	102	TRUE	2.218129040566852e-5	132	31	7	0.22580645161290322	0.05303030303030303	REAC:R-HSA-5693567	REAC	HDR through Homologous Recombination (HRR) or Single Strand Annealing (SSA)	10916	1098		0.7777777777777778	0.7857142857142857	132	10784	7	24	125	10760	10916	0.10434855722292817
R1	cpdb	0	network_modules	102	TRUE	3.014212435302622e-5	138	31	7	0.22580645161290322	0.050724637681159424	REAC:R-HSA-5693538	REAC	Homology Directed Repair	10916	1130		0.8148148148148148	0.8214285714285714	138	10778	7	24	131	10754	10916	0.10182075642293295
R1	cpdb	0	network_modules	102	TRUE	5.12081462056363e-5	147	36	7	0.19444444444444445	0.047619047619047616	GO:0006261	GO:BP	DNA-templated DNA replication	16175	2078		0.6333333333333333	0.6451612903225806	147	16028	7	29	140	15999	16175	0.09224999536672676
R1	cpdb	0	network_modules	102	TRUE	1.1589040288132175e-4	168	31	7	0.22580645161290322	0.041666666666666664	REAC:R-HSA-5693532	REAC	DNA Double-Strand Break Repair	10916	443		0.8518518518518519	0.8571428571428571	168	10748	7	24	161	10724	10916	0.09122016598859563
R1	cpdb	0	network_modules	102	TRUE	3.034316176641213e-4	114	36	6	0.16666666666666666	0.05263157894736842	GO:0000077	GO:BP	DNA damage checkpoint signaling	16175	28		0.6666666666666666	0.6774193548387096	114	16061	6	30	108	16031	16175	0.09011610791640738
R1	cpdb	0	network_modules	102	TRUE	3.616245267079528e-4	41	25	4	0.16	0.0975609756097561	KEGG:03440	KEGG	Homologous recombination	8484	240		1	1	41	8443	4	21	37	8422	8484	0.12163855118823959
R1	cpdb	0	network_modules	102	TRUE	4.765876413735998e-4	123	36	6	0.16666666666666666	0.04878048780487805	GO:0031570	GO:BP	DNA integrity checkpoint signaling	16175	7220		0.7	0.7096774193548387	123	16052	6	30	117	16022	16175	0.08647836341914804
R1	cpdb	0	network_modules	102	TRUE	0.0011192252772755915	231	36	7	0.19444444444444445	0.030303030303030304	GO:0006260	GO:BP	DNA replication	16175	2077		0.7333333333333333	0.7419354838709677	231	15944	7	29	224	15915	16175	0.07171641197346469
R1	cpdb	0	network_modules	102	TRUE	0.0017148710222135925	359	31	8	0.25806451612903225	0.022284122562674095	REAC:R-HSA-3700989	REAC	Transcriptional Regulation by TP53	10916	2546		0.8888888888888888	0.8928571428571429	359	10557	8	23	351	10534	10916	0.06738088692317741
R1	cpdb	0	network_modules	102	TRUE	0.0017659834651311452	651	36	10	0.2777777777777778	0.015360983102918587	GO:0019953	GO:BP	sexual reproduction	16175	6073		0.7666666666666667	0.7741935483870968	651	15524	10	26	641	15498	16175	0.057080039985708673
R1	cpdb	0	network_modules	102	TRUE	0.0018153234456294693	92	31	5	0.16129032258064516	0.05434782608695652	REAC:R-HSA-6804756	REAC	Regulation of TP53 Activity through Phosphorylation	10916	2016		0.9259259259259259	0.9285714285714286	92	10824	5	26	87	10798	10916	0.08923655958377522
R1	cpdb	0	network_modules	102	TRUE	0.002018192364033034	94	31	5	0.16129032258064516	0.05319148936170213	REAC:R-HSA-69473	REAC	G2/M DNA damage checkpoint	10916	1006		0.9629629629629629	0.9642857142857143	94	10822	5	26	89	10796	10916	0.08818446498947055
R1	cpdb	0	network_modules	102	TRUE	0.0023553904472306863	97	31	5	0.16129032258064516	0.05154639175257732	REAC:R-HSA-5693607	REAC	Processing of DNA double-strand break ends	10916	1798		1	1	97	10819	5	26	92	10793	10916	0.08666583065560098
R1	cpdb	0	network_modules	102	TRUE	0.0024795594686408255	379	36	8	0.2222222222222222	0.021108179419525065	GO:0000280	GO:BP	nuclear division	16175	78		0.8	0.8064516129032258	379	15796	8	28	371	15768	16175	0.06206700401698584
R1	cpdb	0	network_modules	102	TRUE	0.0034150945465749923	172	36	6	0.16666666666666666	0.03488372093023256	GO:0042770	GO:BP	signal transduction in response to DNA damage	16175	10355		0.8333333333333334	0.8387096774193549	172	16003	6	30	166	15973	16175	0.07184700773729569
R1	cpdb	0	network_modules	102	TRUE	0.0039031330192886003	176	36	6	0.16666666666666666	0.03409090909090909	GO:0000075	GO:BP	cell cycle checkpoint signaling	16175	26		0.8666666666666667	0.8709677419354839	176	15999	6	30	170	15969	16175	0.07092216802810504
R1	cpdb	0	network_modules	102	TRUE	0.005716194046776702	424	36	8	0.2222222222222222	0.018867924528301886	GO:0048285	GO:BP	organelle fission	16175	12627		0.9	0.9032258064516129	424	15751	8	28	416	15723	16175	0.057942348380285405
R1	cpdb	0	network_modules	102	TRUE	0.007798317540910174	15	36	3	0.08333333333333333	0.2	GO:0031573	GO:BP	mitotic intra-S DNA damage checkpoint signaling	16175	7222		0.9333333333333333	0.9354838709677419	15	16160	3	33	12	16127	16175	0.12786439562882096
R1	cpdb	0	network_modules	102	TRUE	0.009073267549053477	115	36	5	0.1388888888888889	0.043478260869565216	GO:1903322	GO:BP	positive regulation of protein modification by small protein conjugation or removal	16175	22906		0.9666666666666667	0.967741935483871	115	16060	5	31	110	16029	16175	0.07407680552262676
R1	cpdb	0	network_modules	102	TRUE	0.009466814697071068	116	36	5	0.1388888888888889	0.04310344827586207	GO:1901875	GO:BP	positive regulation of post-translational protein modification	16175	21819		1	1	116	16059	5	31	111	16028	16175	0.07372451035052194
R1	cpdb	0	network_modules	103	TRUE	3.746638524290673e-43	19	27	17	0.6296296296296297	0.8947368421052632	REAC:R-HSA-9603798	REAC	Class I peroxisomal membrane protein import	10916	369		0	0.1	19	10897	17	10	2	10887	10916	0.7500739006459872
R1	cpdb	0	network_modules	103	TRUE	1.652269107040335e-37	83	26	21	0.8076923076923077	0.25301204819277107	KEGG:04146	KEGG	Peroxisome	8484	282		NA	1	83	8401	21	5	62	8396	8484	0.44947176995408616
R1	cpdb	0	network_modules	103	TRUE	2.032147301685466e-30	37	30	15	0.5	0.40540540540540543	GO:0007031	GO:BP	peroxisome organization	16175	2636		0	0.0196078431372549	37	16138	15	15	22	16123	16175	0.44909553726247503
R1	cpdb	0	network_modules	103	TRUE	1.2349206549115668e-29	158	27	20	0.7407407407407407	0.12658227848101267	REAC:R-HSA-9609507	REAC	Protein localization	10916	1815		0.1111111111111111	0.2	158	10758	20	7	138	10751	10916	0.3027981053665457
R1	cpdb	0	network_modules	103	TRUE	5.662242886376679e-23	21	30	11	0.36666666666666664	0.5238095238095238	GO:0015919	GO:BP	peroxisomal membrane transport	16175	5014		0.02	0.058823529411764705	21	16154	11	19	10	16135	16175	0.43738828760150833
R1	cpdb	0	network_modules	103	TRUE	5.662242886376679e-23	21	30	11	0.36666666666666664	0.5238095238095238	GO:0043574	GO:BP	peroxisomal transport	16175	10779		0.02	0.058823529411764705	21	16154	11	19	10	16135	16175	0.43738828760150833
R1	cpdb	0	network_modules	103	TRUE	9.211709106692705e-15	20	30	8	0.26666666666666666	0.4	GO:0072662	GO:BP	protein localization to peroxisome	16175	17482		0.06	0.09803921568627451	20	16155	8	22	12	16133	16175	0.3255875066982834
R1	cpdb	0	network_modules	103	TRUE	9.211709106692705e-15	20	30	8	0.26666666666666666	0.4	GO:0072663	GO:BP	establishment of protein localization to peroxisome	16175	17483		0.06	0.09803921568627451	20	16155	8	22	12	16133	16175	0.3255875066982834
R1	cpdb	0	network_modules	103	TRUE	1.0445140824478045e-10	14	30	6	0.2	0.42857142857142855	GO:0016558	GO:BP	protein import into peroxisome matrix	16175	5249		0.1	0.11764705882352941	14	16161	6	24	8	16137	16175	0.2919000669052991
R1	cpdb	0	network_modules	103	TRUE	5.690540167459939e-9	10	30	5	0.16666666666666666	0.5	GO:0016559	GO:BP	peroxisome fission	16175	5250		0.12	0.13725490196078433	10	16165	5	25	5	16140	16175	0.2879604261985711
R1	cpdb	0	network_modules	103	TRUE	5.702083911717901e-9	91	30	8	0.26666666666666666	0.08791208791208792	GO:0019395	GO:BP	fatty acid oxidation	16175	5752		0.14	0.1568627450980392	91	16084	8	22	83	16062	16175	0.15044452592962199
R1	cpdb	0	network_modules	103	TRUE	6.074261934300574e-9	25	30	6	0.2	0.24	GO:0065002	GO:BP	intracellular protein transmembrane transport	16175	15886		0.16	0.17647058823529413	25	16150	6	24	19	16126	16175	0.21776614716377785
R1	cpdb	0	network_modules	103	TRUE	7.441376675158241e-9	94	30	8	0.26666666666666666	0.0851063829787234	GO:0009062	GO:BP	fatty acid catabolic process	16175	3238		0.18	0.19607843137254902	94	16081	8	22	86	16059	16175	0.14793297341075368
R1	cpdb	0	network_modules	103	TRUE	8.50674220792081e-9	319	30	11	0.36666666666666664	0.034482758620689655	GO:0006631	GO:BP	fatty acid metabolic process	16175	2343		0.2	0.21568627450980393	319	15856	11	19	308	15837	16175	0.10756084538779082
R1	cpdb	0	network_modules	103	TRUE	8.84282929514106e-9	96	30	8	0.26666666666666666	0.08333333333333333	GO:0034440	GO:BP	lipid oxidation	16175	8634		0.22	0.23529411764705882	96	16079	8	22	88	16057	16175	0.14632360658161478
R1	cpdb	0	network_modules	103	TRUE	2.3135938539931712e-8	108	30	8	0.26666666666666666	0.07407407407407407	GO:0072329	GO:BP	monocarboxylic acid catabolic process	16175	17352		0.24	0.2549019607843137	108	16067	8	22	100	16045	16175	0.13761404281148992
R1	cpdb	0	network_modules	103	TRUE	2.7599856570866927e-8	60	27	7	0.25925925925925924	0.11666666666666667	REAC:R-HSA-9033241	REAC	Peroxisomal protein import	10916	1728		0.2222222222222222	0.3	60	10856	7	20	53	10836	10916	0.17091049156337978
R1	cpdb	0	network_modules	103	TRUE	3.760273757799528e-8	33	30	6	0.2	0.18181818181818182	GO:0000038	GO:BP	very long-chain fatty acid metabolic process	16175	15		0.26	0.27450980392156865	33	16142	6	24	27	16118	16175	0.1891155712171076
R1	cpdb	0	network_modules	103	TRUE	6.58766768988081e-8	36	30	6	0.2	0.16666666666666666	GO:0044743	GO:BP	protein transmembrane import into intracellular organelle	16175	11137		0.28	0.29411764705882354	36	16139	6	24	30	16115	16175	0.18091154459580494
R1	cpdb	0	network_modules	103	TRUE	7.058738938916647e-8	5	30	4	0.13333333333333333	0.8	GO:0044721	GO:BP	protein import into peroxisome matrix, substrate release	16175	11123		0.3	0.3137254901960784	5	16170	4	26	1	16144	16175	0.3261944612167312
R1	cpdb	0	network_modules	103	TRUE	1.680835280992495e-7	18	27	5	0.18518518518518517	0.2777777777777778	REAC:R-HSA-1369062	REAC	ABC transporters in lipid homeostasis	10916	8		0.3333333333333333	0.4	18	10898	5	22	13	10876	10916	0.22524935775749255
R1	cpdb	0	network_modules	103	TRUE	4.651789788629676e-7	49	30	6	0.2	0.12244897959183673	GO:0071806	GO:BP	protein transmembrane transport	16175	16919		0.32	0.3333333333333333	49	16126	6	24	43	16102	16175	0.15449911868374863
R1	cpdb	0	network_modules	103	TRUE	4.92841441756651e-7	7	30	4	0.13333333333333333	0.5714285714285714	GO:0042760	GO:BP	very long-chain fatty acid catabolic process	16175	10352		0.34	0.35294117647058826	7	16168	4	26	3	16142	16175	0.2754454194619186
R1	cpdb	0	network_modules	103	TRUE	6.380585481349764e-7	163	30	8	0.26666666666666666	0.049079754601226995	GO:0030258	GO:BP	lipid modification	16175	6747		0.36	0.37254901960784315	163	16012	8	22	155	15990	16175	0.11074088455554995
R1	cpdb	0	network_modules	103	TRUE	8.254511747196532e-7	24	27	5	0.18518518518518517	0.20833333333333334	REAC:R-HSA-390918	REAC	Peroxisomal lipid metabolism	10916	1727		0.4444444444444444	0.5	24	10892	5	22	19	10870	10916	0.19454102854519545
R1	cpdb	0	network_modules	103	TRUE	9.84415054023916e-7	8	30	4	0.13333333333333333	0.5	GO:0001561	GO:BP	fatty acid alpha-oxidation	16175	350		0.38	0.39215686274509803	8	16167	4	26	4	16141	16175	0.257543703435845
R1	cpdb	0	network_modules	103	TRUE	1.1335283655403997e-6	504	30	11	0.36666666666666664	0.021825396825396824	GO:0032787	GO:BP	monocarboxylic acid metabolic process	16175	7822		0.4	0.4117647058823529	504	15671	11	19	493	15652	16175	0.08323854171804666
R1	cpdb	0	network_modules	103	TRUE	2.6922166030472365e-6	65	30	6	0.2	0.09230769230769231	GO:0006635	GO:BP	fatty acid beta-oxidation	16175	2346		0.42	0.43137254901960786	65	16110	6	24	59	16086	16175	0.13353540144570206
R1	cpdb	0	network_modules	103	TRUE	4.939168185501022e-6	211	30	8	0.26666666666666666	0.037914691943127965	GO:0016054	GO:BP	organic acid catabolic process	16175	5086		0.44	0.47058823529411764	211	15964	8	22	203	15942	16175	0.0963519395487342
R1	cpdb	0	network_modules	103	TRUE	4.939168185501022e-6	211	30	8	0.26666666666666666	0.037914691943127965	GO:0046395	GO:BP	carboxylic acid catabolic process	16175	12121		0.44	0.47058823529411764	211	15964	8	22	203	15942	16175	0.0963519395487342
R1	cpdb	0	network_modules	103	TRUE	8.466736746244199e-6	3	30	3	0.1	1	GO:0044375	GO:BP	regulation of peroxisome size	16175	10980		0.48	0.49019607843137253	3	16172	3	27	0	16145	16175	0.31596367634387357
R1	cpdb	0	network_modules	103	TRUE	1.3896004168600991e-5	85	30	6	0.2	0.07058823529411765	GO:0015908	GO:BP	fatty acid transport	16175	5004		0.5	0.5098039215686274	85	16090	6	24	79	16066	16175	0.11610867567540258
R1	cpdb	0	network_modules	103	TRUE	1.7545951597238124e-5	248	30	8	0.26666666666666666	0.03225806451612903	GO:0016042	GO:BP	lipid catabolic process	16175	5076		0.52	0.5294117647058824	248	15927	8	22	240	15905	16175	0.08817489135317433
R1	cpdb	0	network_modules	103	TRUE	2.296857811340678e-5	373	30	9	0.3	0.024128686327077747	GO:0072594	GO:BP	establishment of protein localization to organelle	16175	17458		0.54	0.5490196078431373	373	15802	9	21	364	15781	16175	0.07953544201230525
R1	cpdb	0	network_modules	103	TRUE	3.382454000523105e-5	4	30	3	0.1	0.75	GO:0097089	GO:BP	methyl-branched fatty acid metabolic process	16175	18485		0.56	0.5882352941176471	4	16171	3	27	1	16144	16175	0.2734715412069573
R1	cpdb	0	network_modules	103	TRUE	3.382454000523105e-5	4	30	3	0.1	0.75	GO:0015910	GO:BP	long-chain fatty acid import into peroxisome	16175	5006		0.56	0.5882352941176471	4	16171	3	27	1	16144	16175	0.2734715412069573
R1	cpdb	0	network_modules	103	TRUE	3.502266810740808e-5	271	30	8	0.26666666666666666	0.02952029520295203	GO:0044248	GO:BP	cellular catabolic process	16175	10939		0.6	0.6078431372549019	271	15904	8	22	263	15882	16175	0.08393360883450614
R1	cpdb	0	network_modules	103	TRUE	4.311391840885612e-5	5	27	3	0.1111111111111111	0.6	REAC:R-HSA-389599	REAC	Alpha-oxidation of phytanate	10916	134		0.5555555555555556	0.6	5	10911	3	24	2	10887	10916	0.25751206970200585
R1	cpdb	0	network_modules	103	TRUE	6.348135372919341e-5	742	30	11	0.36666666666666664	0.014824797843665768	GO:0019752	GO:BP	carboxylic acid metabolic process	16175	6036		0.62	0.6274509803921569	742	15433	11	19	731	15414	16175	0.06609737211127473
R1	cpdb	0	network_modules	103	TRUE	7.701340959942262e-5	300	30	8	0.26666666666666666	0.02666666666666667	GO:0044282	GO:BP	small molecule catabolic process	16175	10949		0.64	0.6470588235294118	300	15875	8	22	292	15853	16175	0.07927373864797198
R1	cpdb	0	network_modules	103	TRUE	8.222733463421691e-5	761	30	11	0.36666666666666664	0.01445466491458607	GO:0043436	GO:BP	oxoacid metabolic process	16175	10693		0.66	0.6666666666666666	761	15414	11	19	750	15395	16175	0.06506810208718941
R1	cpdb	0	network_modules	103	TRUE	8.40368104730074e-5	58	27	5	0.18518518518518517	0.08620689655172414	REAC:R-HSA-8866654	REAC	E3 ubiquitin ligases ubiquitinate target proteins	10916	811		0.6666666666666666	0.7	58	10858	5	22	53	10836	10916	0.12320427496602607
R1	cpdb	0	network_modules	103	TRUE	8.445546892899441e-5	5	30	3	0.1	0.6	GO:0045046	GO:BP	protein import into peroxisome membrane	16175	11245		0.68	0.6862745098039216	5	16170	3	27	2	16143	16175	0.2444563448700135
R1	cpdb	0	network_modules	103	TRUE	8.909747502558888e-5	767	30	11	0.36666666666666664	0.014341590612777053	GO:0006082	GO:BP	organic acid metabolic process	16175	1947		0.7	0.7058823529411765	767	15408	11	19	756	15389	16175	0.06475048152539947
R1	cpdb	0	network_modules	103	TRUE	2.2391394770381837e-4	135	30	6	0.2	0.044444444444444446	GO:0015718	GO:BP	monocarboxylic acid transport	16175	4838		0.72	0.7254901960784313	135	16040	6	24	129	16016	16175	0.0908101159698073
R1	cpdb	0	network_modules	103	TRUE	2.948544030394264e-4	7	30	3	0.1	0.42857142857142855	GO:0016562	GO:BP	protein import into peroxisome matrix, receptor recycling	16175	5253		0.74	0.7450980392156863	7	16168	3	27	4	16141	16175	0.20635983007136915
R1	cpdb	0	network_modules	103	TRUE	3.7435199522660076e-4	78	27	5	0.18518518518518517	0.0641025641025641	REAC:R-HSA-8852135	REAC	Protein ubiquitination	10916	1818		0.7777777777777778	0.8	78	10838	5	22	73	10816	10916	0.10525589181258846
R1	cpdb	0	network_modules	103	TRUE	6.349182654360794e-4	265	30	7	0.23333333333333334	0.026415094339622643	GO:0006979	GO:BP	response to oxidative stress	16175	2604		0.76	0.7647058823529411	265	15910	7	23	258	15887	16175	0.0736694743834613
R1	cpdb	0	network_modules	103	TRUE	7.05879759773734e-4	9	30	3	0.1	0.3333333333333333	GO:0006625	GO:BP	protein targeting to peroxisome	16175	2339		0.78	0.7843137254901961	9	16166	3	27	6	16139	16175	0.1817774998860541
R1	cpdb	0	network_modules	103	TRUE	0.0010456255354218155	173	27	6	0.2222222222222222	0.03468208092485549	REAC:R-HSA-8978868	REAC	Fatty acid metabolism	10916	935		0.8888888888888888	0.9	173	10743	6	21	167	10722	10916	0.08228494765269896
R1	cpdb	0	network_modules	103	TRUE	0.0011114605364409775	39	30	4	0.13333333333333333	0.10256410256410256	GO:0035337	GO:BP	fatty-acyl-CoA metabolic process	16175	8981		0.8	0.803921568627451	39	16136	4	26	35	16110	16175	0.1150718134137229
R1	cpdb	0	network_modules	103	TRUE	0.00134617322239862	183	30	6	0.2	0.03278688524590164	GO:0034599	GO:BP	cellular response to oxidative stress	16175	8684		0.82	0.8235294117647058	183	15992	6	24	177	15968	16175	0.07690404732266264
R1	cpdb	0	network_modules	103	TRUE	0.0014882570385560286	103	27	5	0.18518518518518517	0.04854368932038835	REAC:R-HSA-382556	REAC	ABC-family proteins mediated transport	10916	9		1	1	103	10813	5	22	98	10791	10916	0.09052192497316054
R1	cpdb	0	network_modules	103	TRUE	0.002118192784087524	107	30	5	0.16666666666666666	0.04672897196261682	GO:0034614	GO:BP	cellular response to reactive oxygen species	16175	8691		0.84	0.8431372549019608	107	16068	5	25	102	16043	16175	0.08510849173798624
R1	cpdb	0	network_modules	103	TRUE	0.0021853483535831763	46	30	4	0.13333333333333333	0.08695652173913043	GO:0015909	GO:BP	long-chain fatty acid transport	16175	5005		0.86	0.8627450980392157	46	16129	4	26	42	16103	16175	0.10562789312625832
R1	cpdb	0	network_modules	103	TRUE	0.004592435218424963	226	30	6	0.2	0.02654867256637168	GO:0062197	GO:BP	cellular response to chemical stress	16175	15861		0.88	0.8823529411764706	226	15949	6	24	220	15925	16175	0.06831921094744689
R1	cpdb	0	network_modules	103	TRUE	0.0048904476213216894	2	30	2	0.06666666666666667	1	GO:0016557	GO:BP	peroxisome membrane biogenesis	16175	5248		0.9	0.9019607843137255	2	16173	2	28	0	16145	16175	0.2579752855695965
R1	cpdb	0	network_modules	103	TRUE	0.004936394037694048	127	30	5	0.16666666666666666	0.03937007874015748	GO:0000302	GO:BP	response to reactive oxygen species	16175	88		0.92	0.9215686274509803	127	16048	5	25	122	16023	16175	0.0775648956200154
R1	cpdb	0	network_modules	103	TRUE	0.005274133862445459	524	30	8	0.26666666666666666	0.015267175572519083	GO:0006886	GO:BP	intracellular protein transport	16175	2542		0.94	0.9411764705882353	524	15651	8	22	516	15629	16175	0.057038451112038854
R1	cpdb	0	network_modules	103	TRUE	0.00784262738729074	248	30	6	0.2	0.024193548387096774	GO:0046942	GO:BP	carboxylic acid transport	16175	12438		0.96	0.9607843137254902	248	15927	6	24	242	15903	16175	0.06478642189371886
R1	cpdb	0	network_modules	103	TRUE	0.008025982464012883	249	30	6	0.2	0.024096385542168676	GO:0015849	GO:BP	organic acid transport	16175	4958		0.98	0.9803921568627451	249	15926	6	24	243	15902	16175	0.06463658111677889
R1	cpdb	0	network_modules	103	TRUE	0.009448718721946312	20	30	3	0.1	0.15	GO:1902001	GO:BP	fatty acid transmembrane transport	16175	21933		1	1	20	16155	3	27	17	16128	16175	0.12114737001952819
R1	cpdb	0	network_modules	105	TRUE	3.43086770622031e-11	84	16	8	0.5	0.09523809523809523	REAC:R-HSA-216083	REAC	Integrin cell surface interactions	10916	1216		0	0.25	84	10832	8	8	76	10824	10916	0.215849196212721
R1	cpdb	0	network_modules	105	TRUE	1.9565897772425967e-7	153	15	7	0.4666666666666667	0.0457516339869281	KEGG:04514	KEGG	Cell adhesion molecules	8484	315		0	0.14285714285714285	153	8331	7	8	146	8323	8484	0.14188186397014724
R1	cpdb	0	network_modules	105	TRUE	9.584757416498403e-7	298	16	8	0.5	0.026845637583892617	REAC:R-HSA-1474244	REAC	Extracellular matrix organization	10916	889		0.3333333333333333	0.5	298	10618	8	8	290	10610	10916	0.11113911941823285
R1	cpdb	0	network_modules	105	TRUE	1.4841035805114029e-6	114	15	6	0.4	0.05263157894736842	KEGG:04670	KEGG	Leukocyte transendothelial migration	8484	343		0.16666666666666666	0.2857142857142857	114	8370	6	9	108	8361	8484	0.1412977629794191
R1	cpdb	0	network_modules	105	TRUE	8.913459889533406e-5	227	15	6	0.4	0.02643171806167401	KEGG:04810	KEGG	Regulation of actin cytoskeleton	8484	365		0.3333333333333333	0.42857142857142855	227	8257	6	9	221	8248	8484	0.09734164912732655
R1	cpdb	0	network_modules	105	TRUE	9.858169959438489e-5	101	18	5	0.2777777777777778	0.04950495049504951	GO:0007229	GO:BP	integrin-mediated signaling pathway	16175	2779		0	0.08333333333333333	101	16074	5	13	96	16061	16175	0.11505382091698874
R1	cpdb	0	network_modules	105	TRUE	1.0426150086752779e-4	124	15	5	0.3333333333333333	0.04032258064516129	KEGG:04650	KEGG	Natural killer cell mediated cytotoxicity	8484	334		0.5	0.5714285714285714	124	8360	5	10	119	8350	8484	0.1117692325893546
R1	cpdb	0	network_modules	105	TRUE	5.561166484510438e-4	279	18	6	0.3333333333333333	0.021505376344086023	GO:0031589	GO:BP	cell-substrate adhesion	16175	7233		0.09090909090909091	0.16666666666666666	279	15896	6	12	273	15884	16175	0.08103214590128555
R1	cpdb	0	network_modules	105	TRUE	7.82886237295641e-4	86	15	4	0.26666666666666666	0.046511627906976744	KEGG:05150	KEGG	Staphylococcus aureus infection	8484	439		0.6666666666666666	0.7142857142857143	86	8398	4	11	82	8387	8484	0.10777824798890961
R1	cpdb	0	network_modules	105	TRUE	8.083144479992152e-4	745	18	8	0.4444444444444444	0.010738255033557046	GO:0098609	GO:BP	cell-cell adhesion	16175	18805		0.18181818181818182	0.25	745	15430	8	10	737	15420	16175	0.06343702883666084
R1	cpdb	0	network_modules	105	TRUE	0.0013790450821674135	210	15	5	0.3333333333333333	0.023809523809523808	KEGG:04015	KEGG	Rap1 signaling pathway	8484	248		0.8333333333333334	0.8571428571428571	210	8274	5	10	205	8264	8484	0.08358566454671225
R1	cpdb	0	network_modules	105	TRUE	0.0014317146511677599	181	16	5	0.3125	0.027624309392265192	REAC:R-HSA-198933	REAC	Immunoregulatory interactions between a Lymphoid and a non-Lymphoid cell	10916	1171		0.6666666666666666	0.75	181	10735	5	11	176	10724	10916	0.08878560649201477
R1	cpdb	0	network_modules	105	TRUE	0.0015908945540464101	73	18	4	0.2222222222222222	0.0547945205479452	GO:0033627	GO:BP	cell adhesion mediated by integrin	16175	8328		0.2727272727272727	0.3333333333333333	73	16102	4	14	69	16088	16175	0.1084115091394929
R1	cpdb	0	network_modules	105	TRUE	0.0016709430887432131	2	18	2	0.1111111111111111	1	GO:2000361	GO:BP	regulation of prostaglandin-E synthase activity	16175	25680		0.36363636363636365	0.6666666666666666	2	16173	2	16	0	16157	16175	0.33316840867318687
R1	cpdb	0	network_modules	105	TRUE	0.0016709430887432131	2	18	2	0.1111111111111111	1	GO:0045963	GO:BP	negative regulation of dopamine metabolic process	16175	11755		0.36363636363636365	0.6666666666666666	2	16173	2	16	0	16157	16175	0.33316840867318687
R1	cpdb	0	network_modules	105	TRUE	0.0016709430887432131	2	18	2	0.1111111111111111	1	GO:0045914	GO:BP	negative regulation of catecholamine metabolic process	16175	11708		0.36363636363636365	0.6666666666666666	2	16173	2	16	0	16157	16175	0.33316840867318687
R1	cpdb	0	network_modules	105	TRUE	0.0016709430887432131	2	18	2	0.1111111111111111	1	GO:2000363	GO:BP	positive regulation of prostaglandin-E synthase activity	16175	25681		0.36363636363636365	0.6666666666666666	2	16173	2	16	0	16157	16175	0.33316840867318687
R1	cpdb	0	network_modules	105	TRUE	0.0024151132900111956	192	18	5	0.2777777777777778	0.026041666666666668	GO:0007160	GO:BP	cell-matrix adhesion	16175	2724		0.7272727272727273	0.75	192	15983	5	13	187	15970	16175	0.08195041897018164
R1	cpdb	0	network_modules	105	TRUE	0.0024776735041194316	193	18	5	0.2777777777777778	0.025906735751295335	GO:0098742	GO:BP	cell-cell adhesion via plasma-membrane adhesion molecules	16175	18867		0.8181818181818182	0.8333333333333334	193	15982	5	13	188	15969	16175	0.08172138887732602
R1	cpdb	0	network_modules	105	TRUE	0.004978742117580753	49	15	3	0.2	0.061224489795918366	KEGG:05144	KEGG	Malaria	8484	436		1	1	49	8435	3	12	46	8423	8484	0.10786821153251833
R1	cpdb	0	network_modules	105	TRUE	0.005009523127675268	3	18	2	0.1111111111111111	0.6666666666666666	GO:0043315	GO:BP	positive regulation of neutrophil degranulation	16175	10623		0.9090909090909091	1	3	16172	2	16	1	16156	16175	0.27188774182133574
R1	cpdb	0	network_modules	105	TRUE	0.005009523127675268	3	18	2	0.1111111111111111	0.6666666666666666	GO:0033239	GO:BP	negative regulation of amine metabolic process	16175	8089		0.9090909090909091	1	3	16172	2	16	1	16156	16175	0.27188774182133574
R1	cpdb	0	network_modules	105	TRUE	0.005376278713158682	111	16	4	0.25	0.036036036036036036	REAC:R-HSA-6785807	REAC	Interleukin-4 and Interleukin-13 signaling	10916	1252		1	1	111	10805	4	12	107	10793	10916	0.09158882966328576
R1	cpdb	0	network_modules	106	TRUE	5.588590549808098e-14	291	15	12	0.8	0.041237113402061855	KEGG:04060	KEGG	Cytokine-cytokine receptor interaction	8484	253		0	0.3333333333333333	291	8193	12	3	279	8190	8484	0.17706021137042227
R1	cpdb	0	network_modules	106	TRUE	5.950842889381211e-7	104	16	6	0.375	0.057692307692307696	GO:0050671	GO:BP	positive regulation of lymphocyte proliferation	16175	13205		0	0.0196078431372549	104	16071	6	10	98	16061	16175	0.14510396676669632
R1	cpdb	0	network_modules	106	TRUE	6.308140066930173e-7	105	16	6	0.375	0.05714285714285714	GO:0032946	GO:BP	positive regulation of mononuclear cell proliferation	16175	7931		0.02	0.0392156862745098	105	16070	6	10	99	16060	16175	0.14439161133228753
R1	cpdb	0	network_modules	106	TRUE	1.3500713807296453e-6	119	16	6	0.375	0.05042016806722689	GO:0070665	GO:BP	positive regulation of leukocyte proliferation	16175	16246		0.04	0.058823529411764705	119	16056	6	10	113	16046	16175	0.13537271613685203
R1	cpdb	0	network_modules	106	TRUE	9.05437971714205e-6	29	13	4	0.3076923076923077	0.13793103448275862	REAC:R-HSA-5669034	REAC	TNFs bind their physiological receptors	10916	2451		0	0.3333333333333333	29	10887	4	9	25	10878	10916	0.20462547263076947
R1	cpdb	0	network_modules	106	TRUE	1.1205902169335233e-5	169	16	6	0.375	0.03550295857988166	GO:0050670	GO:BP	regulation of lymphocyte proliferation	16175	13204		0.06	0.0784313725490196	169	16006	6	10	163	15996	16175	0.1128162089394734
R1	cpdb	0	network_modules	106	TRUE	1.2025419577564262e-5	171	16	6	0.375	0.03508771929824561	GO:0032944	GO:BP	regulation of mononuclear cell proliferation	16175	7929		0.08	0.09803921568627451	171	16004	6	10	165	15994	16175	0.11212348965430562
R1	cpdb	0	network_modules	106	TRUE	2.2600905408301867e-5	190	16	6	0.375	0.031578947368421054	GO:0070663	GO:BP	regulation of leukocyte proliferation	16175	16244		0.1	0.11764705882352941	190	15985	6	10	184	15975	16175	0.10608981695781088
R1	cpdb	0	network_modules	106	TRUE	3.87996320674217e-5	208	16	6	0.375	0.028846153846153848	GO:0046651	GO:BP	lymphocyte proliferation	16175	12287		0.12	0.13725490196078433	208	15967	6	10	202	15957	16175	0.10114187158874251
R1	cpdb	0	network_modules	106	TRUE	4.2256999038037616e-5	211	16	6	0.375	0.02843601895734597	GO:0032943	GO:BP	mononuclear cell proliferation	16175	7928		0.14	0.1568627450980392	211	15964	6	10	205	15954	16175	0.10037827927319067
R1	cpdb	0	network_modules	106	TRUE	5.920306761623403e-5	38	16	4	0.25	0.10526315789473684	GO:0002639	GO:BP	positive regulation of immunoglobulin production	16175	1160		0.16	0.17647058823529413	38	16137	4	12	34	16125	16175	0.1609657192129971
R1	cpdb	0	network_modules	106	TRUE	8.226026641748852e-5	236	16	6	0.375	0.025423728813559324	GO:0070661	GO:BP	leukocyte proliferation	16175	16242		0.18	0.19607843137254902	236	15939	6	10	230	15929	16175	0.09458163843616907
R1	cpdb	0	network_modules	106	TRUE	1.1307151252108856e-4	249	16	6	0.375	0.024096385542168676	GO:0051251	GO:BP	positive regulation of lymphocyte activation	16175	13598		0.2	0.21568627450980393	249	15926	6	10	243	15916	16175	0.09191169752148953
R1	cpdb	0	network_modules	106	TRUE	1.1900472697155435e-4	45	16	4	0.25	0.08888888888888889	GO:0002637	GO:BP	regulation of immunoglobulin production	16175	1158		0.22	0.23529411764705882	45	16130	4	12	41	16118	16175	0.1476908409487558
R1	cpdb	0	network_modules	106	TRUE	1.4173645884769324e-4	699	16	8	0.5	0.011444921316165951	GO:0045321	GO:BP	leukocyte activation	16175	11356		0.24	0.2549019607843137	699	15476	8	8	691	15468	16175	0.070687248993102
R1	cpdb	0	network_modules	106	TRUE	2.035206068070064e-4	275	16	6	0.375	0.02181818181818182	GO:0002696	GO:BP	positive regulation of leukocyte activation	16175	1214		0.26	0.27450980392156865	275	15900	6	10	269	15890	16175	0.08713914267409324
R1	cpdb	0	network_modules	106	TRUE	2.3452455733191793e-4	140	16	5	0.3125	0.03571428571428571	GO:0042098	GO:BP	T cell proliferation	16175	9965		0.28	0.29411764705882354	140	16035	5	11	135	16024	16175	0.10321674503051433
R1	cpdb	0	network_modules	106	TRUE	2.7844925389501173e-4	290	16	6	0.375	0.020689655172413793	GO:0050867	GO:BP	positive regulation of cell activation	16175	13315		0.3	0.3137254901960784	290	15885	6	10	284	15875	16175	0.08467576518707182
R1	cpdb	0	network_modules	106	TRUE	3.132578725236805e-4	57	16	4	0.25	0.07017543859649122	GO:0050871	GO:BP	positive regulation of B cell activation	16175	13319		0.32	0.3333333333333333	57	16118	4	12	53	16106	16175	0.13088164661557036
R1	cpdb	0	network_modules	106	TRUE	6.864901007004839e-4	17	16	3	0.1875	0.17647058823529413	GO:0045830	GO:BP	positive regulation of isotype switching	16175	11648		0.34	0.35294117647058826	17	16158	3	13	14	16145	16175	0.18106679952472396
R1	cpdb	0	network_modules	106	TRUE	7.147840746694361e-4	569	16	7	0.4375	0.012302284710017574	GO:0046649	GO:BP	lymphocyte activation	16175	12286		0.36	0.37254901960784315	569	15606	7	9	562	15597	16175	0.06871778688492754
R1	cpdb	0	network_modules	106	TRUE	7.641537665777689e-4	71	16	4	0.25	0.056338028169014086	GO:0002377	GO:BP	immunoglobulin production	16175	907		0.38	0.39215686274509803	71	16104	4	12	67	16092	16175	0.1169089962746086
R1	cpdb	0	network_modules	106	TRUE	8.091222833914851e-4	27	15	3	0.2	0.1111111111111111	KEGG:05310	KEGG	Asthma	8484	481		0.5	0.6666666666666666	27	8457	3	12	24	8445	8484	0.14706318670281238
R1	cpdb	0	network_modules	106	TRUE	0.0010605066962357617	77	16	4	0.25	0.05194805194805195	GO:0042102	GO:BP	positive regulation of T cell proliferation	16175	9967		0.4	0.4117647058823529	77	16098	4	12	73	16086	16175	0.11211307312418614
R1	cpdb	0	network_modules	106	TRUE	0.0011453367467696525	369	16	6	0.375	0.016260162601626018	GO:0051249	GO:BP	regulation of lymphocyte activation	16175	13596		0.42	0.43137254901960786	369	15806	6	10	363	15796	16175	0.07422431707816271
R1	cpdb	0	network_modules	106	TRUE	0.0011761288709102563	2	16	2	0.125	1	GO:0048304	GO:BP	positive regulation of isotype switching to IgG isotypes	16175	12645		0.44	0.45098039215686275	2	16173	2	14	0	16159	16175	0.3534003324374783
R1	cpdb	0	network_modules	106	TRUE	0.0013394583334122192	21	16	3	0.1875	0.14285714285714285	GO:0045191	GO:BP	regulation of isotype switching	16175	11319		0.46	0.47058823529411764	21	16154	3	13	18	16141	16175	0.16271627577867978
R1	cpdb	0	network_modules	106	TRUE	0.0014262205050665812	100	13	4	0.3076923076923077	0.04	REAC:R-HSA-5668541	REAC	TNFR2 non-canonical NF-kB pathway	10916	2450		0.5	0.6666666666666666	100	10816	4	9	96	10807	10916	0.10819792645493707
R1	cpdb	0	network_modules	106	TRUE	0.001655255470834646	86	16	4	0.25	0.046511627906976744	GO:0045582	GO:BP	positive regulation of T cell differentiation	16175	11433		0.48	0.49019607843137253	86	16089	4	12	82	16077	16175	0.10587352111077508
R1	cpdb	0	network_modules	106	TRUE	0.0017814441654766503	23	16	3	0.1875	0.13043478260869565	GO:0002714	GO:BP	positive regulation of B cell mediated immunity	16175	1232		0.5	0.5294117647058824	23	16152	3	13	20	16139	16175	0.15538715721260482
R1	cpdb	0	network_modules	106	TRUE	0.0017814441654766503	23	16	3	0.1875	0.13043478260869565	GO:0002891	GO:BP	positive regulation of immunoglobulin mediated immune response	16175	1401		0.5	0.5294117647058824	23	16152	3	13	20	16139	16175	0.15538715721260482
R1	cpdb	0	network_modules	106	TRUE	0.0020770860371649665	91	16	4	0.25	0.04395604395604396	GO:0050864	GO:BP	regulation of B cell activation	16175	13312		0.54	0.5490196078431373	91	16084	4	12	87	16072	16175	0.10280976579749565
R1	cpdb	0	network_modules	106	TRUE	0.002162473995044514	111	13	4	0.3076923076923077	0.036036036036036036	REAC:R-HSA-6785807	REAC	Interleukin-4 and Interleukin-13 signaling	10916	1252		1	1	111	10805	4	9	107	10796	10916	0.10240235822184758
R1	cpdb	0	network_modules	106	TRUE	0.002468232810987628	95	16	4	0.25	0.042105263157894736	GO:0002702	GO:BP	positive regulation of production of molecular mediator of immune response	16175	1220		0.56	0.5686274509803921	95	16080	4	12	91	16068	16175	0.10053275055331819
R1	cpdb	0	network_modules	106	TRUE	0.0024688342000416166	421	16	6	0.375	0.014251781472684086	GO:0002694	GO:BP	regulation of leukocyte activation	16175	1212		0.58	0.5882352941176471	421	15754	6	10	415	15744	16175	0.06896859475798688
R1	cpdb	0	network_modules	106	TRUE	0.0029116153200943614	99	16	4	0.25	0.04040404040404041	GO:0045621	GO:BP	positive regulation of lymphocyte differentiation	16175	11472		0.6	0.6078431372549019	99	16076	4	12	95	16064	16175	0.09839332561873755
R1	cpdb	0	network_modules	106	TRUE	0.003411570037252787	103	16	4	0.25	0.038834951456310676	GO:0002520	GO:BP	immune system development	16175	1042		0.62	0.6274509803921569	103	16072	4	12	99	16060	16175	0.09637803353537361
R1	cpdb	0	network_modules	106	TRUE	0.0035263504037166406	3	16	2	0.125	0.6666666666666666	GO:0048293	GO:BP	regulation of isotype switching to IgE isotypes	16175	12634		0.64	0.7254901960784313	3	16172	2	14	1	16158	16175	0.2884162244125957
R1	cpdb	0	network_modules	106	TRUE	0.0035263504037166406	3	16	2	0.125	0.6666666666666666	GO:0048295	GO:BP	positive regulation of isotype switching to IgE isotypes	16175	12636		0.64	0.7254901960784313	3	16172	2	14	1	16158	16175	0.2884162244125957
R1	cpdb	0	network_modules	106	TRUE	0.0035263504037166406	3	16	2	0.125	0.6666666666666666	GO:0048302	GO:BP	regulation of isotype switching to IgG isotypes	16175	12643		0.64	0.7254901960784313	3	16172	2	14	1	16158	16175	0.2884162244125957
R1	cpdb	0	network_modules	106	TRUE	0.0035263504037166406	3	16	2	0.125	0.6666666666666666	GO:0048289	GO:BP	isotype switching to IgE isotypes	16175	12630		0.64	0.7254901960784313	3	16172	2	14	1	16158	16175	0.2884162244125957
R1	cpdb	0	network_modules	106	TRUE	0.0035263504037166406	3	16	2	0.125	0.6666666666666666	GO:1903660	GO:BP	negative regulation of complement-dependent cytotoxicity	16175	23181		0.64	0.7254901960784313	3	16172	2	14	1	16158	16175	0.2884162244125957
R1	cpdb	0	network_modules	106	TRUE	0.004499741868602681	31	16	3	0.1875	0.0967741935483871	GO:0032733	GO:BP	positive regulation of interleukin-10 production	16175	7778		0.74	0.7647058823529411	31	16144	3	13	28	16131	16175	0.1335210968185333
R1	cpdb	0	network_modules	106	TRUE	0.004499741868602681	31	16	3	0.1875	0.0967741935483871	GO:0030890	GO:BP	positive regulation of B cell proliferation	16175	6955		0.74	0.7647058823529411	31	16144	3	13	28	16131	16175	0.1335210968185333
R1	cpdb	0	network_modules	106	TRUE	0.004558396343465647	468	16	6	0.375	0.01282051282051282	GO:0050865	GO:BP	regulation of cell activation	16175	13313		0.78	0.7843137254901961	468	15707	6	10	462	15697	16175	0.06496613092201732
R1	cpdb	0	network_modules	106	TRUE	0.005455170206931775	33	16	3	0.1875	0.09090909090909091	GO:0045190	GO:BP	isotype switching	16175	11318		0.8	0.8431372549019608	33	16142	3	13	30	16129	16175	0.12933355639244704
R1	cpdb	0	network_modules	106	TRUE	0.005455170206931775	33	16	3	0.1875	0.09090909090909091	GO:0002204	GO:BP	somatic recombination of immunoglobulin genes involved in immune response	16175	742		0.8	0.8431372549019608	33	16142	3	13	30	16129	16175	0.12933355639244704
R1	cpdb	0	network_modules	106	TRUE	0.005455170206931775	33	16	3	0.1875	0.09090909090909091	GO:0002208	GO:BP	somatic diversification of immunoglobulins involved in immune response	16175	746		0.8	0.8431372549019608	33	16142	3	13	30	16129	16175	0.12933355639244704
R1	cpdb	0	network_modules	106	TRUE	0.006536114093843217	35	16	3	0.1875	0.08571428571428572	GO:0002381	GO:BP	immunoglobulin production involved in immunoglobulin-mediated immune response	16175	908		0.86	0.8627450980392157	35	16140	3	13	32	16127	16175	0.1255080059505054
R1	cpdb	0	network_modules	106	TRUE	0.006922361331561904	123	16	4	0.25	0.032520325203252036	GO:0002700	GO:BP	regulation of production of molecular mediator of immune response	16175	1218		0.88	0.8823529411764706	123	16052	4	12	119	16040	16175	0.0878020732116133
R1	cpdb	0	network_modules	106	TRUE	0.007048630844640989	4	16	2	0.125	0.5	GO:0048291	GO:BP	isotype switching to IgG isotypes	16175	12632		0.9	0.9019607843137255	4	16171	2	14	2	16157	16175	0.24965977593568692
R1	cpdb	0	network_modules	106	TRUE	0.007750094765573821	37	16	3	0.1875	0.08108108108108109	GO:0002889	GO:BP	regulation of immunoglobulin mediated immune response	16175	1399		0.92	0.9215686274509803	37	16138	3	13	34	16125	16175	0.12199489618678971
R1	cpdb	0	network_modules	106	TRUE	0.008110046186299347	128	16	4	0.25	0.03125	GO:0042129	GO:BP	regulation of T cell proliferation	16175	9983		0.94	0.9411764705882353	128	16047	4	12	124	16035	16175	0.08597373537696315
R1	cpdb	0	network_modules	106	TRUE	0.008364582692916836	129	16	4	0.25	0.031007751937984496	GO:0045580	GO:BP	regulation of T cell differentiation	16175	11431		0.96	0.9607843137254902	129	16046	4	12	125	16034	16175	0.08562065276825695
R1	cpdb	0	network_modules	106	TRUE	0.008409314053970213	38	16	3	0.1875	0.07894736842105263	GO:0002712	GO:BP	regulation of B cell mediated immunity	16175	1230		0.98	0.9803921568627451	38	16137	3	13	35	16124	16175	0.12034254458480281
R1	cpdb	0	network_modules	106	TRUE	0.009104596063967779	39	16	3	0.1875	0.07692307692307693	GO:0016447	GO:BP	somatic recombination of immunoglobulin gene segments	16175	5226		1	1	39	16136	3	13	36	16123	16175	0.11875368695823141
R1	cpdb	0	network_modules	106	TRUE	0.009414343818310713	162	15	4	0.26666666666666666	0.024691358024691357	KEGG:04630	KEGG	JAK-STAT signaling pathway	8484	332		1	1	162	8322	4	11	158	8311	8484	0.07613076778484822
R1	cpdb	0	network_modules	107	TRUE	7.4221308769939816e-6	4	19	3	0.15789473684210525	0.75	GO:1904044	GO:BP	response to aldosterone	16175	23484		0	0.15789473684210525	4	16171	3	16	1	16155	16175	0.3438291238544239
R1	cpdb	0	network_modules	107	TRUE	7.4221308769939816e-6	4	19	3	0.15789473684210525	0.75	GO:0050914	GO:BP	sensory perception of salty taste	16175	13356		0	0.15789473684210525	4	16171	3	16	1	16155	16175	0.3438291238544239
R1	cpdb	0	network_modules	107	TRUE	7.4221308769939816e-6	4	19	3	0.15789473684210525	0.75	GO:1904045	GO:BP	cellular response to aldosterone	16175	23485		0	0.15789473684210525	4	16171	3	16	1	16155	16175	0.3438291238544239
R1	cpdb	0	network_modules	107	TRUE	1.0538988862205604e-5	6	14	3	0.21428571428571427	0.5	REAC:R-HSA-9730628	REAC	Sensory perception of salty taste	10916	2197		0	0.2	6	10910	3	11	3	10899	10916	0.32678661498676614
R1	cpdb	0	network_modules	107	TRUE	1.1580582791617251e-5	37	13	4	0.3076923076923077	0.10810810810810811	KEGG:04960	KEGG	Aldosterone-regulated sodium reabsorption	8484	396		NA	1	37	8447	4	9	33	8438	8484	0.18033079946732136
R1	cpdb	0	network_modules	107	TRUE	1.8541558708927902e-5	5	19	3	0.15789473684210525	0.6	GO:1904116	GO:BP	response to vasopressin	16175	23539		0.16666666666666666	0.3157894736842105	5	16170	3	16	2	16154	16175	0.3074190203017103
R1	cpdb	0	network_modules	107	TRUE	1.8541558708927902e-5	5	19	3	0.15789473684210525	0.6	GO:1904117	GO:BP	cellular response to vasopressin	16175	23540		0.16666666666666666	0.3157894736842105	5	16170	3	16	2	16154	16175	0.3074190203017103
R1	cpdb	0	network_modules	107	TRUE	1.8541558708927902e-5	5	19	3	0.15789473684210525	0.6	GO:0071389	GO:BP	cellular response to mineralocorticoid stimulus	16175	16641		0.16666666666666666	0.3157894736842105	5	16170	3	16	2	16154	16175	0.3074190203017103
R1	cpdb	0	network_modules	107	TRUE	2.9464565484904336e-5	8	14	3	0.21428571428571427	0.375	REAC:R-HSA-194313	REAC	VEGF ligand-receptor interactions	10916	2633		0.25	0.6	8	10908	3	11	5	10897	10916	0.2827888355778489
R1	cpdb	0	network_modules	107	TRUE	2.9464565484904336e-5	8	14	3	0.21428571428571427	0.375	REAC:R-HSA-195399	REAC	VEGF binds to VEGFR leading to receptor dimerization	10916	2632		0.25	0.6	8	10908	3	11	5	10897	10916	0.2827888355778489
R1	cpdb	0	network_modules	107	TRUE	1.0360176138499876e-4	8	19	3	0.15789473684210525	0.375	GO:0051385	GO:BP	response to mineralocorticoid	16175	13689		0.3333333333333333	0.3684210526315789	8	16167	3	16	5	16151	16175	0.2427725538707297
R1	cpdb	0	network_modules	107	TRUE	1.5528732974810387e-4	9	19	3	0.15789473684210525	0.3333333333333333	GO:0050915	GO:BP	sensory perception of sour taste	16175	13357		0.3888888888888889	0.42105263157894735	9	16166	3	16	6	16150	16175	0.2288053323123006
R1	cpdb	0	network_modules	107	TRUE	4.058002299582739e-4	12	19	3	0.15789473684210525	0.25	GO:0110096	GO:BP	cellular response to aldehyde	16175	19409		0.4444444444444444	0.47368421052631576	12	16163	3	16	9	16147	16175	0.1979360151912499
R1	cpdb	0	network_modules	107	TRUE	5.271488521564476e-4	13	19	3	0.15789473684210525	0.23076923076923078	GO:0071468	GO:BP	cellular response to acidic pH	16175	16701		0.5	0.5263157894736842	13	16162	3	16	10	16146	16175	0.19010183994272611
R1	cpdb	0	network_modules	107	TRUE	0.001637421390085486	519	19	7	0.3684210526315789	0.01348747591522158	GO:0070848	GO:BP	response to growth factor	16175	16340		0.5555555555555556	0.5789473684210527	519	15656	7	12	512	15644	16175	0.06544877155027178
R1	cpdb	0	network_modules	107	TRUE	0.001778102346443505	19	19	3	0.15789473684210525	0.15789473684210525	GO:0006883	GO:BP	intracellular sodium ion homeostasis	16175	2539		0.6111111111111112	0.6842105263157895	19	16156	3	16	16	16140	16175	0.15690439269751502
R1	cpdb	0	network_modules	107	TRUE	0.001778102346443505	19	19	3	0.15789473684210525	0.15789473684210525	GO:0010447	GO:BP	response to acidic pH	16175	4144		0.6111111111111112	0.6842105263157895	19	16156	3	16	16	16140	16175	0.15690439269751502
R1	cpdb	0	network_modules	107	TRUE	0.0028195939690438287	22	19	3	0.15789473684210525	0.13636363636363635	GO:0071467	GO:BP	cellular response to pH	16175	16700		0.7222222222222222	0.7894736842105263	22	16153	3	16	19	16137	16175	0.14565540832766186
R1	cpdb	0	network_modules	107	TRUE	0.0028195939690438287	22	19	3	0.15789473684210525	0.13636363636363635	GO:0098719	GO:BP	sodium ion import across plasma membrane	16175	18849		0.7222222222222222	0.7894736842105263	22	16153	3	16	19	16137	16175	0.14565540832766186
R1	cpdb	0	network_modules	107	TRUE	0.002877871156393176	4	14	2	0.14285714285714285	0.5	REAC:R-HSA-194306	REAC	Neurophilin interactions with VEGF and VEGFR	10916	1591		0.75	0.8	4	10912	2	12	2	10900	10916	0.26679570071555003
R1	cpdb	0	network_modules	107	TRUE	0.0037002546257368834	24	19	3	0.15789473684210525	0.125	GO:0050891	GO:BP	multicellular organismal-level water homeostasis	16175	13335		0.8333333333333334	0.8421052631578947	24	16151	3	16	21	16135	16175	0.1393529077787942
R1	cpdb	0	network_modules	107	TRUE	0.004201714729858254	25	19	3	0.15789473684210525	0.12	GO:0071384	GO:BP	cellular response to corticosteroid stimulus	16175	16636		0.8888888888888888	0.8947368421052632	25	16150	3	16	22	16134	16175	0.13648766424315323
R1	cpdb	0	network_modules	107	TRUE	0.00665545531548152	29	19	3	0.15789473684210525	0.10344827586206896	GO:0009268	GO:BP	response to pH	16175	3433		0.9444444444444444	0.9473684210526315	29	16146	3	16	26	16130	16175	0.12654084640823748
R1	cpdb	0	network_modules	107	TRUE	0.008283479067155562	47	14	3	0.21428571428571427	0.06382978723404255	REAC:R-HSA-9717189	REAC	Sensory perception of taste	10916	2200		1	1	47	10869	3	11	44	10858	10916	0.11492351140190453
R1	cpdb	0	network_modules	107	TRUE	0.00990818471842332	33	19	3	0.15789473684210525	0.09090909090909091	GO:0055078	GO:BP	sodium ion homeostasis	16175	14232		1	1	33	16142	3	16	30	16126	16175	0.1184508047106856
R1	cpdb	0	network_modules	108	TRUE	4.84898603508765e-6	21	16	4	0.25	0.19047619047619047	GO:0015701	GO:BP	bicarbonate transport	16175	4821		0	0.09090909090909091	21	16154	4	12	17	16142	16175	0.21733321658924123
R1	cpdb	0	network_modules	108	TRUE	1.3991227513039424e-5	80	16	5	0.3125	0.0625	GO:0051453	GO:BP	regulation of intracellular pH	16175	13714		0.1	0.18181818181818182	80	16095	5	11	75	16084	16175	0.1379520222650738
R1	cpdb	0	network_modules	108	TRUE	1.5861946022115807e-5	82	16	5	0.3125	0.06097560975609756	GO:0030641	GO:BP	regulation of cellular pH	16175	6868		0.2	0.2727272727272727	82	16093	5	11	77	16082	16175	0.13621297758629816
R1	cpdb	0	network_modules	108	TRUE	1.9036195904770947e-5	85	16	5	0.3125	0.058823529411764705	GO:0006885	GO:BP	regulation of pH	16175	2541		0.3	0.36363636363636365	85	16090	5	11	80	16079	16175	0.13371937762522546
R1	cpdb	0	network_modules	108	TRUE	9.875914151246782e-5	10	16	3	0.1875	0.3	REAC:R-HSA-425381	REAC	Bicarbonate transporters	10916	221		0	0.5	10	10906	3	13	7	10893	10916	0.2362934703535439
R1	cpdb	0	network_modules	108	TRUE	0.0011761288709102563	2	16	2	0.125	1	GO:2001150	GO:BP	positive regulation of dipeptide transmembrane transport	16175	26368		0.4	0.9090909090909091	2	16173	2	14	0	16159	16175	0.3534003324374783
R1	cpdb	0	network_modules	108	TRUE	0.0011761288709102563	2	16	2	0.125	1	GO:2000880	GO:BP	positive regulation of dipeptide transport	16175	26130		0.4	0.9090909090909091	2	16173	2	14	0	16159	16175	0.3534003324374783
R1	cpdb	0	network_modules	108	TRUE	0.0011761288709102563	2	16	2	0.125	1	GO:2000878	GO:BP	positive regulation of oligopeptide transport	16175	26128		0.4	0.9090909090909091	2	16173	2	14	0	16159	16175	0.3534003324374783
R1	cpdb	0	network_modules	108	TRUE	0.0011761288709102563	2	16	2	0.125	1	GO:0090089	GO:BP	regulation of dipeptide transport	16175	18010		0.4	0.9090909090909091	2	16173	2	14	0	16159	16175	0.3534003324374783
R1	cpdb	0	network_modules	108	TRUE	0.0011761288709102563	2	16	2	0.125	1	GO:0090088	GO:BP	regulation of oligopeptide transport	16175	18009		0.4	0.9090909090909091	2	16173	2	14	0	16159	16175	0.3534003324374783
R1	cpdb	0	network_modules	108	TRUE	0.0011761288709102563	2	16	2	0.125	1	GO:2001148	GO:BP	regulation of dipeptide transmembrane transport	16175	26366		0.4	0.9090909090909091	2	16173	2	14	0	16159	16175	0.3534003324374783
R1	cpdb	0	network_modules	108	TRUE	0.004313985375145119	105	16	4	0.25	0.0380952380952381	REAC:R-HSA-425393	REAC	Transport of inorganic cations/anions and amino acids/oligopeptides	10916	2596		1	1	105	10811	4	12	101	10799	10916	0.09435892616975583
R1	cpdb	0	network_modules	108	TRUE	0.00476681475489473	112	16	4	0.25	0.03571428571428571	GO:0006820	GO:BP	monoatomic anion transport	16175	2497		1	1	112	16063	4	12	108	16051	16175	0.0922393651695629
R1	cpdb	0	network_modules	109	TRUE	0.0034875949314125934	21	23	3	0.13043478260869565	0.14285714285714285	REAC:R-HSA-379726	REAC	Mitochondrial tRNA aminoacylation	10916	1470		NA	1	21	10895	3	20	18	10875	10916	0.1347630200400537
R1	cpdb	0	network_modules	109	TRUE	0.003598012952444844	44	15	3	0.2	0.06818181818181818	KEGG:00970	KEGG	Aminoacyl-tRNA biosynthesis	8484	153		NA	1	44	8440	3	12	41	8428	8484	0.11414379448473526
R1	cpdb	0	network_modules	109	TRUE	0.0042175950630080755	247	27	6	0.2222222222222222	0.024291497975708502	GO:0006520	GO:BP	amino acid metabolic process	16175	2241		0	0.5	247	15928	6	21	241	15907	16175	0.06900916770811141
R1	cpdb	0	network_modules	109	TRUE	0.008315877801524223	156	27	5	0.18518518518518517	0.03205128205128205	GO:0006839	GO:BP	mitochondrial transport	16175	2508		1	1	156	16019	5	22	151	15997	16175	0.0734453928026276
R1	cpdb	0	network_modules	110	TRUE	4.151911502588195e-6	364	26	9	0.34615384615384615	0.024725274725274724	GO:0007005	GO:BP	mitochondrion organization	16175	2617		0	0.1	364	15811	9	17	355	15794	16175	0.08755952004350792
R1	cpdb	0	network_modules	110	TRUE	4.798647654975324e-6	38	26	5	0.19230769230769232	0.13157894736842105	GO:0017004	GO:BP	cytochrome complex assembly	16175	5266		0.1111111111111111	0.2	38	16137	5	21	33	16116	16175	0.15743939903008405
R1	cpdb	0	network_modules	110	TRUE	1.5806669660216172e-5	8	15	3	0.2	0.375	KEGG:04122	KEGG	Sulfur relay system	8484	271		NA	1	8	8476	3	12	5	8464	8484	0.2729400808619186
R1	cpdb	0	network_modules	110	TRUE	2.335609393131479e-5	109	26	6	0.23076923076923078	0.05504587155963303	GO:0097250	GO:BP	mitochondrial respirasome assembly	16175	18559		0.2222222222222222	0.3	109	16066	6	20	103	16046	16175	0.10987478556722038
R1	cpdb	0	network_modules	110	TRUE	5.1099048710213685e-5	5	26	3	0.11538461538461539	0.6	GO:0034227	GO:BP	tRNA thio-modification	16175	8510		0.3333333333333333	0.4	5	16170	3	23	2	16147	16175	0.26266426439336954
R1	cpdb	0	network_modules	110	TRUE	5.779338331518522e-4	97	26	5	0.19230769230769232	0.05154639175257732	GO:0033108	GO:BP	mitochondrial respiratory chain complex assembly	16175	8042		0.4444444444444444	0.5	97	16078	5	21	92	16057	16175	0.09682650564405117
R1	cpdb	0	network_modules	110	TRUE	0.0011158129876016666	12	26	3	0.11538461538461539	0.25	GO:0034551	GO:BP	mitochondrial respiratory chain complex III assembly	16175	8677		0.5555555555555556	0.7	12	16163	3	23	9	16140	16175	0.16894800003492952
R1	cpdb	0	network_modules	110	TRUE	0.0011158129876016666	12	26	3	0.11538461538461539	0.25	GO:0017062	GO:BP	respiratory chain complex III assembly	16175	5279		0.5555555555555556	0.7	12	16163	3	23	9	16140	16175	0.16894800003492952
R1	cpdb	0	network_modules	110	TRUE	0.0023756679785927656	3	18	2	0.1111111111111111	0.6666666666666666	REAC:R-HSA-434313	REAC	Intracellular metabolism of fatty acids regulates insulin secretion	10916	1264		0	0.5	3	10913	2	16	1	10897	10916	0.27175380533553956
R1	cpdb	0	network_modules	110	TRUE	0.003430526248101933	17	26	3	0.11538461538461539	0.17647058823529413	GO:0002098	GO:BP	tRNA wobble uridine modification	16175	681		0.7777777777777778	0.8	17	16158	3	23	14	16135	16175	0.14158387767899894
R1	cpdb	0	network_modules	110	TRUE	0.003450794777497106	2	26	2	0.07692307692307693	1	GO:0032447	GO:BP	protein urmylation	16175	7569		0.8888888888888888	0.9	2	16173	2	24	0	16149	16175	0.27714423421480233
R1	cpdb	0	network_modules	110	TRUE	0.005074718241316655	31	18	3	0.16666666666666666	0.0967741935483871	REAC:R-HSA-8949613	REAC	Cristae formation	10916	414		1	1	31	10885	3	15	28	10870	10916	0.12511698162669982
R1	cpdb	0	network_modules	110	TRUE	0.005732798402039871	20	26	3	0.11538461538461539	0.15	GO:0002097	GO:BP	tRNA wobble base modification	16175	680		1	1	20	16155	3	23	17	16132	16175	0.1303342339743215
R1	cpdb	0	network_modules	111	TRUE	5.230215135396354e-51	291	35	35	1	0.12027491408934708	KEGG:04060	KEGG	Cytokine-cytokine receptor interaction	8484	253		0	0.09090909090909091	291	8193	35	0	256	8193	8484	0.3415123000696032
R1	cpdb	0	network_modules	111	TRUE	7.948380308390849e-51	98	35	29	0.8285714285714286	0.29591836734693877	KEGG:04061	KEGG	Viral protein interaction with cytokine and cytokine receptor	8484	254		0.1	0.18181818181818182	98	8386	29	6	69	8380	8484	0.49212382773600954
R1	cpdb	0	network_modules	111	TRUE	7.28219148333649e-50	68	37	25	0.6756756756756757	0.36764705882352944	GO:0070098	GO:BP	chemokine-mediated signaling pathway	16175	15910		0	0.0058823529411764705	68	16107	25	12	43	16095	16175	0.49691967888223615
R1	cpdb	0	network_modules	111	TRUE	5.016823831976621e-49	57	31	24	0.7741935483870968	0.42105263157894735	REAC:R-HSA-380108	REAC	Chemokine receptors bind chemokines	10916	346		0	0.1	57	10859	24	7	33	10852	10916	0.5693879313077728
R1	cpdb	0	network_modules	111	TRUE	2.1440809801829894e-48	76	37	25	0.6756756756756757	0.32894736842105265	GO:1990868	GO:BP	response to chemokine	16175	25323		0.005917159763313609	0.01764705882352941	76	16099	25	12	51	16087	16175	0.46980942621243743
R1	cpdb	0	network_modules	111	TRUE	2.1440809801829894e-48	76	37	25	0.6756756756756757	0.32894736842105265	GO:1990869	GO:BP	cellular response to chemokine	16175	25324		0.005917159763313609	0.01764705882352941	76	16099	25	12	51	16087	16175	0.46980942621243743
R1	cpdb	0	network_modules	111	TRUE	9.704660112885516e-44	110	37	25	0.6756756756756757	0.22727272727272727	GO:0071621	GO:BP	granulocyte chemotaxis	16175	16801		0.01775147928994083	0.023529411764705882	110	16065	25	12	85	16053	16175	0.38969837026812165
R1	cpdb	0	network_modules	111	TRUE	1.999873101659073e-43	91	37	24	0.6486486486486487	0.26373626373626374	GO:0030593	GO:BP	neutrophil chemotaxis	16175	6860		0.023668639053254437	0.029411764705882353	91	16084	24	13	67	16071	16175	0.4116507020189275
R1	cpdb	0	network_modules	111	TRUE	1.991468258037874e-42	375	37	31	0.8378378378378378	0.08266666666666667	GO:0042330	GO:BP	taxis	16175	10096		0.029585798816568046	0.041176470588235294	375	15800	31	6	344	15794	16175	0.2592085160906322
R1	cpdb	0	network_modules	111	TRUE	1.991468258037874e-42	375	37	31	0.8378378378378378	0.08266666666666667	GO:0006935	GO:BP	chemotaxis	16175	2574		0.029585798816568046	0.041176470588235294	375	15800	31	6	344	15794	16175	0.2592085160906322
R1	cpdb	0	network_modules	111	TRUE	4.7499352630778675e-42	273	37	29	0.7837837837837838	0.10622710622710622	GO:0060326	GO:BP	cell chemotaxis	16175	14538		0.04142011834319527	0.047058823529411764	273	15902	29	8	244	15894	16175	0.2850723977467337
R1	cpdb	0	network_modules	111	TRUE	5.328253570378162e-42	127	37	25	0.6756756756756757	0.1968503937007874	GO:0097530	GO:BP	granulocyte migration	16175	18690		0.047337278106508875	0.052941176470588235	127	16048	25	12	102	16036	16175	0.36230141843896985
R1	cpdb	0	network_modules	111	TRUE	1.2858226623126615e-41	106	37	24	0.6486486486486487	0.22641509433962265	GO:1990266	GO:BP	neutrophil migration	16175	25128		0.05325443786982249	0.058823529411764705	106	16069	24	13	82	16056	16175	0.38104164737591534
R1	cpdb	0	network_modules	111	TRUE	1.726016429142958e-41	190	35	29	0.8285714285714286	0.15263157894736842	KEGG:04062	KEGG	Chemokine signaling pathway	8484	255		0.2	0.2727272727272727	190	8294	29	6	161	8288	8484	0.3506737477192689
R1	cpdb	0	network_modules	111	TRUE	2.538984826616227e-41	200	37	27	0.7297297297297297	0.135	GO:0030595	GO:BP	leukocyte chemotaxis	16175	6861		0.05917159763313609	0.06470588235294118	200	15975	27	10	173	15965	16175	0.3108315039481298
R1	cpdb	0	network_modules	111	TRUE	7.651741689527514e-40	186	37	26	0.7027027027027027	0.13978494623655913	GO:0097529	GO:BP	myeloid leukocyte migration	16175	18689		0.0650887573964497	0.07058823529411765	186	15989	26	11	160	15978	16175	0.310426712502764
R1	cpdb	0	network_modules	111	TRUE	2.3082793798462945e-38	304	37	28	0.7567567567567568	0.09210526315789473	GO:0050900	GO:BP	leukocyte migration	16175	13342		0.07100591715976332	0.07647058823529412	304	15871	28	9	276	15862	16175	0.26020494529274346
R1	cpdb	0	network_modules	111	TRUE	1.905987403640713e-36	419	37	29	0.7837837837837838	0.06921241050119331	GO:0019221	GO:BP	cytokine-mediated signaling pathway	16175	5598		0.07692307692307693	0.08235294117647059	419	15756	29	8	390	15748	16175	0.22844966293035923
R1	cpdb	0	network_modules	111	TRUE	2.0601171510074457e-34	195	31	24	0.7741935483870968	0.12307692307692308	REAC:R-HSA-375276	REAC	Peptide ligand-binding receptors	10916	1726		0.1111111111111111	0.2	195	10721	24	7	171	10714	10916	0.3047238533133157
R1	cpdb	0	network_modules	111	TRUE	7.920273848818188e-33	555	37	29	0.7837837837837838	0.05225225225225225	GO:0071345	GO:BP	cellular response to cytokine stimulus	16175	16597		0.08284023668639054	0.08823529411764706	555	15620	29	8	526	15612	16175	0.197146220127072
R1	cpdb	0	network_modules	111	TRUE	2.6090007702368394e-31	625	37	29	0.7837837837837838	0.0464	GO:1901652	GO:BP	response to peptide	16175	21619		0.08875739644970414	0.1	625	15550	29	8	596	15542	16175	0.18512081146287604
R1	cpdb	0	network_modules	111	TRUE	2.6090007702368394e-31	625	37	29	0.7837837837837838	0.0464	GO:0034097	GO:BP	response to cytokine	16175	8408		0.08875739644970414	0.1	625	15550	29	8	596	15542	16175	0.18512081146287604
R1	cpdb	0	network_modules	111	TRUE	5.195837254048052e-30	594	37	28	0.7567567567567568	0.04713804713804714	GO:0006954	GO:BP	inflammatory response	16175	2585		0.10059171597633136	0.10588235294117647	594	15581	28	9	566	15572	16175	0.18330827179163864
R1	cpdb	0	network_modules	111	TRUE	6.846010233628726e-30	59	37	17	0.4594594594594595	0.288135593220339	GO:0048247	GO:BP	lymphocyte chemotaxis	16175	12605		0.10650887573964497	0.11176470588235295	59	16116	17	20	42	16096	16175	0.36203559921209094
R1	cpdb	0	network_modules	111	TRUE	8.239334653242259e-29	67	37	17	0.4594594594594595	0.2537313432835821	GO:0002548	GO:BP	monocyte chemotaxis	16175	1069		0.11242603550295859	0.11764705882352941	67	16108	17	20	50	16088	16175	0.3394503041831837
R1	cpdb	0	network_modules	111	TRUE	9.207164611419355e-29	328	31	24	0.7741935483870968	0.07317073170731707	REAC:R-HSA-373076	REAC	Class A/1 (Rhodopsin-like receptors)	10916	365		0.2222222222222222	0.3	328	10588	24	7	304	10581	10916	0.2326185633890184
R1	cpdb	0	network_modules	111	TRUE	1.3231347041344098e-27	102	37	18	0.4864864864864865	0.17647058823529413	GO:0072676	GO:BP	lymphocyte migration	16175	17494		0.11834319526627218	0.12352941176470589	102	16073	18	19	84	16054	16175	0.29045323618979474
R1	cpdb	0	network_modules	111	TRUE	1.5562888880517522e-26	188	37	20	0.5405405405405406	0.10638297872340426	GO:0071674	GO:BP	mononuclear cell migration	16175	16847		0.1242603550295858	0.12941176470588237	188	15987	20	17	168	15970	16175	0.2362903340641873
R1	cpdb	0	network_modules	111	TRUE	3.648787949686424e-25	460	31	24	0.7741935483870968	0.05217391304347826	REAC:R-HSA-500792	REAC	GPCR ligand binding	10916	1019		0.3333333333333333	0.4	460	10456	24	7	436	10449	10916	0.19445150876178952
R1	cpdb	0	network_modules	111	TRUE	2.650007921450447e-23	774	37	26	0.7027027027027027	0.03359173126614987	GO:0007186	GO:BP	G protein-coupled receptor signaling pathway	16175	2744		0.1301775147928994	0.13529411764705881	774	15401	26	11	748	15390	16175	0.14689868327905456
R1	cpdb	0	network_modules	111	TRUE	3.557506835091683e-20	85	37	14	0.3783783783783784	0.16470588235294117	GO:0071346	GO:BP	cellular response to type II interferon	16175	16598		0.13609467455621302	0.1411764705882353	85	16090	14	23	71	16067	16175	0.24710711193739066
R1	cpdb	0	network_modules	111	TRUE	7.108369773442625e-20	89	37	14	0.3783783783783784	0.15730337078651685	GO:0071347	GO:BP	cellular response to interleukin-1	16175	16599		0.14201183431952663	0.14705882352941177	89	16086	14	23	75	16063	16175	0.24136025791903068
R1	cpdb	0	network_modules	111	TRUE	9.273909690220748e-20	312	31	19	0.6129032258064516	0.060897435897435896	REAC:R-HSA-418594	REAC	G alpha (i) signalling events	10916	987		0.4444444444444444	0.5	312	10604	19	12	293	10592	10916	0.187141341782705
R1	cpdb	0	network_modules	111	TRUE	8.364122722415573e-19	105	37	14	0.3783783783783784	0.13333333333333333	GO:0070555	GO:BP	response to interleukin-1	16175	16175		0.14792899408284024	0.15294117647058825	105	16070	14	23	91	16047	16175	0.22173209675601663
R1	cpdb	0	network_modules	111	TRUE	1.105806723165366e-18	107	37	14	0.3783783783783784	0.1308411214953271	GO:0034341	GO:BP	response to type II interferon	16175	8579		0.15384615384615385	0.1588235294117647	107	16068	14	23	93	16045	16175	0.21959069336958273
R1	cpdb	0	network_modules	111	TRUE	1.3710590160205988e-17	27	37	10	0.2702702702702703	0.37037037037037035	GO:0048245	GO:BP	eosinophil chemotaxis	16175	12603		0.15976331360946747	0.16470588235294117	27	16148	10	27	17	16121	16175	0.3150552443657862
R1	cpdb	0	network_modules	111	TRUE	2.1756947289533716e-17	175	37	15	0.40540540540540543	0.08571428571428572	GO:0070374	GO:BP	positive regulation of ERK1 and ERK2 cascade	16175	16085		0.16568047337278108	0.17058823529411765	175	16000	15	22	160	15978	16175	0.1826346668046353
R1	cpdb	0	network_modules	111	TRUE	4.860667543497465e-17	30	37	10	0.2702702702702703	0.3333333333333333	GO:0072677	GO:BP	eosinophil migration	16175	17495		0.17159763313609466	0.17647058823529413	30	16145	10	27	20	16118	16175	0.2987090123008674
R1	cpdb	0	network_modules	111	TRUE	1.7706020357232752e-16	78	37	12	0.32432432432432434	0.15384615384615385	GO:0061844	GO:BP	antimicrobial humoral immune response mediated by antimicrobial peptide	16175	15685		0.17751479289940827	0.18235294117647058	78	16097	12	25	66	16072	16175	0.22083819845386254
R1	cpdb	0	network_modules	111	TRUE	5.560010194229854e-16	164	37	14	0.3783783783783784	0.08536585365853659	GO:0071356	GO:BP	cellular response to tumor necrosis factor	16175	16608		0.1834319526627219	0.18823529411764706	164	16011	14	23	150	15988	16175	0.17600266734224018
R1	cpdb	0	network_modules	111	TRUE	2.110468451374073e-15	180	37	14	0.3783783783783784	0.07777777777777778	GO:0034612	GO:BP	response to tumor necrosis factor	16175	8690		0.1893491124260355	0.19411764705882353	180	15995	14	23	166	15972	16175	0.16763080733937388
R1	cpdb	0	network_modules	111	TRUE	2.5435590850106244e-15	239	37	15	0.40540540540540543	0.06276150627615062	GO:0070372	GO:BP	regulation of ERK1 and ERK2 cascade	16175	16083		0.1952662721893491	0.2	239	15936	15	22	224	15914	16175	0.15502321559792742
R1	cpdb	0	network_modules	111	TRUE	6.777251749816811e-15	255	37	15	0.40540540540540543	0.058823529411764705	GO:0070371	GO:BP	ERK1 and ERK2 cascade	16175	16082		0.20118343195266272	0.20588235294117646	255	15920	15	22	240	15898	16175	0.14977612243300115
R1	cpdb	0	network_modules	111	TRUE	5.497236085454796e-14	123	37	12	0.32432432432432434	0.0975609756097561	GO:0019730	GO:BP	antimicrobial humoral response	16175	6021		0.20710059171597633	0.21176470588235294	123	16052	12	25	111	16027	16175	0.1745736324933551
R1	cpdb	0	network_modules	111	TRUE	6.468197565700952e-14	172	37	13	0.35135135135135137	0.0755813953488372	GO:0002685	GO:BP	regulation of leukocyte migration	16175	1203		0.21301775147928995	0.21764705882352942	172	16003	13	24	159	15979	16175	0.15905598327962459
R1	cpdb	0	network_modules	111	TRUE	1.6521565571472863e-12	77	37	10	0.2702702702702703	0.12987012987012986	GO:0071677	GO:BP	positive regulation of mononuclear cell migration	16175	16850		0.21893491124260356	0.2235294117647059	77	16098	10	27	67	16071	16175	0.18470114537777557
R1	cpdb	0	network_modules	111	TRUE	1.8746589567539812e-12	116	37	11	0.2972972972972973	0.09482758620689655	GO:0050921	GO:BP	positive regulation of chemotaxis	16175	13363		0.22485207100591717	0.22941176470588234	116	16059	11	26	105	16033	16175	0.16463353662310395
R1	cpdb	0	network_modules	111	TRUE	2.0661330596495057e-12	117	37	11	0.2972972972972973	0.09401709401709402	GO:0002687	GO:BP	positive regulation of leukocyte migration	16175	1205		0.23076923076923078	0.23529411764705882	117	16058	11	26	106	16032	16175	0.1638986357681451
R1	cpdb	0	network_modules	111	TRUE	2.0819047101533025e-12	224	37	13	0.35135135135135137	0.05803571428571429	GO:0006959	GO:BP	humoral immune response	16175	2590		0.23668639053254437	0.2411764705882353	224	15951	13	24	211	15927	16175	0.13828648399962848
R1	cpdb	0	network_modules	111	TRUE	2.2491485433842235e-12	376	37	15	0.40540540540540543	0.0398936170212766	GO:0043410	GO:BP	positive regulation of MAPK cascade	16175	10678		0.24260355029585798	0.24705882352941178	376	15799	15	22	361	15777	16175	0.12143850466970074
R1	cpdb	0	network_modules	111	TRUE	2.811808558215391e-12	81	37	10	0.2702702702702703	0.12345679012345678	GO:0002690	GO:BP	positive regulation of leukocyte chemotaxis	16175	1208		0.2485207100591716	0.2529411764705882	81	16094	10	27	71	16067	16175	0.1799375137847103
R1	cpdb	0	network_modules	111	TRUE	8.036972756929837e-12	57	37	9	0.24324324324324326	0.15789473684210525	GO:0072678	GO:BP	T cell migration	16175	17496		0.25443786982248523	0.25882352941176473	57	16118	9	28	48	16090	16175	0.19370028899945382
R1	cpdb	0	network_modules	111	TRUE	3.772443229607919e-11	104	37	10	0.2702702702702703	0.09615384615384616	GO:0002688	GO:BP	regulation of leukocyte chemotaxis	16175	1206		0.2603550295857988	0.2647058823529412	104	16071	10	27	94	16044	16175	0.1580606607303879
R1	cpdb	0	network_modules	111	TRUE	9.687703184616476e-11	114	37	10	0.2702702702702703	0.08771929824561403	GO:0071675	GO:BP	regulation of mononuclear cell migration	16175	16848		0.26627218934911245	0.27058823529411763	114	16061	10	27	104	16034	16175	0.1506622165327618
R1	cpdb	0	network_modules	111	TRUE	9.739713949638494e-11	24	37	7	0.1891891891891892	0.2916666666666667	GO:0010818	GO:BP	T cell chemotaxis	16175	4430		0.27218934911242604	0.27647058823529413	24	16151	7	30	17	16121	16175	0.23350262902325639
R1	cpdb	0	network_modules	111	TRUE	1.0002214534427235e-10	721	37	17	0.4594594594594595	0.023578363384188627	GO:0045087	GO:BP	innate immune response	16175	11270		0.2781065088757396	0.2823529411764706	721	15454	17	20	704	15434	16175	0.09626300560976632
R1	cpdb	0	network_modules	111	TRUE	2.7180423344023864e-10	181	37	11	0.2972972972972973	0.06077348066298342	GO:0050920	GO:BP	regulation of chemotaxis	16175	13362		0.28402366863905326	0.28823529411764703	181	15994	11	26	170	15968	16175	0.13023605519971534
R1	cpdb	0	network_modules	111	TRUE	3.310409373478337e-10	28	37	7	0.1891891891891892	0.25	GO:2000406	GO:BP	positive regulation of T cell migration	16175	25721		0.28994082840236685	0.29411764705882354	28	16147	7	30	21	16117	16175	0.21592335569634408
R1	cpdb	0	network_modules	111	TRUE	3.4429413106584486e-10	530	37	15	0.40540540540540543	0.02830188679245283	GO:0043408	GO:BP	regulation of MAPK cascade	16175	10676		0.2958579881656805	0.3	530	15645	15	22	515	15623	16175	0.10022651705283557
R1	cpdb	0	network_modules	111	TRUE	3.895615585546361e-10	187	37	11	0.2972972972972973	0.058823529411764705	GO:0032496	GO:BP	response to lipopolysaccharide	16175	7607		0.30177514792899407	0.3058823529411765	187	15988	11	26	176	15962	16175	0.12798755948866766
R1	cpdb	0	network_modules	111	TRUE	7.477533876566393e-10	450	37	14	0.3783783783783784	0.03111111111111111	GO:0030335	GO:BP	positive regulation of cell migration	16175	6781		0.3076923076923077	0.31176470588235294	450	15725	14	23	436	15702	16175	0.10206531548422748
R1	cpdb	0	network_modules	111	TRUE	9.058984888236934e-10	142	37	10	0.2702702702702703	0.07042253521126761	GO:0071222	GO:BP	cellular response to lipopolysaccharide	16175	16484		0.3136094674556213	0.3176470588235294	142	16033	10	27	132	16006	16175	0.1342226952802158
R1	cpdb	0	network_modules	111	TRUE	9.613428548918903e-10	203	37	11	0.2972972972972973	0.054187192118226604	GO:0002237	GO:BP	response to molecule of bacterial origin	16175	770		0.31952662721893493	0.3235294117647059	203	15972	11	26	192	15946	16175	0.12247625071441848
R1	cpdb	0	network_modules	111	TRUE	1.349421353576683e-9	470	37	14	0.3783783783783784	0.029787234042553193	GO:2000147	GO:BP	positive regulation of cell motility	16175	25495		0.3254437869822485	0.32941176470588235	470	15705	14	23	456	15682	16175	0.0995811939703655
R1	cpdb	0	network_modules	111	TRUE	1.4894626231241038e-9	34	37	7	0.1891891891891892	0.20588235294117646	GO:2000403	GO:BP	positive regulation of lymphocyte migration	16175	25718		0.33136094674556216	0.3352941176470588	34	16141	7	30	27	16111	16175	0.1955958550187373
R1	cpdb	0	network_modules	111	TRUE	1.7448709390124275e-9	479	37	14	0.3783783783783784	0.029227557411273485	GO:0040017	GO:BP	positive regulation of locomotion	16175	9905		0.33727810650887574	0.3411764705882353	479	15696	14	23	465	15673	16175	0.09851234604184589
R1	cpdb	0	network_modules	111	TRUE	1.8007682262629512e-9	152	37	10	0.2702702702702703	0.06578947368421052	GO:0071219	GO:BP	cellular response to molecule of bacterial origin	16175	16481		0.3431952662721893	0.34705882352941175	152	16023	10	27	142	15996	16175	0.12946602235295038
R1	cpdb	0	network_modules	111	TRUE	1.8322473785425626e-9	595	37	15	0.40540540540540543	0.025210084033613446	GO:0000165	GO:BP	MAPK cascade	16175	55		0.34911242603550297	0.35294117647058826	595	15580	15	22	580	15558	16175	0.0937685645075208
R1	cpdb	0	network_modules	111	TRUE	3.4715340136581825e-9	38	37	7	0.1891891891891892	0.18421052631578946	GO:2000404	GO:BP	regulation of T cell migration	16175	25719		0.35502958579881655	0.3588235294117647	38	16137	7	30	31	16107	16175	0.18479349894478111
R1	cpdb	0	network_modules	111	TRUE	4.3409346903689315e-9	233	37	11	0.2972972972972973	0.04721030042918455	GO:0006874	GO:BP	intracellular calcium ion homeostasis	16175	2532		0.3609467455621302	0.36470588235294116	233	15942	11	26	222	15916	16175	0.11368211332293775
R1	cpdb	0	network_modules	111	TRUE	6.0131065021556664e-9	781	37	16	0.43243243243243246	0.020486555697823303	GO:0030334	GO:BP	regulation of cell migration	16175	6780		0.3668639053254438	0.37058823529411766	781	15394	16	21	765	15373	16175	0.08580600113160179
R1	cpdb	0	network_modules	111	TRUE	6.231372572666009e-9	172	37	10	0.2702702702702703	0.05813953488372093	GO:0071216	GO:BP	cellular response to biotic stimulus	16175	16478		0.3727810650887574	0.3764705882352941	172	16003	10	27	162	15976	16175	0.1212051974532406
R1	cpdb	0	network_modules	111	TRUE	7.836384544762063e-9	246	37	11	0.2972972972972973	0.044715447154471545	GO:0055074	GO:BP	calcium ion homeostasis	16175	14230		0.378698224852071	0.38235294117647056	246	15929	11	26	235	15903	16175	0.11036823214542987
R1	cpdb	0	network_modules	111	TRUE	1.0106883692741252e-8	45	31	7	0.22580645161290322	0.15555555555555556	REAC:R-HSA-6783783	REAC	Interleukin-10 signaling	10916	1234		0.5555555555555556	0.6	45	10871	7	24	38	10847	10916	0.18463907848223773
R1	cpdb	0	network_modules	111	TRUE	1.2942567811840554e-8	443	37	13	0.35135135135135137	0.029345372460496615	GO:0009617	GO:BP	response to bacterium	16175	3543		0.38461538461538464	0.38823529411764707	443	15732	13	24	430	15708	16175	0.09504350011278175
R1	cpdb	0	network_modules	111	TRUE	3.7363147070379285e-8	4	37	4	0.10810810810810811	1	GO:1903237	GO:BP	negative regulation of leukocyte tethering or rolling	16175	22849		0.3905325443786982	0.3941176470588235	4	16171	4	33	0	16138	16175	0.3284623158895637
R1	cpdb	0	network_modules	111	TRUE	5.42980772193235e-8	55	37	7	0.1891891891891892	0.12727272727272726	GO:2000401	GO:BP	regulation of lymphocyte migration	16175	25716		0.39644970414201186	0.4	55	16120	7	30	48	16090	16175	0.15281857622657138
R1	cpdb	0	network_modules	111	TRUE	8.612625969407968e-8	30	37	6	0.16216216216216217	0.2	GO:0042088	GO:BP	T-helper 1 type immune response	16175	9962		0.40236686390532544	0.40588235294117647	30	16145	6	31	24	16114	16175	0.1783997923315813
R1	cpdb	0	network_modules	111	TRUE	9.573829711490489e-8	520	37	13	0.35135135135135137	0.025	GO:0033993	GO:BP	response to lipid	16175	8371		0.40828402366863903	0.4117647058823529	520	15655	13	24	507	15631	16175	0.08664809466896417
R1	cpdb	0	network_modules	111	TRUE	1.2412995160515644e-7	531	37	13	0.35135135135135137	0.02448210922787194	GO:0032103	GO:BP	positive regulation of response to external stimulus	16175	7367		0.41420118343195267	0.4176470588235294	531	15644	13	24	518	15620	16175	0.08559330768334279
R1	cpdb	0	network_modules	111	TRUE	1.5039492683207272e-7	14	37	5	0.13513513513513514	0.35714285714285715	GO:0010819	GO:BP	regulation of T cell chemotaxis	16175	4431		0.42011834319526625	0.4235294117647059	14	16161	5	32	9	16129	16175	0.21862502095763894
R1	cpdb	0	network_modules	111	TRUE	1.8651074893094025e-7	5	37	4	0.10810810810810811	0.8	GO:1904995	GO:BP	negative regulation of leukocyte adhesion to vascular endothelial cell	16175	24280		0.4260355029585799	0.4294117647058823	5	16170	4	33	1	16137	16175	0.2936263130528407
R1	cpdb	0	network_modules	111	TRUE	1.963840256032035e-7	92	35	8	0.22857142857142856	0.08695652173913043	KEGG:04657	KEGG	IL-17 signaling pathway	8484	335		0.3	0.36363636363636365	92	8392	8	27	84	8365	8484	0.13530649238438533
R1	cpdb	0	network_modules	111	TRUE	5.586187964299905e-7	6	37	4	0.10810810810810811	0.6666666666666666	GO:0002692	GO:BP	negative regulation of cellular extravasation	16175	1210		0.4319526627218935	0.43529411764705883	6	16169	4	33	2	16136	16175	0.26789748382831863
R1	cpdb	0	network_modules	111	TRUE	6.822833741339288e-7	373	37	11	0.2972972972972973	0.029490616621983913	GO:0045785	GO:BP	positive regulation of cell adhesion	16175	11617		0.4378698224852071	0.4411764705882353	373	15802	11	26	362	15776	16175	0.08748547028261354
R1	cpdb	0	network_modules	111	TRUE	8.2632749491506e-7	472	31	12	0.3870967741935484	0.025423728813559324	REAC:R-HSA-449147	REAC	Signaling by Interleukins	10916	2261		0.6666666666666666	0.7	472	10444	12	19	460	10425	10916	0.0902202898621543
R1	cpdb	0	network_modules	111	TRUE	9.73662937856385e-7	287	37	10	0.2702702702702703	0.03484320557491289	GO:1903037	GO:BP	regulation of leukocyte cell-cell adhesion	16175	22717		0.4437869822485207	0.4470588235294118	287	15888	10	27	277	15861	16175	0.0915908890117363
R1	cpdb	0	network_modules	111	TRUE	9.802807562331586e-7	386	37	11	0.2972972972972973	0.02849740932642487	GO:0022407	GO:BP	regulation of cell-cell adhesion	16175	6598		0.44970414201183434	0.45294117647058824	386	15789	11	26	375	15763	16175	0.08578290519690586
R1	cpdb	0	network_modules	111	TRUE	1.1532189201569747e-6	20	37	5	0.13513513513513514	0.25	GO:0002825	GO:BP	regulation of T-helper 1 type immune response	16175	1335		0.4556213017751479	0.4588235294117647	20	16155	5	32	15	16123	16175	0.18244335275507553
R1	cpdb	0	network_modules	111	TRUE	1.1560562267461154e-6	84	37	7	0.1891891891891892	0.08333333333333333	GO:0046634	GO:BP	regulation of alpha-beta T cell activation	16175	12271		0.46153846153846156	0.4647058823529412	84	16091	7	30	77	16061	16175	0.12257375564270045
R1	cpdb	0	network_modules	111	TRUE	1.7138708964920822e-6	407	37	11	0.2972972972972973	0.02702702702702703	GO:0098771	GO:BP	inorganic ion homeostasis	16175	18886		0.46745562130177515	0.47058823529411764	407	15768	11	26	396	15742	16175	0.08319920996088488
R1	cpdb	0	network_modules	111	TRUE	2.4905172321342305e-6	23	37	5	0.13513513513513514	0.21739130434782608	GO:1901623	GO:BP	regulation of lymphocyte chemotaxis	16175	21603		0.47337278106508873	0.4764705882352941	23	16152	5	32	18	16120	16175	0.1699094238467415
R1	cpdb	0	network_modules	111	TRUE	2.507286701381487e-6	422	37	11	0.2972972972972973	0.026066350710900472	GO:0030003	GO:BP	intracellular monoatomic cation homeostasis	16175	6648		0.47928994082840237	0.4823529411764706	422	15753	11	26	411	15727	16175	0.08146749710832787
R1	cpdb	0	network_modules	111	TRUE	2.7682162257429105e-6	426	37	11	0.2972972972972973	0.025821596244131457	GO:0006873	GO:BP	intracellular monoatomic ion homeostasis	16175	2531		0.48520710059171596	0.48823529411764705	426	15749	11	26	415	15723	16175	0.08102047061905698
R1	cpdb	0	network_modules	111	TRUE	3.149536969539912e-6	324	37	10	0.2702702702702703	0.030864197530864196	GO:0007159	GO:BP	leukocyte cell-cell adhesion	16175	2723		0.4911242603550296	0.49411764705882355	324	15851	10	27	314	15824	16175	0.08552145391795253
R1	cpdb	0	network_modules	111	TRUE	3.206254732730005e-6	53	37	6	0.16216216216216217	0.11320754716981132	GO:0046635	GO:BP	positive regulation of alpha-beta T cell activation	16175	12272		0.4970414201183432	0.5	53	16122	6	31	47	16091	16175	0.13312424856734692
R1	cpdb	0	network_modules	111	TRUE	3.4327967985495008e-6	57	31	6	0.1935483870967742	0.10526315789473684	REAC:R-HSA-447115	REAC	Interleukin-12 family signaling	10916	1235		0.7777777777777778	0.8	57	10859	6	25	51	10834	10916	0.13944716707330057
R1	cpdb	0	network_modules	111	TRUE	4.070804423295811e-6	88	35	7	0.2	0.07954545454545454	KEGG:05323	KEGG	Rheumatoid arthritis	8484	485		0.4	0.45454545454545453	88	8396	7	28	81	8368	8484	0.12046360997334263
R1	cpdb	0	network_modules	111	TRUE	4.220955942297094e-6	334	37	10	0.2702702702702703	0.029940119760479042	GO:0009615	GO:BP	response to virus	16175	3541		0.5029585798816568	0.5058823529411764	334	15841	10	27	324	15814	16175	0.08404987917754833
R1	cpdb	0	network_modules	111	TRUE	7.233858908485058e-6	467	37	11	0.2972972972972973	0.023554603854389723	GO:0055080	GO:BP	monoatomic cation homeostasis	16175	14233		0.5088757396449705	0.5117647058823529	467	15708	11	26	456	15682	16175	0.07675829372234422
R1	cpdb	0	network_modules	111	TRUE	8.632787936952597e-6	475	37	11	0.2972972972972973	0.023157894736842106	GO:0050801	GO:BP	monoatomic ion homeostasis	16175	13267		0.514792899408284	0.5176470588235295	475	15700	11	26	464	15674	16175	0.07598828022973006
R1	cpdb	0	network_modules	111	TRUE	1.8254598204954324e-5	12	37	4	0.10810810810810811	0.3333333333333333	GO:1903236	GO:BP	regulation of leukocyte tethering or rolling	16175	22848		0.5207100591715976	0.5235294117647059	12	16163	4	33	8	16130	16175	0.18881494208293637
R1	cpdb	0	network_modules	111	TRUE	1.9037396189290858e-5	125	37	7	0.1891891891891892	0.056	GO:0046631	GO:BP	alpha-beta T cell activation	16175	12268		0.5266272189349113	0.5294117647058824	125	16050	7	30	118	16020	16175	0.09922282385474208
R1	cpdb	0	network_modules	111	TRUE	2.6324711999602618e-5	13	37	4	0.10810810810810811	0.3076923076923077	GO:0010820	GO:BP	positive regulation of T cell chemotaxis	16175	4432		0.5325443786982249	0.5352941176470588	13	16162	4	33	9	16129	16175	0.18130867896924197
R1	cpdb	0	network_modules	111	TRUE	2.8558582335027835e-5	408	37	10	0.2702702702702703	0.024509803921568627	GO:0071396	GO:BP	cellular response to lipid	16175	16648		0.5384615384615384	0.5411764705882353	408	15767	10	27	398	15740	16175	0.07482790392156338
R1	cpdb	0	network_modules	111	TRUE	2.900172484401602e-5	534	37	11	0.2972972972972973	0.020599250936329586	GO:0055082	GO:BP	intracellular chemical homeostasis	16175	14235		0.5443786982248521	0.5470588235294118	534	15641	11	26	523	15615	16175	0.07082511252439525
R1	cpdb	0	network_modules	111	TRUE	3.464866814991476e-5	686	37	12	0.32432432432432434	0.01749271137026239	GO:0008284	GO:BP	positive regulation of cell population proliferation	16175	3151		0.5502958579881657	0.5529411764705883	686	15489	12	25	674	15464	16175	0.06698259261664208
R1	cpdb	0	network_modules	111	TRUE	8.181468318852717e-5	90	37	6	0.16216216216216217	0.06666666666666667	GO:0032609	GO:BP	type II interferon production	16175	7657		0.5562130177514792	0.5647058823529412	90	16085	6	31	84	16054	16175	0.10080330583441537
R1	cpdb	0	network_modules	111	TRUE	8.181468318852717e-5	90	37	6	0.16216216216216217	0.06666666666666667	GO:0032649	GO:BP	regulation of type II interferon production	16175	7696		0.5562130177514792	0.5647058823529412	90	16085	6	31	84	16054	16175	0.10080330583441537
R1	cpdb	0	network_modules	111	TRUE	1.1174593429080861e-4	18	37	4	0.10810810810810811	0.2222222222222222	GO:0140131	GO:BP	positive regulation of lymphocyte chemotaxis	16175	19677		0.5680473372781065	0.5764705882352941	18	16157	4	33	14	16124	16175	0.15366264308356842
R1	cpdb	0	network_modules	111	TRUE	1.1174593429080861e-4	18	37	4	0.10810810810810811	0.2222222222222222	GO:0046641	GO:BP	positive regulation of alpha-beta T cell proliferation	16175	12278		0.5680473372781065	0.5764705882352941	18	16157	4	33	14	16124	16175	0.15366264308356842
R1	cpdb	0	network_modules	111	TRUE	1.3793481884882567e-4	622	37	11	0.2972972972972973	0.017684887459807074	GO:0030155	GO:BP	regulation of cell adhesion	16175	6688		0.5798816568047337	0.5823529411764706	622	15553	11	26	611	15527	16175	0.0644546510486396
R1	cpdb	0	network_modules	111	TRUE	1.4020104992305824e-4	623	37	11	0.2972972972972973	0.01765650080256822	GO:0019725	GO:BP	cellular homeostasis	16175	6020		0.5857988165680473	0.5882352941176471	623	15552	11	26	612	15526	16175	0.06438958862985947
R1	cpdb	0	network_modules	111	TRUE	1.4131382529424249e-4	19	37	4	0.10810810810810811	0.21052631578947367	GO:0090026	GO:BP	positive regulation of monocyte chemotaxis	16175	17960		0.591715976331361	0.5941176470588235	19	16156	4	33	15	16123	16175	0.1494824391084959
R1	cpdb	0	network_modules	111	TRUE	1.5228162547739976e-4	257	37	8	0.21621621621621623	0.0311284046692607	GO:0022409	GO:BP	positive regulation of cell-cell adhesion	16175	6600		0.5976331360946746	0.6	257	15918	8	29	249	15889	16175	0.07670965917824488
R1	cpdb	0	network_modules	111	TRUE	1.5305923852467257e-4	169	37	7	0.1891891891891892	0.04142011834319527	GO:0050670	GO:BP	regulation of lymphocyte proliferation	16175	13204		0.6035502958579881	0.6058823529411764	169	16006	7	30	162	15976	16175	0.084170448144457
R1	cpdb	0	network_modules	111	TRUE	1.6354394542203476e-4	101	37	6	0.16216216216216217	0.0594059405940594	GO:0051209	GO:BP	release of sequestered calcium ion into cytosol	16175	13568		0.6094674556213018	0.611764705882353	101	16074	6	31	95	16043	16175	0.09477499401520004
R1	cpdb	0	network_modules	111	TRUE	1.659033812524039e-4	171	37	7	0.1891891891891892	0.04093567251461988	GO:0032944	GO:BP	regulation of mononuclear cell proliferation	16175	7929		0.6153846153846154	0.6176470588235294	171	16004	7	30	164	15974	16175	0.08362411521302186
R1	cpdb	0	network_modules	111	TRUE	1.7347936481393358e-4	102	37	6	0.16216216216216217	0.058823529411764705	GO:0051283	GO:BP	negative regulation of sequestering of calcium ion	16175	13619		0.621301775147929	0.6235294117647059	102	16073	6	31	96	16042	16175	0.09427480394618651
R1	cpdb	0	network_modules	111	TRUE	1.8390676902465506e-4	103	37	6	0.16216216216216217	0.05825242718446602	GO:0051282	GO:BP	regulation of sequestering of calcium ion	16175	13618		0.6272189349112426	0.6294117647058823	103	16072	6	31	97	16041	16175	0.09378174624802438
R1	cpdb	0	network_modules	111	TRUE	1.9484504491278247e-4	104	37	6	0.16216216216216217	0.057692307692307696	GO:0050671	GO:BP	positive regulation of lymphocyte proliferation	16175	13205		0.6331360946745562	0.6352941176470588	104	16071	6	31	98	16040	16175	0.0932956498422668
R1	cpdb	0	network_modules	111	TRUE	2.0631359407532934e-4	105	37	6	0.16216216216216217	0.05714285714285714	GO:0032946	GO:BP	positive regulation of mononuclear cell proliferation	16175	7931		0.6390532544378699	0.6411764705882353	105	16070	6	31	99	16039	16175	0.09281634935535367
R1	cpdb	0	network_modules	111	TRUE	2.183323409962384e-4	106	37	6	0.16216216216216217	0.05660377358490566	GO:0051208	GO:BP	sequestering of calcium ion	16175	13567		0.6449704142011834	0.6470588235294118	106	16069	6	31	100	16038	16175	0.09234368487611636
R1	cpdb	0	network_modules	111	TRUE	2.4073371683791758e-4	102	35	6	0.17142857142857143	0.058823529411764705	KEGG:04064	KEGG	NF-kappa B signaling pathway	8484	256		0.5	0.5454545454545454	102	8382	6	29	96	8353	8484	0.09413749013175828
R1	cpdb	0	network_modules	111	TRUE	2.6332281910046077e-4	276	37	8	0.21621621621621623	0.028985507246376812	GO:0002460	GO:BP	adaptive immune response based on somatic recombination of immune receptors built from immunoglobulin superfamily domains	16175	983		0.650887573964497	0.6529411764705882	276	15899	8	29	268	15870	16175	0.07363213088649527
R1	cpdb	0	network_modules	111	TRUE	2.9299177573252643e-4	57	37	5	0.13513513513513514	0.08771929824561403	GO:2000514	GO:BP	regulation of CD4-positive, alpha-beta T cell activation	16175	25817		0.6568047337278107	0.6588235294117647	57	16118	5	32	52	16086	16175	0.10634573322829785
R1	cpdb	0	network_modules	111	TRUE	3.276645168326365e-4	284	37	8	0.21621621621621623	0.028169014084507043	GO:0050863	GO:BP	regulation of T cell activation	16175	13311		0.6627218934911243	0.6647058823529411	284	15891	8	29	276	15862	16175	0.07242560493938226
R1	cpdb	0	network_modules	111	TRUE	3.405251787359466e-4	190	37	7	0.1891891891891892	0.03684210526315789	GO:0070663	GO:BP	regulation of leukocyte proliferation	16175	16244		0.6686390532544378	0.6705882352941176	190	15985	7	30	183	15955	16175	0.07885790423513998
R1	cpdb	0	network_modules	111	TRUE	3.5375482199905884e-4	6	37	3	0.08108108108108109	0.5	GO:2000669	GO:BP	negative regulation of dendritic cell apoptotic process	16175	25944		0.6745562130177515	0.6764705882352942	6	16169	3	34	3	16135	16175	0.2006925177790762
R1	cpdb	0	network_modules	111	TRUE	3.6596106903135343e-4	403	37	9	0.24324324324324326	0.022332506203473945	GO:0001819	GO:BP	positive regulation of cytokine production	16175	476		0.6804733727810651	0.6823529411764706	403	15772	9	28	394	15744	16175	0.06707092936893815
R1	cpdb	0	network_modules	111	TRUE	3.8027988812857396e-4	60	37	5	0.13513513513513514	0.08333333333333333	GO:0032729	GO:BP	positive regulation of type II interferon production	16175	7774		0.6863905325443787	0.6882352941176471	60	16115	5	32	55	16083	16175	0.10351656150821513
R1	cpdb	0	network_modules	111	TRUE	4.0628296335175904e-4	195	37	7	0.1891891891891892	0.035897435897435895	GO:0050870	GO:BP	positive regulation of T cell activation	16175	13318		0.6923076923076923	0.6941176470588235	195	15980	7	30	188	15950	16175	0.07771689190502572
R1	cpdb	0	network_modules	111	TRUE	4.347121894810335e-4	119	37	6	0.16216216216216217	0.05042016806722689	GO:0070665	GO:BP	positive regulation of leukocyte proliferation	16175	16246		0.6982248520710059	0.7	119	16056	6	31	113	16025	16175	0.08673881466432443
R1	cpdb	0	network_modules	111	TRUE	4.372818331528175e-4	113	35	6	0.17142857142857143	0.05309734513274336	KEGG:04668	KEGG	TNF signaling pathway	8484	342		0.6	0.6363636363636364	113	8371	6	29	107	8342	8484	0.08876909175879713
R1	cpdb	0	network_modules	111	TRUE	4.5670434703300134e-4	25	37	4	0.10810810810810811	0.16	GO:1904994	GO:BP	regulation of leukocyte adhesion to vascular endothelial cell	16175	24279		0.7041420118343196	0.7058823529411765	25	16150	4	33	21	16117	16175	0.12988783621780656
R1	cpdb	0	network_modules	111	TRUE	5.388606592238246e-4	26	37	4	0.10810810810810811	0.15384615384615385	GO:0090025	GO:BP	regulation of monocyte chemotaxis	16175	17959		0.7100591715976331	0.711764705882353	26	16149	4	33	22	16116	16175	0.1272955503413058
R1	cpdb	0	network_modules	111	TRUE	6.292062995503301e-4	208	37	7	0.1891891891891892	0.03365384615384615	GO:0046651	GO:BP	lymphocyte proliferation	16175	12287		0.7159763313609467	0.7176470588235294	208	15967	7	30	201	15937	16175	0.07493811679731902
R1	cpdb	0	network_modules	111	TRUE	6.694289608727712e-4	128	37	6	0.16216216216216217	0.046875	GO:0042129	GO:BP	regulation of T cell proliferation	16175	9983		0.7218934911242604	0.7235294117647059	128	16047	6	31	122	16016	16175	0.08335659016114183
R1	cpdb	0	network_modules	111	TRUE	6.931614337118956e-4	211	37	7	0.1891891891891892	0.03317535545023697	GO:0032943	GO:BP	mononuclear cell proliferation	16175	7928		0.727810650887574	0.7294117647058823	211	15964	7	30	204	15934	16175	0.07433219673618913
R1	cpdb	0	network_modules	111	TRUE	7.355980411328073e-4	28	37	4	0.10810810810810811	0.14285714285714285	GO:0050901	GO:BP	leukocyte tethering or rolling	16175	13343		0.7337278106508875	0.7352941176470589	28	16147	4	33	24	16114	16175	0.12253023484523481
R1	cpdb	0	network_modules	111	TRUE	7.868794710777948e-4	215	37	7	0.1891891891891892	0.03255813953488372	GO:1903039	GO:BP	positive regulation of leukocyte cell-cell adhesion	16175	22719		0.7396449704142012	0.7411764705882353	215	15960	7	30	208	15930	16175	0.07354332005753231
R1	cpdb	0	network_modules	111	TRUE	8.448663585584329e-4	745	37	11	0.2972972972972973	0.01476510067114094	GO:0098609	GO:BP	cell-cell adhesion	16175	18805		0.7455621301775148	0.7470588235294118	745	15430	11	26	734	15404	16175	0.05739122569965509
R1	cpdb	0	network_modules	111	TRUE	8.519012509707603e-4	29	37	4	0.10810810810810811	0.13793103448275862	GO:0046640	GO:BP	regulation of alpha-beta T cell proliferation	16175	12277		0.7514792899408284	0.7529411764705882	29	16146	4	33	25	16113	16175	0.12033286480001869
R1	cpdb	0	network_modules	111	TRUE	8.925054777784163e-4	324	37	8	0.21621621621621623	0.024691358024691357	GO:0006816	GO:BP	calcium ion transport	16175	2495		0.757396449704142	0.7588235294117647	324	15851	8	29	316	15822	16175	0.06704801583455511
R1	cpdb	0	network_modules	111	TRUE	9.8135892799353e-4	30	37	4	0.10810810810810811	0.13333333333333333	GO:0046633	GO:BP	alpha-beta T cell proliferation	16175	12270		0.7633136094674556	0.7705882352941177	30	16145	4	33	26	16112	16175	0.11824518234693823
R1	cpdb	0	network_modules	111	TRUE	9.8135892799353e-4	30	37	4	0.10810810810810811	0.13333333333333333	GO:0002691	GO:BP	regulation of cellular extravasation	16175	1209		0.7633136094674556	0.7705882352941177	30	16145	4	33	26	16112	16175	0.11824518234693823
R1	cpdb	0	network_modules	111	TRUE	0.0010038685996708917	76	35	5	0.14285714285714285	0.06578947368421052	KEGG:05133	KEGG	Pertussis	8484	430		0.7	0.7272727272727273	76	8408	5	30	71	8378	8484	0.09146533952481065
R1	cpdb	0	network_modules	111	TRUE	0.0010706904076714235	763	37	11	0.2972972972972973	0.014416775884665793	GO:0048878	GO:BP	chemical homeostasis	16175	13119		0.7751479289940828	0.7764705882352941	763	15412	11	26	752	15386	16175	0.056491994304358036
R1	cpdb	0	network_modules	111	TRUE	0.0010884271487686058	139	37	6	0.16216216216216217	0.04316546762589928	GO:0002822	GO:BP	regulation of adaptive immune response based on somatic recombination of immune receptors built from immunoglobulin superfamily domains	16175	1332		0.7810650887573964	0.7823529411764706	139	16036	6	31	133	16005	16175	0.07966497949897333
R1	cpdb	0	network_modules	111	TRUE	0.0011229385297868452	334	37	8	0.21621621621621623	0.023952095808383235	GO:0002250	GO:BP	adaptive immune response	16175	782		0.7869822485207101	0.788235294117647	334	15841	8	29	326	15812	16175	0.06584934908628716
R1	cpdb	0	network_modules	111	TRUE	0.0011232632215165902	11	31	3	0.0967741935483871	0.2727272727272727	REAC:R-HSA-9020956	REAC	Interleukin-27 signaling	10916	1245		0.8888888888888888	0.9	11	10905	3	28	8	10877	10916	0.16107739149687908
R1	cpdb	0	network_modules	111	TRUE	0.0011352892491339633	140	37	6	0.16216216216216217	0.04285714285714286	GO:0042098	GO:BP	T cell proliferation	16175	9965		0.7928994082840237	0.7941176470588235	140	16035	6	31	134	16004	16175	0.07935046914878853
R1	cpdb	0	network_modules	111	TRUE	0.0013376416686674832	77	37	5	0.13513513513513514	0.06493506493506493	GO:0042102	GO:BP	positive regulation of T cell proliferation	16175	9967		0.7988165680473372	0.8	77	16098	5	32	72	16066	16175	0.09069478209228587
R1	cpdb	0	network_modules	111	TRUE	0.0014581624715679878	33	37	4	0.10810810810810811	0.12121212121212122	GO:0045622	GO:BP	regulation of T-helper cell differentiation	16175	11473		0.8047337278106509	0.8117647058823529	33	16142	4	33	29	16109	16175	0.11255601730341576
R1	cpdb	0	network_modules	111	TRUE	0.0014581624715679878	33	37	4	0.10810810810810811	0.12121212121212122	GO:2000516	GO:BP	positive regulation of CD4-positive, alpha-beta T cell activation	16175	25819		0.8047337278106509	0.8117647058823529	33	16142	4	33	29	16109	16175	0.11255601730341576
R1	cpdb	0	network_modules	111	TRUE	0.0014728603095948832	236	37	7	0.1891891891891892	0.029661016949152543	GO:0070661	GO:BP	leukocyte proliferation	16175	16242		0.8165680473372781	0.8176470588235294	236	15939	7	30	229	15909	16175	0.06972281989839668
R1	cpdb	0	network_modules	111	TRUE	0.0014787546112924898	9	37	3	0.08108108108108109	0.3333333333333333	GO:0097048	GO:BP	dendritic cell apoptotic process	16175	18461		0.8224852071005917	0.8352941176470589	9	16166	3	34	6	16132	16175	0.16350336330530119
R1	cpdb	0	network_modules	111	TRUE	0.0014787546112924898	9	37	3	0.08108108108108109	0.3333333333333333	GO:0051135	GO:BP	positive regulation of NK T cell activation	16175	13519		0.8224852071005917	0.8352941176470589	9	16166	3	34	6	16132	16175	0.16350336330530119
R1	cpdb	0	network_modules	111	TRUE	0.0014787546112924898	9	37	3	0.08108108108108109	0.3333333333333333	GO:2000668	GO:BP	regulation of dendritic cell apoptotic process	16175	25943		0.8224852071005917	0.8352941176470589	9	16166	3	34	6	16132	16175	0.16350336330530119
R1	cpdb	0	network_modules	111	TRUE	0.0016498875452078442	34	37	4	0.10810810810810811	0.11764705882352941	GO:0001916	GO:BP	positive regulation of T cell mediated cytotoxicity	16175	533		0.8402366863905325	0.8411764705882353	34	16141	4	33	30	16108	16175	0.11082722796983693
R1	cpdb	0	network_modules	111	TRUE	0.0018597367461617074	35	37	4	0.10810810810810811	0.11428571428571428	GO:0032660	GO:BP	regulation of interleukin-17 production	16175	7706		0.8461538461538461	0.8529411764705882	35	16140	4	33	31	16107	16175	0.10917218486028073
R1	cpdb	0	network_modules	111	TRUE	0.0018597367461617074	35	37	4	0.10810810810810811	0.11428571428571428	GO:0032620	GO:BP	interleukin-17 production	16175	7667		0.8461538461538461	0.8529411764705882	35	16140	4	33	31	16107	16175	0.10917218486028073
R1	cpdb	0	network_modules	111	TRUE	0.001985066911723115	154	37	6	0.16216216216216217	0.03896103896103896	GO:0002819	GO:BP	regulation of adaptive immune response	16175	1329		0.8579881656804734	0.8588235294117647	154	16021	6	31	148	15990	16175	0.07526397850994873
R1	cpdb	0	network_modules	111	TRUE	0.0020887900256531407	36	37	4	0.10810810810810811	0.1111111111111111	GO:0051281	GO:BP	positive regulation of release of sequestered calcium ion into cytosol	16175	13617		0.863905325443787	0.8647058823529412	36	16139	4	33	32	16106	16175	0.10758574250566122
R1	cpdb	0	network_modules	111	TRUE	0.002108593905054784	249	37	7	0.1891891891891892	0.028112449799196786	GO:0051251	GO:BP	positive regulation of lymphocyte activation	16175	13598		0.8698224852071006	0.8705882352941177	249	15926	7	30	242	15896	16175	0.0675934635209919
R1	cpdb	0	network_modules	111	TRUE	0.0023743971821536913	369	37	8	0.21621621621621623	0.02168021680216802	GO:0051249	GO:BP	regulation of lymphocyte activation	16175	13596		0.8757396449704142	0.8764705882352941	369	15806	8	29	361	15777	16175	0.062024011866585176
R1	cpdb	0	network_modules	111	TRUE	0.0024814028953630187	160	37	6	0.16216216216216217	0.0375	GO:0097553	GO:BP	calcium ion transmembrane import into cytosol	16175	18700		0.8816568047337278	0.8823529411764706	160	16015	6	31	154	15984	16175	0.07367365055775286
R1	cpdb	0	network_modules	111	TRUE	0.0026045360460270665	88	37	5	0.13513513513513514	0.056818181818181816	GO:0035710	GO:BP	CD4-positive, alpha-beta T cell activation	16175	9184		0.8875739644970414	0.888235294117647	88	16087	5	32	83	16055	16175	0.08442352053341767
R1	cpdb	0	network_modules	111	TRUE	0.0026089686894097117	38	37	4	0.10810810810810811	0.10526315789473684	GO:0002686	GO:BP	negative regulation of leukocyte migration	16175	1204		0.893491124260355	0.8941176470588236	38	16137	4	33	34	16104	16175	0.10460046791878819
R1	cpdb	0	network_modules	111	TRUE	0.0028955468613571646	11	37	3	0.08108108108108109	0.2727272727272727	GO:0051133	GO:BP	regulation of NK T cell activation	16175	13517		0.8994082840236687	0.9	11	16164	3	34	8	16130	16175	0.1476763966029298
R1	cpdb	0	network_modules	111	TRUE	0.0034268174765299214	93	37	5	0.13513513513513514	0.053763440860215055	GO:0051928	GO:BP	positive regulation of calcium ion transport	16175	13999		0.9053254437869822	0.9058823529411765	93	16082	5	32	88	16050	16175	0.08193971958675034
R1	cpdb	0	network_modules	111	TRUE	0.003854644282407897	12	37	3	0.08108108108108109	0.25	GO:0051132	GO:BP	NK T cell activation	16175	13516		0.9112426035502958	0.9117647058823529	12	16163	3	34	9	16129	16175	0.1412850353319482
R1	cpdb	0	network_modules	111	TRUE	0.0039303763300128115	42	37	4	0.10810810810810811	0.09523809523809523	GO:0030838	GO:BP	positive regulation of actin filament polymerization	16175	6923		0.9171597633136095	0.9352941176470588	42	16133	4	33	38	16100	16175	0.09927454735520347
R1	cpdb	0	network_modules	111	TRUE	0.0039303763300128115	42	37	4	0.10810810810810811	0.09523809523809523	GO:0061756	GO:BP	leukocyte adhesion to vascular endothelial cell	16175	15650		0.9171597633136095	0.9352941176470588	42	16133	4	33	38	16100	16175	0.09927454735520347
R1	cpdb	0	network_modules	111	TRUE	0.0039303763300128115	42	37	4	0.10810810810810811	0.09523809523809523	GO:0001914	GO:BP	regulation of T cell mediated cytotoxicity	16175	531		0.9171597633136095	0.9352941176470588	42	16133	4	33	38	16100	16175	0.09927454735520347
R1	cpdb	0	network_modules	111	TRUE	0.0039303763300128115	42	37	4	0.10810810810810811	0.09523809523809523	GO:0071622	GO:BP	regulation of granulocyte chemotaxis	16175	16802		0.9171597633136095	0.9352941176470588	42	16133	4	33	38	16100	16175	0.09927454735520347
R1	cpdb	0	network_modules	111	TRUE	0.0040829056725748955	275	37	7	0.1891891891891892	0.025454545454545455	GO:0002696	GO:BP	positive regulation of leukocyte activation	16175	1214		0.9408284023668639	0.9411764705882353	275	15900	7	30	268	15870	16175	0.06377601357195342
R1	cpdb	0	network_modules	111	TRUE	0.004555391499744914	111	31	5	0.16129032258064516	0.04504504504504504	REAC:R-HSA-6785807	REAC	Interleukin-4 and Interleukin-13 signaling	10916	1252		1	1	111	10805	5	26	106	10779	10916	0.08038653196400297
R1	cpdb	0	network_modules	111	TRUE	0.004600018568369124	104	35	5	0.14285714285714285	0.04807692307692308	KEGG:04625	KEGG	C-type lectin receptor signaling pathway	8484	330		0.8	0.8181818181818182	104	8380	5	30	99	8350	8484	0.07638928561136575
R1	cpdb	0	network_modules	111	TRUE	0.004751299862666524	44	37	4	0.10810810810810811	0.09090909090909091	GO:0043370	GO:BP	regulation of CD4-positive, alpha-beta T cell differentiation	16175	10647		0.9467455621301775	0.9470588235294117	44	16131	4	33	40	16098	16175	0.09688441051059875
R1	cpdb	0	network_modules	111	TRUE	0.0048374287365170274	406	37	8	0.21621621621621623	0.019704433497536946	GO:0042110	GO:BP	T cell activation	16175	9970		0.9526627218934911	0.9529411764705882	406	15769	8	29	398	15740	16175	0.05849943711315512
R1	cpdb	0	network_modules	111	TRUE	0.004907165667364488	100	37	5	0.13513513513513514	0.05	GO:1903038	GO:BP	negative regulation of leukocyte cell-cell adhesion	16175	22718		0.9585798816568047	0.9588235294117647	100	16075	5	32	95	16043	16175	0.07877264526420974
R1	cpdb	0	network_modules	111	TRUE	0.005003140153530381	13	37	3	0.08108108108108109	0.23076923076923078	GO:0002827	GO:BP	positive regulation of T-helper 1 type immune response	16175	1337		0.9644970414201184	0.9647058823529412	13	16162	3	34	10	16128	16175	0.13564200894436634
R1	cpdb	0	network_modules	111	TRUE	0.005039243337795503	106	35	5	0.14285714285714285	0.04716981132075472	KEGG:04620	KEGG	Toll-like receptor signaling pathway	8484	325		0.9	0.9090909090909091	106	8378	5	30	101	8348	8484	0.0755376350034223
R1	cpdb	0	network_modules	111	TRUE	0.005206333716058509	45	37	4	0.10810810810810811	0.08888888888888889	GO:0001913	GO:BP	T cell mediated cytotoxicity	16175	530		0.9704142011834319	0.9705882352941176	45	16130	4	33	41	16097	16175	0.09574863668440194
R1	cpdb	0	network_modules	111	TRUE	0.00524413061561531	182	37	6	0.16216216216216217	0.03296703296703297	GO:0051651	GO:BP	maintenance of location in cell	16175	13864		0.9763313609467456	0.9764705882352941	182	15993	6	31	176	15962	16175	0.06850753080847354
R1	cpdb	0	network_modules	111	TRUE	0.005782799914794923	56	35	4	0.11428571428571428	0.07142857142857142	KEGG:05134	KEGG	Legionellosis	8484	431		1	1	56	8428	4	31	52	8397	8484	0.08559160712388536
R1	cpdb	0	network_modules	111	TRUE	0.005800991533585689	290	37	7	0.1891891891891892	0.02413793103448276	GO:0050867	GO:BP	positive regulation of cell activation	16175	13315		0.9822485207100592	0.9823529411764705	290	15885	7	30	283	15855	16175	0.0617994135228268
R1	cpdb	0	network_modules	111	TRUE	0.006327065667603153	421	37	8	0.21621621621621623	0.019002375296912115	GO:0002694	GO:BP	regulation of leukocyte activation	16175	1212		0.9881656804733728	0.9882352941176471	421	15754	8	29	413	15725	16175	0.057196287686798304
R1	cpdb	0	network_modules	111	TRUE	0.007934474510536641	15	37	3	0.08108108108108109	0.2	GO:0032816	GO:BP	positive regulation of natural killer cell activation	16175	7840		0.9940828402366864	0.9941176470588236	15	16160	3	34	12	16126	16175	0.12608914305468685
R1	cpdb	0	network_modules	111	TRUE	0.008954519463889064	113	37	5	0.13513513513513514	0.04424778761061947	GO:0008064	GO:BP	regulation of actin polymerization or depolymerization	16175	3113		1	1	113	16062	5	32	108	16030	16175	0.07367101256193688
R1	cpdb	0	network_modules	112	TRUE	1.0079100776889888e-27	168	20	18	0.9	0.10714285714285714	KEGG:04141	KEGG	Protein processing in endoplasmic reticulum	8484	278		NA	1	168	8316	18	2	150	8314	8484	0.3071116818258448
R1	cpdb	0	network_modules	112	TRUE	8.668881800106071e-18	182	27	14	0.5185185185185185	0.07692307692307693	GO:0006457	GO:BP	protein folding	16175	2203		0	0.25	182	15993	14	13	168	15980	16175	0.1966538235640153
R1	cpdb	0	network_modules	112	TRUE	7.942635167164486e-15	11	27	7	0.25925925925925924	0.6363636363636364	GO:0034975	GO:BP	protein folding in endoplasmic reticulum	16175	8745		0.3333333333333333	0.5	11	16164	7	20	4	16144	16175	0.40559222459809574
R1	cpdb	0	network_modules	112	TRUE	8.173995202202049e-12	483	27	14	0.5185185185185185	0.028985507246376812	GO:0051604	GO:BP	protein maturation	16175	13821		0.6666666666666666	0.75	483	15692	14	13	469	15679	16175	0.11739747691204659
R1	cpdb	0	network_modules	112	TRUE	7.318862252795704e-10	200	27	10	0.37037037037037035	0.05	GO:0034976	GO:BP	response to endoplasmic reticulum stress	16175	8746		1	1	200	15975	10	17	190	15958	16175	0.13247111808946951
R1	cpdb	0	network_modules	112	TRUE	3.046315796762828e-5	26	19	4	0.21052631578947367	0.15384615384615385	REAC:R-HSA-901042	REAC	Calnexin/calreticulin cycle	10916	302		0	0.2	26	10890	4	15	22	10875	10916	0.1782999243324662
R1	cpdb	0	network_modules	112	TRUE	1.0564020782475484e-4	35	19	4	0.21052631578947367	0.11428571428571428	REAC:R-HSA-532668	REAC	N-glycan trimming in the ER and Calnexin/Calreticulin cycle	10916	1508		0.25	0.4	35	10881	4	15	31	10866	10916	0.1531297778015592
R1	cpdb	0	network_modules	112	TRUE	0.009112879521845849	5	19	2	0.10526315789473684	0.4	REAC:R-HSA-9683686	REAC	Maturation of spike protein	10916	1407		0.5	0.6	5	10911	2	17	3	10894	10916	0.2045276598933455
R1	cpdb	0	network_modules	112	TRUE	0.009617371835837643	107	19	4	0.21052631578947367	0.037383177570093455	REAC:R-HSA-8957275	REAC	Post-translational protein phosphorylation	10916	1777		0.75	0.8	107	10809	4	15	103	10794	10916	0.08507499256645054
R1	cpdb	0	network_modules	112	TRUE	0.009804028720571397	36	19	3	0.15789473684210525	0.08333333333333333	REAC:R-HSA-3299685	REAC	Detoxification of Reactive Oxygen Species	10916	735		1	1	36	10880	3	16	33	10864	10916	0.11259567942006121
R1	cpdb	0	network_modules	113	TRUE	4.659386443042193e-6	3	25	3	0.12	1	GO:0043578	GO:BP	nuclear matrix organization	16175	10783		0	0.2857142857142857	3	16172	3	22	0	16150	16175	0.34617445729716456
R1	cpdb	0	network_modules	113	TRUE	4.659386443042193e-6	3	25	3	0.12	1	GO:0090292	GO:BP	nuclear matrix anchoring at nuclear membrane	16175	18176		0	0.2857142857142857	3	16172	3	22	0	16150	16175	0.34617445729716456
R1	cpdb	0	network_modules	113	TRUE	3.483956381930125e-5	121	25	6	0.24	0.049586776859504134	GO:0006997	GO:BP	nucleus organization	16175	2612		0.3333333333333333	0.42857142857142855	121	16054	6	19	115	16035	16175	0.10617023043072189
R1	cpdb	0	network_modules	113	TRUE	9.801247097485334e-4	16	20	3	0.15	0.1875	REAC:R-HSA-2995383	REAC	Initiation of Nuclear Envelope (NE) Reformation	10916	1201		0	0.3333333333333333	16	10900	3	17	13	10883	10916	0.166340644144421
R1	cpdb	0	network_modules	113	TRUE	0.0023116972571021674	154	20	5	0.25	0.032467532467532464	REAC:R-HSA-1474165	REAC	Reproduction	10916	2064		0.5	0.6666666666666666	154	10762	5	15	149	10747	10916	0.08569427910123935
R1	cpdb	0	network_modules	113	TRUE	0.0031234301241226206	17	25	3	0.12	0.17647058823529413	GO:0007097	GO:BP	nuclear migration	16175	2680		0.5	0.5714285714285714	17	16158	3	22	14	16136	16175	0.14443436822943198
R1	cpdb	0	network_modules	113	TRUE	0.003263473154710179	76	20	4	0.2	0.05263157894736842	REAC:R-HSA-1221632	REAC	Meiotic synapsis	10916	1412		1	1	76	10840	4	16	72	10824	10916	0.09946396571107319
R1	cpdb	0	network_modules	113	TRUE	0.003276358997535711	2	25	2	0.08	1	GO:0031022	GO:BP	nuclear migration along microfilament	16175	6996		0.6666666666666666	0.7142857142857143	2	16173	2	23	0	16150	16175	0.282641522315189
R1	cpdb	0	network_modules	113	TRUE	0.00444181271442159	19	25	3	0.12	0.15789473684210525	GO:0051457	GO:BP	maintenance of protein location in nucleus	16175	13718		0.8333333333333334	0.8571428571428571	19	16156	3	22	16	16134	16175	0.13648766424315323
R1	cpdb	0	network_modules	113	TRUE	0.008085042301513865	23	25	3	0.12	0.13043478260869565	GO:0051647	GO:BP	nucleus localization	16175	13860		1	1	23	16152	3	22	20	16130	16175	0.12380987150270771
R1	cpdb	0	network_modules	114	TRUE	1.4957540202208203e-66	34	30	27	0.9	0.7941176470588235	KEGG:03020	KEGG	RNA polymerase	8484	212		0	0.25	34	8450	27	3	7	8447	8484	0.8448249002106663
R1	cpdb	0	network_modules	114	TRUE	2.2212809145452462e-41	18	35	17	0.4857142857142857	0.9444444444444444	REAC:R-HSA-73780	REAC	RNA Polymerase III Chain Elongation	10916	1897		0	0.012048192771084338	18	10898	17	18	1	10880	10916	0.6766396890227245
R1	cpdb	0	network_modules	114	TRUE	1.2360439302038033e-37	23	35	17	0.4857142857142857	0.7391304347826086	REAC:R-HSA-73980	REAC	RNA Polymerase III Transcription Termination	10916	1903		0.012195121951219513	0.024096385542168676	23	10893	17	18	6	10875	10916	0.5981612982358139
R1	cpdb	0	network_modules	114	TRUE	1.0265458147679691e-35	27	35	17	0.4857142857142857	0.6296296296296297	REAC:R-HSA-76066	REAC	RNA Polymerase III Transcription Initiation From Type 2 Promoter	10916	1901		0.024390243902439025	0.03614457831325301	27	10889	17	18	10	10871	10916	0.5517608786828183
R1	cpdb	0	network_modules	114	TRUE	2.6089466273836697e-35	28	35	17	0.4857142857142857	0.6071428571428571	REAC:R-HSA-76071	REAC	RNA Polymerase III Transcription Initiation From Type 3 Promoter	10916	1902		0.036585365853658534	0.060240963855421686	28	10888	17	18	11	10870	10916	0.5417405897538159
R1	cpdb	0	network_modules	114	TRUE	2.6089466273836697e-35	28	35	17	0.4857142857142857	0.6071428571428571	REAC:R-HSA-76061	REAC	RNA Polymerase III Transcription Initiation From Type 1 Promoter	10916	1900		0.036585365853658534	0.060240963855421686	28	10888	17	18	11	10870	10916	0.5417405897538159
R1	cpdb	0	network_modules	114	TRUE	1.0315509972958908e-32	36	35	17	0.4857142857142857	0.4722222222222222	REAC:R-HSA-76046	REAC	RNA Polymerase III Transcription Initiation	10916	1899		0.06097560975609756	0.07228915662650602	36	10880	17	18	19	10862	10916	0.47722093397055315
R1	cpdb	0	network_modules	114	TRUE	1.8045873917133627e-31	41	35	17	0.4857142857142857	0.4146341463414634	REAC:R-HSA-74158	REAC	RNA Polymerase III Transcription	10916	1898		0.07317073170731707	0.0963855421686747	41	10875	17	18	24	10857	10916	0.4468544371805399
R1	cpdb	0	network_modules	114	TRUE	1.8045873917133627e-31	41	35	17	0.4857142857142857	0.4146341463414634	REAC:R-HSA-749476	REAC	RNA Polymerase III Abortive And Retractive Initiation	10916	1896		0.07317073170731707	0.0963855421686747	41	10875	17	18	24	10857	10916	0.4468544371805399
R1	cpdb	0	network_modules	114	TRUE	1.5840418411786174e-27	64	35	17	0.4857142857142857	0.265625	REAC:R-HSA-1834949	REAC	Cytosolic sensors of pathogen-associated DNA 	10916	428		0.0975609756097561	0.10843373493975904	64	10852	17	18	47	10834	10916	0.3564716278734271
R1	cpdb	0	network_modules	114	TRUE	7.45639876575419e-26	82	30	17	0.5666666666666667	0.2073170731707317	KEGG:04623	KEGG	Cytosolic DNA-sensing pathway	8484	328		0.3333333333333333	0.5	82	8402	17	13	65	8389	8484	0.3391471709425565
R1	cpdb	0	network_modules	114	TRUE	6.410381318810116e-21	31	35	12	0.34285714285714286	0.3870967741935484	REAC:R-HSA-73863	REAC	RNA Polymerase I Transcription Termination	10916	1886		0.10975609756097561	0.12048192771084337	31	10885	12	23	19	10862	10916	0.3623840401934176
R1	cpdb	0	network_modules	114	TRUE	5.511151739557827e-20	56	41	13	0.3170731707317073	0.23214285714285715	GO:0006383	GO:BP	transcription by RNA polymerase III	16175	2148		0	0.1	56	16119	13	28	43	16091	16175	0.26914943340123715
R1	cpdb	0	network_modules	114	TRUE	4.021001269129382e-19	18	35	10	0.2857142857142857	0.5555555555555556	REAC:R-HSA-8851708	REAC	Signaling by FGFR2 IIIa TM	10916	2245		0.12195121951219512	0.13253012048192772	18	10898	10	25	8	10873	10916	0.39707424732962926
R1	cpdb	0	network_modules	114	TRUE	2.3005008963062648e-18	47	35	12	0.34285714285714286	0.2553191489361702	REAC:R-HSA-73762	REAC	RNA Polymerase I Transcription Initiation	10916	1885		0.13414634146341464	0.14457831325301204	47	10869	12	23	35	10846	10916	0.29325417900339334
R1	cpdb	0	network_modules	114	TRUE	5.892737852155796e-18	22	35	10	0.2857142857142857	0.45454545454545453	REAC:R-HSA-167242	REAC	Abortive elongation of HIV-1 transcript in the absence of Tat	10916	51		0.14634146341463414	0.1566265060240964	22	10894	10	25	12	10869	10916	0.3587697046505855
R1	cpdb	0	network_modules	114	TRUE	7.663249185215983e-18	73	35	13	0.37142857142857144	0.1780821917808219	REAC:R-HSA-6807505	REAC	RNA polymerase II transcribes snRNA genes	10916	1904		0.15853658536585366	0.1686746987951807	73	10843	13	22	60	10821	10916	0.2538117575256072
R1	cpdb	0	network_modules	114	TRUE	1.0403869564583908e-17	23	35	10	0.2857142857142857	0.43478260869565216	REAC:R-HSA-203927	REAC	MicroRNA (miRNA) biogenesis	10916	1449		0.17073170731707318	0.18072289156626506	23	10893	10	25	13	10868	10916	0.3507864903924489
R1	cpdb	0	network_modules	114	TRUE	2.960146877529671e-17	25	35	10	0.2857142857142857	0.4	REAC:R-HSA-6803529	REAC	FGFR2 alternative splicing	10916	905		0.18292682926829268	0.1927710843373494	25	10891	10	25	15	10866	10916	0.3362760908565853
R1	cpdb	0	network_modules	114	TRUE	4.800204484042487e-17	26	35	10	0.2857142857142857	0.38461538461538464	REAC:R-HSA-77075	REAC	RNA Pol II CTD phosphorylation and interaction with CE	10916	1879		0.1951219512195122	0.21686746987951808	26	10890	10	25	16	10865	10916	0.32965439017380116
R1	cpdb	0	network_modules	114	TRUE	4.800204484042487e-17	26	35	10	0.2857142857142857	0.38461538461538464	REAC:R-HSA-167160	REAC	RNA Pol II CTD phosphorylation and interaction with CE during HIV infection	10916	1880		0.1951219512195122	0.21686746987951808	26	10890	10	25	16	10865	10916	0.32965439017380116
R1	cpdb	0	network_modules	114	TRUE	1.1809898111218407e-16	28	35	10	0.2857142857142857	0.35714285714285715	REAC:R-HSA-5601884	REAC	PIWI-interacting RNA (piRNA) biogenesis	10916	1685		0.21951219512195122	0.24096385542168675	28	10888	10	25	18	10863	10916	0.31748665705755286
R1	cpdb	0	network_modules	114	TRUE	1.1809898111218407e-16	28	35	10	0.2857142857142857	0.35714285714285715	REAC:R-HSA-72086	REAC	mRNA Capping	10916	2702		0.21951219512195122	0.24096385542168675	28	10888	10	25	18	10863	10916	0.31748665705755286
R1	cpdb	0	network_modules	114	TRUE	1.7988024847531331e-16	29	35	10	0.2857142857142857	0.3448275862068966	REAC:R-HSA-1839126	REAC	FGFR2 mutant receptor activation	10916	907		0.24390243902439024	0.25301204819277107	29	10887	10	25	19	10862	10916	0.3118781197167335
R1	cpdb	0	network_modules	114	TRUE	2.6925737558493986e-16	30	35	10	0.2857142857142857	0.3333333333333333	REAC:R-HSA-167243	REAC	Tat-mediated HIV elongation arrest and recovery	10916	2484		0.25609756097560976	0.27710843373493976	30	10886	10	25	20	10861	10916	0.30655093682187756
R1	cpdb	0	network_modules	114	TRUE	2.6925737558493986e-16	30	35	10	0.2857142857142857	0.3333333333333333	REAC:R-HSA-167238	REAC	Pausing and recovery of Tat-mediated HIV elongation	10916	1720		0.25609756097560976	0.27710843373493976	30	10886	10	25	20	10861	10916	0.30655093682187756
R1	cpdb	0	network_modules	114	TRUE	5.757353090038721e-16	32	35	10	0.2857142857142857	0.3125	REAC:R-HSA-167287	REAC	HIV elongation arrest and recovery	10916	1106		0.2804878048780488	0.3253012048192771	32	10884	10	25	22	10859	10916	0.29665173484761387
R1	cpdb	0	network_modules	114	TRUE	5.757353090038721e-16	32	35	10	0.2857142857142857	0.3125	REAC:R-HSA-167290	REAC	Pausing and recovery of HIV elongation	10916	1719		0.2804878048780488	0.3253012048192771	32	10884	10	25	22	10859	10916	0.29665173484761387
R1	cpdb	0	network_modules	114	TRUE	5.757353090038721e-16	32	35	10	0.2857142857142857	0.3125	REAC:R-HSA-167158	REAC	Formation of the HIV-1 Early Elongation Complex	10916	965		0.2804878048780488	0.3253012048192771	32	10884	10	25	22	10859	10916	0.29665173484761387
R1	cpdb	0	network_modules	114	TRUE	5.757353090038721e-16	32	35	10	0.2857142857142857	0.3125	REAC:R-HSA-113418	REAC	Formation of the Early Elongation Complex	10916	963		0.2804878048780488	0.3253012048192771	32	10884	10	25	22	10859	10916	0.29665173484761387
R1	cpdb	0	network_modules	114	TRUE	3.0763421370627394e-15	37	35	10	0.2857142857142857	0.2702702702702703	REAC:R-HSA-5655253	REAC	Signaling by FGFR2 in disease	10916	2248		0.32926829268292684	0.3373493975903614	37	10879	10	25	27	10854	10916	0.27549693407150694
R1	cpdb	0	network_modules	114	TRUE	7.439479040751815e-15	40	35	10	0.2857142857142857	0.25	REAC:R-HSA-168325	REAC	Viral Messenger RNA Synthesis	10916	2648		0.34146341463414637	0.3493975903614458	40	10876	10	25	30	10851	10916	0.2647430453554624
R1	cpdb	0	network_modules	114	TRUE	9.626521778790806e-15	89	35	12	0.34285714285714286	0.1348314606741573	REAC:R-HSA-5250924	REAC	B-WICH complex positively regulates rRNA expression	10916	198		0.35365853658536583	0.3614457831325301	89	10827	12	23	77	10804	10916	0.2110935386005142
R1	cpdb	0	network_modules	114	TRUE	1.1085775225650716e-14	90	35	12	0.34285714285714286	0.13333333333333333	REAC:R-HSA-73772	REAC	RNA Polymerase I Promoter Escape	10916	1882		0.36585365853658536	0.37349397590361444	90	10826	12	23	78	10803	10916	0.20986975853261994
R1	cpdb	0	network_modules	114	TRUE	1.2860218580134113e-14	42	35	10	0.2857142857142857	0.23809523809523808	REAC:R-HSA-167200	REAC	Formation of HIV-1 elongation complex containing HIV-1 Tat	10916	947		0.3780487804878049	0.40963855421686746	42	10874	10	25	32	10849	10916	0.25821867013005473
R1	cpdb	0	network_modules	114	TRUE	1.2860218580134113e-14	42	35	10	0.2857142857142857	0.23809523809523808	REAC:R-HSA-167169	REAC	HIV Transcription Elongation	10916	1104		0.3780487804878049	0.40963855421686746	42	10874	10	25	32	10849	10916	0.25821867013005473
R1	cpdb	0	network_modules	114	TRUE	1.2860218580134113e-14	42	35	10	0.2857142857142857	0.23809523809523808	REAC:R-HSA-167246	REAC	Tat-mediated elongation of the HIV-1 transcript	10916	2485		0.3780487804878049	0.40963855421686746	42	10874	10	25	32	10849	10916	0.25821867013005473
R1	cpdb	0	network_modules	114	TRUE	2.1595374215461393e-14	44	35	10	0.2857142857142857	0.22727272727272727	REAC:R-HSA-167152	REAC	Formation of HIV elongation complex in the absence of HIV Tat	10916	946		0.4146341463414634	0.42168674698795183	44	10872	10	25	34	10847	10916	0.252141017040912
R1	cpdb	0	network_modules	114	TRUE	3.533006214755532e-14	46	35	10	0.2857142857142857	0.21739130434782608	REAC:R-HSA-73776	REAC	RNA Polymerase II Promoter Escape	10916	1889		0.4268292682926829	0.4939759036144578	46	10870	10	25	36	10845	10916	0.24646105291526554
R1	cpdb	0	network_modules	114	TRUE	3.533006214755532e-14	46	35	10	0.2857142857142857	0.21739130434782608	REAC:R-HSA-75953	REAC	RNA Polymerase II Transcription Initiation	10916	1892		0.4268292682926829	0.4939759036144578	46	10870	10	25	36	10845	10916	0.24646105291526554
R1	cpdb	0	network_modules	114	TRUE	3.533006214755532e-14	46	35	10	0.2857142857142857	0.21739130434782608	REAC:R-HSA-73779	REAC	RNA Polymerase II Transcription Pre-Initiation And Promoter Opening	10916	1894		0.4268292682926829	0.4939759036144578	46	10870	10	25	36	10845	10916	0.24646105291526554
R1	cpdb	0	network_modules	114	TRUE	3.533006214755532e-14	46	35	10	0.2857142857142857	0.21739130434782608	REAC:R-HSA-167161	REAC	HIV Transcription Initiation	10916	1105		0.4268292682926829	0.4939759036144578	46	10870	10	25	36	10845	10916	0.24646105291526554
R1	cpdb	0	network_modules	114	TRUE	3.533006214755532e-14	46	35	10	0.2857142857142857	0.21739130434782608	REAC:R-HSA-167162	REAC	RNA Polymerase II HIV Promoter Escape	10916	1887		0.4268292682926829	0.4939759036144578	46	10870	10	25	36	10845	10916	0.24646105291526554
R1	cpdb	0	network_modules	114	TRUE	3.533006214755532e-14	46	35	10	0.2857142857142857	0.21739130434782608	REAC:R-HSA-76042	REAC	RNA Polymerase II Transcription Initiation And Promoter Clearance	10916	1893		0.4268292682926829	0.4939759036144578	46	10870	10	25	36	10845	10916	0.24646105291526554
R1	cpdb	0	network_modules	114	TRUE	5.645232083128323e-14	48	35	10	0.2857142857142857	0.20833333333333334	REAC:R-HSA-72165	REAC	mRNA Splicing - Minor Pathway	10916	2708		0.5	0.5060240963855421	48	10868	10	25	38	10843	10916	0.24113696854565989
R1	cpdb	0	network_modules	114	TRUE	6.806875211480026e-14	104	35	12	0.34285714285714286	0.11538461538461539	REAC:R-HSA-5250913	REAC	Positive epigenetic regulation of rRNA expression	10916	1771		0.5121951219512195	0.5180722891566265	104	10812	12	23	92	10789	10916	0.19461112098309444
R1	cpdb	0	network_modules	114	TRUE	7.670116534438304e-14	105	35	12	0.34285714285714286	0.11428571428571428	REAC:R-HSA-427413	REAC	NoRC negatively regulates rRNA expression	10916	1602		0.524390243902439	0.5301204819277109	105	10811	12	23	93	10788	10916	0.19363790984310988
R1	cpdb	0	network_modules	114	TRUE	1.0895213902726056e-13	108	35	12	0.34285714285714286	0.1111111111111111	REAC:R-HSA-5250941	REAC	Negative epigenetic regulation of rRNA expression	10916	1566		0.5365853658536586	0.54216867469879515	108	10808	12	23	96	10785	10916	0.190798566511001
R1	cpdb	0	network_modules	114	TRUE	1.2219068417037945e-13	109	35	12	0.34285714285714286	0.11009174311926606	REAC:R-HSA-73854	REAC	RNA Polymerase I Promoter Clearance	10916	1881		0.5487804878048781	0.5542168674698795	109	10807	12	23	97	10784	10916	0.18987785811655347
R1	cpdb	0	network_modules	114	TRUE	1.3540359157424896e-13	52	35	10	0.2857142857142857	0.19230769230769232	REAC:R-HSA-6781823	REAC	Formation of TC-NER Pre-Incision Complex	10916	951		0.5609756097560976	0.5662650602409639	52	10864	10	25	42	10839	10916	0.2314177215319581
R1	cpdb	0	network_modules	114	TRUE	1.3688385103288996e-13	110	35	12	0.34285714285714286	0.10909090909090909	REAC:R-HSA-73864	REAC	RNA Polymerase I Transcription	10916	1884		0.573170731707317	0.5783132530120482	110	10806	12	23	98	10783	10916	0.18896953190658589
R1	cpdb	0	network_modules	114	TRUE	3.0222097994643985e-13	56	35	10	0.2857142857142857	0.17857142857142858	REAC:R-HSA-1226099	REAC	Signaling by FGFR in disease	10916	2240		0.5853658536585366	0.5903614457831325	56	10860	10	25	46	10835	10916	0.2227498559739743
R1	cpdb	0	network_modules	114	TRUE	3.2743133363893003e-13	61	30	10	0.3333333333333333	0.16393442622950818	KEGG:03420	KEGG	Nucleotide excision repair	8484	238		0.6666666666666666	0.75	61	8423	10	20	51	8403	8484	0.22995367090660604
R1	cpdb	0	network_modules	114	TRUE	3.65757167286935e-13	57	35	10	0.2857142857142857	0.17543859649122806	REAC:R-HSA-112382	REAC	Formation of RNA Pol II elongation complex 	10916	949		0.5975609756097561	0.6144578313253012	57	10859	10	25	47	10834	10916	0.2207253410689007
R1	cpdb	0	network_modules	114	TRUE	3.65757167286935e-13	57	35	10	0.2857142857142857	0.17543859649122806	REAC:R-HSA-75955	REAC	RNA Polymerase II Transcription Elongation	10916	1891		0.5975609756097561	0.6144578313253012	57	10859	10	25	47	10834	10916	0.2207253410689007
R1	cpdb	0	network_modules	114	TRUE	7.574270051979096e-13	61	35	10	0.2857142857142857	0.16393442622950818	REAC:R-HSA-6796648	REAC	TP53 Regulates Transcription of DNA Repair Genes	10916	2456		0.6219512195121951	0.6265060240963856	61	10855	10	25	51	10830	10916	0.2131262668175796
R1	cpdb	0	network_modules	114	TRUE	1.0689948719314803e-12	63	35	10	0.2857142857142857	0.15873015873015872	REAC:R-HSA-6782210	REAC	Gap-filling DNA repair synthesis and ligation in TC-NER	10916	1038		0.6341463414634146	0.6385542168674698	63	10853	10	25	53	10828	10916	0.20959817096128303
R1	cpdb	0	network_modules	114	TRUE	1.2643073150905398e-12	64	35	10	0.2857142857142857	0.15625	REAC:R-HSA-5654738	REAC	Signaling by FGFR2	10916	2244		0.6463414634146342	0.6626506024096386	64	10852	10	25	54	10827	10916	0.20789576534498522
R1	cpdb	0	network_modules	114	TRUE	1.2643073150905398e-12	64	35	10	0.2857142857142857	0.15625	REAC:R-HSA-6782135	REAC	Dual incision in TC-NER	10916	808		0.6463414634146342	0.6626506024096386	64	10852	10	25	54	10827	10916	0.20789576534498522
R1	cpdb	0	network_modules	114	TRUE	1.7536409338515068e-12	66	35	10	0.2857142857142857	0.15151515151515152	REAC:R-HSA-9670095	REAC	Inhibition of DNA recombination at telomere	10916	1189		0.6707317073170732	0.6746987951807228	66	10850	10	25	56	10825	10916	0.20460642269821536
R1	cpdb	0	network_modules	114	TRUE	2.8086028864483687e-12	69	35	10	0.2857142857142857	0.14492753623188406	REAC:R-HSA-167172	REAC	Transcription of the HIV genome	10916	2540		0.6829268292682927	0.6867469879518072	69	10847	10	25	59	10822	10916	0.19994002808968764
R1	cpdb	0	network_modules	114	TRUE	7.769444349468433e-12	76	35	10	0.2857142857142857	0.13157894736842105	REAC:R-HSA-190236	REAC	Signaling by FGFR	10916	2239		0.6951219512195121	0.6987951807228916	76	10840	10	25	66	10815	10916	0.19013398175024884
R1	cpdb	0	network_modules	114	TRUE	8.910373545372046e-12	77	35	10	0.2857142857142857	0.12987012987012986	REAC:R-HSA-6781827	REAC	Transcription-Coupled Nucleotide Excision Repair (TC-NER)	10916	2541		0.7073170731707317	0.7108433734939759	77	10839	10	25	67	10814	10916	0.18884194305455548
R1	cpdb	0	network_modules	114	TRUE	1.3289886466152741e-11	80	35	10	0.2857142857142857	0.125	REAC:R-HSA-674695	REAC	RNA Polymerase II Pre-transcription Events	10916	1888		0.7195121951219512	0.7228915662650602	80	10836	10	25	70	10811	10916	0.1851102254100379
R1	cpdb	0	network_modules	114	TRUE	7.825213619592294e-11	185	35	12	0.34285714285714286	0.06486486486486487	REAC:R-HSA-212165	REAC	Epigenetic regulation of gene expression	10916	852		0.7317073170731707	0.7349397590361446	185	10731	12	23	173	10708	10916	0.14320370677749872
R1	cpdb	0	network_modules	114	TRUE	1.6417994320436293e-10	102	35	10	0.2857142857142857	0.09803921568627451	REAC:R-HSA-5578749	REAC	Transcriptional regulation by small RNAs	10916	2555		0.7439024390243902	0.7469879518072289	102	10814	10	25	92	10789	10916	0.16291500799086112
R1	cpdb	0	network_modules	114	TRUE	3.2381661837843024e-10	109	35	10	0.2857142857142857	0.09174311926605505	REAC:R-HSA-5696398	REAC	Nucleotide Excision Repair	10916	1622		0.7560975609756098	0.7590361445783133	109	10807	10	25	99	10782	10916	0.1572822362792669
R1	cpdb	0	network_modules	114	TRUE	3.8982476579152523e-10	111	35	10	0.2857142857142857	0.09009009009009009	REAC:R-HSA-157579	REAC	Telomere Maintenance	10916	2489		0.7682926829268293	0.7710843373493976	111	10805	10	25	101	10780	10916	0.1557696871871869
R1	cpdb	0	network_modules	114	TRUE	8.614281382788497e-10	120	35	10	0.2857142857142857	0.08333333333333333	REAC:R-HSA-5619507	REAC	Activation of HOX genes during differentiation	10916	84		0.7804878048780488	0.7951807228915663	120	10796	10	25	110	10771	10916	0.14942846449906527
R1	cpdb	0	network_modules	114	TRUE	8.614281382788497e-10	120	35	10	0.2857142857142857	0.08333333333333333	REAC:R-HSA-5617472	REAC	Activation of anterior HOX genes in hindbrain development during early embryogenesis	10916	99		0.7804878048780488	0.7951807228915663	120	10796	10	25	110	10771	10916	0.14942846449906527
R1	cpdb	0	network_modules	114	TRUE	2.258325760246278e-9	132	35	10	0.2857142857142857	0.07575757575757576	REAC:R-HSA-162599	REAC	Late Phase of HIV Life Cycle	10916	1304		0.8048780487804879	0.8072289156626506	132	10784	10	25	122	10759	10916	0.141983266436321
R1	cpdb	0	network_modules	114	TRUE	2.4367992828574886e-9	133	35	10	0.2857142857142857	0.07518796992481203	REAC:R-HSA-168273	REAC	Influenza Viral RNA Transcription and Replication	10916	1186		0.8170731707317073	0.8192771084337349	133	10783	10	25	123	10758	10916	0.14140768719086225
R1	cpdb	0	network_modules	114	TRUE	2.6277827116578185e-9	134	35	10	0.2857142857142857	0.07462686567164178	REAC:R-HSA-211000	REAC	Gene Silencing by RNA	10916	1041		0.8292682926829268	0.8313253012048193	134	10782	10	25	124	10757	10916	0.14083840708401227
R1	cpdb	0	network_modules	114	TRUE	3.5327527758723297e-9	138	35	10	0.2857142857142857	0.07246376811594203	REAC:R-HSA-73886	REAC	Chromosome Maintenance	10916	357		0.8414634146341463	0.8433734939759037	138	10778	10	25	128	10753	10916	0.13862199578317172
R1	cpdb	0	network_modules	114	TRUE	5.8044923436401474e-9	145	35	10	0.2857142857142857	0.06896551724137931	REAC:R-HSA-162587	REAC	HIV Life Cycle	10916	1103		0.8536585365853658	0.8554216867469879	145	10771	10	25	135	10746	10916	0.1349608190261798
R1	cpdb	0	network_modules	114	TRUE	6.658043130253291e-9	147	35	10	0.2857142857142857	0.06802721088435375	REAC:R-HSA-9018519	REAC	Estrogen-dependent gene expression	10916	866		0.8658536585365854	0.8674698795180723	147	10769	10	25	137	10744	10916	0.13396186658144896
R1	cpdb	0	network_modules	114	TRUE	9.932209767177308e-9	153	35	10	0.2857142857142857	0.06535947712418301	REAC:R-HSA-168255	REAC	Influenza Infection	10916	1185		0.8780487804878049	0.8795180722891566	153	10763	10	25	143	10738	10916	0.13108031003256443
R1	cpdb	0	network_modules	114	TRUE	5.460532281483061e-8	11	41	5	0.12195121951219512	0.45454545454545453	GO:0042797	GO:BP	tRNA transcription by RNA polymerase III	16175	10374		0.1111111111111111	0.2	11	16164	5	36	6	16128	16175	0.2345049160115257
R1	cpdb	0	network_modules	114	TRUE	9.343545317460698e-8	12	41	5	0.12195121951219512	0.4166666666666667	GO:0009304	GO:BP	tRNA transcription	16175	3451		0.2222222222222222	0.3	12	16163	5	36	7	16127	16175	0.22441384482050494
R1	cpdb	0	network_modules	114	TRUE	1.5520923393998546e-7	202	35	10	0.2857142857142857	0.04950495049504951	REAC:R-HSA-72163	REAC	mRNA Splicing - Major Pathway	10916	2707		0.8902439024390244	0.891566265060241	202	10714	10	25	192	10689	10916	0.11245098676416765
R1	cpdb	0	network_modules	114	TRUE	2.1666369792580166e-7	209	35	10	0.2857142857142857	0.04784688995215311	REAC:R-HSA-72172	REAC	mRNA Splicing	10916	2706		0.9024390243902439	0.9036144578313253	209	10707	10	25	199	10682	10916	0.11032253709832311
R1	cpdb	0	network_modules	114	TRUE	2.989215548671387e-7	216	35	10	0.2857142857142857	0.046296296296296294	REAC:R-HSA-8939211	REAC	ESR-mediated signaling	10916	830		0.9146341463414634	0.9156626506024096	216	10700	10	25	206	10675	10916	0.10829452885625271
R1	cpdb	0	network_modules	114	TRUE	4.4494191726198145e-7	225	35	10	0.2857142857142857	0.044444444444444446	REAC:R-HSA-162906	REAC	HIV Infection	10916	1102		0.926829268292683	0.927710843373494	225	10691	10	25	215	10666	10916	0.10582207699448433
R1	cpdb	0	network_modules	114	TRUE	6.921899689413054e-7	38	41	6	0.14634146341463414	0.15789473684210525	GO:0032728	GO:BP	positive regulation of interferon-beta production	16175	7773		0.3333333333333333	0.4	38	16137	6	35	32	16102	16175	0.14993424493331878
R1	cpdb	0	network_modules	114	TRUE	3.1995998197879843e-6	276	35	10	0.2857142857142857	0.036231884057971016	REAC:R-HSA-72203	REAC	Processing of Capped Intron-Containing Pre-mRNA	10916	1796		0.9390243902439024	0.9397590361445783	276	10640	10	25	266	10615	10916	0.09408693008942308
R1	cpdb	0	network_modules	114	TRUE	3.526334858732985e-6	305	30	10	0.3333333333333333	0.03278688524590164	KEGG:05016	KEGG	Huntington disease	8484	414		1	1	305	8179	10	20	295	8159	8484	0.09515831261737688
R1	cpdb	0	network_modules	114	TRUE	4.407768335918513e-6	51	41	6	0.14634146341463414	0.11764705882352941	GO:0032608	GO:BP	interferon-beta production	16175	7656		0.4444444444444444	0.6	51	16124	6	35	45	16089	16175	0.1287513214112007
R1	cpdb	0	network_modules	114	TRUE	4.407768335918513e-6	51	41	6	0.14634146341463414	0.11764705882352941	GO:0032648	GO:BP	regulation of interferon-beta production	16175	7695		0.4444444444444444	0.6	51	16124	6	35	45	16089	16175	0.1287513214112007
R1	cpdb	0	network_modules	114	TRUE	5.1353160693667555e-6	290	35	10	0.2857142857142857	0.034482758620689655	REAC:R-HSA-9006931	REAC	Signaling by Nuclear Receptors	10916	2289		0.9512195121951219	0.9518072289156626	290	10626	10	25	280	10601	10916	0.09139590307975566
R1	cpdb	0	network_modules	114	TRUE	1.3339458192735878e-5	61	41	6	0.14634146341463414	0.09836065573770492	GO:0006360	GO:BP	transcription by RNA polymerase I	16175	2136		0.6666666666666666	0.7	61	16114	6	35	55	16079	16175	0.1172539246478317
R1	cpdb	0	network_modules	114	TRUE	1.700842340367766e-5	329	35	10	0.2857142857142857	0.030395136778115502	REAC:R-HSA-73894	REAC	DNA Repair	10916	444		0.9634146341463414	0.963855421686747	329	10587	10	25	319	10562	10916	0.08478073491861024
R1	cpdb	0	network_modules	114	TRUE	2.1626061984597318e-5	66	41	6	0.14634146341463414	0.09090909090909091	GO:0032481	GO:BP	positive regulation of type I interferon production	16175	7592		0.7777777777777778	0.8	66	16109	6	35	60	16074	16175	0.11249807013470212
R1	cpdb	0	network_modules	114	TRUE	3.8629796609474456e-5	359	35	10	0.2857142857142857	0.027855153203342618	REAC:R-HSA-3700989	REAC	Transcriptional Regulation by TP53	10916	2546		0.975609756097561	0.9759036144578314	359	10557	10	25	349	10532	10916	0.08040234850741917
R1	cpdb	0	network_modules	114	TRUE	1.5876376137431963e-4	418	35	10	0.2857142857142857	0.023923444976076555	REAC:R-HSA-5663202	REAC	Diseases of signal transduction by growth factor receptors and second messengers	10916	773		0.9878048780487805	0.9879518072289156	418	10498	10	25	408	10473	10916	0.07312397735116181
R1	cpdb	0	network_modules	114	TRUE	4.6975347017811123e-4	110	41	6	0.14634146341463414	0.05454545454545454	GO:0032479	GO:BP	regulation of type I interferon production	16175	7590		0.8888888888888888	1	110	16065	6	35	104	16030	16175	0.08559134144356464
R1	cpdb	0	network_modules	114	TRUE	4.6975347017811123e-4	110	41	6	0.14634146341463414	0.05454545454545454	GO:0032606	GO:BP	type I interferon production	16175	7654		0.8888888888888888	1	110	16065	6	35	104	16030	16175	0.08559134144356464
R1	cpdb	0	network_modules	114	TRUE	9.21142900399037e-4	507	35	10	0.2857142857142857	0.01972386587771203	REAC:R-HSA-9006934	REAC	Signaling by Receptor Tyrosine Kinases	10916	2302		1	1	507	10409	10	25	497	10384	10916	0.06448230483190416
R1	cpdb	0	network_modules	115	TRUE	1.1627943535178678e-10	103	22	9	0.4090909090909091	0.08737864077669903	KEGG:04137	KEGG	Mitophagy - animal	8484	274		0	0.3333333333333333	103	8381	9	13	94	8368	8484	0.18481840213626569
R1	cpdb	0	network_modules	115	TRUE	2.7933339808369415e-8	117	28	8	0.2857142857142857	0.06837606837606838	GO:0070585	GO:BP	protein localization to mitochondrion	16175	16190		0	0.1	117	16058	8	20	109	16038	16175	0.13684664039811223
R1	cpdb	0	network_modules	115	TRUE	7.420824075016494e-8	22	19	5	0.2631578947368421	0.22727272727272727	REAC:R-HSA-5205685	REAC	PINK1-PRKN Mediated Mitophagy	10916	1678		0	0.16666666666666666	22	10894	5	14	17	10880	10916	0.24314166761984146
R1	cpdb	0	network_modules	115	TRUE	2.2627940940768843e-7	27	19	5	0.2631578947368421	0.18518518518518517	REAC:R-HSA-5205647	REAC	Mitophagy	10916	1478		0.2	0.3333333333333333	27	10889	5	14	22	10875	10916	0.21914224969456547
R1	cpdb	0	network_modules	115	TRUE	1.0948554185422873e-5	364	28	9	0.32142857142857145	0.024725274725274724	GO:0007005	GO:BP	mitochondrion organization	16175	2617		0.1111111111111111	0.2	364	15811	9	19	355	15792	16175	0.08392837878592371
R1	cpdb	0	network_modules	115	TRUE	2.627305520715233e-5	99	28	6	0.21428571428571427	0.06060606060606061	GO:0006626	GO:BP	protein targeting to mitochondrion	16175	2340		0.2222222222222222	0.3	99	16076	6	22	93	16054	16175	0.11114215837846231
R1	cpdb	0	network_modules	115	TRUE	4.957764957982886e-5	110	28	6	0.21428571428571427	0.05454545454545454	GO:0072655	GO:BP	establishment of protein localization to mitochondrion	16175	17476		0.3333333333333333	0.4	110	16065	6	22	104	16043	16175	0.10513022188465886
R1	cpdb	0	network_modules	115	TRUE	6.36595265930053e-5	80	19	5	0.2631578947368421	0.0625	REAC:R-HSA-9663891	REAC	Selective autophagy	10916	2186		0.4	0.5	80	10836	5	14	75	10822	10916	0.12524415818788787
R1	cpdb	0	network_modules	115	TRUE	7.929998637932039e-5	8	19	3	0.15789473684210525	0.375	REAC:R-HSA-9715370	REAC	Miro GTPase Cycle	10916	1454		0.6	0.6666666666666666	8	10908	3	16	5	10892	10916	0.24250264233086488
R1	cpdb	0	network_modules	115	TRUE	2.0272788886253686e-4	265	22	7	0.3181818181818182	0.026415094339622643	KEGG:05012	KEGG	Parkinson disease	8484	412		0.5	0.6666666666666666	265	8219	7	15	258	8204	8484	0.08410931050518762
R1	cpdb	0	network_modules	115	TRUE	3.33697742967032e-4	182	22	6	0.2727272727272727	0.03296703296703297	KEGG:04621	KEGG	NOD-like receptor signaling pathway	8484	326		1	1	182	8302	6	16	176	8286	8484	0.08842965553618005
R1	cpdb	0	network_modules	115	TRUE	4.978807327726361e-4	162	28	6	0.21428571428571427	0.037037037037037035	GO:0009060	GO:BP	aerobic respiration	16175	3236		0.4444444444444444	0.5	162	16013	6	22	156	15991	16175	0.08542572266219524
R1	cpdb	0	network_modules	115	TRUE	8.342218806892574e-4	134	19	5	0.2631578947368421	0.03731343283582089	REAC:R-HSA-1632852	REAC	Macroautophagy	10916	1388		0.8	0.8333333333333334	134	10782	5	14	129	10768	10916	0.0951381875981911
R1	cpdb	0	network_modules	115	TRUE	9.568669905435644e-4	95	28	5	0.17857142857142858	0.05263157894736842	GO:0007006	GO:BP	mitochondrial membrane organization	16175	2618		0.5555555555555556	0.6	95	16080	5	23	90	16057	16175	0.09411531203943081
R1	cpdb	0	network_modules	115	TRUE	0.0011951490745018732	188	28	6	0.21428571428571427	0.031914893617021274	GO:0045333	GO:BP	cellular respiration	16175	11360		0.6666666666666666	0.7	188	15987	6	22	182	15965	16175	0.07873885470137071
R1	cpdb	0	network_modules	115	TRUE	0.0014060746471670578	149	19	5	0.2631578947368421	0.03355704697986577	REAC:R-HSA-9612973	REAC	Autophagy	10916	193		1	1	149	10767	5	14	144	10753	10916	0.089790666492685
R1	cpdb	0	network_modules	115	TRUE	0.004405566774427252	373	28	7	0.25	0.01876675603217158	GO:0072594	GO:BP	establishment of protein localization to organelle	16175	17458		0.7777777777777778	0.8	373	15802	7	21	366	15781	16175	0.06296184644867277
R1	cpdb	0	network_modules	115	TRUE	0.004592537865871111	57	28	4	0.14285714285714285	0.07017543859649122	GO:0000422	GO:BP	autophagy of mitochondrion	16175	126		0.8888888888888888	0.9	57	16118	4	24	53	16094	16175	0.09791268205506579
R1	cpdb	0	network_modules	115	TRUE	0.006564401753451561	252	28	6	0.21428571428571427	0.023809523809523808	GO:0015980	GO:BP	energy derivation by oxidation of organic compounds	16175	5060		1	1	252	15923	6	22	246	15901	16175	0.06681529638933749
R1	cpdb	0	network_modules	116	TRUE	2.9323594639275627e-7	248	11	7	0.6363636363636364	0.028225806451612902	KEGG:04144	KEGG	Endocytosis	8484	280		NA	1	248	8236	7	4	241	8232	8484	0.129860662759285
R1	cpdb	0	network_modules	116	TRUE	0.0032968362412703106	2	24	2	0.08333333333333333	1	GO:1905449	GO:BP	regulation of Fc-gamma receptor signaling pathway involved in phagocytosis	16175	24643		0	0.75	2	16173	2	22	0	16151	16175	0.28847872656338225
R1	cpdb	0	network_modules	116	TRUE	0.0032968362412703106	2	24	2	0.08333333333333333	1	GO:1905303	GO:BP	positive regulation of macropinocytosis	16175	24520		0	0.75	2	16173	2	22	0	16151	16175	0.28847872656338225
R1	cpdb	0	network_modules	116	TRUE	0.0032968362412703106	2	24	2	0.08333333333333333	1	GO:1990046	GO:BP	stress-induced mitochondrial fusion	16175	25061		0	0.75	2	16173	2	22	0	16151	16175	0.28847872656338225
R1	cpdb	0	network_modules	116	TRUE	0.009881539404908083	3	24	2	0.08333333333333333	0.6666666666666666	GO:1905301	GO:BP	regulation of macropinocytosis	16175	24518		1	1	3	16172	2	22	1	16150	16175	0.23537416597204877
R1	cpdb	0	network_modules	117	TRUE	0.004101533137935027	3	17	2	0.11764705882352941	0.6666666666666666	GO:1902573	GO:BP	positive regulation of serine-type peptidase activity	16175	22363		0	0.5	3	16172	2	15	1	16157	16175	0.27978750803920066
R1	cpdb	0	network_modules	117	TRUE	0.004101533137935027	3	17	2	0.11764705882352941	0.6666666666666666	GO:1900005	GO:BP	positive regulation of serine-type endopeptidase activity	16175	20322		0	0.5	3	16172	2	15	1	16157	16175	0.27978750803920066
R1	cpdb	0	network_modules	117	TRUE	0.005022934335235676	67	9	3	0.3333333333333333	0.04477611940298507	REAC:R-HSA-1650814	REAC	Collagen biosynthesis and modifying enzymes	10916	384		NA	1	67	10849	3	6	64	10843	10916	0.12033923957713503
R1	cpdb	0	network_modules	117	TRUE	0.008197994358362042	4	17	2	0.11764705882352941	0.5	GO:1900003	GO:BP	regulation of serine-type endopeptidase activity	16175	20320		0.6666666666666666	1	4	16171	2	15	2	16156	16175	0.2421830455760906
R1	cpdb	0	network_modules	117	TRUE	0.008197994358362042	4	17	2	0.11764705882352941	0.5	GO:1902571	GO:BP	regulation of serine-type peptidase activity	16175	22361		0.6666666666666666	1	4	16171	2	15	2	16156	16175	0.2421830455760906
R1	cpdb	0	network_modules	118	TRUE	0.002474147253048524	76	19	4	0.21052631578947367	0.05263157894736842	REAC:R-HSA-909733	REAC	Interferon alpha/beta signaling	10916	1228		0	0.5	76	10840	4	15	72	10825	10916	0.10222721180717641
R1	cpdb	0	network_modules	118	TRUE	0.004904358306393395	167	13	4	0.3076923076923077	0.023952095808383235	KEGG:05164	KEGG	Influenza A	8484	445		NA	1	167	8317	4	9	163	8308	8484	0.08122098580035993
R1	cpdb	0	network_modules	118	TRUE	0.0050695324641646415	91	19	4	0.21052631578947367	0.04395604395604396	REAC:R-HSA-877300	REAC	Interferon gamma signaling	10916	1229		1	1	91	10825	4	15	87	10810	10916	0.0928563744489722
R1	cpdb	0	network_modules	119	TRUE	5.164436201386866e-59	108	44	35	0.7954545454545454	0.32407407407407407	KEGG:03013	KEGG	Nucleocytoplasmic transport	8484	209		0	0.3333333333333333	108	8376	35	9	73	8367	8484	0.5041207829569637
R1	cpdb	0	network_modules	119	TRUE	3.3605395979877197e-50	261	52	36	0.6923076923076923	0.13793103448275862	GO:0051169	GO:BP	nuclear transport	16175	13552		0	0.0625	261	15914	36	16	225	15898	16175	0.30476850236035763
R1	cpdb	0	network_modules	119	TRUE	3.3605395979877197e-50	261	52	36	0.6923076923076923	0.13793103448275862	GO:0006913	GO:BP	nucleocytoplasmic transport	16175	2562		0	0.0625	261	15914	36	16	225	15898	16175	0.30476850236035763
R1	cpdb	0	network_modules	119	TRUE	5.737210455082636e-50	34	38	23	0.6052631578947368	0.6764705882352942	REAC:R-HSA-177243	REAC	Interactions of Rev with host cellular proteins	10916	1221		0	0.013513513513513514	34	10882	23	15	11	10867	10916	0.6386906545623117
R1	cpdb	0	network_modules	119	TRUE	8.812501981294184e-48	32	38	22	0.5789473684210527	0.6875	REAC:R-HSA-165054	REAC	Rev-mediated nuclear export of HIV RNA	10916	2098		0.0136986301369863	0.02702702702702703	32	10884	22	16	10	10868	10916	0.6297178553387826
R1	cpdb	0	network_modules	119	TRUE	3.765627944542758e-46	29	38	21	0.5526315789473685	0.7241379310344828	REAC:R-HSA-168333	REAC	NEP/NS2 Interacts with the Cellular Export Machinery	10916	1514		0.0273972602739726	0.04054054054054054	29	10887	21	17	8	10870	10916	0.6314959640955089
R1	cpdb	0	network_modules	119	TRUE	1.2533385085425258e-45	30	38	21	0.5526315789473685	0.7	REAC:R-HSA-168274	REAC	Export of Viral Ribonucleoproteins from Nucleus	10916	883		0.0410958904109589	0.05405405405405406	30	10886	21	17	9	10869	10916	0.6208069231261436
R1	cpdb	0	network_modules	119	TRUE	3.879558029879643e-45	31	38	21	0.5526315789473685	0.6774193548387096	REAC:R-HSA-180746	REAC	Nuclear import of Rev protein	10916	1619		0.0547945205479452	0.06756756756756757	31	10885	21	17	10	10868	10916	0.6106381339549425
R1	cpdb	0	network_modules	119	TRUE	5.306797405321752e-43	29	38	20	0.5263157894736842	0.6896551724137931	REAC:R-HSA-168271	REAC	Transport of Ribonucleoproteins into the Host Nucleus	10916	2589		0.0684931506849315	0.08108108108108109	29	10887	20	18	9	10869	10916	0.6012794687722928
R1	cpdb	0	network_modules	119	TRUE	4.472537974669531e-42	31	38	20	0.5263157894736842	0.6451612903225806	REAC:R-HSA-159227	REAC	Transport of the SLBP independent Mature mRNA	10916	2602		0.0821917808219178	0.0945945945945946	31	10885	20	18	11	10867	10916	0.5814099294181485
R1	cpdb	0	network_modules	119	TRUE	1.1907985993904418e-41	32	38	20	0.5263157894736842	0.625	REAC:R-HSA-159230	REAC	Transport of the SLBP Dependant Mature mRNA	10916	2601		0.0958904109589041	0.10810810810810811	32	10884	20	18	12	10866	10916	0.572179434097294
R1	cpdb	0	network_modules	119	TRUE	2.0974538895400606e-40	28	38	19	0.5	0.6785714285714286	REAC:R-HSA-170822	REAC	Regulation of Glucokinase by Glucokinase Regulatory Protein	10916	1975		0.1095890410958904	0.13513513513513514	28	10888	19	19	9	10869	10916	0.5812514226849576
R1	cpdb	0	network_modules	119	TRUE	2.0974538895400606e-40	28	38	19	0.5	0.6785714285714286	REAC:R-HSA-5619107	REAC	Defective TPR may confer susceptibility towards thyroid papillary carcinoma (TPC)	10916	684		0.1095890410958904	0.13513513513513514	28	10888	19	19	9	10869	10916	0.5812514226849576
R1	cpdb	0	network_modules	119	TRUE	1.7541836100994222e-39	38	38	20	0.5263157894736842	0.5263157894736842	REAC:R-HSA-168276	REAC	NS1 Mediated Effects on Host Pathways	10916	1550		0.136986301369863	0.16216216216216217	38	10878	20	18	18	10860	10916	0.524661073533254
R1	cpdb	0	network_modules	119	TRUE	1.7541836100994222e-39	38	38	20	0.5263157894736842	0.5263157894736842	REAC:R-HSA-159231	REAC	Transport of Mature mRNA Derived from an Intronless Transcript	10916	2585		0.136986301369863	0.16216216216216217	38	10878	20	18	18	10860	10916	0.524661073533254
R1	cpdb	0	network_modules	119	TRUE	3.595019064540696e-39	39	38	20	0.5263157894736842	0.5128205128205128	REAC:R-HSA-159234	REAC	Transport of Mature mRNAs Derived from Intronless Transcripts	10916	2587		0.1643835616438356	0.17567567567567569	39	10877	20	18	19	10859	10916	0.51782402913878
R1	cpdb	0	network_modules	119	TRUE	4.264201574257323e-39	31	38	19	0.5	0.6129032258064516	REAC:R-HSA-180910	REAC	Vpr-mediated nuclear import of PICs	10916	2665		0.1780821917808219	0.1891891891891892	31	10885	19	19	12	10866	10916	0.5521817248813545
R1	cpdb	0	network_modules	119	TRUE	9.717184288416667e-39	51	38	21	0.5526315789473685	0.4117647058823529	REAC:R-HSA-191859	REAC	snRNP Assembly	10916	2736		0.1917808219178082	0.21621621621621623	51	10865	21	17	30	10848	10916	0.47492970674224444
R1	cpdb	0	network_modules	119	TRUE	9.717184288416667e-39	51	38	21	0.5526315789473685	0.4117647058823529	REAC:R-HSA-194441	REAC	Metabolism of non-coding RNA	10916	1431		0.1917808219178082	0.21621621621621623	51	10865	21	17	30	10848	10916	0.47492970674224444
R1	cpdb	0	network_modules	119	TRUE	1.0479092203257935e-38	32	38	19	0.5	0.59375	REAC:R-HSA-4085377	REAC	SUMOylation of SUMOylation proteins	10916	2172		0.2191780821917808	0.22972972972972974	32	10884	19	19	13	10865	10916	0.5434102234765498
R1	cpdb	0	network_modules	119	TRUE	2.4659758278564813e-38	33	38	19	0.5	0.5757575757575758	REAC:R-HSA-3301854	REAC	Nuclear Pore Complex (NPC) Disassembly	10916	1615		0.2328767123287671	0.24324324324324326	33	10883	19	19	14	10864	10916	0.5350393564676426
R1	cpdb	0	network_modules	119	TRUE	4.978780489915646e-38	43	38	20	0.5263157894736842	0.46511627906976744	REAC:R-HSA-4615885	REAC	SUMOylation of DNA replication proteins	10916	2170		0.2465753424657534	0.25675675675675674	43	10873	20	18	23	10855	10916	0.4928963535701513
R1	cpdb	0	network_modules	119	TRUE	5.580275779456813e-38	34	38	19	0.5	0.5588235294117647	REAC:R-HSA-176033	REAC	Interactions of Vpr with host cellular proteins	10916	1223		0.2602739726027397	0.2702702702702703	34	10882	19	19	15	10863	10916	0.5270394601288642
R1	cpdb	0	network_modules	119	TRUE	1.2186608328184418e-37	35	38	19	0.5	0.5428571428571428	REAC:R-HSA-3232142	REAC	SUMOylation of ubiquitinylation proteins	10916	2179		0.273972602739726	0.28378378378378377	35	10881	19	19	16	10862	10916	0.5193838582057428
R1	cpdb	0	network_modules	119	TRUE	1.6083431290802143e-37	71	38	22	0.5789473684210527	0.30985915492957744	REAC:R-HSA-159236	REAC	Transport of Mature mRNA derived from an Intron-Containing Transcript	10916	2586		0.2876712328767123	0.2972972972972973	71	10845	22	16	49	10829	10916	0.42089058570321075
R1	cpdb	0	network_modules	119	TRUE	1.3776982488351033e-36	152	52	26	0.5	0.17105263157894737	GO:0051168	GO:BP	nuclear export	16175	13551		0.06451612903225806	0.09375	152	16023	26	26	126	15997	16175	0.2887748257638364
R1	cpdb	0	network_modules	119	TRUE	3.458250618643393e-36	80	38	22	0.5789473684210527	0.275	REAC:R-HSA-72202	REAC	Transport of Mature Transcript to Cytoplasm	10916	2584		0.3013698630136986	0.3108108108108108	80	10836	22	16	58	10820	10916	0.3961026213546126
R1	cpdb	0	network_modules	119	TRUE	3.9081002820606236e-36	40	38	19	0.5	0.475	REAC:R-HSA-168325	REAC	Viral Messenger RNA Synthesis	10916	2648		0.3150684931506849	0.32432432432432434	40	10876	19	19	21	10857	10916	0.48550273037927344
R1	cpdb	0	network_modules	119	TRUE	1.0018358332695837e-35	114	52	24	0.46153846153846156	0.21052631578947367	GO:0050658	GO:BP	RNA transport	16175	13198		0.0967741935483871	0.15625	114	16061	24	28	90	16033	16175	0.30853836458468314
R1	cpdb	0	network_modules	119	TRUE	1.0018358332695837e-35	114	52	24	0.46153846153846156	0.21052631578947367	GO:0050657	GO:BP	nucleic acid transport	16175	13197		0.0967741935483871	0.15625	114	16061	24	28	90	16033	16175	0.30853836458468314
R1	cpdb	0	network_modules	119	TRUE	1.998226004996246e-35	117	52	24	0.46153846153846156	0.20512820512820512	GO:0051236	GO:BP	establishment of RNA localization	16175	13586		0.16129032258064516	0.1875	117	16058	24	28	93	16030	16175	0.30446120816683203
R1	cpdb	0	network_modules	119	TRUE	2.3710552164027362e-35	43	38	19	0.5	0.4418604651162791	REAC:R-HSA-4570464	REAC	SUMOylation of RNA binding proteins	10916	2171		0.3287671232876712	0.33783783783783783	43	10873	19	19	24	10854	10916	0.4680656926341805
R1	cpdb	0	network_modules	119	TRUE	2.5685808543243125e-35	55	38	20	0.5263157894736842	0.36363636363636365	REAC:R-HSA-6784531	REAC	tRNA processing in the nucleus	10916	2745		0.3424657534246575	0.35135135135135137	55	10861	20	18	35	10843	10916	0.4351443722865471
R1	cpdb	0	network_modules	119	TRUE	2.051830047531908e-34	47	38	19	0.5	0.40425531914893614	REAC:R-HSA-2980766	REAC	Nuclear Envelope Breakdown	10916	1613		0.3561643835616438	0.36486486486486486	47	10869	19	19	28	10850	10916	0.44745676828330483
R1	cpdb	0	network_modules	119	TRUE	5.974889022166131e-34	90	52	22	0.4230769230769231	0.24444444444444444	GO:0006405	GO:BP	RNA export from nucleus	16175	2166		0.1935483870967742	0.21875	90	16085	22	30	68	16055	16175	0.3187579473071196
R1	cpdb	0	network_modules	119	TRUE	1.6445861531192337e-33	126	38	23	0.6052631578947368	0.18253968253968253	REAC:R-HSA-162909	REAC	Host Interactions of HIV factors	10916	1132		0.3698630136986301	0.3783783783783784	126	10790	23	15	103	10775	10916	0.32852379005158716
R1	cpdb	0	network_modules	119	TRUE	1.1164591368126372e-32	149	52	24	0.46153846153846156	0.1610738255033557	GO:0006403	GO:BP	RNA localization	16175	2164		0.22580645161290322	0.25	149	16026	24	28	125	15998	16175	0.26888685361655795
R1	cpdb	0	network_modules	119	TRUE	1.1175916568792833e-32	71	38	20	0.5263157894736842	0.28169014084507044	REAC:R-HSA-1169408	REAC	ISG15 antiviral mechanism	10916	1166		0.3835616438356164	0.3918918918918919	71	10845	20	18	51	10827	10916	0.38219305579395463
R1	cpdb	0	network_modules	119	TRUE	2.4327466243082965e-31	168	52	24	0.46153846153846156	0.14285714285714285	GO:0015931	GO:BP	nucleobase-containing compound transport	16175	5016		0.25806451612903225	0.28125	168	16007	24	28	144	15979	16175	0.25271811191036697
R1	cpdb	0	network_modules	119	TRUE	4.93286895432195e-31	66	38	19	0.5	0.2878787878787879	REAC:R-HSA-4551638	REAC	SUMOylation of chromatin organization proteins	10916	2173		0.3972602739726027	0.40540540540540543	66	10850	19	19	47	10831	10916	0.37660000177960534
R1	cpdb	0	network_modules	119	TRUE	6.874012925589672e-31	67	38	19	0.5	0.2835820895522388	REAC:R-HSA-3371453	REAC	Regulation of HSF1-mediated heat shock response	10916	1977		0.410958904109589	0.4189189189189189	67	10849	19	19	48	10830	10916	0.3737268900678634
R1	cpdb	0	network_modules	119	TRUE	7.429248596956835e-31	132	38	22	0.5789473684210527	0.16666666666666666	REAC:R-HSA-162599	REAC	Late Phase of HIV Life Cycle	10916	1304		0.4246575342465753	0.43243243243243246	132	10784	22	16	110	10768	10916	0.3065320539186206
R1	cpdb	0	network_modules	119	TRUE	9.523581825933272e-31	68	38	19	0.5	0.27941176470588236	REAC:R-HSA-70171	REAC	Glycolysis	10916	1074		0.4383561643835616	0.44594594594594594	68	10848	19	19	49	10829	10916	0.37091700266202404
R1	cpdb	0	network_modules	119	TRUE	2.629172859945993e-30	24	38	15	0.39473684210526316	0.625	REAC:R-HSA-9615933	REAC	Postmitotic nuclear pore complex (NPC) reformation	10916	1778		0.4520547945205479	0.4594594594594595	24	10892	15	23	9	10869	10916	0.4953399155551477
R1	cpdb	0	network_modules	119	TRUE	3.3237385740634184e-30	72	38	19	0.5	0.2638888888888889	REAC:R-HSA-3108214	REAC	SUMOylation of DNA damage response and repair proteins	10916	2168		0.4657534246575342	0.47297297297297297	72	10844	19	19	53	10825	10916	0.36026545236477947
R1	cpdb	0	network_modules	119	TRUE	6.863530348303674e-30	145	38	22	0.5789473684210527	0.15172413793103448	REAC:R-HSA-162587	REAC	HIV Life Cycle	10916	1103		0.4794520547945205	0.4864864864864865	145	10771	22	16	123	10755	10916	0.29202996213415283
R1	cpdb	0	network_modules	119	TRUE	2.4255544250100395e-29	153	38	22	0.5789473684210527	0.1437908496732026	REAC:R-HSA-168255	REAC	Influenza Infection	10916	1185		0.4931506849315068	0.5	153	10763	22	16	131	10747	10916	0.2840298653674972
R1	cpdb	0	network_modules	119	TRUE	3.925063751973321e-29	102	38	20	0.5263157894736842	0.19607843137254902	REAC:R-HSA-5578749	REAC	Transcriptional regulation by small RNAs	10916	2555		0.5068493150684932	0.5135135135135135	102	10814	20	18	82	10796	10916	0.3175808490259444
R1	cpdb	0	network_modules	119	TRUE	4.8631457015177835e-29	103	38	20	0.5263157894736842	0.1941747572815534	REAC:R-HSA-72306	REAC	tRNA processing	10916	2743		0.5205479452054794	0.527027027027027	103	10813	20	18	83	10795	10916	0.3159940427656394
R1	cpdb	0	network_modules	119	TRUE	1.5058365194681591e-28	86	38	19	0.5	0.22093023255813954	REAC:R-HSA-70326	REAC	Glucose metabolism	10916	1053		0.5342465753424658	0.5405405405405406	86	10830	19	19	67	10811	10916	0.32899539653502863
R1	cpdb	0	network_modules	119	TRUE	1.923375839054311e-28	87	38	19	0.5	0.21839080459770116	REAC:R-HSA-3371556	REAC	Cellular response to heat stress	10916	334		0.547945205479452	0.5540540540540541	87	10829	19	19	68	10810	10916	0.32705336379543615
R1	cpdb	0	network_modules	119	TRUE	1.2234361400981727e-27	95	38	19	0.5	0.2	REAC:R-HSA-5619102	REAC	SLC transporter disorders	10916	2145		0.5616438356164384	0.5675675675675675	95	10821	19	19	76	10802	10916	0.3126292198572753
R1	cpdb	0	network_modules	119	TRUE	2.3651549893428716e-27	225	38	23	0.6052631578947368	0.10222222222222223	REAC:R-HSA-162906	REAC	HIV Infection	10916	1102		0.5753424657534246	0.581081081081081	225	10691	23	15	202	10676	10916	0.24320764847709606
R1	cpdb	0	network_modules	119	TRUE	1.4452332403561417e-26	134	38	20	0.5263157894736842	0.14925373134328357	REAC:R-HSA-211000	REAC	Gene Silencing by RNA	10916	1041		0.589041095890411	0.5945945945945946	134	10782	20	18	114	10764	10916	0.2759153389919869
R1	cpdb	0	network_modules	119	TRUE	4.4464888289485556e-26	113	38	19	0.5	0.168141592920354	REAC:R-HSA-9610379	REAC	HCMV Late Events	10916	1090		0.6027397260273972	0.6081081081081081	113	10803	19	19	94	10784	10916	0.2859259487382029
R1	cpdb	0	network_modules	119	TRUE	1.035878665422912e-25	147	38	20	0.5263157894736842	0.1360544217687075	REAC:R-HSA-1169410	REAC	Antiviral mechanism by IFN-stimulated genes	10916	157		0.6164383561643836	0.6216216216216216	147	10769	20	18	127	10751	10916	0.2629809105388003
R1	cpdb	0	network_modules	119	TRUE	1.5200011958057988e-25	120	38	19	0.5	0.15833333333333333	REAC:R-HSA-9705671	REAC	SARS-CoV-2 activates/modulates innate and adaptive immune responses	10916	2123		0.6301369863013698	0.6351351351351351	120	10796	19	19	101	10777	10916	0.27718758810530186
R1	cpdb	0	network_modules	119	TRUE	1.2254045029799733e-24	133	38	19	0.5	0.14285714285714285	REAC:R-HSA-168273	REAC	Influenza Viral RNA Transcription and Replication	10916	1186		0.6438356164383562	0.6486486486486487	133	10783	19	19	114	10764	10916	0.262809621092038
R1	cpdb	0	network_modules	119	TRUE	1.425474861596945e-24	134	38	19	0.5	0.1417910447761194	REAC:R-HSA-68875	REAC	Mitotic Prophase	10916	1485		0.6575342465753424	0.6621621621621622	134	10782	19	19	115	10763	10916	0.26179012166388493
R1	cpdb	0	network_modules	119	TRUE	1.6561833493642752e-24	135	38	19	0.5	0.14074074074074075	REAC:R-HSA-9609690	REAC	HCMV Early Events	10916	1088		0.6712328767123288	0.6756756756756757	135	10781	19	19	116	10762	10916	0.26078183082350875
R1	cpdb	0	network_modules	119	TRUE	2.501541289461507e-24	171	38	20	0.5263157894736842	0.11695906432748537	REAC:R-HSA-3108232	REAC	SUMO E3 ligases SUMOylate target proteins	10916	2163		0.684931506849315	0.6891891891891891	171	10745	20	18	151	10727	10916	0.24305439223962447
R1	cpdb	0	network_modules	119	TRUE	5.1438375667881946e-24	177	38	20	0.5263157894736842	0.11299435028248588	REAC:R-HSA-2990846	REAC	SUMOylation	10916	2167		0.6986301369863014	0.7027027027027027	177	10739	20	18	157	10721	10916	0.23870882149895586
R1	cpdb	0	network_modules	119	TRUE	1.822689018278394e-23	276	38	22	0.5789473684210527	0.07971014492753623	REAC:R-HSA-72203	REAC	Processing of Capped Intron-Containing Pre-mRNA	10916	1796		0.7123287671232876	0.7162162162162162	276	10640	22	16	254	10624	10916	0.2084496853916742
R1	cpdb	0	network_modules	119	TRUE	4.391766653877217e-23	159	38	19	0.5	0.11949685534591195	REAC:R-HSA-9609646	REAC	HCMV Infection	10916	1089		0.726027397260274	0.7297297297297297	159	10757	19	19	140	10738	10916	0.23947878391487534
R1	cpdb	0	network_modules	119	TRUE	5.623147163811705e-23	406	38	24	0.631578947368421	0.059113300492610835	REAC:R-HSA-68886	REAC	M Phase	10916	1343		0.7397260273972602	0.7432432432432432	406	10510	24	14	382	10496	10916	0.18564569184842308
R1	cpdb	0	network_modules	119	TRUE	2.342262526081914e-22	173	38	19	0.5	0.10982658959537572	REAC:R-HSA-5619115	REAC	Disorders of transmembrane transporters	10916	778		0.7534246575342466	0.7567567567567568	173	10743	19	19	154	10724	10916	0.22912708147631292
R1	cpdb	0	network_modules	119	TRUE	1.324180892471158e-21	70	38	15	0.39473684210526316	0.21428571428571427	REAC:R-HSA-2995410	REAC	Nuclear Envelope (NE) Reassembly	10916	1612		0.7671232876712328	0.7702702702702703	70	10846	15	23	55	10823	10916	0.28753550244181975
R1	cpdb	0	network_modules	119	TRUE	1.4135411316953905e-21	363	44	25	0.5681818181818182	0.06887052341597796	KEGG:05014	KEGG	Amyotrophic lateral sclerosis	8484	413		0.5	0.6666666666666666	363	8121	25	19	338	8102	8484	0.18744936361918574
R1	cpdb	0	network_modules	119	TRUE	2.4432152530159794e-21	288	38	21	0.5526315789473685	0.07291666666666667	REAC:R-HSA-71387	REAC	Metabolism of carbohydrates	10916	1422		0.7808219178082192	0.7837837837837838	288	10628	21	17	267	10611	10916	0.1940660103394467
R1	cpdb	0	network_modules	119	TRUE	3.021224261954385e-21	197	38	19	0.5	0.09644670050761421	REAC:R-HSA-9705683	REAC	SARS-CoV-2-host interactions	10916	2128		0.7945205479452054	0.7972972972972973	197	10719	19	19	178	10700	10916	0.21398105495812386
R1	cpdb	0	network_modules	119	TRUE	3.5375663330790065e-21	69	52	15	0.28846153846153844	0.21739130434782608	GO:0006406	GO:BP	mRNA export from nucleus	16175	2167		0.2903225806451613	0.3125	69	16106	15	37	54	16069	16175	0.24764076563699752
R1	cpdb	0	network_modules	119	TRUE	1.7461644731422592e-20	76	52	15	0.28846153846153844	0.19736842105263158	GO:0051028	GO:BP	mRNA transport	16175	13445		0.3225806451612903	0.34375	76	16099	15	37	61	16062	16175	0.2356527145412581
R1	cpdb	0	network_modules	119	TRUE	1.7932615405249624e-20	263	38	20	0.5263157894736842	0.07604562737642585	REAC:R-HSA-913531	REAC	Interferon Signaling	10916	1227		0.8082191780821918	0.8108108108108109	263	10653	20	18	243	10635	10916	0.19358125981169794
R1	cpdb	0	network_modules	119	TRUE	4.0027519867113485e-19	120	52	16	0.3076923076923077	0.13333333333333333	GO:0051170	GO:BP	import into nucleus	16175	13553		0.3548387096774194	0.375	120	16055	16	36	104	16019	16175	0.19872119590919937
R1	cpdb	0	network_modules	119	TRUE	6.12890766964199e-18	292	38	19	0.5	0.06506849315068493	REAC:R-HSA-9694516	REAC	SARS-CoV-2 Infection	10916	2122		0.821917808219178	0.8243243243243243	292	10624	19	19	273	10605	10916	0.17335493766534968
R1	cpdb	0	network_modules	119	TRUE	1.354440057051996e-17	115	52	15	0.28846153846153844	0.13043478260869565	GO:0006606	GO:BP	protein import into nucleus	16175	2323		0.3870967741935484	0.40625	115	16060	15	37	100	16023	16175	0.19017395713201699
R1	cpdb	0	network_modules	119	TRUE	1.0972753279245895e-16	228	38	17	0.4473684210526316	0.07456140350877193	REAC:R-HSA-68882	REAC	Mitotic Anaphase	10916	1479		0.8356164383561644	0.8378378378378378	228	10688	17	21	211	10667	10916	0.17626476287497467
R1	cpdb	0	network_modules	119	TRUE	1.1830699777593387e-16	229	38	17	0.4473684210526316	0.07423580786026202	REAC:R-HSA-2555396	REAC	Mitotic Metaphase and Anaphase	10916	1482		0.8493150684931506	0.8513513513513513	229	10687	17	21	212	10666	10916	0.17584993187515535
R1	cpdb	0	network_modules	119	TRUE	1.404870559517711e-16	15	52	9	0.17307692307692307	0.6	GO:0006999	GO:BP	nuclear pore organization	16175	2614		0.41935483870967744	0.4375	15	16160	9	43	6	16117	16175	0.3211904757579281
R1	cpdb	0	network_modules	119	TRUE	1.1099024240792578e-15	241	52	17	0.3269230769230769	0.07053941908713693	GO:0034504	GO:BP	protein localization to nucleus	16175	8670		0.45161290322580644	0.46875	241	15934	17	35	224	15899	16175	0.14626468057464728
R1	cpdb	0	network_modules	119	TRUE	1.2366249663311397e-15	459	38	20	0.5263157894736842	0.04357298474945534	REAC:R-HSA-9679506	REAC	SARS-CoV Infections	10916	2112		0.863013698630137	0.8648648648648649	459	10457	20	18	439	10439	10916	0.1426120272352959
R1	cpdb	0	network_modules	119	TRUE	1.6558287546521541e-12	524	52	19	0.36538461538461536	0.03625954198473282	GO:0006886	GO:BP	intracellular protein transport	16175	2542		0.4838709677419355	0.5	524	15651	19	33	505	15618	16175	0.10681104347983741
R1	cpdb	0	network_modules	119	TRUE	7.402640506843631e-12	24	52	8	0.15384615384615385	0.3333333333333333	GO:0016973	GO:BP	poly(A)+ mRNA export from nucleus	16175	5260		0.5161290322580645	0.53125	24	16151	8	44	16	16107	16175	0.22479956170294582
R1	cpdb	0	network_modules	119	TRUE	1.9438850761584647e-10	121	52	11	0.21153846153846154	0.09090909090909091	GO:0006997	GO:BP	nucleus organization	16175	2612		0.5483870967741935	0.5625	121	16054	11	41	110	16013	16175	0.13449058428897454
R1	cpdb	0	network_modules	119	TRUE	2.7479068614475287e-10	10	52	6	0.11538461538461539	0.6	GO:0051292	GO:BP	nuclear pore complex assembly	16175	13624		0.5806451612903226	0.59375	10	16165	6	46	4	16119	16175	0.26221036369804734
R1	cpdb	0	network_modules	119	TRUE	6.980064759916843e-10	373	52	15	0.28846153846153844	0.040214477211796246	GO:0072594	GO:BP	establishment of protein localization to organelle	16175	17458		0.6129032258064516	0.625	373	15802	15	37	358	15765	16175	0.10041892556240982
R1	cpdb	0	network_modules	119	TRUE	7.1620123303186176e-9	92	38	9	0.23684210526315788	0.09782608695652174	REAC:R-HSA-141424	REAC	Amplification of signal from the kinetochores	10916	144		0.8767123287671232	0.8918918918918919	92	10824	9	29	83	10795	10916	0.14767804022048195
R1	cpdb	0	network_modules	119	TRUE	7.1620123303186176e-9	92	38	9	0.23684210526315788	0.09782608695652174	REAC:R-HSA-141444	REAC	Amplification  of signal from unattached  kinetochores via a MAD2  inhibitory signal	10916	143		0.8767123287671232	0.8918918918918919	92	10824	9	29	83	10795	10916	0.14767804022048195
R1	cpdb	0	network_modules	119	TRUE	9.500557871658014e-9	7	52	5	0.09615384615384616	0.7142857142857143	GO:0000972	GO:BP	transcription-dependent tethering of RNA polymerase II gene DNA at nuclear periphery	16175	277		0.6451612903225806	0.65625	7	16168	5	47	2	16121	16175	0.26136862420724244
R1	cpdb	0	network_modules	119	TRUE	3.373749520840083e-8	109	38	9	0.23684210526315788	0.08256880733944955	REAC:R-HSA-69618	REAC	Mitotic Spindle Checkpoint	10916	1486		0.9041095890410958	0.9054054054054054	109	10807	9	29	100	10778	10916	0.13485489138251786
R1	cpdb	0	network_modules	119	TRUE	3.473132028215292e-8	19	52	6	0.11538461538461539	0.3157894736842105	GO:0046931	GO:BP	pore complex assembly	16175	12434		0.6774193548387096	0.6875	19	16156	6	46	13	16110	16175	0.18935784517151918
R1	cpdb	0	network_modules	119	TRUE	5.484786811190733e-8	115	38	9	0.23684210526315788	0.0782608695652174	REAC:R-HSA-9648025	REAC	EML4 and NUDC in mitotic spindle formation	10916	817		0.9178082191780822	0.918918918918919	115	10801	9	29	106	10772	10916	0.13100808394263264
R1	cpdb	0	network_modules	119	TRUE	1.0067822086120452e-7	123	38	9	0.23684210526315788	0.07317073170731707	REAC:R-HSA-2500257	REAC	Resolution of Sister Chromatid Cohesion	10916	2079		0.9315068493150684	0.9324324324324325	123	10793	9	29	114	10764	10916	0.12631259563561653
R1	cpdb	0	network_modules	119	TRUE	2.4815830506379165e-7	136	38	9	0.23684210526315788	0.0661764705882353	REAC:R-HSA-5663220	REAC	RHO GTPases Activate Formins	10916	1848		0.9452054794520548	0.9459459459459459	136	10780	9	29	127	10751	10916	0.11956182920058096
R1	cpdb	0	network_modules	119	TRUE	4.3287005522930497e-7	808	52	17	0.3269230769230769	0.02103960396039604	GO:0033365	GO:BP	protein localization to organelle	16175	8175		0.7096774193548387	0.71875	808	15367	17	35	791	15332	16175	0.07220290455044646
R1	cpdb	0	network_modules	119	TRUE	4.352081431414287e-6	188	38	9	0.23684210526315788	0.047872340425531915	REAC:R-HSA-2467813	REAC	Separation of Sister Chromatids	10916	2204		0.958904109589041	0.9594594594594594	188	10728	9	29	179	10699	10916	0.09977316391194782
R1	cpdb	0	network_modules	119	TRUE	7.146962636860416e-6	199	38	9	0.23684210526315788	0.04522613065326633	REAC:R-HSA-68877	REAC	Mitotic Prometaphase	10916	1484		0.9726027397260274	0.972972972972973	199	10717	9	29	190	10688	10916	0.09658098067073244
R1	cpdb	0	network_modules	119	TRUE	1.4634761582194311e-5	48	52	6	0.11538461538461539	0.125	GO:0006611	GO:BP	protein export from nucleus	16175	2326		0.7419354838709677	0.75	48	16127	6	46	42	16081	16175	0.11737021373136881
R1	cpdb	0	network_modules	119	TRUE	1.7485161522547878e-4	289	38	9	0.23684210526315788	0.031141868512110725	REAC:R-HSA-69620	REAC	Cell Cycle Checkpoints	10916	321		0.9863013698630136	0.9864864864864865	289	10627	9	29	280	10598	10916	0.07744699569115054
R1	cpdb	0	network_modules	119	TRUE	2.017304593043858e-4	4	52	3	0.057692307692307696	0.75	GO:0006404	GO:BP	RNA import into nucleus	16175	2165		0.7741935483870968	0.78125	4	16171	3	49	1	16122	16175	0.20748032905648597
R1	cpdb	0	network_modules	119	TRUE	3.8973629644126326e-4	318	38	9	0.23684210526315788	0.02830188679245283	REAC:R-HSA-195258	REAC	RHO GTPase Effectors	10916	1846		1	1	318	10598	9	29	309	10569	10916	0.07299848503890387
R1	cpdb	0	network_modules	119	TRUE	7.012989129779133e-4	96	44	6	0.13636363636363635	0.0625	KEGG:03015	KEGG	mRNA surveillance pathway	8484	210		1	1	96	8388	6	38	90	8350	8484	0.08536276194346776
R1	cpdb	0	network_modules	119	TRUE	0.0015976793338233518	545	52	11	0.21153846153846154	0.02018348623853211	GO:0051276	GO:BP	chromosome organization	16175	13613		0.8064516129032258	0.8125	545	15630	11	41	534	15589	16175	0.055973917946599
R1	cpdb	0	network_modules	119	TRUE	0.0017531377316237673	7	52	3	0.057692307692307696	0.42857142857142855	GO:0006689	GO:BP	ganglioside catabolic process	16175	2397		0.8387096774193549	0.875	7	16168	3	49	4	16119	16175	0.15634850281880738
R1	cpdb	0	network_modules	119	TRUE	0.0017531377316237673	7	52	3	0.057692307692307696	0.42857142857142855	GO:0000055	GO:BP	ribosomal large subunit export from nucleus	16175	22		0.8387096774193549	0.875	7	16168	3	49	4	16119	16175	0.15634850281880738
R1	cpdb	0	network_modules	119	TRUE	0.0027986487279800213	8	52	3	0.057692307692307696	0.375	GO:0000056	GO:BP	ribosomal small subunit export from nucleus	16175	23		0.9032258064516129	0.90625	8	16167	3	49	5	16118	16175	0.14609724225560775
R1	cpdb	0	network_modules	119	TRUE	0.007886705017764947	137	52	6	0.11538461538461539	0.043795620437956206	GO:0031503	GO:BP	protein-containing complex localization	16175	7188		0.9354838709677419	0.9375	137	16038	6	46	131	15992	16175	0.06625601157418738
R1	cpdb	0	network_modules	119	TRUE	0.00818996480226178	11	52	3	0.057692307692307696	0.2727272727272727	GO:0090435	GO:BP	protein localization to nuclear envelope	16175	18286		0.967741935483871	0.96875	11	16164	3	49	8	16115	16175	0.12419966375855541
R1	cpdb	0	network_modules	119	TRUE	0.009112365927696077	80	52	5	0.09615384615384616	0.0625	GO:0046822	GO:BP	regulation of nucleocytoplasmic transport	16175	12379		1	1	80	16095	5	47	75	16048	16175	0.07383549768352127
R1	cpdb	0	network_modules	120	TRUE	1.1261405350197355e-30	42	35	16	0.45714285714285713	0.38095238095238093	GO:0007007	GO:BP	inner mitochondrial membrane organization	16175	2619		0	0.045454545454545456	42	16133	16	19	26	16114	16175	0.4159320825110295
R1	cpdb	0	network_modules	120	TRUE	7.363912515314085e-27	364	35	23	0.6571428571428571	0.06318681318681318	GO:0007005	GO:BP	mitochondrion organization	16175	2617		0.047619047619047616	0.09090909090909091	364	15811	23	12	341	15799	16175	0.19926128993817943
R1	cpdb	0	network_modules	120	TRUE	3.519135255365371e-24	95	35	16	0.45714285714285713	0.16842105263157894	GO:0007006	GO:BP	mitochondrial membrane organization	16175	2618		0.09523809523809523	0.13636363636363635	95	16080	16	19	79	16061	16175	0.2750158951768092
R1	cpdb	0	network_modules	120	TRUE	1.763912129639655e-17	99	35	13	0.37142857142857144	0.13131313131313133	GO:0006626	GO:BP	protein targeting to mitochondrion	16175	2340		0.14285714285714285	0.18181818181818182	99	16076	13	22	86	16054	16175	0.21811179464625283
R1	cpdb	0	network_modules	120	TRUE	6.086360442358718e-17	32	35	10	0.2857142857142857	0.3125	GO:0090151	GO:BP	establishment of protein localization to mitochondrial membrane	16175	18060		0.19047619047619047	0.22727272727272727	32	16143	10	25	22	16118	16175	0.29735398250837974
R1	cpdb	0	network_modules	120	TRUE	7.455545397709486e-17	110	35	13	0.37142857142857144	0.11818181818181818	GO:0072655	GO:BP	establishment of protein localization to mitochondrion	16175	17476		0.23809523809523808	0.2727272727272727	110	16065	13	22	97	16043	16175	0.2066045103863851
R1	cpdb	0	network_modules	120	TRUE	1.1576153369175046e-16	156	35	14	0.4	0.08974358974358974	GO:0006839	GO:BP	mitochondrial transport	16175	2508		0.2857142857142857	0.3181818181818182	156	16019	14	21	142	15998	16175	0.18599738341580727
R1	cpdb	0	network_modules	120	TRUE	1.7251513631577747e-16	117	35	13	0.37142857142857144	0.1111111111111111	GO:0070585	GO:BP	protein localization to mitochondrion	16175	16190		0.3333333333333333	0.36363636363636365	117	16058	13	22	104	16036	16175	0.20013455977686223
R1	cpdb	0	network_modules	120	TRUE	2.016482067053268e-16	65	25	11	0.44	0.16923076923076924	REAC:R-HSA-1268020	REAC	Mitochondrial protein import	10916	1468		0	0.2	65	10851	11	14	54	10837	10916	0.2702982837090866
R1	cpdb	0	network_modules	120	TRUE	3.557321008216611e-13	13	35	7	0.2	0.5384615384615384	GO:0045039	GO:BP	protein insertion into mitochondrial inner membrane	16175	11242		0.38095238095238093	0.4090909090909091	13	16162	7	28	6	16134	16175	0.3273320766173088
R1	cpdb	0	network_modules	120	TRUE	3.647107148023979e-13	275	35	14	0.4	0.05090909090909091	GO:0006605	GO:BP	protein targeting	16175	2322		0.42857142857142855	0.45454545454545453	275	15900	14	21	261	15879	16175	0.13796173856521976
R1	cpdb	0	network_modules	120	TRUE	5.423026292729313e-12	158	25	11	0.44	0.06962025316455696	REAC:R-HSA-9609507	REAC	Protein localization	10916	1815		0.25	0.4	158	10758	11	14	147	10744	10916	0.17069911522474443
R1	cpdb	0	network_modules	120	TRUE	1.175420885116072e-10	31	25	7	0.28	0.22580645161290322	REAC:R-HSA-8949613	REAC	Cristae formation	10916	414		0.5	0.6	31	10885	7	18	24	10867	10916	0.24953722896889552
R1	cpdb	0	network_modules	120	TRUE	1.619552270441505e-10	657	35	16	0.45714285714285713	0.0243531202435312	GO:0061024	GO:BP	membrane organization	16175	15141		0.47619047619047616	0.5	657	15518	16	19	641	15499	16175	0.09825771576521
R1	cpdb	0	network_modules	120	TRUE	7.061579670638688e-10	373	35	13	0.37142857142857144	0.03485254691689008	GO:0072594	GO:BP	establishment of protein localization to organelle	16175	17458		0.5238095238095238	0.5454545454545454	373	15802	13	22	360	15780	16175	0.10808233596872309
R1	cpdb	0	network_modules	120	TRUE	1.419294397346344e-9	17	35	6	0.17142857142857143	0.35294117647058826	GO:0042407	GO:BP	cristae formation	16175	10152		0.5714285714285714	0.5909090909090909	17	16158	6	29	11	16129	16175	0.2448616070101275
R1	cpdb	0	network_modules	120	TRUE	9.746761155071283e-8	239	35	10	0.2857142857142857	0.04184100418410042	GO:0090150	GO:BP	establishment of protein localization to membrane	16175	18059		0.6190476190476191	0.6363636363636364	239	15936	10	25	229	15911	16175	0.10457033330682639
R1	cpdb	0	network_modules	120	TRUE	3.584617267559533e-7	92	25	7	0.28	0.07608695652173914	REAC:R-HSA-1592230	REAC	Mitochondrial biogenesis	10916	1464		0.75	0.8	92	10824	7	18	85	10806	10916	0.1423301295161516
R1	cpdb	0	network_modules	120	TRUE	1.0389171244925809e-5	808	35	13	0.37142857142857144	0.01608910891089109	GO:0033365	GO:BP	protein localization to organelle	16175	8175		0.6666666666666666	0.6818181818181818	808	15367	13	22	795	15345	16175	0.06871846395442073
R1	cpdb	0	network_modules	120	TRUE	1.2837639863314142e-4	504	35	10	0.2857142857142857	0.01984126984126984	GO:0072657	GO:BP	protein localization to membrane	16175	17478		0.7142857142857143	0.7272727272727273	504	15671	10	25	494	15646	16175	0.06822518269084175
R1	cpdb	0	network_modules	120	TRUE	1.8471131793262446e-4	524	35	10	0.2857142857142857	0.019083969465648856	GO:0006886	GO:BP	intracellular protein transport	16175	2542		0.7619047619047619	0.7727272727272727	524	15651	10	25	514	15626	16175	0.06662802794566028
R1	cpdb	0	network_modules	120	TRUE	5.911020071415443e-4	594	35	10	0.2857142857142857	0.016835016835016835	GO:0051668	GO:BP	localization within membrane	16175	13880		0.8095238095238095	0.8181818181818182	594	15581	10	25	584	15556	16175	0.06164803204597434
R1	cpdb	0	network_modules	120	TRUE	0.0010205853675671148	292	25	7	0.28	0.023972602739726026	REAC:R-HSA-1852241	REAC	Organelle biogenesis and maintenance	10916	1646		1	1	292	10624	7	18	285	10606	10916	0.07519935592234374
R1	cpdb	0	network_modules	120	TRUE	0.00107733561427611	103	14	4	0.2857142857142857	0.038834951456310676	KEGG:04137	KEGG	Mitophagy - animal	8484	274		NA	1	103	8381	4	10	99	8371	8484	0.10156192419840361
R1	cpdb	0	network_modules	120	TRUE	0.0035138527371913015	97	35	5	0.14285714285714285	0.05154639175257732	GO:0033108	GO:BP	mitochondrial respiratory chain complex assembly	16175	8042		0.8571428571428571	0.8636363636363636	97	16078	5	30	92	16048	16175	0.08254712374267895
R1	cpdb	0	network_modules	120	TRUE	0.0035978203121118284	12	35	3	0.08571428571428572	0.25	GO:0034982	GO:BP	mitochondrial protein processing	16175	8747		0.9047619047619048	0.9090909090909091	12	16163	3	32	9	16131	16175	0.14532917967024894
R1	cpdb	0	network_modules	120	TRUE	0.007407884034981109	15	35	3	0.08571428571428572	0.2	GO:0007008	GO:BP	outer mitochondrial membrane organization	16175	2620		0.9523809523809523	1	15	16160	3	32	12	16128	16175	0.12971468407795753
R1	cpdb	0	network_modules	120	TRUE	0.007407884034981109	15	35	3	0.08571428571428572	0.2	GO:0045040	GO:BP	protein insertion into mitochondrial outer membrane	16175	11243		0.9523809523809523	1	15	16160	3	32	12	16128	16175	0.12971468407795753
R1	cpdb	0	network_modules	121	TRUE	1.858183617883645e-4	84	10	4	0.4	0.047619047619047616	REAC:R-HSA-425366	REAC	Transport of bile salts and organic acids, metal ions and amine compounds	10916	2590		NA	1	84	10832	4	6	80	10826	10916	0.13594414730707308
R1	cpdb	0	network_modules	122	TRUE	5.326341319150107e-32	43	30	16	0.5333333333333333	0.37209302325581395	GO:0031146	GO:BP	SCF-dependent proteasomal ubiquitin-dependent protein catabolic process	16175	7064		0	0.08333333333333333	43	16132	16	14	27	16118	16175	0.4442588748531381
R1	cpdb	0	network_modules	122	TRUE	7.677762515326772e-28	244	27	21	0.7777777777777778	0.0860655737704918	REAC:R-HSA-8951664	REAC	Neddylation	10916	1559		0	0.07692307692307693	244	10672	21	6	223	10666	10916	0.25446326534564345
R1	cpdb	0	network_modules	122	TRUE	1.1925327326145265e-25	308	27	21	0.7777777777777778	0.06818181818181818	REAC:R-HSA-983168	REAC	Antigen processing: Ubiquitination & Proteasome degradation	10916	154		0.08333333333333333	0.15384615384615385	308	10608	21	6	287	10602	10916	0.22540681361066453
R1	cpdb	0	network_modules	122	TRUE	1.0812148055534883e-23	380	27	21	0.7777777777777778	0.05526315789473684	REAC:R-HSA-983169	REAC	Class I MHC mediated antigen processing & presentation	10916	368		0.16666666666666666	0.23076923076923078	380	10536	21	6	359	10530	10916	0.2018324342006047
R1	cpdb	0	network_modules	122	TRUE	8.779957722519589e-20	547	30	20	0.6666666666666666	0.03656307129798903	GO:0006511	GO:BP	ubiquitin-dependent protein catabolic process	16175	2235		0.09090909090909091	0.16666666666666666	547	15628	20	10	527	15618	16175	0.15091786681760125
R1	cpdb	0	network_modules	122	TRUE	1.1741380758648495e-19	555	30	20	0.6666666666666666	0.036036036036036036	GO:0019941	GO:BP	modification-dependent protein catabolic process	16175	6072		0.18181818181818182	0.25	555	15620	20	10	535	15610	16175	0.14974746158028807
R1	cpdb	0	network_modules	122	TRUE	1.3555885889546986e-19	559	30	20	0.6666666666666666	0.03577817531305903	GO:0043632	GO:BP	modification-dependent macromolecule catabolic process	16175	10812		0.2727272727272727	0.3333333333333333	559	15616	20	10	539	15606	16175	0.14917147996148855
R1	cpdb	0	network_modules	122	TRUE	5.4891854043273024e-18	673	30	20	0.6666666666666666	0.029717682020802376	GO:0051603	GO:BP	proteolysis involved in protein catabolic process	16175	13820		0.36363636363636365	0.4166666666666667	673	15502	20	10	653	15492	16175	0.13492911710979993
R1	cpdb	0	network_modules	122	TRUE	8.648367307965634e-18	363	30	17	0.5666666666666667	0.046831955922865015	GO:0043161	GO:BP	proteasome-mediated ubiquitin-dependent protein catabolic process	16175	10561		0.45454545454545453	0.5	363	15812	17	13	346	15799	16175	0.158386209953865
R1	cpdb	0	network_modules	122	TRUE	7.016483361585791e-16	470	30	17	0.5666666666666667	0.036170212765957444	GO:0010498	GO:BP	proteasomal protein catabolic process	16175	4177		0.5454545454545454	0.5833333333333334	470	15705	17	13	453	15692	16175	0.13797007828088972
R1	cpdb	0	network_modules	122	TRUE	3.2378752377822527e-14	590	30	17	0.5666666666666667	0.0288135593220339	GO:0016567	GO:BP	protein ubiquitination	16175	5254		0.6363636363636364	0.6666666666666666	590	15585	17	13	573	15572	16175	0.12190977387319184
R1	cpdb	0	network_modules	122	TRUE	2.5197400458966643e-13	667	30	17	0.5666666666666667	0.025487256371814093	GO:0032446	GO:BP	protein modification by small protein conjugation	16175	7568		0.7272727272727273	0.75	667	15508	17	13	650	15495	16175	0.11390954106984995
R1	cpdb	0	network_modules	122	TRUE	1.734177171442146e-12	749	30	17	0.5666666666666667	0.022696929238985315	GO:0070647	GO:BP	protein modification by small protein conjugation or removal	16175	16231		0.8181818181818182	0.8333333333333334	749	15426	17	13	732	15413	16175	0.10673890860244184
R1	cpdb	0	network_modules	122	TRUE	4.9541675877369625e-12	798	30	17	0.5666666666666667	0.021303258145363407	GO:0043687	GO:BP	post-translational protein modification	16175	10838		0.9090909090909091	0.9166666666666666	798	15377	17	13	781	15364	16175	0.10297157875095311
R1	cpdb	0	network_modules	122	TRUE	5.243329593556845e-9	140	11	7	0.6363636363636364	0.05	KEGG:04120	KEGG	Ubiquitin mediated proteolysis	8484	270		0	0.3333333333333333	140	8344	7	4	133	8340	8484	0.17531627609249034
R1	cpdb	0	network_modules	122	TRUE	4.072110200403239e-6	34	11	4	0.36363636363636365	0.11764705882352941	KEGG:04710	KEGG	Circadian rhythm	8484	345		0.5	0.6666666666666666	34	8450	4	7	30	8443	8484	0.20509972321420933
R1	cpdb	0	network_modules	122	TRUE	9.520997836620799e-6	38	27	5	0.18518518518518517	0.13157894736842105	REAC:R-HSA-390471	REAC	Association of TriC/CCT with target proteins during biosynthesis	10916	182		0.25	0.3076923076923077	38	10878	5	22	33	10856	10916	0.15362068868204556
R1	cpdb	0	network_modules	122	TRUE	1.7274058299641273e-05	4	27	3	0.1111111111111111	0.75	REAC:R-HSA-2644607	REAC	Loss of Function of FBXW7 in Cancer and NOTCH1 Signaling	10916	1322		0.3333333333333333	0.46153846153846156	4	10912	3	24	1	10888	10916	0.2881323987221719
R1	cpdb	0	network_modules	122	TRUE	1.7274058299641273e-05	4	27	3	0.1111111111111111	0.75	REAC:R-HSA-2644605	REAC	FBXW7 Mutants and NOTCH1 in Cancer	10916	893		0.3333333333333333	0.46153846153846156	4	10912	3	24	1	10888	10916	0.2881323987221719
R1	cpdb	0	network_modules	122	TRUE	7.048245607977884e-5	168	11	5	0.45454545454545453	0.02976190476190476	KEGG:04141	KEGG	Protein processing in endoplasmic reticulum	8484	278		1	1	168	8316	5	6	163	8310	8484	0.11243449920440748
R1	cpdb	0	network_modules	122	TRUE	4.055400181396125e-4	248	30	7	0.23333333333333334	0.028225806451612902	GO:0000209	GO:BP	protein polyubiquitination	16175	59		1	1	248	15927	7	23	241	15904	16175	0.0764806566234466
R1	cpdb	0	network_modules	122	TRUE	7.043696472508006e-4	11	27	3	0.1111111111111111	0.2727272727272727	REAC:R-HSA-9708530	REAC	Regulation of BACH1 activity	10916	1965		0.5	0.5384615384615384	11	10905	3	24	8	10881	10916	0.17279971661140084
R1	cpdb	0	network_modules	122	TRUE	8.067658026020933e-4	91	27	5	0.18518518518518517	0.054945054945054944	REAC:R-HSA-390466	REAC	Chaperonin-mediated protein folding	10916	345		0.5833333333333334	0.6153846153846154	91	10825	5	22	86	10803	10916	0.09685429280873444
R1	cpdb	0	network_modules	122	TRUE	0.0011643039511883065	98	27	5	0.18518518518518517	0.05102040816326531	REAC:R-HSA-391251	REAC	Protein folding	10916	1812		0.6666666666666666	0.6923076923076923	98	10818	5	22	93	10796	10916	0.09302279111616181
R1	cpdb	0	network_modules	122	TRUE	0.0015462084071894166	14	27	3	0.1111111111111111	0.21428571428571427	REAC:R-HSA-1170546	REAC	Prolactin receptor signaling	10916	1805		0.75	0.7692307692307693	14	10902	3	24	11	10878	10916	0.1528092737707221
R1	cpdb	0	network_modules	122	TRUE	0.002976859218780343	55	27	4	0.14814814814814814	0.07272727272727272	REAC:R-HSA-8854050	REAC	FBXL7 down-regulates AURKA during mitotic entry and in early mitosis	10916	892		0.8333333333333334	0.8461538461538461	55	10861	4	23	51	10838	10916	0.10064776758744376
R1	cpdb	0	network_modules	122	TRUE	0.003443423667529107	18	27	3	0.1111111111111111	0.16666666666666666	REAC:R-HSA-9725371	REAC	Nuclear events stimulated by ALK signaling in cancer	10916	1618		0.9166666666666666	0.9230769230769231	18	10898	3	24	15	10874	10916	0.13434012607631576
R1	cpdb	0	network_modules	122	TRUE	0.008254805281876273	71	27	4	0.14814814814814814	0.056338028169014086	REAC:R-HSA-8939902	REAC	Regulation of RUNX2 expression and activity	10916	2005		1	1	71	10845	4	23	67	10822	10916	0.08774157752037783
R1	cpdb	0	network_modules	123	TRUE	1.90044945736073e-4	140	15	5	0.3333333333333333	0.03571428571428571	KEGG:04120	KEGG	Ubiquitin mediated proteolysis	8484	270		NA	1	140	8344	5	10	135	8334	8484	0.10466649039039516
R1	cpdb	0	network_modules	124	TRUE	1.8376613270633843e-11	5	28	5	0.17857142857142858	1	GO:0006102	GO:BP	isocitrate metabolic process	16175	1961		0	0.045454545454545456	5	16170	5	23	0	16147	16175	0.4222764862841065
R1	cpdb	0	network_modules	124	TRUE	4.4489006658592196e-11	13	28	6	0.21428571428571427	0.46153846153846156	GO:0072350	GO:BP	tricarboxylic acid metabolic process	16175	17366		0.047619047619047616	0.09090909090909091	13	16162	6	22	7	16140	16175	0.31370354590504035
R1	cpdb	0	network_modules	124	TRUE	2.6988370024121827e-10	742	28	15	0.5357142857142857	0.02021563342318059	GO:0019752	GO:BP	carboxylic acid metabolic process	16175	6036		0.09523809523809523	0.13636363636363635	742	15433	15	13	727	15420	16175	0.0975001775147619
R1	cpdb	0	network_modules	124	TRUE	3.899004358402867e-10	761	28	15	0.5357142857142857	0.01971090670170828	GO:0043436	GO:BP	oxoacid metabolic process	16175	10693		0.14285714285714285	0.18181818181818182	761	15414	15	13	746	15401	16175	0.09610363853638873
R1	cpdb	0	network_modules	124	TRUE	4.3705751227455055e-10	767	28	15	0.5357142857142857	0.01955671447196871	GO:0006082	GO:BP	organic acid metabolic process	16175	1947		0.19047619047619047	0.22727272727272727	767	15408	15	13	752	15395	16175	0.09567296309211716
R1	cpdb	0	network_modules	124	TRUE	3.866761039654668e-9	30	21	6	0.2857142857142857	0.2	KEGG:00020	KEGG	Citrate cycle (TCA cycle)	8484	3		0	0.2	30	8454	6	15	24	8439	8484	0.23679900537635745
R1	cpdb	0	network_modules	124	TRUE	7.179842650784915e-9	33	21	6	0.2857142857142857	0.18181818181818182	KEGG:01210	KEGG	2-Oxocarboxylic acid metabolism	8484	185		0.25	0.4	33	8451	6	15	27	8436	8484	0.22553608232697775
R1	cpdb	0	network_modules	124	TRUE	1.0080650574108159e-8	115	21	8	0.38095238095238093	0.06956521739130435	KEGG:01200	KEGG	Carbon metabolism	8484	184		0.5	0.6	115	8369	8	13	107	8356	8484	0.15826999006584805
R1	cpdb	0	network_modules	124	TRUE	1.9513406045247303e-8	74	21	7	0.3333333333333333	0.0945945945945946	KEGG:01230	KEGG	Biosynthesis of amino acids	8484	188		0.75	0.8	74	8410	7	14	67	8396	8484	0.17389918838478313
R1	cpdb	0	network_modules	124	TRUE	2.611791181231591e-7	22	24	5	0.20833333333333334	0.22727272727272727	REAC:R-HSA-71403	REAC	Citric acid cycle (TCA cycle)	10916	364		0	0.25	22	10894	5	19	17	10875	10916	0.2159470646141136
R1	cpdb	0	network_modules	124	TRUE	1.0121374218581384e-5	158	24	7	0.2916666666666667	0.04430379746835443	REAC:R-HSA-9609507	REAC	Protein localization	10916	1815		0.3333333333333333	0.5	158	10758	7	17	151	10741	10916	0.10894379357408243
R1	cpdb	0	network_modules	124	TRUE	2.2153780444081187e-5	177	24	7	0.2916666666666667	0.03954802259887006	REAC:R-HSA-1428517	REAC	Aerobic respiration and respiratory electron transport	10916	127		0.6666666666666666	0.75	177	10739	7	17	170	10722	10916	0.10237469155429238
R1	cpdb	0	network_modules	124	TRUE	3.33689161497643e-5	103	28	6	0.21428571428571427	0.05825242718446602	GO:1902652	GO:BP	secondary alcohol metabolic process	16175	22418		0.23809523809523808	0.2727272727272727	103	16072	6	22	97	16050	16175	0.10884678610320614
R1	cpdb	0	network_modules	124	TRUE	7.695535025104175e-5	65	24	5	0.20833333333333334	0.07692307692307693	REAC:R-HSA-1268020	REAC	Mitochondrial protein import	10916	1468		1	1	65	10851	5	19	60	10832	10916	0.1234777553839799
R1	cpdb	0	network_modules	124	TRUE	1.8033549197754415e-4	26	28	4	0.14285714285714285	0.15384615384615385	GO:0006099	GO:BP	tricarboxylic acid cycle	16175	1959		0.2857142857142857	0.3181818181818182	26	16149	4	24	22	16125	16175	0.1468268558842262
R1	cpdb	0	network_modules	124	TRUE	1.9246580216193847e-4	138	28	6	0.21428571428571427	0.043478260869565216	GO:0170039	GO:BP	proteinogenic amino acid metabolic process	16175	20287		0.3333333333333333	0.36363636363636365	138	16037	6	22	132	16015	16175	0.09315895837479354
R1	cpdb	0	network_modules	124	TRUE	2.478682275926538e-4	144	28	6	0.21428571428571427	0.041666666666666664	GO:0170033	GO:BP	L-amino acid metabolic process	16175	20281		0.38095238095238093	0.4090909090909091	144	16031	6	22	138	16009	16175	0.09105011653876524
R1	cpdb	0	network_modules	124	TRUE	2.601640148629957e-4	372	28	8	0.2857142857142857	0.021505376344086023	GO:0006091	GO:BP	generation of precursor metabolites and energy	16175	1954		0.42857142857142855	0.45454545454545453	372	15803	8	20	364	15783	16175	0.07298311349368637
R1	cpdb	0	network_modules	124	TRUE	3.164847109772374e-4	252	28	7	0.25	0.027777777777777776	GO:0015980	GO:BP	energy derivation by oxidation of organic compounds	16175	5060		0.47619047619047616	0.5	252	15923	7	21	245	15902	16175	0.07882429053447532
R1	cpdb	0	network_modules	124	TRUE	8.389193465031912e-4	177	28	6	0.21428571428571427	0.03389830508474576	GO:1901605	GO:BP	alpha-amino acid metabolic process	16175	21589		0.5238095238095238	0.5454545454545454	177	15998	6	22	171	15976	16175	0.0813929742618428
R1	cpdb	0	network_modules	124	TRUE	0.0010288307510312998	300	28	7	0.25	0.023333333333333334	GO:0044282	GO:BP	small molecule catabolic process	16175	10949		0.5714285714285714	0.5909090909090909	300	15875	7	21	293	15854	16175	0.07143687340508395
R1	cpdb	0	network_modules	124	TRUE	0.0011951490745018732	188	28	6	0.21428571428571427	0.031914893617021274	GO:0045333	GO:BP	cellular respiration	16175	11360		0.6190476190476191	0.6363636363636364	188	15987	6	22	182	15965	16175	0.07873885470137071
R1	cpdb	0	network_modules	124	TRUE	0.0014722999959065426	70	21	4	0.19047619047619047	0.05714285714285714	KEGG:05230	KEGG	Central carbon metabolism in cancer	8484	478		1	1	70	8414	4	17	66	8397	8484	0.10034753130134175
R1	cpdb	0	network_modules	124	TRUE	0.002345827858828071	211	28	6	0.21428571428571427	0.02843601895734597	GO:0016054	GO:BP	organic acid catabolic process	16175	5086		0.6666666666666666	0.7272727272727273	211	15964	6	22	205	15942	16175	0.07385527658583067
R1	cpdb	0	network_modules	124	TRUE	0.002345827858828071	211	28	6	0.21428571428571427	0.02843601895734597	GO:0046395	GO:BP	carboxylic acid catabolic process	16175	12121		0.6666666666666666	0.7272727272727273	211	15964	6	22	205	15942	16175	0.07385527658583067
R1	cpdb	0	network_modules	124	TRUE	0.003420713939653007	53	28	4	0.14285714285714285	0.07547169811320754	GO:0009064	GO:BP	glutamine family amino acid metabolic process	16175	3240		0.7619047619047619	0.7727272727272727	53	16122	4	24	49	16098	16175	0.10170789846625296
R1	cpdb	0	network_modules	124	TRUE	0.005278910802311564	59	28	4	0.14285714285714285	0.06779661016949153	GO:0170040	GO:BP	proteinogenic amino acid catabolic process	16175	20288		0.8095238095238095	0.8636363636363636	59	16116	4	24	55	16092	16175	0.09615939915494791
R1	cpdb	0	network_modules	124	TRUE	0.005278910802311564	59	28	4	0.14285714285714285	0.06779661016949153	GO:0170035	GO:BP	L-amino acid catabolic process	16175	20283		0.8095238095238095	0.8636363636363636	59	16116	4	24	55	16092	16175	0.09615939915494791
R1	cpdb	0	network_modules	124	TRUE	0.0058478243961572664	247	28	6	0.21428571428571427	0.024291497975708502	GO:0006520	GO:BP	amino acid metabolic process	16175	2241		0.9047619047619048	0.9090909090909091	247	15928	6	22	241	15906	16175	0.06758255497012358
R1	cpdb	0	network_modules	124	TRUE	0.00735103991612486	257	28	6	0.21428571428571427	0.023346303501945526	GO:0006066	GO:BP	alcohol metabolic process	16175	1933		0.9523809523809523	0.9545454545454546	257	15918	6	22	251	15896	16175	0.0660695981069518
R1	cpdb	0	network_modules	124	TRUE	0.00997116268499239	271	28	6	0.21428571428571427	0.02214022140221402	GO:0044248	GO:BP	cellular catabolic process	16175	10939		1	1	271	15904	6	22	265	15882	16175	0.06408786969321958
R1	cpdb	0	network_modules	125	TRUE	4.454963153081291e-6	58	17	5	0.29411764705882354	0.08620689655172414	KEGG:04923	KEGG	Regulation of lipolysis in adipocytes	8484	380		0	0.5	58	8426	5	12	53	8414	8484	0.15622225305449972
R1	cpdb	0	network_modules	125	TRUE	1.9023924476521164e-5	15	30	4	0.13333333333333333	0.26666666666666666	GO:0010889	GO:BP	regulation of sequestering of triglyceride	16175	4475		0	0.09090909090909091	15	16160	4	26	11	16134	16175	0.18751118232966826
R1	cpdb	0	network_modules	125	TRUE	3.319769920387954e-5	24	21	4	0.19047619047619047	0.16666666666666666	REAC:R-HSA-163560	REAC	Triglyceride catabolism	10916	2606		0	0.3333333333333333	24	10892	4	17	20	10875	10916	0.1764813162328351
R1	cpdb	0	network_modules	125	TRUE	4.248269087746436e-5	18	30	4	0.13333333333333333	0.2222222222222222	GO:0030730	GO:BP	sequestering of triglyceride	16175	6909		0.1	0.18181818181818182	18	16157	4	26	14	16131	16175	0.17094959970795912
R1	cpdb	0	network_modules	125	TRUE	8.277093995792985e-5	21	30	4	0.13333333333333333	0.19047619047619047	GO:0019433	GO:BP	triglyceride catabolic process	16175	5785		0.2	0.2727272727272727	21	16154	4	26	17	16128	16175	0.15806124023028648
R1	cpdb	0	network_modules	125	TRUE	8.89896977296047e-5	57	30	5	0.16666666666666666	0.08771929824561403	GO:0046503	GO:BP	glycerolipid catabolic process	16175	12206		0.3	0.36363636363636365	57	16118	5	25	52	16093	16175	0.11867536073617689
R1	cpdb	0	network_modules	125	TRUE	2.2661850394451165e-4	38	21	4	0.19047619047619047	0.10526315789473684	REAC:R-HSA-8979227	REAC	Triglyceride metabolism	10916	2607		0.5	0.6666666666666666	38	10878	4	17	34	10861	10916	0.1393873525534739
R1	cpdb	0	network_modules	125	TRUE	4.903261386660199e-4	32	30	4	0.13333333333333333	0.125	GO:0046461	GO:BP	neutral lipid catabolic process	16175	12169		0.4	0.5454545454545454	32	16143	4	26	28	16117	16175	0.12742812549598093
R1	cpdb	0	network_modules	125	TRUE	4.903261386660199e-4	32	30	4	0.13333333333333333	0.125	GO:0046464	GO:BP	acylglycerol catabolic process	16175	12172		0.4	0.5454545454545454	32	16143	4	26	28	16117	16175	0.12742812549598093
R1	cpdb	0	network_modules	125	TRUE	5.572397053243059e-4	33	30	4	0.13333333333333333	0.12121212121212122	GO:0034389	GO:BP	lipid droplet organization	16175	8610		0.6	0.6363636363636364	33	16142	4	26	29	16116	16175	0.1254273687512172
R1	cpdb	0	network_modules	125	TRUE	7.521013776309124e-4	75	17	4	0.23529411764705882	0.05333333333333334	KEGG:03320	KEGG	PPAR signaling pathway	8484	236		1	1	75	8409	4	13	71	8396	8484	0.10840203349380914
R1	cpdb	0	network_modules	125	TRUE	0.001383080098492013	11	30	3	0.1	0.2727272727272727	GO:0010896	GO:BP	regulation of triglyceride catabolic process	16175	4482		0.7	0.7272727272727273	11	16164	3	27	8	16137	16175	0.16422965067086123
R1	cpdb	0	network_modules	125	TRUE	0.0021853483535831763	46	30	4	0.13333333333333333	0.08695652173913043	GO:0010883	GO:BP	regulation of lipid storage	16175	4469		0.8	0.8181818181818182	46	16129	4	26	42	16103	16175	0.10562789312625832
R1	cpdb	0	network_modules	125	TRUE	0.005130429574547129	128	30	5	0.16666666666666666	0.0390625	GO:1905952	GO:BP	regulation of lipid localization	16175	25042		0.9	0.9090909090909091	128	16047	5	25	123	16022	16175	0.07723364359887268
R1	cpdb	0	network_modules	125	TRUE	0.006677556473919444	4	21	2	0.09523809523809523	0.5	REAC:R-HSA-427975	REAC	Proton/oligopeptide cotransporters	10916	1822		1	1	4	10912	2	19	2	10893	10916	0.21762755623977673
R1	cpdb	0	network_modules	125	TRUE	0.008041474614635868	19	30	3	0.1	0.15789473684210525	GO:0090208	GO:BP	positive regulation of triglyceride metabolic process	16175	18108		1	1	19	16156	3	27	16	16129	16175	0.12436853556759232
R1	cpdb	0	network_modules	126	TRUE	8.961169644460634e-6	91	6	4	0.6666666666666666	0.04395604395604396	KEGG:04970	KEGG	Salivary secretion	8484	401		NA	1	91	8393	4	2	87	8391	8484	0.1694005359539422
R1	cpdb	0	network_modules	127	TRUE	5.221737645303926e-10	774	20	13	0.65	0.016795865633074936	GO:0007186	GO:BP	G protein-coupled receptor signaling pathway	16175	2744		0	0.125	774	15401	13	7	761	15394	16175	0.09925774066487697
R1	cpdb	0	network_modules	127	TRUE	1.0559007063206235e-8	156	17	8	0.47058823529411764	0.05128205128205128	REAC:R-HSA-418555	REAC	G alpha (s) signalling events	10916	989		0	0.25	156	10760	8	9	148	10751	10916	0.15183577566385148
R1	cpdb	0	network_modules	127	TRUE	1.4877693457674702e-7	217	20	8	0.4	0.03686635944700461	GO:0007188	GO:BP	adenylate cyclase-modulating G protein-coupled receptor signaling pathway	16175	2746		0.14285714285714285	0.25	217	15958	8	12	209	15946	16175	0.11823085984472517
R1	cpdb	0	network_modules	127	TRUE	3.6973984606294434e-7	33	17	5	0.29411764705882354	0.15151515151515152	REAC:R-HSA-420092	REAC	Glucagon-type ligand receptors	10916	1050		0.3333333333333333	0.5	33	10883	5	12	28	10871	10916	0.2094100250565274
R1	cpdb	0	network_modules	127	TRUE	4.3141314851498953e-7	223	18	8	0.4444444444444444	0.03587443946188341	KEGG:04024	KEGG	cAMP signaling pathway	8484	252		0	0.25	223	8261	8	10	215	8251	8484	0.12052334742793762
R1	cpdb	0	network_modules	127	TRUE	2.3255631674414424e-6	460	17	9	0.5294117647058824	0.01956521739130435	REAC:R-HSA-500792	REAC	GPCR ligand binding	10916	1019		0.6666666666666666	0.75	460	10456	9	8	451	10448	10916	0.09578648232929451
R1	cpdb	0	network_modules	127	TRUE	2.0041966590808417e-5	365	18	8	0.4444444444444444	0.021917808219178082	KEGG:04080	KEGG	Neuroactive ligand-receptor interaction	8484	263		0.3333333333333333	0.5	365	8119	8	10	357	8109	8484	0.09122241305697736
R1	cpdb	0	network_modules	127	TRUE	3.671588814620674e-5	26	20	4	0.2	0.15384615384615385	GO:0071875	GO:BP	adrenergic receptor signaling pathway	16175	16957		0.2857142857142857	0.375	26	16149	4	16	22	16133	16175	0.17424958101181034
R1	cpdb	0	network_modules	127	TRUE	7.661808635240205e-5	93	17	5	0.29411764705882354	0.053763440860215055	REAC:R-HSA-373080	REAC	Class B/2 (Secretin family receptors)	10916	366		1	1	93	10823	5	12	88	10811	10916	0.12272543632162816
R1	cpdb	0	network_modules	127	TRUE	1.987554200039531e-4	9	20	3	0.15	0.3333333333333333	GO:0071872	GO:BP	cellular response to epinephrine stimulus	16175	16954		0.42857142857142855	0.625	9	16166	3	17	6	16149	16175	0.22297724417132353
R1	cpdb	0	network_modules	127	TRUE	1.987554200039531e-4	9	20	3	0.15	0.3333333333333333	GO:0071871	GO:BP	response to epinephrine	16175	16953		0.42857142857142855	0.625	9	16166	3	17	6	16149	16175	0.22297724417132353
R1	cpdb	0	network_modules	127	TRUE	9.286017129837061e-4	140	20	5	0.25	0.03571428571428571	GO:0007189	GO:BP	adenylate cyclase-activating G protein-coupled receptor signaling pathway	16175	2747		0.7142857142857143	0.75	140	16035	5	15	135	16020	16175	0.09167375358613881
R1	cpdb	0	network_modules	127	TRUE	0.0019033593266696196	89	18	4	0.2222222222222222	0.0449438202247191	KEGG:05032	KEGG	Morphine addiction	8484	420		0.6666666666666666	0.75	89	8395	4	14	85	8381	8484	0.09582497084684488
R1	cpdb	0	network_modules	127	TRUE	0.002136057581726714	2	20	2	0.1	1	GO:1901898	GO:BP	negative regulation of relaxation of cardiac muscle	16175	21842		0.8571428571428571	0.875	2	16173	2	18	0	16155	16175	0.316051741641375
R1	cpdb	0	network_modules	127	TRUE	0.0031173179234363978	21	20	3	0.15	0.14285714285714285	GO:0071880	GO:BP	adenylate cyclase-activating adrenergic receptor signaling pathway	16175	16961		1	1	21	16154	3	17	18	16137	16175	0.14530215429655982
R1	cpdb	0	network_modules	127	TRUE	0.003648136685485305	105	18	4	0.2222222222222222	0.0380952380952381	KEGG:04928	KEGG	Parathyroid hormone synthesis, secretion and action	8484	385		1	1	105	8379	4	14	101	8365	8484	0.08752007859320267
R1	cpdb	0	network_modules	128	TRUE	1.756122765111366e-10	774	19	13	0.6842105263157895	0.016795865633074936	GO:0007186	GO:BP	G protein-coupled receptor signaling pathway	16175	2744		0	0.2	774	15401	13	6	761	15395	16175	0.10223776610789599
R1	cpdb	0	network_modules	128	TRUE	1.322524468796804e-4	365	16	7	0.4375	0.019178082191780823	KEGG:04080	KEGG	Neuroactive ligand-receptor interaction	8484	263		0	0.5	365	8119	7	9	358	8110	8484	0.08450747697993322
R1	cpdb	0	network_modules	128	TRUE	1.724375663009829e-4	217	19	6	0.3157894736842105	0.027649769585253458	GO:0007188	GO:BP	adenylate cyclase-modulating G protein-coupled receptor signaling pathway	16175	2746		0.25	0.4	217	15958	6	13	211	15945	16175	0.09013201843454449
R1	cpdb	0	network_modules	128	TRUE	1.7401526667686613e-4	312	19	7	0.3684210526315789	0.022435897435897436	REAC:R-HSA-418594	REAC	G alpha (i) signalling events	10916	987		0	0.25	312	10604	7	12	305	10592	10916	0.08516244276146066
R1	cpdb	0	network_modules	128	TRUE	3.24588179482756e-4	122	19	5	0.2631578947368421	0.040983606557377046	GO:0008277	GO:BP	regulation of G protein-coupled receptor signaling pathway	16175	3149		0.5	0.6	122	16053	5	14	117	16039	16175	0.10131719296767036
R1	cpdb	0	network_modules	128	TRUE	6.492067084443931e-4	56	19	4	0.21052631578947367	0.07142857142857142	GO:0007187	GO:BP	G protein-coupled receptor signaling pathway, coupled to cyclic nucleotide second messenger	16175	2745		0.75	0.8	56	16119	4	15	52	16104	16175	0.1208915899197648
R1	cpdb	0	network_modules	128	TRUE	0.0012260971341183486	29	16	3	0.1875	0.10344827586206896	KEGG:04744	KEGG	Phototransduction	8484	362		1	1	29	8455	3	13	26	8442	8484	0.13709615551222182
R1	cpdb	0	network_modules	128	TRUE	0.001249644959466613	17	19	3	0.15789473684210525	0.17647058823529413	GO:0009584	GO:BP	detection of visible light	16175	3519		1	1	17	16158	3	16	14	16142	16175	0.16599808314375786
R1	cpdb	0	network_modules	128	TRUE	0.002327349828543516	460	19	7	0.3684210526315789	0.015217391304347827	REAC:R-HSA-500792	REAC	GPCR ligand binding	10916	1019		0.3333333333333333	0.5	460	10456	7	12	453	10444	10916	0.0678136363277113
R1	cpdb	0	network_modules	128	TRUE	0.004363018563207249	328	19	6	0.3157894736842105	0.018292682926829267	REAC:R-HSA-373076	REAC	Class A/1 (Rhodopsin-like receptors)	10916	365		0.6666666666666666	0.75	328	10588	6	13	322	10575	10916	0.06989028260509995
R1	cpdb	0	network_modules	128	TRUE	0.009112879521845849	5	19	2	0.10526315789473684	0.4	REAC:R-HSA-8875513	REAC	MET interacts with TNS proteins	10916	1367		1	1	5	10911	2	17	3	10894	10916	0.2045276598933455
R1	cpdb	0	network_modules	129	TRUE	7.221188646187207e-25	33	27	13	0.48148148148148145	0.3939393939393939	REAC:R-HSA-1592389	REAC	Activation of Matrix Metalloproteinases	10916	86		0	0.1	33	10883	13	14	20	10869	10916	0.43397459420734746
R1	cpdb	0	network_modules	129	TRUE	9.366763119503031e-18	140	27	14	0.5185185185185185	0.1	REAC:R-HSA-1474228	REAC	Degradation of the extracellular matrix	10916	726		0.1111111111111111	0.2	140	10776	14	13	126	10763	10916	0.2237926440224284
R1	cpdb	0	network_modules	129	TRUE	2.2763808791475894e-17	37	28	10	0.35714285714285715	0.2702702702702703	GO:0030574	GO:BP	collagen catabolic process	16175	6846		0	0.02631578947368421	37	16138	10	18	27	16120	16175	0.3093164765474533
R1	cpdb	0	network_modules	129	TRUE	2.915164513053493e-14	71	28	10	0.35714285714285715	0.14084507042253522	GO:0032963	GO:BP	collagen metabolic process	16175	7947		0.02702702702702703	0.05263157894736842	71	16104	10	18	61	16086	16175	0.22220431846724037
R1	cpdb	0	network_modules	129	TRUE	5.185236071750125e-14	236	28	13	0.4642857142857143	0.05508474576271186	GO:0030198	GO:BP	extracellular matrix organization	16175	6707		0.05405405405405406	0.07894736842105263	236	15939	13	15	223	15924	16175	0.1561741644889823
R1	cpdb	0	network_modules	129	TRUE	5.481380128947562e-14	237	28	13	0.4642857142857143	0.05485232067510549	GO:0043062	GO:BP	extracellular structure organization	16175	10509		0.08108108108108109	0.10526315789473684	237	15938	13	15	224	15923	16175	0.15582779779910602
R1	cpdb	0	network_modules	129	TRUE	5.793024955983756e-14	238	28	13	0.4642857142857143	0.0546218487394958	GO:0045229	GO:BP	external encapsulating structure organization	16175	11340		0.10810810810810811	0.13157894736842105	238	15937	13	15	225	15922	16175	0.15548358073134802
R1	cpdb	0	network_modules	129	TRUE	4.408454135692831e-13	298	27	14	0.5185185185185185	0.04697986577181208	REAC:R-HSA-1474244	REAC	Extracellular matrix organization	10916	889		0.2222222222222222	0.3	298	10618	14	13	284	10605	10916	0.1501057052641308
R1	cpdb	0	network_modules	129	TRUE	9.683872999520149e-11	59	28	8	0.2857142857142857	0.13559322033898305	GO:0022617	GO:BP	extracellular matrix disassembly	16175	6624		0.13513513513513514	0.15789473684210525	59	16116	8	20	51	16096	16175	0.19483839175304982
R1	cpdb	0	network_modules	129	TRUE	1.2087462457109414e-8	29	28	6	0.21428571428571427	0.20689655172413793	GO:0001990	GO:BP	regulation of systemic arterial blood pressure by hormone	16175	594		0.16216216216216217	0.18421052631578946	29	16146	6	22	23	16124	16175	0.2091655600101589
R1	cpdb	0	network_modules	129	TRUE	5.860684138210535e-8	37	28	6	0.21428571428571427	0.16216216216216217	GO:0003044	GO:BP	regulation of systemic arterial blood pressure mediated by a chemical signal	16175	1495		0.1891891891891892	0.21052631578947367	37	16138	6	22	31	16116	16175	0.184792315412641
R1	cpdb	0	network_modules	129	TRUE	4.318285043958696e-7	7	28	4	0.14285714285714285	0.5714285714285714	GO:0051045	GO:BP	negative regulation of membrane protein ectodomain proteolysis	16175	13455		0.21621621621621623	0.23684210526315788	7	16168	4	24	3	16144	16175	0.28515732906130303
R1	cpdb	0	network_modules	129	TRUE	6.485531815483425e-7	105	24	7	0.2916666666666667	0.06666666666666667	KEGG:04928	KEGG	Parathyroid hormone synthesis, secretion and action	8484	385		0	0.16666666666666666	105	8379	7	17	98	8362	8484	0.13455083820945882
R1	cpdb	0	network_modules	129	TRUE	8.936834610819032e-7	57	28	6	0.21428571428571427	0.10526315789473684	GO:0050886	GO:BP	endocrine process	16175	13330		0.24324324324324326	0.2631578947368421	57	16118	6	22	51	16096	16175	0.14810720640346492
R1	cpdb	0	network_modules	129	TRUE	1.5051329649134883e-6	62	28	6	0.21428571428571427	0.0967741935483871	GO:0003073	GO:BP	regulation of systemic arterial blood pressure	16175	1524		0.2702702702702703	0.2894736842105263	62	16113	6	22	56	16091	16175	0.14182334006108294
R1	cpdb	0	network_modules	129	TRUE	2.754012856831011e-6	64	27	6	0.2222222222222222	0.09375	REAC:R-HSA-1442490	REAC	Collagen degradation	10916	386		0.3333333333333333	0.4	64	10852	6	21	58	10831	10916	0.14111787744231624
R1	cpdb	0	network_modules	129	TRUE	4.052223476306975e-6	11	28	4	0.14285714285714285	0.36363636363636365	GO:0071492	GO:BP	cellular response to UV-A	16175	16725		0.2972972972972973	0.3157894736842105	11	16164	4	24	7	16140	16175	0.22710997663524804
R1	cpdb	0	network_modules	129	TRUE	4.779049113671073e-6	195	27	8	0.2962962962962963	0.041025641025641026	REAC:R-HSA-375276	REAC	Peptide ligand-binding receptors	10916	1726		0.4444444444444444	0.5	195	10721	8	19	187	10702	10916	0.1046734539234948
R1	cpdb	0	network_modules	129	TRUE	5.341888152286893e-6	625	28	11	0.39285714285714285	0.0176	GO:1901652	GO:BP	response to peptide	16175	21619		0.32432432432432434	0.3684210526315789	625	15550	11	17	614	15533	16175	0.07653179584180961
R1	cpdb	0	network_modules	129	TRUE	5.341888152286893e-6	625	28	11	0.39285714285714285	0.0176	GO:0034097	GO:BP	response to cytokine	16175	8408		0.32432432432432434	0.3684210526315789	625	15550	11	17	614	15533	16175	0.07653179584180961
R1	cpdb	0	network_modules	129	TRUE	9.721212764491591e-6	92	24	6	0.25	0.06521739130434782	KEGG:04657	KEGG	IL-17 signaling pathway	8484	335		0.2	0.3333333333333333	92	8392	6	18	86	8374	8484	0.12299170869532142
R1	cpdb	0	network_modules	129	TRUE	1.2248013480698164e-5	14	28	4	0.14285714285714285	0.2857142857142857	GO:0070141	GO:BP	response to UV-A	16175	15936		0.3783783783783784	0.39473684210526316	14	16161	4	24	10	16137	16175	0.20106752486707322
R1	cpdb	0	network_modules	129	TRUE	1.9054737614805817e-5	44	28	5	0.17857142857142858	0.11363636363636363	GO:0042310	GO:BP	vasoconstriction	16175	10083		0.40540540540540543	0.42105263157894735	44	16131	5	23	39	16108	16175	0.14059364437135302
R1	cpdb	0	network_modules	129	TRUE	2.5785025218600403e-5	23	24	4	0.16666666666666666	0.17391304347826086	KEGG:04614	KEGG	Renin-angiotensin system	8484	324		0.4	0.5	23	8461	4	20	19	8441	8484	0.16794721394998474
R1	cpdb	0	network_modules	129	TRUE	2.8430099265453757e-5	18	27	4	0.14814814814814814	0.2222222222222222	REAC:R-HSA-2022377	REAC	Metabolism of Angiotensinogen to Angiotensins	10916	1418		0.5555555555555556	0.6	18	10898	4	23	14	10875	10916	0.17979474191690414
R1	cpdb	0	network_modules	129	TRUE	2.9017544336820336e-5	17	28	4	0.14285714285714285	0.23529411764705882	GO:0003081	GO:BP	regulation of systemic arterial blood pressure by renin-angiotensin	16175	1526		0.43243243243243246	0.4473684210526316	17	16158	4	24	13	16134	16175	0.18224438225094372
R1	cpdb	0	network_modules	129	TRUE	5.147944540713931e-5	594	28	10	0.35714285714285715	0.016835016835016835	GO:0006954	GO:BP	inflammatory response	16175	2585		0.4594594594594595	0.47368421052631576	594	15581	10	18	584	15563	16175	0.07094233189815115
R1	cpdb	0	network_modules	129	TRUE	6.144323319177152e-5	114	28	6	0.21428571428571427	0.05263157894736842	GO:0008217	GO:BP	regulation of blood pressure	16175	3144		0.4864864864864865	0.5	114	16061	6	22	108	16039	16175	0.10315912283442562
R1	cpdb	0	network_modules	129	TRUE	7.097083782913338e-5	69	24	5	0.20833333333333334	0.07246376811594203	KEGG:04924	KEGG	Renin secretion	8484	381		0.6	0.6666666666666666	69	8415	5	19	64	8396	8484	0.11872286954770837
R1	cpdb	0	network_modules	129	TRUE	7.693927041463185e-5	111	27	6	0.2222222222222222	0.05405405405405406	REAC:R-HSA-6785807	REAC	Interleukin-4 and Interleukin-13 signaling	10916	1252		0.6666666666666666	0.7	111	10805	6	21	105	10784	10916	0.10525029277583545
R1	cpdb	0	network_modules	129	TRUE	7.99111191907807e-5	5	28	3	0.10714285714285714	0.6	GO:1905049	GO:BP	negative regulation of metallopeptidase activity	16175	24324		0.5135135135135135	0.5263157894736842	5	16170	3	25	2	16145	16175	0.2530729892717718
R1	cpdb	0	network_modules	129	TRUE	1.5277296590574373e-4	25	28	4	0.14285714285714285	0.16	GO:0051043	GO:BP	regulation of membrane protein ectodomain proteolysis	16175	13453		0.5405405405405406	0.5526315789473685	25	16150	4	24	21	16126	16175	0.14979550036812672
R1	cpdb	0	network_modules	129	TRUE	2.2123662634952504e-4	71	28	5	0.17857142857142858	0.07042253521126761	GO:0097746	GO:BP	blood vessel diameter maintenance	16175	18758		0.5675675675675675	0.631578947368421	71	16104	5	23	66	16081	16175	0.10971965843520481
R1	cpdb	0	network_modules	129	TRUE	2.2123662634952504e-4	71	28	5	0.17857142857142858	0.07042253521126761	GO:0035296	GO:BP	regulation of tube diameter	16175	8954		0.5675675675675675	0.631578947368421	71	16104	5	23	66	16081	16175	0.10971965843520481
R1	cpdb	0	network_modules	129	TRUE	2.2123662634952504e-4	71	28	5	0.17857142857142858	0.07042253521126761	GO:0035150	GO:BP	regulation of tube size	16175	8847		0.5675675675675675	0.631578947368421	71	16104	5	23	66	16081	16175	0.10971965843520481
R1	cpdb	0	network_modules	129	TRUE	2.387332069314602e-4	88	24	5	0.20833333333333334	0.056818181818181816	KEGG:05323	KEGG	Rheumatoid arthritis	8484	485		0.8	0.8333333333333334	88	8396	5	19	83	8377	8484	0.1040693630466334
R1	cpdb	0	network_modules	129	TRUE	2.6359700109762526e-4	328	27	8	0.2962962962962963	0.024390243902439025	REAC:R-HSA-373076	REAC	Class A/1 (Rhodopsin-like receptors)	10916	365		0.7777777777777778	0.8	328	10588	8	19	320	10569	10916	0.07765956478541598
R1	cpdb	0	network_modules	129	TRUE	2.7107126811616724e-4	374	28	8	0.2857142857142857	0.0213903743315508	GO:0022411	GO:BP	cellular component disassembly	16175	6602		0.6486486486486487	0.6578947368421053	374	15801	8	20	366	15781	16175	0.07275805645980939
R1	cpdb	0	network_modules	129	TRUE	4.485775946561843e-4	100	24	5	0.20833333333333334	0.05	KEGG:04933	KEGG	AGE-RAGE signaling pathway in diabetic complications	8484	390		1	1	100	8384	5	19	95	8365	8484	0.0969975237057966
R1	cpdb	0	network_modules	129	TRUE	6.681460795650107e-4	9	28	3	0.10714285714285714	0.3333333333333333	GO:0002002	GO:BP	regulation of angiotensin levels in blood	16175	606		0.6756756756756757	0.7105263157894737	9	16166	3	25	6	16141	16175	0.18821611693635254
R1	cpdb	0	network_modules	129	TRUE	6.681460795650107e-4	9	28	3	0.10714285714285714	0.3333333333333333	GO:0002003	GO:BP	angiotensin maturation	16175	607		0.6756756756756757	0.7105263157894737	9	16166	3	25	6	16141	16175	0.18821611693635254
R1	cpdb	0	network_modules	129	TRUE	0.0013093888251545815	11	28	3	0.10714285714285714	0.2727272727272727	GO:1905048	GO:BP	regulation of metallopeptidase activity	16175	24323		0.7297297297297297	0.7368421052631579	11	16164	3	25	8	16139	16175	0.17006090420272324
R1	cpdb	0	network_modules	129	TRUE	0.0016028596601759685	44	28	4	0.14285714285714285	0.09090909090909091	GO:0006509	GO:BP	membrane protein ectodomain proteolysis	16175	2234		0.7567567567567568	0.7631578947368421	44	16131	4	24	40	16107	16175	0.11203994602113224
R1	cpdb	0	network_modules	129	TRUE	0.0028785580860284476	14	28	3	0.10714285714285714	0.21428571428571427	GO:0001991	GO:BP	regulation of systemic arterial blood pressure by circulatory renin-angiotensin	16175	595		0.7837837837837838	0.7894736842105263	14	16161	3	25	11	16136	16175	0.15049423360121347
R1	cpdb	0	network_modules	129	TRUE	0.0032794779205005016	460	27	8	0.2962962962962963	0.017391304347826087	REAC:R-HSA-500792	REAC	GPCR ligand binding	10916	1019		0.8888888888888888	0.9	460	10456	8	19	452	10437	10916	0.06299275717420859
R1	cpdb	0	network_modules	129	TRUE	0.0033549702988689687	358	28	7	0.25	0.019553072625698324	GO:0008015	GO:BP	blood circulation	16175	3096		0.8108108108108109	0.8157894736842105	358	15817	7	21	351	15796	16175	0.06449935870387793
R1	cpdb	0	network_modules	129	TRUE	0.003464689199434003	213	27	6	0.2222222222222222	0.028169014084507043	REAC:R-HSA-416476	REAC	G alpha (q) signalling events	10916	988		1	1	213	10703	6	21	207	10682	10916	0.07297651504997321
R1	cpdb	0	network_modules	129	TRUE	0.004982325234183615	2	28	2	0.07142857142857142	1	GO:0060585	GO:BP	positive regulation of prostaglandin-endoperoxide synthase activity	16175	14767		0.8378378378378378	0.8947368421052632	2	16173	2	26	0	16147	16175	0.2670463285603229
R1	cpdb	0	network_modules	129	TRUE	0.004982325234183615	2	28	2	0.07142857142857142	1	GO:0002019	GO:BP	regulation of renal output by angiotensin	16175	622		0.8378378378378378	0.8947368421052632	2	16173	2	26	0	16147	16175	0.2670463285603229
R1	cpdb	0	network_modules	129	TRUE	0.004982325234183615	2	28	2	0.07142857142857142	1	GO:0060584	GO:BP	regulation of prostaglandin-endoperoxide synthase activity	16175	14766		0.8378378378378378	0.8947368421052632	2	16173	2	26	0	16147	16175	0.2670463285603229
R1	cpdb	0	network_modules	129	TRUE	0.005278910802311564	59	28	4	0.14285714285714285	0.06779661016949153	GO:0033619	GO:BP	membrane protein proteolysis	16175	8321		0.918918918918919	0.9210526315789473	59	16116	4	24	55	16092	16175	0.09615939915494791
R1	cpdb	0	network_modules	129	TRUE	0.007077589202535729	781	28	9	0.32142857142857145	0.011523687580025609	GO:0030334	GO:BP	regulation of cell migration	16175	6780		0.9459459459459459	0.9473684210526315	781	15394	9	19	772	15375	16175	0.05306010177327809
R1	cpdb	0	network_modules	129	TRUE	0.009345413494104962	68	28	4	0.14285714285714285	0.058823529411764705	GO:0070098	GO:BP	chemokine-mediated signaling pathway	16175	15910		0.972972972972973	0.9736842105263158	68	16107	4	24	64	16083	16175	0.08923706065381089
R1	cpdb	0	network_modules	129	TRUE	0.009488866966252823	419	28	7	0.25	0.016706443914081145	GO:0019221	GO:BP	cytokine-mediated signaling pathway	16175	5598		1	1	419	15756	7	21	412	15735	16175	0.05874638592816679
R1	cpdb	0	network_modules	130	TRUE	0.0015515368203202606	217	15	5	0.3333333333333333	0.02304147465437788	GO:0090092	GO:BP	regulation of transmembrane receptor protein serine/threonine kinase signaling pathway	16175	18013		0	0.25	217	15958	5	10	212	15948	16175	0.08472044599427046
R1	cpdb	0	network_modules	130	TRUE	0.0031106176283111956	18	6	2	0.3333333333333333	0.1111111111111111	KEGG:00511	KEGG	Other glycan degradation	8484	64		NA	1	18	8466	2	4	16	8462	8484	0.19149606507132055
R1	cpdb	0	network_modules	130	TRUE	0.0034989952701483954	256	15	5	0.3333333333333333	0.01953125	GO:0090287	GO:BP	regulation of cellular response to growth factor stimulus	16175	18171		0.3333333333333333	0.5	256	15919	5	10	251	15909	16175	0.07750753143871365
R1	cpdb	0	network_modules	130	TRUE	0.004088840933518318	790	15	7	0.4666666666666667	0.008860759493670886	GO:0007167	GO:BP	enzyme-linked receptor protein signaling pathway	16175	2731		0.6666666666666666	0.75	790	15385	7	8	783	15377	16175	0.059061199573157835
R1	cpdb	0	network_modules	130	TRUE	0.006442508416113868	290	15	5	0.3333333333333333	0.017241379310344827	GO:0007178	GO:BP	cell surface receptor protein serine/threonine kinase signaling pathway	16175	2740		1	1	290	15885	5	10	285	15875	16175	0.07241764906969365
R1	cpdb	0	network_modules	131	TRUE	2.711860622300765e-4	44	19	4	0.21052631578947367	0.09090909090909091	REAC:R-HSA-445989	REAC	TAK1-dependent IKK and NF-kappa-B activation  	10916	2417		0	0.07142857142857142	44	10872	4	15	40	10857	10916	0.1360869428734381
R1	cpdb	0	network_modules	131	TRUE	9.261109061747742e-4	70	19	4	0.21052631578947367	0.05714285714285714	KEGG:04920	KEGG	Adipocytokine signaling pathway	8484	377		NA	1	70	8414	4	15	66	8399	8484	0.1059392682112357
R1	cpdb	0	network_modules	131	TRUE	9.534406584359109e-4	17	19	3	0.15789473684210525	0.17647058823529413	REAC:R-HSA-1810476	REAC	RIP-mediated NFkB activation via ZBP1	10916	1876		0.07692307692307693	0.14285714285714285	17	10899	3	16	14	10883	10916	0.16555104323798445
R1	cpdb	0	network_modules	131	TRUE	0.0018566290623475562	21	19	3	0.15789473684210525	0.14285714285714285	REAC:R-HSA-1606322	REAC	ZBP1(DAI) mediated induction of type I IFNs	10916	2680		0.15384615384615385	0.21428571428571427	21	10895	3	16	18	10879	10916	0.14863028800788033
R1	cpdb	0	network_modules	131	TRUE	0.0031966132300736048	25	19	3	0.15789473684210525	0.12	REAC:R-HSA-933542	REAC	TRAF6 mediated NF-kB activation	10916	2467		0.23076923076923078	0.2857142857142857	25	10891	3	16	22	10875	10916	0.13592682687611676
R1	cpdb	0	network_modules	131	TRUE	0.006011973997203501	95	19	4	0.21052631578947367	0.042105263157894736	REAC:R-HSA-975871	REAC	MyD88 cascade initiated on plasma membrane	10916	1497		0.3076923076923077	0.5	95	10821	4	15	91	10806	10916	0.09073254063009835
R1	cpdb	0	network_modules	131	TRUE	0.006011973997203501	95	19	4	0.21052631578947367	0.042105263157894736	REAC:R-HSA-168142	REAC	Toll Like Receptor 10 (TLR10) Cascade	10916	2513		0.3076923076923077	0.5	95	10821	4	15	91	10806	10916	0.09073254063009835
R1	cpdb	0	network_modules	131	TRUE	0.006011973997203501	95	19	4	0.21052631578947367	0.042105263157894736	REAC:R-HSA-168176	REAC	Toll Like Receptor 5 (TLR5) Cascade	10916	2517		0.3076923076923077	0.5	95	10821	4	15	91	10806	10916	0.09073254063009835
R1	cpdb	0	network_modules	131	TRUE	0.0076595346368239165	101	19	4	0.21052631578947367	0.039603960396039604	REAC:R-HSA-975138	REAC	TRAF6 mediated induction of NFkB and MAP kinases upon TLR7/8 or 9 activation	10916	2468		0.5384615384615384	0.5714285714285714	101	10815	4	15	97	10800	10916	0.08778094273279258
R1	cpdb	0	network_modules	131	TRUE	0.007963376438280935	102	19	4	0.21052631578947367	0.0392156862745098	REAC:R-HSA-975155	REAC	MyD88 dependent cascade initiated on endosome	10916	1500		0.6153846153846154	0.6428571428571429	102	10814	4	15	98	10799	10916	0.08731386426585158
R1	cpdb	0	network_modules	131	TRUE	0.008275991339485835	103	19	4	0.21052631578947367	0.038834951456310676	REAC:R-HSA-168164	REAC	Toll Like Receptor 3 (TLR3) Cascade	10916	2515		0.6923076923076923	0.7857142857142857	103	10813	4	15	99	10798	10916	0.08685342760655247
R1	cpdb	0	network_modules	131	TRUE	0.008275991339485835	103	19	4	0.21052631578947367	0.038834951456310676	REAC:R-HSA-168181	REAC	Toll Like Receptor 7/8 (TLR7/8) Cascade	10916	2518		0.6923076923076923	0.7857142857142857	103	10813	4	15	99	10798	10916	0.08685342760655247
R1	cpdb	0	network_modules	131	TRUE	0.009268066854336402	106	19	4	0.21052631578947367	0.03773584905660377	REAC:R-HSA-168138	REAC	Toll Like Receptor 9 (TLR9) Cascade	10916	2519		0.8461538461538461	0.8571428571428571	106	10810	4	15	102	10795	10916	0.08551040240800872
R1	cpdb	0	network_modules	131	TRUE	0.009617371835837643	107	19	4	0.21052631578947367	0.037383177570093455	REAC:R-HSA-166166	REAC	MyD88-independent TLR4 cascade 	10916	1501		0.9230769230769231	1	107	10809	4	15	103	10794	10916	0.08507499256645054
R1	cpdb	0	network_modules	131	TRUE	0.009617371835837643	107	19	4	0.21052631578947367	0.037383177570093455	REAC:R-HSA-937061	REAC	TRIF (TICAM1)-mediated TLR4 signaling 	10916	2471		0.9230769230769231	1	107	10809	4	15	103	10794	10916	0.08507499256645054
R1	cpdb	0	network_modules	132	TRUE	2.2322948726707007e-38	407	38	30	0.7894736842105263	0.07371007371007371	GO:0007015	GO:BP	actin filament organization	16175	2624		0	0.0196078431372549	407	15768	30	8	377	15760	16175	0.23681516683477585
R1	cpdb	0	network_modules	132	TRUE	1.6054567443317058e-34	632	38	31	0.8157894736842105	0.0490506329113924	GO:0030036	GO:BP	actin cytoskeleton organization	16175	6660		0.02	0.0392156862745098	632	15543	31	7	601	15536	16175	0.19451873720410706
R1	cpdb	0	network_modules	132	TRUE	5.693323953943577e-33	708	38	31	0.8157894736842105	0.043785310734463276	GO:0030029	GO:BP	actin filament-based process	16175	6653		0.04	0.058823529411764705	708	15467	31	7	677	15460	16175	0.1831186456135202
R1	cpdb	0	network_modules	132	TRUE	2.657070492667157e-30	748	38	30	0.7894736842105263	0.040106951871657755	GO:0097435	GO:BP	supramolecular fiber organization	16175	18657		0.06	0.0784313725490196	748	15427	30	8	718	15419	16175	0.17173391755832937
R1	cpdb	0	network_modules	132	TRUE	6.367645443351431e-21	35	31	12	0.3870967741935484	0.34285714285714286	REAC:R-HSA-5663213	REAC	RHO GTPases Activate WASPs and WAVEs	10916	1852		0	0.07142857142857142	35	10881	12	19	23	10862	10916	0.3623840401934176
R1	cpdb	0	network_modules	132	TRUE	7.057819556406688e-19	50	38	12	0.3157894736842105	0.24	GO:0045010	GO:BP	actin nucleation	16175	11227		0.08	0.09803921568627451	50	16125	12	26	38	16099	16175	0.27334763560913505
R1	cpdb	0	network_modules	132	TRUE	1.7397242594383014e-18	136	23	14	0.6086956521739131	0.10294117647058823	KEGG:05135	KEGG	Yersinia infection	8484	432		0	0.1	136	8348	14	9	122	8339	8484	0.24603828245007925
R1	cpdb	0	network_modules	132	TRUE	2.3073429190806084e-18	248	23	16	0.6956521739130435	0.06451612903225806	KEGG:04144	KEGG	Endocytosis	8484	280		0.1111111111111111	0.2	248	8236	16	7	232	8229	8484	0.206261506720138
R1	cpdb	0	network_modules	132	TRUE	1.503279380555608e-17	42	38	11	0.2894736842105263	0.2619047619047619	GO:0034314	GO:BP	Arp2/3 complex-mediated actin nucleation	16175	8568		0.1	0.11764705882352941	42	16133	11	27	31	16106	16175	0.2735510175709236
R1	cpdb	0	network_modules	132	TRUE	3.648399776821881e-16	197	23	14	0.6086956521739131	0.07106598984771574	KEGG:05130	KEGG	Pathogenic Escherichia coli infection	8484	427		0.2222222222222222	0.3	197	8287	14	9	183	8278	8484	0.20268922119244678
R1	cpdb	0	network_modules	132	TRUE	1.3058273445428301e-15	77	23	11	0.4782608695652174	0.14285714285714285	KEGG:05100	KEGG	Bacterial invasion of epithelial cells	8484	423		0.3333333333333333	0.4	77	8407	11	12	66	8395	8484	0.2579478592598114
R1	cpdb	0	network_modules	132	TRUE	3.2713595842163713e-15	170	23	13	0.5652173913043478	0.07647058823529412	KEGG:04530	KEGG	Tight junction	8484	317		0.4444444444444444	0.5	170	8314	13	10	157	8304	8484	0.2028448166639953
R1	cpdb	0	network_modules	132	TRUE	1.681168717172769e-14	96	23	11	0.4782608695652174	0.11458333333333333	KEGG:04666	KEGG	Fc gamma R-mediated phagocytosis	8484	341		0.5555555555555556	0.6	96	8388	11	12	85	8376	8484	0.23017335762386804
R1	cpdb	0	network_modules	132	TRUE	3.3240560593247116e-14	113	31	12	0.3870967741935484	0.10619469026548672	REAC:R-HSA-9664422	REAC	FCGR3A-mediated phagocytosis	10916	899		0.07692307692307693	0.2857142857142857	113	10803	12	19	101	10784	10916	0.19863978716522424
R1	cpdb	0	network_modules	132	TRUE	3.3240560593247116e-14	113	31	12	0.3870967741935484	0.10619469026548672	REAC:R-HSA-9664417	REAC	Leishmania phagocytosis	10916	1312		0.07692307692307693	0.2857142857142857	113	10803	12	19	101	10784	10916	0.19863978716522424
R1	cpdb	0	network_modules	132	TRUE	3.3240560593247116e-14	113	31	12	0.3870967741935484	0.10619469026548672	REAC:R-HSA-9664407	REAC	Parasite infection	10916	1716		0.07692307692307693	0.2857142857142857	113	10803	12	19	101	10784	10916	0.19863978716522424
R1	cpdb	0	network_modules	132	TRUE	4.6040996820614534e-14	116	31	12	0.3870967741935484	0.10344827586206896	REAC:R-HSA-2029482	REAC	Regulation of actin dynamics for phagocytic cup formation	10916	2020		0.3076923076923077	0.35714285714285715	116	10800	12	19	104	10781	10916	0.1959385348312983
R1	cpdb	0	network_modules	132	TRUE	2.873219094874869e-13	40	31	9	0.2903225806451613	0.225	REAC:R-HSA-3928662	REAC	EPHB-mediated forward signaling	10916	821		0.38461538461538464	0.42857142857142855	40	10876	9	22	31	10854	10916	0.25318034318878724
R1	cpdb	0	network_modules	132	TRUE	4.692094399121736e-13	140	31	12	0.3870967741935484	0.08571428571428572	REAC:R-HSA-2029480	REAC	Fcgamma receptor (FCGR) dependent phagocytosis	10916	939		0.46153846153846156	0.5	140	10776	12	19	128	10757	10916	0.1775105540194142
R1	cpdb	0	network_modules	132	TRUE	1.1960353573851676e-12	73	38	10	0.2631578947368421	0.136986301369863	GO:0097581	GO:BP	lamellipodium organization	16175	18706		0.12	0.13725490196078433	73	16102	10	28	63	16074	16175	0.1872522420812246
R1	cpdb	0	network_modules	132	TRUE	1.2299651909577851e-12	46	38	9	0.23684210526315788	0.1956521739130435	GO:1902743	GO:BP	regulation of lamellipodium organization	16175	22469		0.14	0.1568627450980392	46	16129	9	29	37	16100	16175	0.2132330835477397
R1	cpdb	0	network_modules	132	TRUE	9.866492651302845e-12	57	38	9	0.23684210526315788	0.15789473684210525	GO:0030032	GO:BP	lamellipodium assembly	16175	6656		0.16	0.17647058823529413	57	16118	9	29	48	16089	16175	0.19106458972355536
R1	cpdb	0	network_modules	132	TRUE	1.1109398545976102e-11	34	38	8	0.21052631578947367	0.23529411764705882	GO:0010591	GO:BP	regulation of lamellipodium assembly	16175	4239		0.18	0.19607843137254902	34	16141	8	30	26	16111	16175	0.22083523922290518
R1	cpdb	0	network_modules	132	TRUE	8.488381280031784e-11	215	31	12	0.3870967741935484	0.05581395348837209	REAC:R-HSA-9824443	REAC	Parasitic Infection Pathways	10916	1717		0.5384615384615384	0.6428571428571429	215	10701	12	19	203	10682	10916	0.14110388739971938
R1	cpdb	0	network_modules	132	TRUE	8.488381280031784e-11	215	31	12	0.3870967741935484	0.05581395348837209	REAC:R-HSA-9658195	REAC	Leishmania infection	10916	1310		0.5384615384615384	0.6428571428571429	215	10701	12	19	203	10682	10916	0.14110388739971938
R1	cpdb	0	network_modules	132	TRUE	2.590661031589898e-10	227	23	11	0.4782608695652174	0.048458149779735685	KEGG:04810	KEGG	Regulation of actin cytoskeleton	8484	365		0.6666666666666666	0.7	227	8257	11	12	216	8245	8484	0.1458786919324822
R1	cpdb	0	network_modules	132	TRUE	6.234816253550855e-10	246	23	11	0.4782608695652174	0.044715447154471545	KEGG:05131	KEGG	Shigellosis	8484	428		0.7777777777777778	0.8	246	8238	11	12	235	8226	8484	0.13959760848583763
R1	cpdb	0	network_modules	132	TRUE	6.774394096631863e-10	90	31	9	0.2903225806451613	0.1	REAC:R-HSA-2682334	REAC	EPH-Ephrin signaling	10916	818		0.6923076923076923	0.7142857142857143	90	10826	9	22	81	10804	10916	0.16647299866593687
R1	cpdb	0	network_modules	132	TRUE	7.11542863020634e-10	249	23	11	0.4782608695652174	0.04417670682730924	KEGG:05132	KEGG	Salmonella infection	8484	429		0.8888888888888888	0.9	249	8235	11	12	238	8223	8484	0.13867015212301867
R1	cpdb	0	network_modules	132	TRUE	8.70556631685078e-9	318	31	12	0.3870967741935484	0.03773584905660377	REAC:R-HSA-195258	REAC	RHO GTPase Effectors	10916	1846		0.7692307692307693	0.7857142857142857	318	10598	12	19	306	10579	10916	0.11359140654639607
R1	cpdb	0	network_modules	132	TRUE	1.4594409996032057e-7	32	38	6	0.15789473684210525	0.1875	GO:1902745	GO:BP	positive regulation of lamellipodium organization	16175	22471		0.2	0.21568627450980393	32	16143	6	32	26	16111	16175	0.17027437902374207
R1	cpdb	0	network_modules	132	TRUE	2.670627528096014e-7	172	38	9	0.23684210526315788	0.05232558139534884	GO:0120032	GO:BP	regulation of plasma membrane bounded cell projection assembly	16175	19468		0.22	0.23529411764705882	172	16003	9	29	163	15974	16175	0.1070208785130022
R1	cpdb	0	network_modules	132	TRUE	2.812608601731904e-7	173	38	9	0.23684210526315788	0.05202312138728324	GO:0060491	GO:BP	regulation of cell projection assembly	16175	14685		0.24	0.2549019607843137	173	16002	9	29	164	15973	16175	0.10668529004160206
R1	cpdb	0	network_modules	132	TRUE	5.902466368139664e-7	466	38	12	0.3157894736842105	0.02575107296137339	GO:0120035	GO:BP	regulation of plasma membrane bounded cell projection organization	16175	19471		0.26	0.27450980392156865	466	15709	12	26	454	15683	16175	0.0832546421517046
R1	cpdb	0	network_modules	132	TRUE	8.277169789451163e-7	480	38	12	0.3157894736842105	0.025	GO:0031344	GO:BP	regulation of cell projection organization	16175	7135		0.28	0.29411764705882354	480	15695	12	26	468	15669	16175	0.08182058726442226
R1	cpdb	0	network_modules	132	TRUE	1.5353034553982877e-6	144	31	8	0.25806451612903225	0.05555555555555555	REAC:R-HSA-8856828	REAC	Clathrin-mediated endocytosis	10916	372		0.8461538461538461	0.8571428571428571	144	10772	8	23	136	10749	10916	0.11453584168354135
R1	cpdb	0	network_modules	132	TRUE	2.4207977611776766e-6	308	38	10	0.2631578947368421	0.032467532467532464	GO:0032970	GO:BP	regulation of actin filament-based process	16175	7953		0.3	0.3137254901960784	308	15867	10	28	298	15839	16175	0.08667591905940385
R1	cpdb	0	network_modules	132	TRUE	3.3940788310392594e-6	24	38	5	0.13157894736842105	0.20833333333333334	GO:0010592	GO:BP	positive regulation of lamellipodium assembly	16175	4240		0.32	0.37254901960784315	24	16151	5	33	19	16118	16175	0.16401386091463604
R1	cpdb	0	network_modules	132	TRUE	3.3940788310392594e-6	24	38	5	0.13157894736842105	0.20833333333333334	GO:0051016	GO:BP	barbed-end actin filament capping	16175	13441		0.32	0.37254901960784315	24	16151	5	33	19	16118	16175	0.16401386091463604
R1	cpdb	0	network_modules	132	TRUE	3.3940788310392594e-6	24	38	5	0.13157894736842105	0.20833333333333334	GO:0051693	GO:BP	actin filament capping	16175	13896		0.32	0.37254901960784315	24	16151	5	33	19	16118	16175	0.16401386091463604
R1	cpdb	0	network_modules	132	TRUE	6.413708517200119e-6	27	38	5	0.13157894736842105	0.18518518518518517	GO:0030835	GO:BP	negative regulation of actin filament depolymerization	16175	6920		0.38	0.39215686274509803	27	16148	5	33	22	16115	16175	0.15442763886179917
R1	cpdb	0	network_modules	132	TRUE	7.808280855552503e-6	252	38	9	0.23684210526315788	0.03571428571428571	GO:0031346	GO:BP	positive regulation of cell projection organization	16175	7137		0.4	0.4117647058823529	252	15923	9	29	243	15894	16175	0.0867001401010558
R1	cpdb	0	network_modules	132	TRUE	1.6188414805461086e-5	274	38	9	0.23684210526315788	0.032846715328467155	GO:0032956	GO:BP	regulation of actin cytoskeleton organization	16175	7940		0.42	0.43137254901960786	274	15901	9	29	265	15872	16175	0.08269269090552907
R1	cpdb	0	network_modules	132	TRUE	2.2498854783198115e-5	793	38	13	0.34210526315789475	0.01639344262295082	GO:0044087	GO:BP	regulation of cellular component biogenesis	16175	10909		0.44	0.45098039215686275	793	15382	13	25	780	15357	16175	0.06586677112712919
R1	cpdb	0	network_modules	132	TRUE	2.4326621527423553e-5	127	38	7	0.18421052631578946	0.05511811023622047	GO:0030041	GO:BP	actin filament polymerization	16175	6662		0.46	0.47058823529411764	127	16048	7	31	120	16017	16175	0.09696382959324108
R1	cpdb	0	network_modules	132	TRUE	2.5441996511777043e-5	35	38	5	0.13157894736842105	0.14285714285714285	GO:0030834	GO:BP	regulation of actin filament depolymerization	16175	6919		0.48	0.49019607843137253	35	16140	5	33	30	16107	16175	0.13515244319735376
R1	cpdb	0	network_modules	132	TRUE	4.4992144981173014e-5	215	38	8	0.21052631578947367	0.037209302325581395	GO:0110053	GO:BP	regulation of actin filament organization	16175	19377		0.5	0.5098039215686274	215	15960	8	30	207	15930	16175	0.08357400868243783
R1	cpdb	0	network_modules	132	TRUE	5.113219597431115e-5	40	38	5	0.13157894736842105	0.125	GO:0030042	GO:BP	actin filament depolymerization	16175	6663		0.52	0.5294117647058824	40	16135	5	33	35	16102	16175	0.12614110108773058
R1	cpdb	0	network_modules	132	TRUE	8.828047783704478e-5	153	38	7	0.18421052631578946	0.0457516339869281	GO:0008154	GO:BP	actin polymerization or depolymerization	16175	3127		0.54	0.5490196078431373	153	16022	7	31	146	15991	16175	0.08760753946872514
R1	cpdb	0	network_modules	132	TRUE	9.413522461030988e-5	45	38	5	0.13157894736842105	0.1111111111111111	GO:0030837	GO:BP	negative regulation of actin filament polymerization	16175	6922		0.56	0.5686274509803921	45	16130	5	33	40	16097	16175	0.11866061030655828
R1	cpdb	0	network_modules	132	TRUE	1.1801674308215689e-4	94	38	6	0.15789473684210525	0.06382978723404255	GO:0120034	GO:BP	positive regulation of plasma membrane bounded cell projection assembly	16175	19470		0.58	0.5882352941176471	94	16081	6	32	88	16049	16175	0.09709251735082614
R1	cpdb	0	network_modules	132	TRUE	1.4592628369271832e-4	49	38	5	0.13157894736842105	0.10204081632653061	GO:1901880	GO:BP	negative regulation of protein depolymerization	16175	21824		0.6	0.6078431372549019	49	16126	5	33	44	16093	16175	0.11350996402600733
R1	cpdb	0	network_modules	132	TRUE	2.5316127675097236e-4	503	38	10	0.2631578947368421	0.019880715705765408	GO:0120031	GO:BP	plasma membrane bounded cell projection assembly	16175	19467		0.62	0.6274509803921569	503	15672	10	28	493	15644	16175	0.06487535530961781
R1	cpdb	0	network_modules	132	TRUE	3.093852461225282e-4	514	38	10	0.2631578947368421	0.019455252918287938	GO:0030031	GO:BP	cell projection assembly	16175	6655		0.64	0.6470588235294118	514	15661	10	28	504	15633	16175	0.06401180370895108
R1	cpdb	0	network_modules	132	TRUE	3.1608824966481477e-4	57	38	5	0.13157894736842105	0.08771929824561403	GO:0032272	GO:BP	negative regulation of protein polymerization	16175	7453		0.66	0.6666666666666666	57	16118	5	33	52	16085	16175	0.10486442826148511
R1	cpdb	0	network_modules	132	TRUE	3.5456792016244165e-4	113	38	6	0.15789473684210525	0.05309734513274336	GO:0008064	GO:BP	regulation of actin polymerization or depolymerization	16175	3113		0.68	0.6862745098039216	113	16062	6	32	107	16030	16175	0.08792245003280147
R1	cpdb	0	network_modules	132	TRUE	4.101938843169949e-4	60	38	5	0.13157894736842105	0.08333333333333333	GO:0043242	GO:BP	negative regulation of protein-containing complex disassembly	16175	10580		0.7	0.7058823529411765	60	16115	5	33	55	16082	16175	0.10207066408584824
R1	cpdb	0	network_modules	132	TRUE	4.1428658084052453e-4	116	38	6	0.15789473684210525	0.05172413793103448	GO:0030832	GO:BP	regulation of actin filament length	16175	6917		0.72	0.7254901960784313	116	16059	6	32	110	16027	16175	0.08667951662308356
R1	cpdb	0	network_modules	132	TRUE	5.252212050469893e-4	63	38	5	0.13157894736842105	0.07936507936507936	GO:1901879	GO:BP	regulation of protein depolymerization	16175	21823		0.74	0.7450980392156863	63	16112	5	33	58	16079	16175	0.09947554541479318
R1	cpdb	0	network_modules	132	TRUE	6.302862447310536e-4	7	38	3	0.07894736842105263	0.42857142857142855	GO:0070358	GO:BP	actin polymerization-dependent cell motility	16175	16075		0.76	0.7647058823529411	7	16168	3	35	4	16133	16175	0.18318839193808537
R1	cpdb	0	network_modules	132	TRUE	7.083765796973054e-4	127	38	6	0.15789473684210525	0.047244094488188976	GO:0051494	GO:BP	negative regulation of cytoskeleton organization	16175	13749		0.78	0.7843137254901961	127	16048	6	32	121	16016	16175	0.08249515420259472
R1	cpdb	0	network_modules	132	TRUE	7.768211689785988e-4	129	38	6	0.15789473684210525	0.046511627906976744	GO:1902904	GO:BP	negative regulation of supramolecular fiber organization	16175	22603		0.8	0.803921568627451	129	16046	6	32	123	16014	16175	0.08179080201068684
R1	cpdb	0	network_modules	132	TRUE	9.062189812453759e-4	318	38	8	0.21052631578947367	0.025157232704402517	GO:1902903	GO:BP	regulation of supramolecular fiber organization	16175	22602		0.82	0.8235294117647058	318	15857	8	30	310	15827	16175	0.06671599630894527
R1	cpdb	0	network_modules	132	TRUE	9.211638168074398e-4	440	38	9	0.23684210526315788	0.020454545454545454	GO:0051493	GO:BP	regulation of cytoskeleton organization	16175	13748		0.84	0.8431372549019608	440	15735	9	29	431	15706	16175	0.06253719036309273
R1	cpdb	0	network_modules	132	TRUE	0.001772384499256158	238	38	7	0.18421052631578946	0.029411764705882353	GO:0051258	GO:BP	protein polymerization	16175	13605		0.86	0.8627450980392157	238	15937	7	31	231	15906	16175	0.06831145868432283
R1	cpdb	0	network_modules	132	TRUE	0.0024366741443940985	45	31	4	0.12903225806451613	0.08888888888888889	REAC:R-HSA-8955332	REAC	Carboxyterminal post-translational modifications of tubulin	10916	305		0.9230769230769231	0.9285714285714286	45	10871	4	27	41	10844	10916	0.10403654116221266
R1	cpdb	0	network_modules	132	TRUE	0.0029579399315379797	257	38	7	0.18421052631578946	0.027237354085603113	GO:0032535	GO:BP	regulation of cellular component size	16175	7629		0.88	0.8823529411764706	257	15918	7	31	250	15887	16175	0.06532121688080704
R1	cpdb	0	network_modules	132	TRUE	0.0036901103226312246	93	38	5	0.13157894736842105	0.053763440860215055	GO:0051261	GO:BP	protein depolymerization	16175	13608		0.9	0.9019607843137255	93	16082	5	33	88	16049	16175	0.08075977161673556
R1	cpdb	0	network_modules	132	TRUE	0.004322204303512566	173	38	6	0.15789473684210525	0.03468208092485549	GO:0031032	GO:BP	actomyosin structure organization	16175	7004		0.92	0.9215686274509803	173	16002	6	32	167	15970	16175	0.06944164647595331
R1	cpdb	0	network_modules	132	TRUE	0.004544794898897063	97	38	5	0.13157894736842105	0.05154639175257732	GO:0043244	GO:BP	regulation of protein-containing complex disassembly	16175	10582		0.94	0.9607843137254902	97	16078	5	33	92	16045	16175	0.07893149660957341
R1	cpdb	0	network_modules	132	TRUE	0.004544794898897063	97	38	5	0.13157894736842105	0.05154639175257732	GO:0030833	GO:BP	regulation of actin filament polymerization	16175	6918		0.94	0.9607843137254902	97	16078	5	33	92	16045	16175	0.07893149660957341
R1	cpdb	0	network_modules	132	TRUE	0.00627529794073806	412	38	8	0.21052631578947367	0.019417475728155338	GO:0044089	GO:BP	positive regulation of cellular component biogenesis	16175	10911		0.98	0.9803921568627451	412	15763	8	30	404	15733	16175	0.05699768977953013
R1	cpdb	0	network_modules	132	TRUE	0.008776310937520057	449	31	8	0.25806451612903225	0.017817371937639197	REAC:R-HSA-9012999	REAC	RHO GTPase cycle	10916	1847		1	1	449	10467	8	23	441	10444	10916	0.05829347721523057
R1	cpdb	0	network_modules	132	TRUE	0.008960850763839416	193	23	5	0.21739130434782608	0.025906735751295335	KEGG:04814	KEGG	Motor proteins	8484	366		1	1	193	8291	5	18	188	8273	8484	0.068062753942915
R1	cpdb	0	network_modules	132	TRUE	0.009349270796674185	583	38	9	0.23684210526315788	0.015437392795883362	GO:0051129	GO:BP	negative regulation of cellular component organization	16175	13513		1	1	583	15592	9	29	574	15563	16175	0.05227579818373126
R1	cpdb	0	network_modules	133	TRUE	6.054379685010503e-5	144	23	6	0.2608695652173913	0.041666666666666664	GO:0007030	GO:BP	Golgi organization	16175	2635		0	0.3333333333333333	144	16031	6	17	138	16014	16175	0.10122249993635847
R1	cpdb	0	network_modules	133	TRUE	1.6165865680074247e-4	165	13	5	0.38461538461538464	0.030303030303030304	KEGG:04140	KEGG	Autophagy - animal	8484	277		NA	1	165	8319	5	8	160	8311	8484	0.10359027782031241
R1	cpdb	0	network_modules	133	TRUE	5.023221767054319e-4	13	20	3	0.15	0.23076923076923078	REAC:R-HSA-162658	REAC	Golgi Cisternae Pericentriolar Stack Reorganization	10916	1083		0	0.5	13	10903	3	17	10	10886	10916	0.18485438162727327
R1	cpdb	0	network_modules	133	TRUE	0.002105343104654225	16	23	3	0.13043478260869565	0.1875	GO:0048313	GO:BP	Golgi inheritance	16175	12650		0.5	1	16	16159	3	20	13	16139	16175	0.15538715721260482
R1	cpdb	0	network_modules	133	TRUE	0.002105343104654225	16	23	3	0.13043478260869565	0.1875	GO:0048308	GO:BP	organelle inheritance	16175	12646		0.5	1	16	16159	3	20	13	16139	16175	0.15538715721260482
R1	cpdb	0	network_modules	133	TRUE	0.003228851722256244	3	20	2	0.1	0.6666666666666666	REAC:R-HSA-5624958	REAC	ARL13B-mediated ciliary trafficking of INPP5E	10916	32		1	1	3	10913	2	18	1	10895	10916	0.257760921428001
R1	cpdb	0	network_modules	134	TRUE	6.324331296801714e-18	96	19	12	0.631578947368421	0.125	KEGG:03015	KEGG	mRNA surveillance pathway	8484	210		0	0.07142857142857142	96	8388	12	7	84	8381	8484	0.277827606974125
R1	cpdb	0	network_modules	134	TRUE	9.4377339011793e-17	119	19	12	0.631578947368421	0.10084033613445378	KEGG:04660	KEGG	T cell receptor signaling pathway	8484	338		0.07692307692307693	0.14285714285714285	119	8365	12	7	107	8358	8484	0.24878915290778056
R1	cpdb	0	network_modules	134	TRUE	1.0478282242511146e-16	120	19	12	0.631578947368421	0.1	KEGG:04152	KEGG	AMPK signaling pathway	8484	286		0.15384615384615385	0.2857142857142857	120	8364	12	7	108	8357	8484	0.24771788323532226
R1	cpdb	0	network_modules	134	TRUE	1.0478282242511146e-16	120	19	12	0.631578947368421	0.1	KEGG:04071	KEGG	Sphingolipid signaling pathway	8484	260		0.15384615384615385	0.2857142857142857	120	8364	12	7	108	8357	8484	0.24771788323532226
R1	cpdb	0	network_modules	134	TRUE	3.126495573344143e-16	131	19	12	0.631578947368421	0.0916030534351145	KEGG:04728	KEGG	Dopaminergic synapse	8484	358		0.3076923076923077	0.35714285714285715	131	8353	12	7	119	8346	8484	0.23674737260484957
R1	cpdb	0	network_modules	134	TRUE	3.3906175164773653e-16	356	19	15	0.7894736842105263	0.042134831460674156	KEGG:04151	KEGG	PI3K-Akt signaling pathway	8484	285		0.38461538461538464	0.42857142857142855	356	8128	15	4	341	8124	8484	0.17663042019513298
R1	cpdb	0	network_modules	134	TRUE	2.137921769951224e-15	153	19	12	0.631578947368421	0.0784313725490196	KEGG:04261	KEGG	Adrenergic signaling in cardiomyocytes	8484	297		0.46153846153846156	0.5	153	8331	12	7	141	8324	8484	0.21843192768384512
R1	cpdb	0	network_modules	134	TRUE	2.439600073170453e-14	14	20	7	0.35	0.5	REAC:R-HSA-5467337	REAC	APC truncation mutants have impaired AXIN binding	10916	22		0	0.07407407407407407	14	10902	7	13	7	10889	10916	0.4174472333836792
R1	cpdb	0	network_modules	134	TRUE	2.439600073170453e-14	14	20	7	0.35	0.5	REAC:R-HSA-5467340	REAC	AXIN missense mutants destabilize the destruction complex	10916	42		0	0.07407407407407407	14	10902	7	13	7	10889	10916	0.4174472333836792
R1	cpdb	0	network_modules	134	TRUE	2.439600073170453e-14	14	20	7	0.35	0.5	REAC:R-HSA-5467348	REAC	Truncations of AMER1 destabilize the destruction complex	10916	2609		0	0.07407407407407407	14	10902	7	13	7	10889	10916	0.4174472333836792
R1	cpdb	0	network_modules	134	TRUE	2.439600073170453e-14	14	20	7	0.35	0.5	REAC:R-HSA-4839735	REAC	Signaling by AXIN mutants	10916	2222		0	0.07407407407407407	14	10902	7	13	7	10889	10916	0.4174472333836792
R1	cpdb	0	network_modules	134	TRUE	2.439600073170453e-14	14	20	7	0.35	0.5	REAC:R-HSA-4839744	REAC	Signaling by APC mutants	10916	2221		0	0.07407407407407407	14	10902	7	13	7	10889	10916	0.4174472333836792
R1	cpdb	0	network_modules	134	TRUE	2.439600073170453e-14	14	20	7	0.35	0.5	REAC:R-HSA-4839748	REAC	Signaling by AMER1 mutants	10916	2220		0	0.07407407407407407	14	10902	7	13	7	10889	10916	0.4174472333836792
R1	cpdb	0	network_modules	134	TRUE	4.569478321236038e-14	15	20	7	0.35	0.4666666666666667	REAC:R-HSA-4839743	REAC	Signaling by CTNNB1 phospho-site mutants	10916	2228		0.075	0.14814814814814814	15	10901	7	13	8	10888	10916	0.4032048891562805
R1	cpdb	0	network_modules	134	TRUE	4.569478321236038e-14	15	20	7	0.35	0.4666666666666667	REAC:R-HSA-5339716	REAC	Signaling by GSK3beta mutants	10916	2257		0.075	0.14814814814814814	15	10901	7	13	8	10888	10916	0.4032048891562805
R1	cpdb	0	network_modules	134	TRUE	4.569478321236038e-14	15	20	7	0.35	0.4666666666666667	REAC:R-HSA-5358752	REAC	CTNNB1 T41 mutants aren't phosphorylated	10916	292		0.075	0.14814814814814814	15	10901	7	13	8	10888	10916	0.4032048891562805
R1	cpdb	0	network_modules	134	TRUE	4.569478321236038e-14	15	20	7	0.35	0.4666666666666667	REAC:R-HSA-5358751	REAC	CTNNB1 S45 mutants aren't phosphorylated	10916	291		0.075	0.14814814814814814	15	10901	7	13	8	10888	10916	0.4032048891562805
R1	cpdb	0	network_modules	134	TRUE	4.569478321236038e-14	15	20	7	0.35	0.4666666666666667	REAC:R-HSA-5358749	REAC	CTNNB1 S37 mutants aren't phosphorylated	10916	290		0.075	0.14814814814814814	15	10901	7	13	8	10888	10916	0.4032048891562805
R1	cpdb	0	network_modules	134	TRUE	4.569478321236038e-14	15	20	7	0.35	0.4666666666666667	REAC:R-HSA-5358747	REAC	CTNNB1 S33 mutants aren't phosphorylated	10916	289		0.075	0.14814814814814814	15	10901	7	13	8	10888	10916	0.4032048891562805
R1	cpdb	0	network_modules	134	TRUE	1.3781178265206802e-13	17	20	7	0.35	0.4117647058823529	REAC:R-HSA-196299	REAC	Beta-catenin phosphorylation cascade	10916	217		0.15	0.1728395061728395	17	10899	7	13	10	10886	10916	0.3785807282292146
R1	cpdb	0	network_modules	134	TRUE	1.3781178265206802e-13	17	20	7	0.35	0.4117647058823529	REAC:R-HSA-432142	REAC	Platelet sensitization by LDL	10916	1766		0.15	0.1728395061728395	17	10899	7	13	10	10886	10916	0.3785807282292146
R1	cpdb	0	network_modules	134	TRUE	5.476019045899858e-13	20	20	7	0.35	0.35	REAC:R-HSA-389513	REAC	Co-inhibition by CTLA4	10916	376		0.175	0.18518518518518517	20	10896	7	13	13	10883	10916	0.3488069016152716
R1	cpdb	0	network_modules	134	TRUE	1.836314281781534e-11	31	20	7	0.35	0.22580645161290322	REAC:R-HSA-4641262	REAC	Disassembly of the destruction complex and recruitment of AXIN to the membrane	10916	746		0.1875	0.19753086419753085	31	10885	7	13	24	10872	10916	0.27949867838792714
R1	cpdb	0	network_modules	134	TRUE	2.399386151202272e-11	330	19	12	0.631578947368421	0.03636363636363636	KEGG:05165	KEGG	Human papillomavirus infection	8484	446		0.5384615384615384	0.5714285714285714	330	8154	12	7	318	8147	8484	0.14522572066652004
R1	cpdb	0	network_modules	134	TRUE	2.9770763029640155e-11	33	20	7	0.35	0.21212121212121213	REAC:R-HSA-5673000	REAC	RAF activation	10916	1839		0.2	0.20987654320987653	33	10883	7	13	26	10870	10916	0.2707785597319409
R1	cpdb	0	network_modules	134	TRUE	3.74499524573694e-11	34	20	7	0.35	0.20588235294117646	REAC:R-HSA-4791275	REAC	Signaling by WNT in cancer	10916	2315		0.2125	0.2222222222222222	34	10882	7	13	27	10869	10916	0.2667086258479015
R1	cpdb	0	network_modules	134	TRUE	1.8624438134655865e-10	42	20	7	0.35	0.16666666666666666	REAC:R-HSA-5675221	REAC	Negative regulation of MAPK pathway	10916	1573		0.225	0.2345679012345679	42	10874	7	13	35	10861	10916	0.23954828240390091
R1	cpdb	0	network_modules	134	TRUE	1.893605127241287e-10	131	19	9	0.47368421052631576	0.06870229007633588	KEGG:04114	KEGG	Oocyte meiosis	8484	268		0.6153846153846154	0.6428571428571429	131	8353	9	10	122	8343	8484	0.17607726791653583
R1	cpdb	0	network_modules	134	TRUE	6.749317135258381e-10	228	20	10	0.5	0.043859649122807015	REAC:R-HSA-68882	REAC	Mitotic Anaphase	10916	1479		0.2375	0.24691358024691357	228	10688	10	10	218	10678	10916	0.14353819919521604
R1	cpdb	0	network_modules	134	TRUE	7.051521901621948e-10	229	20	10	0.5	0.043668122270742356	REAC:R-HSA-2555396	REAC	Mitotic Metaphase and Anaphase	10916	1482		0.25	0.25925925925925924	229	10687	10	10	219	10677	10916	0.1432037683842899
R1	cpdb	0	network_modules	134	TRUE	7.314203078774271e-10	92	20	8	0.4	0.08695652173913043	REAC:R-HSA-141444	REAC	Amplification  of signal from unattached  kinetochores via a MAD2  inhibitory signal	10916	143		0.2625	0.2839506172839506	92	10824	8	12	84	10812	10916	0.18351383298323612
R1	cpdb	0	network_modules	134	TRUE	7.314203078774271e-10	92	20	8	0.4	0.08695652173913043	REAC:R-HSA-141424	REAC	Amplification of signal from the kinetochores	10916	144		0.2625	0.2839506172839506	92	10824	8	12	84	10812	10916	0.18351383298323612
R1	cpdb	0	network_modules	134	TRUE	9.84861525377732e-10	157	19	9	0.47368421052631576	0.05732484076433121	KEGG:04110	KEGG	Cell cycle	8484	264		0.6923076923076923	0.7142857142857143	157	8327	9	10	148	8317	8484	0.16001175412902605
R1	cpdb	0	network_modules	134	TRUE	1.3360414455884718e-9	99	20	8	0.4	0.08080808080808081	REAC:R-HSA-199418	REAC	Negative regulation of the PI3K/AKT network	10916	1580		0.2875	0.2962962962962963	99	10817	8	12	91	10805	10916	0.17667446760410127
R1	cpdb	0	network_modules	134	TRUE	2.93572791972591e-9	109	20	8	0.4	0.07339449541284404	REAC:R-HSA-69618	REAC	Mitotic Spindle Checkpoint	10916	1486		0.3	0.30864197530864196	109	10807	8	12	101	10795	10916	0.1680583447174561
R1	cpdb	0	network_modules	134	TRUE	4.5437345219059485e-9	115	20	8	0.4	0.06956521739130435	REAC:R-HSA-9648025	REAC	EML4 and NUDC in mitotic spindle formation	10916	817		0.3125	0.32098765432098764	115	10801	8	12	107	10789	10916	0.16343027652504946
R1	cpdb	0	network_modules	134	TRUE	5.30502831172176e-9	188	20	9	0.45	0.047872340425531915	REAC:R-HSA-2467813	REAC	Separation of Sister Chromatids	10916	2204		0.325	0.3333333333333333	188	10728	9	11	179	10717	10916	0.14251855775545308
R1	cpdb	0	network_modules	134	TRUE	5.848575217670914e-9	67	20	7	0.35	0.1044776119402985	REAC:R-HSA-388841	REAC	Regulation of T cell activation by CD28 family	10916	2007		0.3375	0.345679012345679	67	10849	7	13	60	10836	10916	0.18862410192624307
R1	cpdb	0	network_modules	134	TRUE	6.917431096932264e-9	406	20	11	0.55	0.027093596059113302	REAC:R-HSA-68886	REAC	M Phase	10916	1343		0.35	0.35802469135802467	406	10510	11	9	395	10501	10916	0.11610059716375203
R1	cpdb	0	network_modules	134	TRUE	7.84922114509598e-9	123	20	8	0.4	0.06504065040650407	REAC:R-HSA-2500257	REAC	Resolution of Sister Chromatid Cohesion	10916	2079		0.3625	0.37037037037037035	123	10793	8	12	115	10781	10916	0.15778720321234876
R1	cpdb	0	network_modules	134	TRUE	1.7707560415588693e-8	136	20	8	0.4	0.058823529411764705	REAC:R-HSA-5663220	REAC	RHO GTPases Activate Formins	10916	1848		0.375	0.38271604938271603	136	10780	8	12	128	10768	10916	0.14968698793147087
R1	cpdb	0	network_modules	134	TRUE	2.745833232199164e-8	83	20	7	0.35	0.08433734939759036	REAC:R-HSA-195253	REAC	Degradation of beta-catenin by the destruction complex	10916	724		0.3875	0.3950617283950617	83	10833	7	13	76	10820	10916	0.16887324702021245
R1	cpdb	0	network_modules	134	TRUE	3.25743955478205e-8	85	20	7	0.35	0.08235294117647059	REAC:R-HSA-418346	REAC	Platelet homeostasis	10916	1765		0.4	0.4074074074074074	85	10831	7	13	78	10818	10916	0.16680077974384674
R1	cpdb	0	network_modules	134	TRUE	5.739286837922834e-8	92	20	7	0.35	0.07608695652173914	REAC:R-HSA-6811558	REAC	PI5P, PP2A and IER3 Regulate PI3K/AKT Signaling	10916	1677		0.4125	0.41975308641975306	92	10824	7	13	85	10811	10916	0.16008087162205087
R1	cpdb	0	network_modules	134	TRUE	7.600349193546295e-8	101	19	7	0.3684210526315789	0.06930693069306931	KEGG:05142	KEGG	Chagas disease	8484	434		0.7692307692307693	0.7857142857142857	101	8383	7	12	94	8371	8484	0.15573382070116132
R1	cpdb	0	network_modules	134	TRUE	9.654654496807548e-8	7	20	4	0.2	0.5714285714285714	REAC:R-HSA-163767	REAC	PP2A-mediated dephosphorylation of key metabolic factors	10916	1699		0.425	0.43209876543209874	7	10909	4	16	3	10893	10916	0.33739509580618854
R1	cpdb	0	network_modules	134	TRUE	2.1076209612555789e-7	25	20	5	0.25	0.2	REAC:R-HSA-69273	REAC	Cyclin A/B1/B2 associated events during G2/M transition	10916	418		0.4375	0.4444444444444444	25	10891	5	15	20	10876	10916	0.22201599009988765
R1	cpdb	0	network_modules	134	TRUE	3.739530615318297e-7	199	20	8	0.4	0.04020100502512563	REAC:R-HSA-68877	REAC	Mitotic Prometaphase	10916	1484		0.45	0.4567901234567901	199	10717	8	12	191	10705	10916	0.12225974464573969
R1	cpdb	0	network_modules	134	TRUE	4.9469970514384355e-07	105	27	7	0.25925925925925924	0.06666666666666667	GO:0006470	GO:BP	protein dephosphorylation	16175	2209		0	0.3333333333333333	105	16070	7	20	98	16050	16175	0.12870217697367772
R1	cpdb	0	network_modules	134	TRUE	5.772429178667442e-7	10	20	4	0.2	0.4	REAC:R-HSA-2465910	REAC	MASTL Facilitates Mitotic Progression	10916	1354		0.4625	0.4691358024691358	10	10906	4	16	6	10890	10916	0.2819346149013008
R1	cpdb	0	network_modules	134	TRUE	5.777476434621913e-7	318	20	9	0.45	0.02830188679245283	REAC:R-HSA-195258	REAC	RHO GTPase Effectors	10916	1846		0.475	0.48148148148148145	318	10598	9	11	309	10587	10916	0.10721753799928686
R1	cpdb	0	network_modules	134	TRUE	1.3574531990275234e-6	12	20	4	0.2	0.3333333333333333	REAC:R-HSA-9634600	REAC	Regulation of glycolysis by fructose 2,6-bisphosphate metabolism	10916	2038		0.4875	0.49382716049382713	12	10904	4	16	8	10888	10916	0.25715663631504615
R1	cpdb	0	network_modules	134	TRUE	1.6780936609376944e-6	157	19	7	0.3684210526315789	0.044585987261146494	KEGG:04390	KEGG	Hippo signaling pathway	8484	310		0.8461538461538461	0.8571428571428571	157	8327	7	12	150	8315	8484	0.12300795921725585
R1	cpdb	0	network_modules	134	TRUE	1.753683214087639e-6	158	19	7	0.3684210526315789	0.04430379746835443	KEGG:05160	KEGG	Hepatitis C	8484	441		0.9230769230769231	0.9285714285714286	158	8326	7	12	151	8314	8484	0.12258413265690535
R1	cpdb	0	network_modules	134	TRUE	1.9584652102066254e-6	13	20	4	0.2	0.3076923076923077	REAC:R-HSA-113501	REAC	Inhibition of replication initiation of damaged DNA by RB1/E2F1	10916	1198		0.5	0.5185185185185185	13	10903	4	16	9	10887	10916	0.24696563593173385
R1	cpdb	0	network_modules	134	TRUE	1.9584652102066254e-6	13	20	4	0.2	0.3076923076923077	REAC:R-HSA-202670	REAC	ERKs are inactivated	10916	829		0.5	0.5185185185185185	13	10903	4	16	9	10887	10916	0.24696563593173385
R1	cpdb	0	network_modules	134	TRUE	2.4946005691058754e-6	253	20	8	0.4	0.03162055335968379	REAC:R-HSA-1257604	REAC	PIP3 activates AKT signaling	10916	1679		0.525	0.5308641975308642	253	10663	8	12	245	10651	10916	0.10729572757828863
R1	cpdb	0	network_modules	134	TRUE	2.9116134077282284e-6	170	19	7	0.3684210526315789	0.041176470588235294	KEGG:04530	KEGG	Tight junction	8484	317		1	1	170	8314	7	12	163	8302	8484	0.11778551361076843
R1	cpdb	0	network_modules	134	TRUE	5.308154050476657e-6	46	20	5	0.25	0.10869565217391304	REAC:R-HSA-69231	REAC	Cyclin D associated events in G1	10916	420		0.5375	0.5555555555555556	46	10870	5	15	41	10855	10916	0.16255803292175477
R1	cpdb	0	network_modules	134	TRUE	5.308154050476657e-6	46	20	5	0.25	0.10869565217391304	REAC:R-HSA-69236	REAC	G1 Phase	10916	1000		0.5375	0.5555555555555556	46	10870	5	15	41	10855	10916	0.16255803292175477
R1	cpdb	0	network_modules	134	TRUE	7.075194573657388e-6	289	20	8	0.4	0.02768166089965398	REAC:R-HSA-69620	REAC	Cell Cycle Checkpoints	10916	321		0.5625	0.5679012345679012	289	10627	8	12	281	10615	10916	0.0996805687902379
R1	cpdb	0	network_modules	134	TRUE	7.87675523382043e-6	293	20	8	0.4	0.027303754266211604	REAC:R-HSA-9006925	REAC	Intracellular signaling by second messengers	10916	1266		0.575	0.5802469135802469	293	10623	8	12	285	10611	10916	0.09891931691508489
R1	cpdb	0	network_modules	134	TRUE	1.7095270164818253e-5	174	27	7	0.25925925925925924	0.040229885057471264	GO:0016311	GO:BP	dephosphorylation	16175	5199		0.5	0.6666666666666666	174	16001	7	20	167	15981	16175	0.09850275079917419
R1	cpdb	0	network_modules	134	TRUE	1.9825990907359984e-5	22	20	4	0.2	0.18181818181818182	REAC:R-HSA-198753	REAC	ERK/MAPK targets	10916	828		0.5875	0.6049382716049383	22	10894	4	16	18	10878	10916	0.18913477343345228
R1	cpdb	0	network_modules	134	TRUE	1.9825990907359984e-5	22	20	4	0.2	0.18181818181818182	REAC:R-HSA-113510	REAC	E2F mediated regulation of DNA replication	10916	809		0.5875	0.6049382716049383	22	10894	4	16	18	10878	10916	0.18913477343345228
R1	cpdb	0	network_modules	134	TRUE	2.3971717563439126e-5	23	20	4	0.2	0.17391304347826086	REAC:R-HSA-180024	REAC	DARPP-32 events	10916	434		0.6125	0.6172839506172839	23	10893	4	16	19	10877	10916	0.18490035392667054
R1	cpdb	0	network_modules	134	TRUE	3.595108927191401e-5	231	20	7	0.35	0.030303030303030304	REAC:R-HSA-201681	REAC	TCF dependent signaling in response to WNT	10916	2421		0.625	0.6296296296296297	231	10685	7	13	224	10672	10916	0.09788908158225786
R1	cpdb	0	network_modules	134	TRUE	8.43835791398879e-5	31	20	4	0.2	0.12903225806451613	REAC:R-HSA-450282	REAC	MAPK targets/ Nuclear events mediated by MAP kinases	10916	1349		0.6375	0.6419753086419753	31	10885	4	16	27	10869	10916	0.15873365411296622
R1	cpdb	0	network_modules	134	TRUE	8.943208438714642e-5	264	20	7	0.35	0.026515151515151516	REAC:R-HSA-5673001	REAC	RAF/MAP kinase cascade	10916	1841		0.65	0.654320987654321	264	10652	7	13	257	10639	10916	0.09086548152223867
R1	cpdb	0	network_modules	134	TRUE	1.015969903724245e-4	269	20	7	0.35	0.026022304832713755	REAC:R-HSA-5684996	REAC	MAPK1/MAPK3 signaling	10916	1351		0.6625	0.6666666666666666	269	10647	7	13	262	10634	10916	0.08991160097578735
R1	cpdb	0	network_modules	134	TRUE	1.5704773676287806e-4	36	20	4	0.2	0.1111111111111111	REAC:R-HSA-6804757	REAC	Regulation of TP53 Degradation	10916	2017		0.675	0.6790123456790124	36	10880	4	16	32	10864	10916	0.14699015605274104
R1	cpdb	0	network_modules	134	TRUE	1.7587709690905197e-4	37	20	4	0.2	0.10810810810810811	REAC:R-HSA-6806003	REAC	Regulation of TP53 Expression and Degradation	10916	2019		0.6875	0.691358024691358	37	10879	4	16	33	10863	10916	0.14492933206126182
R1	cpdb	0	network_modules	134	TRUE	2.5400024084467796e-4	308	20	7	0.35	0.022727272727272728	REAC:R-HSA-5683057	REAC	MAPK family signaling cascades	10916	1348		0.7	0.7037037037037037	308	10608	7	13	301	10595	10916	0.08325647776733831
R1	cpdb	0	network_modules	134	TRUE	3.799922165234994e-4	327	20	7	0.35	0.021406727828746176	REAC:R-HSA-195721	REAC	Signaling by WNT	10916	2314		0.7125	0.7160493827160493	327	10589	7	13	320	10576	10916	0.08043652109892686
R1	cpdb	0	network_modules	134	TRUE	4.815266117750565e-4	112	20	5	0.25	0.044642857142857144	REAC:R-HSA-187037	REAC	Signaling by NTRK1 (TRKA)	10916	2284		0.725	0.7283950617283951	112	10804	5	15	107	10789	10916	0.10192574021113883
R1	cpdb	0	network_modules	134	TRUE	6.385722337373682e-4	14	20	3	0.15	0.21428571428571427	REAC:R-HSA-1295596	REAC	Spry regulation of FGF signaling	10916	2350		0.7375	0.7407407407407407	14	10902	3	17	11	10885	10916	0.17802864463696338
R1	cpdb	0	network_modules	134	TRUE	9.801247097485334e-4	16	20	3	0.15	0.1875	REAC:R-HSA-2995383	REAC	Initiation of Nuclear Envelope (NE) Reformation	10916	1201		0.75	0.7530864197530864	16	10900	3	17	13	10883	10916	0.166340644144421
R1	cpdb	0	network_modules	134	TRUE	0.001045071457110131	131	20	5	0.25	0.03816793893129771	REAC:R-HSA-166520	REAC	Signaling by NTRKs	10916	2287		0.7625	0.7654320987654321	131	10785	5	15	126	10770	10916	0.0936429043046318
R1	cpdb	0	network_modules	134	TRUE	0.0013510482149275934	61	20	4	0.2	0.06557377049180328	REAC:R-HSA-198725	REAC	Nuclear Events (kinase and transcription factor activation)	10916	1614		0.775	0.7777777777777778	61	10855	4	16	57	10839	10916	0.11173466451223024
R1	cpdb	0	network_modules	134	TRUE	0.0015385160654235773	63	20	4	0.2	0.06349206349206349	REAC:R-HSA-450294	REAC	MAP kinase activation	10916	1345		0.7875	0.7901234567901234	63	10853	4	16	59	10837	10916	0.10985329919151911
R1	cpdb	0	network_modules	134	TRUE	0.0018409896404573047	147	20	5	0.25	0.034013605442176874	REAC:R-HSA-453279	REAC	Mitotic G1 phase and G1/S transition	10916	1480		0.8	0.8024691358024691	147	10769	5	15	142	10754	10916	0.08792073957049192
R1	cpdb	0	network_modules	134	TRUE	0.001950308599356037	418	20	7	0.35	0.01674641148325359	REAC:R-HSA-5663202	REAC	Diseases of signal transduction by growth factor receptors and second messengers	10916	773		0.8125	0.8148148148148148	418	10498	7	13	411	10485	10916	0.06959065483017658
R1	cpdb	0	network_modules	134	TRUE	0.002091109953423047	68	20	4	0.2	0.058823529411764705	REAC:R-HSA-70171	REAC	Glycolysis	10916	1074		0.825	0.8271604938271605	68	10848	4	16	64	10832	10916	0.10551242236750505
R1	cpdb	0	network_modules	134	TRUE	0.0024860987995126726	71	20	4	0.2	0.056338028169014086	REAC:R-HSA-448424	REAC	Interleukin-17 signaling	10916	1238		0.8375	0.8395061728395061	71	10845	4	16	67	10829	10916	0.10312703612740909
R1	cpdb	0	network_modules	134	TRUE	0.0030743851977927056	23	20	3	0.15	0.13043478260869565	REAC:R-HSA-5654732	REAC	Negative regulation of FGFR3 signaling	10916	1570		0.85	0.8518518518518519	23	10893	3	17	20	10876	10916	0.13818309942561657
R1	cpdb	0	network_modules	134	TRUE	0.0030953492070421736	75	20	4	0.2	0.05333333333333334	REAC:R-HSA-9833482	REAC	PKR-mediated signaling	10916	1692		0.8625	0.8641975308641975	75	10841	4	16	71	10825	10916	0.1001677585373263
R1	cpdb	0	network_modules	134	TRUE	0.0044976964357209	26	20	3	0.15	0.11538461538461539	REAC:R-HSA-5654726	REAC	Negative regulation of FGFR1 signaling	10916	1568		0.875	0.8765432098765432	26	10890	3	17	23	10873	10916	0.12974307774804228
R1	cpdb	0	network_modules	134	TRUE	0.0050539975353607975	27	20	3	0.15	0.1111111111111111	REAC:R-HSA-5654733	REAC	Negative regulation of FGFR4 signaling	10916	1571		0.8875	0.8888888888888888	27	10889	3	17	24	10872	10916	0.1272445913898661
R1	cpdb	0	network_modules	134	TRUE	0.005338479828561265	86	20	4	0.2	0.046511627906976744	REAC:R-HSA-70326	REAC	Glucose metabolism	10916	1053		0.9	0.9012345679012346	86	10830	4	16	82	10814	10916	0.09310175028300605
R1	cpdb	0	network_modules	134	TRUE	0.0056538647407706	28	20	3	0.15	0.10714285714285714	REAC:R-HSA-5654727	REAC	Negative regulation of FGFR2 signaling	10916	1569		0.9125	0.9135802469135802	28	10888	3	17	25	10871	10916	0.12487985211920069
R1	cpdb	0	network_modules	134	TRUE	0.006116467168286585	89	20	4	0.2	0.0449438202247191	REAC:R-HSA-111885	REAC	Opioid Signalling	10916	1642		0.925	0.9259259259259259	89	10827	4	16	85	10811	10916	0.09140091303903125
R1	cpdb	0	network_modules	134	TRUE	0.006169238979555305	19	27	3	0.1111111111111111	0.15789473684210525	GO:0043029	GO:BP	T cell homeostasis	16175	10484		1	1	19	16156	3	24	16	16132	16175	0.13123957709566395
R1	cpdb	0	network_modules	134	TRUE	0.007277277981161174	195	20	5	0.25	0.02564102564102564	REAC:R-HSA-69275	REAC	G2/M Transition	10916	1008		0.9375	0.9382716049382716	195	10721	5	15	190	10706	10916	0.07508498656754495
R1	cpdb	0	network_modules	134	TRUE	0.007644559882252988	197	20	5	0.25	0.025380710659898477	REAC:R-HSA-453274	REAC	Mitotic G2-G2/M phases	10916	1481		0.95	0.9506172839506173	197	10719	5	15	192	10704	10916	0.07465087513667958
R1	cpdb	0	network_modules	134	TRUE	0.007918938645475231	95	20	4	0.2	0.042105263157894736	REAC:R-HSA-168176	REAC	Toll Like Receptor 5 (TLR5) Cascade	10916	2517		0.9625	0.9876543209876543	95	10821	4	16	91	10805	10916	0.08823848456947206
R1	cpdb	0	network_modules	134	TRUE	0.007918938645475231	95	20	4	0.2	0.042105263157894736	REAC:R-HSA-168142	REAC	Toll Like Receptor 10 (TLR10) Cascade	10916	2513		0.9625	0.9876543209876543	95	10821	4	16	91	10805	10916	0.08823848456947206
R1	cpdb	0	network_modules	134	TRUE	0.007918938645475231	95	20	4	0.2	0.042105263157894736	REAC:R-HSA-975871	REAC	MyD88 cascade initiated on plasma membrane	10916	1497		0.9625	0.9876543209876543	95	10821	4	16	91	10805	10916	0.08823848456947206
R1	cpdb	0	network_modules	134	TRUE	0.008520256921361111	32	20	3	0.15	0.09375	REAC:R-HSA-5654741	REAC	Signaling by FGFR3	10916	2249		1	1	32	10884	3	17	29	10867	10916	0.11654548499042781
R1	cpdb	0	network_modules	135	TRUE	1.8206776114512959e-7	510	20	10	0.5	0.0196078431372549	GO:0007169	GO:BP	cell surface receptor protein tyrosine kinase signaling pathway	16175	2733		0	0.07692307692307693	510	15665	10	10	500	15655	16175	0.09432725016471966
R1	cpdb	0	network_modules	135	TRUE	2.0551871194794322e-7	235	16	8	0.5	0.03404255319148936	KEGG:04014	KEGG	Ras signaling pathway	8484	247		0	0.1	235	8249	8	8	227	8241	8484	0.12509914058290103
R1	cpdb	0	network_modules	135	TRUE	1.2699155364867056e-5	790	20	10	0.5	0.012658227848101266	GO:0007167	GO:BP	enzyme-linked receptor protein signaling pathway	16175	2731		0.08333333333333333	0.15384615384615385	790	15385	10	10	780	15375	16175	0.07365009720634341
R1	cpdb	0	network_modules	135	TRUE	6.837304917726929e-5	686	20	9	0.45	0.013119533527696793	GO:0008284	GO:BP	positive regulation of cell population proliferation	16175	3151		0.16666666666666666	0.23076923076923078	686	15489	9	11	677	15478	16175	0.07116302099005319
R1	cpdb	0	network_modules	135	TRUE	1.3803838725495707e-4	227	16	6	0.375	0.02643171806167401	KEGG:04810	KEGG	Regulation of actin cytoskeleton	8484	365		0.1111111111111111	0.2	227	8257	6	10	221	8247	8484	0.09380575647615531
R1	cpdb	0	network_modules	135	TRUE	2.4414876064715054e-4	214	20	6	0.3	0.028037383177570093	GO:0018108	GO:BP	peptidyl-tyrosine phosphorylation	16175	5327		0.25	0.3076923076923077	214	15961	6	14	208	15947	16175	0.08830842561366162
R1	cpdb	0	network_modules	135	TRUE	2.477009851770511e-4	251	16	6	0.375	0.02390438247011952	KEGG:04020	KEGG	Calcium signaling pathway	8484	250		0.2222222222222222	0.3	251	8233	6	10	245	8223	8484	0.08861257846595093
R1	cpdb	0	network_modules	135	TRUE	2.509699214441341e-4	215	20	6	0.3	0.027906976744186046	GO:0018212	GO:BP	peptidyl-tyrosine modification	16175	5371		0.3333333333333333	0.38461538461538464	215	15960	6	14	209	15946	16175	0.08808658348310448
R1	cpdb	0	network_modules	135	TRUE	3.1202491050084225e-4	418	16	7	0.4375	0.01674641148325359	REAC:R-HSA-5663202	REAC	Diseases of signal transduction by growth factor receptors and second messengers	10916	773		0	0.125	418	10498	7	9	411	10489	10916	0.07970170807886304
R1	cpdb	0	network_modules	135	TRUE	3.4320055235528607e-4	147	16	5	0.3125	0.034013605442176874	KEGG:05224	KEGG	Breast cancer	8484	475		0.3333333333333333	0.4	147	8337	5	11	142	8326	8484	0.09832946607739469
R1	cpdb	0	network_modules	135	TRUE	3.548127483232431e-4	148	16	5	0.3125	0.033783783783783786	KEGG:05226	KEGG	Gastric cancer	8484	477		0.4444444444444444	0.5	148	8336	5	11	143	8325	8484	0.09796345213203793
R1	cpdb	0	network_modules	135	TRUE	5.047340381118985e-4	72	16	4	0.25	0.05555555555555555	KEGG:05218	KEGG	Melanoma	8484	469		0.5555555555555556	0.6	72	8412	4	12	68	8400	8484	0.11444468940236965
R1	cpdb	0	network_modules	135	TRUE	6.32968925777194e-4	65	16	4	0.25	0.06153846153846154	REAC:R-HSA-2219530	REAC	Constitutive Signaling by Aberrant PI3K in Cancer	10916	401		0.14285714285714285	0.25	65	10851	4	12	61	10839	10916	0.1215316523954654
R1	cpdb	0	network_modules	135	TRUE	7.066400889182899e-4	301	16	6	0.375	0.019933554817275746	KEGG:04010	KEGG	MAPK signaling pathway	8484	243		0.6666666666666666	0.7	301	8183	6	10	295	8173	8484	0.07978071475475064
R1	cpdb	0	network_modules	135	TRUE	0.001246572844341064	61	20	4	0.2	0.06557377049180328	GO:0008543	GO:BP	fibroblast growth factor receptor signaling pathway	16175	3191		0.4166666666666667	0.46153846153846156	61	16114	4	16	57	16098	16175	0.112642386196805
R1	cpdb	0	network_modules	135	TRUE	0.001652232337180095	97	16	4	0.25	0.041237113402061855	KEGG:05215	KEGG	Prostate cancer	8484	466		0.7777777777777778	0.8	97	8387	4	12	93	8375	8484	0.0975418270735957
R1	cpdb	0	network_modules	135	TRUE	0.0018410821363826141	356	16	6	0.375	0.016853932584269662	KEGG:04151	KEGG	PI3K-Akt signaling pathway	8484	285		0.8888888888888888	0.9	356	8128	6	10	350	8118	8484	0.07220180118219358
R1	cpdb	0	network_modules	135	TRUE	0.0019351698119499442	3	16	2	0.125	0.6666666666666666	REAC:R-HSA-1307965	REAC	betaKlotho-mediated ligand binding	10916	2689		0.2857142857142857	0.375	3	10913	2	14	1	10899	10916	0.2882913972771879
R1	cpdb	0	network_modules	135	TRUE	0.001945915781227723	210	16	5	0.3125	0.023809523809523808	KEGG:04015	KEGG	Rap1 signaling pathway	8484	248		1	1	210	8274	5	11	205	8263	8484	0.080503436044494045
R1	cpdb	0	network_modules	135	TRUE	0.002134484362723971	502	20	7	0.35	0.013944223107569721	GO:0071363	GO:BP	cellular response to growth factor stimulus	16175	16615		0.5	0.5384615384615384	502	15673	7	13	495	15660	16175	0.0647172663031176
R1	cpdb	0	network_modules	135	TRUE	0.002550749961913422	92	16	4	0.25	0.043478260869565216	REAC:R-HSA-2219528	REAC	PI3K/AKT Signaling in Cancer	10916	1674		0.42857142857142855	0.625	92	10824	4	12	88	10812	10916	0.10124394673811464
R1	cpdb	0	network_modules	135	TRUE	0.002550749961913422	92	16	4	0.25	0.043478260869565216	REAC:R-HSA-6811558	REAC	PI5P, PP2A and IER3 Regulate PI3K/AKT Signaling	10916	1677		0.42857142857142855	0.625	92	10824	4	12	88	10812	10916	0.10124394673811464
R1	cpdb	0	network_modules	135	TRUE	0.002665797376334212	519	20	7	0.35	0.01348747591522158	GO:0070848	GO:BP	response to growth factor	16175	16340		0.5833333333333334	0.6153846153846154	519	15656	7	13	512	15643	16175	0.06347323280293658
R1	cpdb	0	network_modules	135	TRUE	0.003065600230434619	530	20	7	0.35	0.013207547169811321	GO:0043408	GO:BP	regulation of MAPK cascade	16175	10676		0.6666666666666666	0.6923076923076923	530	15645	7	13	523	15632	16175	0.06269876299557108
R1	cpdb	0	network_modules	135	TRUE	0.003415270560442101	99	16	4	0.25	0.04040404040404041	REAC:R-HSA-199418	REAC	Negative regulation of the PI3K/AKT network	10916	1580		0.7142857142857143	0.75	99	10817	4	12	95	10805	10916	0.09737141443533655
R1	cpdb	0	network_modules	135	TRUE	0.0035382216049385912	79	20	4	0.2	0.05063291139240506	GO:0044344	GO:BP	cellular response to fibroblast growth factor stimulus	16175	10963		0.75	0.7692307692307693	79	16096	4	16	75	16080	16175	0.09847499872527904
R1	cpdb	0	network_modules	135	TRUE	0.00391171295483803	81	20	4	0.2	0.04938271604938271	GO:0071774	GO:BP	response to fibroblast growth factor	16175	16903		0.8333333333333334	0.8461538461538461	81	16094	4	16	77	16078	16175	0.09719606833924284
R1	cpdb	0	network_modules	135	TRUE	0.006558104543001729	376	20	6	0.3	0.015957446808510637	GO:0043410	GO:BP	positive regulation of MAPK cascade	16175	10678		0.9166666666666666	0.9230769230769231	376	15799	6	14	370	15785	16175	0.06462363508556267
R1	cpdb	0	network_modules	135	TRUE	0.00660302654103299	595	20	7	0.35	0.011764705882352941	GO:0000165	GO:BP	MAPK cascade	16175	55		1	1	595	15580	7	13	588	15567	16175	0.05854717222293193
R1	cpdb	0	network_modules	135	TRUE	0.008963550075063845	264	16	5	0.3125	0.01893939393939394	REAC:R-HSA-5673001	REAC	RAF/MAP kinase cascade	10916	1841		0.8571428571428571	0.875	264	10652	5	11	259	10641	10916	0.07190522378750179
R1	cpdb	0	network_modules	135	TRUE	0.009810250789718205	269	16	5	0.3125	0.01858736059479554	REAC:R-HSA-5684996	REAC	MAPK1/MAPK3 signaling	10916	1351		1	1	269	10647	5	11	264	10636	10916	0.07113735448205367
R1	cpdb	0	network_modules	136	TRUE	6.500085075067374e-16	202	15	12	0.8	0.0594059405940594	KEGG:04510	KEGG	Focal adhesion	8484	313		0	0.09090909090909091	202	8282	12	3	190	8279	8484	0.21426697326056712
R1	cpdb	0	network_modules	136	TRUE	1.6850314624250495e-12	192	24	11	0.4583333333333333	0.057291666666666664	GO:0007160	GO:BP	cell-matrix adhesion	16175	2724		0	0.07142857142857142	192	15983	11	13	181	15970	16175	0.15891177168895132
R1	cpdb	0	network_modules	136	TRUE	1.925312021380794e-12	279	24	12	0.5	0.043010752688172046	GO:0031589	GO:BP	cell-substrate adhesion	16175	7233		0.07692307692307693	0.14285714285714285	279	15896	12	12	267	15884	16175	0.14293135084027475
R1	cpdb	0	network_modules	136	TRUE	2.5366002771609315e-11	84	15	8	0.5333333333333333	0.09523809523809523	KEGG:05412	KEGG	Arrhythmogenic right ventricular cardiomyopathy	8484	490		0.1	0.18181818181818182	84	8400	8	7	76	8393	8484	0.2224905099109464
R1	cpdb	0	network_modules	136	TRUE	2.6187590939733447e-11	227	15	10	0.6666666666666666	0.04405286343612335	KEGG:04810	KEGG	Regulation of actin cytoskeleton	8484	365		0.2	0.2727272727272727	227	8257	10	5	217	8252	8484	0.1668880859951544
R1	cpdb	0	network_modules	136	TRUE	4.0941816667760055e-11	89	15	8	0.5333333333333333	0.0898876404494382	KEGG:04512	KEGG	ECM-receptor interaction	8484	314		0.3	0.36363636363636365	89	8395	8	7	81	8388	8484	0.2159713614991142
R1	cpdb	0	network_modules	136	TRUE	1.2574531548154314e-10	73	24	8	0.3333333333333333	0.1095890410958904	GO:0033627	GO:BP	cell adhesion mediated by integrin	16175	8328		0.15384615384615385	0.21428571428571427	73	16102	8	16	65	16086	16175	0.18910688633907122
R1	cpdb	0	network_modules	136	TRUE	1.84433860459672e-9	101	24	8	0.3333333333333333	0.07920792079207921	GO:0007229	GO:BP	integrin-mediated signaling pathway	16175	2779		0.23076923076923078	0.2857142857142857	101	16074	8	16	93	16058	16175	0.16006399180973055
R1	cpdb	0	network_modules	136	TRUE	2.362134410050953e-9	356	15	10	0.6666666666666666	0.028089887640449437	KEGG:04151	KEGG	PI3K-Akt signaling pathway	8484	285		0.4	0.45454545454545453	356	8128	10	5	346	8123	8484	0.1311259314577507
R1	cpdb	0	network_modules	136	TRUE	7.774054785078039e-9	97	15	7	0.4666666666666667	0.07216494845360824	KEGG:05410	KEGG	Hypertrophic cardiomyopathy	8484	489		0.5	0.5454545454545454	97	8387	7	8	90	8379	8484	0.1802084428274339
R1	cpdb	0	network_modules	136	TRUE	1.1129039325139811e-8	102	15	7	0.4666666666666667	0.06862745098039216	KEGG:05414	KEGG	Dilated cardiomyopathy	8484	491		0.6	0.6363636363636364	102	8382	7	8	95	8374	8484	0.17556090343478586
R1	cpdb	0	network_modules	136	TRUE	2.992315588009076e-8	84	20	7	0.35	0.08333333333333333	REAC:R-HSA-216083	REAC	Integrin cell surface interactions	10916	1216		0	0.14285714285714285	84	10832	7	13	77	10819	10916	0.16782787331743967
R1	cpdb	0	network_modules	136	TRUE	4.72936931993162e-8	330	15	9	0.6	0.02727272727272727	KEGG:05165	KEGG	Human papillomavirus infection	8484	446		0.7	0.7272727272727273	330	8154	9	6	321	8148	8484	0.12213234226553624
R1	cpdb	0	network_modules	136	TRUE	2.1188058449583603e-7	745	24	12	0.5	0.016107382550335572	GO:0098609	GO:BP	cell-cell adhesion	16175	18805		0.3076923076923077	0.35714285714285715	745	15430	12	12	733	15418	16175	0.08348121631515269
R1	cpdb	0	network_modules	136	TRUE	8.988288078900017e-6	298	20	8	0.4	0.026845637583892617	REAC:R-HSA-1474244	REAC	Extracellular matrix organization	10916	889		0.16666666666666666	0.2857142857142857	298	10618	8	12	290	10606	10916	0.09798861147622093
R1	cpdb	0	network_modules	136	TRUE	1.4259178936040307e-4	246	15	6	0.4	0.024390243902439025	KEGG:05131	KEGG	Shigellosis	8484	428		0.8	0.8181818181818182	246	8238	6	9	240	8229	8484	0.09305305852754037
R1	cpdb	0	network_modules	136	TRUE	1.4822665818691074e-4	9	20	3	0.15	0.3333333333333333	REAC:R-HSA-447041	REAC	CHL1 interactions	10916	273		0.3333333333333333	0.42857142857142855	9	10907	3	17	6	10890	10916	0.22267354999920771
R1	cpdb	0	network_modules	136	TRUE	5.036124990075351e-4	77	15	4	0.26666666666666666	0.05194805194805195	KEGG:05100	KEGG	Bacterial invasion of epithelial cells	8484	423		0.9	0.9090909090909091	77	8407	4	11	73	8396	8484	0.11431273497684553
R1	cpdb	0	network_modules	136	TRUE	6.643555438701982e-4	339	24	7	0.2916666666666667	0.02064896755162242	GO:0042060	GO:BP	wound healing	16175	9947		0.38461538461538464	0.42857142857142855	339	15836	7	17	332	15819	16175	0.07284996280320574
R1	cpdb	0	network_modules	136	TRUE	7.972827623184886e-4	15	20	3	0.15	0.2	REAC:R-HSA-75892	REAC	Platelet Adhesion to exposed collagen	10916	1760		0.5	0.5714285714285714	15	10901	3	17	12	10884	10916	0.17189394896130689
R1	cpdb	0	network_modules	136	TRUE	0.0020324549444908	150	20	5	0.25	0.03333333333333333	REAC:R-HSA-1500931	REAC	Cell-Cell communication	10916	328		0.6666666666666666	0.7142857142857143	150	10766	5	15	145	10751	10916	0.0869480758210047
R1	cpdb	0	network_modules	136	TRUE	0.0022653184602259937	407	24	7	0.2916666666666667	0.0171990171990172	GO:0009611	GO:BP	response to wounding	16175	3539		0.46153846153846156	0.5	407	15768	7	17	400	15751	16175	0.06559474394659477
R1	cpdb	0	network_modules	136	TRUE	0.0023892241918957178	114	15	4	0.26666666666666666	0.03508771929824561	KEGG:04670	KEGG	Leukocyte transendothelial migration	8484	343		1	1	114	8370	4	11	110	8359	8484	0.09256132271770459
R1	cpdb	0	network_modules	136	TRUE	0.0036063909603417355	18	24	3	0.125	0.16666666666666666	GO:2000811	GO:BP	negative regulation of anoikis	16175	26066		0.5384615384615384	0.5714285714285714	18	16157	3	21	15	16136	16175	0.1432385527576149
R1	cpdb	0	network_modules	136	TRUE	0.004278419411008274	19	24	3	0.125	0.15789473684210525	GO:0048333	GO:BP	mesodermal cell differentiation	16175	12670		0.6153846153846154	0.6428571428571429	19	16156	3	21	16	16135	16175	0.1393529077787942
R1	cpdb	0	network_modules	136	TRUE	0.005001739650104733	70	24	4	0.16666666666666666	0.05714285714285714	GO:0048041	GO:BP	focal adhesion assembly	16175	12482		0.6923076923076923	0.7142857142857143	70	16105	4	20	66	16085	16175	0.09533309327868722
R1	cpdb	0	network_modules	136	TRUE	0.006990565280179796	30	20	3	0.15	0.1	REAC:R-HSA-3000157	REAC	Laminin interactions	10916	1303		0.8333333333333334	1	30	10886	3	17	27	10869	10916	0.12050654140969698
R1	cpdb	0	network_modules	136	TRUE	0.006990565280179796	30	20	3	0.15	0.1	REAC:R-HSA-8874081	REAC	MET activates PTK2 signaling	10916	1362		0.8333333333333334	1	30	10886	3	17	27	10869	10916	0.12050654140969698
R1	cpdb	0	network_modules	136	TRUE	0.007331217501827521	77	24	4	0.16666666666666666	0.05194805194805195	GO:0007044	GO:BP	cell-substrate junction assembly	16175	2648		0.7692307692307693	0.7857142857142857	77	16098	4	20	73	16078	16175	0.09067393186170822
R1	cpdb	0	network_modules	136	TRUE	0.007789075887658279	23	24	3	0.125	0.13043478260869565	GO:2000209	GO:BP	regulation of anoikis	16175	25538		0.8461538461538461	0.8571428571428571	23	16152	3	21	20	16131	16175	0.12641961913648028
R1	cpdb	0	network_modules	136	TRUE	0.008542609148804024	80	24	4	0.16666666666666666	0.05	GO:0001704	GO:BP	formation of primary germ layer	16175	396		0.9230769230769231	0.9285714285714286	80	16095	4	20	76	16075	16175	0.08886392631018665
R1	cpdb	0	network_modules	136	TRUE	0.009896106765312565	83	24	4	0.16666666666666666	0.04819277108433735	GO:0150115	GO:BP	cell-substrate junction organization	16175	20148		1	1	83	16092	4	20	79	16072	16175	0.08715123827766873
R1	cpdb	0	network_modules	137	TRUE	3.7736460219160896e-6	19	16	4	0.25	0.21052631578947367	REAC:R-HSA-5627117	REAC	RHO GTPases Activate ROCKs	10916	1850		0	0.16666666666666666	19	10897	4	12	15	10885	10916	0.22818429863846065
R1	cpdb	0	network_modules	137	TRUE	7.834082587525483e-5	96	18	5	0.2777777777777778	0.052083333333333336	KEGG:04666	KEGG	Fc gamma R-mediated phagocytosis	8484	341		0	0.25	96	8388	5	13	91	8375	8484	0.11616326862413096
R1	cpdb	0	network_modules	137	TRUE	8.734558834684581e-5	40	16	4	0.25	0.1	REAC:R-HSA-3928662	REAC	EPHB-mediated forward signaling	10916	821		0.2	0.3333333333333333	40	10876	4	12	36	10864	10916	0.1561970939140911
R1	cpdb	0	network_modules	137	TRUE	2.995177089703294e-4	227	18	6	0.3333333333333333	0.02643171806167401	KEGG:04810	KEGG	Regulation of actin cytoskeleton	8484	365		0.3333333333333333	0.5	227	8257	6	12	221	8245	8484	0.08760187500579494
R1	cpdb	0	network_modules	137	TRUE	5.945412848952421e-4	64	16	4	0.25	0.0625	REAC:R-HSA-373755	REAC	Semaphorin interactions	10916	2193		0.4	0.5	64	10852	4	12	60	10840	10916	0.12251776795826572
R1	cpdb	0	network_modules	137	TRUE	9.298619041204025e-4	20	16	3	0.1875	0.15	REAC:R-HSA-416572	REAC	Sema4D induced cell migration and growth-cone collapse	10916	2191		0.6	0.6666666666666666	20	10896	3	13	17	10883	10916	0.166340644144421
R1	cpdb	0	network_modules	137	TRUE	0.0016450192499799896	24	16	3	0.1875	0.125	REAC:R-HSA-400685	REAC	Sema4D in semaphorin signaling	10916	2190		0.8	0.8333333333333334	24	10892	3	13	21	10879	10916	0.1515756764281025
R1	cpdb	0	network_modules	137	TRUE	0.0017587139889099033	181	18	5	0.2777777777777778	0.027624309392265192	KEGG:04360	KEGG	Axon guidance	8484	305		0.6666666666666666	0.75	181	8303	5	13	176	8290	8484	0.0818337912761165
R1	cpdb	0	network_modules	137	TRUE	0.0023367254150905336	90	16	4	0.25	0.044444444444444446	REAC:R-HSA-2682334	REAC	EPH-Ephrin signaling	10916	818		1	1	90	10826	4	12	86	10814	10916	0.10243087119182194
R1	cpdb	0	network_modules	137	TRUE	0.0035889503367907733	210	18	5	0.2777777777777778	0.023809523809523808	KEGG:05170	KEGG	Human immunodeficiency virus 1 infection	8484	451		1	1	210	8274	5	13	205	8261	8484	0.07509211342569157
R1	cpdb	0	network_modules	137	TRUE	0.007077170072321803	3	21	2	0.09523809523809523	0.6666666666666666	GO:1901995	GO:BP	positive regulation of meiotic cell cycle phase transition	16175	21928		0	1	3	16172	2	19	1	16153	16175	0.25167235521278336
R1	cpdb	0	network_modules	137	TRUE	0.007077170072321803	3	21	2	0.09523809523809523	0.6666666666666666	GO:0030043	GO:BP	actin filament fragmentation	16175	6664		0	1	3	16172	2	19	1	16153	16175	0.25167235521278336
R1	cpdb	0	network_modules	137	TRUE	0.007077170072321803	3	21	2	0.09523809523809523	0.6666666666666666	GO:0110032	GO:BP	positive regulation of G2/MI transition of meiotic cell cycle	16175	19363		0	1	3	16172	2	19	1	16153	16175	0.25167235521278336
R1	cpdb	0	network_modules	139	TRUE	2.096664712664564e-10	153	17	9	0.5294117647058824	0.058823529411764705	KEGG:04514	KEGG	Cell adhesion molecules	8484	315		NA	1	153	8331	9	8	144	8323	8484	0.17219000717434352
R1	cpdb	0	network_modules	139	TRUE	1.4375947243677982e-7	7	22	4	0.18181818181818182	0.5714285714285714	REAC:R-HSA-447043	REAC	Neurofascin interactions	10916	1589		0	0.125	7	10909	4	18	3	10891	10916	0.3216196437396268
R1	cpdb	0	network_modules	139	TRUE	7.605019337314809e-7	119	22	7	0.3181818181818182	0.058823529411764705	REAC:R-HSA-373760	REAC	L1CAM interactions	10916	1294		0.14285714285714285	0.25	119	10797	7	15	112	10782	10916	0.1329814287312299
R1	cpdb	0	network_modules	139	TRUE	7.852004907823582e-6	165	26	7	0.2692307692307692	0.04242424242424243	GO:0097485	GO:BP	neuron projection guidance	16175	18673		0	0.14285714285714285	165	16010	7	19	158	15991	16175	0.10343566440409391
R1	cpdb	0	network_modules	139	TRUE	7.852004907823582e-6	165	26	7	0.2692307692307692	0.04242424242424243	GO:0007411	GO:BP	axon guidance	16175	2906		0	0.14285714285714285	165	16010	7	19	158	15991	16175	0.10343566440409391
R1	cpdb	0	network_modules	139	TRUE	1.9148278040864472e-5	297	26	8	0.3076923076923077	0.026936026936026935	GO:0007409	GO:BP	axonogenesis	16175	2905		0.15384615384615385	0.21428571428571427	297	15878	8	18	289	15860	16175	0.08647218798534086
R1	cpdb	0	network_modules	139	TRUE	2.2061792777943296e-5	441	26	9	0.34615384615384615	0.02040816326530612	GO:0048812	GO:BP	neuron projection morphogenesis	16175	13058		0.23076923076923078	0.2857142857142857	441	15734	9	17	432	15717	16175	0.07857050875125943
R1	cpdb	0	network_modules	139	TRUE	2.9462004843295476e-5	456	26	9	0.34615384615384615	0.019736842105263157	GO:0120039	GO:BP	plasma membrane bounded cell projection morphogenesis	16175	19473		0.3076923076923077	0.35714285714285715	456	15719	9	17	447	15702	16175	0.07707947546333285
R1	cpdb	0	network_modules	139	TRUE	3.177030775756342e-5	460	26	9	0.34615384615384615	0.01956521739130435	GO:0048858	GO:BP	cell projection morphogenesis	16175	13102		0.38461538461538464	0.42857142857142855	460	15715	9	17	451	15698	16175	0.0766936869185043
R1	cpdb	0	network_modules	139	TRUE	5.352129889208409e-5	339	26	8	0.3076923076923077	0.02359882005899705	GO:0061564	GO:BP	axon development	16175	15561		0.46153846153846156	0.5	339	15836	8	18	331	15818	16175	0.08031835449390048
R1	cpdb	0	network_modules	139	TRUE	1.265960109601274e-4	379	26	8	0.3076923076923077	0.021108179419525065	GO:0048667	GO:BP	cell morphogenesis involved in neuron differentiation	16175	12925		0.5384615384615384	0.5714285714285714	379	15796	8	18	371	15778	16175	0.07540191753093094
R1	cpdb	0	network_modules	139	TRUE	2.8163631989616163e-4	10	22	3	0.13636363636363635	0.3	REAC:R-HSA-190373	REAC	FGFR1c ligand binding and activation	10916	904		0.2857142857142857	0.375	10	10906	3	19	7	10887	10916	0.20119611420834152
R1	cpdb	0	network_modules	139	TRUE	6.150911118013454e-4	651	26	9	0.34615384615384615	0.013824884792626729	GO:0000902	GO:BP	cell morphogenesis	16175	240		0.6153846153846154	0.6428571428571429	651	15524	9	17	642	15507	16175	0.062453187972055645
R1	cpdb	0	network_modules	139	TRUE	6.686075028162948e-4	13	22	3	0.13636363636363635	0.23076923076923078	REAC:R-HSA-190242	REAC	FGFR1 ligand binding and activation	10916	900		0.42857142857142855	0.5	13	10903	3	19	10	10884	10916	0.17612684896878955
R1	cpdb	0	network_modules	139	TRUE	7.084095985923842e-4	41	26	4	0.15384615384615385	0.0975609756097561	GO:0015872	GO:BP	dopamine transport	16175	4980		0.6923076923076923	0.7142857142857143	41	16134	4	22	37	16112	16175	0.12074433881771884
R1	cpdb	0	network_modules	139	TRUE	8.498439983605701e-4	14	22	3	0.13636363636363635	0.21428571428571427	REAC:R-HSA-2033519	REAC	Activated point mutants of FGFR2	10916	69		0.5714285714285714	0.625	14	10902	3	19	11	10883	10916	0.1696128348949038
R1	cpdb	0	network_modules	139	TRUE	9.319472374021386e-4	684	26	9	0.34615384615384615	0.013157894736842105	GO:0031175	GO:BP	neuron projection development	16175	7086		0.7692307692307693	0.7857142857142857	684	15491	9	17	675	15474	16175	0.06058610030747466
R1	cpdb	0	network_modules	139	TRUE	0.0021811519714749652	54	26	4	0.15384615384615385	0.07407407407407407	GO:0051937	GO:BP	catecholamine transport	16175	14007		0.8461538461538461	0.8571428571428571	54	16121	4	22	50	16099	16175	0.10469450923023314
R1	cpdb	0	network_modules	139	TRUE	0.002269584207071115	761	26	9	0.34615384615384615	0.011826544021024968	GO:0048666	GO:BP	neuron development	16175	12924		0.9230769230769231	0.9285714285714286	761	15414	9	17	752	15397	16175	0.05668043408421548
R1	cpdb	0	network_modules	139	TRUE	0.004334650326503141	64	26	4	0.15384615384615385	0.0625	GO:0015844	GO:BP	monoamine transport	16175	4954		1	1	64	16111	4	22	60	16089	16175	0.09580273768665881
R1	cpdb	0	network_modules	139	TRUE	0.005975898395954736	26	22	3	0.13636363636363635	0.11538461538461539	REAC:R-HSA-5654726	REAC	Negative regulation of FGFR1 signaling	10916	1568		0.7142857142857143	0.75	26	10890	3	19	23	10871	10916	0.12351690859159996
R1	cpdb	0	network_modules	139	TRUE	0.007736115924899079	4	22	2	0.09090909090909091	0.5	REAC:R-HSA-190371	REAC	FGFR3b ligand binding and activation	10916	912		0.8571428571428571	0.875	4	10912	2	20	2	10892	10916	0.21259460496347032
R1	cpdb	0	network_modules	139	TRUE	0.008365590382794197	29	22	3	0.13636363636363635	0.10344827586206896	REAC:R-HSA-1839126	REAC	FGFR2 mutant receptor activation	10916	907		1	1	29	10887	3	19	26	10868	10916	0.11672991499915114
R1	cpdb	0	network_modules	141	TRUE	2.786832620828302e-19	165	19	13	0.6842105263157895	0.07878787878787878	GO:0007411	GO:BP	axon guidance	16175	2906		0	0.018018018018018018	165	16010	13	6	152	16004	16175	0.23002901042561366
R1	cpdb	0	network_modules	141	TRUE	2.786832620828302e-19	165	19	13	0.6842105263157895	0.07878787878787878	GO:0097485	GO:BP	neuron projection guidance	16175	18673		0	0.018018018018018018	165	16010	13	6	152	16004	16175	0.23002901042561366
R1	cpdb	0	network_modules	141	TRUE	3.631116163947243e-19	181	12	12	1	0.06629834254143646	KEGG:04360	KEGG	Axon guidance	8484	305		NA	1	181	8303	12	0	169	8303	8484	0.25490354832230666
R1	cpdb	0	network_modules	141	TRUE	2.4985804849567982e-17	99	19	11	0.5789473684210527	0.1111111111111111	GO:0050770	GO:BP	regulation of axonogenesis	16175	13244		0.01818181818181818	0.02702702702702703	99	16076	11	8	88	16068	16175	0.2518667910942901
R1	cpdb	0	network_modules	141	TRUE	6.465188899027318e-16	46	19	9	0.47368421052631576	0.1956521739130435	GO:0050772	GO:BP	positive regulation of axonogenesis	16175	13246		0.02727272727272727	0.036036036036036036	46	16129	9	10	37	16119	16175	0.3032111537299426
R1	cpdb	0	network_modules	141	TRUE	6.896764378816848e-16	297	19	13	0.6842105263157895	0.04377104377104377	GO:0007409	GO:BP	axonogenesis	16175	2905		0.03636363636363636	0.04504504504504504	297	15878	13	6	284	15872	16175	0.17008017840156817
R1	cpdb	0	network_modules	141	TRUE	3.922147370751389e-15	339	19	13	0.6842105263157895	0.038348082595870206	GO:0061564	GO:BP	axon development	16175	15561		0.045454545454545456	0.05405405405405406	339	15836	13	6	326	15830	16175	0.15878530541095426
R1	cpdb	0	network_modules	141	TRUE	1.6901625392918027e-14	379	19	13	0.6842105263157895	0.03430079155672823	GO:0048667	GO:BP	cell morphogenesis involved in neuron differentiation	16175	12925		0.05454545454545454	0.06306306306306306	379	15796	13	6	366	15790	16175	0.14980193840171735
R1	cpdb	0	network_modules	141	TRUE	1.0180230318521834e-13	42	19	8	0.42105263157894735	0.19047619047619047	GO:0071526	GO:BP	semaphorin-plexin signaling pathway	16175	16747		0.06363636363636363	0.07207207207207207	42	16133	8	11	34	16122	16175	0.2819822606172167
R1	cpdb	0	network_modules	141	TRUE	1.220829093180252e-13	441	19	13	0.6842105263157895	0.02947845804988662	GO:0048812	GO:BP	neuron projection morphogenesis	16175	13058		0.07272727272727272	0.08108108108108109	441	15734	13	6	428	15728	16175	0.13833915682489958
R1	cpdb	0	network_modules	141	TRUE	1.8869866153450623e-13	456	19	13	0.6842105263157895	0.02850877192982456	GO:0120039	GO:BP	plasma membrane bounded cell projection morphogenesis	16175	19473		0.08181818181818182	0.09009009009009009	456	15719	13	6	443	15713	16175	0.13591757667064414
R1	cpdb	0	network_modules	141	TRUE	2.1140800556147644e-13	460	19	13	0.6842105263157895	0.02826086956521739	GO:0048858	GO:BP	cell projection morphogenesis	16175	13102		0.09090909090909091	0.0990990990990991	460	15715	13	6	447	15709	16175	0.13529154253671177
R1	cpdb	0	network_modules	141	TRUE	2.129418512279857e-13	220	19	11	0.5789473684210527	0.05	GO:0050767	GO:BP	regulation of neurogenesis	16175	13241		0.1	0.10810810810810811	220	15955	11	8	209	15947	16175	0.1673820366846556
R1	cpdb	0	network_modules	141	TRUE	1.7598256056049672e-12	266	19	11	0.5789473684210527	0.041353383458646614	GO:0051960	GO:BP	regulation of nervous system development	16175	14029		0.10909090909090909	0.11711711711711711	266	15909	11	8	255	15901	16175	0.1516757539068955
R1	cpdb	0	network_modules	141	TRUE	5.534385209928088e-12	295	19	11	0.5789473684210527	0.03728813559322034	GO:0010975	GO:BP	regulation of neuron projection development	16175	4551		0.11818181818181818	0.12612612612612611	295	15880	11	8	284	15872	16175	0.14369964862404402
R1	cpdb	0	network_modules	141	TRUE	9.93954383624948e-12	127	19	9	0.47368421052631576	0.07086614173228346	GO:0050769	GO:BP	positive regulation of neurogenesis	16175	13243		0.12727272727272726	0.13513513513513514	127	16048	9	10	118	16038	16175	0.180997141421961
R1	cpdb	0	network_modules	141	TRUE	1.8979036872188794e-11	651	19	13	0.6842105263157895	0.019969278033794162	GO:0000902	GO:BP	cell morphogenesis	16175	240		0.13636363636363635	0.14414414414414414	651	15524	13	6	638	15518	16175	0.112362896784456
R1	cpdb	0	network_modules	141	TRUE	3.588095752858362e-11	684	19	13	0.6842105263157895	0.019005847953216373	GO:0031175	GO:BP	neuron projection development	16175	7086		0.14545454545454545	0.15315315315315314	684	15491	13	6	671	15485	16175	0.10938791821969086
R1	cpdb	0	network_modules	141	TRUE	5.506067369939802e-11	153	19	9	0.47368421052631576	0.058823529411764705	GO:0051962	GO:BP	positive regulation of nervous system development	16175	14031		0.15454545454545454	0.16216216216216217	153	16022	9	10	144	16012	16175	0.16446700023713298
R1	cpdb	0	network_modules	141	TRUE	1.413185936411616e-10	761	19	13	0.6842105263157895	0.017082785808147174	GO:0048666	GO:BP	neuron development	16175	12924		0.16363636363636364	0.17117117117117117	761	15414	13	6	748	15408	16175	0.10319399988770309
R1	cpdb	0	network_modules	141	TRUE	8.378949335331057e-10	466	19	11	0.5789473684210527	0.023605150214592276	GO:0120035	GO:BP	regulation of plasma membrane bounded cell projection organization	16175	19471		0.17272727272727273	0.18018018018018017	466	15709	11	8	455	15701	16175	0.1127867728553827
R1	cpdb	0	network_modules	141	TRUE	1.0517587106993933e-9	64	17	7	0.4117647058823529	0.109375	REAC:R-HSA-373755	REAC	Semaphorin interactions	10916	2193		0	0.09090909090909091	64	10852	7	10	57	10842	10916	0.20997650763304468
R1	cpdb	0	network_modules	141	TRUE	1.1568745016542216e-9	480	19	11	0.5789473684210527	0.022916666666666665	GO:0031344	GO:BP	regulation of cell projection organization	16175	7135		0.18181818181818182	0.1891891891891892	480	15695	11	8	469	15687	16175	0.11100442840162397
R1	cpdb	0	network_modules	141	TRUE	3.173729763574158e-9	14	17	5	0.29411764705882354	0.35714285714285715	REAC:R-HSA-399955	REAC	SEMA3A-Plexin repulsion signaling by inhibiting Integrin adhesion	10916	2132		0.1	0.18181818181818182	14	10902	5	12	9	10890	10916	0.32314744350057484
R1	cpdb	0	network_modules	141	TRUE	3.3895669846211885e-9	14	19	5	0.2631578947368421	0.35714285714285715	GO:0008045	GO:BP	motor neuron axon guidance	16175	3102		0.19090909090909092	0.1981981981981982	14	16161	5	14	9	16147	16175	0.30587337691055805
R1	cpdb	0	network_modules	141	TRUE	5.110065467646656e-9	252	19	9	0.47368421052631576	0.03571428571428571	GO:0031346	GO:BP	positive regulation of cell projection organization	16175	7137		0.2	0.2072072072072072	252	15923	9	10	243	15913	16175	0.12685456899425612
R1	cpdb	0	network_modules	141	TRUE	6.911808117071405e-9	16	17	5	0.29411764705882354	0.3125	REAC:R-HSA-399956	REAC	CRMPs in Sema3A signaling	10916	287		0.2	0.36363636363636365	16	10900	5	12	11	10888	10916	0.302115343326123
R1	cpdb	0	network_modules	141	TRUE	6.911808117071405e-9	16	17	5	0.29411764705882354	0.3125	REAC:R-HSA-399954	REAC	Sema3A PAK dependent Axon repulsion	10916	2189		0.2	0.36363636363636365	16	10900	5	12	11	10888	10916	0.302115343326123
R1	cpdb	0	network_modules	141	TRUE	7.624727374102622e-9	571	19	11	0.5789473684210527	0.01926444833625219	GO:0060284	GO:BP	regulation of cell development	16175	14500		0.20909090909090908	0.21621621621621623	571	15604	11	8	560	15596	16175	0.10102627066495443
R1	cpdb	0	network_modules	141	TRUE	1.4495971830193782e-8	283	19	9	0.47368421052631576	0.03180212014134275	GO:0010720	GO:BP	positive regulation of cell development	16175	4346		0.21818181818181817	0.22522522522522523	283	15892	9	10	274	15882	16175	0.11932064698671149
R1	cpdb	0	network_modules	141	TRUE	2.2457577478563768e-8	631	19	11	0.5789473684210527	0.017432646592709985	GO:0022603	GO:BP	regulation of anatomical structure morphogenesis	16175	6611		0.22727272727272727	0.23423423423423423	631	15544	11	8	620	15536	16175	0.09563146761867702
R1	cpdb	0	network_modules	141	TRUE	2.7516532360144612e-8	6	19	4	0.21052631578947367	0.6666666666666666	GO:0021636	GO:BP	trigeminal nerve morphogenesis	16175	6219		0.23636363636363636	0.26126126126126126	6	16169	4	15	2	16154	16175	0.37426348719926433
R1	cpdb	0	network_modules	141	TRUE	2.7516532360144612e-8	6	19	4	0.21052631578947367	0.6666666666666666	GO:0021637	GO:BP	trigeminal nerve structural organization	16175	6220		0.23636363636363636	0.26126126126126126	6	16169	4	15	2	16154	16175	0.37426348719926433
R1	cpdb	0	network_modules	141	TRUE	2.7516532360144612e-8	6	19	4	0.21052631578947367	0.6666666666666666	GO:0021785	GO:BP	branchiomotor neuron axon guidance	16175	6363		0.23636363636363636	0.26126126126126126	6	16169	4	15	2	16154	16175	0.37426348719926433
R1	cpdb	0	network_modules	141	TRUE	6.415759548403405e-8	7	19	4	0.21052631578947367	0.5714285714285714	GO:0021561	GO:BP	facial nerve development	16175	6145		0.2636363636363636	0.2882882882882883	7	16168	4	15	3	16153	16175	0.346409437324016
R1	cpdb	0	network_modules	141	TRUE	6.415759548403405e-8	7	19	4	0.21052631578947367	0.5714285714285714	GO:0021610	GO:BP	facial nerve morphogenesis	16175	6193		0.2636363636363636	0.2882882882882883	7	16168	4	15	3	16153	16175	0.346409437324016
R1	cpdb	0	network_modules	141	TRUE	6.415759548403405e-8	7	19	4	0.21052631578947367	0.5714285714285714	GO:0021612	GO:BP	facial nerve structural organization	16175	6195		0.2636363636363636	0.2882882882882883	7	16168	4	15	3	16153	16175	0.346409437324016
R1	cpdb	0	network_modules	141	TRUE	1.2821996634748857e-7	8	19	4	0.21052631578947367	0.5	GO:0021604	GO:BP	cranial nerve structural organization	16175	6187		0.2909090909090909	0.2972972972972973	8	16167	4	15	4	16152	16175	0.32395102241431917
R1	cpdb	0	network_modules	141	TRUE	1.682485747045798e-7	9	17	4	0.23529411764705882	0.4444444444444444	REAC:R-HSA-428542	REAC	Regulation of commissural axon pathfinding by SLIT and ROBO	10916	2024		0.4	0.45454545454545453	9	10907	4	13	5	10894	10916	0.32263194506535536
R1	cpdb	0	network_modules	141	TRUE	1.988967853743136e-7	29	19	5	0.2631578947368421	0.1724137931034483	GO:0048846	GO:BP	axon extension involved in axon guidance	16175	13090		0.3	0.3153153153153153	29	16146	5	14	24	16132	16175	0.21187032448608137
R1	cpdb	0	network_modules	141	TRUE	1.988967853743136e-7	29	19	5	0.2631578947368421	0.1724137931034483	GO:1902284	GO:BP	neuron projection extension involved in neuron projection guidance	16175	22177		0.3	0.3153153153153153	29	16146	5	14	24	16132	16175	0.21187032448608137
R1	cpdb	0	network_modules	141	TRUE	2.2224749846703822e-7	781	19	11	0.5789473684210527	0.014084507042253521	GO:0030334	GO:BP	regulation of cell migration	16175	6780		0.3181818181818182	0.32432432432432434	781	15394	11	8	770	15386	16175	0.08489296461051944
R1	cpdb	0	network_modules	141	TRUE	2.3062465878878362e-7	9	19	4	0.21052631578947367	0.4444444444444444	GO:1902285	GO:BP	semaphorin-plexin signaling pathway involved in neuron projection guidance	16175	22178		0.32727272727272727	0.34234234234234234	9	16166	4	15	5	16151	16175	0.3053434935844076
R1	cpdb	0	network_modules	141	TRUE	2.3062465878878362e-7	9	19	4	0.21052631578947367	0.4444444444444444	GO:1902287	GO:BP	semaphorin-plexin signaling pathway involved in axon guidance	16175	22180		0.32727272727272727	0.34234234234234234	9	16166	4	15	5	16151	16175	0.3053434935844076
R1	cpdb	0	network_modules	141	TRUE	3.840891695786516e-7	10	19	4	0.21052631578947367	0.4	GO:0021783	GO:BP	preganglionic parasympathetic fiber development	16175	6361		0.34545454545454546	0.35135135135135137	10	16165	4	15	6	16150	16175	0.289597937619554
R1	cpdb	0	network_modules	141	TRUE	6.031207500882556e-7	11	19	4	0.21052631578947367	0.36363636363636365	GO:0048532	GO:BP	anatomical structure arrangement	16175	12813		0.35454545454545455	0.36036036036036034	11	16164	4	15	7	16149	16175	0.2760480127212956
R1	cpdb	0	network_modules	141	TRUE	6.282201755517491e-7	36	19	5	0.2631578947368421	0.1388888888888889	GO:0050919	GO:BP	negative chemotaxis	16175	13361		0.36363636363636365	0.36936936936936937	36	16139	5	14	31	16125	16175	0.1898857373553742
R1	cpdb	0	network_modules	141	TRUE	9.040096925695776e-7	12	19	4	0.21052631578947367	0.3333333333333333	GO:0048486	GO:BP	parasympathetic nervous system development	16175	12780		0.37272727272727274	0.38738738738738737	12	16163	4	15	8	16148	16175	0.26422615838272073
R1	cpdb	0	network_modules	141	TRUE	9.040096925695776e-7	12	19	4	0.21052631578947367	0.3333333333333333	GO:0021559	GO:BP	trigeminal nerve development	16175	6143		0.37272727272727274	0.38738738738738737	12	16163	4	15	8	16148	16175	0.26422615838272073
R1	cpdb	0	network_modules	141	TRUE	1.3048226310247709e-6	13	19	4	0.21052631578947367	0.3076923076923077	GO:0021772	GO:BP	olfactory bulb development	16175	6352		0.39090909090909093	0.3963963963963964	13	16162	4	15	9	16147	16175	0.25379331972800295
R1	cpdb	0	network_modules	141	TRUE	1.8253958566408369e-6	14	19	4	0.21052631578947367	0.2857142857142857	GO:0021988	GO:BP	olfactory lobe development	16175	6543		0.4	0.40540540540540543	14	16161	4	15	10	16146	16175	0.24449683246107626
R1	cpdb	0	network_modules	141	TRUE	1.8569105900796214e-6	3	19	3	0.15789473684210525	1	GO:0050923	GO:BP	regulation of negative chemotaxis	16175	13365		0.4090909090909091	0.4144144144144144	3	16172	3	16	0	16156	16175	0.39716309171553144
R1	cpdb	0	network_modules	141	TRUE	2.487328647766252e-6	15	19	4	0.21052631578947367	0.26666666666666666	GO:0021602	GO:BP	cranial nerve morphogenesis	16175	6185		0.41818181818181815	0.42342342342342343	15	16160	4	15	11	16145	16175	0.23614403548177731
R1	cpdb	0	network_modules	141	TRUE	2.8287508352133464e-6	48	19	5	0.2631578947368421	0.10416666666666667	GO:0060411	GO:BP	cardiac septum morphogenesis	16175	14612		0.42727272727272725	0.43243243243243246	48	16127	5	14	43	16113	16175	0.1640393141926977
R1	cpdb	0	network_modules	141	TRUE	3.4951658959371747e-6	50	19	5	0.2631578947368421	0.1	GO:0050922	GO:BP	negative regulation of chemotaxis	16175	13364		0.43636363636363634	0.44144144144144143	50	16125	5	14	45	16111	16175	0.16065862968747466
R1	cpdb	0	network_modules	141	TRUE	7.4221308769939816e-6	4	19	3	0.15789473684210525	0.75	GO:0021891	GO:BP	olfactory bulb interneuron development	16175	6455		0.44545454545454544	0.4594594594594595	4	16171	3	16	1	16155	16175	0.3438291238544239
R1	cpdb	0	network_modules	141	TRUE	7.4221308769939816e-6	4	19	3	0.15789473684210525	0.75	GO:0097491	GO:BP	sympathetic neuron projection guidance	16175	18675		0.44545454545454544	0.4594594594594595	4	16171	3	16	1	16155	16175	0.3438291238544239
R1	cpdb	0	network_modules	141	TRUE	7.708638025277491e-6	129	19	6	0.3157894736842105	0.046511627906976744	GO:0048588	GO:BP	developmental cell growth	16175	12859		0.4636363636363636	0.46846846846846846	129	16046	6	13	123	16033	16175	0.11867645739038173
R1	cpdb	0	network_modules	141	TRUE	9.693984340831422e-6	134	19	6	0.3157894736842105	0.04477611940298507	GO:0060560	GO:BP	developmental growth involved in morphogenesis	16175	14744		0.4727272727272727	0.4774774774774775	134	16041	6	13	128	16028	16175	0.11634248870431986
R1	cpdb	0	network_modules	141	TRUE	1.0582540584652071e-5	62	19	5	0.2631578947368421	0.08064516129032258	GO:0003279	GO:BP	cardiac septum development	16175	1703		0.4818181818181818	0.4864864864864865	62	16113	5	14	57	16099	16175	0.14391769766126533
R1	cpdb	0	network_modules	141	TRUE	1.3905874632519537e-5	615	19	9	0.47368421052631576	0.014634146341463415	GO:0045597	GO:BP	positive regulation of cell differentiation	16175	11448		0.4909090909090909	0.4954954954954955	615	15560	9	10	606	15550	16175	0.07811996942155391
R1	cpdb	0	network_modules	141	TRUE	1.604017671524277e-5	23	19	4	0.21052631578947367	0.17391304347826086	GO:0003148	GO:BP	outflow tract septum morphogenesis	16175	1580		0.5	0.5045045045045045	23	16152	4	15	19	16137	16175	0.19030061956360644
R1	cpdb	0	network_modules	141	TRUE	3.16962276090063e-5	27	19	4	0.21052631578947367	0.14814814814814814	GO:0021545	GO:BP	cranial nerve development	16175	6129		0.509090909090909	0.5135135135135135	27	16148	4	15	23	16133	16175	0.17545352693158756
R1	cpdb	0	network_modules	141	TRUE	3.196286889809002e-5	77	19	5	0.2631578947368421	0.06493506493506493	GO:0048675	GO:BP	axon extension	16175	12933		0.5181818181818182	0.5225225225225225	77	16098	5	14	72	16084	16175	0.1287392833059107
R1	cpdb	0	network_modules	141	TRUE	3.695147834842986e-5	28	19	4	0.21052631578947367	0.14285714285714285	GO:0048483	GO:BP	autonomic nervous system development	16175	12777		0.5272727272727272	0.5315315315315315	28	16147	4	15	24	16132	16175	0.17224627645719445
R1	cpdb	0	network_modules	141	TRUE	3.7055600885495715e-5	6	19	3	0.15789473684210525	0.5	GO:0021889	GO:BP	olfactory bulb interneuron differentiation	16175	6453		0.5363636363636364	0.5495495495495496	6	16169	3	16	3	16153	16175	0.28053246336363274
R1	cpdb	0	network_modules	141	TRUE	3.7055600885495715e-5	6	19	3	0.15789473684210525	0.5	GO:0097490	GO:BP	sympathetic neuron projection extension	16175	18674		0.5363636363636364	0.5495495495495496	6	16169	3	16	3	16153	16175	0.28053246336363274
R1	cpdb	0	network_modules	141	TRUE	4.67664464531158e-5	83	19	5	0.2631578947368421	0.060240963855421686	GO:0003206	GO:BP	cardiac chamber morphogenesis	16175	1636		0.5545454545454546	0.5585585585585585	83	16092	5	14	78	16078	16175	0.12384385240115758
R1	cpdb	0	network_modules	141	TRUE	5.871127472327119e-5	181	19	6	0.3157894736842105	0.03314917127071823	GO:0050920	GO:BP	regulation of chemotaxis	16175	13362		0.5636363636363636	0.5675675675675675	181	15994	6	13	175	15981	16175	0.09930367673550969
R1	cpdb	0	network_modules	141	TRUE	1.0820469025135916e-4	98	19	5	0.2631578947368421	0.05102040816326531	GO:0003205	GO:BP	cardiac chamber development	16175	1635		0.5727272727272728	0.5765765765765766	98	16077	5	14	93	16063	16175	0.11361594501826934
R1	cpdb	0	network_modules	141	TRUE	1.3222899225571967e-4	38	19	4	0.21052631578947367	0.10526315789473684	GO:0021675	GO:BP	nerve development	16175	6258		0.5818181818181818	0.5855855855855856	38	16137	4	15	34	16122	16175	0.1474632288796926
R1	cpdb	0	network_modules	141	TRUE	1.3232769639674345e-4	102	19	5	0.2631578947368421	0.049019607843137254	GO:0008360	GO:BP	regulation of cell shape	16175	3179		0.5909090909090909	0.5945945945945946	102	16073	5	14	97	16059	16175	0.11127262565900266
R1	cpdb	0	network_modules	141	TRUE	1.3897845011336783e-4	103	19	5	0.2631578947368421	0.04854368932038835	GO:0021537	GO:BP	telencephalon development	16175	6121		0.6	0.6036036036036037	103	16072	5	14	98	16058	16175	0.11070794098148416
R1	cpdb	0	network_modules	141	TRUE	1.5528732974810387e-4	9	19	3	0.15789473684210525	0.3333333333333333	GO:0061549	GO:BP	sympathetic ganglion development	16175	15546		0.6090909090909091	0.6126126126126126	9	16166	3	16	6	16150	16175	0.2288053323123006
R1	cpdb	0	network_modules	141	TRUE	1.9991162368868454e-4	42	19	4	0.21052631578947367	0.09523809523809523	GO:0021954	GO:BP	central nervous system neuron development	16175	6509		0.6181818181818182	0.6216216216216216	42	16133	4	15	38	16118	16175	0.14011625338611672
R1	cpdb	0	network_modules	141	TRUE	2.1159580475092093e-4	112	19	5	0.2631578947368421	0.044642857142857144	GO:1990138	GO:BP	neuron projection extension	16175	25092		0.6272727272727273	0.6306306306306306	112	16063	5	14	107	16049	16175	0.10596634475168971
R1	cpdb	0	network_modules	141	TRUE	2.2167443285318439e-4	10	19	3	0.15789473684210525	0.3	GO:0031290	GO:BP	retinal ganglion cell axon guidance	16175	7113		0.6363636363636364	0.6396396396396397	10	16165	3	16	7	16149	16175	0.2169852164756029
R1	cpdb	0	network_modules	141	TRUE	2.7232232351444676e-4	49	17	4	0.23529411764705882	0.08163265306122448	REAC:R-HSA-373752	REAC	Netrin-1 signaling	10916	1586		0.5	0.5454545454545454	49	10867	4	13	45	10854	10916	0.1363601761922691
R1	cpdb	0	network_modules	141	TRUE	5.271488521564476e-4	13	19	3	0.15789473684210525	0.23076923076923078	GO:0061548	GO:BP	ganglion development	16175	15545		0.6454545454545455	0.6486486486486487	13	16162	3	16	10	16146	16175	0.19010183994272611
R1	cpdb	0	network_modules	141	TRUE	6.492067084443931e-4	56	19	4	0.21052631578947367	0.07142857142857142	GO:0003151	GO:BP	outflow tract morphogenesis	16175	1583		0.6545454545454545	0.6576576576576577	56	16119	4	15	52	16104	16175	0.1208915899197648
R1	cpdb	0	network_modules	141	TRUE	6.528725513163051e-4	272	19	6	0.3157894736842105	0.022058823529411766	GO:0048589	GO:BP	developmental growth	16175	12860		0.6636363636363637	0.6666666666666666	272	15903	6	13	266	15890	16175	0.07973752213530978
R1	cpdb	0	network_modules	141	TRUE	9.693594766801913e-4	480	19	7	0.3684210526315789	0.014583333333333334	GO:0001568	GO:BP	blood vessel development	16175	353		0.6727272727272727	0.6756756756756757	480	15695	7	12	473	15683	16175	0.06845837515921367
R1	cpdb	0	network_modules	141	TRUE	9.979345558295864e-4	19	17	3	0.17647058823529413	0.15789473684210525	REAC:R-HSA-416700	REAC	Other semaphorin interactions	10916	1652		0.6	0.6363636363636364	19	10897	3	14	16	10883	10916	0.16555104323798445
R1	cpdb	0	network_modules	141	TRUE	0.001029883574570837	16	19	3	0.15789473684210525	0.1875	GO:0048485	GO:BP	sympathetic nervous system development	16175	12779		0.6818181818181818	0.6846846846846847	16	16159	3	16	13	16143	16175	0.17116905694947215
R1	cpdb	0	network_modules	141	TRUE	0.0011887303359032397	65	19	4	0.21052631578947367	0.06153846153846154	GO:0061387	GO:BP	regulation of extent of cell growth	16175	15458		0.6909090909090909	0.6936936936936937	65	16110	4	15	61	16095	16175	0.11194020892310803
R1	cpdb	0	network_modules	141	TRUE	0.0012497191805893838	160	19	5	0.2631578947368421	0.03125	GO:0030900	GO:BP	forebrain development	16175	6956		0.7	0.7027027027027027	160	16015	5	14	155	16001	16175	0.08776224904746611
R1	cpdb	0	network_modules	141	TRUE	0.0013452516475601262	504	19	7	0.3684210526315789	0.013888888888888888	GO:0001944	GO:BP	vasculature development	16175	555		0.7090909090909091	0.7117117117117117	504	15671	7	12	497	15659	16175	0.06656681381047193
R1	cpdb	0	network_modules	141	TRUE	0.0016862921586492721	170	19	5	0.2631578947368421	0.029411764705882353	GO:0003007	GO:BP	heart morphogenesis	16175	1458		0.7181818181818181	0.7207207207207207	170	16005	5	14	165	15991	16175	0.08496058060501442
R1	cpdb	0	network_modules	141	TRUE	0.0017665773513739864	2	19	2	0.10526315789473684	1	GO:0050925	GO:BP	negative regulation of negative chemotaxis	16175	13367		0.7272727272727273	0.7657657657657657	2	16173	2	17	0	16156	16175	0.32427228087924065
R1	cpdb	0	network_modules	141	TRUE	0.0017665773513739864	2	19	2	0.10526315789473684	1	GO:0021825	GO:BP	substrate-dependent cerebral cortex tangential migration	16175	6399		0.7272727272727273	0.7657657657657657	2	16173	2	17	0	16156	16175	0.32427228087924065
R1	cpdb	0	network_modules	141	TRUE	0.0017665773513739864	2	19	2	0.10526315789473684	1	GO:0021827	GO:BP	postnatal olfactory bulb interneuron migration	16175	6401		0.7272727272727273	0.7657657657657657	2	16173	2	17	0	16156	16175	0.32427228087924065
R1	cpdb	0	network_modules	141	TRUE	0.0017665773513739864	2	19	2	0.10526315789473684	1	GO:0021836	GO:BP	chemorepulsion involved in postnatal olfactory bulb interneuron migration	16175	6410		0.7272727272727273	0.7657657657657657	2	16173	2	17	0	16156	16175	0.32427228087924065
R1	cpdb	0	network_modules	141	TRUE	0.0017665773513739864	2	19	2	0.10526315789473684	1	GO:0021823	GO:BP	cerebral cortex tangential migration using cell-cell interactions	16175	6397		0.7272727272727273	0.7657657657657657	2	16173	2	17	0	16156	16175	0.32427228087924065
R1	cpdb	0	network_modules	141	TRUE	0.001778102346443505	19	19	3	0.15789473684210525	0.15789473684210525	GO:0003184	GO:BP	pulmonary valve morphogenesis	16175	1614		0.7727272727272727	0.7837837837837838	19	16156	3	16	16	16140	16175	0.15690439269751502
R1	cpdb	0	network_modules	141	TRUE	0.001778102346443505	19	19	3	0.15789473684210525	0.15789473684210525	GO:0006929	GO:BP	substrate-dependent cell migration	16175	2568		0.7727272727272727	0.7837837837837838	19	16156	3	16	16	16140	16175	0.15690439269751502
R1	cpdb	0	network_modules	141	TRUE	0.002558150727165912	185	19	5	0.2631578947368421	0.02702702702702703	GO:0022604	GO:BP	regulation of cell morphogenesis	16175	6612		0.7909090909090909	0.7927927927927928	185	15990	5	14	180	15976	16175	0.0811825413245174
R1	cpdb	0	network_modules	141	TRUE	0.0026107425466437963	79	19	4	0.21052631578947367	0.05063291139240506	GO:0035023	GO:BP	regulation of Rho protein signal transduction	16175	8766		0.8	0.8018018018018018	79	16096	4	15	75	16081	16175	0.1011565377365766
R1	cpdb	0	network_modules	141	TRUE	0.0032394549185536066	358	19	6	0.3157894736842105	0.01675977653631285	GO:0016049	GO:BP	cell growth	16175	5081		0.8090909090909091	0.8108108108108109	358	15817	6	13	352	15804	16175	0.06845265429778512
R1	cpdb	0	network_modules	141	TRUE	0.003240127037893117	23	19	3	0.15789473684210525	0.13043478260869565	GO:0003177	GO:BP	pulmonary valve development	16175	1607		0.8181818181818182	0.8198198198198198	23	16152	3	16	20	16136	16175	0.14240194503174
R1	cpdb	0	network_modules	141	TRUE	0.0036707300376271216	86	19	4	0.21052631578947367	0.046511627906976744	GO:0051961	GO:BP	negative regulation of nervous system development	16175	14030		0.8272727272727273	0.8288288288288288	86	16089	4	15	82	16074	16175	0.09676934741082438
R1	cpdb	0	network_modules	141	TRUE	0.0037002546257368834	24	19	3	0.15789473684210525	0.125	GO:0048841	GO:BP	regulation of axon extension involved in axon guidance	16175	13085		0.8363636363636363	0.8378378378378378	24	16151	3	16	21	16135	16175	0.1393529077787942
R1	cpdb	0	network_modules	141	TRUE	0.003844772735090442	87	19	4	0.21052631578947367	0.04597701149425287	GO:0021953	GO:BP	central nervous system neuron differentiation	16175	6508		0.8454545454545455	0.8558558558558559	87	16088	4	15	83	16073	16175	0.09618559775526776
R1	cpdb	0	network_modules	141	TRUE	0.003844772735090442	87	19	4	0.21052631578947367	0.04597701149425287	GO:0010977	GO:BP	negative regulation of neuron projection development	16175	4553		0.8454545454545455	0.8558558558558559	87	16088	4	15	83	16073	16175	0.09618559775526776
R1	cpdb	0	network_modules	141	TRUE	0.003982783882032335	593	19	7	0.3684210526315789	0.011804384485666104	GO:0007417	GO:BP	central nervous system development	16175	2912		0.8636363636363636	0.8648648648648649	593	15582	7	12	586	15570	16175	0.060539473321338355
R1	cpdb	0	network_modules	141	TRUE	0.004236743019623479	375	19	6	0.3157894736842105	0.016	GO:0006935	GO:BP	chemotaxis	16175	2574		0.8727272727272727	0.8828828828828829	375	15800	6	13	369	15787	16175	0.06667953252454609
R1	cpdb	0	network_modules	141	TRUE	0.004236743019623479	375	19	6	0.3157894736842105	0.016	GO:0042330	GO:BP	taxis	16175	10096		0.8727272727272727	0.8828828828828829	375	15800	6	13	369	15787	16175	0.06667953252454609
R1	cpdb	0	network_modules	141	TRUE	0.004557382052659219	4	17	2	0.11764705882352941	0.5	REAC:R-HSA-8985801	REAC	Regulation of cortical dendrite branching	10916	2025		0.7	0.9090909090909091	4	10912	2	15	2	10897	10916	0.2420130338313592
R1	cpdb	0	network_modules	141	TRUE	0.004557382052659219	4	17	2	0.11764705882352941	0.5	REAC:R-HSA-194306	REAC	Neurophilin interactions with VEGF and VEGFR	10916	1591		0.7	0.9090909090909091	4	10912	2	15	2	10897	10916	0.2420130338313592
R1	cpdb	0	network_modules	141	TRUE	0.004557382052659219	4	17	2	0.11764705882352941	0.5	REAC:R-HSA-8985586	REAC	SLIT2:ROBO1 increases RHOA activity	10916	2148		0.7	0.9090909090909091	4	10912	2	15	2	10897	10916	0.2420130338313592
R1	cpdb	0	network_modules	141	TRUE	0.00503232307959776	217	17	5	0.29411764705882354	0.02304147465437788	REAC:R-HSA-376176	REAC	Signaling by ROBO receptors	10916	2301		1	1	217	10699	5	12	212	10687	10916	0.0775928559371562
R1	cpdb	0	network_modules	141	TRUE	0.005296018232941796	3	19	2	0.10526315789473684	0.6666666666666666	GO:0150018	GO:BP	basal dendrite development	16175	20097		0.8909090909090909	0.9369369369369369	3	16172	2	17	1	16155	16175	0.26461970208734953
R1	cpdb	0	network_modules	141	TRUE	0.005296018232941796	3	19	2	0.10526315789473684	0.6666666666666666	GO:0150020	GO:BP	basal dendrite arborization	16175	20099		0.8909090909090909	0.9369369369369369	3	16172	2	17	1	16155	16175	0.26461970208734953
R1	cpdb	0	network_modules	141	TRUE	0.005296018232941796	3	19	2	0.10526315789473684	0.6666666666666666	GO:0022028	GO:BP	tangential migration from the subventricular zone to the olfactory bulb	16175	6580		0.8909090909090909	0.9369369369369369	3	16172	2	17	1	16155	16175	0.26461970208734953
R1	cpdb	0	network_modules	141	TRUE	0.005296018232941796	3	19	2	0.10526315789473684	0.6666666666666666	GO:0061364	GO:BP	apoptotic process involved in luteolysis	16175	15436		0.8909090909090909	0.9369369369369369	3	16172	2	17	1	16155	16175	0.26461970208734953
R1	cpdb	0	network_modules	141	TRUE	0.005296018232941796	3	19	2	0.10526315789473684	0.6666666666666666	GO:0150019	GO:BP	basal dendrite morphogenesis	16175	20098		0.8909090909090909	0.9369369369369369	3	16172	2	17	1	16155	16175	0.26461970208734953
R1	cpdb	0	network_modules	141	TRUE	0.005296018232941796	3	19	2	0.10526315789473684	0.6666666666666666	GO:0001554	GO:BP	luteolysis	16175	345		0.8909090909090909	0.9369369369369369	3	16172	2	17	1	16155	16175	0.26461970208734953
R1	cpdb	0	network_modules	141	TRUE	0.00570265268248892	626	19	7	0.3684210526315789	0.011182108626198083	GO:0035295	GO:BP	tube development	16175	8953		0.9454545454545454	0.9459459459459459	626	15549	7	12	619	15537	16175	0.05862194281241861
R1	cpdb	0	network_modules	141	TRUE	0.0061475547359668105	400	19	6	0.3157894736842105	0.015	GO:0001525	GO:BP	angiogenesis	16175	330		0.9545454545454546	0.954954954954955	400	15775	6	13	394	15762	16175	0.06427201896785942
R1	cpdb	0	network_modules	141	TRUE	0.00665545531548152	29	19	3	0.15789473684210525	0.10344827586206896	GO:0060412	GO:BP	ventricular septum morphogenesis	16175	14613		0.9636363636363636	0.963963963963964	29	16146	3	16	26	16130	16175	0.12654084640823748
R1	cpdb	0	network_modules	141	TRUE	0.0077536337650053275	232	19	5	0.2631578947368421	0.021551724137931036	GO:0007162	GO:BP	negative regulation of cell adhesion	16175	2726		0.9727272727272728	0.972972972972973	232	15943	5	14	227	15929	16175	0.0717631202979514
R1	cpdb	0	network_modules	141	TRUE	0.008961895267447678	239	19	5	0.2631578947368421	0.02092050209205021	GO:0060485	GO:BP	mesenchyme development	16175	14679		0.9818181818181818	0.9819819819819819	239	15936	5	14	234	15922	16175	0.07059690906797418
R1	cpdb	0	network_modules	141	TRUE	0.009522870052197537	242	19	5	0.2631578947368421	0.02066115702479339	GO:0051056	GO:BP	regulation of small GTPase mediated signal transduction	16175	13466		0.990909090909091	0.990990990990991	242	15933	5	14	237	15919	16175	0.07011217178673257
R1	cpdb	0	network_modules	141	TRUE	0.00990818471842332	33	19	3	0.15789473684210525	0.09090909090909091	GO:0008038	GO:BP	neuron recognition	16175	3100		1	1	33	16142	3	16	30	16126	16175	0.1184508047106856
R1	cpdb	0	network_modules	143	TRUE	4.032591991488211e-13	192	17	11	0.6470588235294118	0.057291666666666664	KEGG:05202	KEGG	Transcriptional misregulation in cancer	8484	454		NA	1	192	8292	11	6	181	8286	8484	0.18813189974138167
R1	cpdb	0	network_modules	144	TRUE	6.77515033520198e-30	44	20	14	0.7	0.3181818181818182	GO:0048013	GO:BP	ephrin receptor signaling pathway	16175	12469		0	0.024390243902439025	44	16131	14	6	30	16125	16175	0.4710379266360588
R1	cpdb	0	network_modules	144	TRUE	2.2380809882626197e-27	49	20	14	0.7	0.2857142857142857	REAC:R-HSA-3928665	REAC	EPH-ephrin mediated repulsion of cells	10916	819		0	0.25	49	10867	14	6	35	10861	10916	0.44575499363005644
R1	cpdb	0	network_modules	144	TRUE	2.9330737432445176e-23	90	20	14	0.7	0.15555555555555556	REAC:R-HSA-2682334	REAC	EPH-Ephrin signaling	10916	818		0.3333333333333333	0.5	90	10826	14	6	76	10820	10916	0.327749590341538
R1	cpdb	0	network_modules	144	TRUE	1.8402862922445886e-22	28	20	11	0.55	0.39285714285714285	REAC:R-HSA-3928663	REAC	EPHA-mediated growth cone collapse	10916	820		0.6666666666666666	0.75	28	10888	11	9	17	10879	10916	0.46368647961595594
R1	cpdb	0	network_modules	144	TRUE	3.861664230918164e-22	181	17	15	0.8823529411764706	0.08287292817679558	KEGG:04360	KEGG	Axon guidance	8484	305		0	0.2	181	8303	15	2	166	8301	8484	0.26700297495070835
R1	cpdb	0	network_modules	144	TRUE	4.074895208873063e-21	165	20	14	0.7	0.08484848484848485	GO:0097485	GO:BP	neuron projection guidance	16175	18673		0.025	0.07317073170731707	165	16010	14	6	151	16004	16175	0.2415409522347672
R1	cpdb	0	network_modules	144	TRUE	4.074895208873063e-21	165	20	14	0.7	0.08484848484848485	GO:0007411	GO:BP	axon guidance	16175	2906		0.025	0.07317073170731707	165	16010	14	6	151	16004	16175	0.2415409522347672
R1	cpdb	0	network_modules	144	TRUE	1.883739410824182e-17	297	20	14	0.7	0.04713804713804714	GO:0007409	GO:BP	axonogenesis	16175	2905		0.075	0.0975609756097561	297	15878	14	6	283	15872	16175	0.1786420471037026
R1	cpdb	0	network_modules	144	TRUE	1.229602642837691e-16	339	20	14	0.7	0.04129793510324484	GO:0061564	GO:BP	axon development	16175	15561		0.1	0.12195121951219512	339	15836	14	6	325	15830	16175	0.16679371251847822
R1	cpdb	0	network_modules	144	TRUE	4.876486363371542e-16	510	20	15	0.75	0.029411764705882353	GO:0007169	GO:BP	cell surface receptor protein tyrosine kinase signaling pathway	16175	2733		0.125	0.14634146341463414	510	15665	15	5	495	15660	16175	0.14466520039284042
R1	cpdb	0	network_modules	144	TRUE	5.948403624751472e-16	379	20	14	0.7	0.036939313984168866	GO:0048667	GO:BP	cell morphogenesis involved in neuron differentiation	16175	12925		0.15	0.17073170731707318	379	15796	14	6	365	15790	16175	0.15737095900889062
R1	cpdb	0	network_modules	144	TRUE	2.9556196480477718e-15	761	20	16	0.8	0.02102496714848883	GO:0048666	GO:BP	neuron development	16175	12924		0.175	0.1951219512195122	761	15414	16	4	745	15410	16175	0.12511896448865978
R1	cpdb	0	network_modules	144	TRUE	5.023875684919938e-15	441	20	14	0.7	0.031746031746031744	GO:0048812	GO:BP	neuron projection morphogenesis	16175	13058		0.2	0.21951219512195122	441	15734	14	6	427	15728	16175	0.14534878822370786
R1	cpdb	0	network_modules	144	TRUE	8.037120310502559e-15	456	20	14	0.7	0.03070175438596491	GO:0120039	GO:BP	plasma membrane bounded cell projection morphogenesis	16175	19473		0.225	0.24390243902439024	456	15719	14	6	442	15713	16175	0.14280924484976998
R1	cpdb	0	network_modules	144	TRUE	9.085599424320048e-15	460	20	14	0.7	0.030434782608695653	GO:0048858	GO:BP	cell projection morphogenesis	16175	13102		0.25	0.2682926829268293	460	15715	14	6	446	15709	16175	0.14215272770685053
R1	cpdb	0	network_modules	144	TRUE	1.9037585175361592e-14	651	20	15	0.75	0.02304147465437788	GO:0000902	GO:BP	cell morphogenesis	16175	240		0.275	0.2926829268292683	651	15524	15	5	636	15519	16175	0.12706342305301496
R1	cpdb	0	network_modules	144	TRUE	3.424131648035195e-13	790	20	15	0.75	0.0189873417721519	GO:0007167	GO:BP	enzyme-linked receptor protein signaling pathway	16175	2731		0.3	0.3170731707317073	790	15385	15	5	775	15380	16175	0.11446168755620997
R1	cpdb	0	network_modules	144	TRUE	2.313788219165256e-12	684	20	14	0.7	0.02046783625730994	GO:0031175	GO:BP	neuron projection development	16175	7086		0.325	0.34146341463414637	684	15491	14	6	670	15485	16175	0.11499372351911379
R1	cpdb	0	network_modules	144	TRUE	5.742736881814157e-7	33	20	5	0.25	0.15151515151515152	GO:0008038	GO:BP	neuron recognition	16175	3100		0.35	0.36585365853658536	33	16142	5	15	28	16127	16175	0.19335324601262996
R1	cpdb	0	network_modules	144	TRUE	8.294549331645199e-5	7	20	3	0.15	0.42857142857142855	GO:1902961	GO:BP	positive regulation of aspartic-type endopeptidase activity involved in amyloid precursor protein catabolic process	16175	22649		0.375	0.3902439024390244	7	16168	3	17	4	16151	16175	0.2530259686439337
R1	cpdb	0	network_modules	144	TRUE	1.2915897845339216e-4	210	17	6	0.35294117647058826	0.02857142857142857	KEGG:04015	KEGG	Rap1 signaling pathway	8484	248		0.25	0.4	210	8274	6	11	204	8263	8484	0.09464911558802865
R1	cpdb	0	network_modules	144	TRUE	1.326081599088824e-4	8	20	3	0.15	0.375	GO:1905247	GO:BP	positive regulation of aspartic-type peptidase activity	16175	24475		0.4	0.43902439024390244	8	16167	3	17	5	16150	16175	0.23659360431701468
R1	cpdb	0	network_modules	144	TRUE	1.326081599088824e-4	8	20	3	0.15	0.375	GO:1902959	GO:BP	regulation of aspartic-type endopeptidase activity involved in amyloid precursor protein catabolic process	16175	22647		0.4	0.43902439024390244	8	16167	3	17	5	16150	16175	0.23659360431701468
R1	cpdb	0	network_modules	144	TRUE	1.722974428805399e-4	533	20	8	0.4	0.0150093808630394	GO:0034330	GO:BP	cell junction organization	16175	8572		0.45	0.4634146341463415	533	15642	8	12	525	15630	16175	0.07234671568547413
R1	cpdb	0	network_modules	144	TRUE	1.987554200039531e-4	9	20	3	0.15	0.3333333333333333	GO:1905245	GO:BP	regulation of aspartic-type peptidase activity	16175	24473		0.475	0.4878048780487805	9	16166	3	17	6	16149	16175	0.22297724417132353
R1	cpdb	0	network_modules	144	TRUE	2.4414876064715054e-4	214	20	6	0.3	0.028037383177570093	GO:0018108	GO:BP	peptidyl-tyrosine phosphorylation	16175	5327		0.5	0.5121951219512195	214	15961	6	14	208	15947	16175	0.08830842561366162
R1	cpdb	0	network_modules	144	TRUE	2.484736538966447e-4	235	17	6	0.35294117647058826	0.02553191489361702	KEGG:04014	KEGG	Ras signaling pathway	8484	247		0.5	0.6	235	8249	6	11	229	8238	8484	0.08880396383730717
R1	cpdb	0	network_modules	144	TRUE	2.509699214441341e-4	215	20	6	0.3	0.027906976744186046	GO:0018212	GO:BP	peptidyl-tyrosine modification	16175	5371		0.525	0.5365853658536586	215	15960	6	14	209	15946	16175	0.08808658348310448
R1	cpdb	0	network_modules	144	TRUE	2.536674895132125e-4	366	20	7	0.35	0.01912568306010929	GO:0051336	GO:BP	regulation of hydrolase activity	16175	13663		0.55	0.5609756097560976	366	15809	7	13	359	15796	16175	0.07745603171497183
R1	cpdb	0	network_modules	144	TRUE	2.9192644174675134e-4	111	20	5	0.25	0.04504504504504504	GO:0008037	GO:BP	cell recognition	16175	3099		0.575	0.5853658536585366	111	16064	5	15	106	16049	16175	0.10362618723584512
R1	cpdb	0	network_modules	144	TRUE	2.9902927650913083e-4	43	20	4	0.2	0.09302325581395349	GO:0060997	GO:BP	dendritic spine morphogenesis	16175	15121		0.6	0.6097560975609756	43	16132	4	16	39	16116	16175	0.13484848291506996
R1	cpdb	0	network_modules	144	TRUE	5.621690246114371e-4	622	20	8	0.4	0.012861736334405145	GO:0030155	GO:BP	regulation of cell adhesion	16175	6688		0.625	0.6341463414634146	622	15553	8	12	614	15541	16175	0.06615559841921734
R1	cpdb	0	network_modules	144	TRUE	6.745833686919226e-4	13	20	3	0.15	0.23076923076923078	GO:0106030	GO:BP	neuron projection fasciculation	16175	19221		0.65	0.6829268292682927	13	16162	3	17	10	16145	16175	0.18524419362516745
R1	cpdb	0	network_modules	144	TRUE	6.745833686919226e-4	13	20	3	0.15	0.23076923076923078	GO:0007413	GO:BP	axonal fasciculation	16175	2908		0.65	0.6829268292682927	13	16162	3	17	10	16145	16175	0.18524419362516745
R1	cpdb	0	network_modules	144	TRUE	0.0010316268764931065	143	20	5	0.25	0.03496503496503497	GO:1901888	GO:BP	regulation of cell junction assembly	16175	21832		0.7	0.7073170731707317	143	16032	5	15	138	16017	16175	0.09064581602597127
R1	cpdb	0	network_modules	144	TRUE	0.001032451748709447	301	17	6	0.35294117647058826	0.019933554817275746	KEGG:04010	KEGG	MAPK signaling pathway	8484	243		0.75	0.8	301	8183	6	11	295	8172	8484	0.0768977132586767
R1	cpdb	0	network_modules	144	TRUE	0.0011887610309942646	17	20	3	0.15	0.17647058823529413	REAC:R-HSA-3928664	REAC	Ephrin signaling	10916	849		1	1	17	10899	3	17	14	10882	10916	0.1612819991646386
R1	cpdb	0	network_modules	144	TRUE	0.001246572844341064	61	20	4	0.2	0.06557377049180328	GO:0097061	GO:BP	dendritic spine organization	16175	18469		0.725	0.7317073170731707	61	16114	4	16	57	16098	16175	0.112642386196805
R1	cpdb	0	network_modules	144	TRUE	0.0015141393030002465	64	20	4	0.2	0.0625	GO:0060996	GO:BP	dendritic spine development	16175	15120		0.75	0.7560975609756098	64	16111	4	16	60	16095	16175	0.10987693159063731
R1	cpdb	0	network_modules	144	TRUE	0.002136057581726714	2	20	2	0.1	1	GO:0097156	GO:BP	fasciculation of motor neuron axon	16175	18516		0.775	0.7804878048780488	2	16173	2	18	0	16155	16175	0.316051741641375
R1	cpdb	0	network_modules	144	TRUE	0.002302651031789135	71	20	4	0.2	0.056338028169014086	GO:0106027	GO:BP	neuron projection organization	16175	19219		0.8	0.8048780487804879	71	16104	4	16	67	16088	16175	0.10411227491687333
R1	cpdb	0	network_modules	144	TRUE	0.0026747522551270565	356	17	6	0.35294117647058826	0.016853932584269662	KEGG:04151	KEGG	PI3K-Akt signaling pathway	8484	285		1	1	356	8128	6	11	350	8117	8484	0.06949854724332358
R1	cpdb	0	network_modules	144	TRUE	0.003065600230434619	530	20	7	0.35	0.013207547169811321	GO:0043408	GO:BP	regulation of MAPK cascade	16175	10676		0.825	0.8292682926829268	530	15645	7	13	523	15632	16175	0.06269876299557108
R1	cpdb	0	network_modules	144	TRUE	0.003486293559964248	183	20	5	0.25	0.0273224043715847	GO:0043087	GO:BP	regulation of GTPase activity	16175	10520		0.85	0.8536585365853658	183	15992	5	15	178	15977	16175	0.07940653790389576
R1	cpdb	0	network_modules	144	TRUE	0.0036066804358527516	22	20	3	0.15	0.13636363636363635	GO:1902993	GO:BP	positive regulation of amyloid precursor protein catabolic process	16175	22676		0.875	0.8780487804878049	22	16153	3	17	19	16136	16175	0.14190679921914243
R1	cpdb	0	network_modules	144	TRUE	0.004058777946424487	346	20	6	0.3	0.017341040462427744	GO:0034329	GO:BP	cell junction assembly	16175	8571		0.9	0.9024390243902439	346	15829	6	14	340	15815	16175	0.06775418148930393
R1	cpdb	0	network_modules	144	TRUE	0.006403418026022153	3	20	2	0.1	0.6666666666666666	GO:0097155	GO:BP	fasciculation of sensory neuron axon	16175	18515		0.925	0.926829268292683	3	16172	2	18	1	16154	16175	0.25790340281345747
R1	cpdb	0	network_modules	144	TRUE	0.00660302654103299	595	20	7	0.35	0.011764705882352941	GO:0000165	GO:BP	MAPK cascade	16175	55		0.95	0.9512195121951219	595	15580	7	13	588	15567	16175	0.05854717222293193
R1	cpdb	0	network_modules	144	TRUE	0.006799735211003229	93	20	4	0.2	0.043010752688172046	GO:0048813	GO:BP	dendrite morphogenesis	16175	13059		0.975	0.975609756097561	93	16082	4	16	89	16066	16175	0.0903974530083411
R1	cpdb	0	network_modules	144	TRUE	0.00837929822998974	98	20	4	0.2	0.04081632653061224	GO:0099173	GO:BP	postsynapse organization	16175	19081		1	1	98	16077	4	16	94	16061	16175	0.08793474157835751
R1	cpdb	0	network_modules	145	TRUE	0.008542331266188554	84	11	3	0.2727272727272727	0.03571428571428571	KEGG:04012	KEGG	ErbB signaling pathway	8484	245		NA	1	84	8400	3	8	81	8392	8484	0.09564624082529978
R1	cpdb	0	network_modules	146	TRUE	3.344789561623241e-4	192	23	6	0.2608695652173913	0.03125	GO:0007160	GO:BP	cell-matrix adhesion	16175	2724		0	0.25	192	15983	6	17	186	15966	16175	0.08675880920412127
R1	cpdb	0	network_modules	146	TRUE	0.002982645033309725	279	23	6	0.2608695652173913	0.021505376344086023	GO:0031589	GO:BP	cell-substrate adhesion	16175	7233		0.3333333333333333	0.5	279	15896	6	17	273	15879	16175	0.07060951947159412
R1	cpdb	0	network_modules	146	TRUE	0.008783952978863854	3	23	2	0.08695652173913043	0.6666666666666666	GO:0072218	GO:BP	metanephric ascending thin limb development	16175	17248		0.6666666666666666	1	3	16172	2	21	1	16151	16175	0.24045145819458102
R1	cpdb	0	network_modules	146	TRUE	0.008783952978863854	3	23	2	0.08695652173913043	0.6666666666666666	GO:0072021	GO:BP	ascending thin limb development	16175	17056		0.6666666666666666	1	3	16172	2	21	1	16151	16175	0.24045145819458102
R1	cpdb	0	network_modules	147	TRUE	8.042598214775597e-9	14	20	5	0.25	0.35714285714285715	REAC:R-HSA-354194	REAC	GRB2:SOS provides linkage to MAPK signaling for Integrins 	10916	1024		0	0.03333333333333333	14	10902	5	15	9	10887	10916	0.2977379390103213
R1	cpdb	0	network_modules	147	TRUE	1.2050070835268804e-8	15	20	5	0.25	0.3333333333333333	REAC:R-HSA-372708	REAC	p130Cas linkage to MAPK signaling for integrins	10916	2715		0.034482758620689655	0.06666666666666667	15	10901	5	15	10	10886	10916	0.2875494190587937
R1	cpdb	0	network_modules	147	TRUE	2.1853620485835913e-8	124	14	7	0.5	0.056451612903225805	KEGG:04611	KEGG	Platelet activation	8484	321		0	0.3333333333333333	124	8360	7	7	117	8353	8484	0.1644351556168119
R1	cpdb	0	network_modules	147	TRUE	3.180270197643704e-8	179	20	8	0.4	0.0446927374301676	GO:0007596	GO:BP	blood coagulation	16175	3055		0	0.030303030303030304	179	15996	8	12	171	15984	16175	0.1308124225707846
R1	cpdb	0	network_modules	147	TRUE	3.7985667887197684e-8	183	20	8	0.4	0.04371584699453552	GO:0050817	GO:BP	coagulation	16175	13279		0.03125	0.06060606060606061	183	15992	8	12	175	15980	16175	0.12930878813748434
R1	cpdb	0	network_modules	147	TRUE	4.145198382280106e-8	185	20	8	0.4	0.043243243243243246	GO:0007599	GO:BP	hemostasis	16175	3058		0.0625	0.09090909090909091	185	15990	8	12	177	15978	16175	0.1285750502136953
R1	cpdb	0	network_modules	147	TRUE	1.0482484661414751e-7	22	20	5	0.25	0.22727272727272727	REAC:R-HSA-140875	REAC	Common Pathway of Fibrin Clot Formation	10916	388		0.06896551724137931	0.1	22	10894	5	15	17	10879	10916	0.23689979256170432
R1	cpdb	0	network_modules	147	TRUE	2.606443288712169e-7	26	20	5	0.25	0.19230769230769232	REAC:R-HSA-354192	REAC	Integrin signaling	10916	1217		0.10344827586206896	0.13333333333333333	26	10890	5	15	21	10875	10916	0.217634069227354
R1	cpdb	0	network_modules	147	TRUE	4.4518724414913554e-7	249	20	8	0.4	0.0321285140562249	GO:0050878	GO:BP	regulation of body fluid levels	16175	13323		0.09375	0.12121212121212122	249	15926	8	12	241	15914	16175	0.10991796738142537
R1	cpdb	0	network_modules	147	TRUE	5.337317346476502e-7	126	20	7	0.35	0.05555555555555555	REAC:R-HSA-114608	REAC	Platelet degranulation 	10916	1764		0.13793103448275862	0.16666666666666666	126	10790	7	13	119	10777	10916	0.13575407707805362
R1	cpdb	0	network_modules	147	TRUE	7.017857834042423e-7	131	20	7	0.35	0.05343511450381679	REAC:R-HSA-76005	REAC	Response to elevated platelet cytosolic Ca2+	10916	2090		0.1724137931034483	0.2	131	10785	7	13	124	10772	10916	0.13298878357289048
R1	cpdb	0	network_modules	147	TRUE	1.2730931286577715e-6	35	20	5	0.25	0.14285714285714285	REAC:R-HSA-6802948	REAC	Signaling by high-kinase activity BRAF mutants	10916	2321		0.20689655172413793	0.23333333333333334	35	10881	5	15	30	10866	10916	0.187029716092355
R1	cpdb	0	network_modules	147	TRUE	1.9616737793506243e-6	38	20	5	0.25	0.13157894736842105	REAC:R-HSA-76009	REAC	Platelet Aggregation (Plug Formation)	10916	1761		0.2413793103448276	0.26666666666666666	38	10878	5	15	33	10863	10916	0.17932003822197362
R1	cpdb	0	network_modules	147	TRUE	2.247573483185842e-6	39	20	5	0.25	0.1282051282051282	REAC:R-HSA-140877	REAC	Formation of Fibrin Clot (Clotting Cascade)	10916	945		0.27586206896551724	0.3333333333333333	39	10877	5	15	34	10862	10916	0.17694849075691402
R1	cpdb	0	network_modules	147	TRUE	2.247573483185842e-6	39	20	5	0.25	0.1282051282051282	REAC:R-HSA-5674135	REAC	MAP2K and MAPK activation	10916	1346		0.27586206896551724	0.3333333333333333	39	10877	5	15	34	10862	10916	0.17694849075691402
R1	cpdb	0	network_modules	147	TRUE	2.565708107331832e-6	40	20	5	0.25	0.125	REAC:R-HSA-9656223	REAC	Signaling by RAF1 mutants	10916	2296		0.3448275862068966	0.36666666666666664	40	10876	5	15	35	10861	10916	0.17466571163513392
R1	cpdb	0	network_modules	147	TRUE	2.9774637650505154e-6	192	20	7	0.35	0.036458333333333336	GO:0007160	GO:BP	cell-matrix adhesion	16175	2724		0.125	0.15151515151515152	192	15983	7	13	185	15970	16175	0.10985239454727473
R1	cpdb	0	network_modules	147	TRUE	2.9989998582100897e-6	259	20	8	0.4	0.03088803088803089	REAC:R-HSA-76002	REAC	Platelet activation, signaling and aggregation	10916	1762		0.3793103448275862	0.4	259	10657	8	12	251	10645	10916	0.10592075905949666
R1	cpdb	0	network_modules	147	TRUE	3.38165648637638e-6	15	20	4	0.2	0.26666666666666666	GO:0072378	GO:BP	blood coagulation, fibrin clot formation	16175	17375		0.15625	0.18181818181818182	15	16160	4	16	11	16144	16175	0.2301182595134178
R1	cpdb	0	network_modules	147	TRUE	4.505305632880512e-6	16	20	4	0.2	0.25	GO:0072376	GO:BP	protein activation cascade	16175	17373		0.1875	0.21212121212121213	16	16159	4	16	12	16143	16175	0.22274874279624585
R1	cpdb	0	network_modules	147	TRUE	4.736617108214964e-6	45	20	5	0.25	0.1111111111111111	REAC:R-HSA-6802949	REAC	Signaling by RAS mutants	10916	2299		0.41379310344827586	0.5333333333333333	45	10871	5	15	40	10856	10916	0.16440800418094137
R1	cpdb	0	network_modules	147	TRUE	4.736617108214964e-6	45	20	5	0.25	0.1111111111111111	REAC:R-HSA-6802946	REAC	Signaling by moderate kinase activity BRAF mutants	10916	2325		0.41379310344827586	0.5333333333333333	45	10871	5	15	40	10856	10916	0.16440800418094137
R1	cpdb	0	network_modules	147	TRUE	4.736617108214964e-6	45	20	5	0.25	0.1111111111111111	REAC:R-HSA-9649948	REAC	Signaling downstream of RAS mutants	10916	2329		0.41379310344827586	0.5333333333333333	45	10871	5	15	40	10856	10916	0.16440800418094137
R1	cpdb	0	network_modules	147	TRUE	4.736617108214964e-6	45	20	5	0.25	0.1111111111111111	REAC:R-HSA-6802955	REAC	Paradoxical activation of RAF signaling by kinase inactive BRAF	10916	1715		0.41379310344827586	0.5333333333333333	45	10871	5	15	40	10856	10916	0.16440800418094137
R1	cpdb	0	network_modules	147	TRUE	5.100254866654362e-6	339	20	8	0.4	0.02359882005899705	GO:0042060	GO:BP	wound healing	16175	9947		0.21875	0.24242424242424243	339	15836	8	12	331	15824	16175	0.093104406742003
R1	cpdb	0	network_modules	147	TRUE	5.9512458300646094e-6	115	20	6	0.3	0.05217391304347826	GO:0030168	GO:BP	platelet activation	16175	6695		0.25	0.2727272727272727	115	16060	6	14	109	16046	16175	0.12265607100439767
R1	cpdb	0	network_modules	147	TRUE	6.488543935116046e-6	17	20	4	0.2	0.23529411764705882	REAC:R-HSA-5602498	REAC	MyD88 deficiency (TLR2/4)	10916	1498		0.5517241379310345	0.5666666666666667	17	10899	4	16	13	10883	10916	0.2156066814307826
R1	cpdb	0	network_modules	147	TRUE	8.332624335153239e-6	18	20	4	0.2	0.2222222222222222	REAC:R-HSA-5603041	REAC	IRAK4 deficiency (TLR2/4)	10916	1158		0.5862068965517241	0.6	18	10898	4	16	14	10882	10916	0.20944491201331264
R1	cpdb	0	network_modules	147	TRUE	1.022793225031346e-5	86	14	5	0.35714285714285715	0.05813953488372093	KEGG:04610	KEGG	Complement and coagulation cascades	8484	320		0.5	0.6666666666666666	86	8398	5	9	81	8389	8484	0.1408390080363615
R1	cpdb	0	network_modules	147	TRUE	1.530997278592256e-5	62	20	5	0.25	0.08064516129032258	GO:0070527	GO:BP	platelet aggregation	16175	16166		0.28125	0.30303030303030304	62	16113	5	15	57	16098	16175	0.14016883284815623
R1	cpdb	0	network_modules	147	TRUE	1.6240324350860877e-5	21	20	4	0.2	0.19047619047619047	REAC:R-HSA-5686938	REAC	Regulation of TLR by endogenous ligand	10916	2010		0.6206896551724138	0.6333333333333333	21	10895	4	16	17	10879	10916	0.19366629709065022
R1	cpdb	0	network_modules	147	TRUE	2.1330118426177912e-5	407	20	8	0.4	0.019656019656019656	GO:0009611	GO:BP	response to wounding	16175	3539		0.3125	0.3333333333333333	407	15768	8	12	399	15756	16175	0.08420998202302692
R1	cpdb	0	network_modules	147	TRUE	2.8921108530296573e-5	64	20	5	0.25	0.078125	REAC:R-HSA-6802952	REAC	Signaling by BRAF and RAF1 fusions	10916	2225		0.6551724137931034	0.6666666666666666	64	10852	5	15	59	10837	10916	0.1370041694895333
R1	cpdb	0	network_modules	147	TRUE	3.9646895526768354e-05	279	20	7	0.35	0.025089605734767026	GO:0031589	GO:BP	cell-substrate adhesion	16175	7233		0.34375	0.36363636363636365	279	15896	7	13	272	15883	16175	0.08992477387155881
R1	cpdb	0	network_modules	147	TRUE	7.35817492643081e-5	30	20	4	0.2	0.13333333333333333	REAC:R-HSA-5602358	REAC	Diseases associated with the TLR signaling cascade	10916	753		0.6896551724137931	0.7333333333333333	30	10886	4	16	26	10870	10916	0.1614250870743807
R1	cpdb	0	network_modules	147	TRUE	7.35817492643081e-5	30	20	4	0.2	0.13333333333333333	REAC:R-HSA-5260271	REAC	Diseases of Immune System	10916	759		0.6896551724137931	0.7333333333333333	30	10886	4	16	26	10870	10916	0.1614250870743807
R1	cpdb	0	network_modules	147	TRUE	7.623527551491055e-5	85	20	5	0.25	0.058823529411764705	GO:0034109	GO:BP	homotypic cell-cell adhesion	16175	8417		0.375	0.3939393939393939	85	16090	5	15	80	16075	16175	0.11910557995178095
R1	cpdb	0	network_modules	147	TRUE	8.087843235465832e-5	86	20	5	0.25	0.05813953488372093	GO:0034446	GO:BP	substrate adhesion-dependent cell spreading	16175	8640		0.40625	0.42424242424242425	86	16089	5	15	81	16074	16175	0.1183848485142349
R1	cpdb	0	network_modules	147	TRUE	8.352406291657062e-5	311	20	7	0.35	0.022508038585209004	GO:0023061	GO:BP	signal release	16175	6645		0.4375	0.45454545454545453	311	15864	7	13	304	15851	16175	0.08475182273362086
R1	cpdb	0	network_modules	147	TRUE	1.0137801173827312e-4	82	20	5	0.25	0.06097560975609756	REAC:R-HSA-6802957	REAC	Oncogenic MAPK signaling	10916	1641		0.7586206896551724	0.7666666666666667	82	10834	5	15	77	10819	10916	0.12031895464621382
R1	cpdb	0	network_modules	147	TRUE	1.1444064338177088e-4	84	20	5	0.25	0.05952380952380952	REAC:R-HSA-216083	REAC	Integrin cell surface interactions	10916	1216		0.7931034482758621	0.8	84	10832	5	15	79	10817	10916	0.11879910210475511
R1	cpdb	0	network_modules	147	TRUE	3.4282516700168613e-4	583	20	8	0.4	0.0137221269296741	GO:0032940	GO:BP	secretion by cell	16175	7926		0.46875	0.48484848484848486	583	15592	8	12	575	15580	16175	0.06870215533560928
R1	cpdb	0	network_modules	147	TRUE	4.972888611077351e-4	188	14	5	0.35714285714285715	0.026595744680851064	KEGG:04613	KEGG	Neutrophil extracellular trap formation	8484	323		1	1	188	8296	5	9	183	8287	8484	0.09251946013727816
R1	cpdb	0	network_modules	147	TRUE	7.499788280258984e-4	646	20	8	0.4	0.01238390092879257	GO:0140352	GO:BP	export from cell	16175	19748		0.5	0.5151515151515151	646	15529	8	12	638	15517	16175	0.06469859937814774
R1	cpdb	0	network_modules	147	TRUE	7.596426472443592e-4	54	20	4	0.2	0.07407407407407407	GO:0034113	GO:BP	heterotypic cell-cell adhesion	16175	8421		0.53125	0.5454545454545454	54	16121	4	16	50	16105	16175	0.1199588564001439
R1	cpdb	0	network_modules	147	TRUE	7.768687803566638e-4	649	20	8	0.4	0.012326656394453005	GO:0046903	GO:BP	secretion	16175	12430		0.5625	0.5757575757575758	649	15526	8	12	641	15514	16175	0.06452187457903373
R1	cpdb	0	network_modules	147	TRUE	8.217257509170357e-4	263	20	6	0.3	0.022813688212927757	GO:0006887	GO:BP	exocytosis	16175	2543		0.59375	0.6060606060606061	263	15912	6	14	257	15898	16175	0.07893809320352864
R1	cpdb	0	network_modules	147	TRUE	8.578837838984587e-4	14	20	3	0.15	0.21428571428571427	GO:0034116	GO:BP	positive regulation of heterotypic cell-cell adhesion	16175	8424		0.625	0.6666666666666666	14	16161	3	17	11	16144	16175	0.17843732284698927
R1	cpdb	0	network_modules	147	TRUE	8.578837838984587e-4	14	20	3	0.15	0.21428571428571427	GO:0045907	GO:BP	positive regulation of vasoconstriction	16175	11703		0.625	0.6666666666666666	14	16161	3	17	11	16144	16175	0.17843732284698927
R1	cpdb	0	network_modules	147	TRUE	0.001105186943339058	145	20	5	0.25	0.034482758620689655	GO:0006836	GO:BP	neurotransmitter transport	16175	2506		0.6875	0.696969696969697	145	16030	5	15	140	16015	16175	0.08997795991799083
R1	cpdb	0	network_modules	147	TRUE	0.0011887610309942646	17	20	3	0.15	0.17647058823529413	REAC:R-HSA-181429	REAC	Serotonin Neurotransmitter Release Cycle	10916	2206		0.8275862068965517	0.8333333333333334	17	10899	3	17	14	10882	10916	0.1612819991646386
R1	cpdb	0	network_modules	147	TRUE	0.0012232415913567783	148	20	5	0.25	0.033783783783783786	GO:0017157	GO:BP	regulation of exocytosis	16175	5287		0.71875	0.7272727272727273	148	16027	5	15	143	16012	16175	0.08900115031860074
R1	cpdb	0	network_modules	147	TRUE	0.00186151585197713	264	20	6	0.3	0.022727272727272728	REAC:R-HSA-5673001	REAC	RAF/MAP kinase cascade	10916	1841		0.8620689655172413	0.8666666666666667	264	10652	6	14	258	10638	10916	0.07692115834424905
R1	cpdb	0	network_modules	147	TRUE	0.0020739426947325003	269	20	6	0.3	0.022304832713754646	REAC:R-HSA-5684996	REAC	MAPK1/MAPK3 signaling	10916	1351		0.896551724137931	0.9	269	10647	6	14	263	10633	10916	0.07609423646047461
R1	cpdb	0	network_modules	147	TRUE	0.0026765051786323546	22	20	3	0.15	0.13636363636363635	REAC:R-HSA-212676	REAC	Dopamine Neurotransmitter Release Cycle	10916	781		0.9310344827586207	0.9333333333333333	22	10894	3	17	19	10877	10916	0.14136975430520027
R1	cpdb	0	network_modules	147	TRUE	0.004144412674470078	23	20	3	0.15	0.13043478260869565	GO:0034114	GO:BP	regulation of heterotypic cell-cell adhesion	16175	8422		0.75	0.7575757575757576	23	16152	3	17	20	16135	16175	0.13873415606930908
R1	cpdb	0	network_modules	147	TRUE	0.004505613719761138	308	20	6	0.3	0.01948051948051948	REAC:R-HSA-5683057	REAC	MAPK family signaling cascades	10916	1348		0.9655172413793104	0.9666666666666667	308	10608	6	14	302	10594	10916	0.07031979680013077
R1	cpdb	0	network_modules	147	TRUE	0.0047327376420756824	24	20	3	0.15	0.125	GO:1902042	GO:BP	negative regulation of extrinsic apoptotic signaling pathway via death domain receptors	16175	21965		0.78125	0.8484848484848485	24	16151	3	17	21	16134	16175	0.13576080024891163
R1	cpdb	0	network_modules	147	TRUE	0.0047327376420756824	24	20	3	0.15	0.125	GO:0042730	GO:BP	fibrinolysis	16175	10330		0.78125	0.8484848484848485	24	16151	3	17	21	16134	16175	0.13576080024891163
R1	cpdb	0	network_modules	147	TRUE	0.0047327376420756824	24	20	3	0.15	0.125	GO:0031639	GO:BP	plasminogen activation	16175	7249		0.78125	0.8484848484848485	24	16151	3	17	21	16134	16175	0.13576080024891163
R1	cpdb	0	network_modules	147	TRUE	0.005208585849082069	87	20	4	0.2	0.04597701149425287	GO:0010811	GO:BP	positive regulation of cell-substrate adhesion	16175	4423		0.875	0.8787878787878788	87	16088	4	16	83	16072	16175	0.09362365361441596
R1	cpdb	0	network_modules	147	TRUE	0.00537387115099537	25	20	3	0.15	0.12	GO:2000352	GO:BP	negative regulation of endothelial cell apoptotic process	16175	25671		0.90625	0.9090909090909091	25	16150	3	17	22	16133	16175	0.13296661929196105
R1	cpdb	0	network_modules	147	TRUE	0.006393428598269002	90	20	4	0.2	0.044444444444444446	REAC:R-HSA-1236974	REAC	ER-Phagosome pathway	10916	824		1	1	90	10826	4	16	86	10810	10916	0.0908525058934881
R1	cpdb	0	network_modules	147	TRUE	0.0094485284744261	101	20	4	0.2	0.039603960396039604	GO:0007269	GO:BP	neurotransmitter secretion	16175	2797		0.9375	0.9696969696969697	101	16074	4	16	97	16058	16175	0.08654417452565162
R1	cpdb	0	network_modules	147	TRUE	0.0094485284744261	101	20	4	0.2	0.039603960396039604	GO:0099643	GO:BP	signal release from synapse	16175	19183		0.9375	0.9696969696969697	101	16074	4	16	97	16058	16175	0.08654417452565162
R1	cpdb	0	network_modules	147	TRUE	0.009908095875962517	404	20	6	0.3	0.01485148514851485	GO:1903530	GO:BP	regulation of secretion by cell	16175	23080		1	1	404	15771	6	14	398	15757	16175	0.06200901220273792
R1	cpdb	0	network_modules	148	TRUE	3.4192349859413825e-4	42	21	4	0.19047619047619047	0.09523809523809523	REAC:R-HSA-5675221	REAC	Negative regulation of MAPK pathway	10916	1573		0	0.3333333333333333	42	10874	4	17	38	10857	10916	0.13234834326962486
R1	cpdb	0	network_modules	148	TRUE	0.0013790450821674135	210	15	5	0.3333333333333333	0.023809523809523808	KEGG:04015	KEGG	Rap1 signaling pathway	8484	248		0	0.5	210	8274	5	10	205	8264	8484	0.08358566454671225
R1	cpdb	0	network_modules	148	TRUE	0.005769305102429027	308	21	6	0.2857142857142857	0.01948051948051948	REAC:R-HSA-5683057	REAC	MAPK family signaling cascades	10916	1348		0.5	0.6666666666666666	308	10608	6	15	302	10593	10916	0.06827201016359552
R1	cpdb	0	network_modules	148	TRUE	0.007728117517446573	301	15	5	0.3333333333333333	0.016611295681063124	KEGG:04010	KEGG	MAPK signaling pathway	8484	243		1	1	301	8183	5	10	296	8173	8484	0.06776341454486688
R1	cpdb	0	network_modules	148	TRUE	0.008431872394464449	31	21	3	0.14285714285714285	0.0967741935483871	REAC:R-HSA-187687	REAC	Signalling to ERKs	10916	2331		1	1	31	10885	3	18	28	10867	10916	0.11551705647427302
R1	cpdb	0	network_modules	149	TRUE	4.196456612751151e-4	2	13	2	0.15384615384615385	1	REAC:R-HSA-888568	REAC	GABA synthesis	10916	1012		0	1	2	10914	2	11	0	10903	10916	0.3920345589579044
R1	cpdb	0	network_modules	149	TRUE	4.196456612751151e-4	2	13	2	0.15384615384615385	1	REAC:R-HSA-9022927	REAC	MECP2 regulates transcription of genes involved in GABA signaling	10916	1358		0	1	2	10914	2	11	0	10903	10916	0.3920345589579044
R1	cpdb	0	network_modules	149	TRUE	0.00293052110335139	2	23	2	0.08695652173913043	1	GO:0006540	GO:BP	gamma-aminobutyrate shunt	16175	2260		NA	1	2	16173	2	21	0	16152	16175	0.29469240258173435
R1	cpdb	0	network_modules	149	TRUE	0.009125601646647498	16	10	2	0.2	0.125	KEGG:00430	KEGG	Taurine and hypotaurine metabolism	8484	56		NA	1	16	8468	2	8	14	8460	8484	0.15686331674328202
R1	cpdb	0	network_modules	150	TRUE	3.9683564511621373e-19	31	24	10	0.4166666666666667	0.3225806451612903	GO:0034368	GO:BP	protein-lipid complex remodeling	16175	8593		0	0.028985507246376812	31	16144	10	14	21	16130	16175	0.3655529641704274
R1	cpdb	0	network_modules	150	TRUE	3.9683564511621373e-19	31	24	10	0.4166666666666667	0.3225806451612903	GO:0034369	GO:BP	plasma lipoprotein particle remodeling	16175	8594		0	0.028985507246376812	31	16144	10	14	21	16130	16175	0.3655529641704274
R1	cpdb	0	network_modules	150	TRUE	8.268737367691769e-19	33	24	10	0.4166666666666667	0.30303030303030304	GO:0034367	GO:BP	protein-containing complex remodeling	16175	8592		0.029411764705882353	0.043478260869565216	33	16142	10	14	23	16128	16175	0.3542187908203853
R1	cpdb	0	network_modules	150	TRUE	1.0703529229562975e-18	32	21	10	0.47619047619047616	0.3125	REAC:R-HSA-8963899	REAC	Plasma lipoprotein remodeling	10916	1758		0	0.05	32	10884	10	11	22	10873	10916	0.38431663450750747
R1	cpdb	0	network_modules	150	TRUE	2.784407552352045e-17	51	17	10	0.5882352941176471	0.19607843137254902	KEGG:04979	KEGG	Cholesterol metabolism	8484	410		0	0.5	51	8433	10	7	41	8426	8484	0.3375003986740034
R1	cpdb	0	network_modules	150	TRUE	2.823036142530624e-17	45	24	10	0.4166666666666667	0.2222222222222222	GO:0071827	GO:BP	plasma lipoprotein particle organization	16175	16930		0.04411764705882353	0.057971014492753624	45	16130	10	14	35	16116	16175	0.3029047080865024
R1	cpdb	0	network_modules	150	TRUE	4.156736728279095e-17	71	21	11	0.5238095238095238	0.15492957746478872	REAC:R-HSA-174824	REAC	Plasma lipoprotein assembly, remodeling, and clearance	10916	1756		0.05263157894736842	0.1	71	10845	11	10	60	10835	10916	0.28252868020385796
R1	cpdb	0	network_modules	150	TRUE	4.574909879302468e-17	47	24	10	0.4166666666666667	0.2127659574468085	GO:0071825	GO:BP	protein-lipid complex organization	16175	16928		0.058823529411764705	0.07246376811594203	47	16128	10	14	37	16114	16175	0.2963196919325294
R1	cpdb	0	network_modules	150	TRUE	1.2659717223118827e-16	16	24	8	0.3333333333333333	0.5	GO:0034375	GO:BP	high-density lipoprotein particle remodeling	16175	8600		0.07352941176470588	0.08695652173913043	16	16159	8	16	8	16143	16175	0.4075407231275765
R1	cpdb	0	network_modules	150	TRUE	3.988722687220872e-16	92	24	11	0.4583333333333333	0.11956521739130435	GO:0030301	GO:BP	cholesterol transport	16175	6760		0.08823529411764706	0.10144927536231885	92	16083	11	13	81	16070	16175	0.23202298296058227
R1	cpdb	0	network_modules	150	TRUE	6.524731351443193e-16	96	24	11	0.4583333333333333	0.11458333333333333	GO:0015918	GO:BP	sterol transport	16175	5013		0.10294117647058823	0.11594202898550725	96	16079	11	13	85	16066	16175	0.2270418841403781
R1	cpdb	0	network_modules	150	TRUE	2.1567503652746697e-15	67	24	10	0.4166666666666667	0.14925373134328357	GO:0097006	GO:BP	regulation of plasma lipoprotein particle levels	16175	18441		0.11764705882352941	0.13043478260869565	67	16108	10	14	57	16094	16175	0.24759490687532273
R1	cpdb	0	network_modules	150	TRUE	7.42740939270973e-15	12	24	7	0.2916666666666667	0.5833333333333334	GO:0034370	GO:BP	triglyceride-rich lipoprotein particle remodeling	16175	8595		0.1323529411764706	0.15942028985507245	12	16163	7	17	5	16146	16175	0.4118881602057073
R1	cpdb	0	network_modules	150	TRUE	7.42740939270973e-15	12	24	7	0.2916666666666667	0.5833333333333334	GO:0034372	GO:BP	very-low-density lipoprotein particle remodeling	16175	8597		0.1323529411764706	0.15942028985507245	12	16163	7	17	5	16146	16175	0.4118881602057073
R1	cpdb	0	network_modules	150	TRUE	8.049026825261248e-14	301	24	13	0.5416666666666666	0.04318936877076412	GO:0006869	GO:BP	lipid transport	16175	2530		0.16176470588235295	0.17391304347826086	301	15874	13	11	288	15863	16175	0.1492015611947535
R1	cpdb	0	network_modules	150	TRUE	1.8154647824047586e-13	17	24	7	0.2916666666666667	0.4117647058823529	GO:0043691	GO:BP	reverse cholesterol transport	16175	10840		0.17647058823529413	0.18840579710144928	17	16158	7	17	10	16141	16175	0.3457410566026898
R1	cpdb	0	network_modules	150	TRUE	4.952542064001766e-13	346	24	13	0.5416666666666666	0.03757225433526012	GO:0010876	GO:BP	lipid localization	16175	4462		0.19117647058823528	0.2028985507246377	346	15829	13	11	333	15818	16175	0.13861776664850053
R1	cpdb	0	network_modules	150	TRUE	6.125137113318327e-13	9	21	6	0.2857142857142857	0.6666666666666666	REAC:R-HSA-8964058	REAC	HDL remodeling	10916	1095		0.10526315789473684	0.15	9	10907	6	15	3	10892	10916	0.43577524741860446
R1	cpdb	0	network_modules	150	TRUE	6.0733829024962786e-12	51	24	8	0.3333333333333333	0.1568627450980392	GO:0032371	GO:BP	regulation of sterol transport	16175	7525		0.20588235294117646	0.2318840579710145	51	16124	8	16	43	16108	16175	0.2270282503599945
R1	cpdb	0	network_modules	150	TRUE	6.0733829024962786e-12	51	24	8	0.3333333333333333	0.1568627450980392	GO:0032374	GO:BP	regulation of cholesterol transport	16175	7528		0.20588235294117646	0.2318840579710145	51	16124	8	16	43	16108	16175	0.2270282503599945
R1	cpdb	0	network_modules	150	TRUE	6.922620551717737e-12	218	24	11	0.4583333333333333	0.05045871559633028	GO:0015850	GO:BP	organic hydroxy compound transport	16175	4959		0.23529411764705882	0.2463768115942029	218	15957	11	13	207	15944	16175	0.14871868454374254
R1	cpdb	0	network_modules	150	TRUE	7.171307991004738e-12	52	24	8	0.3333333333333333	0.15384615384615385	GO:0033344	GO:BP	cholesterol efflux	16175	8154		0.25	0.2608695652173913	52	16123	8	16	44	16107	16175	0.22479956170294582
R1	cpdb	0	network_modules	150	TRUE	7.657335272370956e-11	36	24	7	0.2916666666666667	0.19444444444444445	GO:0034381	GO:BP	plasma lipoprotein particle clearance	16175	8606		0.2647058823529412	0.2753623188405797	36	16139	7	17	29	16122	16175	0.23676674580600035
R1	cpdb	0	network_modules	150	TRUE	1.3393600402900772e-10	18	21	6	0.2857142857142857	0.3333333333333333	REAC:R-HSA-8963898	REAC	Plasma lipoprotein assembly	10916	1755		0.15789473684210525	0.2	18	10898	6	15	12	10883	10916	0.30737471169750025
R1	cpdb	0	network_modules	150	TRUE	1.408627841189943e-10	74	24	8	0.3333333333333333	0.10810810810810811	GO:0042632	GO:BP	cholesterol homeostasis	16175	10265		0.27941176470588236	0.2898550724637681	74	16101	8	16	66	16085	16175	0.1877953082269862
R1	cpdb	0	network_modules	150	TRUE	1.575430976106659e-10	75	24	8	0.3333333333333333	0.10666666666666667	GO:0055092	GO:BP	sterol homeostasis	16175	14242		0.29411764705882354	0.30434782608695654	75	16100	8	16	67	16084	16175	0.1865098510490602
R1	cpdb	0	network_modules	150	TRUE	1.691533072189705e-10	128	24	9	0.375	0.0703125	GO:1905952	GO:BP	regulation of lipid localization	16175	25042		0.3088235294117647	0.3188405797101449	128	16047	9	15	119	16032	16175	0.15970435779483574
R1	cpdb	0	network_modules	150	TRUE	1.249863643476046e-9	10	21	5	0.23809523809523808	0.5	REAC:R-HSA-8963888	REAC	Chylomicron assembly	10916	358		0.21052631578947367	0.3	10	10906	5	16	5	10890	10916	0.3441940208000714
R1	cpdb	0	network_modules	150	TRUE	1.249863643476046e-9	10	21	5	0.23809523809523808	0.5	REAC:R-HSA-8963901	REAC	Chylomicron remodeling	10916	360		0.21052631578947367	0.3	10	10906	5	16	5	10890	10916	0.3441940208000714
R1	cpdb	0	network_modules	150	TRUE	1.5651559925235098e-9	99	24	8	0.3333333333333333	0.08080808080808081	GO:0032368	GO:BP	regulation of lipid transport	16175	7522		0.3235294117647059	0.3333333333333333	99	16076	8	16	91	16060	16175	0.16172377087395579
R1	cpdb	0	network_modules	150	TRUE	9.197138250138245e-9	13	24	5	0.20833333333333334	0.38461538461538464	GO:0033700	GO:BP	phospholipid efflux	16175	8356		0.3382352941176471	0.34782608695652173	13	16162	5	19	8	16143	16175	0.28230012684470285
R1	cpdb	0	network_modules	150	TRUE	1.6350462284943484e-8	132	24	8	0.3333333333333333	0.06060606060606061	GO:0055088	GO:BP	lipid homeostasis	16175	14238		0.35294117647058826	0.36231884057971014	132	16043	8	16	124	16027	16175	0.1393267082018601
R1	cpdb	0	network_modules	150	TRUE	2.3313404055547896e-8	78	24	7	0.2916666666666667	0.08974358974358974	GO:0006641	GO:BP	triglyceride metabolic process	16175	2352		0.36764705882352944	0.37681159420289856	78	16097	7	17	71	16080	16175	0.1596161455731469
R1	cpdb	0	network_modules	150	TRUE	2.798115338871317e-8	80	24	7	0.2916666666666667	0.0875	GO:0015914	GO:BP	phospholipid transport	16175	5010		0.38235294117647056	0.391304347826087	80	16095	7	17	73	16078	16175	0.15755016435099276
R1	cpdb	0	network_modules	150	TRUE	8.717991818213654e-8	6	24	4	0.16666666666666666	0.6666666666666666	GO:0034382	GO:BP	chylomicron remnant clearance	16175	8607		0.39705882352941174	0.42028985507246375	6	16169	4	20	2	16149	16175	0.33290021664463487
R1	cpdb	0	network_modules	150	TRUE	8.717991818213654e-8	6	24	4	0.16666666666666666	0.6666666666666666	GO:0071830	GO:BP	triglyceride-rich lipoprotein particle clearance	16175	16933		0.39705882352941174	0.42028985507246375	6	16169	4	20	2	16149	16175	0.33290021664463487
R1	cpdb	0	network_modules	150	TRUE	8.900152202560412e-8	94	24	7	0.2916666666666667	0.07446808510638298	GO:0008203	GO:BP	cholesterol metabolic process	16175	3130		0.4264705882352941	0.43478260869565216	94	16081	7	17	87	16064	16175	0.14496924937244413
R1	cpdb	0	network_modules	150	TRUE	1.708531807023157e-7	103	24	7	0.2916666666666667	0.06796116504854369	GO:1902652	GO:BP	secondary alcohol metabolic process	16175	22418		0.4411764705882353	0.4492753623188406	103	16072	7	17	96	16055	16175	0.13826001360287818
R1	cpdb	0	network_modules	150	TRUE	1.8653516105412284e-7	22	24	5	0.20833333333333334	0.22727272727272727	GO:0034377	GO:BP	plasma lipoprotein particle assembly	16175	8602		0.45588235294117646	0.463768115942029	22	16153	5	19	17	16134	16175	0.21648429683442197
R1	cpdb	0	network_modules	150	TRUE	2.0956301299351832e-7	106	24	7	0.2916666666666667	0.0660377358490566	GO:0006639	GO:BP	acylglycerol metabolic process	16175	2350		0.47058823529411764	0.4927536231884058	106	16069	7	17	99	16052	16175	0.13621357359370517
R1	cpdb	0	network_modules	150	TRUE	2.0956301299351832e-7	106	24	7	0.2916666666666667	0.0660377358490566	GO:0006638	GO:BP	neutral lipid metabolic process	16175	2349		0.47058823529411764	0.4927536231884058	106	16069	7	17	99	16052	16175	0.13621357359370517
R1	cpdb	0	network_modules	150	TRUE	2.2402530031609853e-7	107	24	7	0.2916666666666667	0.06542056074766354	GO:0016125	GO:BP	sterol metabolic process	16175	5143		0.5	0.5072463768115942	107	16068	7	17	100	16051	16175	0.1355503871030822
R1	cpdb	0	network_modules	150	TRUE	3.004847150888254e-7	24	24	5	0.20833333333333334	0.20833333333333334	GO:0065005	GO:BP	protein-lipid complex assembly	16175	15889		0.5147058823529411	0.5217391304347826	24	16151	5	19	19	16132	16175	0.20715693558706375
R1	cpdb	0	network_modules	150	TRUE	4.458501487914449e-7	61	24	6	0.25	0.09836065573770492	GO:0046470	GO:BP	phosphatidylcholine metabolic process	16175	12178		0.5294117647058824	0.5362318840579711	61	16114	6	18	55	16096	16175	0.15485397626076833
R1	cpdb	0	network_modules	150	TRUE	7.964801545644621e-7	128	24	7	0.2916666666666667	0.0546875	GO:0015748	GO:BP	organophosphate ester transport	16175	4867		0.5441176470588235	0.5507246376811594	128	16047	7	17	121	16030	16175	0.12344943000620717
R1	cpdb	0	network_modules	150	TRUE	1.0317377977798666e-6	337	24	9	0.375	0.026706231454005934	GO:0046486	GO:BP	glycerolipid metabolic process	16175	12190		0.5588235294117647	0.5652173913043478	337	15838	9	15	328	15823	16175	0.09558531737246152
R1	cpdb	0	network_modules	150	TRUE	1.192982905931243e-6	31	24	5	0.20833333333333334	0.16129032258064516	GO:0055090	GO:BP	acylglycerol homeostasis	16175	14240		0.5735294117647058	0.5942028985507246	31	16144	5	19	26	16125	16175	0.181931881867387
R1	cpdb	0	network_modules	150	TRUE	1.192982905931243e-6	31	24	5	0.20833333333333334	0.16129032258064516	GO:0070328	GO:BP	triglyceride homeostasis	16175	16059		0.5735294117647058	0.5942028985507246	31	16144	5	19	26	16125	16175	0.181931881867387
R1	cpdb	0	network_modules	150	TRUE	1.2156953963553982e-6	10	24	4	0.16666666666666666	0.4	GO:0034384	GO:BP	high-density lipoprotein particle clearance	16175	8609		0.6029411764705882	0.6086956521739131	10	16165	4	20	6	16145	16175	0.2575117897471632
R1	cpdb	0	network_modules	150	TRUE	1.663124879727886e-6	33	24	5	0.20833333333333334	0.15151515151515152	GO:0010874	GO:BP	regulation of cholesterol efflux	16175	4460		0.6176470588235294	0.6231884057971014	33	16142	5	19	28	16123	16175	0.17623792185084877
R1	cpdb	0	network_modules	150	TRUE	1.8112432451447183e-6	36	21	5	0.23809523809523808	0.1388888888888889	REAC:R-HSA-8964043	REAC	Plasma lipoprotein clearance	10916	1757		0.3157894736842105	0.35	36	10880	5	16	31	10864	10916	0.1797988903305315
R1	cpdb	0	network_modules	150	TRUE	4.126878497071776e-6	13	24	4	0.16666666666666666	0.3076923076923077	GO:0034374	GO:BP	low-density lipoprotein particle remodeling	16175	8599		0.6323529411764706	0.6376811594202898	13	16162	4	20	9	16142	16175	0.22562144616358287
R1	cpdb	0	network_modules	150	TRUE	5.166816219400867e-6	44	21	5	0.23809523809523808	0.11363636363636363	REAC:R-HSA-975634	REAC	Retinoid metabolism and transport	10916	2093		0.3684210526315789	0.4	44	10872	5	16	39	10856	10916	0.16218622618045406
R1	cpdb	0	network_modules	150	TRUE	6.493628872369131e-6	97	21	6	0.2857142857142857	0.061855670103092786	REAC:R-HSA-2173782	REAC	Binding and Uptake of Ligands by Scavenger Receptors	10916	223		0.42105263157894735	0.45	97	10819	6	15	91	10804	10916	0.12950619151079362
R1	cpdb	0	network_modules	150	TRUE	8.10667911309973e-6	48	21	5	0.23809523809523808	0.10416666666666667	REAC:R-HSA-6806667	REAC	Metabolism of fat-soluble vitamins	10916	1424		0.47368421052631576	0.5	48	10868	5	16	43	10852	10916	0.1550669203923217
R1	cpdb	0	network_modules	150	TRUE	1.1736098164800611e-5	107	21	6	0.2857142857142857	0.056074766355140186	REAC:R-HSA-8957275	REAC	Post-translational protein phosphorylation	10916	1777		0.5263157894736842	0.55	107	10809	6	15	101	10794	10916	0.1229548746974853
R1	cpdb	0	network_modules	150	TRUE	1.9371775986899965e-5	5	21	3	0.14285714285714285	0.6	REAC:R-HSA-8964026	REAC	Chylomicron clearance	10916	359		0.5789473684210527	0.6	5	10911	3	18	2	10893	10916	0.29217935115695076
R1	cpdb	0	network_modules	150	TRUE	2.8419459129693984e-5	124	21	6	0.2857142857142857	0.04838709677419355	REAC:R-HSA-381426	REAC	Regulation of Insulin-like Growth Factor (IGF) transport and uptake by Insulin-like Growth Factor Binding Proteins (IGFBPs)	10916	1981		0.631578947368421	0.65	124	10792	6	15	118	10777	10916	0.11366070098952102
R1	cpdb	0	network_modules	150	TRUE	3.869562489483968e-5	6	21	3	0.14285714285714285	0.5	REAC:R-HSA-8964041	REAC	LDL remodeling	10916	1296		0.6842105263157895	0.7	6	10910	3	18	3	10892	10916	0.2665626628941163
R1	cpdb	0	network_modules	150	TRUE	6.698471367806504e-5	242	24	7	0.2916666666666667	0.028925619834710745	GO:0008202	GO:BP	steroid metabolic process	16175	3129		0.6470588235294118	0.6521739130434783	242	15933	7	17	235	15916	16175	0.08786405218143771
R1	cpdb	0	network_modules	150	TRUE	8.943139015632971e-5	6	24	3	0.125	0.5	GO:0034447	GO:BP	very-low-density lipoprotein particle clearance	16175	8641		0.6617647058823529	0.6811594202898551	6	16169	3	21	3	16148	16175	0.249489518890329
R1	cpdb	0	network_modules	150	TRUE	8.943139015632971e-5	6	24	3	0.125	0.5	GO:0010901	GO:BP	regulation of very-low-density lipoprotein particle remodeling	16175	4487		0.6617647058823529	0.6811594202898551	6	16169	3	21	3	16148	16175	0.249489518890329
R1	cpdb	0	network_modules	150	TRUE	1.0115420669918593e-4	257	24	7	0.2916666666666667	0.027237354085603113	GO:0006066	GO:BP	alcohol metabolic process	16175	1933		0.6911764705882353	0.6956521739130435	257	15918	7	17	250	15901	16175	0.0850156594582692
R1	cpdb	0	network_modules	150	TRUE	0.00016086962493168855	80	24	5	0.20833333333333334	0.0625	GO:1905954	GO:BP	positive regulation of lipid localization	16175	25044		0.7058823529411765	0.7101449275362319	80	16095	5	19	75	16076	16175	0.11175933899045534
R1	cpdb	0	network_modules	150	TRUE	1.7840356932660563e-4	31	24	4	0.16666666666666666	0.12903225806451613	GO:0032376	GO:BP	positive regulation of cholesterol transport	16175	7530		0.7205882352941176	0.7391304347826086	31	16144	4	20	27	16124	16175	0.14520766540677896
R1	cpdb	0	network_modules	150	TRUE	1.7840356932660563e-4	31	24	4	0.16666666666666666	0.12903225806451613	GO:0032373	GO:BP	positive regulation of sterol transport	16175	7527		0.7205882352941176	0.7391304347826086	31	16144	4	20	27	16124	16175	0.14520766540677896
R1	cpdb	0	network_modules	150	TRUE	1.8129548031574518e-4	36	21	4	0.19047619047619047	0.1111111111111111	REAC:R-HSA-9029569	REAC	NR1H3 & NR1H2 regulate gene expression linked to cholesterol transport and efflux	10916	1547		0.7368421052631579	0.75	36	10880	4	17	32	10863	10916	0.14333402917476304
R1	cpdb	0	network_modules	150	TRUE	2.499204092417415e-4	8	24	3	0.125	0.375	GO:1905920	GO:BP	positive regulation of CoA-transferase activity	16175	25018		0.75	0.7681159420289855	8	16167	3	21	5	16146	16175	0.21586324943197172
R1	cpdb	0	network_modules	150	TRUE	2.499204092417415e-4	8	24	3	0.125	0.375	GO:1905918	GO:BP	regulation of CoA-transferase activity	16175	25016		0.75	0.7681159420289855	8	16167	3	21	5	16146	16175	0.21586324943197172
R1	cpdb	0	network_modules	150	TRUE	2.87317498939658e-4	97	21	5	0.23809523809523808	0.05154639175257732	REAC:R-HSA-2187338	REAC	Visual phototransduction	10916	2654		0.7894736842105263	0.8	97	10819	5	16	92	10803	10916	0.10722897966484864
R1	cpdb	0	network_modules	150	TRUE	3.442039194834832e-4	189	21	6	0.2857142857142857	0.031746031746031744	REAC:R-HSA-196854	REAC	Metabolism of vitamins and cofactors	10916	1440		0.8421052631578947	0.85	189	10727	6	15	183	10712	10916	0.09033840797189438
R1	cpdb	0	network_modules	150	TRUE	4.534483031305415e-4	45	21	4	0.19047619047619047	0.08888888888888889	REAC:R-HSA-9024446	REAC	NR1H2 and NR1H3-mediated signaling	10916	1546		0.8947368421052632	0.9	45	10871	4	17	41	10854	10916	0.12768997690441997
R1	cpdb	0	network_modules	150	TRUE	5.316922863471642e-4	328	24	7	0.2916666666666667	0.021341463414634148	GO:0006644	GO:BP	phospholipid metabolic process	16175	2355		0.7794117647058824	0.782608695652174	328	15847	7	17	321	15830	16175	0.0742217391973563
R1	cpdb	0	network_modules	150	TRUE	5.34501193424152e-4	10	24	3	0.125	0.3	GO:0034380	GO:BP	high-density lipoprotein particle assembly	16175	8605		0.7941176470588235	0.8260869565217391	10	16165	3	21	7	16144	16175	0.19289414781169373
R1	cpdb	0	network_modules	150	TRUE	5.34501193424152e-4	10	24	3	0.125	0.3	GO:0032375	GO:BP	negative regulation of cholesterol transport	16175	7529		0.7941176470588235	0.8260869565217391	10	16165	3	21	7	16144	16175	0.19289414781169373
R1	cpdb	0	network_modules	150	TRUE	5.34501193424152e-4	10	24	3	0.125	0.3	GO:0032372	GO:BP	negative regulation of sterol transport	16175	7526		0.7941176470588235	0.8260869565217391	10	16165	3	21	7	16144	16175	0.19289414781169373
R1	cpdb	0	network_modules	150	TRUE	7.598504043028633e-4	44	24	4	0.16666666666666666	0.09090909090909091	GO:0009395	GO:BP	phospholipid catabolic process	16175	3464		0.8382352941176471	0.8405797101449275	44	16131	4	20	40	16111	16175	0.12133753106001187
R1	cpdb	0	network_modules	150	TRUE	9.780113106450366e-4	12	24	3	0.125	0.25	GO:2001140	GO:BP	positive regulation of phospholipid transport	16175	26360		0.8529411764705882	0.855072463768116	12	16163	3	21	9	16142	16175	0.17592329514545899
R1	cpdb	0	network_modules	150	TRUE	0.0011891115917239236	763	24	9	0.375	0.011795543905635648	GO:0048878	GO:BP	chemical homeostasis	16175	13119		0.8676470588235294	0.8695652173913043	763	15412	9	15	754	15397	16175	0.059608069694733916
R1	cpdb	0	network_modules	150	TRUE	0.001270176640289424	13	24	3	0.125	0.23076923076923078	GO:2001138	GO:BP	regulation of phospholipid transport	16175	26358		0.8823529411764706	0.8840579710144928	13	16162	3	21	10	16141	16175	0.1689427654824629
R1	cpdb	0	network_modules	150	TRUE	0.001844878245497258	19	21	3	0.14285714285714285	0.15789473684210525	REAC:R-HSA-3000480	REAC	Scavenging by Class A Receptors	10916	2180		0.9473684210526315	0.95	19	10897	3	18	16	10879	10916	0.14863028800788033
R1	cpdb	0	network_modules	150	TRUE	0.0019186344585927046	397	24	7	0.2916666666666667	0.017632241813602016	GO:1901615	GO:BP	organic hydroxy compound metabolic process	16175	21597		0.8970588235294118	0.8985507246376812	397	15778	7	17	390	15761	16175	0.06654870880085409
R1	cpdb	0	network_modules	150	TRUE	0.0021827384827985113	57	24	4	0.16666666666666666	0.07017543859649122	GO:0046503	GO:BP	glycerolipid catabolic process	16175	12206		0.9117647058823529	0.9130434782608695	57	16118	4	20	53	16098	16175	0.10612675132307738
R1	cpdb	0	network_modules	150	TRUE	0.0025533281360618824	69	21	4	0.19047619047619047	0.057971014492753624	REAC:R-HSA-2168880	REAC	Scavenging of heme from plasma	10916	2184		1	1	69	10847	4	17	65	10830	10916	0.10201503044334283
R1	cpdb	0	network_modules	150	TRUE	0.0026865693280671023	60	24	4	0.16666666666666666	0.06666666666666667	GO:0032370	GO:BP	positive regulation of lipid transport	16175	7524		0.9264705882352942	0.927536231884058	60	16115	4	20	56	16095	16175	0.10333158190001307
R1	cpdb	0	network_modules	150	TRUE	0.00280349766699958	36	17	3	0.17647058823529413	0.08333333333333333	KEGG:05143	KEGG	African trypanosomiasis	8484	435		1	1	36	8448	3	14	33	8434	8484	0.11872280474091229
R1	cpdb	0	network_modules	150	TRUE	0.0032718503719319694	269	24	6	0.25	0.022304832713754646	GO:0006650	GO:BP	glycerophospholipid metabolic process	16175	2360		0.9411764705882353	0.9420289855072463	269	15906	6	18	263	15888	16175	0.07034568727209364
R1	cpdb	0	network_modules	150	TRUE	0.0058609106943852286	21	24	3	0.125	0.14285714285714285	GO:0006656	GO:BP	phosphatidylcholine biosynthetic process	16175	2365		0.9558823529411765	0.9565217391304348	21	16154	3	21	18	16133	16175	0.1324268911233211
R1	cpdb	0	network_modules	150	TRUE	0.006779710287488683	22	24	3	0.125	0.13636363636363635	GO:0032369	GO:BP	negative regulation of lipid transport	16175	7523		0.9705882352941176	0.9710144927536232	22	16153	3	21	19	16132	16175	0.1293215278126346
R1	cpdb	0	network_modules	150	TRUE	0.007789075887658279	23	24	3	0.125	0.13043478260869565	GO:0010875	GO:BP	positive regulation of cholesterol efflux	16175	4461		0.9852941176470589	0.9855072463768116	23	16152	3	21	20	16131	16175	0.12641961913648028
R1	cpdb	0	network_modules	150	TRUE	0.008542609148804024	80	24	4	0.16666666666666666	0.05	GO:0045833	GO:BP	negative regulation of lipid metabolic process	16175	11649		1	1	80	16095	4	20	76	16075	16175	0.08886392631018665
R1	cpdb	0	network_modules	151	TRUE	1.7332663663385526e-8	18	18	5	0.2777777777777778	0.2777777777777778	REAC:R-HSA-8963889	REAC	Assembly of active LPL and LIPC lipase complexes	10916	176		0	0.2	18	10898	5	13	13	10885	10916	0.2765848983503599
R1	cpdb	0	network_modules	151	TRUE	2.8416458091539514e-7	31	19	5	0.2631578947368421	0.16129032258064516	GO:0055090	GO:BP	acylglycerol homeostasis	16175	14240		0	0.1	31	16144	5	14	26	16130	16175	0.2048375991779781
R1	cpdb	0	network_modules	151	TRUE	2.8416458091539514e-7	31	19	5	0.2631578947368421	0.16129032258064516	GO:0070328	GO:BP	triglyceride homeostasis	16175	16059		0	0.1	31	16144	5	14	26	16130	16175	0.2048375991779781
R1	cpdb	0	network_modules	151	TRUE	4.0174253484746846e-7	32	18	5	0.2777777777777778	0.15625	REAC:R-HSA-8963899	REAC	Plasma lipoprotein remodeling	10916	1758		0.25	0.4	32	10884	5	13	27	10871	10916	0.20660794522490875
R1	cpdb	0	network_modules	151	TRUE	2.4985269256275505e-5	71	18	5	0.2777777777777778	0.07042253521126761	REAC:R-HSA-174824	REAC	Plasma lipoprotein assembly, remodeling, and clearance	10916	1756		0.5	0.6	71	10845	5	13	66	10832	10916	0.13714813241783394
R1	cpdb	0	network_modules	151	TRUE	3.695147834842986e-5	28	19	4	0.21052631578947367	0.14285714285714285	GO:0030970	GO:BP	retrograde protein transport, ER to cytosol	16175	6980		0.10526315789473684	0.2	28	16147	4	15	24	16132	16175	0.17224627645719445
R1	cpdb	0	network_modules	151	TRUE	3.695147834842986e-5	28	19	4	0.21052631578947367	0.14285714285714285	GO:1903513	GO:BP	endoplasmic reticulum to cytosol transport	16175	23063		0.10526315789473684	0.2	28	16147	4	15	24	16132	16175	0.17224627645719445
R1	cpdb	0	network_modules	151	TRUE	1.3844294523835407e-4	10	18	3	0.16666666666666666	0.3	REAC:R-HSA-8963901	REAC	Chylomicron remodeling	10916	360		0.75	0.8	10	10906	3	15	7	10891	10916	0.22266332413927906
R1	cpdb	0	network_modules	151	TRUE	1.5528732974810387e-4	9	19	3	0.15789473684210525	0.3333333333333333	GO:0019371	GO:BP	cyclooxygenase pathway	16175	5732		0.21052631578947367	0.25	9	16166	3	16	6	16150	16175	0.2288053323123006
R1	cpdb	0	network_modules	151	TRUE	3.173860848779393e-4	47	19	4	0.21052631578947367	0.0851063829787234	GO:0032527	GO:BP	protein exit from endoplasmic reticulum	16175	7621		0.2631578947368421	0.3	47	16128	4	15	43	16113	16175	0.1322773290074798
R1	cpdb	0	network_modules	151	TRUE	3.9665695108722634e-4	127	19	5	0.2631578947368421	0.03937007874015748	GO:0006633	GO:BP	fatty acid biosynthetic process	16175	2344		0.3157894736842105	0.35	127	16048	5	14	122	16034	16175	0.0991980952365146
R1	cpdb	0	network_modules	151	TRUE	4.058002299582739e-4	12	19	3	0.15789473684210525	0.25	GO:0051004	GO:BP	regulation of lipoprotein lipase activity	16175	13435		0.3684210526315789	0.4	12	16163	3	16	9	16147	16175	0.1979360151912499
R1	cpdb	0	network_modules	151	TRUE	4.808600655141863e-4	132	19	5	0.2631578947368421	0.03787878787878788	GO:0055088	GO:BP	lipid homeostasis	16175	14238		0.42105263157894735	0.45	132	16043	5	14	127	16029	16175	0.0971985400166443
R1	cpdb	0	network_modules	151	TRUE	5.222292692891012e-4	15	18	3	0.16666666666666666	0.2	REAC:R-HSA-2162123	REAC	Synthesis of Prostaglandins (PG) and Thromboxanes (TX)	10916	2398		1	1	15	10901	3	15	12	10886	10916	0.1813430115663804
R1	cpdb	0	network_modules	151	TRUE	0.0012644824188297813	66	19	4	0.21052631578947367	0.06060606060606061	GO:0036503	GO:BP	ERAD pathway	16175	9635		0.47368421052631576	0.5	66	16109	4	15	62	16094	16175	0.1110591296397128
R1	cpdb	0	network_modules	151	TRUE	0.0016576743524931048	319	19	6	0.3157894736842105	0.018808777429467086	GO:0006631	GO:BP	fatty acid metabolic process	16175	2343		0.5263157894736842	0.55	319	15856	6	13	313	15843	16175	0.07302187986744196
R1	cpdb	0	network_modules	151	TRUE	0.0020067709201687482	74	19	4	0.21052631578947367	0.05405405405405406	GO:0042632	GO:BP	cholesterol homeostasis	16175	10265		0.5789473684210527	0.6	74	16101	4	15	70	16086	16175	0.10465898898912754
R1	cpdb	0	network_modules	151	TRUE	0.002057674367619998	177	19	5	0.2631578947368421	0.02824858757062147	GO:0072330	GO:BP	monocarboxylic acid biosynthetic process	16175	17353		0.631578947368421	0.65	177	15998	5	14	172	15984	16175	0.08313918076794331
R1	cpdb	0	network_modules	151	TRUE	0.0021182531404570788	75	19	4	0.21052631578947367	0.05333333333333334	GO:0055092	GO:BP	sterol homeostasis	16175	14242		0.6842105263157895	0.7	75	16100	4	15	71	16085	16175	0.1039309414662071
R1	cpdb	0	network_modules	151	TRUE	0.002436912122067516	21	19	3	0.15789473684210525	0.14285714285714285	GO:0019433	GO:BP	triglyceride catabolic process	16175	5785		0.7368421052631579	0.75	21	16154	3	16	18	16138	16175	0.1491373278339042
R1	cpdb	0	network_modules	151	TRUE	0.003052461618563073	51	13	3	0.23076923076923078	0.058823529411764705	KEGG:04979	KEGG	Cholesterol metabolism	8484	410		0	0.3333333333333333	51	8433	3	10	48	8423	8484	0.1139052790231102
R1	cpdb	0	network_modules	151	TRUE	0.003240127037893117	23	19	3	0.15789473684210525	0.13043478260869565	GO:0046457	GO:BP	prostanoid biosynthetic process	16175	12165		0.7894736842105263	0.85	23	16152	3	16	20	16136	16175	0.14240194503174
R1	cpdb	0	network_modules	151	TRUE	0.003240127037893117	23	19	3	0.15789473684210525	0.13043478260869565	GO:0001516	GO:BP	prostaglandin biosynthetic process	16175	326		0.7894736842105263	0.85	23	16152	3	16	20	16136	16175	0.14240194503174
R1	cpdb	0	network_modules	151	TRUE	0.0037521139052851243	200	19	5	0.2631578947368421	0.025	GO:0034976	GO:BP	response to endoplasmic reticulum stress	16175	8746		0.8947368421052632	0.9	200	15975	5	14	195	15961	16175	0.07782773284071881
R1	cpdb	0	network_modules	151	TRUE	0.00501966774099667	168	13	4	0.3076923076923077	0.023809523809523808	KEGG:04141	KEGG	Protein processing in endoplasmic reticulum	8484	278		0.5	0.6666666666666666	168	8316	4	9	164	8307	8484	0.08095062155140278
R1	cpdb	0	network_modules	151	TRUE	0.005228748344179388	61	13	3	0.23076923076923078	0.04918032786885246	KEGG:00590	KEGG	Arachidonic acid metabolism	8484	92		1	1	61	8423	3	10	58	8413	8484	0.10366642591934026
R1	cpdb	0	network_modules	151	TRUE	0.009014129295979612	32	19	3	0.15789473684210525	0.09375	GO:0046461	GO:BP	neutral lipid catabolic process	16175	12169		0.9473684210526315	1	32	16143	3	16	29	16127	16175	0.12033134874051403
R1	cpdb	0	network_modules	151	TRUE	0.009014129295979612	32	19	3	0.15789473684210525	0.09375	GO:0046464	GO:BP	acylglycerol catabolic process	16175	12172		0.9473684210526315	1	32	16143	3	16	29	16127	16175	0.12033134874051403
R1	cpdb	0	network_modules	152	TRUE	1.789297451922571e-5	6	15	3	0.2	0.5	GO:0090118	GO:BP	receptor-mediated endocytosis involved in cholesterol transport	16175	18033		0	0.08333333333333333	6	16169	3	12	3	16157	16175	0.3158462977623385
R1	cpdb	0	network_modules	152	TRUE	1.472067141840827e-4	11	15	3	0.2	0.2727272727272727	GO:0010988	GO:BP	regulation of low-density lipoprotein particle clearance	16175	4563		0.09090909090909091	0.16666666666666666	11	16164	3	12	8	16152	16175	0.23294276220709734
R1	cpdb	0	network_modules	152	TRUE	6.04646915351773e-4	17	15	3	0.2	0.17647058823529413	GO:0010984	GO:BP	regulation of lipoprotein particle clearance	16175	4559		0.18181818181818182	0.25	17	16158	3	12	14	16146	16175	0.1870650819268692
R1	cpdb	0	network_modules	152	TRUE	7.251724331179435e-4	18	15	3	0.2	0.16666666666666666	GO:0001919	GO:BP	regulation of receptor recycling	16175	534		0.2727272727272727	0.3333333333333333	18	16157	3	12	15	16145	16175	0.18174371332799277
R1	cpdb	0	network_modules	152	TRUE	0.0011148721588836801	2	15	2	0.13333333333333333	1	GO:1905595	GO:BP	regulation of low-density lipoprotein particle receptor binding	16175	24753		0.36363636363636365	0.4166666666666667	2	16173	2	13	0	16160	16175	0.36500158742720296
R1	cpdb	0	network_modules	152	TRUE	0.001569497534929302	23	15	3	0.2	0.13043478260869565	GO:0034383	GO:BP	low-density lipoprotein particle clearance	16175	8608		0.45454545454545453	0.5	23	16152	3	12	20	16140	16175	0.16055484548270105
R1	cpdb	0	network_modules	152	TRUE	0.0025864295500052786	27	15	3	0.2	0.1111111111111111	GO:0032367	GO:BP	intracellular cholesterol transport	16175	7521		0.5454545454545454	0.5833333333333334	27	16148	3	12	24	16136	16175	0.14801920198550775
R1	cpdb	0	network_modules	152	TRUE	0.0035840603632773596	30	15	3	0.2	0.1	GO:0032366	GO:BP	intracellular sterol transport	16175	7520		0.6363636363636364	0.6666666666666666	30	16145	3	12	27	16133	16175	0.1403050597743004
R1	cpdb	0	network_modules	152	TRUE	0.006281978019066533	36	15	3	0.2	0.08333333333333333	GO:0034381	GO:BP	plasma lipoprotein particle clearance	16175	8606		0.7272727272727273	0.8333333333333334	36	16139	3	12	33	16127	16175	0.12786439562882096
R1	cpdb	0	network_modules	152	TRUE	0.006281978019066533	36	15	3	0.2	0.08333333333333333	GO:0001881	GO:BP	receptor recycling	16175	511		0.7272727272727273	0.8333333333333334	36	16139	3	12	33	16127	16175	0.12786439562882096
R1	cpdb	0	network_modules	152	TRUE	0.006682065795610729	4	15	2	0.13333333333333333	0.5	GO:1905600	GO:BP	regulation of receptor-mediated endocytosis involved in cholesterol transport	16175	24758		0.9090909090909091	1	4	16171	2	13	2	16158	16175	0.25787147420379075
R1	cpdb	0	network_modules	152	TRUE	0.006682065795610729	4	15	2	0.13333333333333333	0.5	GO:0010989	GO:BP	negative regulation of low-density lipoprotein particle clearance	16175	4564		0.9090909090909091	1	4	16171	2	13	2	16158	16175	0.25787147420379075
R1	cpdb	0	network_modules	153	TRUE	6.061452029931684e-14	13	28	7	0.25	0.5384615384615384	GO:0035235	GO:BP	ionotropic glutamate receptor signaling pathway	16175	8919		0	0.043478260869565216	13	16162	7	21	6	16141	16175	0.36618430687368136
R1	cpdb	0	network_modules	153	TRUE	6.061452029931684e-14	13	28	7	0.25	0.5384615384615384	GO:1990806	GO:BP	ligand-gated ion channel signaling pathway	16175	25299		0	0.043478260869565216	13	16162	7	21	6	16141	16175	0.36618430687368136
R1	cpdb	0	network_modules	153	TRUE	3.8161507096273315e-13	43	18	8	0.4444444444444444	0.18604651162790697	REAC:R-HSA-9609736	REAC	Assembly and cell surface presentation of NMDA receptors	10916	173		0	0.058823529411764705	43	10873	8	10	35	10863	10916	0.2858041739158732
R1	cpdb	0	network_modules	153	TRUE	1.4866446029680824e-12	89	18	9	0.5	0.10112359550561797	REAC:R-HSA-442755	REAC	Activation of NMDA receptors and postsynaptic events	10916	89		0.0625	0.11764705882352941	89	10827	9	9	80	10818	10916	0.22228347778630594
R1	cpdb	0	network_modules	153	TRUE	5.612543979146087e-11	40	18	7	0.3888888888888889	0.175	KEGG:05033	KEGG	Nicotine addiction	8484	421		0	0.06666666666666667	40	8444	7	11	33	8433	8484	0.2585959927606474
R1	cpdb	0	network_modules	153	TRUE	9.339451226541534e-11	20	18	6	0.3333333333333333	0.3	REAC:R-HSA-438066	REAC	Unblocking of NMDA receptors, glutamate binding and activation	10916	2621		0.125	0.23529411764705882	20	10896	6	12	14	10884	10916	0.3150379592854963
R1	cpdb	0	network_modules	153	TRUE	9.339451226541534e-11	20	18	6	0.3333333333333333	0.3	REAC:R-HSA-9617324	REAC	Negative regulation of NMDA receptor-mediated neuronal transmission	10916	1575		0.125	0.23529411764705882	20	10896	6	12	14	10884	10916	0.3150379592854963
R1	cpdb	0	network_modules	153	TRUE	1.3062894220113048e-10	21	18	6	0.3333333333333333	0.2857142857142857	REAC:R-HSA-9620244	REAC	Long-term potentiation	10916	1321		0.25	0.35294117647058826	21	10895	6	12	15	10883	10916	0.30737471169750025
R1	cpdb	0	network_modules	153	TRUE	1.3062894220113048e-10	21	18	6	0.3333333333333333	0.2857142857142857	REAC:R-HSA-8849932	REAC	Synaptic adhesion-like molecules	10916	2366		0.25	0.35294117647058826	21	10895	6	12	15	10883	10916	0.30737471169750025
R1	cpdb	0	network_modules	153	TRUE	2.559600761403782e-10	49	18	7	0.3888888888888889	0.14285714285714285	KEGG:05030	KEGG	Cocaine addiction	8484	418		0.07142857142857142	0.13333333333333333	49	8435	7	11	42	8424	8484	0.2331226325375124
R1	cpdb	0	network_modules	153	TRUE	3.849945591166968e-10	7	28	5	0.17857142857142858	0.7142857142857143	GO:0098976	GO:BP	excitatory chemical synaptic transmission	16175	18986		0.044444444444444446	0.06521739130434782	7	16168	5	23	2	16145	16175	0.35666327904218137
R1	cpdb	0	network_modules	153	TRUE	7.692281930863007e-10	41	28	7	0.25	0.17073170731707318	GO:0007215	GO:BP	glutamate receptor signaling pathway	16175	2769		0.06666666666666667	0.08695652173913043	41	16134	7	21	34	16113	16175	0.20494088371115884
R1	cpdb	0	network_modules	153	TRUE	1.9141999444125085e-9	22	28	6	0.21428571428571427	0.2727272727272727	GO:2000463	GO:BP	positive regulation of excitatory postsynaptic potential	16175	25775		0.08888888888888889	0.10869565217391304	22	16153	6	22	16	16131	16175	0.24058431285926024
R1	cpdb	0	network_modules	153	TRUE	2.107291552706461e-9	196	18	9	0.5	0.04591836734693878	REAC:R-HSA-112314	REAC	Neurotransmitter receptors and postsynaptic signal transmission	10916	1594		0.375	0.4117647058823529	196	10720	9	9	187	10711	10916	0.1475326917244246
R1	cpdb	0	network_modules	153	TRUE	3.142274824778934e-9	69	18	7	0.3888888888888889	0.10144927536231885	KEGG:05031	KEGG	Amphetamine addiction	8484	419		0.14285714285714285	0.2	69	8415	7	11	62	8404	8484	0.19547573456409173
R1	cpdb	0	network_modules	153	TRUE	5.523410427463044e-9	76	18	7	0.3888888888888889	0.09210526315789473	REAC:R-HSA-438064	REAC	Post NMDA receptor activation events	10916	1772		0.4375	0.47058823529411764	76	10840	7	11	69	10829	10916	0.1866744511883071
R1	cpdb	0	network_modules	153	TRUE	1.7332663663385526e-8	18	18	5	0.2777777777777778	0.2777777777777778	REAC:R-HSA-442982	REAC	Ras activation upon Ca2+ influx through NMDA receptor	10916	1941		0.5	0.5294117647058824	18	10898	5	13	13	10885	10916	0.2765848983503599
R1	cpdb	0	network_modules	153	TRUE	1.8338281354331486e-8	262	28	10	0.35714285714285715	0.03816793893129771	GO:0050804	GO:BP	modulation of chemical synaptic transmission	16175	13270		0.1111111111111111	0.13043478260869565	262	15913	10	18	252	15895	16175	0.11246957599896484
R1	cpdb	0	network_modules	153	TRUE	1.8504694536487972e-8	492	28	12	0.42857142857142855	0.024390243902439025	GO:0099537	GO:BP	trans-synaptic signaling	16175	19116		0.13333333333333333	0.15217391304347827	492	15683	12	16	480	15667	16175	0.09654537450453379
R1	cpdb	0	network_modules	153	TRUE	1.8691860996632238e-8	31	28	6	0.21428571428571427	0.1935483870967742	GO:0098815	GO:BP	modulation of excitatory postsynaptic potential	16175	18902		0.15555555555555556	0.17391304347826086	31	16144	6	22	25	16122	16175	0.20220060180622362
R1	cpdb	0	network_modules	153	TRUE	1.904358098302474e-8	263	28	10	0.35714285714285715	0.03802281368821293	GO:0099177	GO:BP	regulation of trans-synaptic signaling	16175	19085		0.17777777777777778	0.1956521739130435	263	15912	10	18	253	15894	16175	0.1122387231863838
R1	cpdb	0	network_modules	153	TRUE	2.5844056304528535e-8	259	18	9	0.5	0.03474903474903475	REAC:R-HSA-112315	REAC	Transmission across Chemical Synapses	10916	2580		0.5625	0.5882352941176471	259	10657	9	9	250	10648	10916	0.12717896996608977
R1	cpdb	0	network_modules	153	TRUE	2.993175464235761e-8	118	28	8	0.2857142857142857	0.06779661016949153	GO:0007611	GO:BP	learning or memory	16175	3068		0.2	0.21739130434782608	118	16057	8	20	110	16037	16175	0.1362395387173518
R1	cpdb	0	network_modules	153	TRUE	3.2245681929653365e-8	516	28	12	0.42857142857142855	0.023255813953488372	GO:0099536	GO:BP	synaptic signaling	16175	19115		0.2222222222222222	0.2391304347826087	516	15659	12	16	504	15643	16175	0.09399402671615306
R1	cpdb	0	network_modules	153	TRUE	3.568582171471526e-8	251	18	9	0.5	0.035856573705179286	KEGG:04020	KEGG	Calcium signaling pathway	8484	250		0.21428571428571427	0.26666666666666666	251	8233	9	9	242	8224	8484	0.12801560995064673
R1	cpdb	0	network_modules	153	TRUE	3.623550466098849e-8	97	18	7	0.3888888888888889	0.07216494845360824	KEGG:04713	KEGG	Circadian entrainment	8484	348		0.2857142857142857	0.3333333333333333	97	8387	7	11	90	8376	8484	0.1637097207963146
R1	cpdb	0	network_modules	153	TRUE	5.860684138210535e-8	37	28	6	0.21428571428571427	0.16216216216216217	GO:0048168	GO:BP	regulation of neuronal synaptic plasticity	16175	12562		0.24444444444444444	0.2608695652173913	37	16138	6	22	31	16116	16175	0.184792315412641
R1	cpdb	0	network_modules	153	TRUE	7.187728475750592e-8	76	28	7	0.25	0.09210526315789473	GO:0035249	GO:BP	synaptic transmission, glutamatergic	16175	8924		0.26666666666666666	0.2826086956521739	76	16099	7	21	69	16078	16175	0.1493726710477781
R1	cpdb	0	network_modules	153	TRUE	1.2106307244898128e-7	115	18	7	0.3888888888888889	0.06086956521739131	KEGG:04724	KEGG	Glutamatergic synapse	8484	354		0.35714285714285715	0.4	115	8369	7	11	108	8358	8484	0.14966833915902653
R1	cpdb	0	network_modules	153	TRUE	1.3201568312344578e-7	26	18	5	0.2777777777777778	0.19230769230769232	REAC:R-HSA-442742	REAC	CREB1 phosphorylation through NMDA receptor-mediated activation of RAS signaling	10916	283		0.625	0.6470588235294118	26	10890	5	13	21	10877	10916	0.2296060449289502
R1	cpdb	0	network_modules	153	TRUE	1.76506603398782e-7	44	28	6	0.21428571428571427	0.13636363636363635	GO:0060079	GO:BP	excitatory postsynaptic potential	16175	14338		0.28888888888888886	0.30434782608695654	44	16131	6	22	38	16109	16175	0.16914734272157383
R1	cpdb	0	network_modules	153	TRUE	3.3124736930063877e-7	159	28	8	0.2857142857142857	0.050314465408805034	GO:0050890	GO:BP	cognition	16175	13334		0.3111111111111111	0.32608695652173914	159	16016	8	20	151	15996	16175	0.11644712709378482
R1	cpdb	0	network_modules	153	TRUE	3.8396056292883635e-7	487	28	11	0.39285714285714285	0.022587268993839837	GO:0007268	GO:BP	chemical synaptic transmission	16175	2796		0.3333333333333333	0.3695652173913043	487	15688	11	17	476	15671	16175	0.08839654216150374
R1	cpdb	0	network_modules	153	TRUE	3.8396056292883635e-7	487	28	11	0.39285714285714285	0.022587268993839837	GO:0098916	GO:BP	anterograde trans-synaptic signaling	16175	18949		0.3333333333333333	0.3695652173913043	487	15688	11	17	476	15671	16175	0.08839654216150374
R1	cpdb	0	network_modules	153	TRUE	4.4664595207326006e-7	51	28	6	0.21428571428571427	0.11764705882352941	GO:0099565	GO:BP	chemical synaptic transmission, postsynaptic	16175	19143		0.37777777777777777	0.391304347826087	51	16124	6	22	45	16102	16175	0.15682359376874883
R1	cpdb	0	network_modules	153	TRUE	5.06805695816671e-7	141	18	7	0.3888888888888889	0.04964539007092199	KEGG:05017	KEGG	Spinocerebellar ataxia	8484	415		0.42857142857142855	0.4666666666666667	141	8343	7	11	134	8332	8484	0.13427167488738567
R1	cpdb	0	network_modules	153	TRUE	6.052915598847443e-7	23	28	5	0.17857142857142858	0.21739130434782608	GO:0051968	GO:BP	positive regulation of synaptic transmission, glutamatergic	16175	14037		0.4	0.41304347826086957	23	16152	5	23	18	16129	16175	0.19576732022850926
R1	cpdb	0	network_modules	153	TRUE	1.0643060257116661e-6	86	18	6	0.3333333333333333	0.06976744186046512	REAC:R-HSA-6794362	REAC	Protein-protein interactions at synapses	10916	1819		0.6875	0.7058823529411765	86	10830	6	12	80	10818	10916	0.14960766957263893
R1	cpdb	0	network_modules	153	TRUE	1.219697766694782e-6	400	18	9	0.5	0.0225	REAC:R-HSA-112316	REAC	Neuronal System	10916	1590		0.75	0.7647058823529411	400	10516	9	9	391	10507	10916	0.1002273831364043
R1	cpdb	0	network_modules	153	TRUE	1.3610648669457282e-6	61	28	6	0.21428571428571427	0.09836065573770492	GO:0060078	GO:BP	regulation of postsynaptic membrane potential	16175	14337		0.4222222222222222	0.43478260869565216	61	16114	6	22	55	16092	16175	0.14301866586861708
R1	cpdb	0	network_modules	153	TRUE	2.771760701367929e-6	127	28	7	0.25	0.05511811023622047	GO:0048167	GO:BP	regulation of synaptic plasticity	16175	12561		0.4444444444444444	0.45652173913043476	127	16048	7	21	120	16027	16175	0.11424747930698538
R1	cpdb	0	network_modules	153	TRUE	3.602015830434744e-6	187	18	7	0.3888888888888889	0.0374331550802139	KEGG:05034	KEGG	Alcoholism	8484	422		0.5	0.5333333333333333	187	8297	7	11	180	8286	8484	0.11521310372964268
R1	cpdb	0	network_modules	153	TRUE	4.1146432990125e-6	73	28	6	0.21428571428571427	0.0821917808219178	GO:0031644	GO:BP	regulation of nervous system process	16175	7254		0.4666666666666667	0.4782608695652174	73	16102	6	22	67	16080	16175	0.13032410587952922
R1	cpdb	0	network_modules	153	TRUE	5.997520355037831e-6	229	28	8	0.2857142857142857	0.034934497816593885	GO:1904062	GO:BP	regulation of monoatomic cation transmembrane transport	16175	23501		0.4888888888888889	0.5	229	15946	8	20	221	15926	16175	0.09571812435863238
R1	cpdb	0	network_modules	153	TRUE	6.194790539077629e-6	341	28	9	0.32142857142857145	0.026392961876832845	GO:0043269	GO:BP	regulation of monoatomic ion transport	16175	10593		0.5111111111111111	0.5217391304347826	341	15834	9	19	332	15815	16175	0.08706180601293889
R1	cpdb	0	network_modules	153	TRUE	7.440610468426546e-6	56	18	5	0.2777777777777778	0.08928571428571429	REAC:R-HSA-6794361	REAC	Neurexins and neuroligins	10916	1587		0.8125	0.8235294117647058	56	10860	5	13	51	10847	10916	0.15510267203548872
R1	cpdb	0	network_modules	153	TRUE	1.2071576962820675e-5	223	18	7	0.3888888888888889	0.03139013452914798	KEGG:04024	KEGG	cAMP signaling pathway	8484	252		0.5714285714285714	0.6	223	8261	7	11	216	8250	8484	0.10451094366366967
R1	cpdb	0	network_modules	153	TRUE	1.2847772346329984e-5	67	18	5	0.2777777777777778	0.07462686567164178	KEGG:04720	KEGG	Long-term potentiation	8484	350		0.6428571428571429	0.6666666666666666	67	8417	5	13	62	8404	8484	0.14058963946337813
R1	cpdb	0	network_modules	153	TRUE	1.3950618746446798e-5	255	28	8	0.2857142857142857	0.03137254901960784	GO:0007610	GO:BP	behavior	16175	3067		0.5333333333333333	0.5434782608695652	255	15920	8	20	247	15900	16175	0.0902438949334423
R1	cpdb	0	network_modules	153	TRUE	1.724256367799213e-5	262	28	8	0.2857142857142857	0.030534351145038167	GO:0034765	GO:BP	regulation of monoatomic ion transmembrane transport	16175	8734		0.5555555555555556	0.5652173913043478	262	15913	8	20	254	15893	16175	0.08890700535403295
R1	cpdb	0	network_modules	153	TRUE	2.0041966590808417e-5	365	18	8	0.4444444444444444	0.021917808219178082	KEGG:04080	KEGG	Neuroactive ligand-receptor interaction	8484	263		0.7142857142857143	0.7333333333333333	365	8119	8	10	357	8109	8484	0.09122241305697736
R1	cpdb	0	network_modules	153	TRUE	2.3223967023294615e-5	97	28	6	0.21428571428571427	0.061855670103092786	GO:0050806	GO:BP	positive regulation of synaptic transmission	16175	13272		0.5777777777777777	0.5869565217391305	97	16078	6	22	91	16056	16175	0.11234181404994877
R1	cpdb	0	network_modules	153	TRUE	2.9017544336820336e-5	17	28	4	0.14285714285714285	0.23529411764705882	GO:0045471	GO:BP	response to ethanol	16175	11399		0.6	0.6086956521739131	17	16158	4	24	13	16134	16175	0.18224438225094372
R1	cpdb	0	network_modules	153	TRUE	3.4963778824258365e-5	264	18	7	0.3888888888888889	0.026515151515151516	REAC:R-HSA-5673001	REAC	RAF/MAP kinase cascade	10916	1841		0.875	0.8823529411764706	264	10652	7	11	257	10641	10916	0.09648273527596112
R1	cpdb	0	network_modules	153	TRUE	3.975200448913165e-5	269	18	7	0.3888888888888889	0.026022304832713755	REAC:R-HSA-5684996	REAC	MAPK1/MAPK3 signaling	10916	1351		0.9375	0.9411764705882353	269	10647	7	11	262	10636	10916	0.09548421804307664
R1	cpdb	0	network_modules	153	TRUE	4.54578418258653e-5	271	18	7	0.3888888888888889	0.025830258302583026	KEGG:05020	KEGG	Prion disease	8484	416		0.7857142857142857	0.8	271	8213	7	11	264	8202	8484	0.09359771373171387
R1	cpdb	0	network_modules	153	TRUE	6.024540301508391e-5	55	28	5	0.17857142857142858	0.09090909090909091	GO:0051966	GO:BP	regulation of synaptic transmission, glutamatergic	16175	14035		0.6222222222222222	0.6304347826086957	55	16120	5	23	50	16097	16175	0.1253071995781217
R1	cpdb	0	network_modules	153	TRUE	8.986930410725475e-5	324	28	8	0.2857142857142857	0.024691358024691357	GO:0006816	GO:BP	calcium ion transport	16175	2495		0.6444444444444445	0.6521739130434783	324	15851	8	20	316	15831	16175	0.07896614225054034
R1	cpdb	0	network_modules	153	TRUE	1.0001612138686805e-4	308	18	7	0.3888888888888889	0.022727272727272728	REAC:R-HSA-5683057	REAC	MAPK family signaling cascades	10916	1348		1	1	308	10608	7	11	301	10597	10916	0.08852142742310043
R1	cpdb	0	network_modules	153	TRUE	1.762394883834012e-4	677	28	10	0.35714285714285715	0.014771048744460856	GO:0030001	GO:BP	metal ion transport	16175	6646		0.6666666666666666	0.6739130434782609	677	15498	10	18	667	15480	16175	0.06556210038973523
R1	cpdb	0	network_modules	153	TRUE	1.778168085150503e-4	354	28	8	0.2857142857142857	0.022598870056497175	GO:0034762	GO:BP	regulation of transmembrane transport	16175	8731		0.6888888888888889	0.6956521739130435	354	15821	8	20	346	15801	16175	0.07508976710511489
R1	cpdb	0	network_modules	153	TRUE	3.1240607571798184e-4	381	28	8	0.2857142857142857	0.02099737532808399	GO:0044057	GO:BP	regulation of system process	16175	10893		0.7111111111111111	0.717391304347826	381	15794	8	20	373	15774	16175	0.07198372064669509
R1	cpdb	0	network_modules	153	TRUE	3.65911109894967e-4	235	18	6	0.3333333333333333	0.02553191489361702	KEGG:04014	KEGG	Ras signaling pathway	8484	247		0.8571428571428571	0.8666666666666667	235	8249	6	12	229	8237	8484	0.08587466469171189
R1	cpdb	0	network_modules	153	TRUE	4.463649527503888e-4	748	28	10	0.35714285714285715	0.013368983957219251	GO:0006812	GO:BP	monoatomic cation transport	16175	2492		0.7333333333333333	0.7391304347826086	748	15427	10	18	738	15409	16175	0.061645969102432925
R1	cpdb	0	network_modules	153	TRUE	4.626567461150718e-4	160	28	6	0.21428571428571427	0.0375	GO:0097553	GO:BP	calcium ion transmembrane import into cytosol	16175	18700		0.7555555555555555	0.7608695652173914	160	16015	6	22	154	15993	16175	0.08600463609452906
R1	cpdb	0	network_modules	153	TRUE	6.780324215808667e-4	282	28	7	0.25	0.024822695035460994	GO:0042391	GO:BP	regulation of membrane potential	16175	10141		0.7777777777777778	0.782608695652174	282	15893	7	21	275	15872	16175	0.07399383330018616
R1	cpdb	0	network_modules	153	TRUE	8.901148976152044e-4	806	28	10	0.35714285714285715	0.01240694789081886	GO:0050877	GO:BP	nervous system process	16175	13322		0.8	0.8043478260869565	806	15369	10	18	796	15351	16175	0.05881225185455848
R1	cpdb	0	network_modules	153	TRUE	0.001743828060791088	12	28	3	0.10714285714285714	0.25	GO:0008542	GO:BP	visual learning	16175	3190		0.8222222222222222	0.8260869565217391	12	16163	3	25	9	16138	16175	0.16273140207277706
R1	cpdb	0	network_modules	153	TRUE	0.00316630651166928	52	28	4	0.14285714285714285	0.07692307692307693	GO:0060291	GO:BP	long-term synaptic potentiation	16175	14506		0.8444444444444444	0.8478260869565217	52	16123	4	24	48	16099	16175	0.1027234963575564
R1	cpdb	0	network_modules	153	TRUE	0.004337953815809478	363	18	6	0.3333333333333333	0.01652892561983471	KEGG:05014	KEGG	Amyotrophic lateral sclerosis	8484	413		0.9285714285714286	0.9333333333333333	363	8121	6	12	357	8109	8484	0.06619969314054001
R1	cpdb	0	network_modules	153	TRUE	0.004418291146288086	16	28	3	0.10714285714285714	0.1875	GO:0007632	GO:BP	visual behavior	16175	3088		0.8666666666666667	0.8695652173913043	16	16159	3	25	13	16134	16175	0.14061938357001555
R1	cpdb	0	network_modules	153	TRUE	0.005278910802311564	59	28	4	0.14285714285714285	0.06779661016949153	GO:0007613	GO:BP	memory	16175	3070		0.8888888888888888	0.8913043478260869	59	16116	4	24	55	16092	16175	0.09615939915494791
R1	cpdb	0	network_modules	153	TRUE	0.0057653188251894924	382	18	6	0.3333333333333333	0.015706806282722512	KEGG:05010	KEGG	Alzheimer disease	8484	411		1	1	382	8102	6	12	376	8090	8484	0.06410999932384025
R1	cpdb	0	network_modules	153	TRUE	0.006126367276762297	249	28	6	0.21428571428571427	0.024096385542168676	GO:0070588	GO:BP	calcium ion transmembrane transport	16175	16193		0.9111111111111111	0.9130434782608695	249	15926	6	22	243	15904	16175	0.06727299569502287
R1	cpdb	0	network_modules	153	TRUE	0.006934793030074254	575	28	8	0.2857142857142857	0.01391304347826087	GO:0098662	GO:BP	inorganic cation transmembrane transport	16175	18818		0.9333333333333333	0.9347826086956522	575	15600	8	20	567	15580	16175	0.056261168779356684
R1	cpdb	0	network_modules	153	TRUE	0.007115295146171602	577	28	8	0.2857142857142857	0.01386481802426343	GO:0098655	GO:BP	monoatomic cation transmembrane transport	16175	18811		0.9555555555555556	0.9565217391304348	577	15598	8	20	569	15578	16175	0.05613941699642821
R1	cpdb	0	network_modules	153	TRUE	0.00761867105046191	19	28	3	0.10714285714285714	0.15789473684210525	GO:0008306	GO:BP	associative learning	16175	3162		0.9777777777777777	0.9782608695652174	19	16156	3	25	16	16131	16175	0.1288276952064913
R1	cpdb	0	network_modules	153	TRUE	0.008709002682593172	593	28	8	0.2857142857142857	0.013490725126475547	GO:0007417	GO:BP	central nervous system development	16175	2912		1	1	593	15582	8	20	585	15562	16175	0.05518611401478274
R1	cpdb	0	network_modules	154	TRUE	1.2596605058129088e-20	196	24	16	0.6666666666666666	0.08163265306122448	REAC:R-HSA-112314	REAC	Neurotransmitter receptors and postsynaptic signal transmission	10916	1594		0	0.045454545454545456	196	10720	16	8	180	10712	10916	0.22931972600074546
R1	cpdb	0	network_modules	154	TRUE	3.310709493885621e-19	400	24	18	0.75	0.045	REAC:R-HSA-112316	REAC	Neuronal System	10916	1590		0.047619047619047616	0.09090909090909091	400	10516	18	6	382	10510	10916	0.17822420856757074
R1	cpdb	0	network_modules	154	TRUE	1.2177061654950637e-18	259	24	16	0.6666666666666666	0.06177606177606178	REAC:R-HSA-112315	REAC	Transmission across Chemical Synapses	10916	2580		0.09523809523809523	0.13636363636363635	259	10657	16	8	243	10649	10916	0.19829804411749488
R1	cpdb	0	network_modules	154	TRUE	5.37253595407886e-15	487	27	16	0.5925925925925926	0.03285420944558522	GO:0007268	GO:BP	chemical synaptic transmission	16175	2796		0	0.125	487	15688	16	11	471	15677	16175	0.13459502671940282
R1	cpdb	0	network_modules	154	TRUE	5.37253595407886e-15	487	27	16	0.5925925925925926	0.03285420944558522	GO:0098916	GO:BP	anterograde trans-synaptic signaling	16175	18949		0	0.125	487	15688	16	11	471	15677	16175	0.13459502671940282
R1	cpdb	0	network_modules	154	TRUE	6.321774222633312e-15	492	27	16	0.5925925925925926	0.032520325203252036	GO:0099537	GO:BP	trans-synaptic signaling	16175	19116		0.13333333333333333	0.1875	492	15683	16	11	476	15672	16175	0.13385710399925094
R1	cpdb	0	network_modules	154	TRUE	1.3488221051857855e-14	516	27	16	0.5925925925925926	0.031007751937984496	GO:0099536	GO:BP	synaptic signaling	16175	19115		0.2	0.25	516	15659	16	11	500	15648	16175	0.13046196597357526
R1	cpdb	0	network_modules	154	TRUE	3.5061274532486345e-14	76	27	10	0.37037037037037035	0.13157894736842105	GO:0035249	GO:BP	synaptic transmission, glutamatergic	16175	8924		0.26666666666666666	0.3125	76	16099	10	17	66	16082	16175	0.21865125702540875
R1	cpdb	0	network_modules	154	TRUE	9.856950736354706e-14	27	24	8	0.3333333333333333	0.2962962962962963	REAC:R-HSA-399719	REAC	Trafficking of AMPA receptors	10916	2532		0.14285714285714285	0.22727272727272727	27	10889	8	16	19	10873	10916	0.3126681071404276
R1	cpdb	0	network_modules	154	TRUE	9.856950736354706e-14	27	24	8	0.3333333333333333	0.2962962962962963	REAC:R-HSA-399721	REAC	Glutamate binding, activation of AMPA receptors and synaptic plasticity	10916	1057		0.14285714285714285	0.22727272727272727	27	10889	8	16	19	10873	10916	0.3126681071404276
R1	cpdb	0	network_modules	154	TRUE	7.248119347409901e-13	115	19	10	0.5263157894736842	0.08695652173913043	KEGG:04724	KEGG	Glutamatergic synapse	8484	354		0	0.125	115	8369	10	9	105	8360	8484	0.21008408060200967
R1	cpdb	0	network_modules	154	TRUE	2.22428517936282e-12	20	24	7	0.2916666666666667	0.35	REAC:R-HSA-438066	REAC	Unblocking of NMDA receptors, glutamate binding and activation	10916	2621		0.23809523809523808	0.2727272727272727	20	10896	7	17	13	10879	10916	0.31813895980476664
R1	cpdb	0	network_modules	154	TRUE	3.696545555395449e-12	10	24	6	0.25	0.6	REAC:R-HSA-451308	REAC	Activation of Ca-permeable Kainate Receptor	10916	81		0.2857142857142857	0.36363636363636365	10	10906	6	18	4	10888	10916	0.38648110433168553
R1	cpdb	0	network_modules	154	TRUE	3.696545555395449e-12	10	24	6	0.25	0.6	REAC:R-HSA-451306	REAC	Ionotropic activity of kainate receptors	10916	1276		0.2857142857142857	0.36363636363636365	10	10906	6	18	4	10888	10916	0.38648110433168553
R1	cpdb	0	network_modules	154	TRUE	5.552933000747933e-12	262	27	12	0.4444444444444444	0.04580152671755725	GO:0050804	GO:BP	modulation of chemical synaptic transmission	16175	13270		0.3333333333333333	0.375	262	15913	12	15	250	15898	16175	0.13871839523816468
R1	cpdb	0	network_modules	154	TRUE	5.813361560719266e-12	263	27	12	0.4444444444444444	0.045627376425855515	GO:0099177	GO:BP	regulation of trans-synaptic signaling	16175	19085		0.4	0.4375	263	15912	12	15	251	15897	16175	0.13843878285464106
R1	cpdb	0	network_modules	154	TRUE	2.790076034534934e-11	86	24	9	0.375	0.10465116279069768	REAC:R-HSA-6794362	REAC	Protein-protein interactions at synapses	10916	1819		0.38095238095238093	0.4090909090909091	86	10830	9	15	77	10815	10916	0.19492245905672578
R1	cpdb	0	network_modules	154	TRUE	3.007805742071198e-11	13	24	6	0.25	0.46153846153846156	REAC:R-HSA-416993	REAC	Trafficking of GluR2-containing AMPA receptors	10916	2533		0.42857142857142855	0.45454545454545453	13	10903	6	18	7	10885	10916	0.3386389336721497
R1	cpdb	0	network_modules	154	TRUE	5.237990996868975e-10	41	27	7	0.25925925925925924	0.17073170731707318	GO:0007215	GO:BP	glutamate receptor signaling pathway	16175	2769		0.4666666666666667	0.5	41	16134	7	20	34	16114	16175	0.20877146316069897
R1	cpdb	0	network_modules	154	TRUE	2.758439343790419e-9	365	19	11	0.5789473684210527	0.030136986301369864	KEGG:04080	KEGG	Neuroactive ligand-receptor interaction	8484	263		0.14285714285714285	0.25	365	8119	11	8	354	8111	8484	0.1251325982122773
R1	cpdb	0	network_modules	154	TRUE	2.891274796474594e-9	89	24	8	0.3333333333333333	0.0898876404494382	REAC:R-HSA-442755	REAC	Activation of NMDA receptors and postsynaptic events	10916	89		0.47619047619047616	0.5	89	10827	8	16	81	10811	10916	0.16974238699291877
R1	cpdb	0	network_modules	154	TRUE	5.54652112452347e-9	4	24	4	0.16666666666666666	1	REAC:R-HSA-399710	REAC	Activation of AMPA receptors	10916	72		0.5238095238095238	0.5454545454545454	4	10912	4	20	0	10892	10916	0.40787399104486916
R1	cpdb	0	network_modules	154	TRUE	1.0160106701223609e-8	30	24	6	0.25	0.2	REAC:R-HSA-451326	REAC	Activation of kainate receptors upon glutamate binding	10916	102		0.5714285714285714	0.5909090909090909	30	10886	6	18	24	10868	10916	0.22169704106231383
R1	cpdb	0	network_modules	154	TRUE	2.0211369502593248e-7	21	24	5	0.20833333333333334	0.23809523809523808	REAC:R-HSA-9620244	REAC	Long-term potentiation	10916	1321		0.6190476190476191	0.6818181818181818	21	10895	5	19	16	10876	10916	0.22111685951359575
R1	cpdb	0	network_modules	154	TRUE	2.0211369502593248e-7	21	24	5	0.20833333333333334	0.23809523809523808	REAC:R-HSA-8849932	REAC	Synaptic adhesion-like molecules	10916	2366		0.6190476190476191	0.6818181818181818	21	10895	5	19	16	10876	10916	0.22111685951359575
R1	cpdb	0	network_modules	154	TRUE	5.354619639836535e-7	56	24	6	0.25	0.10714285714285714	REAC:R-HSA-6794361	REAC	Neurexins and neuroligins	10916	1587		0.7142857142857143	0.7272727272727273	56	10860	6	18	50	10842	10916	0.16089473661078235
R1	cpdb	0	network_modules	154	TRUE	4.978949999516762e-6	36	27	5	0.18518518518518517	0.1388888888888889	GO:0097120	GO:BP	receptor localization to synapse	16175	18510		0.5333333333333333	0.625	36	16139	5	22	31	16117	16175	0.15875677638169897
R1	cpdb	0	network_modules	154	TRUE	4.978949999516762e-6	36	27	5	0.18518518518518517	0.1388888888888889	GO:0043113	GO:BP	receptor clustering	16175	10537		0.5333333333333333	0.625	36	16139	5	22	31	16117	16175	0.15875677638169897
R1	cpdb	0	network_modules	154	TRUE	9.117185119073524e-6	59	19	5	0.2631578947368421	0.0847457627118644	KEGG:04730	KEGG	Long-term depression	8484	359		0.2857142857142857	0.375	59	8425	5	14	54	8411	8484	0.1460623533290778
R1	cpdb	0	network_modules	154	TRUE	9.632256395768027e-5	40	19	4	0.21052631578947367	0.1	KEGG:05033	KEGG	Nicotine addiction	8484	421		0.42857142857142855	0.5	40	8444	4	15	36	8429	8484	0.14234087548326943
R1	cpdb	0	network_modules	154	TRUE	1.693914290999026e-4	76	24	5	0.20833333333333334	0.06578947368421052	REAC:R-HSA-438064	REAC	Post NMDA receptor activation events	10916	1772		0.7619047619047619	0.7727272727272727	76	10840	5	19	71	10821	10916	0.11368181144023956
R1	cpdb	0	network_modules	154	TRUE	4.6293491950489467e-4	594	27	9	0.3333333333333333	0.015151515151515152	GO:0051668	GO:BP	localization within membrane	16175	13880		0.6666666666666666	0.6875	594	15581	9	18	585	15563	16175	0.06448544425069544
R1	cpdb	0	network_modules	154	TRUE	4.905496000721881e-4	131	19	5	0.2631578947368421	0.03816793893129771	KEGG:04728	KEGG	Dopaminergic synapse	8484	358		0.5714285714285714	0.625	131	8353	5	14	126	8339	8484	0.0951837949987842
R1	cpdb	0	network_modules	154	TRUE	6.464140613200237e-4	43	24	4	0.16666666666666666	0.09302325581395349	REAC:R-HSA-9609736	REAC	Assembly and cell surface presentation of NMDA receptors	10916	173		0.8095238095238095	0.8181818181818182	43	10873	4	20	39	10853	10916	0.12194594070332289
R1	cpdb	0	network_modules	154	TRUE	7.601985557147086e-4	39	27	4	0.14814814814814814	0.10256410256410256	GO:0045197	GO:BP	establishment or maintenance of epithelial cell apical/basal polarity	16175	11321		0.7333333333333333	0.75	39	16136	4	23	35	16113	16175	0.12150843840102382
R1	cpdb	0	network_modules	154	TRUE	8.744307645737755e-4	69	19	4	0.21052631578947367	0.057971014492753624	KEGG:05031	KEGG	Amphetamine addiction	8484	419		0.7142857142857143	0.75	69	8415	4	15	65	8400	8484	0.10676001671785794
R1	cpdb	0	network_modules	154	TRUE	8.897717064986633e-4	148	19	5	0.2631578947368421	0.033783783783783786	KEGG:04723	KEGG	Retrograde endocannabinoid signaling	8484	353		0.8571428571428571	0.875	148	8336	5	14	143	8322	8484	0.08891661498512943
R1	cpdb	0	network_modules	154	TRUE	0.001135424293212712	43	27	4	0.14814814814814814	0.09302325581395349	GO:0061245	GO:BP	establishment or maintenance of bipolar cell polarity	16175	15338		0.8	0.875	43	16132	4	23	39	16109	16175	0.11553692071274008
R1	cpdb	0	network_modules	154	TRUE	0.001135424293212712	43	27	4	0.14814814814814814	0.09302325581395349	GO:0035088	GO:BP	establishment or maintenance of apical/basal cell polarity	16175	8802		0.8	0.875	43	16132	4	23	39	16109	16175	0.11553692071274008
R1	cpdb	0	network_modules	154	TRUE	0.0017292656408199392	504	27	8	0.2962962962962963	0.015873015873015872	GO:0072657	GO:BP	protein localization to membrane	16175	17478		0.9333333333333333	0.9375	504	15671	8	19	496	15652	16175	0.062398432402322526
R1	cpdb	0	network_modules	154	TRUE	0.0023015934626519157	18	24	3	0.125	0.16666666666666666	REAC:R-HSA-442982	REAC	Ras activation upon Ca2+ influx through NMDA receptor	10916	1941		0.8571428571428571	0.8636363636363636	18	10898	3	21	15	10877	10916	0.14270806185138812
R1	cpdb	0	network_modules	154	TRUE	0.003206190206104885	20	24	3	0.125	0.15	REAC:R-HSA-9617324	REAC	Negative regulation of NMDA receptor-mediated neuronal transmission	10916	1575		0.9047619047619048	0.9090909090909091	20	10896	3	21	17	10875	10916	0.13519606957514896
R1	cpdb	0	network_modules	154	TRUE	0.0033679956489575838	97	19	4	0.21052631578947367	0.041237113402061855	KEGG:04713	KEGG	Circadian entrainment	8484	348		1	1	97	8387	4	15	93	8372	8484	0.08872190245499476
R1	cpdb	0	network_modules	154	TRUE	0.004283946519856877	3	24	2	0.08333333333333333	0.6666666666666666	REAC:R-HSA-392023	REAC	Adrenaline signalling through Alpha-2 adrenergic receptor	10916	123		0.9523809523809523	0.9545454545454546	3	10913	2	22	1	10891	10916	0.23521593968333548
R1	cpdb	0	network_modules	154	TRUE	0.004398785169219106	137	27	5	0.18518518518518517	0.0364963503649635	GO:0031503	GO:BP	protein-containing complex localization	16175	7188		1	1	137	16038	5	22	132	16016	16175	0.07885071303094891
R1	cpdb	0	network_modules	154	TRUE	0.007249299914918944	26	24	3	0.125	0.11538461538461539	REAC:R-HSA-442742	REAC	CREB1 phosphorylation through NMDA receptor-mediated activation of RAS signaling	10916	283		1	1	26	10890	3	21	23	10869	10916	0.11807815706818106
R1	cpdb	0	network_modules	155	TRUE	1.3979064038635326e-23	20	17	10	0.5882352941176471	0.5	GO:0033141	GO:BP	positive regulation of peptidyl-serine phosphorylation of STAT protein	16175	8056		0	0.017543859649122806	20	16155	10	7	10	16148	16175	0.5418058575096112
R1	cpdb	0	network_modules	155	TRUE	2.6676792532039605e-23	21	17	10	0.5882352941176471	0.47619047619047616	GO:0033139	GO:BP	regulation of peptidyl-serine phosphorylation of STAT protein	16175	8054		0.017857142857142856	0.03508771929824561	21	16154	10	7	11	16147	16175	0.5287090509981788
R1	cpdb	0	network_modules	155	TRUE	4.888818837642831e-23	22	17	10	0.5882352941176471	0.45454545454545453	GO:0042501	GO:BP	serine phosphorylation of STAT protein	16175	10225		0.03571428571428571	0.05263157894736842	22	16153	10	7	12	16146	16175	0.5165147724288572
R1	cpdb	0	network_modules	155	TRUE	7.581918374841747e-22	24	16	10	0.625	0.4166666666666667	REAC:R-HSA-912694	REAC	Regulation of IFNA/IFNB signaling	10916	1979		0	0.1	24	10892	10	6	14	10886	10916	0.5094486398202718
R1	cpdb	0	network_modules	155	TRUE	1.510151594103833e-21	29	17	10	0.5882352941176471	0.3448275862068966	GO:0002323	GO:BP	natural killer cell activation involved in immune response	16175	855		0.05357142857142857	0.07017543859649122	29	16146	10	7	19	16139	16175	0.4496440391065621
R1	cpdb	0	network_modules	155	TRUE	1.1580090277490225e-20	30	16	10	0.625	0.3333333333333333	REAC:R-HSA-933541	REAC	TRAF6 mediated IRF7 activation	10916	2465		0.1111111111111111	0.2	30	10886	10	6	20	10880	10916	0.45538801554896663
R1	cpdb	0	network_modules	155	TRUE	2.4021752670857566e-20	64	17	11	0.6470588235294118	0.171875	GO:0098586	GO:BP	cellular response to virus	16175	18801		0.07142857142857142	0.08771929824561403	64	16111	11	6	53	16105	16175	0.33227957031126953
R1	cpdb	0	network_modules	155	TRUE	2.6179465267179e-20	37	17	10	0.5882352941176471	0.2702702702702703	GO:0043330	GO:BP	response to exogenous dsRNA	16175	10636		0.08928571428571429	0.10526315789473684	37	16138	10	7	27	16131	16175	0.3978397455768781
R1	cpdb	0	network_modules	155	TRUE	8.412572055247443e-20	41	17	10	0.5882352941176471	0.24390243902439024	GO:0043331	GO:BP	response to dsRNA	16175	10637		0.10714285714285714	0.12280701754385964	41	16134	10	7	31	16127	16175	0.3778223124340175
R1	cpdb	0	network_modules	155	TRUE	1.3456835248928753e-19	74	17	11	0.6470588235294118	0.14864864864864866	GO:0060337	GO:BP	type I interferon-mediated signaling pathway	16175	14549		0.125	0.14035087719298245	74	16101	11	6	63	16095	16175	0.3088125111032136
R1	cpdb	0	network_modules	155	TRUE	1.5764344402208406e-19	75	17	11	0.6470588235294118	0.14666666666666667	GO:0071357	GO:BP	cellular response to type I interferon	16175	16609		0.14285714285714285	0.15789473684210525	75	16100	11	6	64	16094	16175	0.3067268605350236
R1	cpdb	0	network_modules	155	TRUE	3.894025212146083e-19	81	17	11	0.6470588235294118	0.13580246913580246	GO:0034340	GO:BP	response to type I interferon	16175	8578		0.16071428571428573	0.17543859649122806	81	16094	11	6	70	16088	16175	0.29503261699178335
R1	cpdb	0	network_modules	155	TRUE	4.760433650283923e-19	106	12	11	0.9166666666666666	0.10377358490566038	KEGG:04620	KEGG	Toll-like receptor signaling pathway	8484	325		0	0.043478260869565216	106	8378	11	1	95	8377	8484	0.30635609250847534
R1	cpdb	0	network_modules	155	TRUE	2.8179445064517683e-18	96	17	11	0.6470588235294118	0.11458333333333333	GO:0140888	GO:BP	interferon-mediated signaling pathway	16175	19923		0.17857142857142858	0.19298245614035087	96	16079	11	6	85	16073	16175	0.2707395305697141
R1	cpdb	0	network_modules	155	TRUE	2.8902033966733428e-18	124	12	11	0.9166666666666666	0.08870967741935484	KEGG:04650	KEGG	Natural killer cell mediated cytotoxicity	8484	334		0.045454545454545456	0.08695652173913043	124	8360	11	1	113	8359	8484	0.2828885577456896
R1	cpdb	0	network_modules	155	TRUE	3.3407853217338314e-18	71	12	10	0.8333333333333334	0.14084507042253522	KEGG:04622	KEGG	RIG-I-like receptor signaling pathway	8484	327		0.09090909090909091	0.13043478260869565	71	8413	10	2	61	8411	8484	0.3408231014589835
R1	cpdb	0	network_modules	155	TRUE	9.816354637774598e-18	138	12	11	0.9166666666666666	0.07971014492753623	KEGG:05162	KEGG	Measles	8484	443		0.13636363636363635	0.17391304347826086	138	8346	11	1	127	8345	8484	0.26788933620412103
R1	cpdb	0	network_modules	155	TRUE	1.544145492508896e-17	82	12	10	0.8333333333333334	0.12195121951219512	KEGG:04623	KEGG	Cytosolic DNA-sensing pathway	8484	328		0.18181818181818182	0.21739130434782608	82	8402	10	2	72	8400	8484	0.31684895636852284
R1	cpdb	0	network_modules	155	TRUE	4.200727925616579e-17	49	12	9	0.75	0.1836734693877551	KEGG:05320	KEGG	Autoimmune thyroid disease	8484	482		0.22727272727272727	0.2608695652173913	49	8435	9	3	40	8432	8484	0.36962526045097516
R1	cpdb	0	network_modules	155	TRUE	4.576825351592565e-17	158	12	11	0.9166666666666666	0.06962025316455696	KEGG:04217	KEGG	Necroptosis	8484	294		0.2727272727272727	0.34782608695652173	158	8326	11	1	147	8325	8484	0.2500051046659484
R1	cpdb	0	network_modules	155	TRUE	4.576825351592565e-17	158	12	11	0.9166666666666666	0.06962025316455696	KEGG:05160	KEGG	Hepatitis C	8484	441		0.2727272727272727	0.34782608695652173	158	8326	11	1	147	8325	8484	0.2500051046659484
R1	cpdb	0	network_modules	155	TRUE	6.077362319953566e-17	162	12	11	0.9166666666666666	0.06790123456790123	KEGG:04630	KEGG	JAK-STAT signaling pathway	8484	332		0.36363636363636365	0.391304347826087	162	8322	11	1	151	8321	8484	0.2468290059231819
R1	cpdb	0	network_modules	155	TRUE	6.137256483888421e-17	75	17	10	0.5882352941176471	0.13333333333333333	GO:0030101	GO:BP	natural killer cell activation	16175	6679		0.19642857142857142	0.21052631578947367	75	16100	10	7	65	16093	16175	0.2786413413210185
R1	cpdb	0	network_modules	155	TRUE	7.06435203254971e-17	76	17	10	0.5882352941176471	0.13157894736842105	GO:0042100	GO:BP	B cell proliferation	16175	9966		0.21428571428571427	0.22807017543859648	76	16099	10	7	66	16092	16175	0.27678137710475403
R1	cpdb	0	network_modules	155	TRUE	8.576382792084019e-17	167	12	11	0.9166666666666666	0.0658682634730539	KEGG:05164	KEGG	Influenza A	8484	445		0.4090909090909091	0.43478260869565216	167	8317	11	1	156	8316	8484	0.24301927445711113
R1	cpdb	0	network_modules	155	TRUE	1.3874343400222073e-16	81	17	10	0.5882352941176471	0.12345679012345678	GO:0033138	GO:BP	positive regulation of peptidyl-serine phosphorylation	16175	8053		0.23214285714285715	0.24561403508771928	81	16094	10	7	71	16087	16175	0.26800227634877355
R1	cpdb	0	network_modules	155	TRUE	1.795170544810913e-16	83	17	10	0.5882352941176471	0.12048192771084337	GO:0046425	GO:BP	regulation of receptor signaling pathway via JAK-STAT	16175	12135		0.25	0.2631578947368421	83	16092	10	7	73	16085	16175	0.2647139630546626
R1	cpdb	0	network_modules	155	TRUE	2.268690651522636e-16	182	12	11	0.9166666666666666	0.06043956043956044	KEGG:04621	KEGG	NOD-like receptor signaling pathway	8484	326		0.45454545454545453	0.4782608695652174	182	8302	11	1	171	8301	8484	0.23254037536172883
R1	cpdb	0	network_modules	155	TRUE	2.50714055914737e-16	142	17	11	0.6470588235294118	0.07746478873239436	GO:0007259	GO:BP	cell surface receptor signaling pathway via JAK-STAT	16175	2789		0.26785714285714285	0.2807017543859649	142	16033	11	6	131	16027	16175	0.22193945213141789
R1	cpdb	0	network_modules	155	TRUE	2.835919672884188e-16	224	17	12	0.7058823529411765	0.05357142857142857	GO:0006959	GO:BP	humoral immune response	16175	2590		0.2857142857142857	0.2982456140350877	224	15951	12	5	212	15946	16175	0.19208095281944298
R1	cpdb	0	network_modules	155	TRUE	3.5950046296782517e-16	76	16	10	0.625	0.13157894736842105	REAC:R-HSA-909733	REAC	Interferon alpha/beta signaling	10916	1228		0.2222222222222222	0.3	76	10840	10	6	66	10834	10916	0.28477629129759235
R1	cpdb	0	network_modules	155	TRUE	4.2104251143054583e-16	90	17	10	0.5882352941176471	0.1111111111111111	GO:1904892	GO:BP	regulation of receptor signaling pathway via STAT	16175	24199		0.30357142857142855	0.3157894736842105	90	16085	10	7	80	16078	16175	0.2540777749404364
R1	cpdb	0	network_modules	155	TRUE	4.328310936991734e-16	149	17	11	0.6470588235294118	0.0738255033557047	GO:0097696	GO:BP	cell surface receptor signaling pathway via STAT	16175	18727		0.32142857142857145	0.3333333333333333	149	16026	11	6	138	16020	16175	0.21656377561190712
R1	cpdb	0	network_modules	155	TRUE	4.66302951017464e-16	194	12	11	0.9166666666666666	0.05670103092783505	KEGG:05167	KEGG	Kaposi sarcoma-associated herpesvirus infection	8484	448		0.5	0.5217391304347826	194	8290	11	1	183	8289	8484	0.22504044358994957
R1	cpdb	0	network_modules	155	TRUE	5.86886855632304e-16	198	12	11	0.9166666666666666	0.05555555555555555	KEGG:05169	KEGG	Epstein-Barr virus infection	8484	450		0.5454545454545454	0.5652173913043478	198	8286	11	1	187	8285	8484	0.22269193910033197
R1	cpdb	0	network_modules	155	TRUE	8.032824707505378e-16	82	16	10	0.625	0.12195121951219512	REAC:R-HSA-168928	REAC	DDX58/IFIH1-mediated induction of interferon-alpha/beta	10916	436		0.3333333333333333	0.4	82	10834	10	6	72	10828	10916	0.2739917672444278
R1	cpdb	0	network_modules	155	TRUE	1.269018572461935e-15	100	17	10	0.5882352941176471	0.1	GO:0002286	GO:BP	T cell activation involved in immune response	16175	818		0.3392857142857143	0.3508771929824561	100	16075	10	7	90	16068	16175	0.24085847101423372
R1	cpdb	0	network_modules	155	TRUE	1.5603306521879563e-15	102	17	10	0.5882352941176471	0.09803921568627451	GO:0033135	GO:BP	regulation of peptidyl-serine phosphorylation	16175	8051		0.35714285714285715	0.3684210526315789	102	16073	10	7	92	16066	16175	0.23844959498814502
R1	cpdb	0	network_modules	155	TRUE	3.1144017909064926e-15	109	17	10	0.5882352941176471	0.09174311926605505	GO:0030183	GO:BP	B cell differentiation	16175	6700		0.375	0.38596491228070173	109	16066	10	7	99	16059	16175	0.23054458322683058
R1	cpdb	0	network_modules	155	TRUE	3.3205121598804126e-15	231	12	11	0.9166666666666666	0.047619047619047616	KEGG:05171	KEGG	Coronavirus disease - COVID-19	8484	452		0.5909090909090909	0.6086956521739131	231	8253	11	1	220	8252	8484	0.20568496059758978
R1	cpdb	0	network_modules	155	TRUE	4.732427574733396e-15	142	12	10	0.8333333333333334	0.07042253521126761	KEGG:04936	KEGG	Alcoholic liver disease	8484	393		0.6363636363636364	0.6521739130434783	142	8342	10	2	132	8340	8484	0.23956659683117862
R1	cpdb	0	network_modules	155	TRUE	1.8331405637574343e-14	162	12	10	0.8333333333333334	0.06172839506172839	KEGG:05161	KEGG	Hepatitis B	8484	442		0.6818181818181818	0.6956521739130435	162	8322	10	2	152	8320	8484	0.22391264253674859
R1	cpdb	0	network_modules	155	TRUE	3.666187553827666e-14	334	17	12	0.7058823529411765	0.03592814371257485	GO:0009615	GO:BP	response to virus	16175	3541		0.39285714285714285	0.40350877192982454	334	15841	12	5	322	15836	16175	0.15629634290486868
R1	cpdb	0	network_modules	155	TRUE	4.0411762901163345e-14	175	12	10	0.8333333333333334	0.05714285714285714	KEGG:05152	KEGG	Tuberculosis	8484	440		0.7272727272727273	0.7391304347826086	175	8309	10	2	165	8307	8484	0.21519814140762603
R1	cpdb	0	network_modules	155	TRUE	4.275605906103399e-14	120	16	10	0.625	0.08333333333333333	REAC:R-HSA-9705671	REAC	SARS-CoV-2 activates/modulates innate and adaptive immune responses	10916	2123		0.4444444444444444	0.5	120	10796	10	6	110	10790	10916	0.22561164081355192
R1	cpdb	0	network_modules	155	TRUE	4.398623840420004e-14	291	12	11	0.9166666666666666	0.037800687285223365	KEGG:04060	KEGG	Cytokine-cytokine receptor interaction	8484	253		0.7727272727272727	0.782608695652174	291	8193	11	1	280	8192	8484	0.18246497011860377
R1	cpdb	0	network_modules	155	TRUE	1.431337700320453e-13	158	17	10	0.5882352941176471	0.06329113924050633	GO:0002285	GO:BP	lymphocyte activation involved in immune response	16175	817		0.4107142857142857	0.42105263157894735	158	16017	10	7	148	16010	16175	0.1907807297458513
R1	cpdb	0	network_modules	155	TRUE	1.7872262964591065e-13	330	12	11	0.9166666666666666	0.03333333333333333	KEGG:05165	KEGG	Human papillomavirus infection	8484	446		0.8181818181818182	0.8260869565217391	330	8154	11	1	319	8153	8484	0.17085853561695635
R1	cpdb	0	network_modules	155	TRUE	2.595662470337686e-13	210	12	10	0.8333333333333334	0.047619047619047616	KEGG:05170	KEGG	Human immunodeficiency virus 1 infection	8484	451		0.8636363636363636	0.8695652173913043	210	8274	10	2	200	8272	8484	0.19586388272665758
R1	cpdb	0	network_modules	155	TRUE	3.1448891663536374e-13	214	12	10	0.8333333333333334	0.04672897196261682	KEGG:05417	KEGG	Lipid and atherosclerosis	8484	494		0.9090909090909091	0.9130434782608695	214	8270	10	2	204	8268	8484	0.19395850006582951
R1	cpdb	0	network_modules	155	TRUE	4.1553346116314873e-13	356	12	11	0.9166666666666666	0.03089887640449438	KEGG:04151	KEGG	PI3K-Akt signaling pathway	8484	285		0.9545454545454546	0.9565217391304348	356	8128	11	1	345	8127	8484	0.16418868879154133
R1	cpdb	0	network_modules	155	TRUE	4.780295230831232e-13	223	12	10	0.8333333333333334	0.04484304932735426	KEGG:05163	KEGG	Human cytomegalovirus infection	8484	444		1	1	223	8261	10	2	213	8259	8484	0.18985814562585787
R1	cpdb	0	network_modules	155	TRUE	7.161168012347714e-13	185	17	10	0.5882352941176471	0.05405405405405406	GO:0018105	GO:BP	peptidyl-serine phosphorylation	16175	5324		0.42857142857142855	0.43859649122807015	185	15990	10	7	175	15983	16175	0.17594969389135917
R1	cpdb	0	network_modules	155	TRUE	1.3567930175565135e-12	197	17	10	0.5882352941176471	0.050761421319796954	GO:0018209	GO:BP	peptidyl-serine modification	16175	5368		0.44642857142857145	0.47368421052631576	197	15978	10	7	187	15971	16175	0.17035125402099427
R1	cpdb	0	network_modules	155	TRUE	1.3567930175565135e-12	197	17	10	0.5882352941176471	0.050761421319796954	GO:0042113	GO:BP	B cell activation	16175	9971		0.44642857142857145	0.47368421052631576	197	15978	10	7	187	15971	16175	0.17035125402099427
R1	cpdb	0	network_modules	155	TRUE	1.4346872460217835e-12	169	16	10	0.625	0.05917159763313609	REAC:R-HSA-983231	REAC	Factors involved in megakaryocyte development and platelet production	10916	931		0.5555555555555556	0.6	169	10747	10	6	159	10741	10916	0.18915155974036776
R1	cpdb	0	network_modules	155	TRUE	2.3550534657488166e-12	208	17	10	0.5882352941176471	0.04807692307692308	GO:0046651	GO:BP	lymphocyte proliferation	16175	12287		0.48214285714285715	0.49122807017543857	208	15967	10	7	198	15960	16175	0.16564690198356574
R1	cpdb	0	network_modules	155	TRUE	2.7230220927460863e-12	211	17	10	0.5882352941176471	0.04739336492890995	GO:0032943	GO:BP	mononuclear cell proliferation	16175	7928		0.5	0.5087719298245614	211	15964	10	7	201	15957	16175	0.1644275342564406
R1	cpdb	0	network_modules	155	TRUE	3.452308383667899e-12	216	17	10	0.5882352941176471	0.046296296296296294	GO:0002366	GO:BP	leukocyte activation involved in immune response	16175	898		0.5178571428571429	0.5263157894736842	216	15959	10	7	206	15952	16175	0.16245139948958265
R1	cpdb	0	network_modules	155	TRUE	4.352497751628986e-12	221	17	10	0.5882352941176471	0.04524886877828054	GO:0002263	GO:BP	cell activation involved in immune response	16175	795		0.5357142857142857	0.543859649122807	221	15954	10	7	211	15947	16175	0.1605419938335412
R1	cpdb	0	network_modules	155	TRUE	6.81421616817004e-12	197	16	10	0.625	0.050761421319796954	REAC:R-HSA-9705683	REAC	SARS-CoV-2-host interactions	10916	2128		0.6666666666666666	0.7	197	10719	10	6	187	10713	10916	0.17468481413638753
R1	cpdb	0	network_modules	155	TRUE	8.45516754501387e-12	236	17	10	0.5882352941176471	0.0423728813559322	GO:0070661	GO:BP	leukocyte proliferation	16175	16242		0.5535714285714286	0.5614035087719298	236	15939	10	7	226	15932	16175	0.15517849323674804
R1	cpdb	0	network_modules	155	TRUE	4.383667155945254e-11	419	17	11	0.6470588235294118	0.026252983293556086	GO:0019221	GO:BP	cytokine-mediated signaling pathway	16175	5598		0.5714285714285714	0.5789473684210527	419	15756	11	6	408	15750	16175	0.12683662916112526
R1	cpdb	0	network_modules	155	TRUE	8.558945970685856e-11	297	17	10	0.5882352941176471	0.03367003367003367	GO:0030098	GO:BP	lymphocyte differentiation	16175	6676		0.5892857142857143	0.5964912280701754	297	15878	10	7	287	15871	16175	0.13768206844161676
R1	cpdb	0	network_modules	155	TRUE	1.2569973730172983e-10	263	16	10	0.625	0.03802281368821293	REAC:R-HSA-913531	REAC	Interferon Signaling	10916	1227		0.7777777777777778	0.8	263	10653	10	6	253	10647	10916	0.15014249932258258
R1	cpdb	0	network_modules	155	TRUE	2.775418161801214e-10	334	17	10	0.5882352941176471	0.029940119760479042	GO:0002250	GO:BP	adaptive immune response	16175	782		0.6071428571428571	0.6140350877192983	334	15841	10	7	324	15834	16175	0.12946196744461191
R1	cpdb	0	network_modules	155	TRUE	3.5869139914262426e-10	292	16	10	0.625	0.03424657534246575	REAC:R-HSA-9694516	REAC	SARS-CoV-2 Infection	10916	2122		0.8888888888888888	0.9	292	10624	10	6	282	10618	10916	0.14205539085980887
R1	cpdb	0	network_modules	155	TRUE	3.731754204090482e-10	721	17	12	0.7058823529411765	0.016643550624133148	GO:0045087	GO:BP	innate immune response	16175	11270		0.625	0.631578947368421	721	15454	12	5	709	15449	16175	0.10394180128284027
R1	cpdb	0	network_modules	155	TRUE	5.39984967026415e-10	357	17	10	0.5882352941176471	0.028011204481792718	GO:1903131	GO:BP	mononuclear cell differentiation	16175	22787		0.6428571428571429	0.6491228070175439	357	15818	10	7	347	15811	16175	0.12499926413145156
R1	cpdb	0	network_modules	155	TRUE	6.504046221770618e-10	536	17	11	0.6470588235294118	0.020522388059701493	GO:0002252	GO:BP	immune effector process	16175	784		0.6607142857142857	0.6666666666666666	536	15639	11	6	525	15633	16175	0.11125018467859138
R1	cpdb	0	network_modules	155	TRUE	9.511447552283644e-10	555	17	11	0.6470588235294118	0.01981981981981982	GO:0071345	GO:BP	cellular response to cytokine stimulus	16175	16597		0.6785714285714286	0.6842105263157895	555	15620	11	6	544	15614	16175	0.10918647902546849
R1	cpdb	0	network_modules	155	TRUE	1.94594578439264e-9	406	17	10	0.5882352941176471	0.024630541871921183	GO:0042110	GO:BP	T cell activation	16175	9970		0.6964285714285714	0.7017543859649122	406	15769	10	7	396	15762	16175	0.11676757055956051
R1	cpdb	0	network_modules	155	TRUE	3.466560141996756e-9	625	17	11	0.6470588235294118	0.0176	GO:0034097	GO:BP	response to cytokine	16175	8408		0.7142857142857143	0.7368421052631579	625	15550	11	6	614	15544	16175	0.10239351998813893
R1	cpdb	0	network_modules	155	TRUE	3.466560141996756e-9	625	17	11	0.6470588235294118	0.0176	GO:1901652	GO:BP	response to peptide	16175	21619		0.7142857142857143	0.7368421052631579	625	15550	11	6	614	15544	16175	0.10239351998813893
R1	cpdb	0	network_modules	155	TRUE	3.775947801273724e-9	434	17	10	0.5882352941176471	0.02304147465437788	GO:0002521	GO:BP	leukocyte differentiation	16175	1043		0.75	0.7543859649122807	434	15741	10	7	424	15734	16175	0.11269100291385349
R1	cpdb	0	network_modules	155	TRUE	4.043261760172914e-9	437	17	10	0.5882352941176471	0.02288329519450801	GO:0014070	GO:BP	response to organic cyclic compound	16175	4635		0.7678571428571429	0.7719298245614035	437	15738	10	7	427	15731	16175	0.11227712341711298
R1	cpdb	0	network_modules	155	TRUE	1.1673919261262141e-8	699	17	11	0.6470588235294118	0.015736766809728183	GO:0045321	GO:BP	leukocyte activation	16175	11356		0.7857142857142857	0.7894736842105263	699	15476	11	6	688	15470	16175	0.09632338693382604
R1	cpdb	0	network_modules	155	TRUE	1.535632603305325e-8	500	17	10	0.5882352941176471	0.02	GO:0001934	GO:BP	positive regulation of protein phosphorylation	16175	548		0.8035714285714286	0.8070175438596491	500	15675	10	7	490	15668	16175	0.1044463923351175
R1	cpdb	0	network_modules	155	TRUE	2.3501477853808238e-8	522	17	10	0.5882352941176471	0.019157088122605363	GO:0042327	GO:BP	positive regulation of phosphorylation	16175	10095		0.8214285714285714	0.8245614035087719	522	15653	10	7	512	15646	16175	0.10204388958741646
R1	cpdb	0	network_modules	155	TRUE	3.20951950686706e-8	459	16	10	0.625	0.02178649237472767	REAC:R-HSA-9679506	REAC	SARS-CoV Infections	10916	2112		1	1	459	10457	10	6	449	10451	10916	0.11128404265112894
R1	cpdb	0	network_modules	155	TRUE	5.0420866458095464e-8	564	17	10	0.5882352941176471	0.01773049645390071	GO:0010562	GO:BP	positive regulation of phosphorus metabolic process	16175	4215		0.8392857142857143	0.8596491228070176	564	15611	10	7	554	15604	16175	0.09784373698011702
R1	cpdb	0	network_modules	155	TRUE	5.0420866458095464e-8	564	17	10	0.5882352941176471	0.01773049645390071	GO:0045937	GO:BP	positive regulation of phosphate metabolic process	16175	11731		0.8392857142857143	0.8596491228070176	564	15611	10	7	554	15604	16175	0.09784373698011702
R1	cpdb	0	network_modules	155	TRUE	5.5000767079405844e-8	569	17	10	0.5882352941176471	0.01757469244288225	GO:0046649	GO:BP	lymphocyte activation	16175	12286		0.875	0.8771929824561403	569	15606	10	7	559	15599	16175	0.09737407375877512
R1	cpdb	0	network_modules	155	TRUE	1.2593093235656022e-7	619	17	10	0.5882352941176471	0.01615508885298869	GO:1901698	GO:BP	response to nitrogen compound	16175	21651		0.8928571428571429	0.8947368421052632	619	15556	10	7	609	15549	16175	0.09298583225167088
R1	cpdb	0	network_modules	155	TRUE	1.544380998442771e-7	632	17	10	0.5882352941176471	0.015822784810126583	GO:0031401	GO:BP	positive regulation of protein modification process	16175	7157		0.9107142857142857	0.9122807017543859	632	15543	10	7	622	15536	16175	0.09192845865484615
R1	cpdb	0	network_modules	155	TRUE	1.6944270266780524e-7	638	17	10	0.5882352941176471	0.01567398119122257	GO:0018193	GO:BP	peptidyl-amino acid modification	16175	5353		0.9285714285714286	0.9473684210526315	638	15537	10	7	628	15530	16175	0.09145102277378511
R1	cpdb	0	network_modules	155	TRUE	1.6944270266780524e-7	638	17	10	0.5882352941176471	0.01567398119122257	GO:0030097	GO:BP	hemopoiesis	16175	6675		0.9285714285714286	0.9473684210526315	638	15537	10	7	628	15530	16175	0.09145102277378511
R1	cpdb	0	network_modules	155	TRUE	7.623287280705998e-7	744	17	10	0.5882352941176471	0.013440860215053764	GO:0001932	GO:BP	regulation of protein phosphorylation	16175	546		0.9642857142857143	0.9649122807017544	744	15431	10	7	734	15424	16175	0.08396179273379109
R1	cpdb	0	network_modules	155	TRUE	1.4018995069402256e-6	792	17	10	0.5882352941176471	0.012626262626262626	GO:0042325	GO:BP	regulation of phosphorylation	16175	10093		0.9821428571428571	0.9824561403508771	792	15383	10	7	782	15376	16175	0.08105853995897222
R1	cpdb	0	network_modules	155	TRUE	0.004101533137935027	3	17	2	0.11764705882352941	0.6666666666666666	GO:2000552	GO:BP	negative regulation of T-helper 2 cell cytokine production	16175	25853		1	1	3	16172	2	15	1	16157	16175	0.27978750803920066
R1	cpdb	0	network_modules	156	TRUE	4.080220906758761e-6	5	17	3	0.17647058823529413	0.6	KEGG:00524	KEGG	Neomycin, kanamycin and gentamicin biosynthesis	8484	73		0	0.07142857142857142	5	8479	3	14	2	8465	8484	0.32473010168748506
R1	cpdb	0	network_modules	156	TRUE	1.160105153417027e-5	70	17	5	0.29411764705882354	0.07142857142857142	KEGG:05230	KEGG	Central carbon metabolism in cancer	8484	478		0.07692307692307693	0.14285714285714285	70	8414	5	12	65	8402	8484	0.14160344537867686
R1	cpdb	0	network_modules	156	TRUE	4.7897947612151584e-4	67	17	4	0.23529411764705882	0.05970149253731343	KEGG:00010	KEGG	Glycolysis / Gluconeogenesis	8484	2		0.15384615384615385	0.21428571428571427	67	8417	4	13	63	8404	8484	0.11511417738077204
R1	cpdb	0	network_modules	156	TRUE	6.099255236129784e-4	10	26	3	0.11538461538461539	0.3	GO:0046835	GO:BP	carbohydrate phosphorylation	16175	12392		NA	1	10	16165	3	23	7	16142	16175	0.18526140987785414
R1	cpdb	0	network_modules	156	TRUE	0.0019572056150882694	32	17	3	0.17647058823529413	0.09375	KEGG:00052	KEGG	Galactose metabolism	8484	7		0.23076923076923078	0.2857142857142857	32	8452	3	14	29	8438	8484	0.12623938878020086
R1	cpdb	0	network_modules	156	TRUE	0.0023554287837546295	34	17	3	0.17647058823529413	0.08823529411764706	KEGG:00051	KEGG	Fructose and mannose metabolism	8484	6		0.3076923076923077	0.35714285714285715	34	8450	3	14	31	8436	8484	0.12231749445239275
R1	cpdb	0	network_modules	156	TRUE	0.00280349766699958	36	17	3	0.17647058823529413	0.08333333333333333	KEGG:00500	KEGG	Starch and sucrose metabolism	8484	62		0.38461538461538464	0.42857142857142855	36	8448	3	14	33	8434	8484	0.11872280474091229
R1	cpdb	0	network_modules	156	TRUE	0.0030470865827980234	37	17	3	0.17647058823529413	0.08108108108108109	KEGG:01250	KEGG	Biosynthesis of nucleotide sugars	8484	191		0.46153846153846156	0.5	37	8447	3	14	34	8433	8484	0.11703423416121439
R1	cpdb	0	network_modules	156	TRUE	0.003301218399419242	109	17	4	0.23529411764705882	0.03669724770642202	KEGG:04066	KEGG	HIF-1 signaling pathway	8484	257		0.5384615384615384	0.5714285714285714	109	8375	4	13	105	8362	8484	0.0885075000268503
R1	cpdb	0	network_modules	156	TRUE	0.00588696430003056	46	17	3	0.17647058823529413	0.06521739130434782	KEGG:04930	KEGG	Type II diabetes mellitus	8484	387		0.6153846153846154	0.6428571428571429	46	8438	3	14	43	8424	8484	0.10437133356881244
R1	cpdb	0	network_modules	156	TRUE	0.006280559270630125	47	17	3	0.17647058823529413	0.06382978723404255	KEGG:00620	KEGG	Pyruvate metabolism	8484	99		0.6923076923076923	0.7857142857142857	47	8437	3	14	44	8423	8484	0.10318999267215878
R1	cpdb	0	network_modules	156	TRUE	0.006280559270630125	47	17	3	0.17647058823529413	0.06382978723404255	KEGG:04973	KEGG	Carbohydrate digestion and absorption	8484	404		0.6923076923076923	0.7857142857142857	47	8437	3	14	44	8423	8484	0.10318999267215878
R1	cpdb	0	network_modules	156	TRUE	0.006690965208907077	48	17	3	0.17647058823529413	0.0625	KEGG:00280	KEGG	Valine, leucine and isoleucine degradation	8484	31		0.8461538461538461	0.8571428571428571	48	8436	3	14	45	8422	8484	0.10204507533183182
R1	cpdb	0	network_modules	156	TRUE	0.007118504180045513	49	17	3	0.17647058823529413	0.061224489795918366	KEGG:00520	KEGG	Amino sugar and nucleotide sugar metabolism	8484	69		0.9230769230769231	0.9285714285714286	49	8435	3	14	46	8421	8484	0.10093472039110293
R1	cpdb	0	network_modules	156	TRUE	0.008050605470462826	137	17	4	0.23529411764705882	0.029197080291970802	KEGG:04910	KEGG	Insulin signaling pathway	8484	367		1	1	137	8347	4	13	133	8334	8484	0.07790557647223839
R1	cpdb	0	network_modules	157	TRUE	1.5777609940432427e-9	56	20	7	0.35	0.125	REAC:R-HSA-72187	REAC	mRNA 3'-end processing	10916	2701		0	0.2	56	10860	7	13	49	10847	10916	0.20681944212162953
R1	cpdb	0	network_modules	157	TRUE	4.691851045776735e-9	65	20	7	0.35	0.1076923076923077	REAC:R-HSA-73856	REAC	RNA Polymerase II Transcription Termination	10916	1895		0.25	0.4	65	10851	7	13	58	10838	10916	0.19158840455683043
R1	cpdb	0	network_modules	157	TRUE	8.906413305665676e-9	71	20	7	0.35	0.09859154929577464	REAC:R-HSA-159236	REAC	Transport of Mature mRNA derived from an Intron-Containing Transcript	10916	2586		0.5	0.6	71	10845	7	13	64	10832	10916	0.18307221601331933
R1	cpdb	0	network_modules	157	TRUE	2.1075095917948123e-8	80	20	7	0.35	0.0875	REAC:R-HSA-72202	REAC	Transport of Mature Transcript to Cytoplasm	10916	2584		0.75	0.8	80	10836	7	13	73	10823	10916	0.17212471271072824
R1	cpdb	0	network_modules	157	TRUE	2.9118892438579624e-8	108	16	7	0.4375	0.06481481481481481	KEGG:03013	KEGG	Nucleocytoplasmic transport	8484	209		0	0.3333333333333333	108	8376	7	9	101	8367	8484	0.16470015579085293
R1	cpdb	0	network_modules	157	TRUE	5.20855961732462e-8	69	30	7	0.23333333333333334	0.10144927536231885	GO:0006406	GO:BP	mRNA export from nucleus	16175	2167		0	0.07692307692307693	69	16106	7	23	62	16083	16175	0.15150639279329595
R1	cpdb	0	network_modules	157	TRUE	1.0462374295021849e-7	76	30	7	0.23333333333333334	0.09210526315789473	GO:0051028	GO:BP	mRNA transport	16175	13445		0.08333333333333333	0.15384615384615385	76	16099	7	23	69	16076	16175	0.14411919781751226
R1	cpdb	0	network_modules	157	TRUE	3.1117843848789877e-7	149	30	8	0.26666666666666666	0.053691275167785234	GO:0006403	GO:BP	RNA localization	16175	2164		0.16666666666666666	0.23076923076923078	149	16026	8	22	141	16004	16175	0.11616662836728273
R1	cpdb	0	network_modules	157	TRUE	3.51358196007551e-7	90	30	7	0.23333333333333334	0.07777777777777778	GO:0006405	GO:BP	RNA export from nucleus	16175	2166		0.25	0.3076923076923077	90	16085	7	23	83	16062	16175	0.13199244818731534
R1	cpdb	0	network_modules	157	TRUE	1.8778510456659956e-6	114	30	7	0.23333333333333334	0.06140350877192982	GO:0050658	GO:BP	RNA transport	16175	13198		0.3333333333333333	0.46153846153846156	114	16061	7	23	107	16038	16175	0.11660139533386801
R1	cpdb	0	network_modules	157	TRUE	1.8778510456659956e-6	114	30	7	0.23333333333333334	0.06140350877192982	GO:0050657	GO:BP	nucleic acid transport	16175	13197		0.3333333333333333	0.46153846153846156	114	16061	7	23	107	16038	16175	0.11660139533386801
R1	cpdb	0	network_modules	157	TRUE	2.2549192587645277e-6	117	30	7	0.23333333333333334	0.05982905982905983	GO:0051236	GO:BP	establishment of RNA localization	16175	13586		0.5	0.5384615384615384	117	16058	7	23	110	16035	16175	0.11501320286023141
R1	cpdb	0	network_modules	157	TRUE	1.4069500909352063e-5	152	30	7	0.23333333333333334	0.046052631578947366	GO:0051168	GO:BP	nuclear export	16175	13551		0.5833333333333334	0.6153846153846154	152	16023	7	23	145	16000	16175	0.10004982238517991
R1	cpdb	0	network_modules	157	TRUE	2.613832371721053e-5	261	30	8	0.26666666666666666	0.03065134099616858	GO:0051169	GO:BP	nuclear transport	16175	13552		0.6666666666666666	0.7692307692307693	261	15914	8	22	253	15892	16175	0.08571105368783291
R1	cpdb	0	network_modules	157	TRUE	2.613832371721053e-5	261	30	8	0.26666666666666666	0.03065134099616858	GO:0006913	GO:BP	nucleocytoplasmic transport	16175	2562		0.6666666666666666	0.7692307692307693	261	15914	8	22	253	15892	16175	0.08571105368783291
R1	cpdb	0	network_modules	157	TRUE	2.8165156911147255e-5	168	30	7	0.23333333333333334	0.041666666666666664	GO:0015931	GO:BP	nucleobase-containing compound transport	16175	5016		0.8333333333333334	0.8461538461538461	168	16007	7	23	161	15984	16175	0.09479333090674771
R1	cpdb	0	network_modules	157	TRUE	5.3361762513523025e-5	193	16	6	0.375	0.031088082901554404	KEGG:04814	KEGG	Motor proteins	8484	366		0.5	0.6666666666666666	193	8291	6	10	187	8281	8484	0.10269297009634537
R1	cpdb	0	network_modules	157	TRUE	1.2095554474606942e-4	276	20	7	0.35	0.025362318840579712	REAC:R-HSA-72203	REAC	Processing of Capped Intron-Containing Pre-mRNA	10916	1796		1	1	276	10640	7	13	269	10627	10916	0.08861828248197583
R1	cpdb	0	network_modules	157	TRUE	0.0013986468282237495	93	16	4	0.25	0.043010752688172046	KEGG:04520	KEGG	Adherens junction	8484	316		1	1	93	8391	4	12	89	8379	8484	0.09979049628462969
R1	cpdb	0	network_modules	157	TRUE	0.005151137262165858	708	30	9	0.3	0.012711864406779662	GO:0030029	GO:BP	actin filament-based process	16175	6653		0.9166666666666666	0.9230769230769231	708	15467	9	21	699	15446	16175	0.05398760665758677
R1	cpdb	0	network_modules	157	TRUE	0.005993857187140468	59	30	4	0.13333333333333333	0.06779661016949153	GO:0030239	GO:BP	myofibril assembly	16175	6736		1	1	59	16116	4	26	55	16090	16175	0.09273068000597846
R1	cpdb	0	network_modules	158	TRUE	1.532041212733805e-8	183	27	9	0.3333333333333333	0.04918032786885246	GO:0043413	GO:BP	macromolecule glycosylation	16175	10680		0	0.25	183	15992	9	18	174	15974	16175	0.12450079984919322
R1	cpdb	0	network_modules	158	TRUE	1.532041212733805e-8	183	27	9	0.3333333333333333	0.04918032786885246	GO:0006486	GO:BP	protein glycosylation	16175	2220		0	0.25	183	15992	9	18	174	15974	16175	0.12450079984919322
R1	cpdb	0	network_modules	158	TRUE	4.071198329970551e-8	204	27	9	0.3333333333333333	0.04411764705882353	GO:0070085	GO:BP	glycosylation	16175	15903		0.2857142857142857	0.375	204	15971	9	18	195	15953	16175	0.11752044733120066
R1	cpdb	0	network_modules	158	TRUE	2.2514992702339513e-7	94	27	7	0.25925925925925924	0.07446808510638298	GO:0006493	GO:BP	protein O-linked glycosylation	16175	2225		0.42857142857142855	0.5	94	16081	7	20	87	16061	16175	0.13634364854675393
R1	cpdb	0	network_modules	158	TRUE	4.202556964979965e-7	265	27	9	0.3333333333333333	0.033962264150943396	GO:0009101	GO:BP	glycoprotein biosynthetic process	16175	3273		0.5714285714285714	0.625	265	15910	9	18	256	15892	16175	0.10209384626720708
R1	cpdb	0	network_modules	158	TRUE	5.398021019347431e-7	108	23	7	0.30434782608695654	0.06481481481481481	REAC:R-HSA-5173105	REAC	O-linked glycosylation	10916	1631		0	0.2	108	10808	7	16	101	10792	10916	0.13670573734177527
R1	cpdb	0	network_modules	158	TRUE	1.9346158257616853e-6	315	27	9	0.3333333333333333	0.02857142857142857	GO:0009100	GO:BP	glycoprotein metabolic process	16175	3272		0.7142857142857143	0.75	315	15860	9	18	306	15842	16175	0.0928740302204571
R1	cpdb	0	network_modules	158	TRUE	2.840149681432797e-6	47	19	5	0.2631578947368421	0.10638297872340426	KEGG:00514	KEGG	Other types of O-glycan biosynthesis	8484	67		0	0.5	47	8437	5	14	42	8423	8484	0.16443615859922733
R1	cpdb	0	network_modules	158	TRUE	8.650969686351786e-6	40	27	5	0.18518518518518517	0.125	GO:0016266	GO:BP	O-glycan processing	16175	5194		0.8571428571428571	0.875	40	16135	5	22	35	16113	16175	0.1504249743405702
R1	cpdb	0	network_modules	158	TRUE	5.1314391424012543e-5	62	23	5	0.21739130434782608	0.08064516129032258	REAC:R-HSA-913709	REAC	O-linked glycosylation of mucins	10916	1632		0.25	0.4	62	10854	5	18	57	10836	10916	0.12945163167376741
R1	cpdb	0	network_modules	158	TRUE	1.3542149076489646e-4	514	27	9	0.3333333333333333	0.017509727626459144	GO:1901137	GO:BP	carbohydrate derivative biosynthetic process	16175	21245		1	1	514	15661	9	18	505	15643	16175	0.07029805761286287
R1	cpdb	0	network_modules	158	TRUE	0.002968892864429106	140	23	5	0.21739130434782608	0.03571428571428571	REAC:R-HSA-3781865	REAC	Diseases of glycosylation	10916	765		0.5	0.6	140	10776	5	18	135	10758	10916	0.08354001252443476
R1	cpdb	0	network_modules	158	TRUE	0.004006059275109083	36	19	3	0.15789473684210525	0.08333333333333333	KEGG:00512	KEGG	Mucin type O-glycan biosynthesis	8484	65		1	1	36	8448	3	16	33	8432	8484	0.1119882490174578
R1	cpdb	0	network_modules	158	TRUE	0.004185559011958507	3	23	2	0.08695652173913043	0.6666666666666666	REAC:R-HSA-5083629	REAC	Defective POMT2 causes MDDGA2, MDDGB2 and MDDGC2	10916	610		0.75	1	3	10913	2	21	1	10892	10916	0.24029702124942165
R1	cpdb	0	network_modules	158	TRUE	0.004185559011958507	3	23	2	0.08695652173913043	0.6666666666666666	REAC:R-HSA-5083633	REAC	Defective POMT1 causes MDDGA1, MDDGB1 and MDDGC1	10916	609		0.75	1	3	10913	2	21	1	10892	10916	0.24029702124942165
R1	cpdb	0	network_modules	159	TRUE	2.8332805107557764e-4	31	8	3	0.375	0.0967741935483871	REAC:R-HSA-917977	REAC	Transferrin endocytosis and recycling	10916	2564		0	0.5	31	10885	3	5	28	10880	10916	0.18939597238523775
R1	cpdb	0	network_modules	159	TRUE	4.5987925237004544e-4	98	11	4	0.36363636363636365	0.04081632653061224	GO:0019882	GO:BP	antigen processing and presentation	16175	6060		0	0.16666666666666666	98	16077	4	7	94	16070	16175	0.12020457855689111
R1	cpdb	0	network_modules	159	TRUE	0.0018278707879155983	57	8	3	0.375	0.05263157894736842	REAC:R-HSA-917937	REAC	Iron uptake and transport	10916	1277		1	1	57	10859	3	5	54	10854	10916	0.13894567767456634
R1	cpdb	0	network_modules	159	TRUE	0.0031944293719536735	107	7	3	0.42857142857142855	0.028037383177570093	KEGG:04350	KEGG	TGF-beta signaling pathway	8484	304		NA	1	107	8377	3	4	104	8373	8484	0.10711331004967398
R1	cpdb	0	network_modules	159	TRUE	0.003232965936939269	43	11	3	0.2727272727272727	0.06976744186046512	GO:0006826	GO:BP	iron ion transport	16175	2501		0.2	0.3333333333333333	43	16132	3	8	40	16124	16175	0.1368240276499761
R1	cpdb	0	network_modules	159	TRUE	0.007156405668604097	6	11	2	0.18181818181818182	0.3333333333333333	GO:0034756	GO:BP	regulation of iron ion transport	16175	8725		0.4	0.6666666666666666	6	16169	2	9	4	16160	16175	0.24580989962527874
R1	cpdb	0	network_modules	159	TRUE	0.007156405668604097	6	11	2	0.18181818181818182	0.3333333333333333	GO:0071281	GO:BP	cellular response to iron ion	16175	16538		0.4	0.6666666666666666	6	16169	2	9	4	16160	16175	0.24580989962527874
R1	cpdb	0	network_modules	159	TRUE	0.009365442617159088	61	11	3	0.2727272727272727	0.04918032786885246	GO:0006879	GO:BP	intracellular iron ion homeostasis	16175	2535		0.8	0.8333333333333334	61	16114	3	8	58	16106	16175	0.11446715388212408
R1	cpdb	0	network_modules	159	TRUE	0.009837994979752492	62	11	3	0.2727272727272727	0.04838709677419355	GO:0048002	GO:BP	antigen processing and presentation of peptide antigen	16175	12460		1	1	62	16113	3	8	59	16105	16175	0.11351770243647508
R1	cpdb	0	network_modules	160	TRUE	3.9012173972186123e-10	21	21	6	0.2857142857142857	0.2857142857142857	REAC:R-HSA-379726	REAC	Mitochondrial tRNA aminoacylation	10916	1470		0	0.3333333333333333	21	10895	6	15	15	10880	10916	0.28433750737559826
R1	cpdb	0	network_modules	160	TRUE	2.423681604715331e-9	158	26	9	0.34615384615384615	0.056962025316455694	GO:0140053	GO:BP	mitochondrial gene expression	16175	19653		0	0.1111111111111111	158	16017	9	17	149	16000	16175	0.13723867654448188
R1	cpdb	0	network_modules	160	TRUE	1.4884382769563399e-8	44	18	6	0.3333333333333333	0.13636363636363635	KEGG:00970	KEGG	Aminoacyl-tRNA biosynthesis	8484	153		NA	1	44	8440	6	12	38	8428	8484	0.21065355362489327
R1	cpdb	0	network_modules	160	TRUE	3.678999564007887e-8	42	21	6	0.2857142857142857	0.14285714285714285	REAC:R-HSA-379724	REAC	tRNA Aminoacylation	10916	2740		0.5	0.6666666666666666	42	10874	6	15	36	10859	10916	0.19988677135298819
R1	cpdb	0	network_modules	160	TRUE	5.574804205216837e-8	41	26	6	0.23076923076923078	0.14634146341463414	GO:0043038	GO:BP	amino acid activation	16175	10488		0.125	0.3333333333333333	41	16134	6	20	35	16114	16175	0.1821278658748456
R1	cpdb	0	network_modules	160	TRUE	5.574804205216837e-8	41	26	6	0.23076923076923078	0.14634146341463414	GO:0043039	GO:BP	tRNA aminoacylation	16175	10489		0.125	0.3333333333333333	41	16134	6	20	35	16114	16175	0.1821278658748456
R1	cpdb	0	network_modules	160	TRUE	6.497034866784692e-8	42	26	6	0.23076923076923078	0.14285714285714285	GO:0000959	GO:BP	mitochondrial RNA metabolic process	16175	267		0.375	0.4444444444444444	42	16133	6	20	36	16113	16175	0.17990344685307375
R1	cpdb	0	network_modules	160	TRUE	1.3509654971872573e-7	247	26	9	0.34615384615384615	0.03643724696356275	GO:0006520	GO:BP	amino acid metabolic process	16175	2241		0.5	0.5555555555555556	247	15928	9	17	238	15911	16175	0.10826896429823563
R1	cpdb	0	network_modules	160	TRUE	4.779850998922892e-7	186	26	8	0.3076923076923077	0.043010752688172046	GO:0006399	GO:BP	tRNA metabolic process	16175	2160		0.625	0.6666666666666666	186	15989	8	18	178	15971	16175	0.1114720354313752
R1	cpdb	0	network_modules	160	TRUE	4.798647654975324e-6	38	26	5	0.19230769230769232	0.13157894736842105	GO:0006418	GO:BP	tRNA aminoacylation for protein translation	16175	2175		0.75	0.7777777777777778	38	16137	5	21	33	16116	16175	0.15743939903008405
R1	cpdb	0	network_modules	160	TRUE	5.8490684378416464e-5	127	26	6	0.23076923076923078	0.047244094488188976	GO:0032543	GO:BP	mitochondrial translation	16175	7635		0.875	0.8888888888888888	127	16048	6	20	121	16028	16175	0.10134217054877155
R1	cpdb	0	network_modules	160	TRUE	2.4327257074074267e-4	292	21	7	0.3333333333333333	0.023972602739726026	REAC:R-HSA-72766	REAC	Translation	10916	2565		1	1	292	10624	7	14	285	10610	10916	0.0834205466506362
R1	cpdb	0	network_modules	160	TRUE	2.8524002094473843e-4	8	26	3	0.11538461538461539	0.375	GO:0070127	GO:BP	tRNA aminoacylation for mitochondrial protein translation	16175	15927		1	1	8	16167	3	23	5	16144	16175	0.20733888428774644
R1	cpdb	0	network_modules	161	TRUE	0.0019759134227206308	4	12	2	0.16666666666666666	0.5	REAC:R-HSA-1306955	REAC	GRB7 events in ERBB2 signaling	10916	1025		0	0.5	4	10912	2	10	2	10902	10916	0.288251721434951
R1	cpdb	0	network_modules	161	TRUE	0.006903031937510064	7	12	2	0.16666666666666666	0.2857142857142857	REAC:R-HSA-5649702	REAC	APEX1-Independent Resolution of AP Sites via the Single Nucleotide Replacement Pathway	10916	30		1	1	7	10909	2	10	5	10899	10916	0.21756763404988302
R1	cpdb	0	network_modules	161	TRUE	0.00946710985138256	79	12	3	0.25	0.0379746835443038	KEGG:01521	KEGG	EGFR tyrosine kinase inhibitor resistance	8484	195		NA	1	79	8405	3	9	76	8396	8484	0.09431287473044947
R1	cpdb	0	network_modules	162	TRUE	8.724720958583772e-15	86	22	10	0.45454545454545453	0.11627906976744186	GO:0045103	GO:BP	intermediate filament-based process	16175	11274		0	0.16666666666666666	86	16089	10	12	76	16077	16175	0.22797261806780952
R1	cpdb	0	network_modules	162	TRUE	1.2568880845814958e-12	85	22	9	0.4090909090909091	0.10588235294117647	GO:0045104	GO:BP	intermediate filament cytoskeleton organization	16175	11275		0.2	0.3333333333333333	85	16090	9	13	76	16077	16175	0.20613249368711187
R1	cpdb	0	network_modules	162	TRUE	3.775124025716162e-11	71	22	8	0.36363636363636365	0.11267605633802817	GO:0045109	GO:BP	intermediate filament organization	16175	11280		0.4	0.5	71	16104	8	14	63	16090	16175	0.20055152805073997
R1	cpdb	0	network_modules	162	TRUE	2.951127253583714e-6	3	22	3	0.13636363636363635	1	GO:0033693	GO:BP	neurofilament bundle assembly	16175	8354		0.6	0.6666666666666666	3	16172	3	19	0	16153	16175	0.36905748440897673
R1	cpdb	0	network_modules	162	TRUE	1.645363116300115e-4	8	22	3	0.13636363636363635	0.375	GO:0045110	GO:BP	intermediate filament bundle assembly	16175	11281		0.8	0.8333333333333334	8	16167	3	19	5	16148	16175	0.2255224840135997
R1	cpdb	0	network_modules	162	TRUE	3.6005025829784e-4	748	22	9	0.4090909090909091	0.012032085561497326	GO:0097435	GO:BP	supramolecular fiber organization	16175	18657		1	1	748	15427	9	13	739	15414	16175	0.06376181607714922
R1	cpdb	0	network_modules	162	TRUE	0.009486506111647216	59	12	3	0.25	0.05084745762711865	REAC:R-HSA-193648	REAC	NRAGE signals death through JNK	10916	1548		NA	1	59	10857	3	9	56	10848	10916	0.11066952303953095
R1	cpdb	0	network_modules	163	TRUE	4.321720651314424e-13	138	16	10	0.625	0.07246376811594203	KEGG:04371	KEGG	Apelin signaling pathway	8484	308		0	0.0625	138	8346	10	6	128	8340	8484	0.20917949732869404
R1	cpdb	0	network_modules	163	TRUE	1.3271572845392748e-12	154	16	10	0.625	0.06493506493506493	KEGG:04921	KEGG	Oxytocin signaling pathway	8484	378		0.06666666666666667	0.125	154	8330	10	6	144	8324	8484	0.1975911198520998
R1	cpdb	0	network_modules	163	TRUE	3.431444340827026e-12	61	16	8	0.5	0.13114754098360656	KEGG:04213	KEGG	Longevity regulating pathway - multiple species	8484	290		0.13333333333333333	0.1875	61	8423	8	8	53	8415	8484	0.25354287834853256
R1	cpdb	0	network_modules	163	TRUE	6.02038609834797e-12	34	16	7	0.4375	0.20588235294117646	KEGG:04710	KEGG	Circadian rhythm	8484	345		0.2	0.25	34	8450	7	9	27	8441	8484	0.29825240737731656
R1	cpdb	0	network_modules	163	TRUE	6.906673068155734e-12	9	30	6	0.2	0.6666666666666666	REAC:R-HSA-9613354	REAC	Lipophagy	10916	1318		0	0.037037037037037035	9	10907	6	24	3	10883	10916	0.3642940202245211
R1	cpdb	0	network_modules	163	TRUE	1.7234121367373676e-11	10	30	6	0.2	0.6	REAC:R-HSA-2151209	REAC	Activation of PPARGC1A (PGC-1alpha) by phosphorylation	10916	92		0.038461538461538464	0.07407407407407407	10	10906	6	24	4	10882	10916	0.34545653453136577
R1	cpdb	0	network_modules	163	TRUE	2.0718211518409273e-10	28	30	7	0.23333333333333334	0.25	REAC:R-HSA-9619483	REAC	Activation of AMPK downstream of NMDARs	10916	73		0.07692307692307693	0.1111111111111111	28	10888	7	23	21	10865	10916	0.23950415482048015
R1	cpdb	0	network_modules	163	TRUE	2.725993230370811e-10	29	30	7	0.23333333333333334	0.2413793103448276	REAC:R-HSA-380972	REAC	Energy dependent regulation of mTOR by LKB1-AMPK	10916	843		0.11538461538461539	0.14814814814814814	29	10887	7	23	22	10864	10916	0.23525592818880242
R1	cpdb	0	network_modules	163	TRUE	1.2972423993489566e-9	70	16	7	0.4375	0.1	KEGG:04920	KEGG	Adipocytokine signaling pathway	8484	377		0.26666666666666666	0.3125	70	8414	7	9	63	8405	8484	0.20626684306042473
R1	cpdb	0	network_modules	163	TRUE	2.2926366237817328e-9	39	34	7	0.20588235294117646	0.1794871794871795	GO:0000387	GO:BP	spliceosomal snRNP assembly	16175	114		0	0.05	39	16136	7	27	32	16109	16175	0.19041067036408602
R1	cpdb	0	network_modules	163	TRUE	3.840430727126435e-9	41	30	7	0.23333333333333334	0.17073170731707318	REAC:R-HSA-165159	REAC	MTOR signalling	10916	1387		0.15384615384615385	0.18518518518518517	41	10875	7	23	34	10852	10916	0.19702100095872732
R1	cpdb	0	network_modules	163	TRUE	7.3248804839616745e-9	89	16	7	0.4375	0.07865168539325842	KEGG:04211	KEGG	Longevity regulating pathway	8484	288		0.3333333333333333	0.375	89	8395	7	9	82	8386	8484	0.18218078883420843
R1	cpdb	0	network_modules	163	TRUE	1.3554587543813544e-8	97	16	7	0.4375	0.07216494845360824	KEGG:05410	KEGG	Hypertrophic cardiomyopathy	8484	489		0.4	0.4375	97	8387	7	9	90	8378	8484	0.1742042091967787
R1	cpdb	0	network_modules	163	TRUE	2.2744930075605794e-8	397	34	12	0.35294117647058826	0.030226700251889168	GO:0008380	GO:BP	RNA splicing	16175	3186		0.05263157894736842	0.1	397	15778	12	22	385	15756	16175	0.09740845362212111
R1	cpdb	0	network_modules	163	TRUE	2.72571078291595e-8	107	16	7	0.4375	0.06542056074766354	KEGG:04922	KEGG	Glucagon signaling pathway	8484	379		0.4666666666666667	0.5	107	8377	7	9	100	8368	8484	0.16550402898706998
R1	cpdb	0	network_modules	163	TRUE	2.9118892438579624e-8	108	16	7	0.4375	0.06481481481481481	KEGG:04931	KEGG	Insulin resistance	8484	388		0.5333333333333333	0.5625	108	8376	7	9	101	8367	8484	0.16470015579085293
R1	cpdb	0	network_modules	163	TRUE	3.9418470405491255e-8	12	34	5	0.14705882352941177	0.4166666666666667	GO:0006388	GO:BP	tRNA splicing, via endonucleolytic cleavage and ligation	16175	2152		0.10526315789473684	0.15	12	16163	5	29	7	16134	16175	0.24663887078146265
R1	cpdb	0	network_modules	163	TRUE	6.142818446659284e-8	120	16	7	0.4375	0.058333333333333334	KEGG:04152	KEGG	AMPK signaling pathway	8484	286		0.6	0.625	120	8364	7	9	113	8355	8484	0.15583967434242232
R1	cpdb	0	network_modules	163	TRUE	6.395927498881974e-8	13	34	5	0.14705882352941177	0.38461538461538464	GO:0000394	GO:BP	RNA splicing, via endonucleolytic cleavage and ligation	16175	119		0.15789473684210525	0.2	13	16162	5	29	8	16133	16175	0.2368701650849631
R1	cpdb	0	network_modules	163	TRUE	1.1405698989537026e-7	131	16	7	0.4375	0.05343511450381679	KEGG:04068	KEGG	FoxO signaling pathway	8484	258		0.6666666666666666	0.6875	131	8353	7	9	124	8344	8484	0.1487944316000501
R1	cpdb	0	network_modules	163	TRUE	1.563034377494646e-7	137	16	7	0.4375	0.051094890510948905	KEGG:04910	KEGG	Insulin signaling pathway	8484	367		0.7333333333333333	0.75	137	8347	7	9	130	8338	8484	0.14530807558748973
R1	cpdb	0	network_modules	163	TRUE	2.0105739832452086e-7	142	16	7	0.4375	0.04929577464788732	KEGG:04936	KEGG	Alcoholic liver disease	8484	393		0.8	0.8125	142	8342	7	9	135	8333	8484	0.14256998502161217
R1	cpdb	0	network_modules	163	TRUE	3.500193454139581e-7	76	30	7	0.23333333333333334	0.09210526315789473	REAC:R-HSA-438064	REAC	Post NMDA receptor activation events	10916	1772		0.19230769230769232	0.2222222222222222	76	10840	7	23	69	10817	10916	0.14291884160607962
R1	cpdb	0	network_modules	163	TRUE	3.5497482895383867e-7	154	16	7	0.4375	0.045454545454545456	KEGG:04932	KEGG	Non-alcoholic fatty liver disease	8484	389		0.8666666666666667	0.875	154	8330	7	9	147	8321	8484	0.13654070246747751
R1	cpdb	0	network_modules	163	TRUE	6.368650416756678e-7	134	30	8	0.26666666666666666	0.05970149253731343	REAC:R-HSA-1632852	REAC	Macroautophagy	10916	1388		0.23076923076923078	0.25925925925925924	134	10782	8	22	126	10760	10916	0.12128018564799449
R1	cpdb	0	network_modules	163	TRUE	7.077401245869937e-7	170	16	7	0.4375	0.041176470588235294	KEGG:04530	KEGG	Tight junction	8484	317		0.9333333333333333	0.9375	170	8314	7	9	163	8305	8484	0.12949649042442818
R1	cpdb	0	network_modules	163	TRUE	7.144997880365833e-7	84	30	7	0.23333333333333334	0.08333333333333333	REAC:R-HSA-5628897	REAC	TP53 Regulates Metabolic Genes	10916	2452		0.2692307692307692	0.2962962962962963	84	10832	7	23	77	10809	10916	0.13555285232599532
R1	cpdb	0	network_modules	163	TRUE	1.0768985628200472e-6	89	30	7	0.23333333333333334	0.07865168539325842	REAC:R-HSA-442755	REAC	Activation of NMDA receptors and postsynaptic events	10916	89		0.3076923076923077	0.3333333333333333	89	10827	7	23	82	10804	10916	0.1314531653144881
R1	cpdb	0	network_modules	163	TRUE	1.361614255247591e-6	92	30	7	0.23333333333333334	0.07608695652173914	REAC:R-HSA-6804756	REAC	Regulation of TP53 Activity through Phosphorylation	10916	2016		0.34615384615384615	0.37037037037037035	92	10824	7	23	85	10801	10916	0.12915224111411663
R1	cpdb	0	network_modules	163	TRUE	1.3678287479801902e-6	51	30	6	0.2	0.11764705882352941	REAC:R-HSA-194441	REAC	Metabolism of non-coding RNA	10916	1431		0.38461538461538464	0.48148148148148145	51	10865	6	24	45	10841	10916	0.15036766230462909
R1	cpdb	0	network_modules	163	TRUE	1.3678287479801902e-6	51	30	6	0.2	0.11764705882352941	REAC:R-HSA-191859	REAC	snRNP Assembly	10916	2736		0.38461538461538464	0.48148148148148145	51	10865	6	24	45	10841	10916	0.15036766230462909
R1	cpdb	0	network_modules	163	TRUE	1.3678287479801902e-6	51	30	6	0.2	0.11764705882352941	REAC:R-HSA-9754678	REAC	SARS-CoV-2 modulates host translation machinery	10916	2125		0.38461538461538464	0.48148148148148145	51	10865	6	24	45	10841	10916	0.15036766230462909
R1	cpdb	0	network_modules	163	TRUE	1.4804358126478285e-6	149	30	8	0.26666666666666666	0.053691275167785234	REAC:R-HSA-9612973	REAC	Autophagy	10916	193		0.5	0.5185185185185185	149	10767	8	22	141	10745	10916	0.11447197165791909
R1	cpdb	0	network_modules	163	TRUE	2.1851918604272718e-6	55	30	6	0.2	0.10909090909090909	REAC:R-HSA-6784531	REAC	tRNA processing in the nucleus	10916	2745		0.5384615384615384	0.5555555555555556	55	10861	6	24	49	10837	10916	0.14455151562989732
R1	cpdb	0	network_modules	163	TRUE	2.6002296787592087e-6	160	30	8	0.26666666666666666	0.05	REAC:R-HSA-5633007	REAC	Regulation of TP53 Activity	10916	2012		0.5769230769230769	0.5925925925925926	160	10756	8	22	152	10734	10916	0.11008322394241708
R1	cpdb	0	network_modules	163	TRUE	4.354941805232488e-6	178	34	8	0.23529411764705882	0.0449438202247191	GO:0022618	GO:BP	protein-RNA complex assembly	16175	6625		0.21052631578947367	0.25	178	15997	8	26	170	15971	16175	0.09867296110670239
R1	cpdb	0	network_modules	163	TRUE	6.086132058750387e-6	232	16	7	0.4375	0.03017241379310345	KEGG:04714	KEGG	Thermogenesis	8484	349		1	1	232	8252	7	9	225	8243	8484	0.1093185866210854
R1	cpdb	0	network_modules	163	TRUE	6.4284776399819156e-6	187	34	8	0.23529411764705882	0.0427807486631016	GO:0031669	GO:BP	cellular response to nutrient levels	16175	7272		0.2631578947368421	0.3	187	15988	8	26	179	15962	16175	0.09605740091012344
R1	cpdb	0	network_modules	163	TRUE	6.704525312736887e-6	188	34	8	0.23529411764705882	0.0425531914893617	GO:0071826	GO:BP	protein-RNA complex organization	16175	16929		0.3157894736842105	0.35	188	15987	8	26	180	15961	16175	0.09577811112835748
R1	cpdb	0	network_modules	163	TRUE	1.1404313451693452e-5	72	30	6	0.2	0.08333333333333333	REAC:R-HSA-1445148	REAC	Translocation of SLC2A4 (GLUT4) to the plasma membrane	10916	2578		0.6153846153846154	0.6296296296296297	72	10844	6	24	66	10820	10916	0.1254280980756008
R1	cpdb	0	network_modules	163	TRUE	2.1604742436679655e-5	80	30	6	0.2	0.075	REAC:R-HSA-9663891	REAC	Selective autophagy	10916	2186		0.6538461538461539	0.6666666666666666	80	10836	6	24	74	10812	10916	0.11858439542859141
R1	cpdb	0	network_modules	163	TRUE	5.011505044211098e-5	92	30	6	0.2	0.06521739130434782	REAC:R-HSA-1592230	REAC	Mitochondrial biogenesis	10916	1464		0.6923076923076923	0.7037037037037037	92	10824	6	24	86	10800	10916	0.1100105224370719
R1	cpdb	0	network_modules	163	TRUE	8.950884705927584e-5	262	34	8	0.23529411764705882	0.030534351145038167	GO:0031667	GO:BP	response to nutrient levels	16175	7271		0.3684210526315789	0.4	262	15913	8	26	254	15887	16175	0.07965753421987726
R1	cpdb	0	network_modules	163	TRUE	9.841820337133528e-5	103	30	6	0.2	0.05825242718446602	REAC:R-HSA-72306	REAC	tRNA processing	10916	2743		0.7307692307692307	0.7407407407407407	103	10813	6	24	97	10789	10916	0.10347604965704756
R1	cpdb	0	network_modules	163	TRUE	1.8069368336332212e-4	287	34	8	0.23529411764705882	0.027874564459930314	GO:0000377	GO:BP	RNA splicing, via transesterification reactions with bulged adenosine as nucleophile	16175	109		0.42105263157894735	0.5	287	15888	8	26	279	15862	16175	0.07563162351509117
R1	cpdb	0	network_modules	163	TRUE	1.8069368336332212e-4	287	34	8	0.23529411764705882	0.027874564459930314	GO:0000398	GO:BP	mRNA splicing, via spliceosome	16175	121		0.42105263157894735	0.5	287	15888	8	26	279	15862	16175	0.07563162351509117
R1	cpdb	0	network_modules	163	TRUE	2.0096169610072712e-4	291	34	8	0.23529411764705882	0.027491408934707903	GO:0000375	GO:BP	RNA splicing, via transesterification reactions	16175	107		0.5263157894736842	0.55	291	15884	8	26	283	15858	16175	0.07503408645641935
R1	cpdb	0	network_modules	163	TRUE	2.5342114194580427e-4	196	30	7	0.23333333333333334	0.03571428571428571	REAC:R-HSA-112314	REAC	Neurotransmitter receptors and postsynaptic signal transmission	10916	1594		0.7692307692307693	0.7777777777777778	196	10720	7	23	189	10697	10916	0.08514633872625078
R1	cpdb	0	network_modules	163	TRUE	2.7809416845393727e-4	120	34	6	0.17647058823529413	0.05	GO:0008033	GO:BP	tRNA processing	16175	3098		0.5789473684210527	0.6	120	16055	6	28	114	16027	16175	0.09041539328327981
R1	cpdb	0	network_modules	163	TRUE	3.396565413120371e-4	8	30	3	0.1	0.375	REAC:R-HSA-163680	REAC	AMPK inhibits chREBP transcriptional activation activity	10916	20		0.8076923076923077	0.8148148148148148	8	10908	3	27	5	10881	10916	0.19256524236901273
R1	cpdb	0	network_modules	163	TRUE	8.576864103777248e-4	352	34	8	0.23529411764705882	0.022727272727272728	GO:0006397	GO:BP	mRNA processing	16175	2158		0.631578947368421	0.65	352	15823	8	26	344	15797	16175	0.06716855948676505
R1	cpdb	0	network_modules	163	TRUE	0.0012838505272486545	359	30	8	0.26666666666666666	0.022284122562674095	REAC:R-HSA-3700989	REAC	Transcriptional Regulation by TP53	10916	2546		0.8461538461538461	0.8518518518518519	359	10557	8	22	351	10535	10916	0.06881423749735538
R1	cpdb	0	network_modules	163	TRUE	0.0016278049542180683	259	30	7	0.23333333333333334	0.02702702702702703	REAC:R-HSA-112315	REAC	Transmission across Chemical Synapses	10916	2580		0.8846153846153846	0.8888888888888888	259	10657	7	23	252	10634	10916	0.07229824774364967
R1	cpdb	0	network_modules	163	TRUE	0.0018577619858626288	390	34	8	0.23529411764705882	0.020512820512820513	GO:0022613	GO:BP	ribonucleoprotein complex biogenesis	16175	6620		0.6842105263157895	0.7	390	15785	8	26	382	15759	16175	0.06318624510080495
R1	cpdb	0	network_modules	163	TRUE	0.0021833103686978873	14	30	3	0.1	0.21428571428571427	REAC:R-HSA-200425	REAC	Carnitine shuttle	10916	311		0.9230769230769231	0.9259259259259259	14	10902	3	27	11	10875	10916	0.1447994587155795
R1	cpdb	0	network_modules	163	TRUE	0.002598702086712046	41	34	4	0.11764705882352941	0.0975609756097561	GO:0006110	GO:BP	regulation of glycolytic process	16175	1969		0.7368421052631579	0.85	41	16134	4	30	37	16104	16175	0.1050696393327419
R1	cpdb	0	network_modules	163	TRUE	0.002598702086712046	41	34	4	0.11764705882352941	0.0975609756097561	GO:0030811	GO:BP	regulation of nucleotide catabolic process	16175	6914		0.7368421052631579	0.85	41	16134	4	30	37	16104	16175	0.1050696393327419
R1	cpdb	0	network_modules	163	TRUE	0.002598702086712046	41	34	4	0.11764705882352941	0.0975609756097561	GO:0033121	GO:BP	regulation of purine nucleotide catabolic process	16175	8045		0.7368421052631579	0.85	41	16134	4	30	37	16104	16175	0.1050696393327419
R1	cpdb	0	network_modules	163	TRUE	0.0036578613979326136	186	34	6	0.17647058823529413	0.03225806451612903	GO:0006399	GO:BP	tRNA metabolic process	16175	2160		0.8947368421052632	0.9	186	15989	6	28	180	15961	16175	0.0710166142280517
R1	cpdb	0	network_modules	163	TRUE	0.003741643753428837	52	30	4	0.13333333333333333	0.07692307692307693	REAC:R-HSA-1660499	REAC	Synthesis of PIPs at the plasma membrane	10916	2395		0.9615384615384616	0.9629629629629629	52	10864	4	26	48	10838	10916	0.09802390833294863
R1	cpdb	0	network_modules	163	TRUE	0.004329002655465686	197	30	6	0.2	0.030456852791878174	REAC:R-HSA-9705683	REAC	SARS-CoV-2-host interactions	10916	2128		1	1	197	10719	6	24	191	10695	10916	0.07175285588125332
R1	cpdb	0	network_modules	163	TRUE	0.004536457188515277	47	34	4	0.11764705882352941	0.0851063829787234	GO:0043470	GO:BP	regulation of carbohydrate catabolic process	16175	10718		0.9473684210526315	0.95	47	16128	4	30	43	16098	16175	0.09783612892603227
R1	cpdb	0	network_modules	163	TRUE	0.009898476697059533	57	34	4	0.11764705882352941	0.07017543859649122	GO:1903578	GO:BP	regulation of ATP metabolic process	16175	23121		1	1	57	16118	4	30	53	16088	16175	0.08838917772277023
R1	cpdb	0	network_modules	164	TRUE	3.404319784548793e-14	21	14	7	0.5	0.3333333333333333	REAC:R-HSA-4641263	REAC	Regulation of FZD by ubiquitination	10916	1974		0	0.2	21	10895	7	7	14	10888	10916	0.4073305628687834
R1	cpdb	0	network_modules	164	TRUE	1.8739327040918525e-8	174	16	8	0.5	0.04597701149425287	KEGG:04310	KEGG	Wnt signaling pathway	8484	299		NA	1	174	8310	8	8	166	8302	8484	0.14705350315668705
R1	cpdb	0	network_modules	164	TRUE	1.65141568796566e-6	231	14	7	0.5	0.030303030303030304	REAC:R-HSA-201681	REAC	TCF dependent signaling in response to WNT	10916	2421		0.25	0.4	231	10685	7	7	224	10678	10916	0.11922578097027398
R1	cpdb	0	network_modules	164	TRUE	1.829373196456487e-5	327	14	7	0.5	0.021406727828746176	REAC:R-HSA-195721	REAC	Signaling by WNT	10916	2314		0.5	0.6	327	10589	7	7	320	10582	10916	0.09881243308282153
R1	cpdb	0	network_modules	164	TRUE	2.9464565484904336e-5	8	14	3	0.21428571428571427	0.375	REAC:R-HSA-5340588	REAC	Signaling by RNF43 mutants	10916	2300		0.75	0.8	8	10908	3	11	5	10897	10916	0.2827888355778489
R1	cpdb	0	network_modules	164	TRUE	3.3062129478630557e-4	345	22	7	0.3181818181818182	0.020289855072463767	GO:0016055	GO:BP	Wnt signaling pathway	16175	5087		0	0.25	345	15830	7	15	338	15815	16175	0.07582630522885826
R1	cpdb	0	network_modules	164	TRUE	0.0012361482260310826	257	22	6	0.2727272727272727	0.023346303501945526	GO:0060070	GO:BP	canonical Wnt signaling pathway	16175	14332		0.3333333333333333	0.5	257	15918	6	16	251	15902	16175	0.07580161178101409
R1	cpdb	0	network_modules	164	TRUE	0.001913226429062965	277	22	6	0.2727272727272727	0.021660649819494584	GO:0030111	GO:BP	regulation of Wnt signaling pathway	16175	6681		0.6666666666666666	0.75	277	15898	6	16	271	15882	16175	0.07270801450660937
R1	cpdb	0	network_modules	164	TRUE	0.0023864290536104726	2	22	2	0.09090909090909091	1	GO:0038018	GO:BP	Wnt receptor catabolic process	16175	9667		1	1	2	16173	2	20	0	16153	16175	0.30132485807762605
R1	cpdb	0	network_modules	164	TRUE	0.0030871712432071156	34	14	3	0.21428571428571427	0.08823529411764706	REAC:R-HSA-4791275	REAC	Signaling by WNT in cancer	10916	2315		1	1	34	10882	3	11	31	10871	10916	0.13580474827579567
R1	cpdb	0	network_modules	165	TRUE	8.911023703355325e-6	205	12	6	0.5	0.02926829268292683	KEGG:05205	KEGG	Proteoglycans in cancer	8484	457		0	0.5	205	8279	6	6	199	8273	8484	0.11662469663338519
R1	cpdb	0	network_modules	165	TRUE	5.24445849538359e-4	227	12	5	0.4166666666666667	0.022026431718061675	KEGG:04810	KEGG	Regulation of actin cytoskeleton	8484	365		1	1	227	8257	5	7	222	8250	8484	0.09093667684328383
R1	cpdb	0	network_modules	165	TRUE	0.0010709605741957553	119	22	5	0.22727272727272727	0.04201680672268908	REAC:R-HSA-373760	REAC	L1CAM interactions	10916	1294		NA	1	119	10797	5	17	114	10780	10916	0.09363879176805931
R1	cpdb	0	network_modules	165	TRUE	0.0066811333727300375	21	26	3	0.11538461538461539	0.14285714285714285	GO:0086012	GO:BP	membrane depolarization during cardiac muscle cell action potential	16175	17886		NA	1	21	16154	3	23	18	16131	16175	0.12712823401015022
R1	cpdb	0	network_modules	166	TRUE	1.7124072246267938e-4	11	17	3	0.17647058823529413	0.2727272727272727	REAC:R-HSA-1660517	REAC	Synthesis of PIPs at the late endosome membrane	10916	2394		0	0.3333333333333333	11	10905	3	14	8	10891	10916	0.21840912037724391
R1	cpdb	0	network_modules	166	TRUE	5.783898292704148e-4	16	17	3	0.17647058823529413	0.1875	REAC:R-HSA-1660516	REAC	Synthesis of PIPs at the early endosome membrane	10916	2393		0.5	0.6666666666666666	16	10900	3	14	13	10886	10916	0.1806639517172271
R1	cpdb	0	network_modules	166	TRUE	8.411753911189443e-4	18	17	3	0.17647058823529413	0.16666666666666666	REAC:R-HSA-1660514	REAC	Synthesis of PIPs at the Golgi membrane	10916	2392		1	1	18	10898	3	14	15	10884	10916	0.17016889495644696
R1	cpdb	0	network_modules	166	TRUE	0.004309231844613065	73	10	3	0.3	0.0410958904109589	KEGG:00562	KEGG	Inositol phosphate metabolism	8484	86		0	0.5	73	8411	3	7	70	8404	8484	0.10838124254548301
R1	cpdb	0	network_modules	166	TRUE	0.0058820471987695334	81	10	3	0.3	0.037037037037037035	KEGG:04662	KEGG	B cell receptor signaling pathway	8484	339		1	1	81	8403	3	7	78	8396	8484	0.10260582867040653
R1	cpdb	0	network_modules	166	TRUE	0.007317310453705712	116	17	4	0.23529411764705882	0.034482758620689655	GO:0006661	GO:BP	phosphatidylinositol biosynthetic process	16175	2370		NA	1	116	16059	4	13	112	16046	16175	0.08769098221853983
R1	cpdb	0	network_modules	167	TRUE	2.2527489381751761e-13	18	20	7	0.35	0.3888888888888889	REAC:R-HSA-446353	REAC	Cell-extracellular matrix interactions	10916	330		0	0.16666666666666666	18	10898	7	13	11	10885	10916	0.36783448292158816
R1	cpdb	0	network_modules	167	TRUE	1.9286656915919484e-7	8	20	4	0.2	0.5	REAC:R-HSA-446388	REAC	Regulation of cytoskeletal remodeling and cell spreading by IPP complex components	10916	2026		0.2	0.3333333333333333	8	10908	4	16	4	10892	10916	0.31547364741049827
R1	cpdb	0	network_modules	167	TRUE	2.63410618095577e-7	114	20	7	0.35	0.06140350877192982	REAC:R-HSA-446728	REAC	Cell junction organization	10916	324		0.4	0.5	114	10802	7	13	107	10789	10916	0.1431042921473296
R1	cpdb	0	network_modules	167	TRUE	1.8128535929110081e-6	150	20	7	0.35	0.04666666666666667	REAC:R-HSA-1500931	REAC	Cell-Cell communication	10916	328		0.6	0.6666666666666666	150	10766	7	13	143	10753	10916	0.12375013846784794
R1	cpdb	0	network_modules	167	TRUE	3.685952730651436e-6	86	24	6	0.25	0.06976744186046512	GO:0034446	GO:BP	substrate adhesion-dependent cell spreading	16175	8640		0	0.0625	86	16089	6	18	80	16071	16175	0.1297001619585755
R1	cpdb	0	network_modules	167	TRUE	6.412506077654141e-6	279	24	8	0.3333333333333333	0.02867383512544803	GO:0031589	GO:BP	cell-substrate adhesion	16175	7233		0.06666666666666667	0.125	279	15896	8	16	271	15880	16175	0.09358524083533475
R1	cpdb	0	network_modules	167	TRUE	5.6092648933920635e-5	65	24	5	0.20833333333333334	0.07692307692307693	GO:1901019	GO:BP	regulation of calcium ion transmembrane transporter activity	16175	21141		0.13333333333333333	0.1875	65	16110	5	19	60	16091	16175	0.12449317716283392
R1	cpdb	0	network_modules	167	TRUE	8.145487066761084e-5	249	24	7	0.2916666666666667	0.028112449799196786	GO:0070588	GO:BP	calcium ion transmembrane transport	16175	16193		0.2	0.25	249	15926	7	17	242	15909	16175	0.0865037416252295
R1	cpdb	0	network_modules	167	TRUE	1.5477610967393595e-4	160	24	6	0.25	0.0375	GO:0097553	GO:BP	calcium ion transmembrane import into cytosol	16175	18700		0.26666666666666666	0.3125	160	16015	6	18	154	15997	16175	0.09352629185771585
R1	cpdb	0	network_modules	167	TRUE	4.893618458378089e-4	324	24	7	0.2916666666666667	0.021604938271604937	GO:0006816	GO:BP	calcium ion transport	16175	2495		0.3333333333333333	0.375	324	15851	7	17	317	15834	16175	0.07473710963818943
R1	cpdb	0	network_modules	167	TRUE	5.192290824055695e-4	101	24	5	0.20833333333333334	0.04950495049504951	GO:0051209	GO:BP	release of sequestered calcium ion into cytosol	16175	13568		0.4	0.4375	101	16074	5	19	96	16055	16175	0.09889412346794017
R1	cpdb	0	network_modules	167	TRUE	5.45457578286924e-4	102	24	5	0.20833333333333334	0.049019607843137254	GO:0051283	GO:BP	negative regulation of sequestering of calcium ion	16175	13619		0.4666666666666667	0.5	102	16073	5	19	97	16054	16175	0.09838110926050411
R1	cpdb	0	network_modules	167	TRUE	5.727243546362108e-4	103	24	5	0.20833333333333334	0.04854368932038835	GO:0051282	GO:BP	regulation of sequestering of calcium ion	16175	13618		0.5333333333333333	0.5625	103	16072	5	19	98	16053	16175	0.09787545119776853
R1	cpdb	0	network_modules	167	TRUE	6.610557580813782e-4	106	24	5	0.20833333333333334	0.04716981132075472	GO:0051208	GO:BP	sequestering of calcium ion	16175	13567		0.6	0.625	106	16069	5	19	101	16050	16175	0.09640087669219215
R1	cpdb	0	network_modules	167	TRUE	8.255172353192183e-4	54	20	4	0.2	0.07407407407407407	REAC:R-HSA-5578775	REAC	Ion homeostasis	10916	1273		0.8	0.8333333333333334	54	10862	4	16	50	10846	10916	0.11910942522306857
R1	cpdb	0	network_modules	167	TRUE	0.0015015803913913629	125	24	5	0.20833333333333334	0.04	GO:1903169	GO:BP	regulation of calcium ion transmembrane transport	16175	22802		0.6666666666666666	0.6875	125	16050	5	19	120	16031	16175	0.08830803180112663
R1	cpdb	0	network_modules	167	TRUE	0.0030082549124477594	17	24	3	0.125	0.17647058823529413	GO:0033623	GO:BP	regulation of integrin activation	16175	8324		0.7333333333333333	0.75	17	16158	3	21	14	16137	16175	0.1474602446488705
R1	cpdb	0	network_modules	167	TRUE	0.006450603655071502	4	20	2	0.1	0.5	REAC:R-HSA-446343	REAC	Localization of the PINCH-ILK-PARVIN complex to focal adhesions	10916	1320		1	1	4	10912	2	18	2	10894	10916	0.22303266570648034
R1	cpdb	0	network_modules	167	TRUE	0.008788332399170614	179	24	5	0.20833333333333334	0.027932960893854747	GO:0051924	GO:BP	regulation of calcium ion transport	16175	13997		0.8	0.8125	179	15996	5	19	174	15977	16175	0.0726895781080942
R1	cpdb	0	network_modules	167	TRUE	0.00953066367494341	182	24	5	0.20833333333333334	0.027472527472527472	GO:0051651	GO:BP	maintenance of location in cell	16175	13864		0.8666666666666667	0.9375	182	15993	5	19	177	15974	16175	0.07202697584073496
R1	cpdb	0	network_modules	167	TRUE	0.00953066367494341	182	24	5	0.20833333333333334	0.027472527472527472	GO:0032412	GO:BP	regulation of monoatomic ion transmembrane transporter activity	16175	7550		0.8666666666666667	0.9375	182	15993	5	19	177	15974	16175	0.07202697584073496
R1	cpdb	0	network_modules	167	TRUE	0.009881539404908083	3	24	2	0.08333333333333333	0.6666666666666666	GO:1901896	GO:BP	positive regulation of ATPase-coupled calcium transmembrane transporter activity	16175	21840		1	1	3	16172	2	22	1	16150	16175	0.23537416597204877
R1	cpdb	0	network_modules	168	TRUE	4.748541893253227e-12	35	8	6	0.75	0.17142857142857143	REAC:R-HSA-2172127	REAC	DAP12 interactions	10916	432		0	0.25	35	10881	6	2	29	10879	10916	0.3577405517988366
R1	cpdb	0	network_modules	168	TRUE	2.948363336562844e-10	21	9	5	0.5555555555555556	0.23809523809523808	GO:1990858	GO:BP	cellular response to lectin	16175	25318		0	0.05357142857142857	21	16154	5	4	16	16150	16175	0.36318337263178885
R1	cpdb	0	network_modules	168	TRUE	2.948363336562844e-10	21	9	5	0.5555555555555556	0.23809523809523808	GO:1990840	GO:BP	response to lectin	16175	25313		0	0.05357142857142857	21	16154	5	4	16	16150	16175	0.36318337263178885
R1	cpdb	0	network_modules	168	TRUE	2.948363336562844e-10	21	9	5	0.5555555555555556	0.23809523809523808	GO:0002223	GO:BP	stimulatory C-type lectin receptor signaling pathway	16175	757		0	0.05357142857142857	21	16154	5	4	16	16150	16175	0.36318337263178885
R1	cpdb	0	network_modules	168	TRUE	7.691646326570643e-10	25	9	5	0.5555555555555556	0.2	GO:0032814	GO:BP	regulation of natural killer cell activation	16175	7838		0.05454545454545454	0.07142857142857142	25	16150	5	4	20	16146	16175	0.33275574487377974
R1	cpdb	0	network_modules	168	TRUE	8.53330915460158e-10	124	10	7	0.7	0.056451612903225805	KEGG:04650	KEGG	Natural killer cell mediated cytotoxicity	8484	334		0	0.5	124	8360	7	3	117	8357	8484	0.1961898660343426
R1	cpdb	0	network_modules	168	TRUE	1.5530520848923859e-9	85	9	6	0.6666666666666666	0.07058823529411765	GO:0002220	GO:BP	innate immune response activating cell surface receptor signaling pathway	16175	754		0.07272727272727272	0.08928571428571429	85	16090	6	3	79	16087	16175	0.21584828774240267
R1	cpdb	0	network_modules	168	TRUE	1.846444927772193e-9	421	9	8	0.8888888888888888	0.019002375296912115	GO:0002694	GO:BP	regulation of leukocyte activation	16175	1212		0.09090909090909091	0.10714285714285714	421	15754	8	1	413	15753	16175	0.12786999925457276
R1	cpdb	0	network_modules	168	TRUE	4.323450049373927e-9	468	9	8	0.8888888888888888	0.017094017094017096	GO:0050865	GO:BP	regulation of cell activation	16175	13313		0.10909090909090909	0.125	468	15707	8	1	460	15706	16175	0.1210516213923154
R1	cpdb	0	network_modules	168	TRUE	7.57544043636059e-9	110	9	6	0.6666666666666666	0.05454545454545454	GO:0002705	GO:BP	positive regulation of leukocyte mediated immunity	16175	1223		0.12727272727272726	0.14285714285714285	110	16065	6	3	104	16062	16175	0.18944508085255596
R1	cpdb	0	network_modules	168	TRUE	6.021760701579988e-8	57	9	5	0.5555555555555556	0.08771929824561403	GO:0001912	GO:BP	positive regulation of leukocyte mediated cytotoxicity	16175	529		0.14545454545454545	0.16071428571428573	57	16118	5	4	52	16114	16175	0.2198037973989876
R1	cpdb	0	network_modules	168	TRUE	1.009613220020685e-7	63	9	5	0.5555555555555556	0.07936507936507936	GO:0031343	GO:BP	positive regulation of cell killing	16175	7134		0.16363636363636364	0.17857142857142858	63	16112	5	4	58	16108	16175	0.20897352428236624
R1	cpdb	0	network_modules	168	TRUE	1.0780750582334048e-7	699	9	8	0.8888888888888888	0.011444921316165951	GO:0045321	GO:BP	leukocyte activation	16175	11356		0.18181818181818182	0.19642857142857142	699	15476	8	1	691	15475	16175	0.09812943837548338
R1	cpdb	0	network_modules	168	TRUE	1.1193540020732599e-7	369	9	7	0.7777777777777778	0.018970189701897018	GO:0051249	GO:BP	regulation of lymphocyte activation	16175	13596		0.2	0.21428571428571427	369	15806	7	2	362	15804	16175	0.11930723619562267
R1	cpdb	0	network_modules	168	TRUE	1.3717451948514332e-7	177	9	6	0.6666666666666666	0.03389830508474576	GO:0002703	GO:BP	regulation of leukocyte mediated immunity	16175	1221		0.21818181818181817	0.23214285714285715	177	15998	6	3	171	15995	16175	0.1487187614728926
R1	cpdb	0	network_modules	168	TRUE	1.535253114780075e-7	386	9	7	0.7777777777777778	0.018134715025906734	GO:0045088	GO:BP	regulation of innate immune response	16175	11271		0.23636363636363636	0.25	386	15789	7	2	379	15787	16175	0.11655072499631146
R1	cpdb	0	network_modules	168	TRUE	2.2445514919814064e-7	192	9	6	0.6666666666666666	0.03125	GO:0002699	GO:BP	positive regulation of immune effector process	16175	1217		0.2545454545454545	0.26785714285714285	192	15983	6	3	186	15980	16175	0.142656261938567
R1	cpdb	0	network_modules	168	TRUE	2.472969302852295e-7	75	9	5	0.5555555555555556	0.06666666666666667	GO:0030101	GO:BP	natural killer cell activation	16175	6679		0.2727272727272727	0.2857142857142857	75	16100	5	4	70	16096	16175	0.19134109571495458
R1	cpdb	0	network_modules	168	TRUE	3.0229741328180944e-7	78	9	5	0.5555555555555556	0.0641025641025641	GO:0001910	GO:BP	regulation of leukocyte mediated cytotoxicity	16175	527		0.2909090909090909	0.30357142857142855	78	16097	5	4	73	16093	16175	0.18757969245473394
R1	cpdb	0	network_modules	168	TRUE	3.665909604025392e-7	25	8	4	0.5	0.16	REAC:R-HSA-2424491	REAC	DAP12 signaling	10916	433		0.3333333333333333	0.5	25	10891	4	4	21	10887	10916	0.2819734711054994
R1	cpdb	0	network_modules	168	TRUE	4.143662323911868e-7	23	9	4	0.4444444444444444	0.17391304347826086	GO:0045954	GO:BP	positive regulation of natural killer cell mediated cytotoxicity	16175	11746		0.3090909090909091	0.32142857142857145	23	16152	4	5	19	16147	16175	0.2774041580041943
R1	cpdb	0	network_modules	168	TRUE	4.566903264808297e-7	451	9	7	0.7777777777777778	0.015521064301552107	GO:0002831	GO:BP	regulation of response to biotic stimulus	16175	1341		0.32727272727272727	0.3392857142857143	451	15724	7	2	444	15722	16175	0.10747193467003369
R1	cpdb	0	network_modules	168	TRUE	6.641253312967013e-7	91	9	5	0.5555555555555556	0.054945054945054944	GO:0031341	GO:BP	regulation of cell killing	16175	7132		0.34545454545454546	0.35714285714285715	91	16084	5	4	86	16080	16175	0.173481678896084
R1	cpdb	0	network_modules	168	TRUE	7.021480921713626e-7	92	9	5	0.5555555555555556	0.05434782608695652	GO:0002708	GO:BP	positive regulation of lymphocyte mediated immunity	16175	1226		0.36363636363636365	0.375	92	16083	5	4	87	16079	16175	0.1725222341071648
R1	cpdb	0	network_modules	168	TRUE	8.204323817206578e-7	27	9	4	0.4444444444444444	0.14814814814814814	GO:0002717	GO:BP	positive regulation of natural killer cell mediated immunity	16175	1235		0.38181818181818183	0.39285714285714285	27	16148	4	5	23	16143	16175	0.25592121801151496
R1	cpdb	0	network_modules	168	TRUE	9.303449546980572e-7	243	9	6	0.6666666666666666	0.024691358024691357	GO:0002758	GO:BP	innate immune response-activating signaling pathway	16175	1269		0.4	0.4107142857142857	243	15932	6	3	237	15929	16175	0.12639678494543918
R1	cpdb	0	network_modules	168	TRUE	1.4427502693541664e-6	106	9	5	0.5555555555555556	0.04716981132075472	GO:0001909	GO:BP	leukocyte mediated cytotoxicity	16175	526		0.41818181818181815	0.42857142857142855	106	16069	5	4	101	16065	16175	0.16054286512570717
R1	cpdb	0	network_modules	168	TRUE	1.4976509812933915e-6	263	9	6	0.6666666666666666	0.022813688212927757	GO:0002218	GO:BP	activation of innate immune response	16175	753		0.43636363636363634	0.44642857142857145	263	15912	6	3	257	15909	16175	0.12134145792113904
R1	cpdb	0	network_modules	168	TRUE	1.5674762512777726e-6	265	9	6	0.6666666666666666	0.022641509433962263	GO:0002429	GO:BP	immune response-activating cell surface receptor signaling pathway	16175	952		0.45454545454545453	0.4642857142857143	265	15910	6	3	259	15907	16175	0.12086731385403197
R1	cpdb	0	network_modules	168	TRUE	2.0017199882090125e-6	276	9	6	0.6666666666666666	0.021739130434782608	GO:0002697	GO:BP	regulation of immune effector process	16175	1215		0.4727272727272727	0.48214285714285715	276	15899	6	3	270	15896	16175	0.11835129974788036
R1	cpdb	0	network_modules	168	TRUE	2.315807088882491e-6	569	9	7	0.7777777777777778	0.012302284710017574	GO:0046649	GO:BP	lymphocyte activation	16175	12286		0.4909090909090909	0.5	569	15606	7	2	562	15604	16175	0.09510805216612266
R1	cpdb	0	network_modules	168	TRUE	2.5315485145280334e-6	287	9	6	0.6666666666666666	0.020905923344947737	GO:0002768	GO:BP	immune response-regulating cell surface receptor signaling pathway	16175	1279		0.509090909090909	0.5178571428571429	287	15888	6	3	281	15885	16175	0.11597970980012957
R1	cpdb	0	network_modules	168	TRUE	3.4413362121310695e-6	38	9	4	0.4444444444444444	0.10526315789473684	GO:0042269	GO:BP	regulation of natural killer cell mediated cytotoxicity	16175	10067		0.5272727272727272	0.5357142857142857	38	16137	4	5	34	16132	16175	0.21546503272793058
R1	cpdb	0	network_modules	168	TRUE	4.258591414306102e-6	40	9	4	0.4444444444444444	0.1	GO:0002715	GO:BP	regulation of natural killer cell mediated immunity	16175	1233		0.5454545454545454	0.5535714285714286	40	16135	4	5	36	16130	16175	0.2099636114010182
R1	cpdb	0	network_modules	168	TRUE	4.774191181556892e-6	319	9	6	0.6666666666666666	0.018808777429467086	GO:0045089	GO:BP	positive regulation of innate immune response	16175	11272		0.5636363636363636	0.5714285714285714	319	15856	6	3	313	15853	16175	0.10978408149248159
R1	cpdb	0	network_modules	168	TRUE	5.092459009614199e-6	136	9	5	0.5555555555555556	0.03676470588235294	GO:0002706	GO:BP	regulation of lymphocyte mediated immunity	16175	1224		0.5818181818181818	0.5892857142857143	136	16039	5	4	131	16035	16175	0.14138736242438937
R1	cpdb	0	network_modules	168	TRUE	6.108440058276939e-6	654	9	7	0.7777777777777778	0.010703363914373088	GO:0031347	GO:BP	regulation of defense response	16175	7138		0.6	0.6071428571428571	654	15521	7	2	647	15519	16175	0.0883255355482149
R1	cpdb	0	network_modules	168	TRUE	6.287946884496518e-6	334	9	6	0.6666666666666666	0.017964071856287425	GO:0002443	GO:BP	leukocyte mediated immunity	16175	966		0.6181818181818182	0.625	334	15841	6	3	328	15838	16175	0.10718747007485799
R1	cpdb	0	network_modules	168	TRUE	6.873340343234422e-6	339	9	6	0.6666666666666666	0.017699115044247787	GO:0002833	GO:BP	positive regulation of response to biotic stimulus	16175	1343		0.6363636363636364	0.6428571428571429	339	15836	6	3	333	15833	16175	0.10635994297901098
R1	cpdb	0	network_modules	168	TRUE	1.0704960052382808e-5	50	9	4	0.4444444444444444	0.08	GO:0006968	GO:BP	cellular defense response	16175	2596		0.6545454545454545	0.6607142857142857	50	16125	4	5	46	16120	16175	0.18759261017003515
R1	cpdb	0	network_modules	168	TRUE	1.2035637635850247e-5	721	9	7	0.7777777777777778	0.009708737864077669	GO:0045087	GO:BP	innate immune response	16175	11270		0.6727272727272727	0.6785714285714286	721	15454	7	2	714	15452	16175	0.08383015999619814
R1	cpdb	0	network_modules	168	TRUE	1.4760500252326572e-5	168	9	5	0.5555555555555556	0.02976190476190476	GO:0001906	GO:BP	cell killing	16175	524		0.6909090909090909	0.6964285714285714	168	16007	5	4	163	16003	16175	0.12687788219625093
R1	cpdb	0	network_modules	168	TRUE	1.5714946878584864e-5	181	8	5	0.625	0.027624309392265192	REAC:R-HSA-198933	REAC	Immunoregulatory interactions between a Lymphoid and a non-Lymphoid cell	10916	1171		0.6666666666666666	0.75	181	10735	5	3	176	10732	10916	0.1290322570329856
R1	cpdb	0	network_modules	168	TRUE	1.6728305084202706e-5	756	9	7	0.7777777777777778	0.009259259259259259	GO:0050776	GO:BP	regulation of immune response	16175	13250		0.7090909090909091	0.7142857142857143	756	15419	7	2	749	15417	16175	0.08171763545607363
R1	cpdb	0	network_modules	168	TRUE	2.1108327032633025e-5	59	9	4	0.4444444444444444	0.06779661016949153	GO:0042267	GO:BP	natural killer cell mediated cytotoxicity	16175	10065		0.7272727272727273	0.7321428571428571	59	16116	4	5	55	16111	16175	0.17252343409586143
R1	cpdb	0	network_modules	168	TRUE	2.261045774808464e-5	60	9	4	0.4444444444444444	0.06666666666666667	GO:0002228	GO:BP	natural killer cell mediated immunity	16175	761		0.7454545454545455	0.75	60	16115	4	5	56	16110	16175	0.17106101050898542
R1	cpdb	0	network_modules	168	TRUE	2.3078157202462048e-5	14	8	3	0.375	0.21428571428571427	REAC:R-HSA-391160	REAC	Signal regulatory protein family interactions	10916	2215		1	1	14	10902	3	5	11	10897	10916	0.2827888355778489
R1	cpdb	0	network_modules	168	TRUE	2.3372282835200958e-5	416	9	6	0.6666666666666666	0.014423076923076924	GO:0002757	GO:BP	immune response-activating signaling pathway	16175	1268		0.7636363636363637	0.7678571428571429	416	15759	6	3	410	15756	16175	0.09553797607466182
R1	cpdb	0	network_modules	168	TRUE	2.581968385379934e-5	423	9	6	0.6666666666666666	0.014184397163120567	GO:0031349	GO:BP	positive regulation of defense response	16175	7140		0.7818181818181819	0.7857142857142857	423	15752	6	3	417	15749	16175	0.09470123896410823
R1	cpdb	0	network_modules	168	TRUE	3.1354992495944396e-5	437	9	6	0.6666666666666666	0.013729977116704805	GO:0002764	GO:BP	immune response-regulating signaling pathway	16175	1275		0.8	0.8035714285714286	437	15738	6	3	431	15735	16175	0.09308740951774344
R1	cpdb	0	network_modules	168	TRUE	4.9761267582379635e-5	69	10	4	0.4	0.057971014492753624	KEGG:04612	KEGG	Antigen processing and presentation	8484	322		1	1	69	8415	4	6	65	8409	8484	0.14987995885055613
R1	cpdb	0	network_modules	168	TRUE	5.153424851572255e-5	475	9	6	0.6666666666666666	0.01263157894736842	GO:0002253	GO:BP	activation of immune response	16175	785		0.8181818181818182	0.8214285714285714	475	15700	6	3	469	15697	16175	0.08906596753313166
R1	cpdb	0	network_modules	168	TRUE	9.999778235569132e-5	531	9	6	0.6666666666666666	0.011299435028248588	GO:0032103	GO:BP	positive regulation of response to external stimulus	16175	7367		0.8363636363636363	0.8392857142857143	531	15644	6	3	525	15641	16175	0.08393083064138865
R1	cpdb	0	network_modules	168	TRUE	1.0572370185603923e-4	536	9	6	0.6666666666666666	0.011194029850746268	GO:0002252	GO:BP	immune effector process	16175	784		0.8545454545454545	0.8571428571428571	536	15639	6	3	530	15636	16175	0.08351105041221113
R1	cpdb	0	network_modules	168	TRUE	1.5560751796912561e-4	269	9	5	0.5555555555555556	0.01858736059479554	GO:0002449	GO:BP	lymphocyte mediated immunity	16175	972		0.8727272727272727	0.875	269	15906	5	4	264	15902	16175	0.09943423117134591
R1	cpdb	0	network_modules	168	TRUE	2.679720843415493e-4	627	9	6	0.6666666666666666	0.009569377990430622	GO:0050778	GO:BP	positive regulation of immune response	16175	13252		0.8909090909090909	0.8928571428571429	627	15548	6	3	621	15545	16175	0.07675132420528528
R1	cpdb	0	network_modules	168	TRUE	0.001755672469704395	4	9	2	0.2222222222222222	0.5	GO:0034239	GO:BP	regulation of macrophage fusion	16175	8515		0.9090909090909091	0.9464285714285714	4	16171	2	7	2	16164	16175	0.33309625079917915
R1	cpdb	0	network_modules	168	TRUE	0.001755672469704395	4	9	2	0.2222222222222222	0.5	GO:0002282	GO:BP	microglial cell activation involved in immune response	16175	814		0.9090909090909091	0.9464285714285714	4	16171	2	7	2	16164	16175	0.33309625079917915
R1	cpdb	0	network_modules	168	TRUE	0.001755672469704395	4	9	2	0.2222222222222222	0.5	GO:0034241	GO:BP	positive regulation of macrophage fusion	16175	8517		0.9090909090909091	0.9464285714285714	4	16171	2	7	2	16164	16175	0.33309625079917915
R1	cpdb	0	network_modules	168	TRUE	0.0027275156303072884	197	9	4	0.4444444444444444	0.02030456852791878	GO:0031348	GO:BP	negative regulation of defense response	16175	7139		0.9636363636363636	0.9642857142857143	197	15978	4	5	193	15973	16175	0.0929865562865343
R1	cpdb	0	network_modules	168	TRUE	0.002925276442811189	5	9	2	0.2222222222222222	0.4	GO:0034238	GO:BP	macrophage fusion	16175	8514		0.9818181818181818	0.9821428571428571	5	16170	2	7	3	16163	16175	0.2978565749868409
R1	cpdb	0	network_modules	168	TRUE	0.006139535781902519	7	9	2	0.2222222222222222	0.2857142857142857	GO:0001915	GO:BP	negative regulation of T cell mediated cytotoxicity	16175	532		1	1	7	16168	2	7	5	16161	16175	0.25161004852258095
R1	cpdb	0	network_modules	169	TRUE	0.002768277736780933	102	7	3	0.42857142857142855	0.029411764705882353	KEGG:04914	KEGG	Progesterone-mediated oocyte maturation	8484	371		NA	1	102	8382	3	4	99	8378	8484	0.10982989274011107
R1	cpdb	0	network_modules	170	TRUE	1.127469114925534e-8	18	18	5	0.2777777777777778	0.2777777777777778	GO:0048490	GO:BP	anterograde synaptic vesicle transport	16175	12783		0	0.08108108108108109	18	16157	5	13	13	16144	16175	0.27697317296252744
R1	cpdb	0	network_modules	170	TRUE	1.127469114925534e-8	18	18	5	0.2777777777777778	0.2777777777777778	GO:0099517	GO:BP	synaptic vesicle transport along microtubule	16175	19106		0	0.08108108108108109	18	16157	5	13	13	16144	16175	0.27697317296252744
R1	cpdb	0	network_modules	170	TRUE	1.127469114925534e-8	18	18	5	0.2777777777777778	0.2777777777777778	GO:0099514	GO:BP	synaptic vesicle cytoskeletal transport	16175	19104		0	0.08108108108108109	18	16157	5	13	13	16144	16175	0.27697317296252744
R1	cpdb	0	network_modules	170	TRUE	3.0918610344143157e-7	33	18	5	0.2777777777777778	0.15151515151515152	GO:0048489	GO:BP	synaptic vesicle transport	16175	12782		0.08333333333333333	0.10810810810810811	33	16142	5	13	28	16129	16175	0.20396728594205024
R1	cpdb	0	network_modules	170	TRUE	7.47046120620412e-7	39	18	5	0.2777777777777778	0.1282051282051282	GO:0032438	GO:BP	melanosome organization	16175	7566		0.1111111111111111	0.16216216216216217	39	16136	5	13	34	16123	16175	0.18740504310076866
R1	cpdb	0	network_modules	170	TRUE	7.47046120620412e-7	39	18	5	0.2777777777777778	0.1282051282051282	GO:0048753	GO:BP	pigment granule organization	16175	13004		0.1111111111111111	0.16216216216216217	39	16136	5	13	34	16123	16175	0.18740504310076866
R1	cpdb	0	network_modules	170	TRUE	8.531943434278525e-7	40	18	5	0.2777777777777778	0.125	GO:0097479	GO:BP	synaptic vesicle localization	16175	18670		0.16666666666666666	0.1891891891891892	40	16135	5	13	35	16122	16175	0.1850118402199794
R1	cpdb	0	network_modules	170	TRUE	1.101524272916378e-6	42	18	5	0.2777777777777778	0.11904761904761904	GO:0047496	GO:BP	vesicle transport along microtubule	16175	12458		0.19444444444444445	0.24324324324324326	42	16133	5	13	37	16120	16175	0.18048316276554335
R1	cpdb	0	network_modules	170	TRUE	1.101524272916378e-6	42	18	5	0.2777777777777778	0.11904761904761904	GO:0008089	GO:BP	anterograde axonal transport	16175	3120		0.19444444444444445	0.24324324324324326	42	16133	5	13	37	16120	16175	0.18048316276554335
R1	cpdb	0	network_modules	170	TRUE	4.0622640397035995e-6	54	18	5	0.2777777777777778	0.09259259259259259	GO:0098930	GO:BP	axonal transport	16175	18959		0.25	0.2702702702702703	54	16121	5	13	49	16108	16175	0.15880113476434085
R1	cpdb	0	network_modules	170	TRUE	5.869972875090378e-6	58	18	5	0.2777777777777778	0.08620689655172414	GO:0033059	GO:BP	cellular pigmentation	16175	8013		0.2777777777777778	0.2972972972972973	58	16117	5	13	53	16104	16175	0.15310834239793406
R1	cpdb	0	network_modules	170	TRUE	7.605888289415003e-6	61	18	5	0.2777777777777778	0.08196721311475409	GO:0008088	GO:BP	axo-dendritic transport	16175	3119		0.3055555555555556	0.32432432432432434	61	16114	5	13	56	16101	16175	0.14920881749023107
R1	cpdb	0	network_modules	170	TRUE	1.2297499232698907e-5	67	18	5	0.2777777777777778	0.07462686567164178	GO:0099518	GO:BP	vesicle cytoskeletal trafficking	16175	19107		0.3333333333333333	0.35135135135135137	67	16108	5	13	62	16095	16175	0.14220489274036088
R1	cpdb	0	network_modules	170	TRUE	1.9049117386460947e-5	73	18	5	0.2777777777777778	0.0684931506849315	GO:0072384	GO:BP	organelle transport along microtubule	16175	17378		0.3611111111111111	0.3783783783783784	73	16102	5	13	68	16089	16175	0.13607623258522694
R1	cpdb	0	network_modules	170	TRUE	3.231970186393777e-5	81	18	5	0.2777777777777778	0.06172839506172839	GO:0043473	GO:BP	pigmentation	16175	10719		0.3888888888888889	0.40540540540540543	81	16094	5	13	76	16081	16175	0.1289799946132089
R1	cpdb	0	network_modules	170	TRUE	9.875914151246782e-5	10	16	3	0.1875	0.3	REAC:R-HSA-9758881	REAC	Uptake of dietary cobalamins into enterocytes	10916	2629		0	0.3333333333333333	10	10906	3	13	7	10893	10916	0.2362934703535439
R1	cpdb	0	network_modules	170	TRUE	1.3827924593684627e-4	9	18	3	0.16666666666666666	0.3333333333333333	GO:0035646	GO:BP	endosome to melanosome transport	16175	9136		0.4166666666666667	0.4864864864864865	9	16166	3	15	6	16151	16175	0.23511161013092363
R1	cpdb	0	network_modules	170	TRUE	1.3827924593684627e-4	9	18	3	0.16666666666666666	0.3333333333333333	GO:0043485	GO:BP	endosome to pigment granule transport	16175	10731		0.4166666666666667	0.4864864864864865	9	16166	3	15	6	16151	16175	0.23511161013092363
R1	cpdb	0	network_modules	170	TRUE	1.3827924593684627e-4	9	18	3	0.16666666666666666	0.3333333333333333	GO:0048757	GO:BP	pigment granule maturation	16175	13008		0.4166666666666667	0.4864864864864865	9	16166	3	15	6	16151	16175	0.23511161013092363
R1	cpdb	0	network_modules	170	TRUE	2.712421683296736e-4	11	18	3	0.16666666666666666	0.2727272727272727	GO:0043476	GO:BP	pigment accumulation	16175	10722		0.5	0.5405405405405406	11	16164	3	15	8	16149	16175	0.21252129700939598
R1	cpdb	0	network_modules	170	TRUE	2.712421683296736e-4	11	18	3	0.16666666666666666	0.2727272727272727	GO:0043482	GO:BP	cellular pigment accumulation	16175	10728		0.5	0.5405405405405406	11	16164	3	15	8	16149	16175	0.21252129700939598
R1	cpdb	0	network_modules	170	TRUE	5.815820479818386e-4	144	18	5	0.2777777777777778	0.034722222222222224	GO:0010970	GO:BP	transport along microtubule	16175	4546		0.5555555555555556	0.5675675675675675	144	16031	5	13	139	16018	16175	0.09554089216068937
R1	cpdb	0	network_modules	170	TRUE	0.0011325014951164467	315	18	6	0.3333333333333333	0.01904761904761905	GO:0016050	GO:BP	vesicle organization	16175	5082		0.5833333333333334	0.5945945945945946	315	15860	6	12	309	15848	16175	0.07581020487206017
R1	cpdb	0	network_modules	170	TRUE	0.0011428528642915378	165	18	5	0.2777777777777778	0.030303030303030304	GO:0099111	GO:BP	microtubule-based transport	16175	19044		0.6111111111111112	0.6216216216216216	165	16010	5	13	160	15997	16175	0.08888143931393591
R1	cpdb	0	network_modules	170	TRUE	0.0012538851854252244	22	16	3	0.1875	0.13636363636363635	REAC:R-HSA-196741	REAC	Cobalamin (Cbl, vitamin B12) transport and metabolism	10916	381		0.5	0.6666666666666666	22	10894	3	13	19	10881	10916	0.15845761835371047
R1	cpdb	0	network_modules	170	TRUE	0.0013348971559334717	18	18	3	0.16666666666666666	0.16666666666666666	GO:0051904	GO:BP	pigment granule transport	16175	13987		0.6388888888888888	0.6756756756756757	18	16157	3	15	15	16142	16175	0.16573827649522394
R1	cpdb	0	network_modules	170	TRUE	0.0013348971559334717	18	18	3	0.16666666666666666	0.16666666666666666	GO:0032402	GO:BP	melanosome transport	16175	7546		0.6388888888888888	0.6756756756756757	18	16157	3	15	15	16142	16175	0.16573827649522394
R1	cpdb	0	network_modules	170	TRUE	0.0015840875911712722	19	18	3	0.16666666666666666	0.15789473684210525	GO:0051905	GO:BP	establishment of pigment granule localization	16175	13988		0.6944444444444444	0.7297297297297297	19	16156	3	15	16	16141	16175	0.16126254114621588
R1	cpdb	0	network_modules	170	TRUE	0.0015840875911712722	19	18	3	0.16666666666666666	0.15789473684210525	GO:0032401	GO:BP	establishment of melanosome localization	16175	7545		0.6944444444444444	0.7297297297297297	19	16156	3	15	16	16141	16175	0.16126254114621588
R1	cpdb	0	network_modules	170	TRUE	0.0016627323350748204	178	18	5	0.2777777777777778	0.028089887640449437	GO:0051650	GO:BP	establishment of vesicle localization	16175	13863		0.75	0.7567567567567568	178	15997	5	13	173	15984	16175	0.08535186359518201
R1	cpdb	0	network_modules	170	TRUE	0.002011269305304724	185	18	5	0.2777777777777778	0.02702702702702703	GO:0030705	GO:BP	cytoskeleton-dependent intracellular transport	16175	6886		0.7777777777777778	0.7837837837837838	185	15990	5	13	180	15977	16175	0.08360400627866467
R1	cpdb	0	network_modules	170	TRUE	0.002065436141932998	186	18	5	0.2777777777777778	0.026881720430107527	GO:0051648	GO:BP	vesicle localization	16175	13861		0.8055555555555556	0.8108108108108109	186	15989	5	13	181	15976	16175	0.08336221397987043
R1	cpdb	0	network_modules	170	TRUE	0.0021712137722592595	21	18	3	0.16666666666666666	0.14285714285714285	GO:0051875	GO:BP	pigment granule localization	16175	13962		0.8333333333333334	0.8648648648648649	21	16154	3	15	18	16139	16175	0.1532861548213182
R1	cpdb	0	network_modules	170	TRUE	0.0021712137722592595	21	18	3	0.16666666666666666	0.14285714285714285	GO:0032400	GO:BP	melanosome localization	16175	7544		0.8333333333333334	0.8648648648648649	21	16154	3	15	18	16139	16175	0.1532861548213182
R1	cpdb	0	network_modules	170	TRUE	0.0025122880252617915	22	18	3	0.16666666666666666	0.13636363636363635	GO:0050931	GO:BP	pigment cell differentiation	16175	13373		0.8888888888888888	0.8918918918918919	22	16153	3	15	19	16138	16175	0.14971050876290892
R1	cpdb	0	network_modules	170	TRUE	0.003297271735169593	24	18	3	0.16666666666666666	0.125	GO:0060155	GO:BP	platelet dense granule organization	16175	14393		0.9166666666666666	0.918918918918919	24	16151	3	15	21	16136	16175	0.1432385527576149
R1	cpdb	0	network_modules	170	TRUE	0.004398858590472755	33	16	3	0.1875	0.09090909090909091	REAC:R-HSA-1592389	REAC	Activation of Matrix Metalloproteinases	10916	86		1	1	33	10883	3	13	30	10870	10916	0.12874222519729
R1	cpdb	0	network_modules	170	TRUE	0.005009523127675268	3	18	2	0.1111111111111111	0.6666666666666666	GO:0050942	GO:BP	positive regulation of pigment cell differentiation	16175	13384		0.9444444444444444	0.972972972972973	3	16172	2	16	1	16156	16175	0.27188774182133574
R1	cpdb	0	network_modules	170	TRUE	0.005009523127675268	3	18	2	0.1111111111111111	0.6666666666666666	GO:0050932	GO:BP	regulation of pigment cell differentiation	16175	13374		0.9444444444444444	0.972972972972973	3	16172	2	16	1	16156	16175	0.27188774182133574
R1	cpdb	0	network_modules	170	TRUE	0.008832800280071943	33	18	3	0.16666666666666666	0.09090909090909091	GO:0048066	GO:BP	developmental pigmentation	16175	12496		1	1	33	16142	3	15	30	16127	16175	0.12177670909042501
R1	cpdb	0	network_modules	171	TRUE	9.765829906948215e-13	55	16	8	0.5	0.14545454545454545	REAC:R-HSA-168643	REAC	Nucleotide-binding domain, leucine rich repeat containing receptor (NLR) signaling pathways	10916	1628		0	0.030303030303030304	55	10861	8	8	47	10853	10916	0.2678338463877958
R1	cpdb	0	network_modules	171	TRUE	1.0137589906725527e-9	182	17	9	0.5294117647058824	0.04945054945054945	KEGG:04621	KEGG	NOD-like receptor signaling pathway	8484	326		0	0.14285714285714285	182	8302	9	8	173	8294	8484	0.15709503933380423
R1	cpdb	0	network_modules	171	TRUE	1.1916642866598009e-8	345	22	10	0.45454545454545453	0.028985507246376812	GO:0051090	GO:BP	regulation of DNA-binding transcription factor activity	16175	13485		0	0.018867924528301886	345	15830	10	12	335	15818	16175	0.11065824029990809
R1	cpdb	0	network_modules	171	TRUE	1.665555532755759e-7	451	22	10	0.45454545454545453	0.022172949002217297	GO:0002831	GO:BP	regulation of response to biotic stimulus	16175	1341		0.019230769230769232	0.03773584905660377	451	15724	10	12	441	15712	16175	0.09564100823224342
R1	cpdb	0	network_modules	171	TRUE	4.853258756513319e-7	227	22	8	0.36363636363636365	0.03524229074889868	GO:0002221	GO:BP	pattern recognition receptor signaling pathway	16175	755		0.038461538461538464	0.05660377358490566	227	15948	8	14	219	15934	16175	0.10968250169070393
R1	cpdb	0	network_modules	171	TRUE	8.334394661121707e-7	243	22	8	0.36363636363636365	0.03292181069958848	GO:0002758	GO:BP	innate immune response-activating signaling pathway	16175	1269		0.057692307692307696	0.07547169811320754	243	15932	8	14	235	15918	16175	0.10576319199963834
R1	cpdb	0	network_modules	171	TRUE	1.0027932986207898e-6	149	22	7	0.3181818181818182	0.04697986577181208	GO:0002753	GO:BP	cytoplasmic pattern recognition receptor signaling pathway	16175	1264		0.07692307692307693	0.09433962264150944	149	16026	7	15	142	16011	16175	0.1193547598803978
R1	cpdb	0	network_modules	171	TRUE	1.1686932346363133e-6	386	22	9	0.4090909090909091	0.023316062176165803	GO:0045088	GO:BP	regulation of innate immune response	16175	11271		0.09615384615384616	0.11320754716981132	386	15789	9	13	377	15776	16175	0.09314824966598659
R1	cpdb	0	network_modules	171	TRUE	1.2355058203362463e-6	81	22	6	0.2727272727272727	0.07407407407407407	GO:0032611	GO:BP	interleukin-1 beta production	16175	7659		0.11538461538461539	0.1509433962264151	81	16094	6	16	75	16078	16175	0.13996988413811695
R1	cpdb	0	network_modules	171	TRUE	1.2355058203362463e-6	81	22	6	0.2727272727272727	0.07407407407407407	GO:0032651	GO:BP	regulation of interleukin-1 beta production	16175	7698		0.11538461538461539	0.1509433962264151	81	16094	6	16	75	16078	16175	0.13996988413811695
R1	cpdb	0	network_modules	171	TRUE	1.5587919975440144e-6	263	22	8	0.36363636363636365	0.030418250950570342	GO:0002218	GO:BP	activation of innate immune response	16175	753		0.15384615384615385	0.16981132075471697	263	15912	8	14	255	15898	16175	0.10136533585015917
R1	cpdb	0	network_modules	171	TRUE	2.257364632483355e-6	416	22	9	0.4090909090909091	0.021634615384615384	GO:0002757	GO:BP	immune response-activating signaling pathway	16175	1268		0.17307692307692307	0.18867924528301888	416	15759	9	13	407	15746	16175	0.08937965327567295
R1	cpdb	0	network_modules	171	TRUE	2.5557126076541547e-6	280	22	8	0.36363636363636365	0.02857142857142857	GO:0007249	GO:BP	canonical NF-kappaB signal transduction	16175	2783		0.19230769230769232	0.20754716981132076	280	15895	8	14	272	15881	16175	0.0979951249279083
R1	cpdb	0	network_modules	171	TRUE	2.689316706484183e-6	92	22	6	0.2727272727272727	0.06521739130434782	GO:0032612	GO:BP	interleukin-1 production	16175	7660		0.21153846153846154	0.24528301886792453	92	16083	6	16	86	16067	16175	0.13104699507798276
R1	cpdb	0	network_modules	171	TRUE	2.689316706484183e-6	92	22	6	0.2727272727272727	0.06521739130434782	GO:0032652	GO:BP	regulation of interleukin-1 production	16175	7699		0.21153846153846154	0.24528301886792453	92	16083	6	16	86	16067	16175	0.13104699507798276
R1	cpdb	0	network_modules	171	TRUE	3.4768457693616613e-6	437	22	9	0.4090909090909091	0.020594965675057208	GO:0002764	GO:BP	immune response-regulating signaling pathway	16175	1275		0.25	0.2641509433962264	437	15738	9	13	428	15725	16175	0.08696828866784663
R1	cpdb	0	network_modules	171	TRUE	4.7129051581282515e-6	20	16	4	0.25	0.2	REAC:R-HSA-622312	REAC	Inflammasomes	10916	1184		0.03125	0.06060606060606061	20	10896	4	12	16	10884	10916	0.2223346761994506
R1	cpdb	0	network_modules	171	TRUE	6.1373532434054296e-6	654	22	10	0.45454545454545453	0.01529051987767584	GO:0031347	GO:BP	regulation of defense response	16175	7138		0.2692307692307692	0.2830188679245283	654	15521	10	12	644	15509	16175	0.07758876632781526
R1	cpdb	0	network_modules	171	TRUE	7.1245103256326246e-6	319	22	8	0.36363636363636365	0.025078369905956112	GO:0045089	GO:BP	positive regulation of innate immune response	16175	11272		0.28846153846153844	0.3018867924528302	319	15856	8	14	311	15842	16175	0.09128248390294713
R1	cpdb	0	network_modules	171	TRUE	7.207421586601776e-6	475	22	9	0.4090909090909091	0.018947368421052633	GO:0002253	GO:BP	activation of immune response	16175	785		0.3076923076923077	0.32075471698113206	475	15700	9	13	466	15687	16175	0.0830044046617254
R1	cpdb	0	network_modules	171	TRUE	1.028489632152576e-5	208	22	7	0.3181818181818182	0.03365384615384615	GO:0051091	GO:BP	positive regulation of DNA-binding transcription factor activity	16175	13486		0.3269230769230769	0.33962264150943394	208	15967	7	15	201	15952	16175	0.1000102392855886
R1	cpdb	0	network_modules	171	TRUE	1.146893214411083e-5	339	22	8	0.36363636363636365	0.02359882005899705	GO:0002833	GO:BP	positive regulation of response to biotic stimulus	16175	1343		0.34615384615384615	0.3584905660377358	339	15836	8	14	331	15822	16175	0.08828619120437656
R1	cpdb	0	network_modules	171	TRUE	1.4097071844445384e-5	56	22	5	0.22727272727272727	0.08928571428571429	GO:0032731	GO:BP	positive regulation of interleukin-1 beta production	16175	7776		0.36538461538461536	0.37735849056603776	56	16119	5	17	51	16102	16175	0.14061984426210128
R1	cpdb	0	network_modules	171	TRUE	1.5632091833840796e-5	721	22	10	0.45454545454545453	0.013869625520110958	GO:0045087	GO:BP	innate immune response	16175	11270		0.38461538461538464	0.39622641509433965	721	15454	10	12	711	15442	16175	0.07331511957986744
R1	cpdb	0	network_modules	171	TRUE	1.596727798732918e-5	249	17	7	0.4117647058823529	0.028112449799196786	KEGG:05132	KEGG	Salmonella infection	8484	429		0.16666666666666666	0.2857142857142857	249	8235	7	10	242	8225	8484	0.101522936974664
R1	cpdb	0	network_modules	171	TRUE	1.6388621504103847e-5	124	22	6	0.2727272727272727	0.04838709677419355	GO:0051092	GO:BP	positive regulation of NF-kappaB transcription factor activity	16175	13487		0.40384615384615385	0.41509433962264153	124	16051	6	16	118	16035	16175	0.11215358852294745
R1	cpdb	0	network_modules	171	TRUE	2.0439197269921564e-5	21	22	4	0.18181818181818182	0.19047619047619047	GO:1900016	GO:BP	negative regulation of cytokine production involved in inflammatory response	16175	20327		0.4230769230769231	0.4339622641509434	21	16154	4	18	17	16136	16175	0.18501391257687402
R1	cpdb	0	network_modules	171	TRUE	2.4574996906572848e-5	756	22	10	0.45454545454545453	0.013227513227513227	GO:0050776	GO:BP	regulation of immune response	16175	13250		0.4423076923076923	0.4528301886792453	756	15419	10	12	746	15407	16175	0.07130079060063643
R1	cpdb	0	network_modules	171	TRUE	2.5781131171536367e-5	63	22	5	0.22727272727272727	0.07936507936507936	GO:0032732	GO:BP	positive regulation of interleukin-1 production	16175	7777		0.46153846153846156	0.4716981132075472	63	16112	5	17	58	16095	16175	0.13235004556643354
R1	cpdb	0	network_modules	171	TRUE	2.5784217911322073e-5	82	17	5	0.29411764705882354	0.06097560975609756	KEGG:04623	KEGG	Cytosolic DNA-sensing pathway	8484	328		0.3333333333333333	0.42857142857142855	82	8402	5	12	77	8390	8484	0.13027817625824015
R1	cpdb	0	network_modules	171	TRUE	3.869908522641361e-5	252	22	7	0.3181818181818182	0.027777777777777776	GO:0043122	GO:BP	regulation of canonical NF-kappaB signal transduction	16175	10541		0.4807692307692308	0.49056603773584906	252	15923	7	15	245	15908	16175	0.0901754722011483
R1	cpdb	0	network_modules	171	TRUE	5.6497009994933e-5	36	16	4	0.25	0.1111111111111111	REAC:R-HSA-168638	REAC	NOD1/2 Signaling Pathway	10916	1529		0.0625	0.09090909090909091	36	10880	4	12	32	10868	10916	0.16486079800460265
R1	cpdb	0	network_modules	171	TRUE	6.416380535177918e-5	423	22	8	0.36363636363636365	0.018912529550827423	GO:0031349	GO:BP	positive regulation of defense response	16175	7140		0.5	0.5094339622641509	423	15752	8	14	415	15738	16175	0.0780450454772399
R1	cpdb	0	network_modules	171	TRUE	7.158434668418398e-5	77	22	5	0.22727272727272727	0.06493506493506493	GO:0032088	GO:BP	negative regulation of NF-kappaB transcription factor activity	16175	7355		0.5192307692307693	0.5283018867924528	77	16098	5	17	72	16081	16175	0.1193030979654546
R1	cpdb	0	network_modules	171	TRUE	7.686287782445112e-5	102	17	5	0.29411764705882354	0.049019607843137254	KEGG:04064	KEGG	NF-kappa B signaling pathway	8484	256		0.5	0.5714285714285714	102	8382	5	12	97	8370	8484	0.11597966234929175
R1	cpdb	0	network_modules	171	TRUE	7.978591725126531e-5	627	22	9	0.4090909090909091	0.014354066985645933	GO:0050778	GO:BP	positive regulation of immune response	16175	13252		0.5384615384615384	0.5471698113207547	627	15548	9	13	618	15535	16175	0.07080172281066009
R1	cpdb	0	network_modules	171	TRUE	8.776679010832547e-5	634	22	9	0.4090909090909091	0.014195583596214511	GO:0001817	GO:BP	regulation of cytokine production	16175	474		0.5576923076923077	0.5660377358490566	634	15541	9	13	625	15528	16175	0.07034333216396471
R1	cpdb	0	network_modules	171	TRUE	9.263431875194931e-5	638	22	9	0.4090909090909091	0.014106583072100314	GO:0001816	GO:BP	cytokine production	16175	473		0.5769230769230769	0.5849056603773585	638	15537	9	13	629	15524	16175	0.07008461254237641
R1	cpdb	0	network_modules	171	TRUE	1.2928677054081244e-4	44	16	4	0.25	0.09090909090909091	REAC:R-HSA-445989	REAC	TAK1-dependent IKK and NF-kappa-B activation  	10916	2417		0.09375	0.12121212121212122	44	10872	4	12	40	10860	10916	0.14873390219947624
R1	cpdb	0	network_modules	171	TRUE	1.337206303453613e-4	302	22	7	0.3181818181818182	0.023178807947019868	GO:0030522	GO:BP	intracellular receptor signaling pathway	16175	6836		0.5961538461538461	0.6037735849056604	302	15873	7	15	295	15858	16175	0.08165990571633734
R1	cpdb	0	network_modules	171	TRUE	1.8765276605415212e-4	120	16	5	0.3125	0.041666666666666664	REAC:R-HSA-9705671	REAC	SARS-CoV-2 activates/modulates innate and adaptive immune responses	10916	2123		0.125	0.15151515151515152	120	10796	5	11	115	10785	10916	0.11078617125365203
R1	cpdb	0	network_modules	171	TRUE	2.347455731998964e-4	13	16	3	0.1875	0.23076923076923078	REAC:R-HSA-933543	REAC	NF-kB activation through FADD/RIP-1 pathway mediated by caspase-8 and -10	10916	1515		0.15625	0.18181818181818182	13	10903	3	13	10	10890	10916	0.2069662954184636
R1	cpdb	0	network_modules	171	TRUE	2.653838574263171e-4	334	22	7	0.3181818181818182	0.020958083832335328	GO:0009615	GO:BP	response to virus	16175	3541		0.6153846153846154	0.6226415094339622	334	15841	7	15	327	15826	16175	0.07721455268051643
R1	cpdb	0	network_modules	171	TRUE	3.1899152381197255e-4	136	17	5	0.29411764705882354	0.03676470588235294	KEGG:05135	KEGG	Yersinia infection	8484	432		0.6666666666666666	0.7142857142857143	136	8348	5	12	131	8336	8484	0.09921585774446039
R1	cpdb	0	network_modules	171	TRUE	3.6840702917074016e-4	531	22	8	0.36363636363636365	0.015065913370998116	GO:0032103	GO:BP	positive regulation of response to external stimulus	16175	7367		0.6346153846153846	0.6415094339622641	531	15644	8	14	523	15630	16175	0.06851470210604814
R1	cpdb	0	network_modules	171	TRUE	3.7279175096128554e-4	15	16	3	0.1875	0.2	REAC:R-HSA-844456	REAC	The NLRP3 inflammasome	10916	2497		0.1875	0.21212121212121213	15	10901	3	13	12	10888	10916	0.19250331445187688
R1	cpdb	0	network_modules	171	TRUE	5.578743939100171e-4	63	16	4	0.25	0.06349206349206349	REAC:R-HSA-450294	REAC	MAP kinase activation	10916	1345		0.21875	0.24242424242424243	63	10853	4	12	59	10841	10916	0.12352694795291107
R1	cpdb	0	network_modules	171	TRUE	5.951762488648863e-4	47	22	4	0.18181818181818182	0.0851063829787234	GO:1900015	GO:BP	regulation of cytokine production involved in inflammatory response	16175	20326		0.6538461538461539	0.6792452830188679	47	16128	4	18	43	16110	16175	0.12266776192006816
R1	cpdb	0	network_modules	171	TRUE	5.951762488648863e-4	47	22	4	0.18181818181818182	0.0851063829787234	GO:0002534	GO:BP	cytokine production involved in inflammatory response	16175	1056		0.6538461538461539	0.6792452830188679	47	16128	4	18	43	16110	16175	0.12266776192006816
R1	cpdb	0	network_modules	171	TRUE	7.664228723126352e-4	50	22	4	0.18181818181818182	0.08	GO:0043124	GO:BP	negative regulation of canonical NF-kappaB signal transduction	16175	10543		0.6923076923076923	0.6981132075471698	50	16125	4	18	46	16107	16175	0.1188185682514684
R1	cpdb	0	network_modules	171	TRUE	8.643730391134429e-4	594	22	8	0.36363636363636365	0.013468013468013467	GO:0006954	GO:BP	inflammatory response	16175	2585		0.7115384615384616	0.71698113207547165	594	15581	8	14	586	15567	16175	0.06414611690166307
R1	cpdb	0	network_modules	171	TRUE	9.035912221971748e-4	71	16	4	0.25	0.056338028169014086	REAC:R-HSA-448424	REAC	Interleukin-17 signaling	10916	1238		0.25	0.2727272727272727	71	10845	4	12	67	10833	10916	0.11605337273995059
R1	cpdb	0	network_modules	171	TRUE	9.436467230174533e-4	403	22	7	0.3181818181818182	0.017369727047146403	GO:0001819	GO:BP	positive regulation of cytokine production	16175	476		0.7307692307692307	0.7358490566037735	403	15772	7	15	396	15757	16175	0.0694378179177869
R1	cpdb	0	network_modules	171	TRUE	0.0012700351506034955	625	22	8	0.36363636363636365	0.0128	GO:0034097	GO:BP	response to cytokine	16175	8408		0.75	0.7735849056603774	625	15550	8	14	617	15536	16175	0.06223038599849566
R1	cpdb	0	network_modules	171	TRUE	0.0012700351506034955	625	22	8	0.36363636363636365	0.0128	GO:1901652	GO:BP	response to peptide	16175	21619		0.75	0.7735849056603774	625	15550	8	14	617	15536	16175	0.06223038599849566
R1	cpdb	0	network_modules	171	TRUE	0.0015874072729906163	143	22	5	0.22727272727272727	0.03496503496503497	GO:0060759	GO:BP	regulation of response to cytokine stimulus	16175	14927		0.7884615384615384	0.8113207547169812	143	16032	5	17	138	16015	16175	0.08611588570438947
R1	cpdb	0	network_modules	171	TRUE	0.0015874072729906163	143	22	5	0.22727272727272727	0.03496503496503497	GO:0043433	GO:BP	negative regulation of DNA-binding transcription factor activity	16175	10690		0.7884615384615384	0.8113207547169812	143	16032	5	17	138	16015	16175	0.08611588570438947
R1	cpdb	0	network_modules	171	TRUE	0.0018367152956497196	62	22	4	0.18181818181818182	0.06451612903225806	GO:0002532	GO:BP	production of molecular mediator involved in inflammatory response	16175	1054		0.8269230769230769	0.8301886792452831	62	16113	4	18	58	16095	16175	0.10629886972237569
R1	cpdb	0	network_modules	171	TRUE	0.00186766946082892	25	16	3	0.1875	0.12	REAC:R-HSA-9660826	REAC	Purinergic signaling in leishmaniasis infection	10916	1826		0.28125	0.36363636363636365	25	10891	3	13	22	10878	10916	0.14844661905822454
R1	cpdb	0	network_modules	171	TRUE	0.00186766946082892	25	16	3	0.1875	0.12	REAC:R-HSA-933542	REAC	TRAF6 mediated NF-kB activation	10916	2467		0.28125	0.36363636363636365	25	10891	3	13	22	10878	10916	0.14844661905822454
R1	cpdb	0	network_modules	171	TRUE	0.00186766946082892	25	16	3	0.1875	0.12	REAC:R-HSA-9664424	REAC	Cell recruitment (pro-inflammatory response)	10916	325		0.28125	0.36363636363636365	25	10891	3	13	22	10878	10916	0.14844661905822454
R1	cpdb	0	network_modules	171	TRUE	0.0019351698119499442	3	16	2	0.125	0.6666666666666666	REAC:R-HSA-5602636	REAC	IKBKB deficiency causes SCID	10916	1143		0.375	0.42424242424242425	3	10913	2	14	1	10899	10916	0.2882913972771879
R1	cpdb	0	network_modules	171	TRUE	0.0019351698119499442	3	16	2	0.125	0.6666666666666666	REAC:R-HSA-5603027	REAC	IKBKG deficiency causes anhidrotic ectodermal dysplasia with immunodeficiency (EDA-ID) (via TLR)	10916	1144		0.375	0.42424242424242425	3	10913	2	14	1	10899	10916	0.2882913972771879
R1	cpdb	0	network_modules	171	TRUE	0.0019359430284191998	197	17	5	0.29411764705882354	0.025380710659898477	KEGG:05130	KEGG	Pathogenic Escherichia coli infection	8484	427		0.8333333333333334	0.8571428571428571	197	8287	5	12	192	8275	8484	0.08059971456641415
R1	cpdb	0	network_modules	171	TRUE	0.00216708754656769	197	16	5	0.3125	0.025380710659898477	REAC:R-HSA-9705683	REAC	SARS-CoV-2-host interactions	10916	2128		0.4375	0.45454545454545453	197	10719	5	11	192	10708	10916	0.08474540243572314
R1	cpdb	0	network_modules	171	TRUE	0.0028985289624203895	95	16	4	0.25	0.042105263157894736	REAC:R-HSA-168176	REAC	Toll Like Receptor 5 (TLR5) Cascade	10916	2517		0.46875	0.5454545454545454	95	10821	4	12	91	10809	10916	0.09953298111271836
R1	cpdb	0	network_modules	171	TRUE	0.0028985289624203895	95	16	4	0.25	0.042105263157894736	REAC:R-HSA-975871	REAC	MyD88 cascade initiated on plasma membrane	10916	1497		0.46875	0.5454545454545454	95	10821	4	12	91	10809	10916	0.09953298111271836
R1	cpdb	0	network_modules	171	TRUE	0.0028985289624203895	95	16	4	0.25	0.042105263157894736	REAC:R-HSA-168142	REAC	Toll Like Receptor 10 (TLR10) Cascade	10916	2513		0.46875	0.5454545454545454	95	10821	4	12	91	10809	10916	0.09953298111271836
R1	cpdb	0	network_modules	171	TRUE	0.003120096453756118	164	22	5	0.22727272727272727	0.03048780487804878	GO:0071356	GO:BP	cellular response to tumor necrosis factor	16175	16608		0.8461538461538461	0.8490566037735849	164	16011	5	17	159	15994	16175	0.07998802261936486
R1	cpdb	0	network_modules	171	TRUE	0.003149072062663227	97	16	4	0.25	0.041237113402061855	REAC:R-HSA-5607764	REAC	CLEC7A (Dectin-1) signaling	10916	275		0.5625	0.5757575757575758	97	10819	4	12	93	10807	10916	0.09843582823272855
R1	cpdb	0	network_modules	171	TRUE	0.0036977382508084776	101	16	4	0.25	0.039603960396039604	REAC:R-HSA-975138	REAC	TRAF6 mediated induction of NFkB and MAP kinases upon TLR7/8 or 9 activation	10916	2468		0.59375	0.6060606060606061	101	10815	4	12	97	10803	10916	0.09633811722473977
R1	cpdb	0	network_modules	171	TRUE	0.003845267541900198	102	16	4	0.25	0.0392156862745098	REAC:R-HSA-975155	REAC	MyD88 dependent cascade initiated on endosome	10916	1500		0.625	0.6363636363636364	102	10814	4	12	98	10802	10916	0.09583266082494514
R1	cpdb	0	network_modules	171	TRUE	0.0038632148352881605	21	22	3	0.13636363636363635	0.14285714285714285	GO:2001056	GO:BP	positive regulation of cysteine-type endopeptidase activity	16175	26298		0.8653846153846154	0.8679245283018868	21	16154	3	19	18	16135	16175	0.13842777919895227
R1	cpdb	0	network_modules	171	TRUE	0.003997098747466138	103	16	4	0.25	0.038834951456310676	REAC:R-HSA-168181	REAC	Toll Like Receptor 7/8 (TLR7/8) Cascade	10916	2518		0.65625	0.696969696969697	103	10813	4	12	99	10801	10916	0.09533442472671759
R1	cpdb	0	network_modules	171	TRUE	0.003997098747466138	103	16	4	0.25	0.038834951456310676	REAC:R-HSA-168164	REAC	Toll Like Receptor 3 (TLR3) Cascade	10916	2515		0.65625	0.696969696969697	103	10813	4	12	99	10801	10916	0.09533442472671759
R1	cpdb	0	network_modules	171	TRUE	0.004398858590472755	33	16	3	0.1875	0.09090909090909091	REAC:R-HSA-5357956	REAC	TNFR1-induced NF-kappa-B signaling pathway	10916	2447		0.71875	0.7272727272727273	33	10883	3	13	30	10870	10916	0.12874222519729
R1	cpdb	0	network_modules	171	TRUE	0.004479201531099925	106	16	4	0.25	0.03773584905660377	REAC:R-HSA-168138	REAC	Toll Like Receptor 9 (TLR9) Cascade	10916	2519		0.75	0.7575757575757576	106	10810	4	12	102	10798	10916	0.09388133427943239
R1	cpdb	0	network_modules	171	TRUE	0.004649041062558586	107	16	4	0.25	0.037383177570093455	REAC:R-HSA-937061	REAC	TRIF (TICAM1)-mediated TLR4 signaling 	10916	2471		0.78125	0.8181818181818182	107	10809	4	12	103	10797	10916	0.09341030334883643
R1	cpdb	0	network_modules	171	TRUE	0.004649041062558586	107	16	4	0.25	0.037383177570093455	REAC:R-HSA-166166	REAC	MyD88-independent TLR4 cascade 	10916	1501		0.78125	0.8181818181818182	107	10809	4	12	103	10797	10916	0.09341030334883643
R1	cpdb	0	network_modules	171	TRUE	0.004927070918364304	180	22	5	0.22727272727272727	0.027777777777777776	GO:0034612	GO:BP	response to tumor necrosis factor	16175	8690		0.8846153846153846	0.8867924528301887	180	15995	5	17	175	15978	16175	0.07604045951710106
R1	cpdb	0	network_modules	171	TRUE	0.0051351155261784714	23	22	3	0.13636363636363635	0.13043478260869565	GO:0032727	GO:BP	positive regulation of interferon-alpha production	16175	7772		0.9038461538461539	0.9056603773584906	23	16152	3	19	20	16133	16175	0.13215941380754104
R1	cpdb	0	network_modules	171	TRUE	0.005570474550889138	112	16	4	0.25	0.03571428571428571	REAC:R-HSA-166058	REAC	MyD88:MAL(TIRAP) cascade initiated on plasma membrane	10916	1502		0.84375	0.8787878787878788	112	10804	4	12	108	10792	10916	0.0911484244216144
R1	cpdb	0	network_modules	171	TRUE	0.005570474550889138	112	16	4	0.25	0.03571428571428571	REAC:R-HSA-168188	REAC	Toll Like Receptor TLR6:TLR2 Cascade	10916	2521		0.84375	0.8787878787878788	112	10804	4	12	108	10792	10916	0.0911484244216144
R1	cpdb	0	network_modules	171	TRUE	0.005600343215789051	246	17	5	0.29411764705882354	0.02032520325203252	KEGG:05131	KEGG	Shigellosis	8484	428		1	1	246	8238	5	12	241	8226	8484	0.07079905826086834
R1	cpdb	0	network_modules	171	TRUE	0.005769793598411577	113	16	4	0.25	0.035398230088495575	REAC:R-HSA-9020702	REAC	Interleukin-1 signaling	10916	1233		0.90625	0.9090909090909091	113	10803	4	12	109	10791	10916	0.09071373990788786
R1	cpdb	0	network_modules	171	TRUE	0.00618414317748855	115	16	4	0.25	0.034782608695652174	REAC:R-HSA-168179	REAC	Toll Like Receptor TLR1:TLR2 Cascade	10916	2520		0.9375	0.9696969696969697	115	10801	4	12	111	10789	10916	0.08986103623956763
R1	cpdb	0	network_modules	171	TRUE	0.00618414317748855	115	16	4	0.25	0.034782608695652174	REAC:R-HSA-181438	REAC	Toll Like Receptor 2 (TLR2) Cascade	10916	2514		0.9375	0.9696969696969697	115	10801	4	12	111	10789	10916	0.08986103623956763
R1	cpdb	0	network_modules	171	TRUE	0.006229500898807303	84	22	4	0.18181818181818182	0.047619047619047616	GO:0033209	GO:BP	tumor necrosis factor-mediated signaling pathway	16175	8075		0.9230769230769231	0.9245283018867925	84	16091	4	18	80	16073	16175	0.090688037629785
R1	cpdb	0	network_modules	171	TRUE	0.007465049077939548	792	22	8	0.36363636363636365	0.010101010101010102	GO:0042325	GO:BP	regulation of phosphorylation	16175	10093		0.9423076923076923	0.9433962264150944	792	15383	8	14	784	15369	16175	0.053815069047123444
R1	cpdb	0	network_modules	171	TRUE	0.0075620328379026325	551	22	7	0.3181818181818182	0.012704174228675136	GO:1902532	GO:BP	negative regulation of intracellular signal transduction	16175	22341		0.9615384615384616	0.9622641509433962	551	15624	7	15	544	15609	16175	0.057803507350984155
R1	cpdb	0	network_modules	171	TRUE	0.009457181219429673	28	22	3	0.13636363636363635	0.10714285714285714	GO:0032647	GO:BP	regulation of interferon-alpha production	16175	7694		0.9807692307692307	1	28	16147	3	19	25	16128	16175	0.11952375557141982
R1	cpdb	0	network_modules	171	TRUE	0.009457181219429673	28	22	3	0.13636363636363635	0.10714285714285714	GO:0032607	GO:BP	interferon-alpha production	16175	7655		0.9807692307692307	1	28	16147	3	19	25	16128	16175	0.11952375557141982
R1	cpdb	0	network_modules	171	TRUE	0.009579368865125053	459	16	6	0.375	0.013071895424836602	REAC:R-HSA-9679506	REAC	SARS-CoV Infections	10916	2112		1	1	459	10457	6	10	453	10447	10916	0.06355965318072258
R1	cpdb	0	network_modules	172	TRUE	1.297050734740722e-11	12	23	6	0.2608695652173913	0.5	REAC:R-HSA-375281	REAC	Hormone ligand-binding receptors	10916	1131		0	0.1	12	10904	6	17	6	10887	10916	0.36021316410816473
R1	cpdb	0	network_modules	172	TRUE	4.78360893763477e-10	8	23	5	0.21739130434782608	0.625	REAC:R-HSA-166665	REAC	Terminal pathway of complement	10916	2490		0.1111111111111111	0.2	8	10908	5	18	3	10890	10916	0.36788470920611577
R1	cpdb	0	network_modules	172	TRUE	2.4192534847821552e-8	86	19	7	0.3684210526315789	0.08139534883720931	KEGG:04610	KEGG	Complement and coagulation cascades	8484	320		0	0.16666666666666666	86	8398	7	12	79	8386	8484	0.16945509295865524
R1	cpdb	0	network_modules	172	TRUE	3.3599858261083716e-7	101	23	7	0.30434782608695654	0.06930693069306931	REAC:R-HSA-977606	REAC	Regulation of Complement cascade	10916	1971		0.2222222222222222	0.3	101	10815	7	16	94	10799	10916	0.14162571467489904
R1	cpdb	0	network_modules	172	TRUE	6.549715675060138e-7	111	23	7	0.30434782608695654	0.06306306306306306	REAC:R-HSA-166658	REAC	Complement cascade	10916	390		0.3333333333333333	0.4	111	10805	7	16	104	10789	10916	0.13473855283333855
R1	cpdb	0	network_modules	172	TRUE	1.781613054924982e-6	365	19	9	0.47368421052631576	0.024657534246575342	KEGG:04080	KEGG	Neuroactive ligand-receptor interaction	8484	263		0.2	0.3333333333333333	365	8119	9	10	356	8109	8484	0.10055481716994642
R1	cpdb	0	network_modules	172	TRUE	2.4114192501951717e-6	12	23	4	0.17391304347826086	0.3333333333333333	REAC:R-HSA-209822	REAC	Glycoprotein hormones	10916	1075		0.4444444444444444	0.5	12	10904	4	19	8	10885	10916	0.2396339890267564
R1	cpdb	0	network_modules	172	TRUE	3.319793681460069e-6	328	23	9	0.391304347826087	0.027439024390243903	REAC:R-HSA-373076	REAC	Class A/1 (Rhodopsin-like receptors)	10916	365		0.5555555555555556	0.6	328	10588	9	14	319	10574	10916	0.09723569642456835
R1	cpdb	0	network_modules	172	TRUE	4.862847617212969e-6	14	23	4	0.17391304347826086	0.2857142857142857	REAC:R-HSA-209952	REAC	Peptide hormone biosynthesis	10916	1724		0.6666666666666666	0.7	14	10902	4	19	10	10883	10916	0.2216430772998748
R1	cpdb	0	network_modules	172	TRUE	6.870939343759816e-6	88	23	6	0.2608695652173913	0.06818181818181818	REAC:R-HSA-2980736	REAC	Peptide hormone metabolism	10916	1725		0.7777777777777778	0.8	88	10828	6	17	82	10811	10916	0.1299059531218631
R1	cpdb	0	network_modules	172	TRUE	1.8757647657423565e-5	223	19	7	0.3684210526315789	0.03139013452914798	KEGG:04024	KEGG	cAMP signaling pathway	8484	252		0.4	0.5	223	8261	7	12	216	8249	8484	0.10131981011170982
R1	cpdb	0	network_modules	172	TRUE	6.149340400588108e-5	460	23	9	0.391304347826087	0.01956521739130435	REAC:R-HSA-500792	REAC	GPCR ligand binding	10916	1019		0.8888888888888888	0.9	460	10456	9	14	451	10442	10916	0.07985864005374682
R1	cpdb	0	network_modules	172	TRUE	2.1014638682212785e-4	156	23	6	0.2608695652173913	0.038461538461538464	REAC:R-HSA-418555	REAC	G alpha (s) signalling events	10916	989		1	1	156	10760	6	17	150	10743	10916	0.09546422896676254
R1	cpdb	0	network_modules	172	TRUE	4.750825313962193e-4	231	19	6	0.3157894736842105	0.025974025974025976	KEGG:05171	KEGG	Coronavirus disease - COVID-19	8484	452		0.6	0.6666666666666666	231	8253	6	13	225	8240	8484	0.0840022330367428
R1	cpdb	0	network_modules	172	TRUE	5.091556415499149e-4	132	19	5	0.2631578947368421	0.03787878787878788	KEGG:05322	KEGG	Systemic lupus erythematosus	8484	484		0.8	0.8333333333333334	132	8352	5	14	127	8338	8484	0.09478312009164856
R1	cpdb	0	network_modules	172	TRUE	0.0013406793949668424	774	24	9	0.375	0.011627906976744186	GO:0007186	GO:BP	G protein-coupled receptor signaling pathway	16175	2744		0	0.3333333333333333	774	15401	9	15	765	15386	16175	0.059081298412214295
R1	cpdb	0	network_modules	172	TRUE	0.00692985575149166	227	19	5	0.2631578947368421	0.022026431718061675	KEGG:04810	KEGG	Regulation of actin cytoskeleton	8484	365		1	1	227	8257	5	14	222	8243	8484	0.06940494387997112
R1	cpdb	0	network_modules	172	TRUE	0.008977483132726609	81	24	4	0.16666666666666666	0.04938271604938271	GO:0007565	GO:BP	female pregnancy	16175	3043		0.5	0.6666666666666666	81	16094	4	20	77	16074	16175	0.08828266137878188
R1	cpdb	0	network_modules	172	TRUE	0.009881539404908083	3	24	2	0.08333333333333333	0.6666666666666666	GO:0042699	GO:BP	follicle-stimulating hormone signaling pathway	16175	10309		1	1	3	16172	2	22	1	16150	16175	0.23537416597204877
R1	cpdb	0	network_modules	173	TRUE	2.3536012748629644e-29	215	39	24	0.6153846153846154	0.11162790697674418	REAC:R-HSA-6805567	REAC	Keratinization	10916	1288		0	0.16666666666666666	215	10701	24	15	191	10686	10916	0.2567020027133742
R1	cpdb	0	network_modules	173	TRUE	1.179410744041361e-5	4	22	3	0.13636363636363635	0.75	GO:1990410	GO:BP	adrenomedullin receptor signaling pathway	16175	25158		0	0.5	4	16171	3	19	1	16152	16175	0.31947793278252273
R1	cpdb	0	network_modules	173	TRUE	2.5944379315472987e-5	12	39	4	0.10256410256410256	0.3333333333333333	REAC:R-HSA-622323	REAC	Presynaptic nicotinic acetylcholine receptors	10916	1792		0.2	0.3333333333333333	12	10904	4	35	8	10869	10916	0.18334670956139812
R1	cpdb	0	network_modules	173	TRUE	5.2196466987981995e-5	14	39	4	0.10256410256410256	0.2857142857142857	REAC:R-HSA-622327	REAC	Postsynaptic nicotinic acetylcholine receptors	10916	1779		0.4	0.6666666666666666	14	10902	4	35	10	10867	10916	0.16945509594910788
R1	cpdb	0	network_modules	173	TRUE	5.2196466987981995e-5	14	39	4	0.10256410256410256	0.2857142857142857	REAC:R-HSA-181431	REAC	Acetylcholine binding and downstream events	10916	54		0.4	0.6666666666666666	14	10902	4	35	10	10867	10916	0.16945509594910788
R1	cpdb	0	network_modules	173	TRUE	1.645363116300115e-4	8	22	3	0.13636363636363635	0.375	GO:0097646	GO:BP	calcitonin family receptor signaling pathway	16175	18719		1	1	8	16167	3	19	5	16148	16175	0.2255224840135997
R1	cpdb	0	network_modules	173	TRUE	5.620445003110092e-4	7	39	3	0.07692307692307693	0.42857142857142855	REAC:R-HSA-629587	REAC	Highly sodium permeable postsynaptic acetylcholine nicotinic receptors	10916	1126		0.8	0.8333333333333334	7	10909	3	36	4	10873	10916	0.18043500712150043
R1	cpdb	0	network_modules	173	TRUE	0.001912748725699554	10	39	3	0.07692307692307693	0.3	REAC:R-HSA-419812	REAC	Calcitonin-like ligand receptors	10916	300		1	1	10	10906	3	36	7	10870	10916	0.15043956057946922
R1	cpdb	0	network_modules	173	TRUE	0.002120880158928568	365	16	6	0.375	0.01643835616438356	KEGG:04080	KEGG	Neuroactive ligand-receptor interaction	8484	263		NA	1	365	8119	6	10	359	8109	8484	0.07111834135025977
R1	cpdb	0	network_modules	174	TRUE	2.0405665836875702e-50	32	35	23	0.6571428571428571	0.71875	KEGG:04130	KEGG	SNARE interactions in vesicular transport	8484	272		0	0.5	32	8452	23	12	9	8440	8484	0.6860206396288167
R1	cpdb	0	network_modules	174	TRUE	1.9045761110801242e-31	101	40	20	0.5	0.19801980198019803	GO:0090174	GO:BP	organelle membrane fusion	16175	18081		0	0.019230769230769232	101	16074	20	20	81	16054	16175	0.3120896296955134
R1	cpdb	0	network_modules	174	TRUE	2.342488318903922e-29	99	40	19	0.475	0.1919191919191919	GO:0006906	GO:BP	vesicle fusion	16175	2557		0.0196078431372549	0.038461538461538464	99	16076	19	21	80	16055	16175	0.29932596897881303
R1	cpdb	0	network_modules	174	TRUE	1.211779299201133e-28	136	40	20	0.5	0.14705882352941177	GO:0048284	GO:BP	organelle fusion	16175	12626		0.0392156862745098	0.057692307692307696	136	16039	20	20	116	16019	16175	0.2680627546804666
R1	cpdb	0	network_modules	174	TRUE	9.13106636166383e-28	70	40	17	0.425	0.24285714285714285	GO:0140056	GO:BP	organelle localization by membrane tethering	16175	19654		0.058823529411764705	0.07692307692307693	70	16105	17	23	53	16082	16175	0.31908351420095243
R1	cpdb	0	network_modules	174	TRUE	2.360913763158566e-27	55	40	16	0.4	0.2909090909090909	GO:0048278	GO:BP	vesicle docking	16175	12620		0.0784313725490196	0.09615384615384616	55	16120	16	24	39	16096	16175	0.3392175460084818
R1	cpdb	0	network_modules	174	TRUE	2.5645503867985894e-27	157	40	20	0.5	0.12738853503184713	GO:0061025	GO:BP	membrane fusion	16175	15142		0.09803921568627451	0.11538461538461539	157	16018	20	20	137	15998	16175	0.2489958503397723
R1	cpdb	0	network_modules	174	TRUE	1.1605684089374952e-26	80	40	17	0.425	0.2125	GO:0022406	GO:BP	membrane docking	16175	6597		0.11764705882352941	0.1346153846153846	80	16095	17	23	63	16072	16175	0.29812921727875186
R1	cpdb	0	network_modules	174	TRUE	2.315530959312192e-19	315	40	19	0.475	0.06031746031746032	GO:0016050	GO:BP	vesicle organization	16175	5082		0.13725490196078433	0.15384615384615385	315	15860	19	21	296	15839	16175	0.16413289414480542
R1	cpdb	0	network_modules	174	TRUE	6.055251551188688e-18	56	40	12	0.3	0.21428571428571427	GO:0140029	GO:BP	exocytic process	16175	19642		0.1568627450980392	0.17307692307692307	56	16119	12	28	44	16091	16175	0.25136621080044447
R1	cpdb	0	network_modules	174	TRUE	3.920653331330856e-16	657	40	21	0.525	0.0319634703196347	GO:0061024	GO:BP	membrane organization	16175	15141		0.17647058823529413	0.19230769230769232	657	15518	21	19	636	15499	16175	0.12217350242237525
R1	cpdb	0	network_modules	174	TRUE	3.825168717745773e-14	263	40	15	0.375	0.057034220532319393	GO:0006887	GO:BP	exocytosis	16175	2543		0.19607843137254902	0.21153846153846154	263	15912	15	25	248	15887	16175	0.14123090962503482
R1	cpdb	0	network_modules	174	TRUE	1.039925240474002e-12	202	31	13	0.41935483870967744	0.06435643564356436	REAC:R-HSA-6811442	REAC	Intra-Golgi and retrograde Golgi-to-ER traffic	10916	1262		0	0.07142857142857142	202	10714	13	18	189	10696	10916	0.15873051387338102
R1	cpdb	0	network_modules	174	TRUE	1.0617868064241628e-12	145	40	12	0.3	0.08275862068965517	GO:0006836	GO:BP	neurotransmitter transport	16175	2506		0.21568627450980393	0.23076923076923078	145	16030	12	28	133	16002	16175	0.1537393629633809
R1	cpdb	0	network_modules	174	TRUE	1.947647527083869e-12	519	40	17	0.425	0.03275529865125241	GO:0051640	GO:BP	organelle localization	16175	13853		0.23529411764705882	0.25	519	15656	17	23	502	15633	16175	0.11101012886801293
R1	cpdb	0	network_modules	174	TRUE	3.810901302912595e-12	161	40	12	0.3	0.07453416149068323	GO:0045055	GO:BP	regulated exocytosis	16175	11253		0.2549019607843137	0.2692307692307692	161	16014	12	28	149	15986	16175	0.14547701501362711
R1	cpdb	0	network_modules	174	TRUE	2.652093068287124e-11	36	40	8	0.2	0.2222222222222222	GO:0006904	GO:BP	vesicle docking involved in exocytosis	16175	2556		0.27450980392156865	0.28846153846153844	36	16139	8	32	28	16107	16175	0.20896338254889676
R1	cpdb	0	network_modules	174	TRUE	5.756270883815464e-11	101	40	10	0.25	0.09900990099009901	GO:0099643	GO:BP	signal release from synapse	16175	19183		0.29411764705882354	0.3269230769230769	101	16074	10	30	91	16044	16175	0.1540714189547343
R1	cpdb	0	network_modules	174	TRUE	5.756270883815464e-11	101	40	10	0.25	0.09900990099009901	GO:0007269	GO:BP	neurotransmitter secretion	16175	2797		0.29411764705882354	0.3269230769230769	101	16074	10	30	91	16044	16175	0.1540714189547343
R1	cpdb	0	network_modules	174	TRUE	8.733627289267407e-11	44	31	8	0.25806451612903225	0.18181818181818182	REAC:R-HSA-6811438	REAC	Intra-Golgi traffic	10916	1263		0.07692307692307693	0.14285714285714285	44	10872	8	23	36	10849	10916	0.2139638933184801
R1	cpdb	0	network_modules	174	TRUE	2.5907916834074055e-10	583	40	16	0.4	0.0274442538593482	GO:0032940	GO:BP	secretion by cell	16175	7926		0.3333333333333333	0.34615384615384615	583	15592	16	24	567	15568	16175	0.09721971781333981
R1	cpdb	0	network_modules	174	TRUE	3.4232003580614635e-10	487	40	15	0.375	0.030800821355236138	GO:0098916	GO:BP	anterograde trans-synaptic signaling	16175	18949		0.35294117647058826	0.38461538461538464	487	15688	15	25	472	15663	16175	0.10049036151294428
R1	cpdb	0	network_modules	174	TRUE	3.4232003580614635e-10	487	40	15	0.375	0.030800821355236138	GO:0007268	GO:BP	chemical synaptic transmission	16175	2796		0.35294117647058826	0.38461538461538464	487	15688	15	25	472	15663	16175	0.10049036151294428
R1	cpdb	0	network_modules	174	TRUE	3.9692971403742085e-10	492	40	15	0.375	0.03048780487804878	GO:0099537	GO:BP	trans-synaptic signaling	16175	19116		0.39215686274509803	0.40384615384615385	492	15683	15	25	477	15658	16175	0.09990474915562202
R1	cpdb	0	network_modules	174	TRUE	4.010774071419625e-10	311	40	13	0.325	0.04180064308681672	GO:0023061	GO:BP	signal release	16175	6645		0.4117647058823529	0.4230769230769231	311	15864	13	27	298	15837	16175	0.11086695041142484
R1	cpdb	0	network_modules	174	TRUE	7.904133012971574e-10	516	40	15	0.375	0.029069767441860465	GO:0099536	GO:BP	synaptic signaling	16175	19115		0.43137254901960786	0.4423076923076923	516	15659	15	25	501	15634	16175	0.0972080622195928
R1	cpdb	0	network_modules	174	TRUE	1.2467848039402155e-9	646	40	16	0.4	0.02476780185758514	GO:0140352	GO:BP	export from cell	16175	19748		0.45098039215686275	0.46153846153846156	646	15529	16	24	630	15505	16175	0.09155432669812708
R1	cpdb	0	network_modules	174	TRUE	1.2853669988190997e-9	78	35	9	0.2571428571428571	0.11538461538461539	KEGG:04721	KEGG	Synaptic vesicle cycle	8484	351		1	1	78	8406	9	26	69	8380	8484	0.1672062608522773
R1	cpdb	0	network_modules	174	TRUE	1.3380719509412498e-9	649	40	16	0.4	0.02465331278890601	GO:0046903	GO:BP	secretion	16175	12430		0.47058823529411764	0.4807692307692308	649	15526	16	24	633	15502	16175	0.09130424524119819
R1	cpdb	0	network_modules	174	TRUE	1.6160111076092268e-9	58	40	8	0.2	0.13793103448275862	GO:0016079	GO:BP	synaptic vesicle exocytosis	16175	5106		0.49019607843137253	0.5	58	16117	8	32	50	16085	16175	0.16360878741487442
R1	cpdb	0	network_modules	174	TRUE	1.6734030757000638e-9	94	40	9	0.225	0.09574468085106383	GO:0042147	GO:BP	retrograde transport, endosome to Golgi	16175	9990		0.5098039215686274	0.5192307692307693	94	16081	9	31	85	16050	16175	0.14357778066519908
R1	cpdb	0	network_modules	174	TRUE	3.409546993754378e-9	284	40	12	0.3	0.04225352112676056	GO:0048193	GO:BP	Golgi vesicle transport	16175	12570		0.5294117647058824	0.5384615384615384	284	15891	12	28	272	15863	16175	0.10707408114479763
R1	cpdb	0	network_modules	174	TRUE	3.254082125763687e-8	130	40	9	0.225	0.06923076923076923	GO:0016482	GO:BP	cytosolic transport	16175	5232		0.5490196078431373	0.5576923076923077	130	16045	9	31	121	16014	16175	0.12098561929392353
R1	cpdb	0	network_modules	174	TRUE	4.785655672987571e-8	270	40	11	0.275	0.040740740740740744	GO:0016197	GO:BP	endosomal transport	16175	5169		0.5686274509803921	0.5769230769230769	270	15905	11	29	259	15876	16175	0.1003871722334394
R1	cpdb	0	network_modules	174	TRUE	5.180426106715571e-7	117	40	8	0.2	0.06837606837606838	GO:0099504	GO:BP	synaptic vesicle cycle	16175	19100		0.5882352941176471	0.5961538461538461	117	16058	8	32	109	16026	16175	0.11326167081896739
R1	cpdb	0	network_modules	174	TRUE	6.787011431589916e-7	121	40	8	0.2	0.06611570247933884	GO:0099003	GO:BP	vesicle-mediated transport in synapse	16175	18999		0.6078431372549019	0.6153846153846154	121	16054	8	32	113	16022	16175	0.11124482176671499
R1	cpdb	0	network_modules	174	TRUE	1.5499119008807541e-6	7	40	4	0.1	0.5714285714285714	GO:0048280	GO:BP	vesicle fusion with Golgi apparatus	16175	12622		0.6274509803921569	0.6346153846153846	7	16168	4	36	3	16132	16175	0.23835763610482583
R1	cpdb	0	network_modules	174	TRUE	3.450789304519133e-6	404	40	11	0.275	0.027227722772277228	GO:1903530	GO:BP	regulation of secretion by cell	16175	23080		0.6470588235294118	0.6538461538461539	404	15771	11	29	393	15742	16175	0.07977187188894419
R1	cpdb	0	network_modules	174	TRUE	3.831664639075565e-6	522	40	12	0.3	0.022988505747126436	GO:0010256	GO:BP	endomembrane system organization	16175	4029		0.6666666666666666	0.6730769230769231	522	15653	12	28	510	15625	16175	0.07543093822802618
R1	cpdb	0	network_modules	174	TRUE	4.000416890296138e-6	524	40	12	0.3	0.022900763358778626	GO:0006886	GO:BP	intracellular protein transport	16175	2542		0.6862745098039216	0.6923076923076923	524	15651	12	28	512	15623	16175	0.07525688590202508
R1	cpdb	0	network_modules	174	TRUE	8.807723341534304e-6	442	40	11	0.275	0.024886877828054297	GO:0051046	GO:BP	regulation of secretion	16175	13456		0.7058823529411765	0.7115384615384616	442	15733	11	29	431	15704	16175	0.07564027531352965
R1	cpdb	0	network_modules	174	TRUE	2.1725703353417046e-5	12	40	4	0.1	0.3333333333333333	GO:0031629	GO:BP	synaptic vesicle fusion to presynaptic active zone membrane	16175	7242		0.7254901960784313	0.75	12	16163	4	36	8	16127	16175	0.18151152734425682
R1	cpdb	0	network_modules	174	TRUE	2.1725703353417046e-5	12	40	4	0.1	0.3333333333333333	GO:0099500	GO:BP	vesicle fusion to plasma membrane	16175	19098		0.7254901960784313	0.75	12	16163	4	36	8	16127	16175	0.18151152734425682
R1	cpdb	0	network_modules	174	TRUE	3.07793889156326e-5	126	40	7	0.175	0.05555555555555555	GO:0006888	GO:BP	endoplasmic reticulum to Golgi vesicle-mediated transport	16175	2544		0.7647058823529411	0.7692307692307693	126	16049	7	33	119	16016	16175	0.09469854532213533
R1	cpdb	0	network_modules	174	TRUE	5.4973605214236444e-5	137	40	7	0.175	0.051094890510948905	GO:0098876	GO:BP	vesicle-mediated transport to the plasma membrane	16175	18924		0.7843137254901961	0.7884615384615384	137	16038	7	33	130	16005	16175	0.09047888850108106
R1	cpdb	0	network_modules	174	TRUE	6.69095014422093e-5	155	31	7	0.22580645161290322	0.04516129032258064	REAC:R-HSA-199977	REAC	ER to Golgi Anterograde Transport	10916	823		0.15384615384615385	0.21428571428571427	155	10761	7	24	148	10737	10916	0.0954483116673467
R1	cpdb	0	network_modules	174	TRUE	7.668052827621757e-5	49	31	5	0.16129032258064516	0.10204081632653061	REAC:R-HSA-6811440	REAC	Retrograde transport at the Trans-Golgi-Network	10916	2096		0.23076923076923078	0.2857142857142857	49	10867	5	26	44	10841	10916	0.1251778515446897
R1	cpdb	0	network_modules	174	TRUE	8.503124275278384e-5	50	31	5	0.16129032258064516	0.1	REAC:R-HSA-112310	REAC	Neurotransmitter release cycle	10916	1595		0.3076923076923077	0.35714285714285715	50	10866	5	26	45	10840	10916	0.12385305143298925
R1	cpdb	0	network_modules	174	TRUE	1.0353226830637686e-4	17	40	4	0.1	0.23529411764705882	GO:0048499	GO:BP	synaptic vesicle membrane organization	16175	12788		0.803921568627451	0.8076923076923077	17	16158	4	36	13	16122	16175	0.152048775399505
R1	cpdb	0	network_modules	174	TRUE	1.1656632249780802e-4	102	31	6	0.1935483870967742	0.058823529411764705	REAC:R-HSA-6807878	REAC	COPI-mediated anterograde transport	10916	279		0.38461538461538464	0.42857142857142855	102	10814	6	25	96	10789	10916	0.10217312215727417
R1	cpdb	0	network_modules	174	TRUE	1.4773291706615842e-4	259	31	8	0.25806451612903225	0.03088803088803089	REAC:R-HSA-112315	REAC	Transmission across Chemical Synapses	10916	2580		0.46153846153846156	0.5	259	10657	8	23	251	10634	10916	0.08216848547334994
R1	cpdb	0	network_modules	174	TRUE	1.8116017577909146e-4	24	31	4	0.12903225806451613	0.16666666666666666	REAC:R-HSA-449836	REAC	Other interleukin signaling	10916	1651		0.5384615384615384	0.5714285714285714	24	10892	4	27	20	10865	10916	0.14451243288517882
R1	cpdb	0	network_modules	174	TRUE	1.8185587846992593e-4	594	40	11	0.275	0.018518518518518517	GO:0051668	GO:BP	localization within membrane	16175	13880		0.8235294117647058	0.8269230769230769	594	15581	11	29	583	15552	16175	0.06307836392753015
R1	cpdb	0	network_modules	174	TRUE	2.3103019785508186e-4	186	31	7	0.22580645161290322	0.03763440860215054	REAC:R-HSA-948021	REAC	Transport to the Golgi and subsequent modification	10916	2604		0.6153846153846154	0.6428571428571429	186	10730	7	24	179	10706	10916	0.0860867238169596
R1	cpdb	0	network_modules	174	TRUE	2.366326395052909e-4	52	40	5	0.125	0.09615384615384616	GO:0006890	GO:BP	retrograde vesicle-mediated transport, Golgi to endoplasmic reticulum	16175	2545		0.8431372549019608	0.8461538461538461	52	16123	5	35	47	16088	16175	0.10711729092476743
R1	cpdb	0	network_modules	174	TRUE	4.0362723050531936e-4	68	31	5	0.16129032258064516	0.07352941176470588	REAC:R-HSA-204005	REAC	COPII-mediated vesicle transport	10916	280		0.6923076923076923	0.7142857142857143	68	10848	5	26	63	10822	10916	0.1051727572431933
R1	cpdb	0	network_modules	174	TRUE	7.337561915974407e-4	409	40	9	0.225	0.022004889975550123	GO:0060627	GO:BP	regulation of vesicle-mediated transport	16175	14803		0.8627450980392157	0.8653846153846154	409	15766	9	31	400	15735	16175	0.06333970498850487
R1	cpdb	0	network_modules	174	TRUE	0.0018632265689984345	144	40	6	0.15	0.041666666666666664	GO:0007030	GO:BP	Golgi organization	16175	2635		0.8823529411764706	0.8846153846153846	144	16031	6	34	138	15997	16175	0.07479062688529103
R1	cpdb	0	network_modules	174	TRUE	0.0019572121077002166	34	40	4	0.1	0.11764705882352941	GO:0006891	GO:BP	intra-Golgi vesicle-mediated transport	16175	2546		0.9019607843137255	0.9038461538461539	34	16141	4	36	30	16105	16175	0.10642873524949356
R1	cpdb	0	network_modules	174	TRUE	0.0021866270669938085	148	40	6	0.15	0.04054054054054054	GO:0017157	GO:BP	regulation of exocytosis	16175	5287		0.9215686274509803	0.9230769230769231	148	16027	6	34	142	15993	16175	0.07365291054972642
R1	cpdb	0	network_modules	174	TRUE	0.0037962018471712554	400	31	8	0.25806451612903225	0.02	REAC:R-HSA-112316	REAC	Neuronal System	10916	1590		0.7692307692307693	0.7857142857142857	400	10516	8	23	392	10493	10916	0.0628917663718522
R1	cpdb	0	network_modules	174	TRUE	0.004394311574874365	93	40	5	0.125	0.053763440860215055	GO:1903076	GO:BP	regulation of protein localization to plasma membrane	16175	22751		0.9411764705882353	0.9423076923076923	93	16082	5	35	88	16047	16175	0.07853045105169923
R1	cpdb	0	network_modules	174	TRUE	0.0054806957006219795	18	31	3	0.0967741935483871	0.16666666666666666	REAC:R-HSA-888590	REAC	GABA synthesis, release, reuptake and degradation	10916	1013		0.8461538461538461	0.8571428571428571	18	10898	3	28	15	10870	10916	0.12511698162669982
R1	cpdb	0	network_modules	174	TRUE	0.00610826977173196	305	31	7	0.22580645161290322	0.022950819672131147	REAC:R-HSA-446203	REAC	Asparagine N-linked glycosylation	10916	169		0.9230769230769231	0.9285714285714286	305	10611	7	24	298	10587	10916	0.06407267358835385
R1	cpdb	0	network_modules	174	TRUE	0.007707954876582515	285	40	7	0.175	0.02456140350877193	GO:1990778	GO:BP	protein localization to cell periphery	16175	25286		0.9607843137254902	0.9615384615384616	285	15890	7	33	278	15857	16175	0.05956011938714124
R1	cpdb	0	network_modules	174	TRUE	0.00779158260191664	3	31	2	0.06451612903225806	0.6666666666666666	REAC:R-HSA-5250971	REAC	Toxicity of botulinum toxin type C (botC)	10916	2525		1	1	3	10913	2	29	1	10884	10916	0.20682917230121037
R1	cpdb	0	network_modules	174	TRUE	0.00828190746599305	2	40	2	0.05	1	GO:0098967	GO:BP	exocytic insertion of neurotransmitter receptor to postsynaptic membrane	16175	18979		0.9803921568627451	0.9807692307692307	2	16173	2	38	0	16135	16175	0.2233439505556375
R1	cpdb	0	network_modules	174	TRUE	0.008706111528889244	49	40	4	0.1	0.08163265306122448	GO:0046928	GO:BP	regulation of neurotransmitter secretion	16175	12432		1	1	49	16126	4	36	45	16090	16175	0.08785544160770731
R1	cpdb	0	network_modules	175	TRUE	0.0018383332997034452	173	19	5	0.2631578947368421	0.028901734104046242	GO:0031032	GO:BP	actomyosin structure organization	16175	7004		0	0.5	173	16002	5	14	168	15988	16175	0.084166767842990875
R1	cpdb	0	network_modules	175	TRUE	0.0019409622539562652	56	10	3	0.3	0.05357142857142857	KEGG:04340	KEGG	Hedgehog signaling pathway	8484	302		0	0.5	56	8428	3	7	53	8421	8484	0.12446845119687343
R1	cpdb	0	network_modules	175	TRUE	0.002768513471693514	63	10	3	0.3	0.047619047619047616	KEGG:05217	KEGG	Basal cell carcinoma	8484	468		1	1	63	8421	3	7	60	8414	8484	0.11706860223691215
R1	cpdb	0	network_modules	175	TRUE	0.005296018232941796	3	19	2	0.10526315789473684	0.6666666666666666	GO:0045218	GO:BP	zonula adherens maintenance	16175	11330		1	1	3	16172	2	17	1	16155	16175	0.26461970208734953
R1	cpdb	0	network_modules	176	TRUE	7.955235848751941e-19	140	27	15	0.5555555555555556	0.10714285714285714	KEGG:04120	KEGG	Ubiquitin mediated proteolysis	8484	270		0	0.5	140	8344	15	12	125	8332	8484	0.23908669459765933
R1	cpdb	0	network_modules	176	TRUE	8.531013010236223e-14	380	25	15	0.6	0.039473684210526314	REAC:R-HSA-983169	REAC	Class I MHC mediated antigen processing & presentation	10916	368		0	0.0625	380	10536	15	10	365	10526	10916	0.1477282162373905
R1	cpdb	0	network_modules	176	TRUE	1.7956132431844157e-13	308	25	14	0.56	0.045454545454545456	REAC:R-HSA-983168	REAC	Antigen processing: Ubiquitination & Proteasome degradation	10916	154		0.06666666666666667	0.125	308	10608	14	11	294	10597	10916	0.15386620524426128
R1	cpdb	0	network_modules	176	TRUE	1.2831414007614896e-10	590	27	14	0.5185185185185185	0.023728813559322035	GO:0016567	GO:BP	protein ubiquitination	16175	5254		0	0.041666666666666664	590	15585	14	13	576	15572	16175	0.10514114440459459
R1	cpdb	0	network_modules	176	TRUE	6.854386414191043e-10	667	27	14	0.5185185185185185	0.020989505247376312	GO:0032446	GO:BP	protein modification by small protein conjugation	16175	7568		0.043478260869565216	0.08333333333333333	667	15508	14	13	653	15495	16175	0.0981524359633695
R1	cpdb	0	network_modules	176	TRUE	3.3092263502661832e-9	749	27	14	0.5185185185185185	0.018691588785046728	GO:0070647	GO:BP	protein modification by small protein conjugation or removal	16175	16231		0.08695652173913043	0.125	749	15426	14	13	735	15413	16175	0.09188332427800411
R1	cpdb	0	network_modules	176	TRUE	7.791624285865198e-9	798	27	14	0.5185185185185185	0.017543859649122806	GO:0043687	GO:BP	post-translational protein modification	16175	10838		0.13043478260869565	0.16666666666666666	798	15377	14	13	784	15364	16175	0.08858739503528366
R1	cpdb	0	network_modules	176	TRUE	1.3146262893324006e-7	248	27	10	0.37037037037037035	0.04032258064516129	KEGG:04144	KEGG	Endocytosis	8484	280		1	1	248	8236	10	17	238	8219	8484	0.11442517391047893
R1	cpdb	0	network_modules	176	TRUE	1.9884369078557176e-6	30	25	5	0.2	0.16666666666666666	REAC:R-HSA-8866652	REAC	Synthesis of active ubiquitin: roles of E1 and E2 enzymes	10916	2400		0.13333333333333333	0.1875	30	10886	5	20	25	10866	10916	0.18052015764425772
R1	cpdb	0	network_modules	176	TRUE	6.128274752969109e-6	78	25	6	0.24	0.07692307692307693	REAC:R-HSA-8852135	REAC	Protein ubiquitination	10916	1818		0.2	0.25	78	10838	6	19	72	10819	10916	0.13245320161426846
R1	cpdb	0	network_modules	176	TRUE	6.610959046275085e-6	673	27	11	0.4074074074074074	0.01634472511144131	GO:0051603	GO:BP	proteolysis involved in protein catabolic process	16175	13820		0.17391304347826086	0.20833333333333334	673	15502	11	16	662	15486	16175	0.07490470366375156
R1	cpdb	0	network_modules	176	TRUE	7.358124025921445e-6	248	27	8	0.2962962962962963	0.03225806451612903	GO:0000209	GO:BP	protein polyubiquitination	16175	59		0.21739130434782608	0.25	248	15927	8	19	240	15908	16175	0.09350280457411018
R1	cpdb	0	network_modules	176	TRUE	1.3877910556502458e-5	155	25	7	0.28	0.04516129032258064	REAC:R-HSA-199977	REAC	ER to Golgi Anterograde Transport	10916	823		0.26666666666666666	0.3125	155	10761	7	18	148	10743	10916	0.10763748502943427
R1	cpdb	0	network_modules	176	TRUE	1.4146711094705122e-5	547	27	10	0.37037037037037035	0.018281535648994516	GO:0006511	GO:BP	ubiquitin-dependent protein catabolic process	16175	2235		0.2608695652173913	0.2916666666666667	547	15628	10	17	537	15611	16175	0.07613328706619285
R1	cpdb	0	network_modules	176	TRUE	1.624878393393244e-5	555	27	10	0.37037037037037035	0.018018018018018018	GO:0019941	GO:BP	modification-dependent protein catabolic process	16175	6072		0.30434782608695654	0.3333333333333333	555	15620	10	17	545	15603	16175	0.07549083691618372
R1	cpdb	0	network_modules	176	TRUE	1.7400326274822826e-5	559	27	10	0.37037037037037035	0.017889087656529516	GO:0043632	GO:BP	modification-dependent macromolecule catabolic process	16175	10812		0.34782608695652173	0.375	559	15616	10	17	549	15599	16175	0.07517453325327791
R1	cpdb	0	network_modules	176	TRUE	2.590601302344207e-5	99	25	6	0.24	0.06060606060606061	REAC:R-HSA-6811434	REAC	COPI-dependent Golgi-to-ER retrograde traffic	10916	277		0.3333333333333333	0.375	99	10817	6	19	93	10798	10916	0.11671062496823371
R1	cpdb	0	network_modules	176	TRUE	3.0991616020856947e-5	102	25	6	0.24	0.058823529411764705	REAC:R-HSA-6807878	REAC	COPI-mediated anterograde transport	10916	279		0.4	0.4375	102	10814	6	19	96	10795	10916	0.11486057486660409
R1	cpdb	0	network_modules	176	TRUE	4.864314508161432e-5	186	25	7	0.28	0.03763440860215054	REAC:R-HSA-948021	REAC	Transport to the Golgi and subsequent modification	10916	2604		0.4666666666666667	0.5	186	10730	7	18	179	10712	10916	0.09734963275242764
R1	cpdb	0	network_modules	176	TRUE	6.289381469711901e-5	470	27	9	0.3333333333333333	0.019148936170212766	GO:0010498	GO:BP	proteasomal protein catabolic process	16175	4177		0.391304347826087	0.4166666666666667	470	15705	9	18	461	15687	16175	0.0740741725653707
R1	cpdb	0	network_modules	176	TRUE	1.4234676191416e-4	363	27	8	0.2962962962962963	0.02203856749311295	GO:0043161	GO:BP	proteasome-mediated ubiquitin-dependent protein catabolic process	16175	10561		0.43478260869565216	0.4583333333333333	363	15812	8	19	355	15793	16175	0.07560309601395857
R1	cpdb	0	network_modules	176	TRUE	1.5062924132772118e-4	133	25	6	0.24	0.045112781954887216	REAC:R-HSA-8856688	REAC	Golgi-to-ER retrograde transport	10916	1084		0.5333333333333333	0.5625	133	10783	6	19	127	10764	10916	0.09949204244316119
R1	cpdb	0	network_modules	176	TRUE	1.596358936343372e-4	524	27	9	0.3333333333333333	0.01717557251908397	GO:0006886	GO:BP	intracellular protein transport	16175	2542		0.4782608695652174	0.5	524	15651	9	18	515	15633	16175	0.0695034964796135
R1	cpdb	0	network_modules	176	TRUE	2.5589754139873557e-4	30	27	4	0.14814814814814814	0.13333333333333333	GO:0048199	GO:BP	vesicle targeting, to, from or within Golgi	16175	12575		0.5217391304347826	0.5416666666666666	30	16145	4	23	26	16122	16175	0.13903110793187473
R1	cpdb	0	network_modules	176	TRUE	2.8346811066618156e-4	79	27	5	0.18518518518518517	0.06329113924050633	GO:0070936	GO:BP	protein K48-linked ubiquitination	16175	16380		0.5652173913043478	0.5833333333333334	79	16096	5	22	74	16074	16175	0.10575299156280804
R1	cpdb	0	network_modules	176	TRUE	3.7602815769803214e-4	35	25	4	0.16	0.11428571428571428	REAC:R-HSA-936440	REAC	Negative regulators of DDX58/IFIH1 signaling	10916	1581		0.6	0.625	35	10881	4	21	31	10860	10916	0.13288006327434482
R1	cpdb	0	network_modules	176	TRUE	4.906957114622627e-4	284	27	7	0.25925925925925924	0.02464788732394366	GO:0048193	GO:BP	Golgi vesicle transport	16175	12570		0.6086956521739131	0.625	284	15891	7	20	277	15871	16175	0.07525077940854911
R1	cpdb	0	network_modules	176	TRUE	5.462878151589395e-4	36	27	4	0.14814814814814814	0.1111111111111111	GO:0006901	GO:BP	vesicle coating	16175	2554		0.6521739130434783	0.6666666666666666	36	16139	4	23	32	16116	16175	0.12661917381391077
R1	cpdb	0	network_modules	176	TRUE	6.78730328217653e-4	94	27	5	0.18518518518518517	0.05319148936170213	GO:0031398	GO:BP	positive regulation of protein ubiquitination	16175	7154		0.6956521739130435	0.7083333333333334	94	16081	5	22	89	16059	16175	0.0964950933371314
R1	cpdb	0	network_modules	176	TRUE	8.4370384305119e-4	40	27	4	0.14814814814814814	0.1	GO:0006513	GO:BP	protein monoubiquitination	16175	2236		0.7391304347826086	0.75	40	16135	4	23	36	16112	16175	0.11993278861516482
R1	cpdb	0	network_modules	176	TRUE	0.0011522249221117653	46	25	4	0.16	0.08695652173913043	REAC:R-HSA-5357905	REAC	Regulation of TNFR1 signaling	10916	2011		0.6666666666666666	0.6875	46	10870	4	21	42	10849	10916	0.11522173140515084
R1	cpdb	0	network_modules	176	TRUE	0.001362461045312618	305	25	7	0.28	0.022950819672131147	REAC:R-HSA-446203	REAC	Asparagine N-linked glycosylation	10916	169		0.7333333333333333	0.75	305	10611	7	18	298	10593	10916	0.07327813519303637
R1	cpdb	0	network_modules	176	TRUE	0.0014679644162048154	206	27	6	0.2222222222222222	0.02912621359223301	GO:1903320	GO:BP	regulation of protein modification by small protein conjugation or removal	16175	22904		0.782608695652174	0.7916666666666666	206	15969	6	21	200	15948	16175	0.076392445072736
R1	cpdb	0	network_modules	176	TRUE	0.0015973200872008953	209	27	6	0.2222222222222222	0.028708133971291867	GO:1901873	GO:BP	regulation of post-translational protein modification	16175	21817		0.8260869565217391	0.8333333333333334	209	15966	6	21	203	15945	16175	0.07578216311495062
R1	cpdb	0	network_modules	176	TRUE	0.0017334767880863363	202	25	6	0.24	0.0297029702970297	REAC:R-HSA-6811442	REAC	Intra-Golgi and retrograde Golgi-to-ER traffic	10916	1262		0.8	0.8125	202	10714	6	19	196	10695	10916	0.07874304005562677
R1	cpdb	0	network_modules	176	TRUE	0.001852977380526632	115	27	5	0.18518518518518517	0.043478260869565216	GO:1903322	GO:BP	positive regulation of protein modification by small protein conjugation or removal	16175	22906		0.8695652173913043	0.875	115	16060	5	22	110	16038	16175	0.08666608049025329
R1	cpdb	0	network_modules	176	TRUE	0.0019342444903532286	116	27	5	0.18518518518518517	0.04310344827586207	GO:1901875	GO:BP	positive regulation of post-translational protein modification	16175	21819		0.9130434782608695	0.9166666666666666	116	16059	5	22	111	16037	16175	0.08626443840889723
R1	cpdb	0	network_modules	176	TRUE	0.002374958143012984	55	25	4	0.16	0.07272727272727272	REAC:R-HSA-75893	REAC	TNF signaling	10916	2446		0.8666666666666667	0.875	55	10861	4	21	51	10840	10916	0.10485937881586006
R1	cpdb	0	network_modules	176	TRUE	0.0035342836417011077	19	25	3	0.12	0.15789473684210525	REAC:R-HSA-168927	REAC	TICAM1, RIP1-mediated IKK complex recruitment	10916	2440		0.9333333333333333	0.9375	19	10897	3	22	16	10875	10916	0.13592682687611676
R1	cpdb	0	network_modules	176	TRUE	0.004111753993326383	59	27	4	0.14814814814814814	0.06779661016949153	GO:0006903	GO:BP	vesicle targeting	16175	2555		0.9565217391304348	0.9583333333333334	59	16116	4	23	55	16093	16175	0.09801254074657645
R1	cpdb	0	network_modules	176	TRUE	0.005591494378376005	22	25	3	0.12	0.13636363636363635	REAC:R-HSA-937041	REAC	IKK complex recruitment mediated by RIP1	10916	1145		1	1	22	10894	3	22	19	10872	10916	0.12604336433891292
R1	cpdb	0	network_modules	176	TRUE	0.008658927596264373	71	27	4	0.14814814814814814	0.056338028169014086	GO:0051865	GO:BP	protein autoubiquitination	16175	13956		1	1	71	16104	4	23	67	16081	16175	0.088921085621162
R1	cpdb	0	network_modules	177	TRUE	1.6649344518608142e-14	667	23	16	0.6956521739130435	0.0239880059970015	GO:0032446	GO:BP	protein modification by small protein conjugation	16175	7568		0	0.07142857142857142	667	15508	16	7	651	15501	16175	0.12419609753248004
R1	cpdb	0	network_modules	177	TRUE	1.0487117486342529e-13	749	23	16	0.6956521739130435	0.021361815754339118	GO:0070647	GO:BP	protein modification by small protein conjugation or removal	16175	16231		0.07692307692307693	0.14285714285714285	749	15426	16	7	733	15419	16175	0.11660139581880538
R1	cpdb	0	network_modules	177	TRUE	1.2826089360831862e-13	590	23	15	0.6521739130434783	0.025423728813559324	GO:0016567	GO:BP	protein ubiquitination	16175	5254		0.15384615384615385	0.21428571428571427	590	15585	15	8	575	15577	16175	0.12393195374277462
R1	cpdb	0	network_modules	177	TRUE	2.859266043188726e-13	798	23	16	0.6956521739130435	0.020050125313283207	GO:0043687	GO:BP	post-translational protein modification	16175	10838		0.23076923076923078	0.2857142857142857	798	15377	16	7	782	15370	16175	0.11261681298967416
R1	cpdb	0	network_modules	177	TRUE	1.007256255583513e-9	363	23	11	0.4782608695652174	0.030303030303030304	GO:0043161	GO:BP	proteasome-mediated ubiquitin-dependent protein catabolic process	16175	10561		0.3076923076923077	0.35714285714285715	363	15812	11	12	352	15800	16175	0.11612897705196495
R1	cpdb	0	network_modules	177	TRUE	2.331163779270379e-9	244	21	10	0.47619047619047616	0.040983606557377046	REAC:R-HSA-8951664	REAC	Neddylation	10916	1559		0	0.3333333333333333	244	10672	10	11	234	10661	10916	0.13478530939350253
R1	cpdb	0	network_modules	177	TRUE	1.6602275914569505e-8	470	23	11	0.4782608695652174	0.023404255319148935	GO:0010498	GO:BP	proteasomal protein catabolic process	16175	4177		0.38461538461538464	0.42857142857142855	470	15705	11	12	459	15693	16175	0.10091842475922663
R1	cpdb	0	network_modules	177	TRUE	8.488596624431136e-8	547	23	11	0.4782608695652174	0.02010968921389397	GO:0006511	GO:BP	ubiquitin-dependent protein catabolic process	16175	2235		0.46153846153846156	0.5	547	15628	11	12	536	15616	16175	0.09278248593294064
R1	cpdb	0	network_modules	177	TRUE	9.917496616235113e-8	555	23	11	0.4782608695652174	0.01981981981981982	GO:0019941	GO:BP	modification-dependent protein catabolic process	16175	6072		0.5384615384615384	0.5714285714285714	555	15620	11	12	544	15608	16175	0.09203241044455421
R1	cpdb	0	network_modules	177	TRUE	1.0710354035348964e-7	559	23	11	0.4782608695652174	0.01967799642218247	GO:0043632	GO:BP	modification-dependent macromolecule catabolic process	16175	10812		0.6153846153846154	0.6428571428571429	559	15616	11	12	548	15604	16175	0.09166319992776371
R1	cpdb	0	network_modules	177	TRUE	7.74394126152836e-7	673	23	11	0.4782608695652174	0.01634472511144131	GO:0051603	GO:BP	proteolysis involved in protein catabolic process	16175	13820		0.6923076923076923	0.7142857142857143	673	15502	11	12	662	15490	16175	0.08251455323329618
R1	cpdb	0	network_modules	177	TRUE	1.716027962924172e-5	308	21	8	0.38095238095238093	0.025974025974025976	REAC:R-HSA-983168	REAC	Antigen processing: Ubiquitination & Proteasome degradation	10916	154		0.5	0.6666666666666666	308	10608	8	13	300	10595	10916	0.09352298471620814
R1	cpdb	0	network_modules	177	TRUE	1.7984440559514626e-5	19	23	4	0.17391304347826086	0.21052631578947367	GO:0035024	GO:BP	negative regulation of Rho protein signal transduction	16175	8767		0.7692307692307693	0.7857142857142857	19	16156	4	19	15	16137	16175	0.19030061956360644
R1	cpdb	0	network_modules	177	TRUE	8.670743910332717e-5	380	21	8	0.38095238095238093	0.021052631578947368	REAC:R-HSA-983169	REAC	Class I MHC mediated antigen processing & presentation	10916	368		1	1	380	10536	8	13	372	10523	10916	0.08290544232040904
R1	cpdb	0	network_modules	177	TRUE	2.639213751374235e-4	140	8	4	0.5	0.02857142857142857	KEGG:04120	KEGG	Ubiquitin mediated proteolysis	8484	270		0	0.5	140	8344	4	4	136	8340	8484	0.11659878097656846
R1	cpdb	0	network_modules	177	TRUE	5.598330665151077e-4	43	23	4	0.17391304347826086	0.09302325581395349	GO:0051058	GO:BP	negative regulation of small GTPase mediated signal transduction	16175	13468		0.8461538461538461	0.8571428571428571	43	16132	4	19	39	16113	16175	0.12550441864619108
R1	cpdb	0	network_modules	177	TRUE	8.325955364364987e-4	56	8	3	0.375	0.05357142857142857	KEGG:04340	KEGG	Hedgehog signaling pathway	8484	302		1	1	56	8428	3	5	53	8423	8484	0.13976960755062678
R1	cpdb	0	network_modules	177	TRUE	0.006588860481137562	79	23	4	0.17391304347826086	0.05063291139240506	GO:0035023	GO:BP	regulation of Rho protein signal transduction	16175	8766		0.9230769230769231	0.9285714285714286	79	16096	4	19	75	16077	16175	0.09149211230298003
R1	cpdb	0	network_modules	177	TRUE	0.009251189046622615	86	23	4	0.17391304347826086	0.046511627906976744	GO:0032465	GO:BP	regulation of cytokinesis	16175	7580		1	1	86	16089	4	19	82	16070	16175	0.0874840893946644
R1	cpdb	0	network_modules	179	TRUE	1.8548653948607837e-97	127	77	54	0.7012987012987013	0.4251968503937008	GO:0006119	GO:BP	oxidative phosphorylation	16175	1977		0	0.02127659574468085	127	16048	54	23	73	16025	16175	0.543381307979566
R1	cpdb	0	network_modules	179	TRUE	6.867268341139172e-93	162	77	55	0.7142857142857143	0.3395061728395062	GO:0009060	GO:BP	aerobic respiration	16175	3236		0.021739130434782608	0.0425531914893617	162	16013	55	22	107	15991	16175	0.489158021372542
R1	cpdb	0	network_modules	179	TRUE	1.296374578572965e-90	103	71	51	0.7183098591549296	0.49514563106796117	REAC:R-HSA-611105	REAC	Respiratory electron transport	10916	2081		0	0.1	103	10813	51	20	52	10793	10916	0.5932740603694806
R1	cpdb	0	network_modules	179	TRUE	3.3896812118270018e-90	177	71	57	0.8028169014084507	0.3220338983050847	REAC:R-HSA-1428517	REAC	Aerobic respiration and respiratory electron transport	10916	127		0.1111111111111111	0.2	177	10739	57	14	120	10725	10916	0.5039233812283865
R1	cpdb	0	network_modules	179	TRUE	1.1986439178070393e-88	188	77	55	0.7142857142857143	0.2925531914893617	GO:0045333	GO:BP	cellular respiration	16175	11360		0.043478260869565216	0.06382978723404255	188	15987	55	22	133	15965	16175	0.4534070458067197
R1	cpdb	0	network_modules	179	TRUE	7.459519140156952e-87	134	65	53	0.8153846153846154	0.39552238805970147	KEGG:00190	KEGG	Oxidative phosphorylation	8484	18		0	0.08333333333333333	134	8350	53	12	81	8338	8484	0.5635064580247764
R1	cpdb	0	network_modules	179	TRUE	1.2039821952306024e-83	88	77	45	0.5844155844155844	0.5113636363636364	GO:0042773	GO:BP	ATP synthesis coupled electron transport	16175	10358		0.06521739130434782	0.10638297872340426	88	16087	45	32	43	16055	16175	0.5443581158294584
R1	cpdb	0	network_modules	179	TRUE	1.2039821952306024e-83	88	77	45	0.5844155844155844	0.5113636363636364	GO:0042775	GO:BP	mitochondrial ATP synthesis coupled electron transport	16175	10360		0.06521739130434782	0.10638297872340426	88	16087	45	32	43	16055	16175	0.5443581158294584
R1	cpdb	0	network_modules	179	TRUE	7.899006080780075e-83	82	77	44	0.5714285714285714	0.5365853658536586	GO:0019646	GO:BP	aerobic electron transport chain	16175	5967		0.10869565217391304	0.1276595744680851	82	16093	44	33	38	16060	16175	0.5515311929970423
R1	cpdb	0	network_modules	179	TRUE	1.2389960056908095e-80	252	77	55	0.7142857142857143	0.21825396825396826	GO:0015980	GO:BP	energy derivation by oxidation of organic compounds	16175	5060		0.13043478260869565	0.14893617021276595	252	15923	55	22	197	15901	16175	0.390198429727705
R1	cpdb	0	network_modules	179	TRUE	1.5518220704402638e-80	99	77	45	0.5844155844155844	0.45454545454545453	GO:0022904	GO:BP	respiratory electron transport chain	16175	6631		0.15217391304347827	0.1702127659574468	99	16076	45	32	54	16044	16175	0.5127982716241944
R1	cpdb	0	network_modules	179	TRUE	5.615003682417153e-79	232	65	56	0.8615384615384616	0.2413793103448276	KEGG:04714	KEGG	Thermogenesis	8484	349		0.09090909090909091	0.16666666666666666	232	8252	56	9	176	8243	8484	0.449438171276467
R1	cpdb	0	network_modules	179	TRUE	1.4728615120458017e-78	107	77	45	0.5844155844155844	0.4205607476635514	GO:0022900	GO:BP	electron transport chain	16175	6630		0.17391304347826086	0.19148936170212766	107	16068	45	32	62	16036	16175	0.49295668042343876
R1	cpdb	0	network_modules	179	TRUE	1.6566187975907062e-75	202	65	53	0.8153846153846154	0.2623762376237624	KEGG:05415	KEGG	Diabetic cardiomyopathy	8484	492		0.18181818181818182	0.25	202	8282	53	12	149	8270	8484	0.45622166530185737
R1	cpdb	0	network_modules	179	TRUE	3.832246644421803e-73	221	65	53	0.8153846153846154	0.2398190045248869	KEGG:05208	KEGG	Chemical carcinogenesis - reactive oxygen species	8484	460		0.2727272727272727	0.3333333333333333	221	8263	53	12	168	8251	8484	0.4354354173504506
R1	cpdb	0	network_modules	179	TRUE	1.0505109817057053e-70	154	65	48	0.7384615384615385	0.3116883116883117	KEGG:04932	KEGG	Non-alcoholic fatty liver disease	8484	389		0.36363636363636365	0.4166666666666667	154	8330	48	17	106	8313	8484	0.4740929525575229
R1	cpdb	0	network_modules	179	TRUE	1.8469732332712382e-70	372	77	55	0.7142857142857143	0.1478494623655914	GO:0006091	GO:BP	generation of precursor metabolites and energy	16175	1954		0.1956521739130435	0.2127659574468085	372	15803	55	22	317	15781	16175	0.3189488227584292
R1	cpdb	0	network_modules	179	TRUE	1.8335450932605489e-68	265	65	53	0.8153846153846154	0.2	KEGG:05012	KEGG	Parkinson disease	8484	412		0.45454545454545453	0.5	265	8219	53	12	212	8207	8484	0.3960896027693918
R1	cpdb	0	network_modules	179	TRUE	6.8009115287925995e-68	271	65	53	0.8153846153846154	0.19557195571955718	KEGG:05020	KEGG	Prion disease	8484	416		0.5454545454545454	0.5833333333333334	271	8213	53	12	218	8201	8484	0.3914699693166127
R1	cpdb	0	network_modules	179	TRUE	6.499815113429825e-65	305	65	53	0.8153846153846154	0.1737704918032787	KEGG:05016	KEGG	Huntington disease	8484	414		0.6363636363636364	0.6666666666666666	305	8179	53	12	252	8167	8484	0.3678804726501348
R1	cpdb	0	network_modules	179	TRUE	1.1575637832692786e-62	363	65	54	0.8307692307692308	0.1487603305785124	KEGG:05014	KEGG	Amyotrophic lateral sclerosis	8484	413		0.7272727272727273	0.75	363	8121	54	11	309	8110	8484	0.342125746962914
R1	cpdb	0	network_modules	179	TRUE	1.3446390150431602e-61	65	77	34	0.44155844155844154	0.5230769230769231	GO:0042776	GO:BP	proton motive force-driven mitochondrial ATP synthesis	16175	10361		0.21739130434782608	0.23404255319148937	65	16110	34	43	31	16067	16175	0.4783181927880806
R1	cpdb	0	network_modules	179	TRUE	2.204614821578679e-61	382	65	54	0.8307692307692308	0.14136125654450263	KEGG:05010	KEGG	Alzheimer disease	8484	411		0.8181818181818182	0.8333333333333334	382	8102	54	11	328	8091	8484	0.3329507279877787
R1	cpdb	0	network_modules	179	TRUE	1.541272478566396e-59	72	77	34	0.44155844155844154	0.4722222222222222	GO:0015986	GO:BP	proton motive force-driven ATP synthesis	16175	5062		0.2391304347826087	0.2553191489361702	72	16103	34	43	38	16060	16175	0.4541213645970803
R1	cpdb	0	network_modules	179	TRUE	2.625182130440219e-55	90	77	34	0.44155844155844154	0.37777777777777777	GO:0006754	GO:BP	ATP biosynthetic process	16175	2451		0.2608695652173913	0.2765957446808511	90	16085	34	43	56	16042	16175	0.4053710351476867
R1	cpdb	0	network_modules	179	TRUE	6.613443473699701e-55	92	77	34	0.44155844155844154	0.3695652173913043	GO:0009145	GO:BP	purine nucleoside triphosphate biosynthetic process	16175	3312		0.2826086956521739	0.3191489361702128	92	16083	34	43	58	16040	16175	0.40085183279654496
R1	cpdb	0	network_modules	179	TRUE	6.613443473699701e-55	92	77	34	0.44155844155844154	0.3695652173913043	GO:0009206	GO:BP	purine ribonucleoside triphosphate biosynthetic process	16175	3372		0.2826086956521739	0.3191489361702128	92	16083	34	43	58	16040	16175	0.40085183279654496
R1	cpdb	0	network_modules	179	TRUE	5.985399208007618e-54	97	77	34	0.44155844155844154	0.35051546391752575	GO:0009201	GO:BP	ribonucleoside triphosphate biosynthetic process	16175	3367		0.32608695652173914	0.3404255319148936	97	16078	34	43	63	16035	16175	0.3901677134898851
R1	cpdb	0	network_modules	179	TRUE	7.02853868010758e-53	103	77	34	0.44155844155844154	0.3300970873786408	GO:0009142	GO:BP	nucleoside triphosphate biosynthetic process	16175	3309		0.34782608695652173	0.3617021276595745	103	16072	34	43	69	16029	16175	0.3783812540918443
R1	cpdb	0	network_modules	179	TRUE	9.703915202088142e-51	57	71	30	0.4225352112676056	0.5263157894736842	REAC:R-HSA-6799198	REAC	Complex I biogenesis	10916	391		0.2222222222222222	0.3	57	10859	30	41	27	10818	10916	0.4684983138070922
R1	cpdb	0	network_modules	179	TRUE	9.561422407226953e-50	46	77	27	0.35064935064935066	0.5869565217391305	GO:0006120	GO:BP	mitochondrial electron transport, NADH to ubiquinone	16175	1978		0.3695652173913043	0.3829787234042553	46	16129	27	50	19	16079	16175	0.45170764795994794
R1	cpdb	0	network_modules	179	TRUE	4.035770255935709e-49	128	77	34	0.44155844155844154	0.265625	GO:0009152	GO:BP	purine ribonucleotide biosynthetic process	16175	3319		0.391304347826087	0.40425531914893614	128	16047	34	43	94	16004	16175	0.33848242004674095
R1	cpdb	0	network_modules	179	TRUE	5.627058069274663e-48	137	77	34	0.44155844155844154	0.24817518248175183	GO:0009260	GO:BP	ribonucleotide biosynthetic process	16175	3425		0.41304347826086957	0.425531914893617	137	16038	34	43	103	15995	16175	0.3268474003009933
R1	cpdb	0	network_modules	179	TRUE	2.921395582339388e-47	143	77	34	0.44155844155844154	0.23776223776223776	GO:0046390	GO:BP	ribose phosphate biosynthetic process	16175	12117		0.43478260869565216	0.44680851063829785	143	16032	34	43	109	15989	16175	0.319702783331603
R1	cpdb	0	network_modules	179	TRUE	5.2662296421269423e-45	164	77	34	0.44155844155844154	0.2073170731707317	GO:0006164	GO:BP	purine nucleotide biosynthetic process	16175	1999		0.45652173913043476	0.46808510638297873	164	16011	34	43	130	15968	16175	0.2978325402729349
R1	cpdb	0	network_modules	179	TRUE	3.311820422445156e-43	109	77	30	0.38961038961038963	0.27522935779816515	GO:0097250	GO:BP	mitochondrial respirasome assembly	16175	18559		0.4782608695652174	0.48936170212765956	109	16066	30	47	79	16019	16175	0.32366050530687845
R1	cpdb	0	network_modules	179	TRUE	3.8350388497377555e-43	184	77	34	0.44155844155844154	0.18478260869565216	GO:0046034	GO:BP	ATP metabolic process	16175	11811		0.5	0.5106382978723404	184	15991	34	43	150	15948	16175	0.28054987000739356
R1	cpdb	0	network_modules	179	TRUE	5.719568866934717e-43	186	77	34	0.44155844155844154	0.1827956989247312	GO:0009165	GO:BP	nucleotide biosynthetic process	16175	3331		0.5217391304347826	0.5319148936170213	186	15989	34	43	152	15946	16175	0.27897470321521667
R1	cpdb	0	network_modules	179	TRUE	5.7141283129618355e-42	198	77	34	0.44155844155844154	0.1717171717171717	GO:0009205	GO:BP	purine ribonucleoside triphosphate metabolic process	16175	3371		0.5434782608695652	0.5531914893617021	198	15977	34	43	164	15934	16175	0.270023707609999
R1	cpdb	0	network_modules	179	TRUE	9.915435640704994e-42	201	77	34	0.44155844155844154	0.1691542288557214	GO:0009144	GO:BP	purine nucleoside triphosphate metabolic process	16175	3311		0.5652173913043478	0.574468085106383	201	15974	34	43	167	15931	16175	0.2679104031826664
R1	cpdb	0	network_modules	179	TRUE	1.705041886779634e-41	204	77	34	0.44155844155844154	0.16666666666666666	GO:0009199	GO:BP	ribonucleoside triphosphate metabolic process	16175	3365		0.5869565217391305	0.5957446808510638	204	15971	34	43	170	15928	16175	0.2658432054484342
R1	cpdb	0	network_modules	179	TRUE	1.135439848671321e-40	97	77	28	0.36363636363636365	0.28865979381443296	GO:0033108	GO:BP	mitochondrial respiratory chain complex assembly	16175	8042		0.6086956521739131	0.6170212765957447	97	16078	28	49	69	16029	16175	0.32036660230959796
R1	cpdb	0	network_modules	179	TRUE	1.1567279265119894e-40	215	77	34	0.44155844155844154	0.15813953488372093	GO:0009141	GO:BP	nucleoside triphosphate metabolic process	16175	3308		0.6304347826086957	0.6382978723404256	215	15960	34	43	181	15917	16175	0.25863181213122727
R1	cpdb	0	network_modules	179	TRUE	1.884773697273862e-40	61	77	25	0.3246753246753247	0.4098360655737705	GO:0010257	GO:BP	NADH dehydrogenase complex assembly	16175	4030		0.6521739130434783	0.6808510638297872	61	16114	25	52	36	16062	16175	0.3620864910633116
R1	cpdb	0	network_modules	179	TRUE	1.884773697273862e-40	61	77	25	0.3246753246753247	0.4098360655737705	GO:0032981	GO:BP	mitochondrial respiratory chain complex I assembly	16175	7963		0.6521739130434783	0.6808510638297872	61	16114	25	52	36	16062	16175	0.3620864910633116
R1	cpdb	0	network_modules	179	TRUE	2.665358673492096e-40	220	77	34	0.44155844155844154	0.15454545454545454	GO:0072522	GO:BP	purine-containing compound biosynthetic process	16175	17424		0.6956521739130435	0.7021276595744681	220	15955	34	43	186	15912	16175	0.2555314081820476
R1	cpdb	0	network_modules	179	TRUE	1.0843371934861298e-37	260	77	34	0.44155844155844154	0.13076923076923078	GO:1901293	GO:BP	nucleoside phosphate biosynthetic process	16175	21368		0.717391304347826	0.723404255319149	260	15915	34	43	226	15872	16175	0.23398994028451245
R1	cpdb	0	network_modules	179	TRUE	2.4452667460599905e-37	266	77	34	0.44155844155844154	0.12781954887218044	GO:0009150	GO:BP	purine ribonucleotide metabolic process	16175	3317		0.7391304347826086	0.7446808510638298	266	15909	34	43	232	15866	16175	0.2311778040071474
R1	cpdb	0	network_modules	179	TRUE	9.079302154501397e-37	276	77	34	0.44155844155844154	0.12318840579710146	GO:0009259	GO:BP	ribonucleotide metabolic process	16175	3424		0.7608695652173914	0.7659574468085106	276	15899	34	43	242	15856	16175	0.22669236728340458
R1	cpdb	0	network_modules	179	TRUE	2.2061979355726052e-36	283	77	34	0.44155844155844154	0.12014134275618374	GO:0019693	GO:BP	ribose phosphate metabolic process	16175	6010		0.782608695652174	0.7872340425531915	283	15892	34	43	249	15849	16175	0.22369221228024397
R1	cpdb	0	network_modules	179	TRUE	1.254590978299439e-34	148	65	30	0.46153846153846156	0.20270270270270271	KEGG:04723	KEGG	Retrograde endocannabinoid signaling	8484	353		0.9090909090909091	0.9166666666666666	148	8336	30	35	118	8301	8484	0.2980520692971525
R1	cpdb	0	network_modules	179	TRUE	3.458841496057062e-33	349	77	34	0.44155844155844154	0.09742120343839542	GO:0006163	GO:BP	purine nucleotide metabolic process	16175	1998		0.8043478260869565	0.8085106382978723	349	15826	34	43	315	15783	16175	0.1999106843967813
R1	cpdb	0	network_modules	179	TRUE	1.358741914251294e-31	388	77	34	0.44155844155844154	0.08762886597938144	GO:0009117	GO:BP	nucleotide metabolic process	16175	3286		0.8260869565217391	0.8297872340425532	388	15787	34	43	354	15744	16175	0.18874182553663033
R1	cpdb	0	network_modules	179	TRUE	2.6998130456031957e-30	514	77	36	0.4675324675324675	0.07003891050583658	GO:1901137	GO:BP	carbohydrate derivative biosynthetic process	16175	21245		0.8478260869565217	0.851063829787234	514	15661	36	41	478	15620	16175	0.17181251625733449
R1	cpdb	0	network_modules	179	TRUE	1.9188593316114624e-29	364	77	32	0.4155844155844156	0.08791208791208792	GO:0007005	GO:BP	mitochondrion organization	16175	2617		0.8695652173913043	0.8723404255319149	364	15811	32	45	332	15766	16175	0.1832968012434327
R1	cpdb	0	network_modules	179	TRUE	6.599578540378528e-29	512	77	35	0.45454545454545453	0.068359375	GO:0090407	GO:BP	organophosphate biosynthetic process	16175	18274		0.8913043478260869	0.8936170212765957	512	15663	35	42	477	15621	16175	0.1670553406655668
R1	cpdb	0	network_modules	179	TRUE	8.994132942546706e-29	469	77	34	0.44155844155844154	0.07249466950959488	GO:0072521	GO:BP	purine-containing compound metabolic process	16175	17423		0.9130434782608695	0.9148936170212766	469	15706	34	43	435	15663	16175	0.17004929329170365
R1	cpdb	0	network_modules	179	TRUE	3.1678129896715996e-27	521	77	34	0.44155844155844154	0.06525911708253358	GO:0006753	GO:BP	nucleoside phosphate metabolic process	16175	2450		0.9347826086956522	0.9361702127659575	521	15654	34	43	487	15611	16175	0.16034857034606628
R1	cpdb	0	network_modules	179	TRUE	3.1863983062873386e-26	558	77	34	0.44155844155844154	0.06093189964157706	GO:0055086	GO:BP	nucleobase-containing small molecule metabolic process	16175	14237		0.9565217391304348	0.9574468085106383	558	15617	34	43	524	15574	16175	0.1542577614997055
R1	cpdb	0	network_modules	179	TRUE	7.050635129333009e-20	87	65	18	0.27692307692307694	0.20689655172413793	KEGG:04260	KEGG	Cardiac muscle contraction	8484	296		1	1	87	8397	18	47	69	8350	8484	0.23258251694480403
R1	cpdb	0	network_modules	179	TRUE	6.321009017780731e-16	19	77	10	0.12987012987012986	0.5263157894736842	GO:0006123	GO:BP	mitochondrial electron transport, cytochrome c to oxygen	16175	1981		0.9782608695652174	0.9787234042553191	19	16156	10	67	9	16089	16175	0.2598503186326312
R1	cpdb	0	network_modules	179	TRUE	3.039561887802937e-14	62	71	13	0.18309859154929578	0.20967741935483872	REAC:R-HSA-9707564	REAC	Cytoprotection by HMOX1	10916	426		0.3333333333333333	0.4	62	10854	13	58	49	10796	10916	0.1910235636814528
R1	cpdb	0	network_modules	179	TRUE	4.979360424376354e-13	13	77	8	0.1038961038961039	0.6153846153846154	GO:0006122	GO:BP	mitochondrial electron transport, ubiquinol to cytochrome c	16175	1980		1	1	13	16162	8	69	5	16093	16175	0.2516002624995449
R1	cpdb	0	network_modules	179	TRUE	2.052383947848117e-12	84	71	13	0.18309859154929578	0.15476190476190477	REAC:R-HSA-5628897	REAC	TP53 Regulates Metabolic Genes	10916	2452		0.4444444444444444	0.5	84	10832	13	58	71	10774	10916	0.1624134991385264
R1	cpdb	0	network_modules	179	TRUE	3.148494988238616e-7	211	71	13	0.18309859154929578	0.061611374407582936	REAC:R-HSA-9711123	REAC	Cellular response to chemical stress	10916	333		0.5555555555555556	0.6	211	10705	13	58	198	10647	10916	0.0962444066362867
R1	cpdb	0	network_modules	179	TRUE	3.2380908956133226e-5	18	71	5	0.07042253521126761	0.2777777777777778	REAC:R-HSA-163210	REAC	Formation of ATP by chemiosmotic coupling	10916	944		0.6666666666666666	0.7	18	10898	5	66	13	10832	10916	0.13714813241783394
R1	cpdb	0	network_modules	179	TRUE	1.75259331408627e-4	359	71	13	0.18309859154929578	0.036211699164345405	REAC:R-HSA-3700989	REAC	Transcriptional Regulation by TP53	10916	2546		0.7777777777777778	0.8	359	10557	13	58	346	10499	10916	0.06814946125245078
R1	cpdb	0	network_modules	179	TRUE	6.013630048829796e-4	31	71	5	0.07042253521126761	0.16129032258064516	REAC:R-HSA-8949613	REAC	Cristae formation	10916	414		0.8888888888888888	0.9	31	10885	5	66	26	10819	10916	0.10275860187089284
R1	cpdb	0	network_modules	179	TRUE	0.0014911061014627172	65	71	6	0.08450704225352113	0.09230769230769231	REAC:R-HSA-1268020	REAC	Mitochondrial protein import	10916	1468		1	1	65	10851	6	65	59	10786	10916	0.08261259508148647
R1	cpdb	0	network_modules	180	TRUE	1.250630097317645e-12	111	15	9	0.6	0.08108108108108109	REAC:R-HSA-166658	REAC	Complement cascade	10916	390		0	0.25	111	10805	9	6	102	10799	10916	0.2180871263286566
R1	cpdb	0	network_modules	180	TRUE	5.374233108195629e-12	86	13	8	0.6153846153846154	0.09302325581395349	KEGG:04610	KEGG	Complement and coagulation cascades	8484	320		NA	1	86	8398	8	5	78	8393	8484	0.23670155804205267
R1	cpdb	0	network_modules	180	TRUE	7.774607789962598e-11	101	15	8	0.5333333333333333	0.07920792079207921	REAC:R-HSA-977606	REAC	Regulation of Complement cascade	10916	1971		0.3333333333333333	0.5	101	10815	8	7	93	10808	10916	0.20304875779885403
R1	cpdb	0	network_modules	180	TRUE	1.7839733758295857e-10	56	18	7	0.3888888888888889	0.125	GO:0006956	GO:BP	complement activation	16175	2587		0	0.09090909090909091	56	16119	7	11	49	16108	16175	0.2190175809871704
R1	cpdb	0	network_modules	180	TRUE	2.398666841102998e-6	536	18	9	0.5	0.016791044776119403	GO:0002252	GO:BP	immune effector process	16175	784		0.1	0.18181818181818182	536	15639	9	9	527	15630	16175	0.08705670631440775
R1	cpdb	0	network_modules	180	TRUE	3.552507671147552e-6	224	18	7	0.3888888888888889	0.03125	GO:0006959	GO:BP	humoral immune response	16175	2590		0.2	0.2727272727272727	224	15951	7	11	217	15940	16175	0.10711744775427438
R1	cpdb	0	network_modules	180	TRUE	9.225033858072778e-5	8	18	3	0.16666666666666666	0.375	GO:0051838	GO:BP	cytolysis by host of symbiont cells	16175	13951		0.3	0.36363636363636365	8	16167	3	15	5	16152	16175	0.24945861854572904
R1	cpdb	0	network_modules	180	TRUE	6.187957597592429e-4	475	18	7	0.3888888888888889	0.014736842105263158	GO:0002253	GO:BP	activation of immune response	16175	785		0.4	0.45454545454545453	475	15700	7	11	468	15689	16175	0.07107710385542988
R1	cpdb	0	network_modules	180	TRUE	9.036880949045994e-4	756	18	8	0.4444444444444444	0.010582010582010581	GO:0050776	GO:BP	regulation of immune response	16175	13250		0.5	0.5454545454545454	756	15419	8	10	748	15409	16175	0.06288874647459174
R1	cpdb	0	network_modules	180	TRUE	0.0012494467554751449	168	18	5	0.2777777777777778	0.02976190476190476	GO:0001906	GO:BP	cell killing	16175	524		0.6	0.6363636363636364	168	16007	5	13	163	15994	16175	0.08803147265233625
R1	cpdb	0	network_modules	180	TRUE	0.0025122880252617915	22	18	3	0.16666666666666666	0.13636363636363635	GO:0051873	GO:BP	killing by host of symbiont cells	16175	13960		0.7	0.7272727272727273	22	16153	3	15	19	16138	16175	0.14971050876290892
R1	cpdb	0	network_modules	180	TRUE	0.003297271735169593	24	18	3	0.16666666666666666	0.125	GO:0140353	GO:BP	lipid export from cell	16175	19749		0.8	0.8181818181818182	24	16151	3	15	21	16136	16175	0.1432385527576149
R1	cpdb	0	network_modules	180	TRUE	0.003446951663930191	107	15	4	0.26666666666666666	0.037383177570093455	REAC:R-HSA-8957275	REAC	Post-translational protein phosphorylation	10916	1777		0.6666666666666666	0.75	107	10809	4	11	103	10798	10916	0.09671536964437824
R1	cpdb	0	network_modules	180	TRUE	0.003980716310929161	627	18	7	0.3888888888888889	0.011164274322169059	GO:0050778	GO:BP	positive regulation of immune response	16175	13252		0.9	0.9090909090909091	627	15548	7	11	620	15537	16175	0.06054143594431163
R1	cpdb	0	network_modules	180	TRUE	0.0059320058446771335	29	18	3	0.16666666666666666	0.10344827586206896	GO:0042551	GO:BP	neuron maturation	16175	10242		1	1	29	16146	3	15	26	16131	16175	0.13008292443451058
R1	cpdb	0	network_modules	180	TRUE	0.0061803130311473	124	15	4	0.26666666666666666	0.03225806451612903	REAC:R-HSA-381426	REAC	Regulation of Insulin-like Growth Factor (IGF) transport and uptake by Insulin-like Growth Factor Binding Proteins (IGFBPs)	10916	1981		1	1	124	10792	4	11	120	10781	10916	0.08936701021612989
R1	cpdb	0	network_modules	181	TRUE	0.005201303028186909	365	12	5	0.4166666666666667	0.0136986301369863	KEGG:04080	KEGG	Neuroactive ligand-receptor interaction	8484	263		NA	1	365	8119	5	7	360	8112	8484	0.06930414479675827
R1	cpdb	0	network_modules	181	TRUE	0.00853327964827157	41	16	3	0.1875	0.07317073170731707	REAC:R-HSA-383280	REAC	Nuclear Receptor transcription pathway	10916	1616		NA	1	41	10875	3	13	38	10862	10916	0.11508453891527895
R1	cpdb	0	network_modules	182	TRUE	1.8061394633865058e-9	10	24	5	0.20833333333333334	0.5	GO:0071358	GO:BP	cellular response to type III interferon	16175	16610		0	0.0625	10	16165	5	19	5	16146	16175	0.32212943168263275
R1	cpdb	0	network_modules	182	TRUE	1.8061394633865058e-9	10	24	5	0.20833333333333334	0.5	GO:0038196	GO:BP	type III interferon-mediated signaling pathway	16175	9765		0	0.0625	10	16165	5	19	5	16146	16175	0.32212943168263275
R1	cpdb	0	network_modules	182	TRUE	1.8326346076679412e-9	25	22	6	0.2727272727272727	0.24	REAC:R-HSA-8854691	REAC	Interleukin-20 family signaling	10916	1242		0	0.05555555555555555	25	10891	6	16	19	10875	10916	0.25423977701580963
R1	cpdb	0	network_modules	182	TRUE	3.3080129640261837e-9	11	24	5	0.20833333333333334	0.45454545454545453	GO:0034342	GO:BP	response to type III interferon	16175	8580		0.06451612903225806	0.09375	11	16164	5	19	6	16145	16175	0.3070564438264654
R1	cpdb	0	network_modules	182	TRUE	4.827959903390332e-8	89	20	7	0.35	0.07865168539325842	KEGG:04658	KEGG	Th1 and Th2 cell differentiation	8484	336		0	0.14285714285714285	89	8395	7	13	82	8382	8484	0.16198493247010048
R1	cpdb	0	network_modules	182	TRUE	9.74436565073972e-8	162	20	8	0.4	0.04938271604938271	KEGG:04630	KEGG	JAK-STAT signaling pathway	8484	332		0.16666666666666666	0.2857142857142857	162	8322	8	12	154	8310	8484	0.1352924018670013
R1	cpdb	0	network_modules	182	TRUE	2.197431370406924e-7	60	20	6	0.3	0.1	KEGG:04330	KEGG	Notch signaling pathway	8484	301		0.3333333333333333	0.42857142857142855	60	8424	6	14	54	8410	8484	0.16992360418213465
R1	cpdb	0	network_modules	182	TRUE	5.771912836735142e-6	14	24	4	0.16666666666666666	0.2857142857142857	GO:0002486	GO:BP	antigen processing and presentation of endogenous peptide antigen via MHC class I via ER pathway, TAP-independent	16175	1009		0.0967741935483871	0.15625	14	16161	4	20	10	16141	16175	0.2173399504793674
R1	cpdb	0	network_modules	182	TRUE	5.771912836735142e-6	14	24	4	0.16666666666666666	0.2857142857142857	GO:0002484	GO:BP	antigen processing and presentation of endogenous peptide antigen via MHC class I via ER pathway	16175	1007		0.0967741935483871	0.15625	14	16161	4	20	10	16141	16175	0.2173399504793674
R1	cpdb	0	network_modules	182	TRUE	6.978543318491584e-6	419	24	9	0.375	0.021479713603818614	GO:0019221	GO:BP	cytokine-mediated signaling pathway	16175	5598		0.16129032258064516	0.1875	419	15756	9	15	410	15741	16175	0.08471588679671868
R1	cpdb	0	network_modules	182	TRUE	7.863001877529722e-6	15	24	4	0.16666666666666666	0.26666666666666666	GO:0002428	GO:BP	antigen processing and presentation of peptide antigen via MHC class Ib	16175	951		0.1935483870967742	0.25	15	16160	4	20	11	16140	16175	0.20989854079427026
R1	cpdb	0	network_modules	182	TRUE	7.863001877529722e-6	15	24	4	0.16666666666666666	0.26666666666666666	GO:0002476	GO:BP	antigen processing and presentation of endogenous peptide antigen via MHC class Ib	16175	999		0.1935483870967742	0.25	15	16160	4	20	11	16140	16175	0.20989854079427026
R1	cpdb	0	network_modules	182	TRUE	9.680940642371288e-6	291	20	8	0.4	0.027491408934707903	KEGG:04060	KEGG	Cytokine-cytokine receptor interaction	8484	253		0.5	0.5714285714285714	291	8193	8	12	283	8181	8484	0.09767535238688778
R1	cpdb	0	network_modules	182	TRUE	1.101423424868488e-5	48	22	5	0.22727272727272727	0.10416666666666667	REAC:R-HSA-9012852	REAC	Signaling by NOTCH3	10916	2282		0.058823529411764705	0.1111111111111111	48	10868	5	17	43	10851	10916	0.15137289002215365
R1	cpdb	0	network_modules	182	TRUE	2.7771520057808218e-5	20	24	4	0.16666666666666666	0.2	GO:0019885	GO:BP	antigen processing and presentation of endogenous peptide antigen via MHC class I	16175	6063		0.25806451612903225	0.3125	20	16155	4	20	16	16135	16175	0.18146651247757528
R1	cpdb	0	network_modules	182	TRUE	2.7771520057808218e-5	20	24	4	0.16666666666666666	0.2	GO:0002475	GO:BP	antigen processing and presentation via MHC class Ib	16175	998		0.25806451612903225	0.3125	20	16155	4	20	16	16135	16175	0.18146651247757528
R1	cpdb	0	network_modules	182	TRUE	4.184660472996148e-5	22	24	4	0.16666666666666666	0.18181818181818182	GO:0002483	GO:BP	antigen processing and presentation of endogenous peptide antigen	16175	1006		0.3225806451612903	0.34375	22	16153	4	20	18	16133	16175	0.17290291232352828
R1	cpdb	0	network_modules	182	TRUE	4.267628087560805e-5	24	22	4	0.18181818181818182	0.16666666666666666	REAC:R-HSA-9013508	REAC	NOTCH3 Intracellular Domain Regulates Transcription	10916	1536		0.11764705882352941	0.16666666666666666	24	10892	4	18	20	10874	10916	0.17233576147403248
R1	cpdb	0	network_modules	182	TRUE	5.18286535260573e-5	64	24	5	0.20833333333333334	0.078125	GO:0098586	GO:BP	cellular response to virus	16175	18801		0.3548387096774194	0.375	64	16111	5	19	59	16092	16175	0.12549607902682272
R1	cpdb	0	network_modules	182	TRUE	7.966057867044521e-5	555	24	9	0.375	0.016216216216216217	GO:0071345	GO:BP	cellular response to cytokine stimulus	16175	16597		0.3870967741935484	0.40625	555	15620	9	15	546	15605	16175	0.07214724703133701
R1	cpdb	0	network_modules	182	TRUE	8.17985580895041e-5	28	22	4	0.18181818181818182	0.14285714285714285	REAC:R-HSA-350054	REAC	Notch-HLH transcription pathway	10916	1610		0.17647058823529413	0.2222222222222222	28	10888	4	18	24	10870	10916	0.15925566188323498
R1	cpdb	0	network_modules	182	TRUE	8.943139015632971e-5	6	24	3	0.125	0.5	GO:0007221	GO:BP	positive regulation of transcription of Notch receptor target	16175	2775		0.41935483870967744	0.4375	6	16169	3	21	3	16148	16175	0.249489518890329
R1	cpdb	0	network_modules	182	TRUE	1.1643667176113948e-4	28	24	4	0.16666666666666666	0.14285714285714285	GO:0019883	GO:BP	antigen processing and presentation of endogenous antigen	16175	6061		0.45161290322580644	0.46875	28	16147	4	20	24	16127	16175	0.1529465441689966
R1	cpdb	0	network_modules	182	TRUE	1.6240086054188384e-4	33	22	4	0.18181818181818182	0.12121212121212122	REAC:R-HSA-1980145	REAC	Signaling by NOTCH2	10916	2281		0.23529411764705882	0.2777777777777778	33	10883	4	18	29	10865	10916	0.1463543048521924
R1	cpdb	0	network_modules	182	TRUE	2.2008922405769172e-4	625	24	9	0.375	0.0144	GO:1901652	GO:BP	response to peptide	16175	21619		0.4838709677419355	0.53125	625	15550	9	15	616	15535	16175	0.06727434835789849
R1	cpdb	0	network_modules	182	TRUE	2.2008922405769172e-4	625	24	9	0.375	0.0144	GO:0034097	GO:BP	response to cytokine	16175	8408		0.4838709677419355	0.53125	625	15550	9	15	616	15535	16175	0.06727434835789849
R1	cpdb	0	network_modules	182	TRUE	2.3155350559415187e-4	33	24	4	0.16666666666666666	0.12121212121212122	GO:0002474	GO:BP	antigen processing and presentation of peptide antigen via MHC class I	16175	997		0.5483870967741935	0.5625	33	16142	4	20	29	16122	16175	0.14064174805694146
R1	cpdb	0	network_modules	182	TRUE	2.6216757834744833e-4	34	24	4	0.16666666666666666	0.11764705882352941	GO:0001916	GO:BP	positive regulation of T cell mediated cytotoxicity	16175	533		0.5806451612903226	0.59375	34	16141	4	20	30	16121	16175	0.1385103077811109
R1	cpdb	0	network_modules	182	TRUE	3.2385503573270825e-4	39	22	4	0.18181818181818182	0.10256410256410256	REAC:R-HSA-186712	REAC	Regulation of beta-cell development	10916	2022		0.29411764705882354	0.3333333333333333	39	10877	4	18	35	10859	10916	0.13424952368063076
R1	cpdb	0	network_modules	182	TRUE	4.02652388735314e-4	96	24	5	0.20833333333333334	0.052083333333333336	GO:0140888	GO:BP	interferon-mediated signaling pathway	16175	19923		0.6129032258064516	0.625	96	16079	5	19	91	16060	16175	0.10157616616915773
R1	cpdb	0	network_modules	182	TRUE	5.05697357383188e-4	124	20	5	0.25	0.04032258064516129	KEGG:04650	KEGG	Natural killer cell mediated cytotoxicity	8484	334		0.6666666666666666	0.7142857142857143	124	8360	5	15	119	8345	8484	0.09534353589317596
R1	cpdb	0	network_modules	182	TRUE	5.1498583784505e-4	12	22	3	0.13636363636363635	0.25	REAC:R-HSA-2197563	REAC	NOTCH2 intracellular domain regulates transcription	10916	1534		0.35294117647058826	0.3888888888888889	12	10904	3	19	9	10885	10916	0.183434462507226
R1	cpdb	0	network_modules	182	TRUE	6.277572331977316e-4	42	24	4	0.16666666666666666	0.09523809523809523	GO:0001914	GO:BP	regulation of T cell mediated cytotoxicity	16175	531		0.6451612903225806	0.65625	42	16133	4	20	38	16113	16175	0.12427888405333369
R1	cpdb	0	network_modules	182	TRUE	7.387528649782629e-4	721	24	9	0.375	0.012482662968099861	GO:0045087	GO:BP	innate immune response	16175	11270		0.6774193548387096	0.6875	721	15454	9	15	712	15439	16175	0.06172129999880762
R1	cpdb	0	network_modules	182	TRUE	7.598393850199763e-4	109	24	5	0.20833333333333334	0.045871559633027525	GO:0007219	GO:BP	Notch signaling pathway	16175	2773		0.7096774193548387	0.71875	109	16066	5	19	104	16047	16175	0.09498648886102821
R1	cpdb	0	network_modules	182	TRUE	8.331566585486729e-4	45	24	4	0.16666666666666666	0.08888888888888889	GO:0001913	GO:BP	T cell mediated cytotoxicity	16175	530		0.7419354838709677	0.75	45	16130	4	20	41	16110	16175	0.11994023481958847
R1	cpdb	0	network_modules	182	TRUE	8.498439983605701e-4	14	22	3	0.13636363636363635	0.21428571428571427	REAC:R-HSA-8941856	REAC	RUNX3 regulates NOTCH signaling	10916	1934		0.4117647058823529	0.4444444444444444	14	10902	3	19	11	10883	10916	0.1696128348949038
R1	cpdb	0	network_modules	182	TRUE	0.0013040405928422382	16	22	3	0.13636363636363635	0.1875	REAC:R-HSA-210744	REAC	Regulation of gene expression in late stage (branching morphogenesis) pancreatic bud precursor cells	10916	2037		0.47058823529411764	0.5	16	10900	3	19	13	10881	10916	0.15845761835371047
R1	cpdb	0	network_modules	182	TRUE	0.0015187466701631952	57	22	4	0.18181818181818182	0.07017543859649122	REAC:R-HSA-2894862	REAC	Constitutive Signaling by NOTCH1 HD+PEST Domain Mutants	10916	405		0.5294117647058824	0.7777777777777778	57	10859	4	18	53	10841	10916	0.1101110495348271
R1	cpdb	0	network_modules	182	TRUE	0.0015187466701631952	57	22	4	0.18181818181818182	0.07017543859649122	REAC:R-HSA-2644606	REAC	Constitutive Signaling by NOTCH1 PEST Domain Mutants	10916	406		0.5294117647058824	0.7777777777777778	57	10859	4	18	53	10841	10916	0.1101110495348271
R1	cpdb	0	network_modules	182	TRUE	0.0015187466701631952	57	22	4	0.18181818181818182	0.07017543859649122	REAC:R-HSA-2894858	REAC	Signaling by NOTCH1 HD+PEST Domain Mutants in Cancer	10916	2277		0.5294117647058824	0.7777777777777778	57	10859	4	18	53	10841	10916	0.1101110495348271
R1	cpdb	0	network_modules	182	TRUE	0.0015187466701631952	57	22	4	0.18181818181818182	0.07017543859649122	REAC:R-HSA-2644602	REAC	Signaling by NOTCH1 PEST Domain Mutants in Cancer	10916	2278		0.5294117647058824	0.7777777777777778	57	10859	4	18	53	10841	10916	0.1101110495348271
R1	cpdb	0	network_modules	182	TRUE	0.0015187466701631952	57	22	4	0.18181818181818182	0.07017543859649122	REAC:R-HSA-2644603	REAC	Signaling by NOTCH1 in Cancer	10916	2279		0.5294117647058824	0.7777777777777778	57	10859	4	18	53	10841	10916	0.1101110495348271
R1	cpdb	0	network_modules	182	TRUE	0.0021827384827985113	57	24	4	0.16666666666666666	0.07017543859649122	GO:0001912	GO:BP	positive regulation of leukocyte mediated cytotoxicity	16175	529		0.7741935483870968	0.8125	57	16118	4	20	53	16098	16175	0.10612675132307738
R1	cpdb	0	network_modules	182	TRUE	0.0021827384827985113	57	24	4	0.16666666666666666	0.07017543859649122	GO:0002711	GO:BP	positive regulation of T cell mediated immunity	16175	1229		0.7741935483870968	0.8125	57	16118	4	20	53	16098	16175	0.10612675132307738
R1	cpdb	0	network_modules	182	TRUE	0.0025099494621158825	59	24	4	0.16666666666666666	0.06779661016949153	GO:0042267	GO:BP	natural killer cell mediated cytotoxicity	16175	10065		0.8387096774193549	0.84375	59	16116	4	20	55	16096	16175	0.10423989308450525
R1	cpdb	0	network_modules	182	TRUE	0.002640818442917265	20	22	3	0.13636363636363635	0.15	REAC:R-HSA-9013695	REAC	NOTCH4 Intracellular Domain Regulates Transcription	10916	1538		0.8235294117647058	0.8333333333333334	20	10896	3	19	17	10877	10916	0.14136975430520027
R1	cpdb	0	network_modules	182	TRUE	0.0026865693280671023	60	24	4	0.16666666666666666	0.06666666666666667	GO:0002228	GO:BP	natural killer cell mediated immunity	16175	761		0.8709677419354839	0.875	60	16115	4	20	56	16095	16175	0.10333158190001307
R1	cpdb	0	network_modules	182	TRUE	0.0030673011598895588	62	24	4	0.16666666666666666	0.06451612903225806	GO:0048002	GO:BP	antigen processing and presentation of peptide antigen	16175	12460		0.9032258064516129	0.90625	62	16113	4	20	58	16093	16175	0.10158045498144225
R1	cpdb	0	network_modules	182	TRUE	0.003272011310529916	63	24	4	0.16666666666666666	0.06349206349206349	GO:0031343	GO:BP	positive regulation of cell killing	16175	7134		0.9354838709677419	0.9375	63	16112	4	20	59	16092	16175	0.10073590181751142
R1	cpdb	0	network_modules	182	TRUE	0.0038778496075179327	72	22	4	0.18181818181818182	0.05555555555555555	REAC:R-HSA-1980143	REAC	Signaling by NOTCH1	10916	2275		0.8823529411764706	0.8888888888888888	72	10844	4	18	68	10826	10916	0.09727689562172932
R1	cpdb	0	network_modules	182	TRUE	0.004448555656175176	98	20	4	0.2	0.04081632653061224	KEGG:04061	KEGG	Viral protein interaction with cytokine and cytokine receptor	8484	254		0.8333333333333334	0.8571428571428571	98	8386	4	16	94	8370	8484	0.08572960904259658
R1	cpdb	0	network_modules	182	TRUE	0.004664176146263619	24	22	3	0.13636363636363635	0.125	REAC:R-HSA-449836	REAC	Other interleukin signaling	10916	1651		0.9411764705882353	0.9444444444444444	24	10892	3	19	21	10873	10916	0.12872445833395138
R1	cpdb	0	network_modules	182	TRUE	0.00510392865919524	330	20	6	0.3	0.01818181818181818	KEGG:05165	KEGG	Human papillomavirus infection	8484	446		1	1	330	8154	6	14	324	8140	8484	0.06564441610744912
R1	cpdb	0	network_modules	182	TRUE	0.007719848308882638	78	24	4	0.16666666666666666	0.05128205128205128	GO:0001910	GO:BP	regulation of leukocyte mediated cytotoxicity	16175	527		0.967741935483871	0.96875	78	16097	4	20	74	16077	16175	0.0900592098467906
R1	cpdb	0	network_modules	182	TRUE	0.008542609148804024	80	24	4	0.16666666666666666	0.05	GO:0002709	GO:BP	regulation of T cell mediated immunity	16175	1227		1	1	80	16095	4	20	76	16075	16175	0.08886392631018665
R1	cpdb	0	network_modules	182	TRUE	0.008722660682911146	472	22	7	0.3181818181818182	0.014830508474576272	REAC:R-HSA-449147	REAC	Signaling by Interleukins	10916	2261		1	1	472	10444	7	15	465	10429	10916	0.06074613987783948
R1	cpdb	0	network_modules	184	TRUE	7.84168117201655e-7	12	18	4	0.2222222222222222	0.3333333333333333	REAC:R-HSA-9755779	REAC	SARS-CoV-2 targets host intracellular signalling and regulatory pathways	10916	2127		0	0.07692307692307693	12	10904	4	14	8	10890	10916	0.27119182331547365
R1	cpdb	0	network_modules	184	TRUE	1.226702146600332e-4	510	20	8	0.4	0.01568627450980392	GO:0007169	GO:BP	cell surface receptor protein tyrosine kinase signaling pathway	16175	2733		0	0.5	510	15665	8	12	502	15653	16175	0.07419207007347135
R1	cpdb	0	network_modules	184	TRUE	2.2725388213934179e-4	119	18	5	0.2777777777777778	0.04201680672268908	KEGG:04660	KEGG	T cell receptor signaling pathway	8484	338		0	0.16666666666666666	119	8365	5	13	114	8352	8484	0.10341560085767489
R1	cpdb	0	network_modules	184	TRUE	2.532890188986026e-4	12	18	3	0.16666666666666666	0.25	REAC:R-HSA-9614399	REAC	Regulation of localization of FOXO transcription factors	10916	2042		0.08333333333333333	0.15384615384615385	12	10904	3	15	9	10889	10916	0.20305681265188247
R1	cpdb	0	network_modules	184	TRUE	3.2893626725219796e-4	13	18	3	0.16666666666666666	0.23076923076923078	REAC:R-HSA-75035	REAC	Chk1/Chk2(Cds1) mediated inactivation of Cyclin B:Cdk1 complex	10916	347		0.16666666666666666	0.23076923076923078	13	10903	3	15	10	10888	10916	0.1949916727240632
R1	cpdb	0	network_modules	184	TRUE	4.7982922634148145e-4	54	18	4	0.2222222222222222	0.07407407407407407	REAC:R-HSA-109606	REAC	Intrinsic Pathway for Apoptosis	10916	1268		0.25	0.3076923076923077	54	10862	4	14	50	10848	10916	0.12585922908696306
R1	cpdb	0	network_modules	184	TRUE	5.222292692891012e-4	15	18	3	0.16666666666666666	0.2	REAC:R-HSA-9735871	REAC	SARS-CoV-1 targets host intracellular signalling and regulatory pathways	10916	2118		0.3333333333333333	0.46153846153846156	15	10901	3	15	12	10886	10916	0.1813430115663804
R1	cpdb	0	network_modules	184	TRUE	5.222292692891012e-4	15	18	3	0.16666666666666666	0.2	REAC:R-HSA-111447	REAC	Activation of BAD and translocation to mitochondria 	10916	76		0.3333333333333333	0.46153846153846156	15	10901	3	15	12	10886	10916	0.1813430115663804
R1	cpdb	0	network_modules	184	TRUE	7.329955860201419e-4	70	18	4	0.2222222222222222	0.05714285714285714	KEGG:04920	KEGG	Adipocytokine signaling pathway	8484	377		0.2	0.3333333333333333	70	8414	4	14	66	8400	8484	0.10906947656503499
R1	cpdb	0	network_modules	184	TRUE	0.0017102187882444603	74	18	4	0.2222222222222222	0.05405405405405406	REAC:R-HSA-9013106	REAC	RHOC GTPase cycle	10916	1865		0.5	0.5384615384615384	74	10842	4	14	70	10828	10916	0.10670593405676138
R1	cpdb	0	network_modules	184	TRUE	0.0019033593266696196	89	18	4	0.2222222222222222	0.0449438202247191	KEGG:05235	KEGG	PD-L1 expression and PD-1 checkpoint pathway in cancer	8484	480		0.4	0.5	89	8395	4	14	85	8381	8484	0.09582497084684488
R1	cpdb	0	network_modules	184	TRUE	0.002296169876878316	176	18	5	0.2777777777777778	0.028409090909090908	REAC:R-HSA-109581	REAC	Apoptosis	10916	158		0.5833333333333334	0.6153846153846154	176	10740	5	13	171	10727	10916	0.08442991847955146
R1	cpdb	0	network_modules	184	TRUE	0.0028385180943214633	84	18	4	0.2222222222222222	0.047619047619047616	REAC:R-HSA-5628897	REAC	TP53 Regulates Metabolic Genes	10916	2452		0.6666666666666666	0.6923076923076923	84	10832	4	14	80	10818	10916	0.0997733518722103
R1	cpdb	0	network_modules	184	TRUE	0.003427422881356627	790	20	8	0.4	0.010126582278481013	GO:0007167	GO:BP	enzyme-linked receptor protein signaling pathway	16175	2731		1	1	790	15385	8	12	782	15373	16175	0.05732546106639679
R1	cpdb	0	network_modules	184	TRUE	0.003890280663689712	356	18	6	0.3333333333333333	0.016853932584269662	KEGG:04151	KEGG	PI3K-Akt signaling pathway	8484	285		0.6	0.6666666666666666	356	8128	6	12	350	8116	8484	0.06700832166491304
R1	cpdb	0	network_modules	184	TRUE	0.00407365712106707	108	18	4	0.2222222222222222	0.037037037037037035	KEGG:05145	KEGG	Toxoplasmosis	8484	437		0.8	1	108	8376	4	14	104	8362	8484	0.08616597258856983
R1	cpdb	0	network_modules	184	TRUE	0.00407365712106707	108	18	4	0.2222222222222222	0.037037037037037035	KEGG:04931	KEGG	Insulin resistance	8484	388		0.8	1	108	8376	4	14	104	8362	8484	0.08616597258856983
R1	cpdb	0	network_modules	184	TRUE	0.004255642245589117	93	18	4	0.2222222222222222	0.043010752688172046	REAC:R-HSA-5625740	REAC	RHO GTPases activate PKNs	10916	1857		0.75	0.7692307692307693	93	10823	4	14	89	10809	10916	0.09449763005636269
R1	cpdb	0	network_modules	184	TRUE	0.004588347037971318	30	18	3	0.16666666666666666	0.1	REAC:R-HSA-114452	REAC	Activation of BH3-only proteins	10916	77		0.8333333333333334	0.8461538461538461	30	10886	3	15	27	10871	10916	0.1272504453227571
R1	cpdb	0	network_modules	184	TRUE	0.005172269299281317	208	18	5	0.2777777777777778	0.02403846153846154	REAC:R-HSA-5357801	REAC	Programmed Cell Death	10916	1803		0.9166666666666666	0.9230769230769231	208	10708	5	13	203	10695	10916	0.07690877039003498
R1	cpdb	0	network_modules	184	TRUE	0.005238011845305936	98	18	4	0.2222222222222222	0.04081632653061224	REAC:R-HSA-202424	REAC	Downstream TCR signaling	10916	789		1	1	98	10818	4	14	94	10804	10916	0.09187933479129005
R1	cpdb	0	network_modules	185	TRUE	1.8016457072718637e-31	155	29	20	0.6896551724137931	0.12903225806451613	GO:0007034	GO:BP	vacuolar transport	16175	2639		0	0.0072992700729927005	155	16020	20	9	135	16011	16175	0.29584818696079757
R1	cpdb	0	network_modules	185	TRUE	2.7520627844558053e-31	67	29	17	0.5862068965517241	0.2537313432835821	GO:0008333	GO:BP	endosome to lysosome transport	16175	3164		0.007352941176470588	0.014598540145985401	67	16108	17	12	50	16096	16175	0.3840819213736937
R1	cpdb	0	network_modules	185	TRUE	5.422086908720685e-31	125	29	19	0.6551724137931034	0.152	GO:0007041	GO:BP	lysosomal transport	16175	2645		0.014705882352941176	0.021897810218978103	125	16050	19	10	106	16040	16175	0.3133435749633566
R1	cpdb	0	network_modules	185	TRUE	1.4983217918382126e-30	99	29	18	0.6206896551724138	0.18181818181818182	GO:0006906	GO:BP	vesicle fusion	16175	2557		0.022058823529411766	0.029197080291970802	99	16076	18	11	81	16065	16175	0.33394499418397855
R1	cpdb	0	network_modules	185	TRUE	2.2206059532936146e-30	101	29	18	0.6206896551724138	0.1782178217821782	GO:0090174	GO:BP	organelle membrane fusion	16175	18081		0.029411764705882353	0.0364963503649635	101	16074	18	11	83	16063	16175	0.3305761205585088
R1	cpdb	0	network_modules	185	TRUE	7.097242148302382e-28	136	29	18	0.6206896551724138	0.1323529411764706	GO:0048284	GO:BP	organelle fusion	16175	12626		0.03676470588235294	0.043795620437956206	136	16039	18	11	118	16028	16175	0.2841868234050349
R1	cpdb	0	network_modules	185	TRUE	1.397334650174203e-27	55	29	15	0.5172413793103449	0.2727272727272727	GO:0097352	GO:BP	autophagosome maturation	16175	18619		0.04411764705882353	0.051094890510948905	55	16120	15	14	40	16106	16175	0.37408971166729593
R1	cpdb	0	network_modules	185	TRUE	3.696564634668401e-27	315	29	21	0.7241379310344828	0.06666666666666667	GO:0016050	GO:BP	vesicle organization	16175	5082		0.051470588235294115	0.058394160583941604	315	15860	21	8	294	15852	16175	0.21611538323403662
R1	cpdb	0	network_modules	185	TRUE	1.093352769178964e-26	157	29	18	0.6206896551724138	0.11464968152866242	GO:0061025	GO:BP	membrane fusion	16175	15142		0.058823529411764705	0.06569343065693431	157	16018	18	11	139	16007	16175	0.2641108215510215
R1	cpdb	0	network_modules	185	TRUE	3.657346503455155e-26	21	29	12	0.41379310344827586	0.5714285714285714	GO:1902774	GO:BP	late endosome to lysosome transport	16175	22495		0.0661764705882353	0.072992700729927	21	16154	12	17	9	16137	16175	0.48548924054569875
R1	cpdb	0	network_modules	185	TRUE	3.130626728447223e-25	309	29	20	0.6896551724137931	0.06472491909385113	GO:0016236	GO:BP	macroautophagy	16175	5179		0.07352941176470588	0.08029197080291971	309	15866	20	9	289	15857	16175	0.20760129773939545
R1	cpdb	0	network_modules	185	TRUE	9.55861176196397e-23	14	29	10	0.3448275862068966	0.7142857142857143	GO:0046753	GO:BP	non-lytic viral release	16175	12352		0.08088235294117647	0.08759124087591241	14	16161	10	19	4	16142	16175	0.4957049020265869
R1	cpdb	0	network_modules	185	TRUE	1.6204915978818567e-22	202	29	17	0.5862068965517241	0.08415841584158416	GO:0007033	GO:BP	vacuole organization	16175	2638		0.08823529411764706	0.0948905109489051	202	15973	17	12	185	15961	16175	0.2189478723482766
R1	cpdb	0	network_modules	185	TRUE	7.8833037157278075e-22	88	29	14	0.4827586206896552	0.1590909090909091	GO:0007032	GO:BP	endosome organization	16175	2637		0.09558823529411764	0.10218978102189781	88	16087	14	15	74	16072	16175	0.27500454672213626
R1	cpdb	0	network_modules	185	TRUE	1.8511535669659874e-21	17	29	10	0.3448275862068966	0.5882352941176471	GO:0061952	GO:BP	midbody abscission	16175	15745		0.10294117647058823	0.10948905109489052	17	16158	10	19	7	16139	16175	0.4496440391065621
R1	cpdb	0	network_modules	185	TRUE	3.781962668193995e-21	491	29	20	0.6896551724137931	0.04073319755600815	GO:0006914	GO:BP	autophagy	16175	2563		0.11029411764705882	0.12408759124087591	491	15684	20	9	471	15675	16175	0.162863783594188
R1	cpdb	0	network_modules	185	TRUE	3.781962668193995e-21	491	29	20	0.6896551724137931	0.04073319755600815	GO:0061919	GO:BP	process utilizing autophagic mechanism	16175	15723		0.11029411764705882	0.12408759124087591	491	15684	20	9	471	15675	16175	0.162863783594188
R1	cpdb	0	network_modules	185	TRUE	3.828695231622671e-21	29	29	11	0.3793103448275862	0.3793103448275862	GO:0019076	GO:BP	viral release from host cell	16175	5568		0.125	0.1386861313868613	29	16146	11	18	18	16128	16175	0.3781955176258025
R1	cpdb	0	network_modules	185	TRUE	3.828695231622671e-21	29	29	11	0.3793103448275862	0.3793103448275862	GO:0035891	GO:BP	exit from host cell	16175	9315		0.125	0.1386861313868613	29	16146	11	18	18	16128	16175	0.3781955176258025
R1	cpdb	0	network_modules	185	TRUE	6.339277753029372e-21	47	29	12	0.41379310344827586	0.2553191489361702	GO:0071985	GO:BP	multivesicular body sorting pathway	16175	17028		0.13970588235294118	0.145985401459854	47	16128	12	17	35	16111	16175	0.3235150101187421
R1	cpdb	0	network_modules	185	TRUE	2.268330387521218e-20	657	29	21	0.7241379310344828	0.0319634703196347	GO:0061024	GO:BP	membrane organization	16175	15141		0.14705882352941177	0.15328467153284672	657	15518	21	8	636	15510	16175	0.14674431567139054
R1	cpdb	0	network_modules	185	TRUE	5.0781726846960987e-20	215	29	16	0.5517241379310345	0.07441860465116279	GO:0032984	GO:BP	protein-containing complex disassembly	16175	7964		0.15441176470588236	0.16058394160583941	215	15960	16	13	199	15947	16175	0.19925352816835507
R1	cpdb	0	network_modules	185	TRUE	5.517740172185442e-20	13	29	9	0.3103448275862069	0.6923076923076923	GO:0046761	GO:BP	viral budding from plasma membrane	16175	12356		0.16176470588235295	0.1678832116788321	13	16162	9	20	4	16142	16175	0.46292425243846475
R1	cpdb	0	network_modules	185	TRUE	9.38466208162211e-20	37	29	11	0.3793103448275862	0.2972972972972973	GO:0045324	GO:BP	late endosome to vacuole transport	16175	11357		0.16911764705882354	0.17518248175182483	37	16138	11	18	26	16120	16175	0.3344666227484072
R1	cpdb	0	network_modules	185	TRUE	1.9416474347158096e-19	175	29	15	0.5172413793103449	0.08571428571428572	GO:0000910	GO:BP	cytokinesis	16175	243		0.17647058823529413	0.18248175182481752	175	16000	15	14	160	15986	16175	0.20746485940288226
R1	cpdb	0	network_modules	185	TRUE	3.08485138555028e-19	25	29	10	0.3448275862068966	0.4	GO:1902410	GO:BP	mitotic cytokinetic process	16175	22262		0.18382352941176472	0.1897810218978102	25	16150	10	19	15	16131	16175	0.3703442167364811
R1	cpdb	0	network_modules	185	TRUE	4.936379353722325e-19	96	29	13	0.4482758620689655	0.13541666666666666	GO:0007040	GO:BP	lysosome organization	16175	2644		0.19117647058823528	0.20437956204379562	96	16079	13	16	83	16063	16175	0.24406339975991997
R1	cpdb	0	network_modules	185	TRUE	4.936379353722325e-19	96	29	13	0.4482758620689655	0.13541666666666666	GO:0080171	GO:BP	lytic vacuole organization	16175	17845		0.19117647058823528	0.20437956204379562	96	16079	13	16	83	16063	16175	0.24406339975991997
R1	cpdb	0	network_modules	185	TRUE	7.944620558209502e-19	27	29	10	0.3448275862068966	0.37037037037037035	GO:0001778	GO:BP	plasma membrane repair	16175	443		0.20588235294117646	0.2116788321167883	27	16148	10	19	17	16129	16175	0.3562575890798832
R1	cpdb	0	network_modules	185	TRUE	1.8676880887186367e-18	17	29	9	0.3103448275862069	0.5294117647058824	GO:0032510	GO:BP	endosome to lysosome transport via multivesicular body sorting pathway	16175	7617		0.21323529411764705	0.21897810218978103	17	16158	9	20	8	16138	16175	0.40454216859831355
R1	cpdb	0	network_modules	185	TRUE	2.098004685514654e-18	270	29	16	0.5517241379310345	0.05925925925925926	GO:0016197	GO:BP	endosomal transport	16175	5169		0.22058823529411764	0.22627737226277372	270	15905	16	13	254	15892	16175	0.17698710228613274
R1	cpdb	0	network_modules	185	TRUE	2.679229032933459e-18	10	29	8	0.27586206896551724	0.8	GO:1904896	GO:BP	ESCRT complex disassembly	16175	24203		0.22794117647058823	0.24087591240875914	10	16165	8	21	2	16144	16175	0.469289193460881
R1	cpdb	0	network_modules	185	TRUE	2.679229032933459e-18	10	29	8	0.27586206896551724	0.8	GO:1904903	GO:BP	ESCRT III complex disassembly	16175	24210		0.22794117647058823	0.24087591240875914	10	16165	8	21	2	16144	16175	0.469289193460881
R1	cpdb	0	network_modules	185	TRUE	6.042830502099584e-18	32	29	10	0.3448275862068966	0.3125	GO:0036258	GO:BP	multivesicular body assembly	16175	9519		0.2426470588235294	0.24817518248175183	32	16143	10	19	22	16124	16175	0.32699933780098034
R1	cpdb	0	network_modules	185	TRUE	8.660874085233332e-18	33	29	10	0.3448275862068966	0.30303030303030304	GO:0036257	GO:BP	multivesicular body organization	16175	9518		0.25	0.25547445255474455	33	16142	10	19	23	16123	16175	0.32195859514722536
R1	cpdb	0	network_modules	185	TRUE	1.134535814742303e-17	83	29	12	0.41379310344827586	0.14457831325301204	GO:0000281	GO:BP	mitotic cytokinesis	16175	79		0.25735294117647056	0.26277372262773724	83	16092	12	17	71	16075	16175	0.24239894371073553
R1	cpdb	0	network_modules	185	TRUE	2.248159617727994e-17	21	29	9	0.3103448275862069	0.42857142857142855	GO:0039702	GO:BP	viral budding via host ESCRT complex	16175	9879		0.2647058823529412	0.27007299270072993	21	16154	9	20	12	16134	16175	0.3637349191690971
R1	cpdb	0	network_modules	185	TRUE	2.940349510927036e-17	12	29	8	0.27586206896551724	0.6666666666666666	GO:0097576	GO:BP	vacuole fusion	16175	18701		0.27205882352941174	0.2773722627737226	12	16163	8	21	4	16142	16175	0.42823450431276494
R1	cpdb	0	network_modules	185	TRUE	4.3997279262285646e-17	38	29	10	0.3448275862068966	0.2631578947368421	GO:0032506	GO:BP	cytokinetic process	16175	7613		0.27941176470588236	0.2846715328467153	38	16137	10	19	28	16118	16175	0.29980622932451084
R1	cpdb	0	network_modules	185	TRUE	9.967216774883908e-17	24	29	9	0.3103448275862069	0.375	GO:0046755	GO:BP	viral budding	16175	12354		0.2867647058823529	0.291970802919708	24	16151	9	20	15	16131	16175	0.3400702473042435
R1	cpdb	0	network_modules	185	TRUE	1.0400602235243445e-16	41	29	10	0.3448275862068966	0.24390243902439024	GO:0032509	GO:BP	endosome transport via multivesicular body sorting pathway	16175	7616		0.29411764705882354	0.29927007299270075	41	16134	10	19	31	16115	16175	0.28849987987288667
R1	cpdb	0	network_modules	185	TRUE	1.1270640295707882e-16	265	29	15	0.5172413793103449	0.05660377358490566	GO:0051301	GO:BP	cell division	16175	13632		0.3014705882352941	0.30656934306569344	265	15910	15	14	250	15896	16175	0.16721200891576196
R1	cpdb	0	network_modules	185	TRUE	1.5556423921712316e-16	25	29	9	0.3103448275862069	0.36	GO:0031468	GO:BP	nuclear membrane reassembly	16175	7184		0.3088235294117647	0.31386861313868614	25	16150	9	20	16	16130	16175	0.3331430510434981
R1	cpdb	0	network_modules	185	TRUE	3.1879611997163885e-16	108	29	12	0.41379310344827586	0.1111111111111111	GO:0061640	GO:BP	cytoskeleton-dependent cytokinesis	16175	15599		0.3161764705882353	0.32116788321167883	108	16067	12	17	96	16050	16175	0.21186043134417304
R1	cpdb	0	network_modules	185	TRUE	4.0423871099800487e-16	374	29	16	0.5517241379310345	0.0427807486631016	GO:0022411	GO:BP	cellular component disassembly	16175	6602		0.3235294117647059	0.3284671532846715	374	15801	16	13	358	15788	16175	0.14906015142219303
R1	cpdb	0	network_modules	185	TRUE	1.8351965483348008e-15	519	29	17	0.5862068965517241	0.03275529865125241	GO:0051640	GO:BP	organelle localization	16175	13853		0.33088235294117646	0.3357664233576642	519	15656	17	12	502	15644	16175	0.13325724292326593
R1	cpdb	0	network_modules	185	TRUE	2.635725862220872e-15	10	23	7	0.30434782608695654	0.7	REAC:R-HSA-9754560	REAC	SARS-CoV-2 modulates autophagy	10916	2124		0	0.045454545454545456	10	10906	7	16	3	10890	10916	0.46087372959052725
R1	cpdb	0	network_modules	185	TRUE	2.910647646582333e-15	33	29	9	0.3103448275862069	0.2727272727272727	GO:0019068	GO:BP	virion assembly	16175	5561		0.3382352941176471	0.34306569343065696	33	16142	9	20	24	16122	16175	0.28957111387312534
R1	cpdb	0	network_modules	185	TRUE	5.3168511815417444e-15	35	29	9	0.3103448275862069	0.2571428571428571	GO:0043162	GO:BP	ubiquitin-dependent protein catabolic process via the multivesicular body sorting pathway	16175	10562		0.34558823529411764	0.35036496350364965	35	16140	9	20	26	16120	16175	0.2810806046871707
R1	cpdb	0	network_modules	185	TRUE	1.4403853771082146e-14	11	29	7	0.2413793103448276	0.6363636363636364	GO:0051469	GO:BP	vesicle fusion with vacuole	16175	13730		0.35294117647058826	0.36496350364963503	11	16164	7	22	4	16142	16175	0.3913044484793765
R1	cpdb	0	network_modules	185	TRUE	1.4403853771082146e-14	11	29	7	0.2413793103448276	0.6363636363636364	GO:0061763	GO:BP	multivesicular body-lysosome fusion	16175	15654		0.35294117647058826	0.36496350364963503	11	16164	7	22	4	16142	16175	0.3913044484793765
R1	cpdb	0	network_modules	185	TRUE	1.8776402580780433e-14	22	29	8	0.27586206896551724	0.36363636363636365	GO:1901673	GO:BP	regulation of mitotic spindle assembly	16175	21638		0.36764705882352944	0.3722627737226277	22	16153	8	21	14	16132	16175	0.3156590926274413
R1	cpdb	0	network_modules	185	TRUE	3.75459195195751e-14	13	23	7	0.30434782608695654	0.5384615384615384	REAC:R-HSA-9679504	REAC	Translation of Replicase and Assembly of the Replication Transcription Complex	10916	2568		0.047619047619047616	0.09090909090909091	13	10903	7	16	6	10887	10916	0.4039024504450869
R1	cpdb	0	network_modules	185	TRUE	4.2086919618583366e-14	43	29	9	0.3103448275862069	0.20930232558139536	GO:0071763	GO:BP	nuclear membrane organization	16175	16893		0.375	0.3795620437956204	43	16132	9	20	34	16112	16175	0.2532449454772137
R1	cpdb	0	network_modules	185	TRUE	5.285026854556756e-14	44	29	9	0.3103448275862069	0.20454545454545456	GO:0090148	GO:BP	membrane fission	16175	18057		0.38235294117647056	0.38686131386861317	44	16131	9	20	35	16111	16175	0.2503080774631852
R1	cpdb	0	network_modules	185	TRUE	7.499543506003247e-14	14	23	7	0.30434782608695654	0.5	REAC:R-HSA-9694676	REAC	Translation of Replicase and Assembly of the Replication Transcription Complex	10916	2569		0.09523809523809523	0.13636363636363635	14	10902	7	16	7	10886	10916	0.3891103721966563
R1	cpdb	0	network_modules	185	TRUE	8.203598225285477e-14	522	29	16	0.5517241379310345	0.03065134099616858	GO:0010256	GO:BP	endomembrane system organization	16175	4029		0.3897058823529412	0.39416058394160586	522	15653	16	13	506	15640	16175	0.12457253076013074
R1	cpdb	0	network_modules	185	TRUE	9.808272115657906e-14	28	23	8	0.34782608695652173	0.2857142857142857	REAC:R-HSA-162588	REAC	Budding and maturation of HIV virion	10916	258		0.14285714285714285	0.18181818181818182	28	10888	8	15	20	10873	10916	0.313652101622804
R1	cpdb	0	network_modules	185	TRUE	1.4926555336575816e-13	14	29	7	0.2413793103448276	0.5	GO:0097212	GO:BP	lysosomal membrane organization	16175	18546		0.39705882352941174	0.40145985401459855	14	16161	7	22	7	16139	16175	0.3466192194425421
R1	cpdb	0	network_modules	185	TRUE	2.0356031198709862e-13	126	29	11	0.3793103448275862	0.0873015873015873	GO:0051701	GO:BP	biological process involved in interaction with host	16175	13901		0.40441176470588236	0.40875912408759124	126	16049	11	18	115	16031	16175	0.179095382623132
R1	cpdb	0	network_modules	185	TRUE	2.4803207293538434e-13	31	23	8	0.34782608695652173	0.25806451612903225	REAC:R-HSA-917729	REAC	Endosomal Sorting Complex Required For Transport (ESCRT)	10916	841		0.19047619047619047	0.22727272727272727	31	10885	8	15	23	10870	10916	0.29789305361698687
R1	cpdb	0	network_modules	185	TRUE	3.270719238210858e-13	53	29	9	0.3103448275862069	0.16981132075471697	GO:0006998	GO:BP	nuclear envelope organization	16175	2613		0.4117647058823529	0.41605839416058393	53	16122	9	20	44	16102	16175	0.2277184485182246
R1	cpdb	0	network_modules	185	TRUE	3.9204843033734133e-13	54	29	9	0.3103448275862069	0.16666666666666666	GO:0071709	GO:BP	membrane assembly	16175	16873		0.41911764705882354	0.4233576642335766	54	16121	9	20	45	16101	16175	0.22556166553157933
R1	cpdb	0	network_modules	185	TRUE	4.584189285438919e-13	31	29	8	0.27586206896551724	0.25806451612903225	GO:0090169	GO:BP	regulation of spindle assembly	16175	18077		0.4264705882352941	0.4306569343065693	31	16144	8	21	23	16123	16175	0.2654535960305851
R1	cpdb	0	network_modules	185	TRUE	7.815574220765044e-13	58	29	9	0.3103448275862069	0.15517241379310345	GO:0044091	GO:BP	membrane biogenesis	16175	10913		0.4338235294117647	0.43795620437956206	58	16117	9	20	49	16097	16175	0.21749641078982337
R1	cpdb	0	network_modules	185	TRUE	8.160370749039116e-13	292	23	13	0.5652173913043478	0.04452054794520548	REAC:R-HSA-9694516	REAC	SARS-CoV-2 Infection	10916	2122		0.23809523809523808	0.2727272727272727	292	10624	13	10	279	10614	10916	0.15334791179612417
R1	cpdb	0	network_modules	185	TRUE	9.212086302503654e-13	59	29	9	0.3103448275862069	0.15254237288135594	GO:0007080	GO:BP	mitotic metaphase chromosome alignment	16175	2669		0.4411764705882353	0.44525547445255476	59	16116	9	20	50	16096	16175	0.21560857193335028
R1	cpdb	0	network_modules	185	TRUE	2.0777635071173312e-12	248	25	13	0.52	0.05241935483870968	KEGG:04144	KEGG	Endocytosis	8484	280		0	0.2	248	8236	13	12	235	8224	8484	0.15838127210122627
R1	cpdb	0	network_modules	185	TRUE	2.6582927561989827e-12	225	29	12	0.41379310344827586	0.05333333333333334	GO:0044403	GO:BP	biological process involved in symbiotic interaction	16175	10991		0.4485294117647059	0.45255474452554745	225	15950	12	17	213	15933	16175	0.14470111558041138
R1	cpdb	0	network_modules	185	TRUE	5.48852217160531e-12	41	29	8	0.27586206896551724	0.1951219512195122	GO:0060236	GO:BP	regulation of mitotic spindle organization	16175	14457		0.45588235294117646	0.45985401459854014	41	16134	8	21	33	16113	16175	0.23037261911910534
R1	cpdb	0	network_modules	185	TRUE	6.400258213067589e-12	242	29	12	0.41379310344827586	0.049586776859504134	GO:0019058	GO:BP	viral life cycle	16175	5555		0.4632352941176471	0.46715328467153283	242	15933	12	17	230	15916	16175	0.1392336056669157
R1	cpdb	0	network_modules	185	TRUE	8.310389057242816e-12	43	29	8	0.27586206896551724	0.18604651162790697	GO:0010824	GO:BP	regulation of centrosome duplication	16175	4434		0.47058823529411764	0.4744525547445255	43	16132	8	21	35	16111	16175	0.2248635018689469
R1	cpdb	0	network_modules	185	TRUE	1.0145397676953298e-11	44	29	8	0.27586206896551724	0.18181818181818182	GO:0090224	GO:BP	regulation of spindle organization	16175	18121		0.47794117647058826	0.48175182481751827	44	16131	8	21	36	16110	16175	0.22225013421363377
R1	cpdb	0	network_modules	185	TRUE	1.4157362982690859e-11	11	29	6	0.20689655172413793	0.5454545454545454	GO:0034058	GO:BP	endosomal vesicle fusion	16175	8388		0.4852941176470588	0.48905109489051096	11	16164	6	23	5	16141	16175	0.33524587361042435
R1	cpdb	0	network_modules	185	TRUE	2.1500995244096975e-11	48	29	8	0.27586206896551724	0.16666666666666666	GO:0046605	GO:BP	regulation of centrosome cycle	16175	12255		0.49264705882352944	0.49635036496350365	48	16127	8	21	40	16106	16175	0.21262201397923391
R1	cpdb	0	network_modules	185	TRUE	2.4887273569565712e-11	165	25	11	0.44	0.06666666666666667	KEGG:04140	KEGG	Autophagy - animal	8484	277		0.25	0.4	165	8319	11	14	154	8305	8484	0.16555905335814103
R1	cpdb	0	network_modules	185	TRUE	3.8375010352976536e-11	137	29	10	0.3448275862068966	0.072992700729927	GO:0007009	GO:BP	plasma membrane organization	16175	2621		0.5	0.5036496350364964	137	16038	10	19	127	16019	16175	0.1555524417997964
R1	cpdb	0	network_modules	185	TRUE	5.779441255424321e-11	793	29	16	0.5517241379310345	0.0201765447667087	GO:0044087	GO:BP	regulation of cellular component biogenesis	16175	10909		0.5073529411764706	0.5109489051094891	793	15382	16	13	777	15369	16175	0.09866766620258885
R1	cpdb	0	network_modules	185	TRUE	9.120164134159553e-11	96	29	9	0.3103448275862069	0.09375	GO:0051310	GO:BP	metaphase chromosome alignment	16175	13641		0.5147058823529411	0.5182481751824818	96	16079	9	20	87	16059	16175	0.16795936650321572
R1	cpdb	0	network_modules	185	TRUE	1.7516149926914623e-10	103	29	9	0.3103448275862069	0.08737864077669903	GO:0051303	GO:BP	establishment of chromosome localization	16175	13634		0.5220588235294118	0.5255474452554745	103	16072	9	20	94	16052	16175	0.16195633123196498
R1	cpdb	0	network_modules	185	TRUE	2.1842001637238918e-10	37	23	7	0.30434782608695654	0.1891891891891892	REAC:R-HSA-9772572	REAC	Early SARS-CoV-2 Infection Events	10916	832		0.2857142857142857	0.3181818181818182	37	10879	7	16	30	10863	10916	0.23793847657946332
R1	cpdb	0	network_modules	185	TRUE	2.7146710912471903e-10	108	29	9	0.3103448275862069	0.08333333333333333	GO:0050000	GO:BP	chromosome localization	16175	13183		0.5294117647058824	0.5328467153284672	108	16067	9	20	99	16047	16175	0.15802666112625174
R1	cpdb	0	network_modules	185	TRUE	2.7851856687920407e-10	459	23	13	0.5652173913043478	0.02832244008714597	REAC:R-HSA-9679506	REAC	SARS-CoV Infections	10916	2112		0.3333333333333333	0.36363636363636365	459	10457	13	10	446	10447	10916	0.11978041595380629
R1	cpdb	0	network_modules	185	TRUE	4.115501544126449e-10	68	29	8	0.27586206896551724	0.11764705882352941	GO:0090307	GO:BP	mitotic spindle assembly	16175	18189		0.5367647058823529	0.5401459854014599	68	16107	8	21	60	16086	16175	0.17793918953020926
R1	cpdb	0	network_modules	185	TRUE	5.254759877157926e-10	350	29	12	0.41379310344827586	0.03428571428571429	GO:0016032	GO:BP	viral process	16175	5071		0.5441176470588235	0.5474452554744526	350	15825	12	17	338	15808	16175	0.11422533426248506
R1	cpdb	0	network_modules	185	TRUE	5.902788084976836e-10	71	29	8	0.27586206896551724	0.11267605633802817	GO:0051298	GO:BP	centrosome duplication	16175	13629		0.5514705882352942	0.5547445255474452	71	16104	8	21	63	16083	16175	0.17403665507221588
R1	cpdb	0	network_modules	185	TRUE	7.727222054238098e-10	121	29	9	0.3103448275862069	0.0743801652892562	GO:0006997	GO:BP	nucleus organization	16175	2612		0.5588235294117647	0.5620437956204379	121	16054	9	20	112	16034	16175	0.14896161260105298
R1	cpdb	0	network_modules	185	TRUE	1.1747740483876409e-9	20	29	6	0.20689655172413793	0.3	GO:0035493	GO:BP	SNARE complex assembly	16175	9063		0.5661764705882353	0.5693430656934306	20	16155	6	23	14	16132	16175	0.24802321143213926
R1	cpdb	0	network_modules	185	TRUE	1.389210210666228e-9	129	29	9	0.3103448275862069	0.06976744186046512	GO:0007098	GO:BP	centrosome cycle	16175	2681		0.5735294117647058	0.5766423357664233	129	16046	9	20	120	16026	16175	0.14406902893824103
R1	cpdb	0	network_modules	185	TRUE	4.296236345403475e-9	146	29	9	0.3103448275862069	0.06164383561643835	GO:0031023	GO:BP	microtubule organizing center organization	16175	6997		0.5808823529411765	0.583941605839416	146	16029	9	20	137	16009	16175	0.13502277962977294
R1	cpdb	0	network_modules	185	TRUE	1.6309891288047695e-8	12	29	5	0.1724137931034483	0.4166666666666667	GO:0035542	GO:BP	regulation of SNARE complex assembly	16175	9085		0.5882352941176471	0.5912408759124088	12	16163	5	24	7	16139	16175	0.26721352577870955
R1	cpdb	0	network_modules	185	TRUE	2.2258838144643663e-8	158	25	9	0.36	0.056962025316455694	KEGG:04217	KEGG	Necroptosis	8484	294		0.5	0.6	158	8326	9	16	149	8310	8484	0.13727716205824128
R1	cpdb	0	network_modules	185	TRUE	2.582635515201015e-8	178	29	9	0.3103448275862069	0.05056179775280899	GO:0000070	GO:BP	mitotic sister chromatid segregation	16175	24		0.5955882352941176	0.5985401459854015	178	15997	9	20	169	15977	16175	0.1216036391037832
R1	cpdb	0	network_modules	185	TRUE	2.7041917312256325e-8	113	29	8	0.27586206896551724	0.07079646017699115	GO:0051225	GO:BP	spindle assembly	16175	13578		0.6029411764705882	0.6058394160583942	113	16062	8	21	105	16041	16175	0.13681187247584364
R1	cpdb	0	network_modules	185	TRUE	3.655650340795434e-8	197	23	9	0.391304347826087	0.04568527918781726	REAC:R-HSA-9705683	REAC	SARS-CoV-2-host interactions	10916	2128		0.38095238095238093	0.4090909090909091	197	10719	9	14	188	10705	10916	0.12884035792615878
R1	cpdb	0	network_modules	185	TRUE	3.836176866108783e-8	186	29	9	0.3103448275862069	0.04838709677419355	GO:1902115	GO:BP	regulation of organelle assembly	16175	22028		0.6102941176470589	0.6131386861313869	186	15989	9	20	177	15969	16175	0.11879291991484958
R1	cpdb	0	network_modules	185	TRUE	5.113751920627119e-8	132	23	8	0.34782608695652173	0.06060606060606061	REAC:R-HSA-162599	REAC	Late Phase of HIV Life Cycle	10916	1304		0.42857142857142855	0.45454545454545453	132	10784	8	15	124	10769	10916	0.1411470427584726
R1	cpdb	0	network_modules	185	TRUE	5.743934254462461e-8	124	29	8	0.27586206896551724	0.06451612903225806	GO:0007052	GO:BP	mitotic spindle organization	16175	2651		0.6176470588235294	0.6204379562043796	124	16051	8	21	116	16030	16175	0.13031700400420668
R1	cpdb	0	network_modules	185	TRUE	5.7616367108799674e-8	249	25	10	0.4	0.040160642570281124	KEGG:05132	KEGG	Salmonella infection	8484	429		0.75	0.8	249	8235	10	15	239	8220	8484	0.11938353286720176
R1	cpdb	0	network_modules	185	TRUE	8.993903340282293e-8	410	29	11	0.3793103448275862	0.026829268292682926	GO:0051656	GO:BP	establishment of organelle localization	16175	13869		0.625	0.6277372262773723	410	15765	11	18	399	15747	16175	0.09543974220458072
R1	cpdb	0	network_modules	185	TRUE	1.0881708186619371e-7	145	23	8	0.34782608695652173	0.05517241379310345	REAC:R-HSA-162587	REAC	HIV Life Cycle	10916	1103		0.47619047619047616	0.5	145	10771	8	15	137	10756	10916	0.13427445844569266
R1	cpdb	0	network_modules	185	TRUE	1.2664507294915413e-7	17	29	5	0.1724137931034483	0.29411764705882354	GO:1903541	GO:BP	regulation of exosomal secretion	16175	23091		0.6323529411764706	0.635036496350365	17	16158	5	24	12	16134	16175	0.22413468656531918
R1	cpdb	0	network_modules	185	TRUE	1.526335721033672e-7	217	29	9	0.3103448275862069	0.041474654377880185	GO:0000819	GO:BP	sister chromatid segregation	16175	237		0.6397058823529411	0.6423357664233577	217	15958	9	20	208	15938	16175	0.10938163833772753
R1	cpdb	0	network_modules	185	TRUE	2.263150267575364e-7	147	29	8	0.27586206896551724	0.05442176870748299	GO:0070507	GO:BP	regulation of microtubule cytoskeleton organization	16175	16162		0.6470588235294118	0.6496350364963503	147	16028	8	21	139	16007	16175	0.11913954353483795
R1	cpdb	0	network_modules	185	TRUE	3.1191383537978303e-7	153	29	8	0.27586206896551724	0.05228758169934641	GO:1902850	GO:BP	microtubule cytoskeleton organization involved in mitosis	16175	22560		0.6544117647058824	0.656934306569343	153	16022	8	21	145	16001	16175	0.11663956483273151
R1	cpdb	0	network_modules	185	TRUE	3.1613232516019725e-7	20	29	5	0.1724137931034483	0.25	GO:1990182	GO:BP	exosomal secretion	16175	25111		0.6617647058823529	0.6642335766423357	20	16155	5	24	15	16131	16175	0.20643748068771248
R1	cpdb	0	network_modules	185	TRUE	3.250096668695206e-7	339	29	10	0.3448275862068966	0.029498525073746312	GO:0042060	GO:BP	wound healing	16175	9947		0.6691176470588235	0.6715328467153284	339	15836	10	19	329	15817	16175	0.09582040990023954
R1	cpdb	0	network_modules	185	TRUE	4.1441034003532644e-7	21	29	5	0.1724137931034483	0.23809523809523808	GO:0097734	GO:BP	extracellular exosome biogenesis	16175	18749		0.6764705882352942	0.6788321167883211	21	16154	5	24	16	16130	16175	0.20139582400029488
R1	cpdb	0	network_modules	185	TRUE	5.009138642047328e-7	630	29	12	0.41379310344827586	0.01904761904761905	GO:0010564	GO:BP	regulation of cell cycle process	16175	4217		0.6838235294117647	0.6861313868613139	630	15545	12	17	618	15528	16175	0.08210996465083895
R1	cpdb	0	network_modules	185	TRUE	5.771226203449833e-7	252	29	9	0.3103448275862069	0.03571428571428571	GO:0140014	GO:BP	mitotic nuclear division	16175	19633		0.6911764705882353	0.6934306569343066	252	15923	9	20	243	15903	16175	0.10087286340985731
R1	cpdb	0	network_modules	185	TRUE	6.000227735559739e-7	361	29	10	0.3448275862068966	0.027700831024930747	GO:0007059	GO:BP	chromosome segregation	16175	2658		0.6985294117647058	0.7007299270072993	361	15814	10	19	351	15795	16175	0.09252912289731739
R1	cpdb	0	network_modules	185	TRUE	6.835721745620487e-7	23	29	5	0.1724137931034483	0.21739130434782608	GO:0140112	GO:BP	extracellular vesicle biogenesis	16175	19667		0.7058823529411765	0.708029197080292	23	16152	5	24	18	16128	16175	0.19231322164853548
R1	cpdb	0	network_modules	185	TRUE	7.961833339871661e-7	656	29	12	0.41379310344827586	0.018292682926829267	GO:1903047	GO:BP	mitotic cell cycle process	16175	22727		0.7132352941176471	0.7153284671532847	656	15519	12	17	644	15502	16175	0.08018836460015033
R1	cpdb	0	network_modules	185	TRUE	9.543452684008213e-7	176	29	8	0.27586206896551724	0.045454545454545456	GO:0007051	GO:BP	spindle organization	16175	2650		0.7205882352941176	0.7226277372262774	176	15999	8	21	168	15978	16175	0.10824875910999951
R1	cpdb	0	network_modules	185	TRUE	1.3318914495041099e-6	277	29	9	0.3103448275862069	0.032490974729241874	GO:0098813	GO:BP	nuclear chromosome segregation	16175	18900		0.7279411764705882	0.7299270072992701	277	15898	9	20	268	15878	16175	0.09578394745570455
R1	cpdb	0	network_modules	185	TRUE	1.6642867289456649e-6	32	23	5	0.21739130434782608	0.15625	REAC:R-HSA-9668328	REAC	Sealing of the nuclear envelope (NE) by ESCRT-III	10916	2185		0.5238095238095238	0.5454545454545454	32	10884	5	18	27	10866	10916	0.18227637794886925
R1	cpdb	0	network_modules	185	TRUE	1.9209624929485357e-6	407	29	10	0.3448275862068966	0.02457002457002457	GO:0009611	GO:BP	response to wounding	16175	3539		0.7352941176470589	0.7372262773722628	407	15768	10	19	397	15749	16175	0.08650093422616303
R1	cpdb	0	network_modules	185	TRUE	2.456998465355615e-6	134	23	7	0.30434782608695654	0.05223880597014925	REAC:R-HSA-1632852	REAC	Macroautophagy	10916	1388		0.5714285714285714	0.5909090909090909	134	10782	7	16	127	10766	10916	0.12188266797818549
R1	cpdb	0	network_modules	185	TRUE	3.3358570461798903e-6	140	23	7	0.30434782608695654	0.05	REAC:R-HSA-9678108	REAC	SARS-CoV-1 Infection	10916	2114		0.6190476190476191	0.6363636363636364	140	10776	7	16	133	10760	10916	0.11905102407882455
R1	cpdb	0	network_modules	185	TRUE	3.5555244884006267e-6	225	23	8	0.34782608695652173	0.035555555555555556	REAC:R-HSA-162906	REAC	HIV Infection	10916	1102		0.6666666666666666	0.6818181818181818	225	10691	8	15	217	10676	10916	0.10582428275472218
R1	cpdb	0	network_modules	185	TRUE	5.147671132005868e-6	149	23	7	0.30434782608695654	0.04697986577181208	REAC:R-HSA-9612973	REAC	Autophagy	10916	193		0.7142857142857143	0.7272727272727273	149	10767	7	16	142	10751	10916	0.11512123813161936
R1	cpdb	0	network_modules	185	TRUE	6.585532925893002e-6	12	29	4	0.13793103448275862	0.3333333333333333	GO:0090385	GO:BP	phagosome-lysosome fusion	16175	18259		0.7426470588235294	0.7445255474452555	12	16163	4	25	8	16138	16175	0.21353986626735771
R1	cpdb	0	network_modules	185	TRUE	6.775043783110797e-6	792	29	12	0.41379310344827586	0.015151515151515152	GO:0000278	GO:BP	mitotic cell cycle	16175	76		0.75	0.7518248175182481	792	15383	12	17	780	15366	16175	0.07165007380504917
R1	cpdb	0	network_modules	185	TRUE	8.477956129618098e-6	232	29	8	0.27586206896551724	0.034482758620689655	GO:0032886	GO:BP	regulation of microtubule-based process	16175	7882		0.7573529411764706	0.7591240875912408	232	15943	8	21	224	15922	16175	0.09321481830790708
R1	cpdb	0	network_modules	185	TRUE	1.1466944733177125e-5	39	29	5	0.1724137931034483	0.1282051282051282	GO:0006623	GO:BP	protein targeting to vacuole	16175	2337		0.7647058823529411	0.7664233576642335	39	16136	5	24	34	16112	16175	0.14690490516937854
R1	cpdb	0	network_modules	185	TRUE	1.481700819407038e-5	156	25	7	0.28	0.04487179487179487	KEGG:04148	KEGG	Efferocytosis	8484	283		1	1	156	8328	7	18	149	8310	8484	0.10586122060821866
R1	cpdb	0	network_modules	185	TRUE	1.809280907674053e-5	15	29	4	0.13793103448275862	0.26666666666666666	GO:1903543	GO:BP	positive regulation of exosomal secretion	16175	23093		0.7720588235294118	0.781021897810219	15	16160	4	25	11	16135	16175	0.19075535171938793
R1	cpdb	0	network_modules	185	TRUE	1.809280907674053e-5	15	29	4	0.13793103448275862	0.26666666666666666	GO:0001845	GO:BP	phagolysosome assembly	16175	501		0.7720588235294118	0.781021897810219	15	16160	4	25	11	16135	16175	0.19075535171938793
R1	cpdb	0	network_modules	185	TRUE	2.06684580888681e-5	379	29	9	0.3103448275862069	0.023746701846965697	GO:0000280	GO:BP	nuclear division	16175	78		0.7867647058823529	0.7883211678832117	379	15796	9	20	370	15776	16175	0.08038384785415224
R1	cpdb	0	network_modules	185	TRUE	3.097561664107619e-5	113	23	6	0.2608695652173913	0.05309734513274336	REAC:R-HSA-9610379	REAC	HCMV Late Events	10916	1090		0.7619047619047619	0.7727272727272727	113	10803	6	17	107	10786	10916	0.11373152217965407
R1	cpdb	0	network_modules	185	TRUE	3.33896446904446e-5	4	29	3	0.10344827586206896	0.75	GO:1903542	GO:BP	negative regulation of exosomal secretion	16175	23092		0.7941176470588235	0.7956204379562044	4	16171	3	26	1	16145	16175	0.278160977676875
R1	cpdb	0	network_modules	185	TRUE	4.826937317186076e-5	186	29	7	0.2413793103448276	0.03763440860215054	GO:0051648	GO:BP	vesicle localization	16175	13861		0.8014705882352942	0.8029197080291971	186	15989	7	22	179	15967	16175	0.09137871285936143
R1	cpdb	0	network_modules	185	TRUE	5.446670670628619e-5	424	29	9	0.3103448275862069	0.02122641509433962	GO:0048285	GO:BP	organelle fission	16175	12627		0.8088235294117647	0.8102189781021898	424	15751	9	20	415	15731	16175	0.0753690877089914
R1	cpdb	0	network_modules	185	TRUE	7.449152925517745e-5	56	29	5	0.1724137931034483	0.08928571428571429	GO:0072666	GO:BP	establishment of protein localization to vacuole	16175	17486		0.8161764705882353	0.8175182481751825	56	16119	5	24	51	16095	16175	0.12190182758903978
R1	cpdb	0	network_modules	185	TRUE	8.337346278552082e-5	5	29	3	0.10344827586206896	0.6	GO:0090611	GO:BP	ubiquitin-independent protein catabolic process via the multivesicular body sorting pathway	16175	18369		0.8235294117647058	0.8248175182481752	5	16170	3	26	2	16144	16175	0.24865338676338936
R1	cpdb	0	network_modules	185	TRUE	8.372622866934166e-5	27	23	4	0.17391304347826086	0.14814814814814814	REAC:R-HSA-5620971	REAC	Pyroptosis	10916	1831		0.8095238095238095	0.8181818181818182	27	10889	4	19	23	10870	10916	0.15859481412000134
R1	cpdb	0	network_modules	185	TRUE	9.492274208116515e-5	70	23	5	0.21739130434782608	0.07142857142857142	REAC:R-HSA-2995410	REAC	Nuclear Envelope (NE) Reassembly	10916	1612		0.8571428571428571	0.8636363636363636	70	10846	5	18	65	10828	10916	0.12145306608543299
R1	cpdb	0	network_modules	185	TRUE	1.3928554177576374e-4	24	29	4	0.13793103448275862	0.16666666666666666	GO:0090382	GO:BP	phagosome maturation	16175	18256		0.8308823529411765	0.8321167883211679	24	16151	4	25	20	16126	16175	0.15023472075636082
R1	cpdb	0	network_modules	185	TRUE	1.768823199428613e-4	343	29	8	0.27586206896551724	0.023323615160349854	GO:0140694	GO:BP	membraneless organelle assembly	16175	19860		0.8382352941176471	0.8394160583941606	343	15832	8	21	335	15811	16175	0.07491186988008529
R1	cpdb	0	network_modules	185	TRUE	1.954800787610196e-4	26	29	4	0.13793103448275862	0.15384615384615385	GO:0006622	GO:BP	protein targeting to lysosome	16175	2336		0.8455882352941176	0.8467153284671532	26	16149	4	25	22	16124	16175	0.1442189798031482
R1	cpdb	0	network_modules	185	TRUE	2.1909783390158046e-4	34	23	4	0.17391304347826086	0.11764705882352941	REAC:R-HSA-9615710	REAC	Late endosomal microautophagy	10916	1306		0.9047619047619048	0.9090909090909091	34	10882	4	19	30	10863	10916	0.1408456840377437
R1	cpdb	0	network_modules	185	TRUE	2.350763187180326e-4	159	23	6	0.2608695652173913	0.03773584905660377	REAC:R-HSA-9609646	REAC	HCMV Infection	10916	1089		0.9523809523809523	0.9545454545454546	159	10757	6	17	153	10740	10916	0.09446711268538346
R1	cpdb	0	network_modules	185	TRUE	3.414032348427922e-4	148	29	6	0.20689655172413793	0.04054054054054054	GO:0017157	GO:BP	regulation of exocytosis	16175	5287		0.8529411764705882	0.8540145985401459	148	16027	6	23	142	16004	16175	0.08801626331071574
R1	cpdb	0	network_modules	185	TRUE	4.0062470227005524e-4	78	29	5	0.1724137931034483	0.0641025641025641	GO:0072665	GO:BP	protein localization to vacuole	16175	17485		0.8602941176470589	0.8613138686131386	78	16097	5	24	73	16073	16175	0.10252815058307206
R1	cpdb	0	network_modules	185	TRUE	4.6333150652786857e-4	545	29	9	0.3103448275862069	0.01651376146788991	GO:0051276	GO:BP	chromosome organization	16175	13613		0.8676470588235294	0.8686131386861314	545	15630	9	20	536	15610	16175	0.06497781322992054
R1	cpdb	0	network_modules	185	TRUE	4.778857799534421e-4	547	29	9	0.3103448275862069	0.016453382084095063	GO:0006511	GO:BP	ubiquitin-dependent protein catabolic process	16175	2235		0.875	0.8759124087591241	547	15628	9	20	538	15608	16175	0.06483407487206864
R1	cpdb	0	network_modules	185	TRUE	5.143653501255546e-4	263	29	7	0.2413793103448276	0.026615969581749048	GO:0006887	GO:BP	exocytosis	16175	2543		0.8823529411764706	0.8832116788321168	263	15912	7	22	256	15890	16175	0.07543692211165218
R1	cpdb	0	network_modules	185	TRUE	5.40164321871907e-4	555	29	9	0.3103448275862069	0.016216216216216217	GO:0019941	GO:BP	modification-dependent protein catabolic process	16175	6072		0.8897058823529411	0.8905109489051095	555	15620	9	20	546	15600	16175	0.06426643530536136
R1	cpdb	0	network_modules	185	TRUE	5.738729298904842e-4	559	29	9	0.3103448275862069	0.016100178890876567	GO:0043632	GO:BP	modification-dependent macromolecule catabolic process	16175	10812		0.8970588235294118	0.8978102189781022	559	15616	9	20	550	15596	16175	0.06398691301695426
R1	cpdb	0	network_modules	185	TRUE	6.543782366980766e-4	86	29	5	0.1724137931034483	0.05813953488372093	GO:0032465	GO:BP	regulation of cytokinesis	16175	7580		0.9044117647058824	0.9051094890510949	86	16089	5	24	81	16065	16175	0.09737905944360362
R1	cpdb	0	network_modules	185	TRUE	6.781143502949066e-4	409	29	8	0.27586206896551724	0.019559902200488997	GO:0060627	GO:BP	regulation of vesicle-mediated transport	16175	14803		0.9117647058823529	0.9124087591240876	409	15766	8	21	401	15745	16175	0.06764381659579019
R1	cpdb	0	network_modules	185	TRUE	8.532839945040304e-4	586	29	9	0.3103448275862069	0.015358361774744027	GO:0000226	GO:BP	microtubule cytoskeleton organization	16175	61		0.9191176470588235	0.9197080291970803	586	15589	9	20	577	15569	16175	0.06217093365804484
R1	cpdb	0	network_modules	185	TRUE	0.0011787959008238299	440	29	8	0.27586206896551724	0.01818181818181818	GO:0051493	GO:BP	regulation of cytoskeleton organization	16175	13748		0.9264705882352942	0.927007299270073	440	15735	8	21	432	15714	16175	0.06478229450323289
R1	cpdb	0	network_modules	185	TRUE	0.001299811319179866	41	29	4	0.13793103448275862	0.0975609756097561	GO:0045022	GO:BP	early endosome to late endosome transport	16175	11234		0.9338235294117647	0.9343065693430657	41	16134	4	25	37	16109	16175	0.1141180976115427
R1	cpdb	0	network_modules	185	TRUE	0.0018187927351900701	12	29	3	0.10344827586206896	0.25	GO:0036092	GO:BP	phosphatidylinositol-3-phosphate biosynthetic process	16175	9435		0.9411764705882353	0.9416058394160584	12	16163	3	26	9	16137	16175	0.15986620675600594
R1	cpdb	0	network_modules	185	TRUE	0.0019029238085705622	45	29	4	0.13793103448275862	0.08888888888888889	GO:0098927	GO:BP	vesicle-mediated transport between endosomal compartments	16175	18957		0.9485294117647058	0.948905109489051	45	16130	4	25	41	16105	16175	0.10874269513373701
R1	cpdb	0	network_modules	185	TRUE	0.0019384179527215171	58	23	4	0.17391304347826086	0.06896551724137931	REAC:R-HSA-5218859	REAC	Regulated Necrosis	10916	1959		1	1	58	10858	4	19	54	10839	10916	0.10656674068658986
R1	cpdb	0	network_modules	185	TRUE	0.002706185452892332	673	29	9	0.3103448275862069	0.01337295690936107	GO:0051603	GO:BP	proteolysis involved in protein catabolic process	16175	13820		0.9558823529411765	0.9562043795620438	673	15502	9	20	664	15482	16175	0.05703448718743494
R1	cpdb	0	network_modules	185	TRUE	0.003703038984996041	53	29	4	0.13793103448275862	0.07547169811320754	GO:0061462	GO:BP	protein localization to lysosome	16175	15493		0.9632352941176471	0.9635036496350365	53	16122	4	25	49	16097	16175	0.09985823438090378
R1	cpdb	0	network_modules	185	TRUE	0.004364975064517977	524	29	8	0.27586206896551724	0.015267175572519083	GO:0006886	GO:BP	intracellular protein transport	16175	2542		0.9705882352941176	0.9708029197080292	524	15651	8	21	516	15630	16175	0.058279142505800526
R1	cpdb	0	network_modules	185	TRUE	0.0050061356295680115	2	29	2	0.06896551724137931	1	GO:0061764	GO:BP	late endosome to lysosome transport via multivesicular body sorting pathway	16175	15655		0.9779411764705882	0.9781021897810219	2	16173	2	27	0	16146	16175	0.26239356474948966
R1	cpdb	0	network_modules	185	TRUE	0.005288455803197067	131	29	5	0.1724137931034483	0.03816793893129771	GO:0051302	GO:BP	regulation of cell division	16175	13633		0.9852941176470589	0.9854014598540146	131	16044	5	24	126	16020	16175	0.0776954740010016
R1	cpdb	0	network_modules	185	TRUE	0.007926274178814243	64	29	4	0.13793103448275862	0.0625	GO:0032418	GO:BP	lysosome localization	16175	7556		0.9926470588235294	1	64	16111	4	25	60	16086	16175	0.09044428110077278
R1	cpdb	0	network_modules	185	TRUE	0.007926274178814243	64	29	4	0.13793103448275862	0.0625	GO:1990849	GO:BP	vacuolar localization	16175	25315		0.9926470588235294	1	64	16111	4	25	60	16086	16175	0.09044428110077278
R1	cpdb	0	network_modules	186	TRUE	1.0212654954470986e-11	8	12	5	0.4166666666666667	0.625	REAC:R-HSA-5632681	REAC	Ligand-receptor interactions	10916	1315		0	0.125	8	10908	5	7	3	10901	10916	0.5098798879435862
R1	cpdb	0	network_modules	186	TRUE	7.10142089173788e-8	53	21	6	0.2857142857142857	0.11320754716981132	GO:0060390	GO:BP	regulation of SMAD protein signal transduction	16175	14595		0	0.06666666666666667	53	16122	6	15	47	16107	16175	0.1781923493982208
R1	cpdb	0	network_modules	186	TRUE	2.7402738072125427e-7	56	11	5	0.45454545454545453	0.08928571428571429	KEGG:04340	KEGG	Hedgehog signaling pathway	8484	302		0	0.3333333333333333	56	8428	5	6	51	8422	8484	0.19931804387420834
R1	cpdb	0	network_modules	186	TRUE	4.3670699848037887e-7	71	21	6	0.2857142857142857	0.08450704225352113	GO:0060395	GO:BP	SMAD protein signal transduction	16175	14598		0.07142857142857142	0.13333333333333333	71	16104	6	15	65	16089	16175	0.15343550052376773
R1	cpdb	0	network_modules	186	TRUE	7.561621130158814e-7	18	12	4	0.3333333333333333	0.2222222222222222	REAC:R-HSA-5635838	REAC	Activation of SMO	10916	97		0.14285714285714285	0.25	18	10898	4	8	14	10890	10916	0.27119182331547365
R1	cpdb	0	network_modules	186	TRUE	1.0277833562078887e-6	35	21	5	0.23809523809523808	0.14285714285714285	GO:0060391	GO:BP	positive regulation of SMAD protein signal transduction	16175	14596		0.14285714285714285	0.2	35	16140	5	16	30	16124	16175	0.1830686015866721
R1	cpdb	0	network_modules	186	TRUE	1.2076879195408305e-6	4	12	3	0.25	0.75	REAC:R-HSA-5658034	REAC	HHAT G278V doesn't palmitoylate Hh-Np	10916	1101		0.2857142857142857	0.375	4	10912	3	9	1	10903	10916	0.4326951565792737
R1	cpdb	0	network_modules	186	TRUE	5.740040329059967e-6	85	12	5	0.4166666666666667	0.058823529411764705	REAC:R-HSA-5632684	REAC	Hedgehog 'on' state	10916	1113		0.42857142857142855	0.5	85	10831	5	7	80	10824	10916	0.15431682635611862
R1	cpdb	0	network_modules	186	TRUE	7.3989616356313806e-6	107	11	5	0.45454545454545453	0.04672897196261682	KEGG:04350	KEGG	TGF-beta signaling pathway	8484	304		0.5	0.6666666666666666	107	8377	5	6	102	8371	8484	0.14269184579646188
R1	cpdb	0	network_modules	186	TRUE	9.192973074407795e-6	117	21	6	0.2857142857142857	0.05128205128205128	GO:0030509	GO:BP	BMP signaling pathway	16175	6825		0.21428571428571427	0.26666666666666666	117	16058	6	15	111	16043	16175	0.11848698672504285
R1	cpdb	0	network_modules	186	TRUE	1.0350845613208385e-5	217	21	7	0.3333333333333333	0.03225806451612903	GO:0090092	GO:BP	regulation of transmembrane receptor protein serine/threonine kinase signaling pathway	16175	18013		0.2857142857142857	0.3333333333333333	217	15958	7	14	210	15944	16175	0.1002611981265625
R1	cpdb	0	network_modules	186	TRUE	1.2430592578539658e-5	123	21	6	0.2857142857142857	0.04878048780487805	GO:0071773	GO:BP	cellular response to BMP stimulus	16175	16902		0.35714285714285715	0.4666666666666667	123	16052	6	15	117	16037	16175	0.1154285674370287
R1	cpdb	0	network_modules	186	TRUE	1.2430592578539658e-5	123	21	6	0.2857142857142857	0.04878048780487805	GO:0071772	GO:BP	response to BMP	16175	16901		0.35714285714285715	0.4666666666666667	123	16052	6	15	117	16037	16175	0.1154285674370287
R1	cpdb	0	network_modules	186	TRUE	1.686583492834049e-5	8	12	3	0.25	0.375	REAC:R-HSA-5362798	REAC	Release of Hh-Np from the secreting cell	10916	2055		0.5714285714285714	0.625	8	10908	3	9	5	10899	10916	0.3055685724457451
R1	cpdb	0	network_modules	186	TRUE	7.333291806085497e-5	80	21	5	0.23809523809523808	0.0625	GO:0090100	GO:BP	positive regulation of transmembrane receptor protein serine/threonine kinase signaling pathway	16175	18018		0.5	0.5333333333333333	80	16095	5	16	75	16079	16175	0.11982780182485059
R1	cpdb	0	network_modules	186	TRUE	7.638836185439824e-5	290	21	7	0.3333333333333333	0.02413793103448276	GO:0007178	GO:BP	cell surface receptor protein serine/threonine kinase signaling pathway	16175	2740		0.5714285714285714	0.6	290	15885	7	14	283	15871	16175	0.08570162935317244
R1	cpdb	0	network_modules	186	TRUE	9.6684470217912e-5	149	12	5	0.4166666666666667	0.03355704697986577	REAC:R-HSA-5358351	REAC	Signaling by Hedgehog	10916	2258		0.7142857142857143	0.75	149	10767	5	7	144	10760	10916	0.11522430046838883
R1	cpdb	0	network_modules	186	TRUE	6.05620010167272e-4	12	21	3	0.14285714285714285	0.25	GO:0097264	GO:BP	self proteolysis	16175	18563		0.6428571428571429	0.6666666666666666	12	16163	3	18	9	16145	16175	0.1881927954648218
R1	cpdb	0	network_modules	186	TRUE	0.001085302558041308	56	21	4	0.19047619047619047	0.07142857142857142	GO:0008589	GO:BP	regulation of smoothened signaling pathway	16175	3199		0.7142857142857143	0.7333333333333333	56	16119	4	17	52	16102	16175	0.11479555955280907
R1	cpdb	0	network_modules	186	TRUE	0.001472613086961649	275	21	6	0.2857142857142857	0.02181818181818182	GO:0141091	GO:BP	transforming growth factor beta receptor superfamily signaling pathway	16175	20020		0.7857142857142857	0.8	275	15900	6	15	269	15885	16175	0.07494406503121855
R1	cpdb	0	network_modules	186	TRUE	0.001740595064970278	283	21	6	0.2857142857142857	0.02120141342756184	GO:0001501	GO:BP	skeletal system development	16175	318		0.8571428571428571	0.8666666666666667	283	15892	6	15	277	15877	16175	0.07375977167753275
R1	cpdb	0	network_modules	186	TRUE	0.001970953177264988	157	11	4	0.36363636363636365	0.025477707006369428	KEGG:04390	KEGG	Hippo signaling pathway	8484	310		1	1	157	8327	4	7	153	8320	8484	0.09227162882767366
R1	cpdb	0	network_modules	186	TRUE	0.003291177469690408	5	12	2	0.16666666666666666	0.4	REAC:R-HSA-9758920	REAC	Formation of lateral plate mesoderm	10916	960		0.8571428571428571	0.875	5	10911	2	10	3	10901	10916	0.2576899618144285
R1	cpdb	0	network_modules	186	TRUE	0.004204086732519456	22	21	3	0.14285714285714285	0.13636363636363635	GO:0045880	GO:BP	positive regulation of smoothened signaling pathway	16175	11684		0.9285714285714286	0.9333333333333333	22	16153	3	18	19	16135	16175	0.13842777919895227
R1	cpdb	0	network_modules	186	TRUE	0.005307882235651971	83	21	4	0.19047619047619047	0.04819277108433735	GO:0007224	GO:BP	smoothened signaling pathway	16175	2777		1	1	83	16092	4	17	79	16075	16175	0.09352985913406651
R1	cpdb	0	network_modules	186	TRUE	0.009486506111647216	59	12	3	0.25	0.05084745762711865	REAC:R-HSA-5387390	REAC	Hh mutants abrogate ligand secretion	10916	1121		1	1	59	10857	3	9	56	10848	10916	0.11066952303953095
R1	cpdb	0	network_modules	187	TRUE	2.585708807833892e-28	36	23	14	0.6086956521739131	0.3888888888888889	REAC:R-HSA-390522	REAC	Striated Muscle Contraction	10916	2356		0	0.3333333333333333	36	10880	14	9	22	10871	10916	0.4852089365764871
R1	cpdb	0	network_modules	187	TRUE	7.7886353516101335e-22	193	20	16	0.8	0.08290155440414508	KEGG:04814	KEGG	Motor proteins	8484	366		0	0.2	193	8291	16	4	177	8287	8484	0.2534003284288597
R1	cpdb	0	network_modules	187	TRUE	2.321269617072774e-19	258	33	17	0.5151515151515151	0.06589147286821706	GO:0006936	GO:BP	muscle contraction	16175	2575		0	0.01639344262295082	258	15917	17	16	241	15901	16175	0.1801596588845397
R1	cpdb	0	network_modules	187	TRUE	9.256507675903617e-19	203	23	15	0.6521739130434783	0.07389162561576355	REAC:R-HSA-397014	REAC	Muscle contraction	10916	1496		0.5	0.6666666666666666	203	10713	15	8	188	10705	10916	0.21550123830826284
R1	cpdb	0	network_modules	187	TRUE	3.711607735166604e-18	303	33	17	0.5151515151515151	0.056105610561056105	GO:0003012	GO:BP	muscle system process	16175	1463		0.016666666666666666	0.03278688524590164	303	15872	17	16	286	15856	16175	0.16555174269206413
R1	cpdb	0	network_modules	187	TRUE	7.1622837291913e-18	708	33	21	0.6363636363636364	0.029661016949152543	GO:0030029	GO:BP	actin filament-based process	16175	6653		0.03333333333333333	0.04918032786885246	708	15467	21	12	687	15455	16175	0.1309661262788674
R1	cpdb	0	network_modules	187	TRUE	1.561241306674971e-16	59	33	11	0.3333333333333333	0.1864406779661017	GO:0030239	GO:BP	myofibril assembly	16175	6736		0.05	0.06557377049180328	59	16116	11	22	48	16094	16175	0.2472681052727731
R1	cpdb	0	network_modules	187	TRUE	1.004592021966682e-15	632	33	19	0.5757575757575758	0.030063291139240507	GO:0030036	GO:BP	actin cytoskeleton organization	16175	6660		0.06666666666666667	0.08196721311475409	632	15543	19	14	613	15529	16175	0.12523220516383662
R1	cpdb	0	network_modules	187	TRUE	1.4224468712637717e-14	34	33	9	0.2727272727272727	0.2647058823529412	GO:0045214	GO:BP	sarcomere organization	16175	11327		0.08333333333333333	0.09836065573770492	34	16141	9	24	25	16117	16175	0.26716911201193777
R1	cpdb	0	network_modules	187	TRUE	2.3330369675173547e-14	748	33	19	0.5757575757575758	0.02540106951871658	GO:0097435	GO:BP	supramolecular fiber organization	16175	18657		0.1	0.11475409836065574	748	15427	19	14	729	15413	16175	0.11400082148871901
R1	cpdb	0	network_modules	187	TRUE	4.6967588531846425e-14	96	33	11	0.3333333333333333	0.11458333333333333	GO:0032989	GO:BP	cellular anatomical entity morphogenesis	16175	7969		0.11666666666666667	0.14754098360655737	96	16079	11	22	85	16057	16175	0.1927231143634801
R1	cpdb	0	network_modules	187	TRUE	4.6967588531846425e-14	96	33	11	0.3333333333333333	0.11458333333333333	GO:0010927	GO:BP	cellular component assembly involved in morphogenesis	16175	4511		0.11666666666666667	0.14754098360655737	96	16079	11	22	85	16057	16175	0.1927231143634801
R1	cpdb	0	network_modules	187	TRUE	1.0529711986725632e-13	103	33	11	0.3333333333333333	0.10679611650485436	GO:0055002	GO:BP	striated muscle cell development	16175	14191		0.15	0.16393442622950818	103	16072	11	22	92	16050	16175	0.18585357501926117
R1	cpdb	0	network_modules	187	TRUE	3.832152605827874e-13	14	33	7	0.21212121212121213	0.5	GO:0030049	GO:BP	muscle filament sliding	16175	6668		0.16666666666666666	0.18032786885245902	14	16161	7	26	7	16135	16175	0.32481258448679723
R1	cpdb	0	network_modules	187	TRUE	4.957221266280184e-13	118	33	11	0.3333333333333333	0.09322033898305085	GO:0055001	GO:BP	muscle cell development	16175	14190		0.18333333333333332	0.19672131147540983	118	16057	11	22	107	16035	16175	0.17322787062759837
R1	cpdb	0	network_modules	187	TRUE	1.273791038030507e-12	16	33	7	0.21212121212121213	0.4375	GO:0033275	GO:BP	actin-myosin filament sliding	16175	8109		0.2	0.21311475409836064	16	16159	7	26	9	16133	16175	0.30367530897263584
R1	cpdb	0	network_modules	187	TRUE	3.637384150935849e-11	173	33	11	0.3333333333333333	0.06358381502890173	GO:0031032	GO:BP	actomyosin structure organization	16175	7004		0.21666666666666667	0.22950819672131148	173	16002	11	22	162	15980	16175	0.14181679679764866
R1	cpdb	0	network_modules	187	TRUE	4.1328733866144206e-11	175	33	11	0.3333333333333333	0.06285714285714286	GO:0051146	GO:BP	striated muscle cell differentiation	16175	13529		0.23333333333333334	0.2459016393442623	175	16000	11	22	164	15978	16175	0.1409588571450484
R1	cpdb	0	network_modules	187	TRUE	6.346221073902026e-10	87	20	8	0.4	0.09195402298850575	KEGG:04260	KEGG	Cardiac muscle contraction	8484	296		0.25	0.4	87	8397	8	12	79	8385	8484	0.18805597171507205
R1	cpdb	0	network_modules	187	TRUE	7.374402218686733e-10	407	33	13	0.3939393939393939	0.03194103194103194	GO:0007015	GO:BP	actin filament organization	16175	2624		0.25	0.26229508196721313	407	15768	13	20	394	15748	16175	0.10646357118298118
R1	cpdb	0	network_modules	187	TRUE	1.5497836482283608e-9	97	20	8	0.4	0.08247422680412371	KEGG:05410	KEGG	Hypertrophic cardiomyopathy	8484	489		0.5	0.6	97	8387	8	12	89	8375	8484	0.17766596377709926
R1	cpdb	0	network_modules	187	TRUE	2.0965679769560924e-9	250	33	11	0.3333333333333333	0.044	GO:0042692	GO:BP	muscle cell differentiation	16175	10302		0.26666666666666666	0.2786885245901639	250	15925	11	22	239	15903	16175	0.1165124921167781
R1	cpdb	0	network_modules	187	TRUE	2.3367610483324966e-9	102	20	8	0.4	0.0784313725490196	KEGG:05414	KEGG	Dilated cardiomyopathy	8484	491		0.75	0.8	102	8382	8	12	94	8370	8484	0.17304549997557248
R1	cpdb	0	network_modules	187	TRUE	1.3301922800713203e-8	144	33	9	0.2727272727272727	0.0625	GO:0006941	GO:BP	striated muscle contraction	16175	2579		0.2833333333333333	0.29508196721311475	144	16031	9	24	135	16007	16175	0.12699201009124925
R1	cpdb	0	network_modules	187	TRUE	2.2314001580994272e-8	414	33	12	0.36363636363636365	0.028985507246376812	GO:0061061	GO:BP	muscle structure development	16175	15177		0.3	0.3114754098360656	414	15761	12	21	402	15740	16175	0.0967832737245371
R1	cpdb	0	network_modules	187	TRUE	6.174372409711976e-8	153	20	8	0.4	0.05228758169934641	KEGG:04261	KEGG	Adrenergic signaling in cardiomyocytes	8484	297		1	1	153	8331	8	12	145	8319	8484	0.13952701896630768
R1	cpdb	0	network_modules	187	TRUE	6.42439181489031e-8	343	33	11	0.3333333333333333	0.03206997084548105	GO:0140694	GO:BP	membraneless organelle assembly	16175	19860		0.31666666666666665	0.32786885245901637	343	15832	11	22	332	15810	16175	0.09795803067806881
R1	cpdb	0	network_modules	187	TRUE	1.2599995541864448e-7	36	33	6	0.18181818181818182	0.16666666666666666	GO:0003009	GO:BP	skeletal muscle contraction	16175	1460		0.3333333333333333	0.3442622950819672	36	16139	6	27	30	16112	16175	0.17231428525848433
R1	cpdb	0	network_modules	187	TRUE	2.887878504715433e-7	41	33	6	0.18181818181818182	0.14634146341463414	GO:0050879	GO:BP	multicellular organismal movement	16175	13324		0.35	0.3770491803278688	41	16134	6	27	35	16107	16175	0.1612128765449468
R1	cpdb	0	network_modules	187	TRUE	2.887878504715433e-7	41	33	6	0.18181818181818182	0.14634146341463414	GO:0050881	GO:BP	musculoskeletal movement	16175	13325		0.35	0.3770491803278688	41	16134	6	27	35	16107	16175	0.1612128765449468
R1	cpdb	0	network_modules	187	TRUE	5.420482382504788e-7	86	33	7	0.21212121212121213	0.08139534883720931	GO:0070252	GO:BP	actin-mediated cell contraction	16175	16020		0.38333333333333336	0.39344262295081966	86	16089	7	26	79	16063	16175	0.12857855411437605
R1	cpdb	0	network_modules	187	TRUE	3.1032012382534617e-6	110	33	7	0.21212121212121213	0.06363636363636363	GO:0030048	GO:BP	actin filament-based movement	16175	6667		0.4	0.4098360655737705	110	16065	7	26	103	16039	16175	0.11295836354994941
R1	cpdb	0	network_modules	187	TRUE	4.508643190870378e-6	116	33	7	0.21212121212121213	0.0603448275862069	GO:0030832	GO:BP	regulation of actin filament length	16175	6917		0.4166666666666667	0.4262295081967213	116	16059	7	26	109	16033	16175	0.10982002225641227
R1	cpdb	0	network_modules	187	TRUE	7.83583203460714e-6	43	23	5	0.21739130434782608	0.11627906976744186	REAC:R-HSA-445355	REAC	Smooth Muscle Contraction	10916	2336		1	1	43	10873	5	18	38	10855	10916	0.15658323789861
R1	cpdb	0	network_modules	187	TRUE	9.598369890997079e-6	72	33	6	0.18181818181818182	0.08333333333333333	GO:0050905	GO:BP	neuromuscular process	16175	13347		0.43333333333333335	0.4426229508196721	72	16103	6	27	66	16076	16175	0.12046903748163526
R1	cpdb	0	network_modules	187	TRUE	1.1456172029399557e-5	308	33	9	0.2727272727272727	0.02922077922077922	GO:0032970	GO:BP	regulation of actin filament-based process	16175	7953		0.45	0.45901639344262296	308	15867	9	24	299	15843	16175	0.08392580870648554
R1	cpdb	0	network_modules	187	TRUE	1.2123331379923689e-5	35	33	5	0.15151515151515152	0.14285714285714285	GO:0055010	GO:BP	ventricular cardiac muscle tissue morphogenesis	16175	14199		0.4666666666666667	0.47540983606557374	35	16140	5	28	30	16112	16175	0.14532685034626602
R1	cpdb	0	network_modules	187	TRUE	1.6786468456748786e-5	140	33	7	0.21212121212121213	0.05	GO:0048738	GO:BP	cardiac muscle tissue development	16175	12995		0.48333333333333334	0.4918032786885246	140	16035	7	26	133	16009	16175	0.09931519017165592
R1	cpdb	0	network_modules	187	TRUE	2.7744630120011427e-5	41	33	5	0.15151515151515152	0.12195121951219512	GO:0003229	GO:BP	ventricular cardiac muscle tissue development	16175	1659		0.5	0.5081967213114754	41	16134	5	28	36	16106	16175	0.13396418245720618
R1	cpdb	0	network_modules	187	TRUE	4.003291554820188e-5	44	33	5	0.15151515151515152	0.11363636363636363	GO:0055008	GO:BP	cardiac muscle tissue morphogenesis	16175	14197		0.5166666666666667	0.5245901639344263	44	16131	5	28	39	16103	16175	0.12916762138181118
R1	cpdb	0	network_modules	187	TRUE	6.978648261926232e-5	49	33	5	0.15151515151515152	0.10204081632653061	GO:0048644	GO:BP	muscle organ morphogenesis	16175	12902		0.5333333333333333	0.5573770491803278	49	16126	5	28	44	16098	16175	0.12216480327116819
R1	cpdb	0	network_modules	187	TRUE	6.978648261926232e-5	49	33	5	0.15151515151515152	0.10204081632653061	GO:0060415	GO:BP	muscle tissue morphogenesis	16175	14616		0.5333333333333333	0.5573770491803278	49	16126	5	28	44	16098	16175	0.12216480327116819
R1	cpdb	0	network_modules	187	TRUE	8.922414145256189e-5	274	33	8	0.24242424242424243	0.029197080291970802	GO:0032956	GO:BP	regulation of actin cytoskeleton organization	16175	7940		0.5666666666666667	0.5737704918032787	274	15901	8	25	266	15876	16175	0.07900449852863156
R1	cpdb	0	network_modules	187	TRUE	1.0285133880243312e-4	182	33	7	0.21212121212121213	0.038461538461538464	GO:0007517	GO:BP	muscle organ development	16175	2999		0.5833333333333334	0.5901639344262295	182	15993	7	26	175	15967	16175	0.0861064031772998
R1	cpdb	0	network_modules	187	TRUE	1.0441704774259777e-4	53	33	5	0.15151515151515152	0.09433962264150944	GO:0003208	GO:BP	cardiac ventricle morphogenesis	16175	1638		0.6	0.6065573770491803	53	16122	5	28	48	16094	16175	0.11728329996174003
R1	cpdb	0	network_modules	187	TRUE	1.1505346869018925e-4	185	33	7	0.21212121212121213	0.03783783783783784	GO:0060047	GO:BP	heart contraction	16175	14310		0.6166666666666667	0.6229508196721312	185	15990	7	26	178	15964	16175	0.08533453504054056
R1	cpdb	0	network_modules	187	TRUE	1.3152917971532557e-4	111	33	6	0.18181818181818182	0.05405405405405406	GO:0060048	GO:BP	cardiac muscle contraction	16175	14311		0.6333333333333333	0.639344262295082	111	16064	6	27	105	16037	16175	0.09582138539320471
R1	cpdb	0	network_modules	187	TRUE	1.4316144809489685e-4	191	33	7	0.21212121212121213	0.03664921465968586	GO:0003015	GO:BP	heart process	16175	1466		0.65	0.6557377049180327	191	15984	7	26	184	15958	16175	0.0838440046225807
R1	cpdb	0	network_modules	187	TRUE	1.4634628893377675e-4	113	33	6	0.18181818181818182	0.05309734513274336	GO:0008064	GO:BP	regulation of actin polymerization or depolymerization	16175	3113		0.6666666666666666	0.6721311475409836	113	16062	6	27	107	16035	16175	0.094908412674698
R1	cpdb	0	network_modules	187	TRUE	2.4792128044151475e-4	207	33	7	0.21212121212121213	0.033816425120772944	GO:0014706	GO:BP	striated muscle tissue development	16175	4643		0.6833333333333333	0.6885245901639344	207	15968	7	26	200	15942	16175	0.08018092476186611
R1	cpdb	0	network_modules	187	TRUE	2.520845129675659e-4	63	33	5	0.15151515151515152	0.07936507936507936	GO:0043462	GO:BP	regulation of ATP-dependent activity	16175	10710		0.7	0.7049180327868853	63	16112	5	28	58	16084	16175	0.10715773585009955
R1	cpdb	0	network_modules	187	TRUE	2.9682353725619525e-4	770	33	11	0.3333333333333333	0.014285714285714285	GO:0048646	GO:BP	anatomical structure formation involved in morphogenesis	16175	12904		0.7166666666666667	0.7213114754098361	770	15405	11	22	759	15383	16175	0.060673731274931274
R1	cpdb	0	network_modules	187	TRUE	3.208783550676337e-4	215	33	7	0.21212121212121213	0.03255813953488372	GO:0110053	GO:BP	regulation of actin filament organization	16175	19377		0.7333333333333333	0.7377049180327869	215	15960	7	26	208	15934	16175	0.07849949255475837
R1	cpdb	0	network_modules	187	TRUE	3.868105845118403e-4	221	33	7	0.21212121212121213	0.03167420814479638	GO:0060537	GO:BP	muscle tissue development	16175	14726		0.75	0.7540983606557377	221	15954	7	26	214	15928	16175	0.07729663709985567
R1	cpdb	0	network_modules	187	TRUE	6.502556308643373e-4	76	33	5	0.15151515151515152	0.06578947368421052	GO:0003231	GO:BP	cardiac ventricle development	16175	1661		0.7666666666666667	0.7704918032786885	76	16099	5	28	71	16071	16175	0.09707140909566854
R1	cpdb	0	network_modules	187	TRUE	8.822956378663661e-4	153	33	6	0.18181818181818182	0.0392156862745098	GO:0008154	GO:BP	actin polymerization or depolymerization	16175	3127		0.7833333333333333	0.7868852459016393	153	16022	6	27	147	15995	16175	0.0805105562816142
R1	cpdb	0	network_modules	187	TRUE	0.0010116322308583378	83	33	5	0.15151515151515152	0.060240963855421686	GO:0003206	GO:BP	cardiac chamber morphogenesis	16175	1636		0.8	0.8032786885245902	83	16092	5	28	78	16064	16175	0.0926342255745386
R1	cpdb	0	network_modules	187	TRUE	0.0010715072577942542	257	33	7	0.21212121212121213	0.027237354085603113	GO:0032535	GO:BP	regulation of cellular component size	16175	7629		0.8166666666666667	0.819672131147541	257	15918	7	26	250	15892	16175	0.07095495053000105
R1	cpdb	0	network_modules	187	TRUE	0.0022004823784351245	97	33	5	0.15151515151515152	0.05154639175257732	GO:0030833	GO:BP	regulation of actin filament polymerization	16175	6918		0.8333333333333334	0.8360655737704918	97	16078	5	28	92	16050	16175	0.08521933678326292
R1	cpdb	0	network_modules	187	TRUE	0.0023154385167995146	98	33	5	0.15151515151515152	0.05102040816326531	GO:0003205	GO:BP	cardiac chamber development	16175	1635		0.85	0.8524590163934426	98	16077	5	28	93	16049	16175	0.08475004456056144
R1	cpdb	0	network_modules	187	TRUE	0.0030549134662783335	45	33	4	0.12121212121212122	0.08888888888888889	GO:0030837	GO:BP	negative regulation of actin filament polymerization	16175	6922		0.8666666666666667	0.8688524590163934	45	16130	4	29	41	16101	16175	0.10166256436407971
R1	cpdb	0	network_modules	187	TRUE	0.0032555298772037333	440	33	8	0.24242424242424243	0.01818181818181818	GO:0051493	GO:BP	regulation of cytoskeleton organization	16175	13748		0.8833333333333333	0.8852459016393442	440	15735	8	25	432	15710	16175	0.059820367067508325
R1	cpdb	0	network_modules	187	TRUE	0.004433344484326769	318	33	7	0.21212121212121213	0.0220125786163522	GO:1902903	GO:BP	regulation of supramolecular fiber organization	16175	22602		0.9	0.9016393442622951	318	15857	7	26	311	15831	16175	0.06268184932244496
R1	cpdb	0	network_modules	187	TRUE	0.005328058627066485	116	33	5	0.15151515151515152	0.04310344827586207	GO:0006937	GO:BP	regulation of muscle contraction	16175	2576		0.9166666666666666	0.9180327868852459	116	16059	5	28	111	16031	16175	0.07734492952082594
R1	cpdb	0	network_modules	187	TRUE	0.00554997341634068	329	33	7	0.21212121212121213	0.02127659574468085	GO:0090066	GO:BP	regulation of anatomical structure size	16175	17992		0.9333333333333333	0.9344262295081968	329	15846	7	26	322	15820	16175	0.061428626117126565
R1	cpdb	0	network_modules	187	TRUE	0.007880619852887627	347	33	7	0.21212121212121213	0.020172910662824207	GO:0007507	GO:BP	heart development	16175	2993		0.95	0.9508196721311475	347	15828	7	26	340	15802	16175	0.05950088758336989
R1	cpdb	0	network_modules	187	TRUE	0.007960791731520377	57	33	4	0.12121212121212122	0.07017543859649122	GO:0032272	GO:BP	negative regulation of protein polymerization	16175	7453		0.9666666666666667	0.9672131147540983	57	16118	4	29	53	16089	16175	0.08979711289628535
R1	cpdb	0	network_modules	187	TRUE	0.008312197256746354	127	33	5	0.15151515151515152	0.03937007874015748	GO:0030041	GO:BP	actin filament polymerization	16175	6662		0.9833333333333333	0.9836065573770492	127	16048	5	28	122	16020	16175	0.07359643857346226
R1	cpdb	0	network_modules	187	TRUE	0.009670590591535456	358	33	7	0.21212121212121213	0.019553072625698324	GO:0008015	GO:BP	blood circulation	16175	3096		1	1	358	15817	7	26	351	15791	16175	0.05839099195801173
R1	cpdb	0	network_modules	188	TRUE	1.922953167220462e-5	365	13	7	0.5384615384615384	0.019178082191780823	KEGG:04080	KEGG	Neuroactive ligand-receptor interaction	8484	263		NA	1	365	8119	7	6	358	8113	8484	0.09565282807714501
R1	cpdb	0	network_modules	189	TRUE	4.942322921564439e-10	43	26	7	0.2692307692307692	0.16279069767441862	GO:0042743	GO:BP	hydrogen peroxide metabolic process	16175	10336		0	0.07692307692307693	43	16132	7	19	36	16113	16175	0.20772793565677164
R1	cpdb	0	network_modules	189	TRUE	4.0537327219070695e-8	39	26	6	0.23076923076923078	0.15384615384615385	GO:0045454	GO:BP	cell redox homeostasis	16175	11384		0.08333333333333333	0.15384615384615385	39	16136	6	20	33	16116	16175	0.18682901562490142
R1	cpdb	0	network_modules	189	TRUE	1.4332511002853556e-7	56	20	6	0.3	0.10714285714285714	KEGG:00480	KEGG	Glutathione metabolism	8484	61		0	0.16666666666666666	56	8428	6	14	50	8414	8484	0.17612892558057036
R1	cpdb	0	network_modules	189	TRUE	4.125557022204835e-7	24	26	5	0.19230769230769232	0.20833333333333334	GO:0042744	GO:BP	hydrogen peroxide catabolic process	16175	10337		0.16666666666666666	0.23076923076923078	24	16151	5	21	19	16130	16175	0.19892328940629272
R1	cpdb	0	network_modules	189	TRUE	1.7242374066621785e-6	84	20	6	0.3	0.07142857142857142	KEGG:01232	KEGG	Nucleotide metabolism	8484	189		0.2	0.3333333333333333	84	8400	6	14	78	8386	8484	0.14242780813205183
R1	cpdb	0	network_modules	189	TRUE	1.1819654725955622e-5	175	26	7	0.2692307692307692	0.04	GO:0072593	GO:BP	reactive oxygen species metabolic process	16175	17457		0.25	0.3076923076923077	175	16000	7	19	168	15981	16175	0.10022847948277891
R1	cpdb	0	network_modules	189	TRUE	2.5440641085562742e-5	68	20	5	0.25	0.07352941176470588	KEGG:00982	KEGG	Drug metabolism - cytochrome P450	8484	156		0.4	0.5	68	8416	5	15	63	8401	8484	0.1319194403175118
R1	cpdb	0	network_modules	189	TRUE	6.930282897186173e-5	83	20	5	0.25	0.060240963855421686	KEGG:04146	KEGG	Peroxisome	8484	282		0.6	0.6666666666666666	83	8401	5	15	78	8386	8484	0.11863881812397846
R1	cpdb	0	network_modules	189	TRUE	2.0492315008393378e-4	265	26	7	0.2692307692307692	0.026415094339622643	GO:0006979	GO:BP	response to oxidative stress	16175	2604		0.3333333333333333	0.38461538461538464	265	15910	7	19	258	15891	16175	0.07992059663018301
R1	cpdb	0	network_modules	189	TRUE	2.3285378283610233e-4	36	22	4	0.18181818181818182	0.1111111111111111	REAC:R-HSA-3299685	REAC	Detoxification of Reactive Oxygen Species	10916	735		0	0.125	36	10880	4	18	32	10862	10916	0.1399274823328539
R1	cpdb	0	network_modules	189	TRUE	2.8284057100565066e-4	91	22	5	0.22727272727272727	0.054945054945054944	REAC:R-HSA-15869	REAC	Metabolism of nucleotides	10916	1432		0.14285714285714285	0.25	91	10825	5	17	86	10808	10916	0.10820925014384575
R1	cpdb	0	network_modules	189	TRUE	3.8674432545441717e-4	11	22	3	0.13636363636363635	0.2727272727272727	REAC:R-HSA-73817	REAC	Purine ribonucleoside monophosphate biosynthesis	10916	1824		0.2857142857142857	0.375	11	10905	3	19	8	10886	10916	0.19171201310844765
R1	cpdb	0	network_modules	189	TRUE	5.469080184490279e-4	126	20	5	0.25	0.03968253968253968	KEGG:00230	KEGG	Purine metabolism	8484	22		0.8	0.8333333333333334	126	8358	5	15	121	8343	8484	0.0945003929842353
R1	cpdb	0	network_modules	189	TRUE	8.498439983605701e-4	14	22	3	0.13636363636363635	0.21428571428571427	REAC:R-HSA-8956320	REAC	Nucleotide biosynthesis	10916	1623		0.42857142857142855	0.5	14	10902	3	19	11	10883	10916	0.1696128348949038
R1	cpdb	0	network_modules	189	TRUE	9.329528053337923e-4	211	22	6	0.2727272727272727	0.02843601895734597	REAC:R-HSA-9711123	REAC	Cellular response to chemical stress	10916	333		0.5714285714285714	0.625	211	10705	6	16	205	10689	10916	0.08270838502424233
R1	cpdb	0	network_modules	189	TRUE	0.0012925086367273537	2	22	2	0.09090909090909091	1	REAC:R-HSA-141333	REAC	Biogenic amines are oxidatively deaminated to aldehydes by MAOA and MAOB	10916	226		0.7142857142857143	0.75	2	10914	2	20	0	10894	10916	0.3012349568172482
R1	cpdb	0	network_modules	189	TRUE	0.0018422277729335168	14	26	3	0.11538461538461539	0.21428571428571427	GO:0009168	GO:BP	purine ribonucleoside monophosphate biosynthetic process	16175	3334		0.4166666666666667	0.46153846153846156	14	16161	3	23	11	16138	16175	0.15625642062334155
R1	cpdb	0	network_modules	189	TRUE	0.0019043752476083301	79	20	4	0.2	0.05063291139240506	KEGG:00983	KEGG	Drug metabolism - other enzymes	8484	157		1	1	79	8405	4	16	75	8389	8484	0.09650939587052607
R1	cpdb	0	network_modules	189	TRUE	0.002300329022634316	15	26	3	0.11538461538461539	0.2	GO:0009127	GO:BP	purine nucleoside monophosphate biosynthetic process	16175	3294		0.5	0.5384615384615384	15	16160	3	23	12	16137	16175	0.15088121656469844
R1	cpdb	0	network_modules	189	TRUE	0.002389342609204167	558	26	8	0.3076923076923077	0.014336917562724014	GO:0055086	GO:BP	nucleobase-containing small molecule metabolic process	16175	14237		0.5833333333333334	0.6153846153846154	558	15617	8	18	550	15599	16175	0.06006401974120901
R1	cpdb	0	network_modules	189	TRUE	0.0038727888435273945	3	22	2	0.09090909090909091	0.6666666666666666	REAC:R-HSA-140179	REAC	Amine Oxidase reactions	10916	138		0.8571428571428571	0.875	3	10913	2	20	1	10893	10916	0.24572021915797454
R1	cpdb	0	network_modules	189	TRUE	0.004086488663090117	23	22	3	0.13636363636363635	0.13043478260869565	REAC:R-HSA-9748787	REAC	Azathioprine ADME	10916	197		1	1	23	10893	3	19	20	10874	10916	0.13157678726397642
R1	cpdb	0	network_modules	189	TRUE	0.005732798402039871	20	26	3	0.11538461538461539	0.15	GO:0009156	GO:BP	ribonucleoside monophosphate biosynthetic process	16175	3323		0.6666666666666666	0.6923076923076923	20	16155	3	23	17	16132	16175	0.1303342339743215
R1	cpdb	0	network_modules	189	TRUE	0.007727800711620386	22	26	3	0.11538461538461539	0.13636363636363635	GO:0009167	GO:BP	purine ribonucleoside monophosphate metabolic process	16175	3333		0.75	0.7692307692307693	22	16153	3	23	19	16130	16175	0.12414189032667687
R1	cpdb	0	network_modules	189	TRUE	0.008877495418110313	23	26	3	0.11538461538461539	0.13043478260869565	GO:0009126	GO:BP	purine nucleoside monophosphate metabolic process	16175	3293		0.8333333333333334	1	23	16152	3	23	20	16129	16175	0.12135109035153473
R1	cpdb	0	network_modules	189	TRUE	0.008877495418110313	23	26	3	0.11538461538461539	0.13043478260869565	GO:0009124	GO:BP	nucleoside monophosphate biosynthetic process	16175	3291		0.8333333333333334	1	23	16152	3	23	20	16129	16175	0.12135109035153473
R1	cpdb	0	network_modules	189	TRUE	0.008877495418110313	23	26	3	0.11538461538461539	0.13043478260869565	GO:0098869	GO:BP	cellular oxidant detoxification	16175	18920		0.8333333333333334	1	23	16152	3	23	20	16129	16175	0.12135109035153473
R1	cpdb	0	network_modules	190	TRUE	6.1653669588634884e-27	24	28	13	0.4642857142857143	0.5416666666666666	REAC:R-HSA-379716	REAC	Cytosolic tRNA aminoacylation	10916	430		0	0.125	24	10892	13	15	11	10877	10916	0.5003027617717605
R1	cpdb	0	network_modules	190	TRUE	3.2465019321465585e-24	38	32	13	0.40625	0.34210526315789475	GO:0006418	GO:BP	tRNA aminoacylation for protein translation	16175	2175		0	0.09090909090909091	38	16137	13	19	25	16118	16175	0.371448456751513
R1	cpdb	0	network_modules	190	TRUE	6.628263120160222e-24	247	32	19	0.59375	0.07692307692307693	GO:0006520	GO:BP	amino acid metabolic process	16175	2241		0.1	0.18181818181818182	247	15928	19	13	228	15915	16175	0.21003227851206063
R1	cpdb	0	network_modules	190	TRUE	1.0529409275531272e-23	41	32	13	0.40625	0.3170731707317073	GO:0043038	GO:BP	amino acid activation	16175	10488		0.2	0.36363636363636365	41	16134	13	19	28	16115	16175	0.3574697753858505
R1	cpdb	0	network_modules	190	TRUE	1.0529409275531272e-23	41	32	13	0.40625	0.3170731707317073	GO:0043039	GO:BP	tRNA aminoacylation	16175	10489		0.2	0.36363636363636365	41	16134	13	19	28	16115	16175	0.3574697753858505
R1	cpdb	0	network_modules	190	TRUE	6.159422037588445e-23	42	28	13	0.4642857142857143	0.30952380952380953	REAC:R-HSA-379724	REAC	tRNA Aminoacylation	10916	2740		0.14285714285714285	0.25	42	10874	13	15	29	10859	10916	0.377155528657911
R1	cpdb	0	network_modules	190	TRUE	6.195624632644097e-22	44	28	13	0.4642857142857143	0.29545454545454547	KEGG:00970	KEGG	Aminoacyl-tRNA biosynthesis	8484	153		0	0.3333333333333333	44	8440	13	15	31	8425	8484	0.36779551495468404
R1	cpdb	0	network_modules	190	TRUE	1.6994075188003256e-14	186	32	13	0.40625	0.06989247311827956	GO:0006399	GO:BP	tRNA metabolic process	16175	2160		0.4	0.45454545454545453	186	15989	13	19	173	15970	16175	0.16484774878181124
R1	cpdb	0	network_modules	190	TRUE	2.3998169885595e-11	292	28	13	0.4642857142857143	0.04452054794520548	REAC:R-HSA-72766	REAC	Translation	10916	2565		0.2857142857142857	0.375	292	10624	13	15	279	10609	10916	0.13751396711953828
R1	cpdb	0	network_modules	190	TRUE	2.854823404603089e-8	566	32	13	0.40625	0.022968197879858657	GO:0006412	GO:BP	translation	16175	2170		0.5	0.5454545454545454	566	15609	13	19	553	15590	16175	0.08995118763641086
R1	cpdb	0	network_modules	190	TRUE	4.443525747809045e-6	117	28	7	0.25	0.05982905982905983	REAC:R-HSA-2408522	REAC	Selenoamino acid metabolism	10916	2187		0.42857142857142855	0.5	117	10799	7	21	110	10778	10916	0.11784018908984248
R1	cpdb	0	network_modules	190	TRUE	6.970400200805587e-5	370	28	9	0.32142857142857145	0.024324324324324326	REAC:R-HSA-71291	REAC	Metabolism of amino acids and derivatives	10916	1421		0.5714285714285714	0.625	370	10546	9	19	361	10527	10916	0.08057716775766638
R1	cpdb	0	network_modules	190	TRUE	5.32932850163985e-4	153	28	6	0.21428571428571427	0.0392156862745098	KEGG:01240	KEGG	Biosynthesis of cofactors	8484	190		0.5	0.6666666666666666	153	8331	6	22	147	8309	8484	0.08486262936430763
R1	cpdb	0	network_modules	190	TRUE	0.0021150141328265793	2	28	2	0.07142857142857142	1	REAC:R-HSA-5578999	REAC	Defective GCLC causes HAGGSD	10916	556		0.7142857142857143	0.875	2	10914	2	26	0	10888	10916	0.26694270903326517
R1	cpdb	0	network_modules	190	TRUE	0.0021150141328265793	2	28	2	0.07142857142857142	1	REAC:R-HSA-916853	REAC	Degradation of GABA	10916	721		0.7142857142857143	0.875	2	10914	2	26	0	10888	10916	0.26694270903326517
R1	cpdb	0	network_modules	190	TRUE	0.005576234529139214	2	32	2	0.0625	1	GO:0015965	GO:BP	diadenosine tetraphosphate metabolic process	16175	5046		0.6	1	2	16173	2	30	0	16143	16175	0.2497680244466571
R1	cpdb	0	network_modules	190	TRUE	0.005576234529139214	2	32	2	0.0625	1	GO:0015966	GO:BP	diadenosine tetraphosphate biosynthetic process	16175	5047		0.6	1	2	16173	2	30	0	16143	16175	0.2497680244466571
R1	cpdb	0	network_modules	190	TRUE	0.005576234529139214	2	32	2	0.0625	1	GO:0015960	GO:BP	diadenosine polyphosphate biosynthetic process	16175	5041		0.6	1	2	16173	2	30	0	16143	16175	0.2497680244466571
R1	cpdb	0	network_modules	190	TRUE	0.005576234529139214	2	32	2	0.0625	1	GO:0006425	GO:BP	glutaminyl-tRNA aminoacylation	16175	2182		0.6	1	2	16173	2	30	0	16143	16175	0.2497680244466571
R1	cpdb	0	network_modules	190	TRUE	0.005576234529139214	2	32	2	0.0625	1	GO:0009450	GO:BP	gamma-aminobutyric acid catabolic process	16175	3497		0.6	1	2	16173	2	30	0	16143	16175	0.2497680244466571
R1	cpdb	0	network_modules	190	TRUE	0.005624287039499959	27	28	3	0.10714285714285714	0.1111111111111111	KEGG:00650	KEGG	Butanoate metabolism	8484	112		1	1	27	8457	3	25	24	8432	8484	0.10621236182597123
R1	cpdb	0	network_modules	190	TRUE	0.006497052513124942	21	28	3	0.10714285714285714	0.14285714285714285	REAC:R-HSA-379726	REAC	Mitochondrial tRNA aminoacylation	10916	1470		1	1	21	10895	3	25	18	10870	10916	0.12176983109925771
R1	cpdb	0	network_modules	191	TRUE	2.4596622675212864e-8	5	23	4	0.17391304347826086	0.8	REAC:R-HSA-74713	REAC	IRS activation	10916	1163		0	0.14285714285714285	5	10911	4	19	1	10892	10916	0.3724973925153196
R1	cpdb	0	network_modules	191	TRUE	4.42592592715433e-7	199	24	8	0.3333333333333333	0.04020100502512563	GO:0071375	GO:BP	cellular response to peptide hormone stimulus	16175	16627		0	0.02127659574468085	199	15976	8	16	191	15960	16175	0.11226278008871926
R1	cpdb	0	network_modules	191	TRUE	6.163883188938613e-7	9	23	4	0.17391304347826086	0.4444444444444444	REAC:R-HSA-74749	REAC	Signal attenuation	10916	2214		0.16666666666666666	0.2857142857142857	9	10907	4	19	5	10888	10916	0.2771074238607614
R1	cpdb	0	network_modules	191	TRUE	1.7139929158052156e-6	236	24	8	0.3333333333333333	0.03389830508474576	GO:0043434	GO:BP	response to peptide hormone	16175	10691		0.021739130434782608	0.0425531914893617	236	15939	8	16	228	15923	16175	0.10247176255274253
R1	cpdb	0	network_modules	191	TRUE	3.1928674652609933e-6	84	24	6	0.25	0.07142857142857142	GO:0008286	GO:BP	insulin receptor signaling pathway	16175	3153		0.043478260869565216	0.06382978723404255	84	16091	6	18	78	16073	16175	0.13129328641129165
R1	cpdb	0	network_modules	191	TRUE	7.760486160949807e-6	791	24	11	0.4583333333333333	0.01390644753476612	GO:1901701	GO:BP	cellular response to oxygen-containing compound	16175	21654		0.06521739130434782	0.0851063829787234	791	15384	11	13	780	15371	16175	0.07318258306076257
R1	cpdb	0	network_modules	191	TRUE	4.248106299228168e-5	23	23	4	0.17391304347826086	0.17391304347826086	REAC:R-HSA-982772	REAC	Growth hormone receptor signaling	10916	1085		0.3333333333333333	0.42857142857142855	23	10893	4	19	19	10874	10916	0.17216880405844998
R1	cpdb	0	network_modules	191	TRUE	4.4759285037255744e-5	5	24	3	0.125	0.6	GO:1990036	GO:BP	calcium ion import into sarcoplasmic reticulum	16175	25058		0.08695652173913043	0.10638297872340426	5	16170	3	21	2	16149	16175	0.27342919440425356
R1	cpdb	0	network_modules	191	TRUE	6.984277353408227e-5	140	24	6	0.25	0.04285714285714286	GO:0032869	GO:BP	cellular response to insulin stimulus	16175	7866		0.10869565217391304	0.1276595744680851	140	16035	6	18	134	16017	16175	0.10043600035559488
R1	cpdb	0	network_modules	191	TRUE	8.518577724521335e-5	26	24	4	0.16666666666666666	0.15384615384615385	GO:0090075	GO:BP	relaxation of muscle	16175	17999		0.13043478260869565	0.14893617021276595	26	16149	4	20	22	16129	16175	0.15882928177839048
R1	cpdb	0	network_modules	191	TRUE	9.990172978933945e-5	27	24	4	0.16666666666666666	0.14814814814814814	GO:0005979	GO:BP	regulation of glycogen biosynthetic process	16175	1854		0.15217391304347827	0.2127659574468085	27	16148	4	20	23	16128	16175	0.1558066942008116
R1	cpdb	0	network_modules	191	TRUE	9.990172978933945e-5	27	24	4	0.16666666666666666	0.14814814814814814	GO:0046627	GO:BP	negative regulation of insulin receptor signaling pathway	16175	12264		0.15217391304347827	0.2127659574468085	27	16148	4	20	23	16128	16175	0.1558066942008116
R1	cpdb	0	network_modules	191	TRUE	9.990172978933945e-5	27	24	4	0.16666666666666666	0.14814814814814814	GO:0010962	GO:BP	regulation of glucan biosynthetic process	16175	4539		0.15217391304347827	0.2127659574468085	27	16148	4	20	23	16128	16175	0.1558066942008116
R1	cpdb	0	network_modules	191	TRUE	1.1407345052790111e-4	152	24	6	0.25	0.039473684210526314	GO:0032868	GO:BP	response to insulin	16175	7865		0.21739130434782608	0.23404255319148937	152	16023	6	18	146	16005	16175	0.09612960019116353
R1	cpdb	0	network_modules	191	TRUE	1.1643667176113948e-4	28	24	4	0.16666666666666666	0.14285714285714285	GO:1900077	GO:BP	negative regulation of cellular response to insulin stimulus	16175	20374		0.2391304347826087	0.2553191489361702	28	16147	4	20	24	16127	16175	0.1529465441689966
R1	cpdb	0	network_modules	191	TRUE	1.1731657116347879e-4	73	23	5	0.21739130434782608	0.0684931506849315	REAC:R-HSA-74752	REAC	Signaling by Insulin receptor	10916	2260		0.5	0.5714285714285714	73	10843	5	18	68	10825	10916	0.11879278193092019
R1	cpdb	0	network_modules	191	TRUE	1.1979154362179902e-4	790	24	10	0.4166666666666667	0.012658227848101266	GO:0007167	GO:BP	enzyme-linked receptor protein signaling pathway	16175	2731		0.2608695652173913	0.2765957446808511	790	15385	10	14	780	15371	16175	0.06578549823687567
R1	cpdb	0	network_modules	191	TRUE	1.3073446249148188e-4	164	21	6	0.2857142857142857	0.036585365853658534	KEGG:04022	KEGG	cGMP-PKG signaling pathway	8484	251		0	0.16666666666666666	164	8320	6	15	158	8305	8484	0.09637676151709064
R1	cpdb	0	network_modules	191	TRUE	1.5635251887141397e-4	7	24	3	0.125	0.42857142857142855	GO:1901894	GO:BP	regulation of ATPase-coupled calcium transmembrane transporter activity	16175	21838		0.2826086956521739	0.2978723404255319	7	16168	3	21	4	16147	16175	0.23087496910088323
R1	cpdb	0	network_modules	191	TRUE	1.7840356932660563e-4	31	24	4	0.16666666666666666	0.12903225806451613	GO:0070873	GO:BP	regulation of glycogen metabolic process	16175	16349		0.30434782608695654	0.3191489361702128	31	16144	4	20	27	16124	16175	0.14520766540677896
R1	cpdb	0	network_modules	191	TRUE	1.8819708945121922e-4	431	24	8	0.3333333333333333	0.018561484918793503	GO:1901699	GO:BP	cellular response to nitrogen compound	16175	21652		0.32608695652173914	0.3404255319148936	431	15744	8	16	423	15728	16175	0.07340908014215228
R1	cpdb	0	network_modules	191	TRUE	2.3155350559415187e-4	33	24	4	0.16666666666666666	0.12121212121212122	GO:0032885	GO:BP	regulation of polysaccharide biosynthetic process	16175	7881		0.34782608695652173	0.3617021276595745	33	16142	4	20	29	16122	16175	0.14064174805694146
R1	cpdb	0	network_modules	191	TRUE	2.6648921760478143e-4	451	24	8	0.3333333333333333	0.017738359201773836	GO:0032870	GO:BP	cellular response to hormone stimulus	16175	7867		0.3695652173913043	0.3829787234042553	451	15724	8	16	443	15708	16175	0.07151904027902818
R1	cpdb	0	network_modules	191	TRUE	2.95702699034101e-4	35	24	4	0.16666666666666666	0.11428571428571428	GO:0070296	GO:BP	sarcoplasmic reticulum calcium ion transport	16175	16040		0.391304347826087	0.40425531914893614	35	16140	4	20	31	16120	16175	0.13647019038274022
R1	cpdb	0	network_modules	191	TRUE	3.391094998958637e-4	108	21	5	0.23809523809523808	0.046296296296296294	KEGG:04931	KEGG	Insulin resistance	8484	388		0.2	0.3333333333333333	108	8376	5	16	103	8360	8484	0.10013943870496113
R1	cpdb	0	network_modules	191	TRUE	3.7225067479315904e-4	37	24	4	0.16666666666666666	0.10810810810810811	GO:0046324	GO:BP	regulation of D-glucose import	16175	12057		0.41304347826086957	0.48936170212765956	37	16138	4	20	33	16118	16175	0.13263902154438909
R1	cpdb	0	network_modules	191	TRUE	3.7225067479315904e-4	37	24	4	0.16666666666666666	0.10810810810810811	GO:0005978	GO:BP	glycogen biosynthetic process	16175	1853		0.41304347826086957	0.48936170212765956	37	16138	4	20	33	16118	16175	0.13263902154438909
R1	cpdb	0	network_modules	191	TRUE	3.7225067479315904e-4	37	24	4	0.16666666666666666	0.10810810810810811	GO:0032881	GO:BP	regulation of polysaccharide metabolic process	16175	7878		0.41304347826086957	0.48936170212765956	37	16138	4	20	33	16118	16175	0.13263902154438909
R1	cpdb	0	network_modules	191	TRUE	3.7225067479315904e-4	37	24	4	0.16666666666666666	0.10810810810810811	GO:0009250	GO:BP	glucan biosynthetic process	16175	3415		0.41304347826086957	0.48936170212765956	37	16138	4	20	33	16118	16175	0.13263902154438909
R1	cpdb	0	network_modules	191	TRUE	6.806931103843763e-4	510	24	8	0.3333333333333333	0.01568627450980392	GO:0007169	GO:BP	cell surface receptor protein tyrosine kinase signaling pathway	16175	2733		0.5	0.5106382978723404	510	15665	8	16	502	15649	16175	0.06657692706644668
R1	cpdb	0	network_modules	191	TRUE	6.93191457848113e-4	45	23	4	0.17391304347826086	0.08888888888888889	REAC:R-HSA-74751	REAC	Insulin receptor signalling cascade	10916	1211		0.6666666666666666	0.7142857142857143	45	10871	4	19	41	10852	10916	0.12176612074911033
R1	cpdb	0	network_modules	191	TRUE	8.331566585486729e-4	45	24	4	0.16666666666666666	0.08888888888888889	GO:0046626	GO:BP	regulation of insulin receptor signaling pathway	16175	12263		0.5217391304347826	0.5531914893617021	45	16130	4	20	41	16110	16175	0.11994023481958847
R1	cpdb	0	network_modules	191	TRUE	8.331566585486729e-4	45	24	4	0.16666666666666666	0.08888888888888889	GO:1900076	GO:BP	regulation of cellular response to insulin stimulus	16175	20373		0.5217391304347826	0.5531914893617021	45	16130	4	20	41	16110	16175	0.11994023481958847
R1	cpdb	0	network_modules	191	TRUE	8.501816659318926e-4	61	21	4	0.19047619047619047	0.06557377049180328	KEGG:04213	KEGG	Longevity regulating pathway - multiple species	8484	290		0.4	0.5	61	8423	4	17	57	8406	8484	0.10806363011643282
R1	cpdb	0	network_modules	191	TRUE	8.894098355294265e-4	354	24	7	0.2916666666666667	0.01977401129943503	GO:0034762	GO:BP	regulation of transmembrane transport	16175	8731		0.5652173913043478	0.574468085106383	354	15821	7	17	347	15804	16175	0.07107928180918925
R1	cpdb	0	network_modules	191	TRUE	0.0010352700254210802	539	24	8	0.3333333333333333	0.014842300556586271	GO:0009725	GO:BP	response to hormone	16175	3623		0.5869565217391305	0.5957446808510638	539	15636	8	16	531	15620	16175	0.06443608698867846
R1	cpdb	0	network_modules	191	TRUE	0.0010854386134328885	137	21	5	0.23809523809523808	0.0364963503649635	KEGG:04910	KEGG	Insulin signaling pathway	8484	367		0.6	0.6666666666666666	137	8347	5	16	132	8331	8484	0.08771468470420724
R1	cpdb	0	network_modules	191	TRUE	0.0011800933229164172	49	24	4	0.16666666666666666	0.08163265306122448	GO:0010827	GO:BP	regulation of D-glucose transmembrane transport	16175	4437		0.6086956521739131	0.6170212765957447	49	16126	4	20	45	16106	16175	0.11478130018486503
R1	cpdb	0	network_modules	191	TRUE	0.001281440419746232	50	24	4	0.16666666666666666	0.08	GO:0046323	GO:BP	D-glucose import	16175	12056		0.6304347826086957	0.6382978723404256	50	16125	4	20	46	16105	16175	0.11358828228005226
R1	cpdb	0	network_modules	191	TRUE	0.001452983561970654	54	23	4	0.17391304347826086	0.07407407407407407	REAC:R-HSA-5578775	REAC	Ion homeostasis	10916	1273		0.8333333333333334	0.8571428571428571	54	10862	4	19	50	10843	10916	0.11066280919575078
R1	cpdb	0	network_modules	191	TRUE	0.001503393320158339	52	24	4	0.16666666666666666	0.07692307692307693	GO:0005977	GO:BP	glycogen metabolic process	16175	1852		0.6521739130434783	0.6595744680851063	52	16123	4	20	48	16103	16175	0.11130518282332948
R1	cpdb	0	network_modules	191	TRUE	0.0015647584521585327	55	23	4	0.17391304347826086	0.07272727272727272	REAC:R-HSA-936837	REAC	Ion transport by P-type ATPases	10916	1275		1	1	55	10861	4	19	51	10842	10916	0.10959776360658763
R1	cpdb	0	network_modules	191	TRUE	0.0016150142932310726	14	24	3	0.125	0.21428571428571427	GO:0045725	GO:BP	positive regulation of glycogen biosynthetic process	16175	11567		0.6739130434782609	0.6808510638297872	14	16161	3	21	11	16140	16175	0.16272131740802678
R1	cpdb	0	network_modules	191	TRUE	0.001624509615523333	53	24	4	0.16666666666666666	0.07547169811320754	GO:0000271	GO:BP	polysaccharide biosynthetic process	16175	74		0.6956521739130435	0.723404255319149	53	16122	4	20	49	16102	16175	0.11021185061745167
R1	cpdb	0	network_modules	191	TRUE	0.001624509615523333	53	24	4	0.16666666666666666	0.07547169811320754	GO:0044042	GO:BP	glucan metabolic process	16175	10891		0.6956521739130435	0.723404255319149	53	16122	4	20	49	16102	16175	0.11021185061745167
R1	cpdb	0	network_modules	191	TRUE	0.0020168021160694542	15	24	3	0.125	0.2	GO:0070875	GO:BP	positive regulation of glycogen metabolic process	16175	16351		0.7391304347826086	0.7446808510638298	15	16160	3	21	12	16139	16175	0.15713029557594074
R1	cpdb	0	network_modules	191	TRUE	0.0029339132016994876	619	24	8	0.3333333333333333	0.012924071082390954	GO:1901698	GO:BP	response to nitrogen compound	16175	21651		0.7608695652173914	0.7659574468085106	619	15556	8	16	611	15540	16175	0.05928880867579365
R1	cpdb	0	network_modules	191	TRUE	0.0030673011598895588	62	24	4	0.16666666666666666	0.06451612903225806	GO:0006112	GO:BP	energy reserve metabolic process	16175	1971		0.782608695652174	0.7872340425531915	62	16113	4	20	58	16093	16175	0.10158045498144225
R1	cpdb	0	network_modules	191	TRUE	0.0032968362412703106	2	24	2	0.08333333333333333	1	GO:0032470	GO:BP	positive regulation of endoplasmic reticulum calcium ion concentration	16175	7585		0.8043478260869565	0.851063829787234	2	16173	2	22	0	16151	16175	0.28847872656338225
R1	cpdb	0	network_modules	191	TRUE	0.0032968362412703106	2	24	2	0.08333333333333333	1	GO:1901876	GO:BP	regulation of calcium ion binding	16175	21820		0.8043478260869565	0.851063829787234	2	16173	2	22	0	16151	16175	0.28847872656338225
R1	cpdb	0	network_modules	191	TRUE	0.0032968362412703106	2	24	2	0.08333333333333333	1	GO:1901877	GO:BP	negative regulation of calcium ion binding	16175	21821		0.8043478260869565	0.851063829787234	2	16173	2	22	0	16151	16175	0.28847872656338225
R1	cpdb	0	network_modules	191	TRUE	0.003802610202520603	89	21	4	0.19047619047619047	0.0449438202247191	KEGG:04211	KEGG	Longevity regulating pathway	8484	288		0.8	0.8333333333333334	89	8395	4	17	85	8378	8484	0.08799969368373825
R1	cpdb	0	network_modules	191	TRUE	0.00472059961142502	69	24	4	0.16666666666666666	0.057971014492753624	GO:0043255	GO:BP	regulation of carbohydrate biosynthetic process	16175	10589		0.8695652173913043	0.8723404255319149	69	16106	4	20	65	16086	16175	0.09605501368088011
R1	cpdb	0	network_modules	191	TRUE	0.005295103282008657	71	24	4	0.16666666666666666	0.056338028169014086	GO:0005976	GO:BP	polysaccharide metabolic process	16175	1851		0.8913043478260869	0.8936170212765957	71	16104	4	20	67	16084	16175	0.09462624130317772
R1	cpdb	0	network_modules	191	TRUE	0.006957263558012986	76	24	4	0.16666666666666666	0.05263157894736842	GO:1904659	GO:BP	D-glucose transmembrane transport	16175	23999		0.9130434782608695	0.9148936170212766	76	16099	4	20	72	16079	16175	0.09130053649606168
R1	cpdb	0	network_modules	191	TRUE	0.00698759920226666	202	21	5	0.23809523809523808	0.024752475247524754	KEGG:05415	KEGG	Diabetic cardiomyopathy	8484	492		1	1	202	8282	5	16	197	8266	8484	0.0700161228525199
R1	cpdb	0	network_modules	191	TRUE	0.007018461639834767	307	24	6	0.25	0.019543973941368076	GO:0051051	GO:BP	negative regulation of transport	16175	13461		0.9347826086956522	0.9361702127659575	307	15868	6	18	301	15850	16175	0.06526339647505126
R1	cpdb	0	network_modules	191	TRUE	0.008542609148804024	80	24	4	0.16666666666666666	0.05	GO:0008645	GO:BP	hexose transmembrane transport	16175	3222		0.9565217391304348	0.9574468085106383	80	16095	4	20	76	16075	16175	0.08886392631018665
R1	cpdb	0	network_modules	191	TRUE	0.009428521836291321	82	24	4	0.16666666666666666	0.04878048780487805	GO:0015749	GO:BP	monosaccharide transmembrane transport	16175	4868		0.9782608695652174	0.9787234042553191	82	16093	4	20	78	16073	16175	0.08771187047416024
R1	cpdb	0	network_modules	191	TRUE	0.009881539404908083	3	24	2	0.08333333333333333	0.6666666666666666	GO:1901895	GO:BP	negative regulation of ATPase-coupled calcium transmembrane transporter activity	16175	21839		1	1	3	16172	2	22	1	16150	16175	0.23537416597204877
R1	cpdb	0	network_modules	192	TRUE	1.0553749047284479e-12	35	28	8	0.2857142857142857	0.22857142857142856	GO:0000184	GO:BP	nuclear-transcribed mRNA catabolic process, nonsense-mediated decay	16175	57		0	0.02702702702702703	35	16140	8	20	27	16120	16175	0.2541101074907205
R1	cpdb	0	network_modules	192	TRUE	2.248092174279936e-12	96	24	10	0.4166666666666667	0.10416666666666667	KEGG:03015	KEGG	mRNA surveillance pathway	8484	210		0	0.3333333333333333	96	8388	10	14	86	8374	8484	0.2041210472092481
R1	cpdb	0	network_modules	192	TRUE	5.090758757449114e-10	183	28	10	0.35714285714285715	0.0546448087431694	GO:0071805	GO:BP	potassium ion transmembrane transport	16175	16918		0.027777777777777776	0.05405405405405406	183	15992	10	18	173	15974	16175	0.13616390035533107
R1	cpdb	0	network_modules	192	TRUE	7.872417938539209e-10	116	25	9	0.36	0.07758620689655173	REAC:R-HSA-927802	REAC	Nonsense-Mediated Decay (NMD)	10916	1608		0	0.13333333333333333	116	10800	9	16	107	10784	10916	0.16324827931016633
R1	cpdb	0	network_modules	192	TRUE	7.872417938539209e-10	116	25	9	0.36	0.07758620689655173	REAC:R-HSA-975957	REAC	Nonsense Mediated Decay (NMD) enhanced by the Exon Junction Complex (EJC)	10916	1606		0	0.13333333333333333	116	10800	9	16	107	10784	10916	0.16324827931016633
R1	cpdb	0	network_modules	192	TRUE	1.123669019725413e-9	198	28	10	0.35714285714285715	0.050505050505050504	GO:0006813	GO:BP	potassium ion transport	16175	2493		0.05555555555555555	0.08108108108108109	198	15977	10	18	188	15959	16175	0.13061485133016368
R1	cpdb	0	network_modules	192	TRUE	1.4156183182064163e-9	43	25	7	0.28	0.16279069767441862	REAC:R-HSA-1296072	REAC	Voltage gated Potassium channels	10916	2663		0.14285714285714285	0.2	43	10873	7	18	36	10855	10916	0.21115215442781957
R1	cpdb	0	network_modules	192	TRUE	2.0198873830836556e-8	108	24	8	0.3333333333333333	0.07407407407407407	KEGG:03013	KEGG	Nucleocytoplasmic transport	8484	209		0.5	0.6666666666666666	108	8376	8	16	100	8360	8484	0.15232077169554117
R1	cpdb	0	network_modules	192	TRUE	2.1054069823559864e-8	113	28	8	0.2857142857142857	0.07079646017699115	GO:0000956	GO:BP	nuclear-transcribed mRNA catabolic process	16175	264		0.08333333333333333	0.10810810810810811	113	16062	8	20	105	16042	16175	0.13935394055251554
R1	cpdb	0	network_modules	192	TRUE	2.624391510619664e-7	7	25	4	0.16	0.5714285714285714	REAC:R-HSA-5576894	REAC	Phase 1 - inactivation of fast Na+ channels	10916	1733		0.21428571428571427	0.26666666666666666	7	10909	4	21	3	10888	10916	0.30160188201565996
R1	cpdb	0	network_modules	192	TRUE	3.253418958682889e-7	630	28	12	0.42857142857142855	0.01904761904761905	GO:0098660	GO:BP	inorganic ion transmembrane transport	16175	18816		0.1111111111111111	0.13513513513513514	630	15545	12	16	618	15529	16175	0.08386016231521129
R1	cpdb	0	network_modules	192	TRUE	6.712808841895893e-7	671	28	12	0.42857142857142855	0.01788375558867362	GO:0034220	GO:BP	monoatomic ion transmembrane transport	16175	8508		0.1388888888888889	0.16216216216216217	671	15504	12	16	659	15488	16175	0.0808357674910833
R1	cpdb	0	network_modules	192	TRUE	7.978733616843588e-7	103	25	7	0.28	0.06796116504854369	REAC:R-HSA-1296071	REAC	Potassium Channels	10916	1780		0.2857142857142857	0.3333333333333333	103	10813	7	18	96	10795	10916	0.13408445952863798
R1	cpdb	0	network_modules	192	TRUE	2.2262644874859473e-6	575	28	11	0.39285714285714285	0.019130434782608695	GO:0098662	GO:BP	inorganic cation transmembrane transport	16175	18818		0.16666666666666666	0.1891891891891892	575	15600	11	17	564	15583	16175	0.08035713713785875
R1	cpdb	0	network_modules	192	TRUE	2.3091284346236895e-6	577	28	11	0.39285714285714285	0.019064124783362217	GO:0098655	GO:BP	monoatomic cation transmembrane transport	16175	18811		0.19444444444444445	0.21621621621621623	577	15598	11	17	566	15581	16175	0.08019513040951569
R1	cpdb	0	network_modules	192	TRUE	2.9111431151274448e-6	69	28	6	0.21428571428571427	0.08695652173913043	GO:0006406	GO:BP	mRNA export from nucleus	16175	2167		0.2222222222222222	0.24324324324324326	69	16106	6	22	63	16084	16175	0.13418976086501352
R1	cpdb	0	network_modules	192	TRUE	5.265738487212237e-6	76	28	6	0.21428571428571427	0.07894736842105263	GO:0051028	GO:BP	mRNA transport	16175	13445		0.25	0.2702702702702703	76	16099	6	22	70	16077	16175	0.1276249825035527
R1	cpdb	0	network_modules	192	TRUE	5.406064737850061e-6	226	28	8	0.2857142857142857	0.035398230088495575	GO:0006402	GO:BP	mRNA catabolic process	16175	2163		0.2777777777777778	0.2972972972972973	226	15949	8	20	218	15929	16175	0.0964080661242998
R1	cpdb	0	network_modules	192	TRUE	1.2301482293001739e-5	677	28	11	0.39285714285714285	0.01624815361890694	GO:0030001	GO:BP	metal ion transport	16175	6646		0.3055555555555556	0.32432432432432434	677	15498	11	17	666	15481	16175	0.07298865174206072
R1	cpdb	0	network_modules	192	TRUE	1.4752977595295185e-5	90	28	6	0.21428571428571427	0.06666666666666667	GO:0006405	GO:BP	RNA export from nucleus	16175	2166		0.3333333333333333	0.35135135135135137	90	16085	6	22	84	16063	16175	0.1168457531506748
R1	cpdb	0	network_modules	192	TRUE	1.4924245662163748e-5	4	25	3	0.12	0.75	REAC:R-HSA-111957	REAC	Cam-PDE 1 activation	10916	303		0.35714285714285715	0.4	4	10912	3	22	1	10890	10916	0.29948186161293255
R1	cpdb	0	network_modules	192	TRUE	2.7321281039463465e-5	171	25	7	0.28	0.04093567251461988	REAC:R-HSA-9010553	REAC	Regulation of expression of SLITs and ROBOs	10916	2031		0.42857142857142855	0.4666666666666667	171	10745	7	18	164	10727	10916	0.10198890491329973
R1	cpdb	0	network_modules	192	TRUE	2.81640075870697e-5	279	28	8	0.2857142857142857	0.02867383512544803	GO:0006401	GO:BP	RNA catabolic process	16175	2162		0.3611111111111111	0.3783783783783784	279	15896	8	20	271	15876	16175	0.08586570653665898
R1	cpdb	0	network_modules	192	TRUE	3.459110455669689e-5	748	28	11	0.39285714285714285	0.014705882352941176	GO:0006812	GO:BP	monoatomic cation transport	16175	2492		0.3888888888888889	0.40540540540540543	748	15427	11	17	737	15410	16175	0.06872751072872621
R1	cpdb	0	network_modules	192	TRUE	4.825346225911335e-5	299	28	8	0.2857142857142857	0.026755852842809364	GO:0141188	GO:BP	nucleic acid catabolic process	16175	20075		0.4166666666666667	0.43243243243243246	299	15876	8	20	291	15856	16175	0.0826142147044959
R1	cpdb	0	network_modules	192	TRUE	6.144323319177152e-5	114	28	6	0.21428571428571427	0.05263157894736842	GO:0050657	GO:BP	nucleic acid transport	16175	13197		0.4444444444444444	0.4864864864864865	114	16061	6	22	108	16039	16175	0.10315912283442562
R1	cpdb	0	network_modules	192	TRUE	6.144323319177152e-5	114	28	6	0.21428571428571427	0.05263157894736842	GO:0050658	GO:BP	RNA transport	16175	13198		0.4444444444444444	0.4864864864864865	114	16061	6	22	108	16039	16175	0.10315912283442562
R1	cpdb	0	network_modules	192	TRUE	7.180394925972226e-5	117	28	6	0.21428571428571427	0.05128205128205128	GO:0051236	GO:BP	establishment of RNA localization	16175	13586		0.5	0.5135135135135135	117	16058	6	22	111	16036	16175	0.10174635165941912
R1	cpdb	0	network_modules	192	TRUE	1.390393290061449e-4	217	25	7	0.28	0.03225806451612903	REAC:R-HSA-376176	REAC	Signaling by ROBO receptors	10916	2301		0.5	0.5333333333333333	217	10699	7	18	210	10681	10916	0.08928396708467415
R1	cpdb	0	network_modules	192	TRUE	3.035123263911171e-4	149	28	6	0.21428571428571427	0.040268456375838924	GO:0006403	GO:BP	RNA localization	16175	2164		0.5277777777777778	0.5405405405405406	149	16026	6	22	143	16004	16175	0.08938861600242556
R1	cpdb	0	network_modules	192	TRUE	3.415686300677181e-4	152	28	6	0.21428571428571427	0.039473684210526314	GO:0051168	GO:BP	nuclear export	16175	13551		0.5555555555555556	0.5675675675675675	152	16023	6	22	146	16001	16175	0.0884303303265175
R1	cpdb	0	network_modules	192	TRUE	6.170281129877747e-4	168	28	6	0.21428571428571427	0.03571428571428571	GO:0015931	GO:BP	nucleobase-containing compound transport	16175	5016		0.5833333333333334	0.5945945945945946	168	16007	6	22	162	15985	16175	0.08374975339694535
R1	cpdb	0	network_modules	192	TRUE	0.001071070390282925	448	28	8	0.2857142857142857	0.017857142857142856	GO:0034655	GO:BP	nucleobase-containing compound catabolic process	16175	8711		0.6111111111111112	0.6216216216216216	448	15727	8	20	440	15707	16175	0.06547328442280721
R1	cpdb	0	network_modules	192	TRUE	0.001743828060791088	12	28	3	0.10714285714285714	0.25	GO:2000622	GO:BP	regulation of nuclear-transcribed mRNA catabolic process, nonsense-mediated decay	16175	25904		0.6388888888888888	0.6486486486486487	12	16163	3	25	9	16138	16175	0.16273140207277706
R1	cpdb	0	network_modules	192	TRUE	0.0017731506814441475	2	25	2	0.08	1	REAC:R-HSA-5679096	REAC	Defective ABCG5 causes sitosterolemia	10916	471		0.5714285714285714	0.6666666666666666	2	10914	2	23	0	10891	10916	0.28254452604712355
R1	cpdb	0	network_modules	192	TRUE	0.0017731506814441475	2	25	2	0.08	1	REAC:R-HSA-5679090	REAC	Defective ABCG8 causes GBD4 and sitosterolemia	10916	472		0.5714285714285714	0.6666666666666666	2	10914	2	23	0	10891	10916	0.28254452604712355
R1	cpdb	0	network_modules	192	TRUE	0.0018126584154033864	108	28	5	0.17857142857142858	0.046296296296296294	GO:0001508	GO:BP	action potential	16175	323		0.6666666666666666	0.6756756756756757	108	16067	5	23	103	16044	16175	0.087894152433735
R1	cpdb	0	network_modules	192	TRUE	0.0019222095621152912	46	28	4	0.14285714285714285	0.08695652173913043	GO:0086009	GO:BP	membrane repolarization	16175	17883		0.6944444444444444	0.7027027027027027	46	16129	4	24	42	16105	16175	0.10948733272780738
R1	cpdb	0	network_modules	192	TRUE	0.002307739262435894	69	24	4	0.16666666666666666	0.057971014492753624	KEGG:04924	KEGG	Renin secretion	8484	381		1	1	69	8415	4	20	65	8395	8484	0.094013694166422
R1	cpdb	0	network_modules	192	TRUE	0.002553707250026746	56	25	4	0.16	0.07142857142857142	REAC:R-HSA-72187	REAC	mRNA 3'-end processing	10916	2701		0.7142857142857143	0.7333333333333333	56	10860	4	21	52	10839	10916	0.1038622647259157
R1	cpdb	0	network_modules	192	TRUE	0.0034265471746125374	130	25	5	0.2	0.038461538461538464	REAC:R-HSA-5576891	REAC	Cardiac conduction	10916	306		0.7857142857142857	0.8	130	10786	5	20	125	10766	10916	0.08307407165431621
R1	cpdb	0	network_modules	192	TRUE	0.004418291146288086	16	28	3	0.10714285714285714	0.1875	GO:0097623	GO:BP	potassium ion export across plasma membrane	16175	18713		0.7222222222222222	0.7297297297297297	16	16159	3	25	13	16134	16175	0.14061938357001555
R1	cpdb	0	network_modules	192	TRUE	0.004642481921176187	65	25	4	0.16	0.06153846153846154	REAC:R-HSA-73856	REAC	RNA Polymerase II Transcription Termination	10916	1895		0.8571428571428571	0.8666666666666667	65	10851	4	21	61	10830	10916	0.09593054975345325
R1	cpdb	0	network_modules	192	TRUE	0.004982325234183615	2	28	2	0.07142857142857142	1	GO:0010949	GO:BP	negative regulation of intestinal phytosterol absorption	16175	4527		0.75	0.8378378378378378	2	16173	2	26	0	16147	16175	0.2670463285603229
R1	cpdb	0	network_modules	192	TRUE	0.004982325234183615	2	28	2	0.07142857142857142	1	GO:0060752	GO:BP	intestinal phytosterol absorption	16175	14920		0.75	0.8378378378378378	2	16173	2	26	0	16147	16175	0.2670463285603229
R1	cpdb	0	network_modules	192	TRUE	0.004982325234183615	2	28	2	0.07142857142857142	1	GO:1904730	GO:BP	negative regulation of intestinal lipid absorption	16175	24060		0.75	0.8378378378378378	2	16173	2	26	0	16147	16175	0.2670463285603229
R1	cpdb	0	network_modules	192	TRUE	0.004982325234183615	2	28	2	0.07142857142857142	1	GO:0045796	GO:BP	negative regulation of intestinal cholesterol absorption	16175	11624		0.75	0.8378378378378378	2	16173	2	26	0	16147	16175	0.2670463285603229
R1	cpdb	0	network_modules	192	TRUE	0.005070260249704647	381	28	7	0.25	0.01837270341207349	GO:0044057	GO:BP	regulation of system process	16175	10893		0.8611111111111112	0.8648648648648649	381	15794	7	21	374	15773	16175	0.062177293723369505
R1	cpdb	0	network_modules	192	TRUE	0.006601176332624161	71	25	4	0.16	0.056338028169014086	REAC:R-HSA-159236	REAC	Transport of Mature mRNA derived from an Intron-Containing Transcript	10916	2586		0.9285714285714286	0.9333333333333333	71	10845	4	21	67	10824	10916	0.09148547700886611
R1	cpdb	0	network_modules	192	TRUE	0.00761867105046191	19	28	3	0.10714285714285714	0.15789473684210525	GO:0086013	GO:BP	membrane repolarization during cardiac muscle cell action potential	16175	17887		0.8888888888888888	0.8918918918918919	19	16156	3	25	16	16131	16175	0.1288276952064913
R1	cpdb	0	network_modules	192	TRUE	0.007797063322564959	65	28	4	0.14285714285714285	0.06153846153846154	GO:1901379	GO:BP	regulation of potassium ion transmembrane transport	16175	21429		0.9166666666666666	0.918918918918919	65	16110	4	24	61	16086	16175	0.09138673179113517
R1	cpdb	0	network_modules	192	TRUE	0.008034246595815062	261	28	6	0.21428571428571427	0.022988505747126436	GO:0006913	GO:BP	nucleocytoplasmic transport	16175	2562		0.9444444444444444	0.972972972972973	261	15914	6	22	255	15892	16175	0.0654878715101142
R1	cpdb	0	network_modules	192	TRUE	0.008034246595815062	261	28	6	0.21428571428571427	0.022988505747126436	GO:0051169	GO:BP	nuclear transport	16175	13552		0.9444444444444444	0.972972972972973	261	15914	6	22	255	15892	16175	0.0654878715101142
R1	cpdb	0	network_modules	192	TRUE	0.008035900028655351	400	25	7	0.28	0.0175	REAC:R-HSA-112316	REAC	Neuronal System	10916	1590		1	1	400	10516	7	18	393	10498	10916	0.06205651626899848
R1	cpdb	0	network_modules	192	TRUE	0.008388999117297529	590	28	8	0.2857142857142857	0.013559322033898305	GO:0016071	GO:BP	mRNA metabolic process	16175	5098		1	1	590	15585	8	20	582	15565	16175	0.05536211247384937
R1	cpdb	0	network_modules	193	TRUE	1.403947993321637e-7	49	22	6	0.2727272727272727	0.12244897959183673	REAC:R-HSA-6811440	REAC	Retrograde transport at the Trans-Golgi-Network	10916	2096		0	0.14285714285714285	49	10867	6	16	43	10851	10916	0.18032225826920284
R1	cpdb	0	network_modules	193	TRUE	5.16168974760276e-7	9	22	4	0.18181818181818182	0.4444444444444444	REAC:R-HSA-1296052	REAC	Ca2+ activated K+ channels	10916	295		0.16666666666666666	0.2857142857142857	9	10907	4	18	5	10889	10916	0.2833810065188784
R1	cpdb	0	network_modules	193	TRUE	5.547693886873508e-6	15	22	4	0.18181818181818182	0.26666666666666666	REAC:R-HSA-418457	REAC	cGMP effects	10916	2691		0.3333333333333333	0.42857142857142855	15	10901	4	18	11	10883	10916	0.218899592836248
R1	cpdb	0	network_modules	193	TRUE	2.4132484961465207e-5	21	22	4	0.18181818181818182	0.19047619047619047	REAC:R-HSA-392154	REAC	Nitric oxide stimulates guanylate cyclase	10916	1601		0.5	0.5714285714285714	21	10895	4	18	17	10877	10916	0.18449116021832385
R1	cpdb	0	network_modules	193	TRUE	2.010656846914115e-4	85	22	5	0.22727272727272727	0.058823529411764705	REAC:R-HSA-418346	REAC	Platelet homeostasis	10916	1765		0.6666666666666666	0.7142857142857143	85	10831	5	17	80	10814	10916	0.11221327807683253
R1	cpdb	0	network_modules	193	TRUE	5.241596214400697e-4	103	22	5	0.22727272727272727	0.04854368932038835	REAC:R-HSA-1296071	REAC	Potassium Channels	10916	1780		0.8333333333333334	0.8571428571428571	103	10813	5	17	98	10796	10916	0.10125609820918427
R1	cpdb	0	network_modules	193	TRUE	7.241719504757004e-4	202	22	6	0.2727272727272727	0.0297029702970297	REAC:R-HSA-6811442	REAC	Intra-Golgi and retrograde Golgi-to-ER traffic	10916	1262		1	1	202	10714	6	16	196	10698	10916	0.08477023047509266
R1	cpdb	0	network_modules	193	TRUE	0.001063844581604754	14	22	3	0.13636363636363635	0.21428571428571427	GO:0005513	GO:BP	detection of calcium ion	16175	1849		0	0.25	14	16161	3	19	11	16142	16175	0.17004509759073805
R1	cpdb	0	network_modules	193	TRUE	0.0023178171706393575	677	22	8	0.36363636363636365	0.011816838995568686	GO:0030001	GO:BP	metal ion transport	16175	6646		0.3333333333333333	0.5	677	15498	8	14	669	15484	16175	0.059300471204093985
R1	cpdb	0	network_modules	193	TRUE	0.004883981595285748	748	22	8	0.36363636363636365	0.0106951871657754	GO:0006812	GO:BP	monoatomic cation transport	16175	2492		0.6666666666666666	0.75	748	15427	8	14	740	15413	16175	0.0557742435661486
R1	cpdb	0	network_modules	193	TRUE	0.006792388208783714	85	10	3	0.3	0.03529411764705882	KEGG:04911	KEGG	Insulin secretion	8484	368		NA	1	85	8399	3	7	82	8392	8484	0.1000237035112913
R1	cpdb	0	network_modules	193	TRUE	0.00975805893646308	94	22	4	0.18181818181818182	0.0425531914893617	GO:0042147	GO:BP	retrograde transport, endosome to Golgi	16175	9990		1	1	94	16081	4	18	90	16063	16175	0.08545508103456813
R1	cpdb	0	network_modules	194	TRUE	8.920285506089016e-7	39	17	5	0.29411764705882354	0.1282051282051282	REAC:R-HSA-420499	REAC	Class C/3 (Metabotropic glutamate/pheromone receptors)	10916	367		0	0.5	39	10877	5	12	34	10865	10916	0.19231850079584725
R1	cpdb	0	network_modules	194	TRUE	5.1564814756123094e-6	13	26	4	0.15384615384615385	0.3076923076923077	GO:0007216	GO:BP	G protein-coupled glutamate receptor signaling pathway	16175	2770		0	0.125	13	16162	4	22	9	16140	16175	0.21669595891045385
R1	cpdb	0	network_modules	194	TRUE	7.385539330163913e-5	312	17	7	0.4117647058823529	0.022435897435897436	REAC:R-HSA-418594	REAC	G alpha (i) signalling events	10916	987		1	1	312	10604	7	10	305	10594	10916	0.09082146859606262
R1	cpdb	0	network_modules	194	TRUE	1.0214054554477656e-4	115	16	5	0.3125	0.043478260869565216	KEGG:04724	KEGG	Glutamatergic synapse	8484	354		0	0.2	115	8369	5	11	110	8358	8484	0.1123766088984199
R1	cpdb	0	network_modules	194	TRUE	2.1793836196153514e-4	774	26	10	0.38461538461538464	0.012919896640826873	GO:0007186	GO:BP	G protein-coupled receptor signaling pathway	16175	2744		0.14285714285714285	0.25	774	15401	10	16	764	15385	16175	0.06330507932857037
R1	cpdb	0	network_modules	194	TRUE	3.4320055235528607e-4	147	16	5	0.3125	0.034013605442176874	KEGG:04072	KEGG	Phospholipase D signaling pathway	8484	261		0.25	0.4	147	8337	5	11	142	8326	8484	0.09832946607739469
R1	cpdb	0	network_modules	194	TRUE	7.084095985923842e-4	41	26	4	0.15384615384615385	0.0975609756097561	GO:0007215	GO:BP	glutamate receptor signaling pathway	16175	2769		0.2857142857142857	0.375	41	16134	4	22	37	16112	16175	0.12074433881771884
R1	cpdb	0	network_modules	194	TRUE	0.0011158129876016666	12	26	3	0.11538461538461539	0.25	GO:0007194	GO:BP	negative regulation of adenylate cyclase activity	16175	2752		0.42857142857142855	0.5	12	16163	3	23	9	16140	16175	0.16894800003492952
R1	cpdb	0	network_modules	194	TRUE	0.0011749518642782415	89	16	4	0.25	0.0449438202247191	KEGG:05032	KEGG	Morphine addiction	8484	420		0.5	0.6	89	8395	4	12	85	8383	8484	0.1021851805703158
R1	cpdb	0	network_modules	194	TRUE	0.0014490099394394822	13	26	3	0.11538461538461539	0.23076923076923078	GO:0031280	GO:BP	negative regulation of cyclase activity	16175	7104		0.5714285714285714	0.625	13	16162	3	23	10	16139	16175	0.16223747198685623
R1	cpdb	0	network_modules	194	TRUE	0.002300329022634316	15	26	3	0.11538461538461539	0.2	GO:0051350	GO:BP	negative regulation of lyase activity	16175	13677		0.7142857142857143	0.75	15	16160	3	23	12	16137	16175	0.15088121656469844
R1	cpdb	0	network_modules	194	TRUE	0.0023496619006924766	55	26	4	0.15384615384615385	0.07272727272727272	GO:0051966	GO:BP	regulation of synaptic transmission, glutamatergic	16175	14035		0.8571428571428571	0.875	55	16120	4	22	51	16098	16175	0.10369897883128286
R1	cpdb	0	network_modules	194	TRUE	0.0025976306122133075	223	16	5	0.3125	0.02242152466367713	KEGG:04024	KEGG	cAMP signaling pathway	8484	252		0.75	0.8	223	8261	5	11	218	8250	8484	0.07776679870575248
R1	cpdb	0	network_modules	194	TRUE	0.00604147479493553	49	16	3	0.1875	0.061224489795918366	KEGG:05030	KEGG	Cocaine addiction	8484	418		1	1	49	8435	3	13	46	8422	8484	0.10424204922054718
R1	cpdb	0	network_modules	194	TRUE	0.008639015077545349	76	26	4	0.15384615384615385	0.05263157894736842	GO:0035249	GO:BP	synaptic transmission, glutamatergic	16175	8924		1	1	76	16099	4	22	72	16077	16175	0.08751208044771674
R1	cpdb	0	network_modules	195	TRUE	2.8882098118282e-5	7	16	3	0.1875	0.42857142857142855	REAC:R-HSA-9833576	REAC	CDH11 homotypic and heterotypic interactions	10916	271		0	0.1111111111111111	7	10909	3	13	4	10896	10916	0.28280181556864015
R1	cpdb	0	network_modules	195	TRUE	9.875914151246782e-5	10	16	3	0.1875	0.3	REAC:R-HSA-9762292	REAC	Regulation of CDH11 function	10916	1967		0.125	0.2222222222222222	10	10906	3	13	7	10893	10916	0.2362934703535439
R1	cpdb	0	network_modules	195	TRUE	1.0678818553252491e-4	42	16	4	0.25	0.09523809523809523	REAC:R-HSA-3769402	REAC	Deactivation of the beta-catenin transactivating complex	10916	452		0.25	0.3333333333333333	42	10874	4	12	38	10862	10916	0.15233338731847706
R1	cpdb	0	network_modules	195	TRUE	3.216794380465631e-4	55	16	4	0.25	0.07272727272727272	REAC:R-HSA-418990	REAC	Adherens junctions interactions	10916	121		0.375	0.4444444444444444	55	10861	4	12	51	10849	10916	0.13255371187136145
R1	cpdb	0	network_modules	195	TRUE	3.6045143442815027e-4	45	20	4	0.2	0.08888888888888889	GO:0034332	GO:BP	adherens junction organization	16175	8574		0	0.2	45	16130	4	16	41	16114	16175	0.131743367152938
R1	cpdb	0	network_modules	195	TRUE	0.0010316268764931065	143	20	5	0.25	0.03496503496503497	GO:0007043	GO:BP	cell-cell junction assembly	16175	2647		0.25	0.4	143	16032	5	15	138	16017	16175	0.09064581602597127
R1	cpdb	0	network_modules	195	TRUE	0.0020409843648803165	87	16	4	0.25	0.04597701149425287	REAC:R-HSA-421270	REAC	Cell-cell junction organization	10916	329		0.5	0.5555555555555556	87	10829	4	12	83	10817	10916	0.10428593817143536
R1	cpdb	0	network_modules	195	TRUE	0.0023709448219664943	27	16	3	0.1875	0.1111111111111111	REAC:R-HSA-9759475	REAC	Regulation of CDH11 Expression and Function	10916	1966		0.625	0.6666666666666666	27	10889	3	13	24	10876	10916	0.1427146241737168
R1	cpdb	0	network_modules	195	TRUE	0.003127411349317719	179	20	5	0.25	0.027932960893854747	GO:0045216	GO:BP	cell-cell junction organization	16175	11328		0.5	0.6	179	15996	5	15	174	15981	16175	0.08036199493410265
R1	cpdb	0	network_modules	195	TRUE	0.0031829833432179314	533	20	7	0.35	0.013133208255159476	GO:0034330	GO:BP	cell junction organization	16175	8572		0.75	0.8	533	15642	7	13	526	15629	16175	0.06249150155196778
R1	cpdb	0	network_modules	195	TRUE	0.003282136692844115	30	16	3	0.1875	0.1	REAC:R-HSA-9759476	REAC	Regulation of Homotypic Cell-Cell Adhesion	10916	1978		0.75	0.8888888888888888	30	10886	3	13	27	10873	10916	0.1352085064936884
R1	cpdb	0	network_modules	195	TRUE	0.003282136692844115	30	16	3	0.1875	0.1	REAC:R-HSA-9764260	REAC	Regulation of Expression and Function of Type II Classical Cadherins	10916	1972		0.75	0.8888888888888888	30	10886	3	13	27	10873	10916	0.1352085064936884
R1	cpdb	0	network_modules	195	TRUE	0.004058777946424487	346	20	6	0.3	0.017341040462427744	GO:0034329	GO:BP	cell junction assembly	16175	8571		1	1	346	15829	6	14	340	15815	16175	0.06775418148930393
R1	cpdb	0	network_modules	195	TRUE	0.005974321177556288	114	16	4	0.25	0.03508771929824561	REAC:R-HSA-446728	REAC	Cell junction organization	10916	324		1	1	114	10802	4	12	110	10790	10916	0.09028465096346232
R1	cpdb	0	network_modules	196	TRUE	5.09092914262621e-12	28	19	7	0.3684210526315789	0.25	REAC:R-HSA-350054	REAC	Notch-HLH transcription pathway	10916	1610		0	0.04	28	10888	7	12	21	10876	10916	0.30202575213395827
R1	cpdb	0	network_modules	196	TRUE	2.2617375118523883e-10	46	19	7	0.3684210526315789	0.15217391304347827	REAC:R-HSA-2122947	REAC	NOTCH1 Intracellular Domain Regulates Transcription	10916	1532		0.041666666666666664	0.08	46	10870	7	12	39	10858	10916	0.23476941519045408
R1	cpdb	0	network_modules	196	TRUE	1.105382384430682e-9	57	19	7	0.3684210526315789	0.12280701754385964	REAC:R-HSA-2644602	REAC	Signaling by NOTCH1 PEST Domain Mutants in Cancer	10916	2278		0.08333333333333333	0.28	57	10859	7	12	50	10847	10916	0.21042608823570602
R1	cpdb	0	network_modules	196	TRUE	1.105382384430682e-9	57	19	7	0.3684210526315789	0.12280701754385964	REAC:R-HSA-2894858	REAC	Signaling by NOTCH1 HD+PEST Domain Mutants in Cancer	10916	2277		0.08333333333333333	0.28	57	10859	7	12	50	10847	10916	0.21042608823570602
R1	cpdb	0	network_modules	196	TRUE	1.105382384430682e-9	57	19	7	0.3684210526315789	0.12280701754385964	REAC:R-HSA-2644606	REAC	Constitutive Signaling by NOTCH1 PEST Domain Mutants	10916	406		0.08333333333333333	0.28	57	10859	7	12	50	10847	10916	0.21042608823570602
R1	cpdb	0	network_modules	196	TRUE	1.105382384430682e-9	57	19	7	0.3684210526315789	0.12280701754385964	REAC:R-HSA-2894862	REAC	Constitutive Signaling by NOTCH1 HD+PEST Domain Mutants	10916	405		0.08333333333333333	0.28	57	10859	7	12	50	10847	10916	0.21042608823570602
R1	cpdb	0	network_modules	196	TRUE	1.105382384430682e-9	57	19	7	0.3684210526315789	0.12280701754385964	REAC:R-HSA-2644603	REAC	Signaling by NOTCH1 in Cancer	10916	2279		0.08333333333333333	0.28	57	10859	7	12	50	10847	10916	0.21042608823570602
R1	cpdb	0	network_modules	196	TRUE	6.07033315791764e-9	72	19	7	0.3684210526315789	0.09722222222222222	REAC:R-HSA-1980143	REAC	Signaling by NOTCH1	10916	2275		0.2916666666666667	0.32	72	10844	7	12	65	10832	10916	0.18664858256588482
R1	cpdb	0	network_modules	196	TRUE	2.9676446821801074e-6	83	24	6	0.25	0.07228915662650602	GO:0043535	GO:BP	regulation of blood vessel endothelial cell migration	16175	10756		0	0.0625	83	16092	6	18	77	16074	16175	0.13211109281429217
R1	cpdb	0	network_modules	196	TRUE	3.400277186502026e-6	418	19	9	0.47368421052631576	0.0215311004784689	REAC:R-HSA-5663202	REAC	Diseases of signal transduction by growth factor receptors and second messengers	10916	773		0.3333333333333333	0.36	418	10498	9	10	409	10488	10916	0.0947383176031094
R1	cpdb	0	network_modules	196	TRUE	7.760486160949807e-6	791	24	11	0.4583333333333333	0.01390644753476612	GO:0000122	GO:BP	negative regulation of transcription by RNA polymerase II	16175	48		0.06666666666666667	0.125	791	15384	11	13	780	15371	16175	0.07318258306076257
R1	cpdb	0	network_modules	196	TRUE	1.0396262307296127e-5	102	24	6	0.25	0.058823529411764705	GO:0043534	GO:BP	blood vessel endothelial cell migration	16175	10755		0.13333333333333333	0.1875	102	16073	6	18	96	16055	16175	0.11867149958894527
R1	cpdb	0	network_modules	196	TRUE	2.3105843917707458e-5	232	19	7	0.3684210526315789	0.03017241379310345	REAC:R-HSA-157118	REAC	Signaling by NOTCH	10916	2274		0.375	0.4	232	10684	7	12	225	10672	10916	0.10051142151658371
R1	cpdb	0	network_modules	196	TRUE	2.838381137275285e-5	6	19	3	0.15789473684210525	0.5	REAC:R-HSA-9022537	REAC	Loss of MECP2 binding ability to the NCoR/SMRT complex	10916	1330		0.4166666666666667	0.44	6	10910	3	16	3	10894	10916	0.28031867571142527
R1	cpdb	0	network_modules	196	TRUE	1.2814836918024835e-4	155	24	6	0.25	0.03870967741935484	GO:0010594	GO:BP	regulation of endothelial cell migration	16175	4242		0.2	0.25	155	16020	6	18	149	16002	16175	0.09513029235962892
R1	cpdb	0	network_modules	196	TRUE	2.3155350559415187e-4	33	24	4	0.16666666666666666	0.12121212121212122	GO:0090049	GO:BP	regulation of cell migration involved in sprouting angiogenesis	16175	17977		0.26666666666666666	0.3125	33	16142	4	20	29	16122	16175	0.14064174805694146
R1	cpdb	0	network_modules	196	TRUE	2.3288181911626814e-4	11	19	3	0.15789473684210525	0.2727272727272727	REAC:R-HSA-9005895	REAC	Pervasive developmental disorders	10916	1729		0.4583333333333333	0.6	11	10905	3	16	8	10889	10916	0.2064737038345342
R1	cpdb	0	network_modules	196	TRUE	2.3288181911626814e-4	11	19	3	0.15789473684210525	0.2727272727272727	REAC:R-HSA-9005891	REAC	Loss of function of MECP2 in Rett syndrome	10916	1332		0.4583333333333333	0.6	11	10905	3	16	8	10889	10916	0.2064737038345342
R1	cpdb	0	network_modules	196	TRUE	2.3288181911626814e-4	11	19	3	0.15789473684210525	0.2727272727272727	REAC:R-HSA-9697154	REAC	Disorders of Nervous System Development	10916	777		0.4583333333333333	0.6	11	10905	3	16	8	10889	10916	0.2064737038345342
R1	cpdb	0	network_modules	196	TRUE	2.3288181911626814e-4	11	19	3	0.15789473684210525	0.2727272727272727	REAC:R-HSA-9675151	REAC	Disorders of Developmental Biology	10916	776		0.4583333333333333	0.6	11	10905	3	16	8	10889	10916	0.2064737038345342
R1	cpdb	0	network_modules	196	TRUE	3.551392023185713e-4	47	19	4	0.21052631578947367	0.0851063829787234	REAC:R-HSA-9707616	REAC	Heme signaling	10916	1117		0.625	0.64	47	10869	4	15	43	10854	10916	0.13151503505432155
R1	cpdb	0	network_modules	196	TRUE	4.6267562207770246e-4	39	24	4	0.16666666666666666	0.10256410256410256	GO:0006476	GO:BP	protein deacetylation	16175	2213		0.3333333333333333	0.375	39	16136	4	20	35	16116	16175	0.12910408307256965
R1	cpdb	0	network_modules	196	TRUE	5.142158783368583e-4	196	24	6	0.25	0.030612244897959183	GO:0043542	GO:BP	endothelial cell migration	16175	10759		0.4	0.4375	196	15979	6	18	190	15961	16175	0.0838127180527561
R1	cpdb	0	network_modules	196	TRUE	5.791966524905563e-4	53	19	4	0.21052631578947367	0.07547169811320754	REAC:R-HSA-2151201	REAC	Transcriptional activation of mitochondrial biogenesis	10916	2548		0.6666666666666666	0.68	53	10863	4	15	49	10848	10916	0.12355126843844282
R1	cpdb	0	network_modules	196	TRUE	8.942891081314875e-4	59	19	4	0.21052631578947367	0.06779661016949153	REAC:R-HSA-8986944	REAC	Transcriptional Regulation by MECP2	10916	2544		0.7083333333333334	0.72	59	10857	4	15	55	10842	10916	0.11681992177256229
R1	cpdb	0	network_modules	196	TRUE	9.95415566087303e-4	47	24	4	0.16666666666666666	0.0851063829787234	GO:0098732	GO:BP	macromolecule deacylation	16175	18861		0.4666666666666667	0.5625	47	16128	4	20	43	16108	16175	0.11727929832485437
R1	cpdb	0	network_modules	196	TRUE	9.95415566087303e-4	47	24	4	0.16666666666666666	0.0851063829787234	GO:0035601	GO:BP	protein deacylation	16175	9110		0.4666666666666667	0.5625	47	16128	4	20	43	16108	16175	0.11727929832485437
R1	cpdb	0	network_modules	196	TRUE	0.001084833005377294	48	24	4	0.16666666666666666	0.08333333333333333	GO:0002042	GO:BP	cell migration involved in sprouting angiogenesis	16175	642		0.6	0.625	48	16127	4	20	44	16107	16175	0.11601099343237364
R1	cpdb	0	network_modules	196	TRUE	0.001270176640289424	13	24	3	0.125	0.23076923076923078	GO:0071498	GO:BP	cellular response to fluid shear stress	16175	16731		0.6666666666666666	0.6875	13	16162	3	21	10	16141	16175	0.1689427654824629
R1	cpdb	0	network_modules	196	TRUE	0.0014928546893296978	67	19	4	0.21052631578947367	0.05970149253731343	REAC:R-HSA-400253	REAC	Circadian Clock	10916	363		0.75	0.76	67	10849	4	15	63	10834	10916	0.10927256304084418
R1	cpdb	0	network_modules	196	TRUE	0.0019475584997937733	174	19	5	0.2631578947368421	0.028735632183908046	KEGG:04310	KEGG	Wnt signaling pathway	8484	299		0	0.25	174	8310	5	14	169	8296	8484	0.08110858291147506
R1	cpdb	0	network_modules	196	TRUE	0.002753344571755127	187	19	5	0.2631578947368421	0.026737967914438502	KEGG:05034	KEGG	Alcoholism	8484	422		0.3333333333333333	0.5	187	8297	5	14	182	8283	8484	0.07780533739490648
R1	cpdb	0	network_modules	196	TRUE	0.0028246376539957847	188	19	5	0.2631578947368421	0.026595744680851064	KEGG:04613	KEGG	Neutrophil extracellular trap formation	8484	323		0.6666666666666666	0.75	188	8296	5	14	183	8282	8484	0.07756487323163092
R1	cpdb	0	network_modules	196	TRUE	0.0031914546379032366	626	24	8	0.3333333333333333	0.012779552715654952	GO:0035295	GO:BP	tube development	16175	8953		0.7333333333333333	0.75	626	15549	8	16	618	15533	16175	0.058883169183428355
R1	cpdb	0	network_modules	196	TRUE	0.0035164994297425104	83	19	4	0.21052631578947367	0.04819277108433735	REAC:R-HSA-381340	REAC	Transcriptional regulation of white adipocyte differentiation	10916	2562		0.7916666666666666	0.84	83	10833	4	15	79	10818	10916	0.09754483450890726
R1	cpdb	0	network_modules	196	TRUE	0.0035164994297425104	83	19	4	0.21052631578947367	0.04819277108433735	REAC:R-HSA-9843745	REAC	Adipogenesis	10916	122		0.7916666666666666	0.84	83	10833	4	15	79	10818	10916	0.09754483450890726
R1	cpdb	0	network_modules	196	TRUE	0.0038887368726577116	201	19	5	0.2631578947368421	0.024875621890547265	KEGG:05203	KEGG	Viral carcinogenesis	8484	455		1	1	201	8283	5	14	196	8269	8484	0.07459615017461994
R1	cpdb	0	network_modules	196	TRUE	0.00502853374470541	20	24	3	0.125	0.15	GO:0034405	GO:BP	response to fluid shear stress	16175	8620		0.8	0.8125	20	16155	3	21	17	16134	16175	0.13576080024891163
R1	cpdb	0	network_modules	196	TRUE	0.005294122268554554	92	19	4	0.21052631578947367	0.043478260869565216	REAC:R-HSA-1592230	REAC	Mitochondrial biogenesis	10916	1464		0.875	0.88	92	10824	4	15	88	10809	10916	0.0923127630692026
R1	cpdb	0	network_modules	196	TRUE	0.0056117619559253856	30	19	3	0.15789473684210525	0.1	REAC:R-HSA-9022692	REAC	Regulation of MECP2 expression and activity	10916	1983		0.9166666666666666	0.92	30	10886	3	16	27	10870	10916	0.12374680052774317
R1	cpdb	0	network_modules	196	TRUE	0.005765195229821226	94	19	4	0.21052631578947367	0.0425531914893617	REAC:R-HSA-3214815	REAC	HDACs deacetylate histones	10916	1092		0.9583333333333334	0.96	94	10822	4	15	90	10807	10916	0.09125106987271796
R1	cpdb	0	network_modules	196	TRUE	0.006767152392770418	480	24	7	0.2916666666666667	0.014583333333333334	GO:0001568	GO:BP	blood vessel development	16175	353		0.8666666666666667	0.875	480	15695	7	17	473	15678	16175	0.05951626872552681
R1	cpdb	0	network_modules	196	TRUE	0.006957263558012986	76	24	4	0.16666666666666666	0.05263157894736842	GO:0014902	GO:BP	myotube differentiation	16175	4777		0.9333333333333333	0.9375	76	16099	4	20	72	16079	16175	0.09130053649606168
R1	cpdb	0	network_modules	196	TRUE	0.009329604801346576	504	24	7	0.2916666666666667	0.013888888888888888	GO:0001944	GO:BP	vasculature development	16175	555		1	1	504	15671	7	17	497	15654	16175	0.05779719473340078
R1	cpdb	0	network_modules	196	TRUE	0.009804028720571397	36	19	3	0.15789473684210525	0.08333333333333333	REAC:R-HSA-9029569	REAC	NR1H3 & NR1H2 regulate gene expression linked to cholesterol transport and efflux	10916	1547		1	1	36	10880	3	16	33	10864	10916	0.11259567942006121
R1	cpdb	0	network_modules	198	TRUE	3.039285033900904e-10	144	23	9	0.391304347826087	0.0625	GO:0007030	GO:BP	Golgi organization	16175	2635		0	0.1111111111111111	144	16031	9	14	135	16017	16175	0.15362197303597436
R1	cpdb	0	network_modules	198	TRUE	1.6699544209777875e-9	522	23	12	0.5217391304347826	0.022988505747126436	GO:0010256	GO:BP	endomembrane system organization	16175	4029		0.125	0.2222222222222222	522	15653	12	11	510	15642	16175	0.10451641891632521
R1	cpdb	0	network_modules	198	TRUE	7.294817061325342e-9	126	23	8	0.34782608695652173	0.06349206349206349	GO:0006888	GO:BP	endoplasmic reticulum to Golgi vesicle-mediated transport	16175	2544		0.25	0.3333333333333333	126	16049	8	15	118	16034	16175	0.14595233914278477
R1	cpdb	0	network_modules	198	TRUE	4.839039807978066e-6	284	23	8	0.34782608695652173	0.028169014084507043	GO:0048193	GO:BP	Golgi vesicle transport	16175	12570		0.375	0.4444444444444444	284	15891	8	15	276	15876	16175	0.09489141749747229
R1	cpdb	0	network_modules	198	TRUE	1.1246368897952362e-5	186	13	6	0.46153846153846156	0.03225806451612903	REAC:R-HSA-948021	REAC	Transport to the Golgi and subsequent modification	10916	2604		0	0.125	186	10730	6	7	180	10723	10916	0.11859787280585543
R1	cpdb	0	network_modules	198	TRUE	7.58917467893925e-5	6	23	3	0.13043478260869565	0.5	GO:0048200	GO:BP	Golgi transport vesicle coating	16175	12576		0.5	0.7777777777777778	6	16169	3	20	3	16149	16175	0.2548792144510706
R1	cpdb	0	network_modules	198	TRUE	7.58917467893925e-5	6	23	3	0.13043478260869565	0.5	GO:0035964	GO:BP	COPI-coated vesicle budding	16175	9367		0.5	0.7777777777777778	6	16169	3	20	3	16149	16175	0.2548792144510706
R1	cpdb	0	network_modules	198	TRUE	7.58917467893925e-5	6	23	3	0.13043478260869565	0.5	GO:0048205	GO:BP	COPI coating of Golgi vesicle	16175	12581		0.5	0.7777777777777778	6	16169	3	20	3	16149	16175	0.2548792144510706
R1	cpdb	0	network_modules	198	TRUE	2.0364387791301105e-4	155	13	5	0.38461538461538464	0.03225806451612903	REAC:R-HSA-199977	REAC	ER to Golgi Anterograde Transport	10916	823		0.14285714285714285	0.25	155	10761	5	8	150	10753	10916	0.10810849506993432
R1	cpdb	0	network_modules	198	TRUE	2.1121099851546587e-4	305	13	6	0.46153846153846156	0.019672131147540985	REAC:R-HSA-446203	REAC	Asparagine N-linked glycosylation	10916	169		0.2857142857142857	0.375	305	10611	6	7	299	10604	10916	0.09084922234119647
R1	cpdb	0	network_modules	198	TRUE	3.178592664005211e-4	9	23	3	0.13043478260869565	0.3333333333333333	GO:0048194	GO:BP	Golgi vesicle budding	16175	12571		0.875	0.8888888888888888	9	16166	3	20	6	16146	16175	0.20783052589345608
R1	cpdb	0	network_modules	198	TRUE	5.561511463819473e-4	524	23	8	0.34782608695652173	0.015267175572519083	GO:0006886	GO:BP	intracellular protein transport	16175	2542		1	1	524	15651	8	15	516	15636	16175	0.06722981744624433
R1	cpdb	0	network_modules	198	TRUE	0.0010824194111356857	26	13	3	0.23076923076923078	0.11538461538461539	REAC:R-HSA-1187000	REAC	Fertilization	10916	940		0.42857142857142855	0.5	26	10890	3	10	23	10880	10916	0.16178331684266212
R1	cpdb	0	network_modules	198	TRUE	0.0013700798805043372	99	13	4	0.3076923076923077	0.04040404040404041	REAC:R-HSA-6811434	REAC	COPI-dependent Golgi-to-ER retrograde traffic	10916	277		0.5714285714285714	0.625	99	10817	4	9	95	10808	10916	0.10877134882369989
R1	cpdb	0	network_modules	198	TRUE	0.0015435987228649398	102	13	4	0.3076923076923077	0.0392156862745098	REAC:R-HSA-6807878	REAC	COPI-mediated anterograde transport	10916	279		0.7142857142857143	0.75	102	10814	4	9	98	10805	10916	0.10707606135419917
R1	cpdb	0	network_modules	198	TRUE	0.002260503013776053	33	13	3	0.23076923076923078	0.09090909090909091	REAC:R-HSA-5694530	REAC	Cargo concentration in the ER	10916	308		0.8571428571428571	0.875	33	10883	3	10	30	10873	10916	0.14324581670044279
R1	cpdb	0	network_modules	198	TRUE	0.004432847126425254	133	13	4	0.3076923076923077	0.03007518796992481	REAC:R-HSA-8856688	REAC	Golgi-to-ER retrograde transport	10916	1084		1	1	133	10783	4	9	129	10774	10916	0.09301143441224813
R1	cpdb	0	network_modules	199	TRUE	6.441175188545482e-4	12	22	3	0.13636363636363635	0.25	GO:0016554	GO:BP	cytidine to uridine editing	16175	5245		0	0.5	12	16163	3	19	9	16144	16175	0.183825929278777
R1	cpdb	0	network_modules	199	TRUE	0.002819593969043836	19	22	3	0.13636363636363635	0.15789473684210525	GO:0016553	GO:BP	base conversion or substitution editing	16175	5244		1	1	19	16156	3	19	16	16137	16175	0.14565540832766186
R1	cpdb	0	network_modules	200	TRUE	3.5032165254327755e-7	315	23	9	0.391304347826087	0.02857142857142857	GO:0009100	GO:BP	glycoprotein metabolic process	16175	3272		0	0.1111111111111111	315	15860	9	14	306	15846	16175	0.10153889610004077
R1	cpdb	0	network_modules	200	TRUE	1.1505258435771395e-6	514	23	10	0.43478260869565216	0.019455252918287938	GO:1901137	GO:BP	carbohydrate derivative biosynthetic process	16175	21245		0.125	0.2222222222222222	514	15661	10	13	504	15648	16175	0.08669905671914052
R1	cpdb	0	network_modules	200	TRUE	2.80506565062024e-6	265	23	8	0.34782608695652173	0.03018867924528302	GO:0009101	GO:BP	glycoprotein biosynthetic process	16175	3273		0.25	0.3333333333333333	265	15910	8	15	257	15895	16175	0.09852480631105372
R1	cpdb	0	network_modules	200	TRUE	6.7424876691193125e-6	183	23	7	0.30434782608695654	0.03825136612021858	GO:0006486	GO:BP	protein glycosylation	16175	2220		0.375	0.5555555555555556	183	15992	7	16	176	15976	16175	0.10455293685758679
R1	cpdb	0	network_modules	200	TRUE	6.7424876691193125e-6	183	23	7	0.30434782608695654	0.03825136612021858	GO:0043413	GO:BP	macromolecule glycosylation	16175	10680		0.375	0.5555555555555556	183	15992	7	16	176	15976	16175	0.10455293685758679
R1	cpdb	0	network_modules	200	TRUE	1.4333787255728862e-5	204	23	7	0.30434782608695654	0.03431372549019608	GO:0070085	GO:BP	glycosylation	16175	15903		0.625	0.6666666666666666	204	15971	7	16	197	15955	16175	0.09865147842801712
R1	cpdb	0	network_modules	200	TRUE	0.00013177416819013259	8	22	3	0.13636363636363635	0.375	REAC:R-HSA-9012546	REAC	Interleukin-18 signaling	10916	1239		0	0.25	8	10908	3	19	5	10889	10916	0.22522772086011703
R1	cpdb	0	network_modules	200	TRUE	1.6240086054188384e-4	33	22	4	0.18181818181818182	0.12121212121212122	REAC:R-HSA-4085001	REAC	Sialic acid metabolism	10916	2211		0.3333333333333333	0.5	33	10883	4	18	29	10865	10916	0.1463543048521924
R1	cpdb	0	network_modules	200	TRUE	0.002105343104654225	16	23	3	0.13043478260869565	0.1875	GO:0001574	GO:BP	ganglioside biosynthetic process	16175	358		0.75	0.7777777777777778	16	16159	3	20	13	16139	16175	0.15538715721260482
R1	cpdb	0	network_modules	200	TRUE	0.0022721365569176705	63	22	4	0.18181818181818182	0.06349206349206349	REAC:R-HSA-446219	REAC	Synthesis of substrates in N-glycan biosythesis	10916	2411		0.6666666666666666	0.75	63	10853	4	18	59	10835	10916	0.10443936733124766
R1	cpdb	0	network_modules	200	TRUE	0.003399392148099341	67	23	4	0.17391304347826086	0.05970149253731343	GO:0009247	GO:BP	glycolipid biosynthetic process	16175	3412		0.875	0.8888888888888888	67	16108	4	19	63	16089	16175	0.09974702749516456
R1	cpdb	0	network_modules	200	TRUE	0.005334174899498794	78	22	4	0.18181818181818182	0.05128205128205128	REAC:R-HSA-446193	REAC	Biosynthesis of the N-glycan precursor (dolichol lipid-linked oligosaccharide, LLO) and transfer to a nascent protein	10916	250		1	1	78	10838	4	18	74	10820	10916	0.09319322881732645
R1	cpdb	0	network_modules	200	TRUE	0.008575044865241972	25	23	3	0.13043478260869565	0.12	GO:0001573	GO:BP	ganglioside metabolic process	16175	357		1	1	25	16150	3	20	22	16130	16175	0.12380987150270771
R1	cpdb	0	network_modules	200	TRUE	0.008957198343276044	47	19	3	0.15789473684210525	0.06382978723404255	KEGG:00514	KEGG	Other types of O-glycan biosynthesis	8484	67		NA	1	47	8437	3	16	44	8421	8484	0.09724727572515289
R1	cpdb	0	network_modules	201	TRUE	2.5101205320986827e-17	419	20	15	0.75	0.03579952267303103	GO:0019221	GO:BP	cytokine-mediated signaling pathway	16175	5598		0	0.058823529411764705	419	15756	15	5	404	15751	16175	0.16038799303256196
R1	cpdb	0	network_modules	201	TRUE	1.7397681379404473e-15	555	20	15	0.75	0.02702702702702703	GO:0071345	GO:BP	cellular response to cytokine stimulus	16175	16597		0.0625	0.11764705882352941	555	15620	15	5	540	15615	16175	0.13833829142464826
R1	cpdb	0	network_modules	201	TRUE	1.0340341198749788e-14	625	20	15	0.75	0.024	GO:1901652	GO:BP	response to peptide	16175	21619		0.125	0.23529411764705882	625	15550	15	5	610	15545	16175	0.12986440114152722
R1	cpdb	0	network_modules	201	TRUE	1.0340341198749788e-14	625	20	15	0.75	0.024	GO:0034097	GO:BP	response to cytokine	16175	8408		0.125	0.23529411764705882	625	15550	15	5	610	15545	16175	0.12986440114152722
R1	cpdb	0	network_modules	201	TRUE	4.921443012442973e-12	291	15	11	0.7333333333333333	0.037800687285223365	KEGG:04060	KEGG	Cytokine-cytokine receptor interaction	8484	253		0	0.25	291	8193	11	4	280	8189	8484	0.16164423656190177
R1	cpdb	0	network_modules	201	TRUE	1.8572682608914966e-11	472	16	12	0.75	0.025423728813559324	REAC:R-HSA-449147	REAC	Signaling by Interleukins	10916	2261		0	0.1111111111111111	472	10444	12	4	460	10440	10916	0.133130708073033
R1	cpdb	0	network_modules	201	TRUE	5.3839763725073584e-11	92	15	8	0.5333333333333333	0.08695652173913043	KEGG:04640	KEGG	Hematopoietic cell lineage	8484	333		0.3333333333333333	0.5	92	8392	8	7	84	8385	8484	0.21231518134168334
R1	cpdb	0	network_modules	201	TRUE	8.639401665268257e-9	45	16	6	0.375	0.13333333333333333	REAC:R-HSA-6783783	REAC	Interleukin-10 signaling	10916	1234		0.125	0.2222222222222222	45	10871	6	10	39	10861	10916	0.2217685113411563
R1	cpdb	0	network_modules	201	TRUE	1.962487539945665e-7	27	20	5	0.25	0.18518518518518517	GO:0070498	GO:BP	interleukin-1-mediated signaling pathway	16175	16156		0.25	0.29411764705882354	27	16148	5	15	22	16133	16175	0.21404006124147468
R1	cpdb	0	network_modules	201	TRUE	9.501941077632904e-6	4	20	3	0.15	0.75	GO:0038157	GO:BP	granulocyte-macrophage colony-stimulating factor signaling pathway	16175	9736		0.3125	0.35294117647058826	4	16171	3	17	1	16154	16175	0.3351058789798762
R1	cpdb	0	network_modules	201	TRUE	1.4465750108521286e-5	26	16	4	0.25	0.15384615384615385	REAC:R-HSA-912526	REAC	Interleukin receptor SHC signaling	10916	1230		0.25	0.3333333333333333	26	10890	4	12	22	10878	10916	0.1946221088946285
R1	cpdb	0	network_modules	201	TRUE	1.4522773822255059e-5	151	16	6	0.375	0.039735099337748346	REAC:R-HSA-446652	REAC	Interleukin-1 family signaling	10916	1231		0.375	0.4444444444444444	151	10765	6	10	145	10755	10916	0.11847397326103282
R1	cpdb	0	network_modules	201	TRUE	9.617081991845261e-5	89	20	5	0.25	0.056179775280898875	GO:0071347	GO:BP	cellular response to interleukin-1	16175	16599		0.375	0.4117647058823529	89	16086	5	15	84	16071	16175	0.1162951266187404
R1	cpdb	0	network_modules	201	TRUE	1.2928677054081244e-4	44	16	4	0.25	0.09090909090909091	REAC:R-HSA-451927	REAC	Interleukin-2 family signaling	10916	1240		0.5	0.5555555555555556	44	10872	4	12	40	10860	10916	0.14873390219947624
R1	cpdb	0	network_modules	201	TRUE	1.3903050590269889e-4	113	16	5	0.3125	0.04424778761061947	REAC:R-HSA-9020702	REAC	Interleukin-1 signaling	10916	1233		0.625	0.6666666666666666	113	10803	5	11	108	10792	10916	0.11437178618164799
R1	cpdb	0	network_modules	201	TRUE	1.694228935478235e-4	47	16	4	0.25	0.0851063829787234	REAC:R-HSA-512988	REAC	Interleukin-3, Interleukin-5 and GM-CSF signaling	10916	1246		0.75	0.7777777777777778	47	10869	4	12	43	10857	10916	0.14376785478989199
R1	cpdb	0	network_modules	201	TRUE	2.209665946086305e-4	105	20	5	0.25	0.047619047619047616	GO:0070555	GO:BP	response to interleukin-1	16175	16175		0.4375	0.47058823529411764	105	16070	5	15	100	16055	16175	0.10668843508825503
R1	cpdb	0	network_modules	201	TRUE	3.8957874352047166e-4	162	15	5	0.3333333333333333	0.030864197530864196	KEGG:04630	KEGG	JAK-STAT signaling pathway	8484	332		0.6666666666666666	0.75	162	8322	5	10	157	8312	8484	0.09663141635612518
R1	cpdb	0	network_modules	201	TRUE	4.1342670372181205e-4	119	20	5	0.25	0.04201680672268908	GO:0070665	GO:BP	positive regulation of leukocyte proliferation	16175	16246		0.5	0.5294117647058824	119	16056	5	15	114	16041	16175	0.09990364972354733
R1	cpdb	0	network_modules	201	TRUE	4.348860574101986e-4	236	20	6	0.3	0.025423728813559324	GO:0070661	GO:BP	leukocyte proliferation	16175	16242		0.5625	0.5882352941176471	236	15939	6	14	230	15925	16175	0.083750579306198
R1	cpdb	0	network_modules	201	TRUE	0.004191806078506253	190	20	5	0.25	0.02631578947368421	GO:0070663	GO:BP	regulation of leukocyte proliferation	16175	16244		0.625	0.6470588235294118	190	15985	5	15	185	15970	16175	0.07780579303395534
R1	cpdb	0	network_modules	201	TRUE	0.0047327376420756824	24	20	3	0.15	0.125	GO:1901099	GO:BP	negative regulation of signal transduction in absence of ligand	16175	21211		0.6875	0.7647058823529411	24	16151	3	17	21	16134	16175	0.13576080024891163
R1	cpdb	0	network_modules	201	TRUE	0.0047327376420756824	24	20	3	0.15	0.125	GO:2001240	GO:BP	negative regulation of extrinsic apoptotic signaling pathway in absence of ligand	16175	26429		0.6875	0.7647058823529411	24	16151	3	17	21	16134	16175	0.13576080024891163
R1	cpdb	0	network_modules	201	TRUE	0.006403418026022153	3	20	2	0.1	0.6666666666666666	GO:0033091	GO:BP	positive regulation of immature T cell proliferation	16175	8039		0.8125	0.8823529411764706	3	16172	2	18	1	16154	16175	0.25790340281345747
R1	cpdb	0	network_modules	201	TRUE	0.006403418026022153	3	20	2	0.1	0.6666666666666666	GO:0033092	GO:BP	positive regulation of immature T cell proliferation in thymus	16175	8040		0.8125	0.8823529411764706	3	16172	2	18	1	16154	16175	0.25790340281345747
R1	cpdb	0	network_modules	201	TRUE	0.006530057222593608	594	20	7	0.35	0.011784511784511785	GO:0006954	GO:BP	inflammatory response	16175	2585		0.9375	0.9411764705882353	594	15581	7	13	587	15568	16175	0.05860611888460958
R1	cpdb	0	network_modules	201	TRUE	0.007728117517446573	301	15	5	0.3333333333333333	0.016611295681063124	KEGG:04010	KEGG	MAPK signaling pathway	8484	243		1	1	301	8183	5	10	296	8173	8484	0.06776341454486688
R1	cpdb	0	network_modules	201	TRUE	0.008510555983739343	29	20	3	0.15	0.10344827586206896	GO:2001239	GO:BP	regulation of extrinsic apoptotic signaling pathway in absence of ligand	16175	26428		1	1	29	16146	3	17	26	16129	16175	0.12326601919885889
R1	cpdb	0	network_modules	201	TRUE	0.008963550075063845	264	16	5	0.3125	0.01893939393939394	REAC:R-HSA-5673001	REAC	RAF/MAP kinase cascade	10916	1841		0.875	0.8888888888888888	264	10652	5	11	259	10641	10916	0.07190522378750179
R1	cpdb	0	network_modules	201	TRUE	0.009810250789718205	269	16	5	0.3125	0.01858736059479554	REAC:R-HSA-5684996	REAC	MAPK1/MAPK3 signaling	10916	1351		1	1	269	10647	5	11	264	10636	10916	0.07113735448205367
R1	cpdb	0	network_modules	202	TRUE	3.402177057813431e-8	162	18	8	0.4444444444444444	0.04938271604938271	KEGG:04630	KEGG	JAK-STAT signaling pathway	8484	332		0	0.125	162	8322	8	10	154	8312	8484	0.1433086898116522
R1	cpdb	0	network_modules	202	TRUE	8.150004345665991e-8	625	26	12	0.46153846153846156	0.0192	GO:1901652	GO:BP	response to peptide	16175	21619		0	0.125	625	15550	12	14	613	15536	16175	0.08804185268072089
R1	cpdb	0	network_modules	202	TRUE	8.150004345665991e-8	625	26	12	0.46153846153846156	0.0192	GO:0034097	GO:BP	response to cytokine	16175	8408		0	0.125	625	15550	12	14	613	15536	16175	0.08804185268072089
R1	cpdb	0	network_modules	202	TRUE	4.729774309905257e-7	555	26	11	0.4230769230769231	0.01981981981981982	GO:0071345	GO:BP	cellular response to cytokine stimulus	16175	16597		0.13333333333333333	0.1875	555	15620	11	15	544	15605	16175	0.08569549229813822
R1	cpdb	0	network_modules	202	TRUE	6.227141049823158e-7	419	26	10	0.38461538461538464	0.02386634844868735	GO:0019221	GO:BP	cytokine-mediated signaling pathway	16175	5598		0.2	0.25	419	15756	10	16	409	15740	16175	0.09060936759181272
R1	cpdb	0	network_modules	202	TRUE	1.5109872847174795e-6	472	21	10	0.47619047619047616	0.0211864406779661	REAC:R-HSA-449147	REAC	Signaling by Interleukins	10916	2261		0	0.16666666666666666	472	10444	10	11	462	10433	10916	0.09345317661013723
R1	cpdb	0	network_modules	202	TRUE	2.385103679300842e-6	11	26	4	0.15384615384615385	0.36363636363636365	GO:0035723	GO:BP	interleukin-15-mediated signaling pathway	16175	9193		0.26666666666666666	0.4375	11	16164	4	22	7	16142	16175	0.2357490841402948
R1	cpdb	0	network_modules	202	TRUE	2.385103679300842e-6	11	26	4	0.15384615384615385	0.36363636363636365	GO:0070672	GO:BP	response to interleukin-15	16175	16253		0.26666666666666666	0.4375	11	16164	4	22	7	16142	16175	0.2357490841402948
R1	cpdb	0	network_modules	202	TRUE	2.385103679300842e-6	11	26	4	0.15384615384615385	0.36363636363636365	GO:0071350	GO:BP	cellular response to interleukin-15	16175	16602		0.26666666666666666	0.4375	11	16164	4	22	7	16142	16175	0.2357490841402948
R1	cpdb	0	network_modules	202	TRUE	3.16657872860657e-6	14	21	4	0.19047619047619047	0.2857142857142857	REAC:R-HSA-8983432	REAC	Interleukin-15 signaling	10916	1237		0.2	0.3333333333333333	14	10902	4	17	10	10885	10916	0.23208605732703347
R1	cpdb	0	network_modules	202	TRUE	3.4744228277712655e-6	291	18	8	0.4444444444444444	0.027491408934707903	KEGG:04060	KEGG	Cytokine-cytokine receptor interaction	8484	253		0.14285714285714285	0.25	291	8193	8	10	283	8183	8484	0.10391226023424852
R1	cpdb	0	network_modules	202	TRUE	5.166816219400867e-6	44	21	5	0.23809523809523808	0.11363636363636363	REAC:R-HSA-451927	REAC	Interleukin-2 family signaling	10916	1240		0.4	0.5	44	10872	5	16	39	10856	10916	0.16218622618045406
R1	cpdb	0	network_modules	202	TRUE	1.0336692553002941e-5	218	18	7	0.3888888888888889	0.03211009174311927	KEGG:05166	KEGG	Human T-cell leukemia virus 1 infection	8484	447		0.2857142857142857	0.375	218	8266	7	11	211	8255	8484	0.10584244296133222
R1	cpdb	0	network_modules	202	TRUE	5.367998242797634e-5	89	18	5	0.2777777777777778	0.056179775280898875	KEGG:04658	KEGG	Th1 and Th2 cell differentiation	8484	336		0.42857142857142855	0.5	89	8395	5	13	84	8382	8484	0.12096813447227421
R1	cpdb	0	network_modules	202	TRUE	6.335379830861127e-5	92	18	5	0.2777777777777778	0.05434782608695652	KEGG:04640	KEGG	Hematopoietic cell lineage	8484	333		0.5714285714285714	0.625	92	8392	5	13	87	8379	8484	0.11884331488424575
R1	cpdb	0	network_modules	202	TRUE	1.1232630896391543e-4	44	18	4	0.2222222222222222	0.09090909090909091	KEGG:04672	KEGG	Intestinal immune network for IgA production	8484	344		0.7142857142857143	0.75	44	8440	4	14	40	8426	8484	0.13932593752680922
R1	cpdb	0	network_modules	202	TRUE	1.223343666309722e-4	105	18	5	0.2777777777777778	0.047619047619047616	KEGG:04659	KEGG	Th17 cell differentiation	8484	337		0.8571428571428571	0.875	105	8379	5	13	100	8366	8484	0.11069053190359184
R1	cpdb	0	network_modules	202	TRUE	1.8129548031574518e-4	36	21	4	0.19047619047619047	0.1111111111111111	REAC:R-HSA-1266695	REAC	Interleukin-7 signaling	10916	1255		0.6	0.6666666666666666	36	10880	4	17	32	10863	10916	0.14333402917476304
R1	cpdb	0	network_modules	202	TRUE	3.784907987735282e-4	132	18	5	0.2777777777777778	0.03787878787878788	KEGG:05322	KEGG	Systemic lupus erythematosus	8484	484		1	1	132	8352	5	13	127	8339	8484	0.0976966921909347
R1	cpdb	0	network_modules	202	TRUE	4.2250245759077284e-4	12	21	3	0.14285714285714285	0.25	REAC:R-HSA-9020558	REAC	Interleukin-2 signaling	10916	1241		0.8	0.8333333333333334	12	10904	3	18	9	10886	10916	0.1878118959846124
R1	cpdb	0	network_modules	202	TRUE	4.2740370063761187e-4	9	26	3	0.11538461538461539	0.3333333333333333	GO:0038110	GO:BP	interleukin-2-mediated signaling pathway	16175	9704		0.4666666666666667	0.5625	9	16166	3	23	6	16143	16175	0.19538182665355472
R1	cpdb	0	network_modules	202	TRUE	4.2740370063761187e-4	9	26	3	0.11538461538461539	0.3333333333333333	GO:0071352	GO:BP	cellular response to interleukin-2	16175	16604		0.4666666666666667	0.5625	9	16166	3	23	6	16143	16175	0.19538182665355472
R1	cpdb	0	network_modules	202	TRUE	5.45672578679351e-4	185	26	6	0.23076923076923078	0.032432432432432434	GO:0006909	GO:BP	phagocytosis	16175	2559		0.6	0.625	185	15990	6	20	179	15970	16175	0.08276556935352623
R1	cpdb	0	network_modules	202	TRUE	6.099255236129784e-4	10	26	3	0.11538461538461539	0.3	GO:0070669	GO:BP	response to interleukin-2	16175	16250		0.6666666666666666	0.6875	10	16165	3	23	7	16142	16175	0.18526140987785414
R1	cpdb	0	network_modules	202	TRUE	0.0015467149387951536	221	26	6	0.23076923076923078	0.027149321266968326	GO:0030100	GO:BP	regulation of endocytosis	16175	6678		0.7333333333333333	0.75	221	15954	6	20	215	15934	16175	0.07504113295481218
R1	cpdb	0	network_modules	202	TRUE	0.0019607759436756573	124	26	5	0.19230769230769232	0.04032258064516129	GO:0045807	GO:BP	positive regulation of endocytosis	16175	11631		0.8	0.8125	124	16051	5	21	119	16030	16175	0.08494262379521283
R1	cpdb	0	network_modules	202	TRUE	0.003121909558998613	59	26	4	0.15384615384615385	0.06779661016949153	GO:0050766	GO:BP	positive regulation of phagocytosis	16175	13240		0.8666666666666667	0.875	59	16116	4	22	55	16094	16175	0.09996989812666293
R1	cpdb	0	network_modules	202	TRUE	0.004907439070020555	26	21	3	0.14285714285714285	0.11538461538461539	REAC:R-HSA-912526	REAC	Interleukin receptor SHC signaling	10916	1230		1	1	26	10890	3	18	23	10872	10916	0.12651993704673264
R1	cpdb	0	network_modules	202	TRUE	0.005493673699735357	275	26	6	0.23076923076923078	0.02181818181818182	GO:0002696	GO:BP	positive regulation of leukocyte activation	16175	1214		0.9333333333333333	0.9375	275	15900	6	20	269	15880	16175	0.06634913898833207
R1	cpdb	0	network_modules	202	TRUE	0.007456344467770729	290	26	6	0.23076923076923078	0.020689655172413793	GO:0050867	GO:BP	positive regulation of cell activation	16175	13315		1	1	290	15885	6	20	284	15865	16175	0.06436050711088802
R1	cpdb	0	network_modules	203	TRUE	5.064386117016e-12	141	24	10	0.4166666666666667	0.07092198581560284	GO:0006665	GO:BP	sphingolipid metabolic process	16175	2374		0	0.03333333333333333	141	16034	10	14	131	16020	16175	0.16917108008100953
R1	cpdb	0	network_modules	203	TRUE	5.84839833796408e-12	143	24	10	0.4166666666666667	0.06993006993006994	GO:0043604	GO:BP	amide biosynthetic process	16175	10796		0.034482758620689655	0.06666666666666667	143	16032	10	14	133	16018	16175	0.16794345933346805
R1	cpdb	0	network_modules	203	TRUE	6.066105116336687e-11	180	24	10	0.4166666666666667	0.05555555555555555	GO:0006643	GO:BP	membrane lipid metabolic process	16175	2354		0.06896551724137931	0.1	180	15995	10	14	170	15981	16175	0.14902316789115788
R1	cpdb	0	network_modules	203	TRUE	1.5576047566393064e-9	32	17	6	0.35294117647058826	0.1875	REAC:R-HSA-1660661	REAC	Sphingolipid de novo biosynthesis	10916	2348		0	0.25	32	10884	6	11	26	10873	10916	0.2556851384838674
R1	cpdb	0	network_modules	203	TRUE	1.5651559925235098e-9	99	24	8	0.3333333333333333	0.08080808080808081	GO:0030148	GO:BP	sphingolipid biosynthetic process	16175	6682		0.10344827586206896	0.13333333333333333	99	16076	8	16	91	16060	16175	0.16172377087395579
R1	cpdb	0	network_modules	203	TRUE	1.4292647913325449e-8	14	24	5	0.20833333333333334	0.35714285714285715	GO:0046520	GO:BP	sphingoid biosynthetic process	16175	12218		0.13793103448275862	0.2	14	16161	5	19	9	16142	16175	0.271958583550708
R1	cpdb	0	network_modules	203	TRUE	1.4292647913325449e-8	14	24	5	0.20833333333333334	0.35714285714285715	GO:0046512	GO:BP	sphingosine biosynthetic process	16175	12211		0.13793103448275862	0.2	14	16161	5	19	9	16142	16175	0.271958583550708
R1	cpdb	0	network_modules	203	TRUE	1.4447085318641969e-8	130	24	8	0.3333333333333333	0.06153846153846154	GO:0046467	GO:BP	membrane lipid biosynthetic process	16175	12175		0.20689655172413793	0.23333333333333334	130	16045	8	16	122	16029	16175	0.1404389930573534
R1	cpdb	0	network_modules	203	TRUE	8.260869432525275e-8	19	24	5	0.20833333333333334	0.2631578947368421	GO:0034312	GO:BP	diol biosynthetic process	16175	8566		0.2413793103448276	0.26666666666666666	19	16156	5	19	14	16137	16175	0.2331361478429518
R1	cpdb	0	network_modules	203	TRUE	1.1003703643865848e-7	20	24	5	0.20833333333333334	0.25	GO:0006670	GO:BP	sphingosine metabolic process	16175	2379		0.27586206896551724	0.3	20	16155	5	19	15	16136	16175	0.22717222470623896
R1	cpdb	0	network_modules	203	TRUE	1.3094146862095394e-7	389	24	10	0.4166666666666667	0.02570694087403599	GO:0043603	GO:BP	amide metabolic process	16175	10795		0.3103448275862069	0.3333333333333333	389	15786	10	14	379	15772	16175	0.09878902101785021
R1	cpdb	0	network_modules	203	TRUE	1.8653516105412284e-7	22	24	5	0.20833333333333334	0.22727272727272727	GO:0046519	GO:BP	sphingoid metabolic process	16175	12217		0.3448275862068966	0.36666666666666664	22	16153	5	19	17	16134	16175	0.21648429683442197
R1	cpdb	0	network_modules	203	TRUE	5.44537122289121e-7	63	24	6	0.25	0.09523809523809523	GO:0046513	GO:BP	ceramide biosynthetic process	16175	12212		0.3793103448275862	0.4	63	16112	6	18	57	16094	16175	0.15230908697603038
R1	cpdb	0	network_modules	203	TRUE	5.690501164875691e-7	27	24	5	0.20833333333333334	0.18518518518518517	GO:0034311	GO:BP	diol metabolic process	16175	8565		0.41379310344827586	0.43333333333333335	27	16148	5	19	22	16129	16175	0.19515243326747816
R1	cpdb	0	network_modules	203	TRUE	6.481528964996725e-7	625	24	11	0.4583333333333333	0.0176	GO:0008610	GO:BP	lipid biosynthetic process	16175	3206		0.4482758620689655	0.4666666666666667	625	15550	11	13	614	15537	16175	0.08394159070427426
R1	cpdb	0	network_modules	203	TRUE	9.506452695105662e-7	89	17	6	0.35294117647058826	0.06741573033707865	REAC:R-HSA-428157	REAC	Sphingolipid metabolism	10916	2349		0.3333333333333333	0.5	89	10827	6	11	83	10816	10916	0.15142505514567633
R1	cpdb	0	network_modules	203	TRUE	5.771912836735142e-6	14	24	4	0.16666666666666666	0.2857142857142857	GO:0030497	GO:BP	fatty acid elongation	16175	6820		0.4827586206896552	0.5	14	16161	4	20	10	16141	16175	0.2173399504793674
R1	cpdb	0	network_modules	203	TRUE	6.880056222471287e-6	27	15	4	0.26666666666666666	0.14814814814814814	KEGG:01040	KEGG	Biosynthesis of unsaturated fatty acids	8484	164		0	0.4	27	8457	4	11	23	8446	8484	0.19687689996135274
R1	cpdb	0	network_modules	203	TRUE	6.880056222471287e-6	27	15	4	0.26666666666666666	0.14814814814814814	KEGG:00062	KEGG	Fatty acid elongation	8484	10		0	0.4	27	8457	4	11	23	8446	8484	0.19687689996135274
R1	cpdb	0	network_modules	203	TRUE	7.1986822918159464e-6	96	24	6	0.25	0.0625	GO:0006672	GO:BP	ceramide metabolic process	16175	2381		0.5172413793103449	0.5333333333333333	96	16079	6	18	90	16061	16175	0.12248711916436111
R1	cpdb	0	network_modules	203	TRUE	1.0602487520227111e-5	47	24	5	0.20833333333333334	0.10638297872340426	GO:0046173	GO:BP	polyol biosynthetic process	16175	11943		0.5517241379310345	0.5666666666666667	47	16128	5	19	42	16109	16175	0.14711936392613353
R1	cpdb	0	network_modules	203	TRUE	1.3987375042074025e-5	24	17	4	0.23529411764705882	0.16666666666666666	REAC:R-HSA-75876	REAC	Synthesis of very long-chain fatty acyl-CoAs	10916	2412		0.6666666666666666	0.75	24	10892	4	13	20	10879	10916	0.1965482278409663
R1	cpdb	0	network_modules	203	TRUE	1.7574672977911386e-5	18	24	4	0.16666666666666666	0.2222222222222222	GO:0035338	GO:BP	long-chain fatty-acyl-CoA biosynthetic process	16175	8982		0.5862068965517241	0.6	18	16157	4	20	14	16137	16175	0.19141362170433107
R1	cpdb	0	network_modules	203	TRUE	2.3596947222337705e-5	482	24	9	0.375	0.01867219917012448	GO:0044283	GO:BP	small molecule biosynthetic process	16175	10950		0.6206896551724138	0.6333333333333333	482	15693	9	15	473	15678	16175	0.07826104612692823
R1	cpdb	0	network_modules	203	TRUE	6.066744668659922e-5	24	24	4	0.16666666666666666	0.16666666666666666	GO:0035336	GO:BP	long-chain fatty-acyl-CoA metabolic process	16175	8980		0.6551724137931034	0.6666666666666666	24	16151	4	20	20	16131	16175	0.1654283532495408
R1	cpdb	0	network_modules	203	TRUE	8.518577724521335e-5	26	24	4	0.16666666666666666	0.15384615384615385	GO:0046949	GO:BP	fatty-acyl-CoA biosynthetic process	16175	12443		0.6896551724137931	0.7	26	16149	4	20	22	16129	16175	0.15882928177839048
R1	cpdb	0	network_modules	203	TRUE	8.860281052646055e-5	120	15	5	0.3333333333333333	0.041666666666666664	KEGG:04071	KEGG	Sphingolipid signaling pathway	8484	260		0.5	0.6	120	8364	5	10	115	8354	8484	0.11375764375725053
R1	cpdb	0	network_modules	203	TRUE	9.587554096331279e-5	38	17	4	0.23529411764705882	0.10526315789473684	REAC:R-HSA-75105	REAC	Fatty acyl-CoA biosynthesis	10916	937		1	1	38	10878	4	13	34	10865	10916	0.15544118652808794
R1	cpdb	0	network_modules	203	TRUE	1.5009549681282972e-4	57	15	4	0.26666666666666666	0.07017543859649122	KEGG:01212	KEGG	Fatty acid metabolism	8484	186		0.75	0.8	57	8427	4	11	53	8416	8484	0.13391925003033386
R1	cpdb	0	network_modules	203	TRUE	1.9371948812102466e-4	83	24	5	0.20833333333333334	0.060240963855421686	GO:0019751	GO:BP	polyol metabolic process	16175	6035		0.7241379310344828	0.7333333333333333	83	16092	5	19	78	16073	16175	0.10963116554598046
R1	cpdb	0	network_modules	203	TRUE	4.6267562207770246e-4	39	24	4	0.16666666666666666	0.10256410256410256	GO:0035337	GO:BP	fatty-acyl-CoA metabolic process	16175	8981		0.7586206896551724	0.7666666666666667	39	16136	4	20	35	16116	16175	0.12910408307256965
R1	cpdb	0	network_modules	203	TRUE	6.277572331977316e-4	42	24	4	0.16666666666666666	0.09523809523809523	GO:0071616	GO:BP	acyl-CoA biosynthetic process	16175	16800		0.7931034482758621	0.8333333333333334	42	16133	4	20	38	16113	16175	0.12427888405333369
R1	cpdb	0	network_modules	203	TRUE	6.277572331977316e-4	42	24	4	0.16666666666666666	0.09523809523809523	GO:0035384	GO:BP	thioester biosynthetic process	16175	9013		0.7931034482758621	0.8333333333333334	42	16133	4	20	38	16113	16175	0.12427888405333369
R1	cpdb	0	network_modules	203	TRUE	7.952407700914803e-4	110	24	5	0.20833333333333334	0.045454545454545456	GO:0046165	GO:BP	alcohol biosynthetic process	16175	11935		0.8620689655172413	0.8666666666666667	110	16065	5	19	105	16046	16175	0.09452769106834549
R1	cpdb	0	network_modules	203	TRUE	0.0011800933229164172	49	24	4	0.16666666666666666	0.08163265306122448	GO:1901570	GO:BP	fatty acid derivative biosynthetic process	16175	21572		0.896551724137931	0.9	49	16126	4	20	45	16106	16175	0.11478130018486503
R1	cpdb	0	network_modules	203	TRUE	0.001270176640289424	13	24	3	0.125	0.23076923076923078	GO:0042761	GO:BP	very long-chain fatty acid biosynthetic process	16175	10353		0.9310344827586207	0.9333333333333333	13	16162	3	21	10	16141	16175	0.1689427654824629
R1	cpdb	0	network_modules	203	TRUE	0.005295103282008657	71	24	4	0.16666666666666666	0.056338028169014086	GO:1901568	GO:BP	fatty acid derivative metabolic process	16175	21570		0.9655172413793104	0.9666666666666667	71	16104	4	20	67	16084	16175	0.09462624130317772
R1	cpdb	0	network_modules	203	TRUE	0.006667289789927858	54	15	3	0.2	0.05555555555555555	KEGG:00600	KEGG	Sphingolipid metabolism	8484	95		1	1	54	8430	3	12	51	8418	8484	0.10247161714953465
R1	cpdb	0	network_modules	203	TRUE	0.009881539404908083	3	24	2	0.08333333333333333	0.6666666666666666	GO:1904220	GO:BP	regulation of serine C-palmitoyltransferase activity	16175	23620		1	1	3	16172	2	22	1	16150	16175	0.23537416597204877
R1	cpdb	0	network_modules	204	TRUE	2.785603413593603e-6	248	14	7	0.5	0.028225806451612902	KEGG:04144	KEGG	Endocytosis	8484	280		0	0.1111111111111111	248	8236	7	7	241	8229	8484	0.11361779689060666
R1	cpdb	0	network_modules	204	TRUE	3.4951658959371747e-6	50	19	5	0.2631578947368421	0.1	GO:0046854	GO:BP	phosphatidylinositol phosphate biosynthetic process	16175	12405		0	0.06666666666666667	50	16125	5	14	45	16111	16175	0.16065862968747466
R1	cpdb	0	network_modules	204	TRUE	4.46256241152779e-6	73	14	5	0.35714285714285715	0.0684931506849315	KEGG:00562	KEGG	Inositol phosphate metabolism	8484	86		0.125	0.2222222222222222	73	8411	5	9	68	8402	8484	0.15342226522200259
R1	cpdb	0	network_modules	204	TRUE	9.727062559029322e-6	72	15	5	0.3333333333333333	0.06944444444444445	REAC:R-HSA-199992	REAC	trans-Golgi Network Vesicle Budding	10916	2749		0	0.2	72	10844	5	10	67	10834	10916	0.1497317774230406
R1	cpdb	0	network_modules	204	TRUE	1.779199090926017e-5	96	14	5	0.35714285714285715	0.052083333333333336	KEGG:04666	KEGG	Fc gamma R-mediated phagocytosis	8484	341		0.25	0.3333333333333333	96	8388	5	9	91	8379	8484	0.13292834410732707
R1	cpdb	0	network_modules	204	TRUE	1.973229503486384e-5	98	14	5	0.35714285714285715	0.05102040816326531	KEGG:05231	KEGG	Choline metabolism in cancer	8484	479		0.375	0.4444444444444444	98	8386	5	9	93	8377	8484	0.1314909344598572
R1	cpdb	0	network_modules	204	TRUE	2.499034392592067e-5	202	14	6	0.42857142857142855	0.0297029702970297	KEGG:04510	KEGG	Focal adhesion	8484	313		0.5	0.5555555555555556	202	8282	6	8	196	8274	8484	0.10793922752802573
R1	cpdb	0	network_modules	204	TRUE	7.595616825329823e-5	189	19	6	0.3157894736842105	0.031746031746031744	GO:0046474	GO:BP	glycerophospholipid biosynthetic process	16175	12181		0.07142857142857142	0.13333333333333333	189	15986	6	13	183	15973	16175	0.09704576786328747
R1	cpdb	0	network_modules	204	TRUE	1.7719465182879213e-4	218	19	6	0.3157894736842105	0.027522935779816515	GO:0008654	GO:BP	phospholipid biosynthetic process	16175	3225		0.14285714285714285	0.2	218	15957	6	13	212	15944	16175	0.08990948689915
R1	cpdb	0	network_modules	204	TRUE	1.8905785664408896e-4	52	15	4	0.26666666666666666	0.07692307692307693	REAC:R-HSA-1660499	REAC	Synthesis of PIPs at the plasma membrane	10916	2395		0.25	0.4	52	10864	4	11	48	10853	10916	0.14109770104739913
R1	cpdb	0	network_modules	204	TRUE	2.192916980922366e-4	226	19	6	0.3157894736842105	0.02654867256637168	GO:0045017	GO:BP	glycerolipid biosynthetic process	16175	11231		0.21428571428571427	0.26666666666666666	226	15949	6	13	220	15936	16175	0.08818147127214264
R1	cpdb	0	network_modules	204	TRUE	2.4209692893432898e-4	44	19	4	0.21052631578947367	0.09090909090909091	GO:0072583	GO:BP	clathrin-dependent endocytosis	16175	17454		0.2857142857142857	0.3333333333333333	44	16131	4	15	40	16116	16175	0.13682183467984477
R1	cpdb	0	network_modules	204	TRUE	2.522446994780108e-4	116	19	5	0.2631578947368421	0.04310344827586207	GO:0006661	GO:BP	phosphatidylinositol biosynthetic process	16175	2370		0.35714285714285715	0.4	116	16059	5	14	111	16045	16175	0.10403577439313522
R1	cpdb	0	network_modules	204	TRUE	3.16401655522221e-4	144	15	5	0.3333333333333333	0.034722222222222224	REAC:R-HSA-8856828	REAC	Clathrin-mediated endocytosis	10916	372		0.5	0.6	144	10772	5	10	139	10762	10916	0.10408515633275678
R1	cpdb	0	network_modules	204	TRUE	5.579232833562456e-4	136	19	5	0.2631578947368421	0.03676470588235294	GO:0046488	GO:BP	phosphatidylinositol metabolic process	16175	12192		0.42857142857142855	0.4666666666666667	136	16039	5	14	131	16025	16175	0.09567754422845513
R1	cpdb	0	network_modules	204	TRUE	6.117380609812897e-4	269	19	6	0.3157894736842105	0.022304832713754646	GO:0006650	GO:BP	glycerophospholipid metabolic process	16175	2360		0.5	0.5333333333333333	269	15906	6	13	263	15893	16175	0.0802230970169187
R1	cpdb	0	network_modules	204	TRUE	8.491019820352158e-4	97	14	4	0.2857142857142857	0.041237113402061855	KEGG:04070	KEGG	Phosphatidylinositol signaling system	8484	259		0.625	0.6666666666666666	97	8387	4	10	93	8377	8484	0.10488889431330495
R1	cpdb	0	network_modules	204	TRUE	0.001029883574570837	16	19	3	0.15789473684210525	0.1875	GO:0048268	GO:BP	clathrin coat assembly	16175	12619		0.5714285714285714	0.6	16	16159	3	16	13	16143	16175	0.17116905694947215
R1	cpdb	0	network_modules	204	TRUE	0.0012438203074788827	227	14	5	0.35714285714285715	0.022026431718061675	KEGG:04810	KEGG	Regulation of actin cytoskeleton	8484	365		0.75	0.7777777777777778	227	8257	5	9	222	8248	8484	0.08323794305319505
R1	cpdb	0	network_modules	204	TRUE	0.0012515011055750144	83	15	4	0.26666666666666666	0.04819277108433735	REAC:R-HSA-1483255	REAC	PI Metabolism	10916	1665		0.75	0.8	83	10833	4	11	79	10822	10916	0.11062880188400909
R1	cpdb	0	network_modules	204	TRUE	0.0017665773513739864	2	19	2	0.10526315789473684	1	GO:2000588	GO:BP	positive regulation of platelet-derived growth factor receptor-beta signaling pathway	16175	25880		0.6428571428571429	0.6666666666666666	2	16173	2	17	0	16156	16175	0.32427228087924065
R1	cpdb	0	network_modules	204	TRUE	0.0019491104452394649	328	19	6	0.3157894736842105	0.018292682926829267	GO:0006644	GO:BP	phospholipid metabolic process	16175	2355		0.7142857142857143	0.7333333333333333	328	15847	6	13	322	15834	16175	0.07189815733411033
R1	cpdb	0	network_modules	204	TRUE	0.0019566019312268743	533	19	7	0.3684210526315789	0.013133208255159476	GO:0006897	GO:BP	endocytosis	16175	2551		0.7857142857142857	0.8	533	15642	7	12	526	15630	16175	0.06444611952967952
R1	cpdb	0	network_modules	204	TRUE	0.0020279530008416586	210	15	5	0.3333333333333333	0.023809523809523808	REAC:R-HSA-1483257	REAC	Phospholipid metabolism	10916	1748		1	1	210	10706	5	10	205	10696	10916	0.08482316204285008
R1	cpdb	0	network_modules	204	TRUE	0.002281285586917482	337	19	6	0.3157894736842105	0.017804154302670624	GO:0046486	GO:BP	glycerolipid metabolic process	16175	12190		0.8571428571428571	0.8666666666666667	337	15838	6	13	331	15825	16175	0.07081815255187221
R1	cpdb	0	network_modules	204	TRUE	0.00321961216636867	136	14	4	0.2857142857142857	0.029411764705882353	KEGG:05135	KEGG	Yersinia infection	8484	432		0.875	0.8888888888888888	136	8348	4	10	132	8338	8484	0.08730068641241687
R1	cpdb	0	network_modules	204	TRUE	0.004363451182340092	147	14	4	0.2857142857142857	0.027210884353741496	KEGG:04072	KEGG	Phospholipase D signaling pathway	8484	261		1	1	147	8337	4	10	143	8327	8484	0.08362223582025562
R1	cpdb	0	network_modules	204	TRUE	0.006074003216728927	632	19	7	0.3684210526315789	0.011075949367088608	GO:0030036	GO:BP	actin cytoskeleton organization	16175	6660		0.9285714285714286	0.9333333333333333	632	15543	7	12	625	15531	16175	0.058288620297997105
R1	cpdb	0	network_modules	204	TRUE	0.006117231113347379	221	19	5	0.2631578947368421	0.02262443438914027	GO:0006898	GO:BP	receptor-mediated endocytosis	16175	2552		1	1	221	15954	5	14	216	15940	16175	0.07370293713807233
R1	cpdb	0	network_modules	205	TRUE	1.2922491087802987e-13	38	18	8	0.4444444444444444	0.21052631578947367	REAC:R-HSA-190861	REAC	Gap junction assembly	10916	1033		0	0.16666666666666666	38	10878	8	10	30	10868	10916	0.30427236757869996
R1	cpdb	0	network_modules	205	TRUE	1.1810203168695337e-12	49	18	8	0.4444444444444444	0.16326530612244897	REAC:R-HSA-190828	REAC	Gap junction trafficking	10916	1035		0.2	0.3333333333333333	49	10867	8	10	41	10857	10916	0.26747449403731643
R1	cpdb	0	network_modules	205	TRUE	1.40482743834835e-12	50	18	8	0.4444444444444444	0.16	REAC:R-HSA-157858	REAC	Gap junction trafficking and regulation	10916	1036		0.4	0.5	50	10866	8	10	42	10856	10916	0.2647432868396879
R1	cpdb	0	network_modules	205	TRUE	1.9456085950574264e-11	6	21	5	0.23809523809523808	0.8333333333333334	GO:1990349	GO:BP	gap junction-mediated intercellular transport	16175	25138		0	0.14285714285714285	6	16169	5	16	1	16153	16175	0.44511298140655087
R1	cpdb	0	network_modules	205	TRUE	4.0756787299545043e-10	9	21	5	0.23809523809523808	0.5555555555555556	GO:0010496	GO:BP	intercellular transport	16175	4175		0.16666666666666666	0.2857142857142857	9	16166	5	16	4	16150	16175	0.36318337263178885
R1	cpdb	0	network_modules	205	TRUE	1.40476515704222e-8	16	21	5	0.23809523809523808	0.3125	GO:0016264	GO:BP	gap junction assembly	16175	5193		0.3333333333333333	0.42857142857142855	16	16159	5	16	11	16143	16175	0.2719501573998027
R1	cpdb	0	network_modules	205	TRUE	1.1620509831086633e-6	3	18	3	0.16666666666666666	1	REAC:R-HSA-190827	REAC	Transport of connexins along the secretory pathway	10916	2591		0.6	0.8333333333333334	3	10913	3	15	0	10898	10916	0.4079676238240486
R1	cpdb	0	network_modules	205	TRUE	1.1620509831086633e-6	3	18	3	0.16666666666666666	1	REAC:R-HSA-190704	REAC	Oligomerization of connexins into connexons	10916	1639		0.6	0.8333333333333334	3	10913	3	15	0	10898	10916	0.4079676238240486
R1	cpdb	0	network_modules	205	TRUE	2.7115388477519414e-6	179	21	7	0.3333333333333333	0.03910614525139665	GO:0045216	GO:BP	cell-cell junction organization	16175	11328		0.5	0.5714285714285714	179	15996	7	14	172	15982	16175	0.11107014758728355
R1	cpdb	0	network_modules	205	TRUE	3.074358088820165e-5	143	21	6	0.2857142857142857	0.04195804195804196	GO:0007043	GO:BP	cell-cell junction assembly	16175	2647		0.6666666666666666	0.7142857142857143	143	16032	6	15	137	16017	16175	0.10664325421941459
R1	cpdb	0	network_modules	205	TRUE	2.5483224602635134e-4	346	21	7	0.3333333333333333	0.02023121387283237	GO:0034329	GO:BP	cell junction assembly	16175	8571		0.8333333333333334	0.8571428571428571	346	15829	7	14	339	15815	16175	0.07773621222177071
R1	cpdb	0	network_modules	205	TRUE	2.703241085306446e-4	533	21	8	0.38095238095238093	0.0150093808630394	GO:0034330	GO:BP	cell junction organization	16175	8572		1	1	533	15642	8	13	525	15629	16175	0.07028841716621047
R1	cpdb	0	network_modules	205	TRUE	0.007903423199387085	5	18	2	0.1111111111111111	0.4	REAC:R-HSA-390648	REAC	Muscarinic acetylcholine receptors	10916	1495		1	1	5	10911	2	16	3	10895	10916	0.21017088694923294
R1	cpdb	0	network_modules	206	TRUE	2.4321099965392645e-20	179	26	15	0.5769230769230769	0.08379888268156424	GO:0045216	GO:BP	cell-cell junction organization	16175	11328		0	0.034482758620689655	179	15996	15	11	164	15985	16175	0.2170362770563472
R1	cpdb	0	network_modules	206	TRUE	7.192056371477058e-18	170	17	13	0.7647058823529411	0.07647058823529412	KEGG:04530	KEGG	Tight junction	8484	317		0	0.2	170	8314	13	4	157	8310	8484	0.23811878470380007
R1	cpdb	0	network_modules	206	TRUE	1.512771646793291e-17	143	26	13	0.5	0.09090909090909091	GO:0007043	GO:BP	cell-cell junction assembly	16175	2647		0.03571428571428571	0.06896551724137931	143	16032	13	13	130	16019	16175	0.2105322128613122
R1	cpdb	0	network_modules	206	TRUE	3.762606633606956e-17	69	26	11	0.4230769230769231	0.15942028985507245	GO:0120192	GO:BP	tight junction assembly	16175	19553		0.07142857142857142	0.10344827586206896	69	16106	11	15	58	16091	16175	0.25784452660348733
R1	cpdb	0	network_modules	206	TRUE	5.273519314910484e-17	71	26	11	0.4230769230769231	0.15492957746478872	GO:0120193	GO:BP	tight junction organization	16175	19554		0.10714285714285714	0.13793103448275862	71	16104	11	15	60	16089	16175	0.2541277062361046
R1	cpdb	0	network_modules	206	TRUE	1.219836574441769e-13	30	22	8	0.36363636363636365	0.26666666666666666	REAC:R-HSA-420029	REAC	Tight junction interactions	10916	2510		0	0.1111111111111111	30	10886	8	14	22	10872	10916	0.30978398091852377
R1	cpdb	0	network_modules	206	TRUE	2.5334157860116216e-13	33	26	8	0.3076923076923077	0.24242424242424243	GO:0035633	GO:BP	maintenance of blood-brain barrier	16175	9129		0.14285714285714285	0.1724137931034483	33	16142	8	18	25	16124	16175	0.2718002927634411
R1	cpdb	0	network_modules	206	TRUE	3.712263601309077e-13	533	26	15	0.5769230769230769	0.028142589118198873	GO:0034330	GO:BP	cell junction organization	16175	8572		0.17857142857142858	0.20689655172413793	533	15642	15	11	518	15631	16175	0.1222711904085845
R1	cpdb	0	network_modules	206	TRUE	5.443941586791275e-13	64	26	9	0.34615384615384615	0.140625	GO:0070830	GO:BP	bicellular tight junction assembly	16175	16327		0.21428571428571427	0.2413793103448276	64	16111	9	17	55	16094	16175	0.2187173644143784
R1	cpdb	0	network_modules	206	TRUE	1.4623721464961528e-12	71	26	9	0.34615384615384615	0.1267605633802817	GO:0043297	GO:BP	apical junction assembly	16175	10606		0.25	0.27586206896551724	71	16104	9	17	62	16087	16175	0.2074382583363665
R1	cpdb	0	network_modules	206	TRUE	1.7647935003892222e-12	346	26	13	0.5	0.03757225433526012	GO:0034329	GO:BP	cell junction assembly	16175	8571		0.2857142857142857	0.3103448275862069	346	15829	13	13	333	15816	16175	0.13273155608592
R1	cpdb	0	network_modules	206	TRUE	2.096664712664564e-10	153	17	9	0.5294117647058824	0.058823529411764705	KEGG:04514	KEGG	Cell adhesion molecules	8484	315		0.25	0.4	153	8331	9	8	144	8323	8484	0.17219000717434352
R1	cpdb	0	network_modules	206	TRUE	1.115900092100769e-9	114	17	8	0.47058823529411764	0.07017543859649122	KEGG:04670	KEGG	Leukocyte transendothelial migration	8484	343		0.5	0.6	114	8370	8	9	106	8361	8484	0.17791191261789022
R1	cpdb	0	network_modules	206	TRUE	1.140871321857555e-9	87	22	8	0.36363636363636365	0.09195402298850575	REAC:R-HSA-421270	REAC	Cell-cell junction organization	10916	329		0.125	0.2222222222222222	87	10829	8	14	79	10815	10916	0.17975055153777292
R1	cpdb	0	network_modules	206	TRUE	1.0416821828498709e-8	114	22	8	0.36363636363636365	0.07017543859649122	REAC:R-HSA-446728	REAC	Cell junction organization	10916	324		0.25	0.3333333333333333	114	10802	8	14	106	10788	10916	0.15613085216496417
R1	cpdb	0	network_modules	206	TRUE	3.6374829413857004e-8	5	26	4	0.15384615384615385	0.8	GO:1905605	GO:BP	positive regulation of blood-brain barrier permeability	16175	24763		0.32142857142857145	0.3448275862068966	5	16170	4	22	1	16148	16175	0.3504542112176851
R1	cpdb	0	network_modules	206	TRUE	4.764035654048608e-8	40	26	6	0.23076923076923078	0.15	GO:0061028	GO:BP	establishment of endothelial barrier	16175	15145		0.35714285714285715	0.3793103448275862	40	16135	6	20	34	16115	16175	0.18443464235588194
R1	cpdb	0	network_modules	206	TRUE	9.123521252123349e-8	197	17	8	0.47058823529411764	0.04060913705583756	KEGG:05130	KEGG	Pathogenic Escherichia coli infection	8484	427		0.75	0.8	197	8287	8	9	189	8278	8484	0.1331047422120944
R1	cpdb	0	network_modules	206	TRUE	9.499607694070368e-8	152	26	8	0.3076923076923077	0.05263157894736842	GO:0060249	GO:BP	anatomical structure homeostasis	16175	14466		0.39285714285714285	0.4482758620689655	152	16023	8	18	144	16005	16175	0.12405393373163973
R1	cpdb	0	network_modules	206	TRUE	9.499607694070368e-8	152	26	8	0.3076923076923077	0.05263157894736842	GO:0001894	GO:BP	tissue homeostasis	16175	519		0.39285714285714285	0.4482758620689655	152	16023	8	18	144	16005	16175	0.12405393373163973
R1	cpdb	0	network_modules	206	TRUE	9.546893965684967e-8	150	22	8	0.36363636363636365	0.05333333333333334	REAC:R-HSA-1500931	REAC	Cell-Cell communication	10916	328		0.375	0.4444444444444444	150	10766	8	14	142	10752	10916	0.13506604517662388
R1	cpdb	0	network_modules	206	TRUE	1.0055766820206167e-7	45	26	6	0.23076923076923078	0.13333333333333333	GO:0001885	GO:BP	endothelial cell development	16175	512		0.4642857142857143	0.4827586206896552	45	16130	6	20	39	16110	16175	0.17367811365272162
R1	cpdb	0	network_modules	206	TRUE	2.5406985359111305e-7	7	26	4	0.15384615384615385	0.5714285714285714	GO:1905603	GO:BP	regulation of blood-brain barrier permeability	16175	24761		0.5	0.5517241379310345	7	16168	4	22	3	16146	16175	0.29596764351688354
R1	cpdb	0	network_modules	206	TRUE	2.5406985359111305e-7	7	26	4	0.15384615384615385	0.5714285714285714	GO:0090557	GO:BP	establishment of endothelial intestinal barrier	16175	18351		0.5	0.5517241379310345	7	16168	4	22	3	16146	16175	0.29596764351688354
R1	cpdb	0	network_modules	206	TRUE	2.561595340686005e-7	22	26	5	0.19230769230769232	0.22727272727272727	GO:0016338	GO:BP	calcium-independent cell-cell adhesion via plasma membrane cell-adhesion molecules	16175	5213		0.5714285714285714	0.5862068965517241	22	16153	5	21	17	16132	16175	0.20789035553360857
R1	cpdb	0	network_modules	206	TRUE	6.924443720880107e-7	158	17	7	0.4117647058823529	0.04430379746835443	KEGG:05160	KEGG	Hepatitis C	8484	441		1	1	158	8326	7	10	151	8316	8484	0.13030539297757962
R1	cpdb	0	network_modules	206	TRUE	3.5744770977587608e-6	80	26	6	0.23076923076923078	0.075	GO:0045446	GO:BP	endothelial cell differentiation	16175	11379		0.6071428571428571	0.6206896551724138	80	16095	6	20	74	16075	16175	0.12916250605126228
R1	cpdb	0	network_modules	206	TRUE	3.6119243833630753e-6	36	26	5	0.19230769230769232	0.1388888888888889	GO:0043114	GO:BP	regulation of vascular permeability	16175	10538		0.6428571428571429	0.6551724137931034	36	16139	5	21	31	16118	16175	0.1618488651997726
R1	cpdb	0	network_modules	206	TRUE	5.1564814756123094e-6	13	26	4	0.15384615384615385	0.3076923076923077	GO:0043117	GO:BP	positive regulation of vascular permeability	16175	10540		0.6785714285714286	0.6896551724137931	13	16162	4	22	9	16140	16175	0.21669595891045385
R1	cpdb	0	network_modules	206	TRUE	1.0467917233623342e-5	745	26	11	0.4230769230769231	0.01476510067114094	GO:0098609	GO:BP	cell-cell adhesion	16175	18805		0.7142857142857143	0.7241379310344828	745	15430	11	15	734	15415	16175	0.07217043970909333
R1	cpdb	0	network_modules	206	TRUE	1.08412625633152e-5	96	26	6	0.23076923076923078	0.0625	GO:0003158	GO:BP	endothelium development	16175	1588		0.75	0.7586206896551724	96	16079	6	20	90	16059	16175	0.11745061103473797
R1	cpdb	0	network_modules	206	TRUE	1.3593293299107507e-5	50	22	5	0.22727272727272727	0.1	REAC:R-HSA-157858	REAC	Gap junction trafficking and regulation	10916	1036		0.5	0.5555555555555556	50	10866	5	17	45	10849	10916	0.14820625052834918
R1	cpdb	0	network_modules	206	TRUE	1.5646861798521288e-5	102	26	6	0.23076923076923078	0.058823529411764705	GO:0002064	GO:BP	epithelial cell development	16175	655		0.7857142857142857	0.7931034482758621	102	16073	6	20	96	16053	16175	0.1137770694718326
R1	cpdb	0	network_modules	206	TRUE	2.194845937270891e-5	18	26	4	0.15384615384615385	0.2222222222222222	GO:2000810	GO:BP	regulation of bicellular tight junction assembly	16175	26065		0.8214285714285714	0.8275862068965517	18	16157	4	22	14	16135	16175	0.18381262560292377
R1	cpdb	0	network_modules	206	TRUE	2.328739581719152e-5	193	26	7	0.2692307692307692	0.03626943005181347	GO:0098742	GO:BP	cell-cell adhesion via plasma-membrane adhesion molecules	16175	18867		0.8571428571428571	0.8620689655172413	193	15982	7	19	186	15963	16175	0.09508273109397732
R1	cpdb	0	network_modules	206	TRUE	2.3623518319092105e-5	5	22	3	0.13636363636363635	0.6	REAC:R-HSA-8935964	REAC	RUNX1 regulates expression of components of tight junctions	10916	1918		0.625	0.6666666666666666	5	10911	3	19	2	10892	10916	0.28543106118269873
R1	cpdb	0	network_modules	206	TRUE	2.777112118919247e-5	19	26	4	0.15384615384615385	0.21052631578947367	GO:0150105	GO:BP	protein localization to cell-cell junction	16175	20144		0.8928571428571429	0.896551724137931	19	16156	4	22	15	16134	16175	0.17884318701465213
R1	cpdb	0	network_modules	206	TRUE	2.9102345572758686e-4	38	22	4	0.18181818181818182	0.10526315789473684	REAC:R-HSA-190861	REAC	Gap junction assembly	10916	1033		0.75	0.7777777777777778	38	10878	4	18	34	10860	10916	0.13606813824202607
R1	cpdb	0	network_modules	206	TRUE	3.8674432545441717e-4	11	22	3	0.13636363636363635	0.2727272727272727	REAC:R-HSA-351906	REAC	Apoptotic cleavage of cell adhesion  proteins	10916	160		0.875	0.8888888888888888	11	10905	3	19	8	10886	10916	0.19171201310844765
R1	cpdb	0	network_modules	206	TRUE	8.23287600298394e-4	49	22	4	0.18181818181818182	0.08163265306122448	REAC:R-HSA-190828	REAC	Gap junction trafficking	10916	1035		1	1	49	10867	4	18	45	10849	10916	0.11920897405464734
R1	cpdb	0	network_modules	206	TRUE	0.0011446974497423242	701	26	9	0.34615384615384615	0.012838801711840228	GO:0060429	GO:BP	epithelium development	16175	14627		0.9285714285714286	0.9310344827586207	701	15474	9	17	692	15457	16175	0.059672707393879275
R1	cpdb	0	network_modules	206	TRUE	0.001215646201967063	510	26	8	0.3076923076923077	0.01568627450980392	GO:0048871	GO:BP	multicellular organismal-level homeostasis	16175	13114		0.9642857142857143	0.9655172413793104	510	15665	8	18	502	15647	16175	0.0634120864147359
R1	cpdb	0	network_modules	206	TRUE	0.00490618201676497	66	26	4	0.15384615384615385	0.06060606060606061	GO:1902414	GO:BP	protein localization to cell junction	16175	22265		1	1	66	16109	4	22	62	16087	16175	0.09426804243787204
R1	cpdb	0	network_modules	207	TRUE	6.745219909429603e-9	6	14	4	0.2857142857142857	0.6666666666666666	GO:0098700	GO:BP	neurotransmitter loading into synaptic vesicle	16175	18833		0	0.03225806451612903	6	16169	4	10	2	16159	16175	0.4361388069030599
R1	cpdb	0	network_modules	207	TRUE	5.7982744437769e-8	78	7	5	0.7142857142857143	0.0641025641025641	KEGG:04721	KEGG	Synaptic vesicle cycle	8484	351		0	0.3333333333333333	78	8406	5	2	73	8404	8484	0.21229137157281014
R1	cpdb	0	network_modules	207	TRUE	2.1101893998514173e-7	583	14	9	0.6428571428571429	0.015437392795883362	GO:0032940	GO:BP	secretion by cell	16175	7926		0.03333333333333333	0.06451612903225806	583	15592	9	5	574	15587	16175	0.0958174255271041
R1	cpdb	0	network_modules	207	TRUE	3.7780129538977195e-7	50	12	5	0.4166666666666667	0.1	REAC:R-HSA-112310	REAC	Neurotransmitter release cycle	10916	1595		0	0.2	50	10866	5	7	45	10859	10916	0.2024554551340875
R1	cpdb	0	network_modules	207	TRUE	5.250077443527092e-7	646	14	9	0.6428571428571429	0.01393188854489164	GO:0140352	GO:BP	export from cell	16175	19748		0.06666666666666667	0.0967741935483871	646	15529	9	5	637	15524	16175	0.09062439790753393
R1	cpdb	0	network_modules	207	TRUE	5.470319391971099e-7	649	14	9	0.6428571428571429	0.01386748844375963	GO:0046903	GO:BP	secretion	16175	12430		0.1	0.12903225806451613	649	15526	9	5	640	15521	16175	0.09039561828680119
R1	cpdb	0	network_modules	207	TRUE	1.6975126416806618e-6	145	14	6	0.42857142857142855	0.041379310344827586	GO:0006836	GO:BP	neurotransmitter transport	16175	2506		0.13333333333333333	0.16129032258064516	145	16030	6	8	139	16022	16175	0.13102860907316083
R1	cpdb	0	network_modules	207	TRUE	2.8179190279734008e-6	68	14	5	0.35714285714285715	0.07352941176470588	GO:0015837	GO:BP	amine transport	16175	4947		0.16666666666666666	0.1935483870967742	68	16107	5	9	63	16098	16175	0.16055057252018984
R1	cpdb	0	network_modules	207	TRUE	3.560393357624396e-6	311	14	7	0.5	0.022508038585209004	GO:0023061	GO:BP	signal release	16175	6645		0.2	0.22580645161290322	311	15864	7	7	304	15857	16175	0.10304514481822112
R1	cpdb	0	network_modules	207	TRUE	1.6934887950950717e-5	400	12	7	0.5833333333333334	0.0175	REAC:R-HSA-112316	REAC	Neuronal System	10916	1590		0.25	0.4	400	10516	7	5	393	10511	10916	0.09652659223566548
R1	cpdb	0	network_modules	207	TRUE	4.4271650856086965e-5	117	14	5	0.35714285714285715	0.042735042735042736	GO:0099504	GO:BP	synaptic vesicle cycle	16175	19100		0.23333333333333334	0.25806451612903225	117	16058	5	9	112	16049	16175	0.12153216474508954
R1	cpdb	0	network_modules	207	TRUE	5.2429124861072317e-5	121	14	5	0.35714285714285715	0.04132231404958678	GO:0099003	GO:BP	vesicle-mediated transport in synapse	16175	18999		0.26666666666666666	0.2903225806451613	121	16054	5	9	116	16045	16175	0.11943690333806001
R1	cpdb	0	network_modules	207	TRUE	6.025149402259886e-5	263	14	6	0.42857142857142855	0.022813688212927757	GO:0006887	GO:BP	exocytosis	16175	2543		0.3	0.3225806451612903	263	15912	6	8	257	15904	16175	0.09595324439136801
R1	cpdb	0	network_modules	207	TRUE	1.013295574509476e-4	50	14	4	0.2857142857142857	0.08	GO:0017156	GO:BP	calcium-ion regulated exocytosis	16175	5286		0.3333333333333333	0.3548387096774194	50	16125	4	10	46	16115	16175	0.14984662894237805
R1	cpdb	0	network_modules	207	TRUE	1.439413634013472e-4	148	14	5	0.35714285714285715	0.033783783783783786	GO:0017157	GO:BP	regulation of exocytosis	16175	5287		0.36666666666666664	0.3870967741935484	148	16027	5	9	143	16018	16175	0.10756912652059243
R1	cpdb	0	network_modules	207	TRUE	1.628426987443445e-4	40	7	3	0.42857142857142855	0.075	KEGG:05033	KEGG	Nicotine addiction	8484	421		0.5	0.6666666666666666	40	8444	3	4	37	8440	8484	0.17780480923077277
R1	cpdb	0	network_modules	207	TRUE	1.9935940654397757e-4	59	14	4	0.2857142857142857	0.06779661016949153	GO:0051952	GO:BP	regulation of amine transport	16175	14022		0.4	0.41935483870967744	59	16116	4	10	55	16106	16175	0.13771186053785367
R1	cpdb	0	network_modules	207	TRUE	2.1917354351879098e-4	161	14	5	0.35714285714285715	0.031055900621118012	GO:0045055	GO:BP	regulated exocytosis	16175	11253		0.43333333333333335	0.45161290322580644	161	16014	5	9	156	16005	16175	0.10293843952088068
R1	cpdb	0	network_modules	207	TRUE	2.77625581835423e-4	64	14	4	0.2857142857142857	0.0625	GO:0015844	GO:BP	monoamine transport	16175	4954		0.4666666666666667	0.4838709677419355	64	16111	4	10	60	16101	16175	0.13209869813963582
R1	cpdb	0	network_modules	207	TRUE	7.60157793924122e-4	404	14	6	0.42857142857142855	0.01485148514851485	GO:1903530	GO:BP	regulation of secretion by cell	16175	23080		0.5	0.5161290322580645	404	15771	6	8	398	15763	16175	0.07612008313230662
R1	cpdb	0	network_modules	207	TRUE	8.169892638852501e-4	409	14	6	0.42857142857142855	0.014669926650366748	GO:0060627	GO:BP	regulation of vesicle-mediated transport	16175	14803		0.5333333333333333	0.5483870967741935	409	15766	6	8	403	15758	16175	0.07560741280601341
R1	cpdb	0	network_modules	207	TRUE	8.918977271069437e-4	2	14	2	0.14285714285714285	1	GO:0051630	GO:BP	acetylcholine uptake	16175	13846		0.5666666666666667	0.5806451612903226	2	16173	2	12	0	16161	16175	0.377824226446696
R1	cpdb	0	network_modules	207	TRUE	9.615674022446239e-4	87	14	4	0.2857142857142857	0.04597701149425287	GO:1903305	GO:BP	regulation of regulated secretory pathway	16175	22892		0.6	0.6129032258064516	87	16088	4	10	83	16078	16175	0.11280849692506123
R1	cpdb	0	network_modules	207	TRUE	0.001080184420555975	104	12	4	0.3333333333333333	0.038461538461538464	REAC:R-HSA-8856825	REAC	Cargo recognition for clathrin-mediated endocytosis	10916	309		0.5	0.6	104	10812	4	8	100	10804	10916	0.11057997254853136
R1	cpdb	0	network_modules	207	TRUE	0.0012865113295008877	442	14	6	0.42857142857142855	0.013574660633484163	GO:0051046	GO:BP	regulation of secretion	16175	13456		0.6333333333333333	0.6451612903225806	442	15733	6	8	436	15725	16175	0.07243813377285403
R1	cpdb	0	network_modules	207	TRUE	0.0014881018284921134	259	12	5	0.4166666666666667	0.019305019305019305	REAC:R-HSA-112315	REAC	Transmission across Chemical Synapses	10916	2580		0.75	0.8	259	10657	5	7	254	10650	10916	0.08564857352383803
R1	cpdb	0	network_modules	207	TRUE	0.002140466269098076	28	14	3	0.21428571428571427	0.10714285714285714	GO:0014046	GO:BP	dopamine secretion	16175	4616		0.6666666666666666	0.6774193548387096	28	16147	3	11	25	16136	16175	0.15049423360121347
R1	cpdb	0	network_modules	207	TRUE	0.0022644480098327215	487	14	6	0.42857142857142855	0.012320328542094456	GO:0007268	GO:BP	chemical synaptic transmission	16175	2796		0.7	0.7419354838709677	487	15688	6	8	481	15680	16175	0.0686300285789112
R1	cpdb	0	network_modules	207	TRUE	0.0022644480098327215	487	14	6	0.42857142857142855	0.012320328542094456	GO:0098916	GO:BP	anterograde trans-synaptic signaling	16175	18949		0.7	0.7419354838709677	487	15688	6	8	481	15680	16175	0.0686300285789112
R1	cpdb	0	network_modules	207	TRUE	0.002403115464492658	492	14	6	0.42857142857142855	0.012195121951219513	GO:0099537	GO:BP	trans-synaptic signaling	16175	19116		0.7666666666666667	0.7741935483870968	492	15683	6	8	486	15675	16175	0.06823831294088424
R1	cpdb	0	network_modules	207	TRUE	0.002650007721764824	30	14	3	0.21428571428571427	0.1	GO:0098810	GO:BP	neurotransmitter reuptake	16175	18899		0.8	0.8064516129032258	30	16145	3	11	27	16134	16175	0.14531566509861754
R1	cpdb	0	network_modules	207	TRUE	0.003169423325801953	516	14	6	0.42857142857142855	0.011627906976744186	GO:0099536	GO:BP	synaptic signaling	16175	19115		0.8333333333333334	0.8387096774193549	516	15659	6	8	510	15651	16175	0.06643501920777659
R1	cpdb	0	network_modules	207	TRUE	0.003234144197223559	32	14	3	0.21428571428571427	0.09375	GO:0017158	GO:BP	regulation of calcium ion-dependent exocytosis	16175	5288		0.8666666666666667	0.8709677419354839	32	16143	3	11	29	16132	16175	0.14062810170400844
R1	cpdb	0	network_modules	207	TRUE	0.0038978567232688917	34	14	3	0.21428571428571427	0.08823529411764706	GO:0015800	GO:BP	acidic amino acid transport	16175	4914		0.9	0.9032258064516129	34	16141	3	11	31	16130	16175	0.13635828904223973
R1	cpdb	0	network_modules	207	TRUE	0.003941457855575503	144	12	4	0.3333333333333333	0.027777777777777776	REAC:R-HSA-8856828	REAC	Clathrin-mediated endocytosis	10916	372		1	1	144	10772	4	8	140	10764	10916	0.09308378636433523
R1	cpdb	0	network_modules	207	TRUE	0.005937783571117076	39	14	3	0.21428571428571427	0.07692307692307693	GO:0001504	GO:BP	neurotransmitter uptake	16175	321		0.9333333333333333	0.9354838709677419	39	16136	3	11	36	16125	16175	0.12715188792566942
R1	cpdb	0	network_modules	207	TRUE	0.006415948967409174	40	14	3	0.21428571428571427	0.075	GO:0050432	GO:BP	catecholamine secretion	16175	13186		0.9666666666666667	0.967741935483871	40	16135	3	11	37	16124	16175	0.12551968344240563
R1	cpdb	0	network_modules	207	TRUE	0.006918937818048657	41	14	3	0.21428571428571427	0.07317073170731707	GO:0015872	GO:BP	dopamine transport	16175	4980		1	1	41	16134	3	11	38	16123	16175	0.12394716022273836
R1	cpdb	0	network_modules	207	TRUE	0.00839635959471317	148	7	3	0.42857142857142855	0.02027027027027027	KEGG:04723	KEGG	Retrograde endocannabinoid signaling	8484	353		1	1	148	8336	3	4	145	8332	8484	0.09023908728170854
R1	cpdb	0	network_modules	208	TRUE	1.0628260790683131e-10	144	12	8	0.6666666666666666	0.05555555555555555	REAC:R-HSA-8856828	REAC	Clathrin-mediated endocytosis	10916	372		0	0.14285714285714285	144	10772	8	4	136	10768	10916	0.1900031503430727
R1	cpdb	0	network_modules	208	TRUE	1.316652016063742e-9	104	12	7	0.5833333333333334	0.0673076923076923	REAC:R-HSA-8856825	REAC	Cargo recognition for clathrin-mediated endocytosis	10916	309		0.16666666666666666	0.2857142857142857	104	10812	7	5	97	10807	10916	0.19595513619006533
R1	cpdb	0	network_modules	208	TRUE	2.8985905863507597e-4	19	12	3	0.25	0.15789473684210525	REAC:R-HSA-8964038	REAC	LDL clearance	10916	1295		0.3333333333333333	0.42857142857142855	19	10897	3	9	16	10888	10916	0.19757715000289244
R1	cpdb	0	network_modules	208	TRUE	3.973535017817977e-4	21	12	3	0.25	0.14285714285714285	REAC:R-HSA-164938	REAC	Nef-mediates down modulation of cell surface receptors by recruiting them to clathrin adapters	10916	1565		0.5	0.5714285714285714	21	10895	3	9	18	10886	10916	0.1878118959846124
R1	cpdb	0	network_modules	208	TRUE	8.706387220533925e-4	27	12	3	0.25	0.1111111111111111	REAC:R-HSA-164952	REAC	The role of Nef in HIV-1 replication and disease pathogenesis	10916	2504		0.6666666666666666	0.7142857142857143	27	10889	3	9	24	10880	10916	0.16531306015909594
R1	cpdb	0	network_modules	208	TRUE	0.0021134394013098625	36	12	3	0.25	0.08333333333333333	REAC:R-HSA-8964043	REAC	Plasma lipoprotein clearance	10916	1757		0.8333333333333334	0.8571428571428571	36	10880	3	9	33	10871	10916	0.14274744937012845
R1	cpdb	0	network_modules	208	TRUE	0.004323894345985547	248	9	4	0.4444444444444444	0.016129032258064516	KEGG:04144	KEGG	Endocytosis	8484	280		NA	1	248	8236	4	5	244	8231	8484	0.08032281895699178
R1	cpdb	0	network_modules	208	TRUE	0.006485383986860109	121	16	4	0.25	0.03305785123966942	GO:0099003	GO:BP	vesicle-mediated transport in synapse	16175	18999		0	0.5	121	16054	4	12	117	16042	16175	0.08856437608005159
R1	cpdb	0	network_modules	208	TRUE	0.006903031937510064	7	12	2	0.16666666666666666	0.2857142857142857	REAC:R-HSA-182218	REAC	Nef Mediated CD8 Down-regulation	10916	1561		1	1	7	10909	2	10	5	10899	10916	0.21756763404988302
R1	cpdb	0	network_modules	208	TRUE	0.00964096021214287	533	16	6	0.375	0.01125703564727955	GO:0006897	GO:BP	endocytosis	16175	2551		1	1	533	15642	6	10	527	15632	16175	0.060294019962829216
R1	cpdb	0	network_modules	209	TRUE	1.0540407639842962e-18	11	23	8	0.34782608695652173	0.7272727272727273	GO:0001867	GO:BP	complement activation, lectin pathway	16175	504		0	0.03125	11	16164	8	15	3	16149	16175	0.5025004879478894
R1	cpdb	0	network_modules	209	TRUE	2.574865934050782e-14	7	19	6	0.3157894736842105	0.8571428571428571	REAC:R-HSA-166662	REAC	Lectin pathway of complement activation	10916	1309		0	0.16666666666666666	7	10909	6	13	1	10896	10916	0.5198286482616711
R1	cpdb	0	network_modules	209	TRUE	8.74319423988552e-12	56	23	8	0.34782608695652173	0.14285714285714285	GO:0006956	GO:BP	complement activation	16175	2587		0.03225806451612903	0.0625	56	16119	8	15	48	16104	16175	0.22123288307613434
R1	cpdb	0	network_modules	209	TRUE	6.940884204395164e-10	9	23	5	0.21739130434782608	0.5555555555555556	GO:1903028	GO:BP	positive regulation of opsonization	16175	22710		0.06451612903225806	0.09375	9	16166	5	18	4	16148	16175	0.3469777901149326
R1	cpdb	0	network_modules	209	TRUE	1.9422768292535144e-9	111	19	8	0.42105263157894735	0.07207207207207207	REAC:R-HSA-166658	REAC	Complement cascade	10916	390		0.2	0.3333333333333333	111	10805	8	11	103	10794	10916	0.17101424317144248
R1	cpdb	0	network_modules	209	TRUE	2.5402708133168487e-9	11	23	5	0.21739130434782608	0.45454545454545453	GO:1903027	GO:BP	regulation of opsonization	16175	22709		0.0967741935483871	0.125	11	16164	5	18	6	16146	16175	0.31369365404798205
R1	cpdb	0	network_modules	209	TRUE	4.0103281456316356e-9	68	19	7	0.3684210526315789	0.10294117647058823	REAC:R-HSA-166786	REAC	Creation of C4 and C2 activators	10916	413		0.4	0.5	68	10848	7	12	61	10836	10916	0.19221886508252164
R1	cpdb	0	network_modules	209	TRUE	8.973977712194966e-9	76	19	7	0.3684210526315789	0.09210526315789473	REAC:R-HSA-166663	REAC	Initial triggering of complement	10916	1200		0.6	0.6666666666666666	76	10840	7	12	69	10828	10916	0.18151988665941263
R1	cpdb	0	network_modules	209	TRUE	1.645056523840451e-8	15	23	5	0.21739130434782608	0.3333333333333333	GO:0008228	GO:BP	opsonization	16175	3147		0.12903225806451613	0.15625	15	16160	5	18	10	16142	16175	0.2683578602474453
R1	cpdb	0	network_modules	209	TRUE	2.110251465099678e-8	81	23	7	0.30434782608695654	0.08641975308641975	GO:0050764	GO:BP	regulation of phagocytosis	16175	13238		0.16129032258064516	0.1875	81	16094	7	16	74	16078	16175	0.16002411834164865
R1	cpdb	0	network_modules	209	TRUE	8.453826392968477e-8	20	23	5	0.21739130434782608	0.25	GO:0006910	GO:BP	phagocytosis, recognition	16175	2560		0.1935483870967742	0.21875	20	16155	5	18	15	16137	16175	0.23210875190499303
R1	cpdb	0	network_modules	209	TRUE	1.4758261437415183e-7	86	14	6	0.42857142857142855	0.06976744186046512	KEGG:05150	KEGG	Staphylococcus aureus infection	8484	439		0	0.3333333333333333	86	8398	6	8	80	8390	8484	0.16982964623949842
R1	cpdb	0	network_modules	209	TRUE	2.6437118511515094e-7	59	23	6	0.2608695652173913	0.1016949152542373	GO:0050766	GO:BP	positive regulation of phagocytosis	16175	13240		0.22580645161290322	0.25	59	16116	6	17	53	16099	16175	0.16100837389997602
R1	cpdb	0	network_modules	209	TRUE	7.417083800013731e-7	224	23	8	0.34782608695652173	0.03571428571428571	GO:0006959	GO:BP	humoral immune response	16175	2590		0.25806451612903225	0.28125	224	15951	8	15	216	15936	16175	0.10784359804384727
R1	cpdb	0	network_modules	209	TRUE	5.68926729798942e-6	4	19	3	0.15789473684210525	0.75	REAC:R-HSA-2855086	REAC	Ficolins bind to repetitive carbohydrate structures on the target cell surface	10916	942		0.8	0.8333333333333334	4	10912	3	16	1	10896	10916	0.34368713053794575
R1	cpdb	0	network_modules	209	TRUE	7.272077933304434e-6	185	23	7	0.30434782608695654	0.03783783783783784	GO:0006909	GO:BP	phagocytosis	16175	2559		0.2903225806451613	0.3125	185	15990	7	16	178	15974	16175	0.10394887269278816
R1	cpdb	0	network_modules	209	TRUE	8.233143441551848e-6	451	23	9	0.391304347826087	0.019955654101995565	GO:0002831	GO:BP	regulation of response to biotic stimulus	16175	1341		0.3225806451612903	0.34375	451	15724	9	14	442	15710	16175	0.0832983227053474
R1	cpdb	0	network_modules	209	TRUE	1.022793225031346e-5	86	14	5	0.35714285714285715	0.05813953488372093	KEGG:04610	KEGG	Complement and coagulation cascades	8484	320		0.5	0.6666666666666666	86	8398	5	9	81	8389	8484	0.1408390080363615
R1	cpdb	0	network_modules	209	TRUE	1.1735041006324835e-5	654	23	10	0.43478260869565216	0.01529051987767584	GO:0031347	GO:BP	regulation of defense response	16175	7138		0.3548387096774194	0.375	654	15521	10	13	644	15508	16175	0.0755488750653359
R1	cpdb	0	network_modules	209	TRUE	2.4705142161345024e-5	124	23	6	0.2608695652173913	0.04838709677419355	GO:0045807	GO:BP	positive regulation of endocytosis	16175	11631		0.3870967741935484	0.40625	124	16051	6	17	118	16034	16175	0.1095475631023826
R1	cpdb	0	network_modules	209	TRUE	2.493197853397391e-5	221	23	7	0.30434782608695654	0.03167420814479638	GO:0030100	GO:BP	regulation of endocytosis	16175	6678		0.41935483870967744	0.4375	221	15954	7	16	214	15938	16175	0.094490118919648
R1	cpdb	0	network_modules	209	TRUE	2.9773703186635583e-5	721	23	10	0.43478260869565216	0.013869625520110958	GO:0045087	GO:BP	innate immune response	16175	11270		0.45161290322580644	0.46875	721	15454	10	13	711	15441	16175	0.07135144035872495
R1	cpdb	0	network_modules	209	TRUE	3.685993968338416e-5	536	23	9	0.391304347826087	0.016791044776119403	GO:0002252	GO:BP	immune effector process	16175	784		0.4838709677419355	0.5	536	15639	9	14	527	15625	16175	0.07550808989720384
R1	cpdb	0	network_modules	209	TRUE	5.0410182177221815e-5	67	23	5	0.21739130434782608	0.07462686567164178	GO:0002752	GO:BP	cell surface pattern recognition receptor signaling pathway	16175	1263		0.5161290322580645	0.53125	67	16108	5	18	62	16090	16175	0.12529220980860029
R1	cpdb	0	network_modules	209	TRUE	1.1477529601518697e-4	276	23	7	0.30434782608695654	0.025362318840579712	GO:0002697	GO:BP	regulation of immune effector process	16175	1215		0.5483870967741935	0.5625	276	15899	7	16	269	15883	16175	0.08370814889357207
R1	cpdb	0	network_modules	209	TRUE	1.6837296540226287e-4	85	23	5	0.21739130434782608	0.058823529411764705	GO:0002220	GO:BP	innate immune response activating cell surface receptor signaling pathway	16175	754		0.5806451612903226	0.59375	85	16090	5	18	80	16072	16175	0.11071909332317335
R1	cpdb	0	network_modules	209	TRUE	2.628000647512518e-4	475	23	8	0.34782608695652173	0.016842105263157894	GO:0002253	GO:BP	activation of immune response	16175	785		0.6129032258064516	0.625	475	15700	8	15	467	15685	16175	0.07117918571182458
R1	cpdb	0	network_modules	209	TRUE	4.6464102455505933e-4	339	23	7	0.30434782608695654	0.02064896755162242	GO:0002833	GO:BP	positive regulation of response to biotic stimulus	16175	1343		0.6451612903225806	0.65625	339	15836	7	16	332	15820	16175	0.07465455331790831
R1	cpdb	0	network_modules	209	TRUE	6.152331283677547e-4	531	23	8	0.34782608695652173	0.015065913370998116	GO:0032103	GO:BP	positive regulation of response to external stimulus	16175	7367		0.6774193548387096	0.6875	531	15644	8	15	523	15629	16175	0.06670850399247234
R1	cpdb	0	network_modules	209	TRUE	6.421581668777062e-4	111	23	5	0.21739130434782608	0.04504504504504504	GO:0008037	GO:BP	cell recognition	16175	3099		0.7096774193548387	0.71875	111	16064	5	18	106	16046	16175	0.09623174494390782
R1	cpdb	0	network_modules	209	TRUE	6.958199890205495e-4	756	23	9	0.391304347826087	0.011904761904761904	GO:0050776	GO:BP	regulation of immune response	16175	13250		0.7419354838709677	0.75	756	15419	9	14	747	15405	16175	0.06159960265523175
R1	cpdb	0	network_modules	209	TRUE	0.0011148216287131347	386	23	7	0.30434782608695654	0.018134715025906734	GO:0045088	GO:BP	regulation of innate immune response	16175	11271		0.7741935483870968	0.78125	386	15789	7	16	379	15773	16175	0.0693476792555098
R1	cpdb	0	network_modules	209	TRUE	0.001159885036419975	125	23	5	0.21739130434782608	0.04	GO:0045766	GO:BP	positive regulation of angiogenesis	16175	11602		0.8064516129032258	0.8125	125	16050	5	18	120	16032	16175	0.09034934466893389
R1	cpdb	0	network_modules	209	TRUE	0.0013535070480908452	231	14	5	0.35714285714285715	0.021645021645021644	KEGG:05171	KEGG	Coronavirus disease - COVID-19	8484	452		1	1	231	8253	5	9	226	8244	8484	0.0824163351537273
R1	cpdb	0	network_modules	209	TRUE	0.0013561244795143202	129	23	5	0.21739130434782608	0.03875968992248062	GO:1904018	GO:BP	positive regulation of vasculature development	16175	23459		0.8387096774193549	0.84375	129	16046	5	18	124	16028	16175	0.08884372016468399
R1	cpdb	0	network_modules	209	TRUE	0.0016432689601298216	409	23	7	0.30434782608695654	0.017114914425427872	GO:0060627	GO:BP	regulation of vesicle-mediated transport	16175	14803		0.8709677419354839	0.875	409	15766	7	16	402	15750	16175	0.06707692916932965
R1	cpdb	0	network_modules	209	TRUE	0.002057870973826124	423	23	7	0.30434782608695654	0.016548463356973995	GO:0031349	GO:BP	positive regulation of defense response	16175	7140		0.9032258064516129	0.90625	423	15752	7	16	416	15736	16175	0.065782209861979
R1	cpdb	0	network_modules	209	TRUE	0.0021610403463724875	627	23	8	0.34782608695652173	0.012759170653907496	GO:0050778	GO:BP	positive regulation of immune response	16175	13252		0.9354838709677419	0.9375	627	15548	8	15	619	15533	16175	0.06041856689899995
R1	cpdb	0	network_modules	209	TRUE	0.005473410724453834	4	19	2	0.10526315789473684	0.5	REAC:R-HSA-190371	REAC	FGFR3b ligand binding and activation	10916	912		1	1	4	10912	2	17	2	10895	10916	0.22885826432368842
R1	cpdb	0	network_modules	209	TRUE	0.009515485888275225	533	23	7	0.30434782608695654	0.013133208255159476	GO:0006897	GO:BP	endocytosis	16175	2551		0.967741935483871	0.96875	533	15642	7	16	526	15626	16175	0.0573704603519189
R1	cpdb	0	network_modules	209	TRUE	0.009585806792600684	192	23	5	0.21739130434782608	0.026041666666666668	GO:0002699	GO:BP	positive regulation of immune effector process	16175	1217		1	1	192	15983	5	18	187	15965	16175	0.07160968751147428
R1	cpdb	0	network_modules	211	TRUE	5.1163337515944345e-14	7	21	6	0.2857142857142857	0.8571428571428571	REAC:R-HSA-420597	REAC	Nectin/Necl  trans heterodimerization	10916	1558		0	0.16666666666666666	7	10909	6	15	1	10894	10916	0.49439513744047614
R1	cpdb	0	network_modules	211	TRUE	7.30421178207926e-12	87	21	9	0.42857142857142855	0.10344827586206896	REAC:R-HSA-421270	REAC	Cell-cell junction organization	10916	329		0.2	0.3333333333333333	87	10829	9	12	78	10817	10916	0.20767133107208224
R1	cpdb	0	network_modules	211	TRUE	8.985156868186407e-11	114	21	9	0.42857142857142855	0.07894736842105263	REAC:R-HSA-446728	REAC	Cell junction organization	10916	324		0.4	0.5	114	10802	9	12	105	10790	10916	0.18057779282962919
R1	cpdb	0	network_modules	211	TRUE	1.1091851949984647e-9	150	21	9	0.42857142857142855	0.06	REAC:R-HSA-1500931	REAC	Cell-Cell communication	10916	328		0.6	0.6666666666666666	150	10766	9	12	141	10754	10916	0.15644332360242486
R1	cpdb	0	network_modules	211	TRUE	4.304004244808405e-9	153	22	9	0.4090909090909091	0.058823529411764705	KEGG:04514	KEGG	Cell adhesion molecules	8484	315		0	0.2	153	8331	9	13	144	8318	8484	0.14983774556764537
R1	cpdb	0	network_modules	211	TRUE	1.111571747441355e-8	170	22	9	0.4090909090909091	0.052941176470588235	KEGG:04530	KEGG	Tight junction	8484	317		0.25	0.4	170	8314	9	13	161	8301	8484	0.14156470906616694
R1	cpdb	0	network_modules	211	TRUE	2.0021176305106373e-7	55	21	6	0.2857142857142857	0.10909090909090909	REAC:R-HSA-418990	REAC	Adherens junctions interactions	10916	121		0.8	0.8333333333333334	55	10861	6	15	49	10846	10916	0.17403968567106112
R1	cpdb	0	network_modules	211	TRUE	8.229560475976222e-7	63	26	6	0.23076923076923078	0.09523809523809523	GO:0007156	GO:BP	homophilic cell adhesion via plasma membrane adhesion molecules	16175	2720		0	0.125	63	16112	6	20	57	16092	16175	0.1461498947448764
R1	cpdb	0	network_modules	211	TRUE	6.333632344228321e-6	93	22	6	0.2727272727272727	0.06451612903225806	KEGG:04520	KEGG	Adherens junction	8484	316		0.5	0.6	93	8391	6	16	87	8375	8484	0.12818567641937756
R1	cpdb	0	network_modules	211	TRUE	2.4472337384836274e-5	52	26	5	0.19230769230769232	0.09615384615384616	GO:0007157	GO:BP	heterophilic cell-cell adhesion via plasma membrane cell adhesion molecules	16175	2721		0.14285714285714285	0.25	52	16123	5	21	47	16102	16175	0.1340320516224091
R1	cpdb	0	network_modules	211	TRUE	4.2485418412463216e-5	210	22	7	0.3181818181818182	0.03333333333333333	KEGG:04015	KEGG	Rap1 signaling pathway	8484	248		0.75	0.8	210	8274	7	15	203	8259	8484	0.09629674894371325
R1	cpdb	0	network_modules	211	TRUE	1.4134188349947927e-4	157	22	6	0.2727272727272727	0.03821656050955414	KEGG:04390	KEGG	Hippo signaling pathway	8484	310		1	1	157	8327	6	16	151	8311	8484	0.09618210050367591
R1	cpdb	0	network_modules	211	TRUE	1.5249698747401219e-4	745	26	10	0.38461538461538464	0.013422818791946308	GO:0098609	GO:BP	cell-cell adhesion	16175	18805		0.2857142857142857	0.375	745	15430	10	16	735	15414	16175	0.06480796698798971
R1	cpdb	0	network_modules	211	TRUE	5.766215495442562e-4	39	26	4	0.15384615384615385	0.10256410256410256	GO:0045197	GO:BP	establishment or maintenance of epithelial cell apical/basal polarity	16175	11321		0.42857142857142855	0.5	39	16136	4	22	35	16114	16175	0.12389512983763872
R1	cpdb	0	network_modules	211	TRUE	6.99886123998844e-4	193	26	6	0.23076923076923078	0.031088082901554404	GO:0098742	GO:BP	cell-cell adhesion via plasma-membrane adhesion molecules	16175	18867		0.5714285714285714	0.625	193	15982	6	20	187	15962	16175	0.08086957320728715
R1	cpdb	0	network_modules	211	TRUE	8.614060425922523e-4	43	26	4	0.15384615384615385	0.09302325581395349	GO:0035088	GO:BP	establishment or maintenance of apical/basal cell polarity	16175	8802		0.7142857142857143	0.875	43	16132	4	22	39	16110	16175	0.1178138528809874
R1	cpdb	0	network_modules	211	TRUE	8.614060425922523e-4	43	26	4	0.15384615384615385	0.09302325581395349	GO:0061245	GO:BP	establishment or maintenance of bipolar cell polarity	16175	15338		0.7142857142857143	0.875	43	16132	4	22	39	16110	16175	0.1178138528809874
R1	cpdb	0	network_modules	211	TRUE	0.007625315185891984	30	21	3	0.14285714285714285	0.1	REAC:R-HSA-420029	REAC	Tight junction interactions	10916	2510		1	1	30	10886	3	18	27	10868	10916	0.11749798984366094
R1	cpdb	0	network_modules	211	TRUE	0.008877495418110313	23	26	3	0.11538461538461539	0.13043478260869565	GO:0045954	GO:BP	positive regulation of natural killer cell mediated cytotoxicity	16175	11746		1	1	23	16152	3	23	20	16129	16175	0.12135109035153473
R1	cpdb	0	network_modules	212	TRUE	4.787152842873928e-4	84	14	4	0.2857142857142857	0.047619047619047616	KEGG:03083	KEGG	Polycomb repressive complex	8484	220		0	0.5	84	8400	4	10	80	8390	8484	0.11325539106817116
R1	cpdb	0	network_modules	212	TRUE	0.0025122880252617915	22	18	3	0.16666666666666666	0.13636363636363635	GO:0016338	GO:BP	calcium-independent cell-cell adhesion via plasma membrane cell-adhesion molecules	16175	5213		NA	1	22	16153	3	15	19	16138	16175	0.14971050876290892
R1	cpdb	0	network_modules	212	TRUE	0.003264448349888602	87	18	4	0.2222222222222222	0.04597701149425287	REAC:R-HSA-421270	REAC	Cell-cell junction organization	10916	329		0	0.25	87	10829	4	14	83	10815	10916	0.097925997995281
R1	cpdb	0	network_modules	212	TRUE	0.004588347037971318	30	18	3	0.16666666666666666	0.1	REAC:R-HSA-420029	REAC	Tight junction interactions	10916	2510		0.3333333333333333	0.5	30	10886	3	15	27	10871	10916	0.1272504453227571
R1	cpdb	0	network_modules	212	TRUE	0.005099790796476949	153	14	4	0.2857142857142857	0.026143790849673203	KEGG:04514	KEGG	Cell adhesion molecules	8484	315		1	1	153	8331	4	10	149	8321	8484	0.08177963431763084
R1	cpdb	0	network_modules	212	TRUE	0.006136786649401866	102	18	4	0.2222222222222222	0.0392156862745098	REAC:R-HSA-5689603	REAC	UCH proteinases	10916	2615		0.6666666666666666	0.75	102	10814	4	14	98	10800	10916	0.08992163120158835
R1	cpdb	0	network_modules	212	TRUE	0.00951784390500348	114	18	4	0.2222222222222222	0.03508771929824561	REAC:R-HSA-446728	REAC	Cell junction organization	10916	324		1	1	114	10802	4	14	110	10788	10916	0.08466509954597778
R1	cpdb	0	network_modules	213	TRUE	1.8402338307184354e-5	62	3	3	1	0.04838709677419355	KEGG:05321	KEGG	Inflammatory bowel disease	8484	483		0	0.3333333333333333	62	8422	3	0	59	8422	8484	0.21920419923267398
R1	cpdb	0	network_modules	213	TRUE	2.3107855663899115e-5	60	3	3	1	0.05	GO:0032729	GO:BP	positive regulation of type II interferon production	16175	7774		0	0.021739130434782608	60	16115	3	0	57	16115	16175	0.22321238648003008
R1	cpdb	0	network_modules	213	TRUE	2.4546618119665805e-5	57	3	3	1	0.05263157894736842	REAC:R-HSA-447115	REAC	Interleukin-12 family signaling	10916	1235		0	0.3333333333333333	57	10859	3	0	54	10859	10916	0.22884742942275274
R1	cpdb	0	network_modules	213	TRUE	7.933111874327498e-5	90	3	3	1	0.03333333333333333	GO:0032609	GO:BP	type II interferon production	16175	7657		0.022222222222222223	0.06521739130434782	90	16085	3	0	87	16085	16175	0.18208242926735604
R1	cpdb	0	network_modules	213	TRUE	7.933111874327498e-5	90	3	3	1	0.03333333333333333	GO:0032649	GO:BP	regulation of type II interferon production	16175	7696		0.022222222222222223	0.06521739130434782	90	16085	3	0	87	16085	16175	0.18208242926735604
R1	cpdb	0	network_modules	213	TRUE	1.637909389408838e-4	6	3	2	0.6666666666666666	0.3333333333333333	GO:2000330	GO:BP	positive regulation of T-helper 17 cell lineage commitment	16175	25649		0.06666666666666667	0.08695652173913043	6	16169	2	1	4	16168	16175	0.47127333823288325
R1	cpdb	0	network_modules	213	TRUE	3.057178758161412e-4	8	3	2	0.6666666666666666	0.25	GO:2000328	GO:BP	regulation of T-helper 17 cell lineage commitment	16175	25647		0.08888888888888889	0.13043478260869565	8	16167	2	1	6	16166	16175	0.4080841830381798
R1	cpdb	0	network_modules	213	TRUE	3.057178758161412e-4	8	3	2	0.6666666666666666	0.25	GO:0010455	GO:BP	positive regulation of cell fate commitment	16175	4151		0.08888888888888889	0.13043478260869565	8	16167	2	1	6	16166	16175	0.4080841830381798
R1	cpdb	0	network_modules	213	TRUE	3.294716546085134e-4	9	3	2	0.6666666666666666	0.2222222222222222	REAC:R-HSA-9020933	REAC	Interleukin-23 signaling	10916	1244		0.5	0.6666666666666666	9	10907	2	1	7	10906	10916	0.3846355971777174
R1	cpdb	0	network_modules	213	TRUE	3.3842396455348685e-4	162	3	3	1	0.018518518518518517	KEGG:04630	KEGG	JAK-STAT signaling pathway	8484	332		0.5	0.6666666666666666	162	8322	3	0	159	8322	8484	0.1348011025084183
R1	cpdb	0	network_modules	213	TRUE	3.930496337734984e-4	9	3	2	0.6666666666666666	0.2222222222222222	GO:0043382	GO:BP	positive regulation of memory T cell differentiation	16175	10659		0.13333333333333333	0.1956521739130435	9	16166	2	1	7	16165	16175	0.38472164991098856
R1	cpdb	0	network_modules	213	TRUE	3.930496337734984e-4	9	3	2	0.6666666666666666	0.2222222222222222	GO:2000321	GO:BP	positive regulation of T-helper 17 cell differentiation	16175	25643		0.13333333333333333	0.1956521739130435	9	16166	2	1	7	16165	16175	0.38472164991098856
R1	cpdb	0	network_modules	213	TRUE	3.930496337734984e-4	9	3	2	0.6666666666666666	0.2222222222222222	GO:0035722	GO:BP	interleukin-12-mediated signaling pathway	16175	9192		0.13333333333333333	0.1956521739130435	9	16166	2	1	7	16165	16175	0.38472164991098856
R1	cpdb	0	network_modules	213	TRUE	4.912917840149466e-4	10	3	2	0.6666666666666666	0.2	GO:0043379	GO:BP	memory T cell differentiation	16175	10656		0.2	0.2608695652173913	10	16165	2	1	8	16164	16175	0.3649564167636381
R1	cpdb	0	network_modules	213	TRUE	4.912917840149466e-4	10	3	2	0.6666666666666666	0.2	GO:0043380	GO:BP	regulation of memory T cell differentiation	16175	10657		0.2	0.2608695652173913	10	16165	2	1	8	16164	16175	0.3649564167636381
R1	cpdb	0	network_modules	213	TRUE	4.912917840149466e-4	10	3	2	0.6666666666666666	0.2	GO:0090715	GO:BP	immunological memory formation process	16175	18426		0.2	0.2608695652173913	10	16165	2	1	8	16164	16175	0.3649564167636381
R1	cpdb	0	network_modules	213	TRUE	6.004429759936907e-4	11	3	2	0.6666666666666666	0.18181818181818182	GO:0071349	GO:BP	cellular response to interleukin-12	16175	16601		0.26666666666666666	0.30434782608695654	11	16164	2	1	9	16163	16175	0.3479507533206276
R1	cpdb	0	network_modules	213	TRUE	6.004429759936907e-4	11	3	2	0.6666666666666666	0.18181818181818182	GO:0070671	GO:BP	response to interleukin-12	16175	16252		0.26666666666666666	0.30434782608695654	11	16164	2	1	9	16163	16175	0.3479507533206276
R1	cpdb	0	network_modules	213	TRUE	8.514670829758922e-4	13	3	2	0.6666666666666666	0.15384615384615385	GO:0002827	GO:BP	positive regulation of T-helper 1 type immune response	16175	1337		0.3111111111111111	0.34782608695652173	13	16162	2	1	11	16161	16175	0.32002851642455643
R1	cpdb	0	network_modules	213	TRUE	8.514670829758922e-4	13	3	2	0.6666666666666666	0.15384615384615385	GO:0090713	GO:BP	immunological memory process	16175	18424		0.3111111111111111	0.34782608695652173	13	16162	2	1	11	16161	16175	0.32002851642455643
R1	cpdb	0	network_modules	213	TRUE	0.0013097872928090391	16	3	2	0.6666666666666666	0.125	GO:2000318	GO:BP	positive regulation of T-helper 17 type immune response	16175	25640		0.35555555555555557	0.3695652173913043	16	16159	2	1	14	16158	16175	0.2884162244125957
R1	cpdb	0	network_modules	213	TRUE	0.0016698410425584236	18	3	2	0.6666666666666666	0.1111111111111111	GO:0045624	GO:BP	positive regulation of T-helper cell differentiation	16175	11475		0.37777777777777777	0.41304347826086957	18	16157	2	1	16	16156	16175	0.27188774182133574
R1	cpdb	0	network_modules	213	TRUE	0.0016698410425584236	18	3	2	0.6666666666666666	0.1111111111111111	GO:0072540	GO:BP	T-helper 17 cell lineage commitment	16175	17438		0.37777777777777777	0.41304347826086957	18	16157	2	1	16	16156	16175	0.27188774182133574
R1	cpdb	0	network_modules	213	TRUE	0.0018662159487509247	19	3	2	0.6666666666666666	0.10526315789473684	GO:2000319	GO:BP	regulation of T-helper 17 cell differentiation	16175	25641		0.4222222222222222	0.43478260869565216	19	16156	2	1	17	16155	16175	0.26461970208734953
R1	cpdb	0	network_modules	213	TRUE	0.001977830479004981	291	3	3	1	0.010309278350515464	KEGG:04060	KEGG	Cytokine-cytokine receptor interaction	8484	253		1	1	291	8193	3	0	288	8193	8484	0.09979575742282806
R1	cpdb	0	network_modules	213	TRUE	0.0020734877417595598	20	3	2	0.6666666666666666	0.1	GO:0002295	GO:BP	T-helper cell lineage commitment	16175	827		0.4444444444444444	0.5	20	16155	2	1	18	16154	16175	0.25790340281345747
R1	cpdb	0	network_modules	213	TRUE	0.0020734877417595598	20	3	2	0.6666666666666666	0.1	GO:0002825	GO:BP	regulation of T-helper 1 type immune response	16175	1335		0.4444444444444444	0.5	20	16155	2	1	18	16154	16175	0.25790340281345747
R1	cpdb	0	network_modules	213	TRUE	0.0020734877417595598	20	3	2	0.6666666666666666	0.1	GO:0042104	GO:BP	positive regulation of activated T cell proliferation	16175	9969		0.4444444444444444	0.5	20	16155	2	1	18	16154	16175	0.25790340281345747
R1	cpdb	0	network_modules	213	TRUE	0.002760670936214356	23	3	2	0.6666666666666666	0.08695652173913043	GO:0043373	GO:BP	CD4-positive, alpha-beta T cell lineage commitment	16175	10650		0.5111111111111111	0.5434782608695652	23	16152	2	1	21	16151	16175	0.24045145819458102
R1	cpdb	0	network_modules	213	TRUE	0.002760670936214356	23	3	2	0.6666666666666666	0.08695652173913043	GO:0002363	GO:BP	alpha-beta T cell lineage commitment	16175	895		0.5111111111111111	0.5434782608695652	23	16152	2	1	21	16151	16175	0.24045145819458102
R1	cpdb	0	network_modules	213	TRUE	0.003011516771019604	24	3	2	0.6666666666666666	0.08333333333333333	GO:0002360	GO:BP	T cell lineage commitment	16175	892		0.5555555555555556	0.5869565217391305	24	16151	2	1	22	16150	16175	0.23537416597204877
R1	cpdb	0	network_modules	213	TRUE	0.003011516771019604	24	3	2	0.6666666666666666	0.08333333333333333	GO:0043369	GO:BP	CD4-positive or CD8-positive, alpha-beta T cell lineage commitment	16175	10646		0.5555555555555556	0.5869565217391305	24	16151	2	1	22	16150	16175	0.23537416597204877
R1	cpdb	0	network_modules	213	TRUE	0.003545877492329801	26	3	2	0.6666666666666666	0.07692307692307693	GO:2000316	GO:BP	regulation of T-helper 17 type immune response	16175	25638		0.6	0.6086956521739131	26	16149	2	1	24	16148	16175	0.22611214812597225
R1	cpdb	0	network_modules	213	TRUE	0.0038293896777411626	27	3	2	0.6666666666666666	0.07407407407407407	GO:0043372	GO:BP	positive regulation of CD4-positive, alpha-beta T cell differentiation	16175	10649		0.6222222222222222	0.6304347826086957	27	16148	2	1	25	16147	16175	0.22187162332806412
R1	cpdb	0	network_modules	213	TRUE	0.0044290709453424304	29	3	2	0.6666666666666666	0.06896551724137931	GO:0010453	GO:BP	regulation of cell fate commitment	16175	4149		0.6444444444444445	0.6739130434782609	29	16146	2	1	27	16145	16175	0.21405766387249664
R1	cpdb	0	network_modules	213	TRUE	0.0044290709453424304	29	3	2	0.6666666666666666	0.06896551724137931	GO:0072539	GO:BP	T-helper 17 cell differentiation	16175	17437		0.6444444444444445	0.6739130434782609	29	16146	2	1	27	16145	16175	0.21405766387249664
R1	cpdb	0	network_modules	213	TRUE	0.004745237326438741	30	3	2	0.6666666666666666	0.06666666666666667	GO:0042088	GO:BP	T-helper 1 type immune response	16175	9962		0.6888888888888889	0.6956521739130435	30	16145	2	1	28	16144	16175	0.21044674716327783
R1	cpdb	0	network_modules	213	TRUE	0.005072285738336455	31	3	2	0.6666666666666666	0.06451612903225806	GO:0043368	GO:BP	positive T cell selection	16175	10645		0.7111111111111111	0.7391304347826086	31	16144	2	1	29	16143	16175	0.2070117797524927
R1	cpdb	0	network_modules	213	TRUE	0.005072285738336455	31	3	2	0.6666666666666666	0.06451612903225806	GO:0002230	GO:BP	positive regulation of defense response to virus by host	16175	763		0.7111111111111111	0.7391304347826086	31	16144	2	1	29	16143	16175	0.2070117797524927
R1	cpdb	0	network_modules	213	TRUE	0.005759023252348881	33	3	2	0.6666666666666666	0.06060606060606061	GO:0045622	GO:BP	regulation of T-helper cell differentiation	16175	11473		0.7555555555555555	0.8043478260869565	33	16142	2	1	31	16141	16175	0.2006157612716187
R1	cpdb	0	network_modules	213	TRUE	0.005759023252348881	33	3	2	0.6666666666666666	0.06060606060606061	GO:0046006	GO:BP	regulation of activated T cell proliferation	16175	11797		0.7555555555555555	0.8043478260869565	33	16142	2	1	31	16141	16175	0.2006157612716187
R1	cpdb	0	network_modules	213	TRUE	0.005759023252348881	33	3	2	0.6666666666666666	0.06060606060606061	GO:2000516	GO:BP	positive regulation of CD4-positive, alpha-beta T cell activation	16175	25819		0.7555555555555555	0.8043478260869565	33	16142	2	1	31	16141	16175	0.2006157612716187
R1	cpdb	0	network_modules	213	TRUE	0.0061187096533699865	34	3	2	0.6666666666666666	0.058823529411764705	GO:0001916	GO:BP	positive regulation of T cell mediated cytotoxicity	16175	533		0.8222222222222222	0.8478260869565217	34	16141	2	1	32	16140	16175	0.19763124847567545
R1	cpdb	0	network_modules	213	TRUE	0.0061187096533699865	34	3	2	0.6666666666666666	0.058823529411764705	GO:0050798	GO:BP	activated T cell proliferation	16175	13265		0.8222222222222222	0.8478260869565217	34	16141	2	1	32	16140	16175	0.19763124847567545
R1	cpdb	0	network_modules	213	TRUE	0.007263023225931468	37	3	2	0.6666666666666666	0.05405405405405406	GO:0046638	GO:BP	positive regulation of alpha-beta T cell differentiation	16175	12275		0.8666666666666667	0.9130434782608695	37	16138	2	1	35	16137	16175	0.1894145562825279
R1	cpdb	0	network_modules	213	TRUE	0.007263023225931468	37	3	2	0.6666666666666666	0.05405405405405406	GO:0072538	GO:BP	T-helper 17 type immune response	16175	17436		0.8666666666666667	0.9130434782608695	37	16138	2	1	35	16137	16175	0.1894145562825279
R1	cpdb	0	network_modules	213	TRUE	0.007263023225931468	37	3	2	0.6666666666666666	0.05405405405405406	GO:0045058	GO:BP	T cell selection	16175	11256		0.8666666666666667	0.9130434782608695	37	16138	2	1	35	16137	16175	0.1894145562825279
R1	cpdb	0	network_modules	213	TRUE	0.007311455859823412	403	3	3	1	0.007444168734491315	GO:0001819	GO:BP	positive regulation of cytokine production	16175	476		0.9333333333333333	0.9347826086956522	403	15772	3	0	400	15772	16175	0.08520589098498678
R1	cpdb	0	network_modules	213	TRUE	0.00821967697076913	419	3	3	1	0.007159904534606206	GO:0019221	GO:BP	cytokine-mediated signaling pathway	16175	5598		0.9555555555555556	0.9565217391304348	419	15756	3	0	416	15756	16175	0.0835208173211863
R1	cpdb	0	network_modules	213	TRUE	0.008505189991257421	40	3	2	0.6666666666666666	0.05	GO:0050691	GO:BP	regulation of defense response to virus by host	16175	13221		0.9777777777777777	0.9782608695652174	40	16135	2	1	38	16134	16175	0.18213916081693896
R1	cpdb	0	network_modules	213	TRUE	0.00938764604571993	42	3	2	0.6666666666666666	0.047619047619047616	GO:0001914	GO:BP	regulation of T cell mediated cytotoxicity	16175	531		1	1	42	16133	2	1	40	16132	16175	0.17772754548378375
R1	cpdb	0	network_modules	213	TRUE	0.009870327694299876	47	3	2	0.6666666666666666	0.0425531914893617	REAC:R-HSA-9020591	REAC	Interleukin-12 signaling	10916	1236		1	1	47	10869	2	1	45	10868	10916	0.1677270644490913
R1	cpdb	0	network_modules	214	TRUE	3.6268950154475914e-13	175	18	11	0.6111111111111112	0.06285714285714286	KEGG:05152	KEGG	Tuberculosis	8484	440		0	0.09090909090909091	175	8309	11	7	164	8302	8484	0.19156340431716506
R1	cpdb	0	network_modules	214	TRUE	2.4015366740945296e-12	78	25	9	0.36	0.11538461538461539	GO:0032755	GO:BP	positive regulation of interleukin-6 production	16175	7799		0	0.00909090909090909	78	16097	9	16	69	16081	16175	0.2017223415223149
R1	cpdb	0	network_modules	214	TRUE	2.8157872655857286e-11	59	25	8	0.32	0.13559322033898305	GO:0002224	GO:BP	toll-like receptor signaling pathway	16175	758		0.009174311926605505	0.01818181818181818	59	16116	8	17	51	16099	16175	0.20646408830978377
R1	cpdb	0	network_modules	214	TRUE	9.703776754890055e-11	116	25	9	0.36	0.07758620689655173	GO:0032635	GO:BP	interleukin-6 production	16175	7682		0.01834862385321101	0.03636363636363636	116	16059	9	16	107	16043	16175	0.16451419241182969
R1	cpdb	0	network_modules	214	TRUE	9.703776754890055e-11	116	25	9	0.36	0.07758620689655173	GO:0032675	GO:BP	regulation of interleukin-6 production	16175	7721		0.01834862385321101	0.03636363636363636	116	16059	9	16	107	16043	16175	0.16451419241182969
R1	cpdb	0	network_modules	214	TRUE	4.429259963001329e-10	82	25	8	0.32	0.0975609756097561	GO:0032677	GO:BP	regulation of interleukin-8 production	16175	7723		0.03669724770642202	0.05454545454545454	82	16093	8	17	74	16076	16175	0.1744685894152383
R1	cpdb	0	network_modules	214	TRUE	4.429259963001329e-10	82	25	8	0.32	0.0975609756097561	GO:0032637	GO:BP	interleukin-8 production	16175	7684		0.03669724770642202	0.05454545454545454	82	16093	8	17	74	16076	16175	0.1744685894152383
R1	cpdb	0	network_modules	214	TRUE	1.1031326921546962e-9	106	18	8	0.4444444444444444	0.07547169811320754	KEGG:04620	KEGG	Toll-like receptor signaling pathway	8484	325		0.1	0.18181818181818182	106	8378	8	10	98	8368	8484	0.1793116420977446
R1	cpdb	0	network_modules	214	TRUE	1.145888490793591e-9	50	25	7	0.28	0.14	GO:0032655	GO:BP	regulation of interleukin-12 production	16175	7702		0.05504587155963303	0.07272727272727272	50	16125	7	18	43	16107	16175	0.1962591617701741
R1	cpdb	0	network_modules	214	TRUE	1.145888490793591e-9	50	25	7	0.28	0.14	GO:0032615	GO:BP	interleukin-12 production	16175	7663		0.05504587155963303	0.07272727272727272	50	16125	7	18	43	16107	16175	0.1962591617701741
R1	cpdb	0	network_modules	214	TRUE	1.7688492041978288e-9	25	25	6	0.24	0.24	GO:0098581	GO:BP	detection of external biotic stimulus	16175	18798		0.07339449541284404	0.08181818181818182	25	16150	6	19	19	16131	16175	0.23882352941176468
R1	cpdb	0	network_modules	214	TRUE	1.8652061099138978e-9	243	25	10	0.4	0.0411522633744856	GO:0002758	GO:BP	innate immune response-activating signaling pathway	16175	1269		0.08256880733944955	0.09090909090909091	243	15932	10	15	233	15917	16175	0.12451575924088693
R1	cpdb	0	network_modules	214	TRUE	4.102758798529061e-9	263	25	10	0.4	0.03802281368821293	GO:0002218	GO:BP	activation of innate immune response	16175	753		0.09174311926605505	0.1	263	15912	10	15	253	15897	16175	0.11937825520340141
R1	cpdb	0	network_modules	214	TRUE	5.5762318032148855e-9	62	25	7	0.28	0.11290322580645161	GO:0032757	GO:BP	positive regulation of interleukin-8 production	16175	7801		0.10091743119266056	0.10909090909090909	62	16113	7	18	55	16095	16175	0.17583917812194733
R1	cpdb	0	network_modules	214	TRUE	6.4723203412237605e-9	12	25	5	0.2	0.4166666666666667	GO:0032490	GO:BP	detection of molecule of bacterial origin	16175	7601		0.11009174311926606	0.11818181818181818	12	16163	5	20	7	16143	16175	0.2879336595472652
R1	cpdb	0	network_modules	214	TRUE	8.987247355054973e-9	32	25	6	0.24	0.1875	GO:0009595	GO:BP	detection of biotic stimulus	16175	3526		0.11926605504587157	0.12727272727272726	32	16143	6	19	26	16124	16175	0.21075474340617417
R1	cpdb	0	network_modules	214	TRUE	1.3311337339147748e-8	34	25	6	0.24	0.17647058823529413	GO:0032735	GO:BP	positive regulation of interleukin-12 production	16175	7780		0.12844036697247707	0.13636363636363635	34	16141	6	19	28	16122	16175	0.20436857987076248
R1	cpdb	0	network_modules	214	TRUE	2.237648577693994e-8	437	25	11	0.44	0.02517162471395881	GO:0002764	GO:BP	immune response-regulating signaling pathway	16175	1275		0.13761467889908258	0.14545454545454545	437	15738	11	14	426	15724	16175	0.10021776531882233
R1	cpdb	0	network_modules	214	TRUE	2.7793956607578053e-8	319	25	10	0.4	0.03134796238244514	GO:0045089	GO:BP	positive regulation of innate immune response	16175	11272		0.14678899082568808	0.15454545454545454	319	15856	10	15	309	15841	16175	0.10760620319981945
R1	cpdb	0	network_modules	214	TRUE	3.042943239927603e-8	17	21	5	0.23809523809523808	0.29411764705882354	REAC:R-HSA-5602498	REAC	MyD88 deficiency (TLR2/4)	10916	1498		0	0.07692307692307693	17	10899	5	16	12	10883	10916	0.26335555929485016
R1	cpdb	0	network_modules	214	TRUE	3.14212310694612e-8	451	25	11	0.44	0.024390243902439025	GO:0002831	GO:BP	regulation of response to biotic stimulus	16175	1341		0.1559633027522936	0.16363636363636364	451	15724	11	14	440	15710	16175	0.09848708008609387
R1	cpdb	0	network_modules	214	TRUE	3.55488564784774e-8	16	25	5	0.2	0.3125	GO:0034134	GO:BP	toll-like receptor 2 signaling pathway	16175	8442		0.1651376146788991	0.17272727272727273	16	16159	5	20	11	16139	16175	0.24907921360072902
R1	cpdb	0	network_modules	214	TRUE	4.208154639744775e-8	18	21	5	0.23809523809523808	0.2777777777777778	REAC:R-HSA-5603041	REAC	IRAK4 deficiency (TLR2/4)	10916	1158		0.08333333333333333	0.15384615384615385	18	10898	5	16	13	10882	10916	0.25584821590693674
R1	cpdb	0	network_modules	214	TRUE	4.327226477558926e-8	227	25	9	0.36	0.039647577092511016	GO:0002221	GO:BP	pattern recognition receptor signaling pathway	16175	755		0.1743119266055046	0.18181818181818182	227	15948	9	16	218	15932	16175	0.11571653074059343
R1	cpdb	0	network_modules	214	TRUE	5.0614919733800905e-8	339	25	10	0.4	0.029498525073746312	GO:0002833	GO:BP	positive regulation of response to biotic stimulus	16175	1343		0.1834862385321101	0.19090909090909092	339	15836	10	15	329	15821	16175	0.10411000359841924
R1	cpdb	0	network_modules	214	TRUE	5.472134621671238e-8	85	25	7	0.28	0.08235294117647059	GO:0002220	GO:BP	innate immune response activating cell surface receptor signaling pathway	16175	754		0.1926605504587156	0.2	85	16090	7	18	78	16072	16175	0.1495100223347246
R1	cpdb	0	network_modules	214	TRUE	9.434177766954616e-8	19	25	5	0.2	0.2631578947368421	GO:0098543	GO:BP	detection of other organism	16175	18795		0.2018348623853211	0.20909090909090908	19	16156	5	20	14	16136	16175	0.2283789428751201
R1	cpdb	0	network_modules	214	TRUE	1.1931940221469534e-7	164	21	8	0.38095238095238093	0.04878048780487805	REAC:R-HSA-168898	REAC	Toll-like Receptor Cascades	10916	2522		0.16666666666666666	0.23076923076923078	164	10752	8	13	156	10739	10916	0.1320654802632682
R1	cpdb	0	network_modules	214	TRUE	1.8103755448649873e-7	386	25	10	0.4	0.025906735751295335	GO:0045088	GO:BP	regulation of innate immune response	16175	11271		0.21100917431192662	0.21818181818181817	386	15789	10	15	376	15774	16175	0.09696209304048288
R1	cpdb	0	network_modules	214	TRUE	2.2115738601389023e-7	7	25	4	0.16	0.5714285714285714	GO:0070339	GO:BP	response to bacterial lipopeptide	16175	16061		0.22018348623853212	0.24545454545454545	7	16168	4	21	3	16147	16175	0.30185235972088303
R1	cpdb	0	network_modules	214	TRUE	2.2115738601389023e-7	7	25	4	0.16	0.5714285714285714	GO:0071220	GO:BP	cellular response to bacterial lipoprotein	16175	16482		0.22018348623853212	0.24545454545454545	7	16168	4	21	3	16147	16175	0.30185235972088303
R1	cpdb	0	network_modules	214	TRUE	2.2115738601389023e-7	7	25	4	0.16	0.5714285714285714	GO:0071221	GO:BP	cellular response to bacterial lipopeptide	16175	16483		0.22018348623853212	0.24545454545454545	7	16168	4	21	3	16147	16175	0.30185235972088303
R1	cpdb	0	network_modules	214	TRUE	3.761207621365869e-7	416	25	10	0.4	0.02403846153846154	GO:0002757	GO:BP	immune response-activating signaling pathway	16175	1268		0.24770642201834864	0.2545454545454545	416	15759	10	15	406	15744	16175	0.09302831709790445
R1	cpdb	0	network_modules	214	TRUE	4.4185524136196694e-7	8	25	4	0.16	0.5	GO:0032493	GO:BP	response to bacterial lipoprotein	16175	7604		0.25688073394495414	0.2636363636363636	8	16167	4	21	4	16146	16175	0.2822563585533348
R1	cpdb	0	network_modules	214	TRUE	4.4255634785819737e-7	423	25	10	0.4	0.02364066193853428	GO:0031349	GO:BP	positive regulation of defense response	16175	7140		0.26605504587155965	0.2727272727272727	423	15752	10	15	413	15737	16175	0.09216916952216513
R1	cpdb	0	network_modules	214	TRUE	4.826814563009386e-7	60	25	6	0.24	0.1	GO:0140895	GO:BP	cell surface toll-like receptor signaling pathway	16175	19927		0.27522935779816515	0.2818181818181818	60	16115	6	19	54	16096	16175	0.152926815005202
R1	cpdb	0	network_modules	214	TRUE	5.959434093297332e-7	594	25	11	0.44	0.018518518518518517	GO:0006954	GO:BP	inflammatory response	16175	2585		0.28440366972477066	0.2909090909090909	594	15581	11	14	583	15567	16175	0.0843607113675485
R1	cpdb	0	network_modules	214	TRUE	6.897120602147568e-7	30	21	5	0.23809523809523808	0.16666666666666666	REAC:R-HSA-5260271	REAC	Diseases of Immune System	10916	759		0.25	0.38461538461538464	30	10886	5	16	25	10870	10916	0.19736647836308327
R1	cpdb	0	network_modules	214	TRUE	6.897120602147568e-7	30	21	5	0.23809523809523808	0.16666666666666666	REAC:R-HSA-5602358	REAC	Diseases associated with the TLR signaling cascade	10916	753		0.25	0.38461538461538464	30	10886	5	16	25	10870	10916	0.19736647836308327
R1	cpdb	0	network_modules	214	TRUE	9.55385799623929e-7	67	25	6	0.24	0.08955223880597014	GO:0002752	GO:BP	cell surface pattern recognition receptor signaling pathway	16175	1263		0.29357798165137616	0.3	67	16108	6	19	61	16089	16175	0.14448410480150697
R1	cpdb	0	network_modules	214	TRUE	1.188133658903921e-6	634	25	11	0.44	0.017350157728706624	GO:0001817	GO:BP	regulation of cytokine production	16175	474		0.30275229357798167	0.3090909090909091	634	15541	11	14	623	15527	16175	0.0812597821040263
R1	cpdb	0	network_modules	214	TRUE	1.2697681231407743e-6	638	25	11	0.44	0.017241379310344827	GO:0001816	GO:BP	cytokine production	16175	473		0.3119266055045872	0.3181818181818182	638	15537	11	14	627	15523	16175	0.0809650892070403
R1	cpdb	0	network_modules	214	TRUE	1.365058743076011e-6	475	25	10	0.4	0.021052631578947368	GO:0002253	GO:BP	activation of immune response	16175	785		0.3211009174311927	0.32727272727272727	475	15700	10	15	465	15685	16175	0.08637266054572691
R1	cpdb	0	network_modules	214	TRUE	1.488207084301736e-6	72	25	6	0.24	0.08333333333333333	GO:0032602	GO:BP	chemokine production	16175	7650		0.3302752293577982	0.34545454545454546	72	16103	6	19	66	16084	16175	0.13921597457510793
R1	cpdb	0	network_modules	214	TRUE	1.488207084301736e-6	72	25	6	0.24	0.08333333333333333	GO:0032642	GO:BP	regulation of chemokine production	16175	7689		0.3302752293577982	0.34545454545454546	72	16103	6	19	66	16084	16175	0.13921597457510793
R1	cpdb	0	network_modules	214	TRUE	2.839289746701893e-6	80	25	6	0.24	0.075	GO:0032760	GO:BP	positive regulation of tumor necrosis factor production	16175	7804		0.3486238532110092	0.35454545454545455	80	16095	6	19	74	16076	16175	0.13182730373045876
R1	cpdb	0	network_modules	214	TRUE	3.825170726498088e-6	84	25	6	0.24	0.07142857142857142	GO:1903557	GO:BP	positive regulation of tumor necrosis factor superfamily cytokine production	16175	23104		0.3577981651376147	0.36363636363636365	84	16091	6	19	78	16072	16175	0.12853089774531457
R1	cpdb	0	network_modules	214	TRUE	4.004235073568568e-6	531	25	10	0.4	0.018832391713747645	GO:0032103	GO:BP	positive regulation of response to external stimulus	16175	7367		0.3669724770642202	0.37272727272727274	531	15644	10	15	521	15629	16175	0.08107293620982033
R1	cpdb	0	network_modules	214	TRUE	4.599346983586047e-6	721	25	11	0.44	0.015256588072122053	GO:0045087	GO:BP	innate immune response	16175	11270		0.3761467889908257	0.38181818181818183	721	15454	11	14	710	15440	16175	0.07538832771242822
R1	cpdb	0	network_modules	214	TRUE	4.659386443042193e-6	3	25	3	0.12	1	GO:0070340	GO:BP	detection of bacterial lipopeptide	16175	16062		0.3853211009174312	0.39090909090909093	3	16172	3	22	0	16150	16175	0.34617445729716456
R1	cpdb	0	network_modules	214	TRUE	5.153811504867361e-6	56	18	5	0.2777777777777778	0.08928571428571429	KEGG:05134	KEGG	Legionellosis	8484	431		0.2	0.2727272727272727	56	8428	5	13	51	8415	8484	0.1544167983922696
R1	cpdb	0	network_modules	214	TRUE	6.9389716081564465e-6	403	25	9	0.36	0.022332506203473945	GO:0001819	GO:BP	positive regulation of cytokine production	16175	476		0.3944954128440367	0.4	403	15772	9	16	394	15756	16175	0.08458378597079513
R1	cpdb	0	network_modules	214	TRUE	7.553657439688691e-6	756	25	11	0.44	0.01455026455026455	GO:0050776	GO:BP	regulation of immune response	16175	13250		0.4036697247706422	0.4090909090909091	756	15419	11	14	745	15405	16175	0.07330272752187149
R1	cpdb	0	network_modules	214	TRUE	7.949834275872354e-6	172	25	7	0.28	0.040697674418604654	GO:0071216	GO:BP	cellular response to biotic stimulus	16175	16478		0.41284403669724773	0.41818181818181815	172	16003	7	18	165	15985	16175	0.10332522861515998
R1	cpdb	0	network_modules	214	TRUE	1.0475754984724436e-5	105	21	6	0.2857142857142857	0.05714285714285714	REAC:R-HSA-1236975	REAC	Antigen processing-Cross presentation	10916	153		0.4166666666666667	0.46153846153846156	105	10811	6	15	99	10796	10916	0.1241912818554225
R1	cpdb	0	network_modules	214	TRUE	1.059901774992513e-5	287	25	8	0.32	0.027874564459930314	GO:0002768	GO:BP	immune response-regulating cell surface receptor signaling pathway	16175	1279		0.42201834862385323	0.42727272727272725	287	15888	8	17	279	15871	16175	0.09007996615297006
R1	cpdb	0	network_modules	214	TRUE	1.5444242339151144e-5	112	21	6	0.2857142857142857	0.05357142857142857	REAC:R-HSA-166058	REAC	MyD88:MAL(TIRAP) cascade initiated on plasma membrane	10916	1502		0.5	0.6153846153846154	112	10804	6	15	106	10789	10916	0.12000726165172097
R1	cpdb	0	network_modules	214	TRUE	1.5444242339151144e-5	112	21	6	0.2857142857142857	0.05357142857142857	REAC:R-HSA-168188	REAC	Toll Like Receptor TLR6:TLR2 Cascade	10916	2521		0.5	0.6153846153846154	112	10804	6	15	106	10789	10916	0.12000726165172097
R1	cpdb	0	network_modules	214	TRUE	1.8099570627110634e-5	115	21	6	0.2857142857142857	0.05217391304347826	REAC:R-HSA-181438	REAC	Toll Like Receptor 2 (TLR2) Cascade	10916	2514		0.6666666666666666	0.7692307692307693	115	10801	6	15	109	10786	10916	0.11832987385795377
R1	cpdb	0	network_modules	214	TRUE	1.8099570627110634e-5	115	21	6	0.2857142857142857	0.05217391304347826	REAC:R-HSA-168179	REAC	Toll Like Receptor TLR1:TLR2 Cascade	10916	2520		0.6666666666666666	0.7692307692307693	115	10801	6	15	109	10786	10916	0.11832987385795377
R1	cpdb	0	network_modules	214	TRUE	1.8439603369350967e-5	51	25	5	0.2	0.09803921568627451	GO:0032648	GO:BP	regulation of interferon-beta production	16175	7695		0.43119266055045874	0.44545454545454544	51	16124	5	20	46	16104	16175	0.1381450466107242
R1	cpdb	0	network_modules	214	TRUE	1.8439603369350967e-5	51	25	5	0.2	0.09803921568627451	GO:0032608	GO:BP	interferon-beta production	16175	7656		0.43119266055045874	0.44545454545454544	51	16124	5	20	46	16104	16175	0.1381450466107242
R1	cpdb	0	network_modules	214	TRUE	1.861853022027406e-5	4	25	3	0.12	0.75	GO:0042494	GO:BP	detection of bacterial lipoprotein	16175	10222		0.44954128440366975	0.45454545454545453	4	16171	3	22	1	16149	16175	0.29965044535356145
R1	cpdb	0	network_modules	214	TRUE	1.8768427066828177e-5	21	21	4	0.19047619047619047	0.19047619047619047	REAC:R-HSA-5686938	REAC	Regulation of TLR by endogenous ligand	10916	2010		0.8333333333333334	0.8461538461538461	21	10895	4	17	17	10878	10916	0.18891584169234468
R1	cpdb	0	network_modules	214	TRUE	1.9115641141113835e-5	18	25	4	0.16	0.2222222222222222	GO:0002755	GO:BP	MyD88-dependent toll-like receptor signaling pathway	16175	1266		0.45871559633027525	0.4636363636363636	18	16157	4	21	14	16136	16175	0.1874995584348584
R1	cpdb	0	network_modules	214	TRUE	1.9632995371056077e-5	110	25	6	0.24	0.05454545454545454	GO:0032606	GO:BP	type I interferon production	16175	7654		0.46788990825688076	0.4818181818181818	110	16065	6	19	104	16046	16175	0.11163971459324909
R1	cpdb	0	network_modules	214	TRUE	1.9632995371056077e-5	110	25	6	0.24	0.05454545454545454	GO:0032479	GO:BP	regulation of type I interferon production	16175	7590		0.46788990825688076	0.4818181818181818	110	16065	6	19	104	16046	16175	0.11163971459324909
R1	cpdb	0	network_modules	214	TRUE	1.9667498071723456e-5	627	25	10	0.4	0.01594896331738437	GO:0050778	GO:BP	positive regulation of immune response	16175	13252		0.48623853211009177	0.4909090909090909	627	15548	10	15	617	15533	16175	0.07362894724299786
R1	cpdb	0	network_modules	214	TRUE	2.349614586044044e-5	147	18	6	0.3333333333333333	0.04081632653061224	KEGG:04145	KEGG	Phagosome	8484	281		0.3	0.36363636363636365	147	8337	6	12	141	8325	8484	0.11166841871635393
R1	cpdb	0	network_modules	214	TRUE	2.5073067889452637e-5	203	25	7	0.28	0.034482758620689655	GO:0002237	GO:BP	response to molecule of bacterial origin	16175	770		0.4954128440366973	0.5	203	15972	7	18	196	15954	16175	0.09452410770847712
R1	cpdb	0	network_modules	214	TRUE	2.9372340108396845e-5	654	25	10	0.4	0.01529051987767584	GO:0031347	GO:BP	regulation of defense response	16175	7138		0.5045871559633027	0.509090909090909	654	15521	10	15	644	15506	16175	0.07182231762944127
R1	cpdb	0	network_modules	214	TRUE	2.9830331335614355e-5	56	25	5	0.2	0.08928571428571429	GO:0032722	GO:BP	positive regulation of chemokine production	16175	7767		0.5137614678899083	0.5181818181818182	56	16119	5	20	51	16099	16175	0.13164707305720283
R1	cpdb	0	network_modules	214	TRUE	4.247514540606656e-5	60	25	5	0.2	0.08333333333333333	GO:0032729	GO:BP	positive regulation of type II interferon production	16175	7774		0.5229357798165137	0.5272727272727272	60	16115	5	20	55	16095	16175	0.12703889001609533
R1	cpdb	0	network_modules	214	TRUE	4.8817876505428104e-5	128	25	6	0.24	0.046875	GO:0032680	GO:BP	regulation of tumor necrosis factor production	16175	7726		0.5321100917431193	0.5454545454545454	128	16047	6	19	122	16028	16175	0.10305666830726631
R1	cpdb	0	network_modules	214	TRUE	4.8817876505428104e-5	128	25	6	0.24	0.046875	GO:0032640	GO:BP	tumor necrosis factor production	16175	7687		0.5321100917431193	0.5454545454545454	128	16047	6	19	122	16028	16175	0.10305666830726631
R1	cpdb	0	network_modules	214	TRUE	5.367998242797634e-5	89	18	5	0.2777777777777778	0.056179775280898875	KEGG:05235	KEGG	PD-L1 expression and PD-1 checkpoint pathway in cancer	8484	480		0.4	0.45454545454545453	89	8395	5	13	84	8382	8484	0.12096813447227421
R1	cpdb	0	network_modules	214	TRUE	5.502988534246868e-5	23	25	4	0.16	0.17391304347826086	GO:0032727	GO:BP	positive regulation of interferon-alpha production	16175	7772		0.5504587155963303	0.5545454545454546	23	16152	4	21	19	16131	16175	0.16557472388135833
R1	cpdb	0	network_modules	214	TRUE	6.140455274736984e-5	133	25	6	0.24	0.045112781954887216	GO:0071706	GO:BP	tumor necrosis factor superfamily cytokine production	16175	16870		0.5596330275229358	0.5727272727272728	133	16042	6	19	127	16023	16175	0.1009820318715038
R1	cpdb	0	network_modules	214	TRUE	6.140455274736984e-5	133	25	6	0.24	0.045112781954887216	GO:1903555	GO:BP	regulation of tumor necrosis factor superfamily cytokine production	16175	23102		0.5596330275229358	0.5727272727272728	133	16042	6	19	127	16023	16175	0.1009820318715038
R1	cpdb	0	network_modules	214	TRUE	6.6448086970293e-5	143	21	6	0.2857142857142857	0.04195804195804196	REAC:R-HSA-166016	REAC	Toll Like Receptor 4 (TLR4) Cascade	10916	2516		0.9166666666666666	0.9230769230769231	143	10773	6	15	137	10758	10916	0.10526203463024567
R1	cpdb	0	network_modules	214	TRUE	6.907477100179471e-5	66	25	5	0.2	0.07575757575757576	GO:0032481	GO:BP	positive regulation of type I interferon production	16175	7592		0.5779816513761468	0.5818181818181818	66	16109	5	20	61	16089	16175	0.12092044079752956
R1	cpdb	0	network_modules	214	TRUE	1.0086866993361844e-4	101	18	5	0.2777777777777778	0.04950495049504951	KEGG:05142	KEGG	Chagas disease	8484	434		0.5	0.5454545454545454	101	8383	5	13	96	8370	8484	0.11303465738539356
R1	cpdb	0	network_modules	214	TRUE	1.209416844033359e-4	149	25	6	0.24	0.040268456375838924	GO:0002753	GO:BP	cytoplasmic pattern recognition receptor signaling pathway	16175	1264		0.5871559633027523	0.5909090909090909	149	16026	6	19	143	16007	16175	0.09504647779068645
R1	cpdb	0	network_modules	214	TRUE	1.2658331460761645e-4	28	25	4	0.16	0.14285714285714285	GO:0032647	GO:BP	regulation of interferon-alpha production	16175	7694		0.5963302752293578	0.6090909090909091	28	16147	4	21	24	16126	16175	0.14979550036812672
R1	cpdb	0	network_modules	214	TRUE	1.2658331460761645e-4	28	25	4	0.16	0.14285714285714285	GO:0032607	GO:BP	interferon-alpha production	16175	7655		0.5963302752293578	0.6090909090909091	28	16147	4	21	24	16126	16175	0.14979550036812672
R1	cpdb	0	network_modules	214	TRUE	1.3617121179492823e-4	152	25	6	0.24	0.039473684210526314	GO:0071219	GO:BP	cellular response to molecule of bacterial origin	16175	16481		0.6146788990825688	0.6181818181818182	152	16023	6	19	146	16004	16175	0.09403702096622818
R1	cpdb	0	network_modules	214	TRUE	1.5620431716921858e-4	265	25	7	0.28	0.026415094339622643	GO:0002429	GO:BP	immune response-activating cell surface receptor signaling pathway	16175	952		0.6238532110091743	0.6272727272727273	265	15910	7	18	258	15892	16175	0.08170392311671036
R1	cpdb	0	network_modules	214	TRUE	1.9392140684227816e-4	31	25	4	0.16	0.12903225806451613	GO:0032733	GO:BP	positive regulation of interleukin-10 production	16175	7778		0.6330275229357798	0.6363636363636364	31	16144	4	21	27	16123	16175	0.14220931603669823
R1	cpdb	0	network_modules	214	TRUE	1.9762822118645282e-4	90	21	5	0.23809523809523808	0.05555555555555555	REAC:R-HSA-1236974	REAC	ER-Phagosome pathway	10916	824		1	1	90	10826	5	16	85	10810	10916	0.1115962671365758
R1	cpdb	0	network_modules	214	TRUE	2.2726701988508494e-4	280	25	7	0.28	0.025	GO:0007249	GO:BP	canonical NF-kappaB signal transduction	16175	2783		0.6422018348623854	0.6454545454545455	280	15895	7	18	273	15877	16175	0.07924305136279707
R1	cpdb	0	network_modules	214	TRUE	3.313721382774635e-4	90	25	5	0.2	0.05555555555555555	GO:0032609	GO:BP	type II interferon production	16175	7657		0.6513761467889908	0.6636363636363637	90	16085	5	20	85	16065	16175	0.10284249480792548
R1	cpdb	0	network_modules	214	TRUE	3.313721382774635e-4	90	25	5	0.2	0.05555555555555555	GO:0032649	GO:BP	regulation of type II interferon production	16175	7696		0.6513761467889908	0.6636363636363637	90	16085	5	20	85	16065	16175	0.10284249480792548
R1	cpdb	0	network_modules	214	TRUE	4.5071196806965673e-4	62	18	4	0.2222222222222222	0.06451612903225806	KEGG:05321	KEGG	Inflammatory bowel disease	8484	483		0.6	0.6363636363636364	62	8422	4	14	58	8408	8484	0.11634821607798972
R1	cpdb	0	network_modules	214	TRUE	4.5162911789245073e-4	38	25	4	0.16	0.10526315789473684	GO:0032728	GO:BP	positive regulation of interferon-beta production	16175	7773		0.6697247706422018	0.6727272727272727	38	16137	4	21	34	16116	16175	0.12812111915467386
R1	cpdb	0	network_modules	214	TRUE	5.107758612347687e-4	249	18	6	0.3333333333333333	0.024096385542168676	KEGG:05132	KEGG	Salmonella infection	8484	429		0.7	0.7272727272727273	249	8235	6	12	243	8223	8484	0.08304566886223305
R1	cpdb	0	network_modules	214	TRUE	5.260278289440563e-4	191	25	6	0.24	0.031413612565445025	GO:0009593	GO:BP	detection of chemical stimulus	16175	3524		0.6788990825688074	0.6818181818181818	191	15984	6	19	185	15965	16175	0.08311288680022326
R1	cpdb	0	network_modules	214	TRUE	6.176799149104499e-4	41	25	4	0.16	0.0975609756097561	GO:0140894	GO:BP	endolysosomal toll-like receptor signaling pathway	16175	19926		0.6880733944954128	0.6909090909090909	41	16134	4	21	37	16113	16175	0.12321107061738303
R1	cpdb	0	network_modules	214	TRUE	7.62546401250899e-4	11	25	3	0.12	0.2727272727272727	GO:0034135	GO:BP	regulation of toll-like receptor 2 signaling pathway	16175	8443		0.6972477064220184	0.7	11	16164	3	22	8	16142	16175	0.18008199221677743
R1	cpdb	0	network_modules	214	TRUE	9.04999060622818e-4	45	25	4	0.16	0.08888888888888889	GO:0032613	GO:BP	interleukin-10 production	16175	7661		0.7064220183486238	0.7181818181818181	45	16130	4	21	41	16109	16175	0.11743746299480184
R1	cpdb	0	network_modules	214	TRUE	9.04999060622818e-4	45	25	4	0.16	0.08888888888888889	GO:0032653	GO:BP	regulation of interleukin-10 production	16175	7700		0.7064220183486238	0.7181818181818181	45	16130	4	21	41	16109	16175	0.11743746299480184
R1	cpdb	0	network_modules	214	TRUE	0.001081142484452315	47	25	4	0.16	0.0851063829787234	GO:1900015	GO:BP	regulation of cytokine production involved in inflammatory response	16175	20326		0.7247706422018348	0.7363636363636363	47	16128	4	21	43	16107	16175	0.1148283752051561
R1	cpdb	0	network_modules	214	TRUE	0.001081142484452315	47	25	4	0.16	0.0851063829787234	GO:0002534	GO:BP	cytokine production involved in inflammatory response	16175	1056		0.7247706422018348	0.7363636363636363	47	16128	4	21	43	16107	16175	0.1148283752051561
R1	cpdb	0	network_modules	214	TRUE	0.001638978477584706	124	25	5	0.2	0.04032258064516129	GO:0051092	GO:BP	positive regulation of NF-kappaB transcription factor activity	16175	13487		0.7431192660550459	0.7454545454545455	124	16051	5	20	119	16031	16175	0.08676046323636018
R1	cpdb	0	network_modules	214	TRUE	0.0021113913984195484	188	18	5	0.2777777777777778	0.026595744680851064	KEGG:04613	KEGG	Neutrophil extracellular trap formation	8484	323		0.8	0.8181818181818182	188	8296	5	13	183	8283	8484	0.0800712536898876
R1	cpdb	0	network_modules	214	TRUE	0.0022055561037404407	56	25	4	0.16	0.07142857142857142	GO:0032731	GO:BP	positive regulation of interleukin-1 beta production	16175	7776		0.7522935779816514	0.7545454545454545	56	16119	4	21	52	16098	16175	0.10485384994678754
R1	cpdb	0	network_modules	214	TRUE	0.0025748630171493763	16	25	3	0.12	0.1875	GO:0016045	GO:BP	detection of bacterium	16175	5078		0.7614678899082569	0.7636363636363637	16	16159	3	22	13	16137	16175	0.14895231009052606
R1	cpdb	0	network_modules	214	TRUE	0.003276358997535711	2	25	2	0.08	1	GO:0038124	GO:BP	toll-like receptor TLR6:TLR2 signaling pathway	16175	9715		0.7706422018348624	0.8090909090909091	2	16173	2	23	0	16150	16175	0.282641522315189
R1	cpdb	0	network_modules	214	TRUE	0.003276358997535711	2	25	2	0.08	1	GO:1903974	GO:BP	positive regulation of cellular response to macrophage colony-stimulating factor stimulus	16175	23431		0.7706422018348624	0.8090909090909091	2	16173	2	23	0	16150	16175	0.282641522315189
R1	cpdb	0	network_modules	214	TRUE	0.003276358997535711	2	25	2	0.08	1	GO:0042496	GO:BP	detection of diacyl bacterial lipopeptide	16175	10224		0.7706422018348624	0.8090909090909091	2	16173	2	23	0	16150	16175	0.282641522315189
R1	cpdb	0	network_modules	214	TRUE	0.003276358997535711	2	25	2	0.08	1	GO:1903971	GO:BP	positive regulation of response to macrophage colony-stimulating factor	16175	23428		0.7706422018348624	0.8090909090909091	2	16173	2	23	0	16150	16175	0.282641522315189
R1	cpdb	0	network_modules	214	TRUE	0.003276358997535711	2	25	2	0.08	1	GO:0042495	GO:BP	detection of triacyl bacterial lipopeptide	16175	10223		0.7706422018348624	0.8090909090909091	2	16173	2	23	0	16150	16175	0.282641522315189
R1	cpdb	0	network_modules	214	TRUE	0.0033289929325452587	62	25	4	0.16	0.06451612903225806	GO:0062208	GO:BP	positive regulation of pattern recognition receptor signaling pathway	16175	15864		0.8165137614678899	0.8272727272727273	62	16113	4	21	58	16092	16175	0.09943357151019452
R1	cpdb	0	network_modules	214	TRUE	0.0033289929325452587	62	25	4	0.16	0.06451612903225806	GO:0002532	GO:BP	production of molecular mediator involved in inflammatory response	16175	1054		0.8165137614678899	0.8272727272727273	62	16113	4	21	58	16092	16175	0.09943357151019452
R1	cpdb	0	network_modules	214	TRUE	0.0035234720842386106	421	25	7	0.28	0.0166270783847981	GO:0002694	GO:BP	regulation of leukocyte activation	16175	1212		0.8348623853211009	0.8363636363636363	421	15754	7	18	414	15736	16175	0.06275924458135652
R1	cpdb	0	network_modules	214	TRUE	0.0035509927577732107	63	25	4	0.16	0.06349206349206349	GO:0032732	GO:BP	positive regulation of interleukin-1 production	16175	7777		0.8440366972477065	0.8454545454545455	63	16112	4	21	59	16091	16175	0.09860526898133012
R1	cpdb	0	network_modules	214	TRUE	0.003670670552439521	146	25	5	0.2	0.03424657534246575	GO:0062207	GO:BP	regulation of pattern recognition receptor signaling pathway	16175	15863		0.8532110091743119	0.8545454545454545	146	16029	5	20	141	16009	16175	0.07944599469750675
R1	cpdb	0	network_modules	214	TRUE	0.0037442930207189206	18	25	3	0.12	0.16666666666666666	GO:0043032	GO:BP	positive regulation of macrophage activation	16175	10487		0.8623853211009175	0.8636363636363636	18	16157	3	22	15	16135	16175	0.14029636220631622
R1	cpdb	0	network_modules	214	TRUE	0.003927189084008848	214	18	5	0.2777777777777778	0.02336448598130841	KEGG:05417	KEGG	Lipid and atherosclerosis	8484	494		0.9	0.9090909090909091	214	8270	5	13	209	8257	8484	0.07426635212380818
R1	cpdb	0	network_modules	214	TRUE	0.0044092134829797095	275	25	6	0.24	0.02181818181818182	GO:0002696	GO:BP	positive regulation of leukocyte activation	16175	1214		0.8715596330275229	0.8727272727272727	275	15900	6	19	269	15881	16175	0.06786798797896537
R1	cpdb	0	network_modules	214	TRUE	0.00444181271442159	19	25	3	0.12	0.15789473684210525	GO:1900017	GO:BP	positive regulation of cytokine production involved in inflammatory response	16175	20328		0.8807339449541285	0.8818181818181818	19	16156	3	22	16	16134	16175	0.13648766424315323
R1	cpdb	0	network_modules	214	TRUE	0.004936759340415415	443	25	7	0.28	0.01580135440180587	GO:0009617	GO:BP	response to bacterium	16175	3543		0.8899082568807339	0.8909090909090909	443	15732	7	18	436	15714	16175	0.06089593055157679
R1	cpdb	0	network_modules	214	TRUE	0.0059892261424218775	290	25	6	0.24	0.020689655172413793	GO:0050867	GO:BP	positive regulation of cell activation	16175	13315		0.8990825688073395	0.9	290	15885	6	19	284	15866	16175	0.0658457062907517
R1	cpdb	0	network_modules	214	TRUE	0.00687013786657229	297	25	6	0.24	0.020202020202020204	GO:0051606	GO:BP	detection of stimulus	16175	13822		0.908256880733945	0.9090909090909091	297	15878	6	19	291	15859	16175	0.06495263549481047
R1	cpdb	0	network_modules	214	TRUE	0.0070905435563991745	468	25	7	0.28	0.014957264957264958	GO:0050865	GO:BP	regulation of cell activation	16175	13313		0.9174311926605505	0.9181818181818182	468	15707	7	18	461	15689	16175	0.05893145747755121
R1	cpdb	0	network_modules	214	TRUE	0.007561831477602128	302	25	6	0.24	0.019867549668874173	GO:0030522	GO:BP	intracellular receptor signaling pathway	16175	6836		0.926605504587156	0.9272727272727272	302	15873	6	19	296	15854	16175	0.06433299762841702
R1	cpdb	0	network_modules	214	TRUE	0.008549401343483606	49	18	3	0.16666666666666666	0.061224489795918366	KEGG:05144	KEGG	Malaria	8484	436		1	1	49	8435	3	15	46	8420	8484	0.09790146448991008
R1	cpdb	0	network_modules	214	TRUE	0.008809191312596065	79	25	4	0.16	0.05063291139240506	GO:0042116	GO:BP	macrophage activation	16175	9972		0.9357798165137615	0.9363636363636364	79	16096	4	21	75	16075	16175	0.08754107491124559
R1	cpdb	0	network_modules	214	TRUE	0.00938447996374264	699	25	8	0.32	0.011444921316165951	GO:0045321	GO:BP	leukocyte activation	16175	11356		0.944954128440367	0.9454545454545454	699	15476	8	17	691	15459	16175	0.05355535309399728
R1	cpdb	0	network_modules	214	TRUE	0.009734269564140235	81	25	4	0.16	0.04938271604938271	GO:0032651	GO:BP	regulation of interleukin-1 beta production	16175	7698		0.9541284403669725	0.9636363636363636	81	16094	4	21	77	16073	16175	0.08639001850379645
R1	cpdb	0	network_modules	214	TRUE	0.009734269564140235	81	25	4	0.16	0.04938271604938271	GO:0032611	GO:BP	interleukin-1 beta production	16175	7659		0.9541284403669725	0.9636363636363636	81	16094	4	21	77	16073	16175	0.08639001850379645
R1	cpdb	0	network_modules	214	TRUE	0.009819758219721055	3	25	2	0.08	0.6666666666666666	GO:0071725	GO:BP	response to triacyl bacterial lipopeptide	16175	16885		0.9724770642201835	1	3	16172	2	23	1	16149	16175	0.23060434694047444
R1	cpdb	0	network_modules	214	TRUE	0.009819758219721055	3	25	2	0.08	0.6666666666666666	GO:0016046	GO:BP	detection of fungus	16175	5079		0.9724770642201835	1	3	16172	2	23	1	16149	16175	0.23060434694047444
R1	cpdb	0	network_modules	214	TRUE	0.009819758219721055	3	25	2	0.08	0.6666666666666666	GO:1904466	GO:BP	positive regulation of matrix metallopeptidase secretion	16175	23844		0.9724770642201835	1	3	16172	2	23	1	16149	16175	0.23060434694047444
R1	cpdb	0	network_modules	214	TRUE	0.009819758219721055	3	25	2	0.08	0.6666666666666666	GO:0071727	GO:BP	cellular response to triacyl bacterial lipopeptide	16175	16887		0.9724770642201835	1	3	16172	2	23	1	16149	16175	0.23060434694047444
R1	cpdb	0	network_modules	215	TRUE	9.631869283817229e-6	18	21	4	0.19047619047619047	0.2222222222222222	REAC:R-HSA-1912420	REAC	Pre-NOTCH Processing in Golgi	10916	1784		0	0.16666666666666666	18	10898	4	17	14	10881	10916	0.20432172011637328
R1	cpdb	0	network_modules	215	TRUE	1.9371775986899965e-5	5	21	3	0.14285714285714285	0.6	REAC:R-HSA-5083630	REAC	Defective LFNG causes SCDO3	10916	575		0.2	0.3333333333333333	5	10911	3	18	2	10893	10916	0.29217935115695076
R1	cpdb	0	network_modules	215	TRUE	2.772034786580535e-5	61	21	5	0.23809523809523808	0.08196721311475409	REAC:R-HSA-198725	REAC	Nuclear Events (kinase and transcription factor activation)	10916	1614		0.4	0.5	61	10855	5	16	56	10839	10916	0.1369354725299394
R1	cpdb	0	network_modules	215	TRUE	2.5220278333946456e-4	39	21	4	0.19047619047619047	0.10256410256410256	REAC:R-HSA-9031628	REAC	NGF-stimulated transcription	10916	1527		0.6	0.6666666666666666	39	10877	4	17	35	10860	10916	0.13752764767893022
R1	cpdb	0	network_modules	215	TRUE	2.7904078941657794e-4	7	28	3	0.10714285714285714	0.42857142857142855	GO:0002315	GO:BP	marginal zone B cell differentiation	16175	847		0	0.2	7	16168	3	25	4	16143	16175	0.2136513790804247
R1	cpdb	0	network_modules	215	TRUE	3.0736319090737287e-4	60	17	4	0.23529411764705882	0.06666666666666667	KEGG:04330	KEGG	Notch signaling pathway	8484	301		NA	1	60	8424	4	13	56	8411	8484	0.12203460753669139
R1	cpdb	0	network_modules	215	TRUE	5.871771194418306e-4	112	21	5	0.23809523809523808	0.044642857142857144	REAC:R-HSA-187037	REAC	Signaling by NTRK1 (TRKA)	10916	2284		0.8	0.8333333333333334	112	10804	5	16	107	10788	10916	0.09926104240380848
R1	cpdb	0	network_modules	215	TRUE	0.0012725159383169288	131	21	5	0.23809523809523808	0.03816793893129771	REAC:R-HSA-166520	REAC	Signaling by NTRKs	10916	2287		1	1	131	10785	5	16	126	10769	10916	0.09115990047099551
R1	cpdb	0	network_modules	215	TRUE	0.0018975492858337613	109	28	5	0.17857142857142858	0.045871559633027525	GO:0007219	GO:BP	Notch signaling pathway	16175	2773		0.25	0.6	109	16066	5	23	104	16043	16175	0.0874612942675081
R1	cpdb	0	network_modules	215	TRUE	0.0018975492858337613	109	28	5	0.17857142857142858	0.045871559633027525	GO:0030183	GO:BP	B cell differentiation	16175	6700		0.25	0.6	109	16066	5	23	104	16043	16175	0.0874612942675081
R1	cpdb	0	network_modules	215	TRUE	0.006423166935591639	18	28	3	0.10714285714285714	0.16666666666666666	GO:0002313	GO:BP	mature B cell differentiation involved in immune response	16175	845		0.75	0.8	18	16157	3	25	15	16132	16175	0.13243099629359648
R1	cpdb	0	network_modules	215	TRUE	0.00761867105046191	19	28	3	0.10714285714285714	0.15789473684210525	GO:0002335	GO:BP	mature B cell differentiation	16175	867		1	1	19	16156	3	25	16	16131	16175	0.1288276952064913
R1	cpdb	0	network_modules	216	TRUE	3.0751062734680614e-13	158	25	11	0.44	0.06962025316455696	GO:0050851	GO:BP	antigen receptor-mediated signaling pathway	16175	13299		0	0.041666666666666664	158	16017	11	14	147	16003	16175	0.17211211688963
R1	cpdb	0	network_modules	216	TRUE	8.265183997940391e-11	114	25	9	0.36	0.07894736842105263	GO:0050852	GO:BP	T cell receptor signaling pathway	16175	13300		0.043478260869565216	0.08333333333333333	114	16061	9	16	105	16045	16175	0.16599884538601153
R1	cpdb	0	network_modules	216	TRUE	9.645746126779365e-11	265	25	11	0.44	0.04150943396226415	GO:0002429	GO:BP	immune response-activating cell surface receptor signaling pathway	16175	952		0.08695652173913043	0.125	265	15910	11	14	254	15896	16175	0.1312934524380158
R1	cpdb	0	network_modules	216	TRUE	2.3159480019601384e-10	287	25	11	0.44	0.03832752613240418	GO:0002768	GO:BP	immune response-regulating cell surface receptor signaling pathway	16175	1279		0.13043478260869565	0.16666666666666666	287	15888	11	14	276	15874	16175	0.1258429471926336
R1	cpdb	0	network_modules	216	TRUE	1.3155845553934415e-8	416	25	11	0.44	0.026442307692307692	GO:0002757	GO:BP	immune response-activating signaling pathway	16175	1268		0.17391304347826086	0.20833333333333334	416	15759	11	14	405	15745	16175	0.10297039195128142
R1	cpdb	0	network_modules	216	TRUE	1.3292370914758323e-8	119	21	8	0.38095238095238093	0.06722689075630252	KEGG:04660	KEGG	T cell receptor signaling pathway	8484	338		0	0.1	119	8365	8	13	111	8352	8484	0.1554247381135681
R1	cpdb	0	network_modules	216	TRUE	2.237648577693994e-8	437	25	11	0.44	0.02517162471395881	GO:0002764	GO:BP	immune response-regulating signaling pathway	16175	1275		0.21739130434782608	0.25	437	15738	11	14	426	15724	16175	0.10021776531882233
R1	cpdb	0	network_modules	216	TRUE	5.484703732522876e-8	475	25	11	0.44	0.023157894736842106	GO:0002253	GO:BP	activation of immune response	16175	785		0.2608695652173913	0.2916666666666667	475	15700	11	14	464	15686	16175	0.09569428045783455
R1	cpdb	0	network_modules	216	TRUE	3.7747108578591525e-7	569	25	11	0.44	0.019332161687170474	GO:0046649	GO:BP	lymphocyte activation	16175	12286		0.30434782608695654	0.3333333333333333	569	15606	11	14	558	15592	16175	0.08645507208824856
R1	cpdb	0	network_modules	216	TRUE	4.4185524136196694e-7	8	25	4	0.16	0.5	GO:0045059	GO:BP	positive thymic T cell selection	16175	11257		0.34782608695652173	0.375	8	16167	4	21	4	16146	16175	0.2822563585533348
R1	cpdb	0	network_modules	216	TRUE	7.588843512848702e-7	124	21	7	0.3333333333333333	0.056451612903225805	KEGG:04650	KEGG	Natural killer cell mediated cytotoxicity	8484	334		0.1111111111111111	0.2	124	8360	7	14	117	8346	8484	0.13229401067760532
R1	cpdb	0	network_modules	216	TRUE	1.0565613190425104e-6	627	25	11	0.44	0.017543859649122806	GO:0050778	GO:BP	positive regulation of immune response	16175	13252		0.391304347826087	0.4166666666666667	627	15548	11	14	616	15534	16175	0.08178193866285403
R1	cpdb	0	network_modules	216	TRUE	1.3374831211903217e-6	334	25	9	0.36	0.02694610778443114	GO:0002250	GO:BP	adaptive immune response	16175	782		0.43478260869565216	0.4583333333333333	334	15841	9	16	325	15825	16175	0.09388850880743721
R1	cpdb	0	network_modules	216	TRUE	1.4834599862067889e-6	37	21	5	0.23809523809523808	0.13513513513513514	KEGG:05340	KEGG	Primary immunodeficiency	8484	488		0.2222222222222222	0.3	37	8447	5	16	32	8431	8484	0.17669248634867066
R1	cpdb	0	network_modules	216	TRUE	2.0765461649207186e-6	11	25	4	0.16	0.36363636363636365	GO:0045061	GO:BP	thymic T cell selection	16175	11259		0.4782608695652174	0.5	11	16164	4	21	7	16143	16175	0.2404514476386712
R1	cpdb	0	network_modules	216	TRUE	3.159418725993219e-6	35	24	5	0.20833333333333334	0.14285714285714285	REAC:R-HSA-202433	REAC	Generation of second messenger molecules	10916	1044		0	0.14285714285714285	35	10881	5	19	30	10862	10916	0.17032162720679644
R1	cpdb	0	network_modules	216	TRUE	3.3225694749797183e-6	699	25	11	0.44	0.015736766809728183	GO:0045321	GO:BP	leukocyte activation	16175	11356		0.5217391304347826	0.5416666666666666	699	15476	11	14	688	15462	16175	0.07677423635409304
R1	cpdb	0	network_modules	216	TRUE	3.4589646035220064e-6	89	21	6	0.2857142857142857	0.06741573033707865	KEGG:05235	KEGG	PD-L1 expression and PD-1 checkpoint pathway in cancer	8484	480		0.3333333333333333	0.5	89	8395	6	15	83	8380	8484	0.1345640371653758
R1	cpdb	0	network_modules	216	TRUE	3.4589646035220064e-6	89	21	6	0.2857142857142857	0.06741573033707865	KEGG:04658	KEGG	Th1 and Th2 cell differentiation	8484	336		0.3333333333333333	0.5	89	8395	6	15	83	8380	8484	0.1345640371653758
R1	cpdb	0	network_modules	216	TRUE	7.402728038264503e-6	406	25	9	0.36	0.022167487684729065	GO:0042110	GO:BP	T cell activation	16175	9970		0.5652173913043478	0.5833333333333334	406	15769	9	16	397	15753	16175	0.08423207186598271
R1	cpdb	0	network_modules	216	TRUE	7.553657439688691e-6	756	25	11	0.44	0.01455026455026455	GO:0050776	GO:BP	regulation of immune response	16175	13250		0.6086956521739131	0.625	756	15419	11	14	745	15405	16175	0.07330272752187149
R1	cpdb	0	network_modules	216	TRUE	9.348132943149e-6	105	21	6	0.2857142857142857	0.05714285714285714	KEGG:04659	KEGG	Th17 cell differentiation	8484	337		0.5555555555555556	0.6	105	8379	6	15	99	8364	8484	0.12315654046234394
R1	cpdb	0	network_modules	216	TRUE	2.6249262121104477e-5	20	24	4	0.16666666666666666	0.2	REAC:R-HSA-202430	REAC	Translocation of ZAP-70 to Immunological synapse	10916	2579		0.16666666666666666	0.2857142857142857	20	10896	4	20	16	10876	10916	0.18093179213255337
R1	cpdb	0	network_modules	216	TRUE	5.5003547083340464e-5	120	24	6	0.25	0.05	REAC:R-HSA-202403	REAC	TCR signaling	10916	2422		0.3333333333333333	0.42857142857142855	120	10796	6	18	114	10778	10916	0.10759790679237985
R1	cpdb	0	network_modules	216	TRUE	1.5344084552173598e-4	92	21	5	0.23809523809523808	0.05434782608695652	KEGG:04640	KEGG	Hematopoietic cell lineage	8484	333		0.6666666666666666	0.7	92	8392	5	16	87	8376	8484	0.10930193620480814
R1	cpdb	0	network_modules	216	TRUE	1.9392140684227816e-4	31	25	4	0.16	0.12903225806451613	GO:0043368	GO:BP	positive T cell selection	16175	10645		0.6521739130434783	0.6666666666666666	31	16144	4	21	27	16123	16175	0.14220931603669823
R1	cpdb	0	network_modules	216	TRUE	2.7749857540370227e-4	35	24	4	0.16666666666666666	0.11428571428571428	REAC:R-HSA-114604	REAC	GPVI-mediated activation cascade	10916	1021		0.5	0.5714285714285714	35	10881	4	20	31	10861	10916	0.13572484859515913
R1	cpdb	0	network_modules	216	TRUE	3.615911834437848e-4	638	25	9	0.36	0.014106583072100314	GO:0030097	GO:BP	hemopoiesis	16175	6675		0.6956521739130435	0.7083333333333334	638	15537	9	16	629	15521	16175	0.06479456513945114
R1	cpdb	0	network_modules	216	TRUE	4.0450956451494396e-4	37	25	4	0.16	0.10810810810810811	GO:0045058	GO:BP	T cell selection	16175	11256		0.7391304347826086	0.75	37	16138	4	21	33	16117	16175	0.12988783621780656
R1	cpdb	0	network_modules	216	TRUE	4.5162911789245073e-4	38	25	4	0.16	0.10526315789473684	GO:0033077	GO:BP	T cell differentiation in thymus	16175	8025		0.782608695652174	0.7916666666666666	38	16137	4	21	34	16116	16175	0.12812111915467386
R1	cpdb	0	network_modules	216	TRUE	6.199939743568752e-4	181	24	6	0.25	0.03314917127071823	REAC:R-HSA-198933	REAC	Immunoregulatory interactions between a Lymphoid and a non-Lymphoid cell	10916	1171		0.6666666666666666	0.7142857142857143	181	10735	6	18	175	10717	10916	0.08580466821911026
R1	cpdb	0	network_modules	216	TRUE	0.0016770806674558068	14	25	3	0.12	0.21428571428571427	GO:0046629	GO:BP	gamma-delta T cell activation	16175	12266		0.8260869565217391	0.8333333333333334	14	16161	3	22	11	16139	16175	0.15939229457778828
R1	cpdb	0	network_modules	216	TRUE	0.00170550472180571	125	25	5	0.2	0.04	GO:0046631	GO:BP	alpha-beta T cell activation	16175	12268		0.8695652173913043	0.875	125	16050	5	20	120	16030	16175	0.0863876390767625
R1	cpdb	0	network_modules	216	TRUE	0.004310092855673024	434	25	7	0.28	0.016129032258064516	GO:0002521	GO:BP	leukocyte differentiation	16175	1043		0.9130434782608695	0.9166666666666666	434	15741	7	18	427	15723	16175	0.06164198605420902
R1	cpdb	0	network_modules	216	TRUE	0.004959319277248285	23	24	3	0.125	0.13043478260869565	REAC:R-HSA-202427	REAC	Phosphorylation of CD3 and TCR zeta chains	10916	1749		0.8333333333333334	0.8571428571428571	23	10893	3	21	20	10872	10916	0.1258070015753195
R1	cpdb	0	network_modules	216	TRUE	0.005659617375167741	24	24	3	0.125	0.125	REAC:R-HSA-389948	REAC	Co-inhibition by PD-1	10916	377		1	1	24	10892	3	21	21	10871	10916	0.1230719794344473
R1	cpdb	0	network_modules	216	TRUE	0.006237158959713951	101	21	4	0.19047619047619047	0.039603960396039604	KEGG:05142	KEGG	Chagas disease	8484	434		0.7777777777777778	0.8	101	8383	4	17	97	8366	8484	0.08201620873353188
R1	cpdb	0	network_modules	216	TRUE	0.0063565121654035606	198	21	5	0.23809523809523808	0.025252525252525252	KEGG:05169	KEGG	Epstein-Barr virus infection	8484	450		0.8888888888888888	0.9	198	8286	5	16	193	8270	8484	0.0708583099896978
R1	cpdb	0	network_modules	216	TRUE	0.006481295830372446	102	21	4	0.19047619047619047	0.0392156862745098	KEGG:04064	KEGG	NF-kappa B signaling pathway	8484	256		1	1	102	8382	4	17	98	8365	8484	0.08156417315803094
R1	cpdb	0	network_modules	216	TRUE	0.00687013786657229	297	25	6	0.24	0.020202020202020204	GO:0030098	GO:BP	lymphocyte differentiation	16175	6676		0.9565217391304348	0.9583333333333334	297	15878	6	19	291	15859	16175	0.06495263549481047
R1	cpdb	0	network_modules	216	TRUE	0.007853925296892975	304	25	6	0.24	0.019736842105263157	GO:0050900	GO:BP	leukocyte migration	16175	13342		1	1	304	15871	6	19	298	15852	16175	0.06408924266489582
R1	cpdb	0	network_modules	218	TRUE	7.948972652152261e-22	86	22	14	0.6363636363636364	0.16279069767441862	KEGG:04610	KEGG	Complement and coagulation cascades	8484	320		NA	1	86	8398	14	8	72	8390	8484	0.31876457690318966
R1	cpdb	0	network_modules	218	TRUE	2.4321099965392645e-20	179	26	15	0.5769230769230769	0.08379888268156424	GO:0007596	GO:BP	blood coagulation	16175	3055		0	0.023255813953488372	179	15996	15	11	164	15985	16175	0.2170362770563472
R1	cpdb	0	network_modules	218	TRUE	3.4254665465280924e-20	183	26	15	0.5769230769230769	0.08196721311475409	GO:0050817	GO:BP	coagulation	16175	13279		0.023809523809523808	0.046511627906976744	183	15992	15	11	168	15981	16175	0.2145842134401683
R1	cpdb	0	network_modules	218	TRUE	4.05334839630068e-20	185	26	15	0.5769230769230769	0.08108108108108109	GO:0007599	GO:BP	hemostasis	16175	3058		0.047619047619047616	0.06976744186046512	185	15990	15	11	170	15979	16175	0.21338783473340026
R1	cpdb	0	network_modules	218	TRUE	3.9055436320606335e-18	249	26	15	0.5769230769230769	0.060240963855421686	GO:0050878	GO:BP	regulation of body fluid levels	16175	13323		0.07142857142857142	0.09302325581395349	249	15926	15	11	234	15915	16175	0.18301103135037597
R1	cpdb	0	network_modules	218	TRUE	4.233161920879183e-16	339	26	15	0.5769230769230769	0.04424778761061947	GO:0042060	GO:BP	wound healing	16175	9947		0.09523809523809523	0.11627906976744186	339	15836	15	11	324	15825	16175	0.15573378984768851
R1	cpdb	0	network_modules	218	TRUE	6.628730737947456e-15	407	26	15	0.5769230769230769	0.036855036855036855	GO:0009611	GO:BP	response to wounding	16175	3539		0.11904761904761904	0.13953488372093023	407	15768	15	11	392	15757	16175	0.14135900193260736
R1	cpdb	0	network_modules	218	TRUE	1.3631104725861053e-14	39	24	9	0.375	0.23076923076923078	REAC:R-HSA-140877	REAC	Formation of Fibrin Clot (Clotting Cascade)	10916	945		0	0.045454545454545456	39	10877	9	15	30	10862	10916	0.2922148224300195
R1	cpdb	0	network_modules	218	TRUE	1.7901833248988093e-13	57	26	9	0.34615384615384615	0.15789473684210525	GO:0030193	GO:BP	regulation of blood coagulation	16175	6704		0.14285714285714285	0.16279069767441862	57	16118	9	17	48	16101	16175	0.23200128406831946
R1	cpdb	0	network_modules	218	TRUE	2.116982530676644e-13	58	26	9	0.34615384615384615	0.15517241379310345	GO:1900046	GO:BP	regulation of hemostasis	16175	20348		0.16666666666666666	0.18604651162790697	58	16117	9	17	49	16100	16175	0.22995821119295434
R1	cpdb	0	network_modules	218	TRUE	2.49566975330538e-13	59	26	9	0.34615384615384615	0.15254237288135594	GO:0050818	GO:BP	regulation of coagulation	16175	13280		0.19047619047619047	0.20930232558139536	59	16116	9	17	50	16099	16175	0.22796700908815906
R1	cpdb	0	network_modules	218	TRUE	2.6728736976075483e-12	22	26	7	0.2692307692307692	0.3181818181818182	GO:1900048	GO:BP	positive regulation of hemostasis	16175	20350		0.21428571428571427	0.27906976744186046	22	16153	7	19	15	16134	16175	0.2916388207405403
R1	cpdb	0	network_modules	218	TRUE	2.6728736976075483e-12	22	26	7	0.2692307692307692	0.3181818181818182	GO:0030194	GO:BP	positive regulation of blood coagulation	16175	6705		0.21428571428571427	0.27906976744186046	22	16153	7	19	15	16134	16175	0.2916388207405403
R1	cpdb	0	network_modules	218	TRUE	2.6728736976075483e-12	22	26	7	0.2692307692307692	0.3181818181818182	GO:0050820	GO:BP	positive regulation of coagulation	16175	13282		0.21428571428571427	0.27906976744186046	22	16153	7	19	15	16134	16175	0.2916388207405403
R1	cpdb	0	network_modules	218	TRUE	3.1988530018466863e-12	44	26	8	0.3076923076923077	0.18181818181818182	GO:0030195	GO:BP	negative regulation of blood coagulation	16175	6706		0.2857142857142857	0.32558139534883723	44	16131	8	18	36	16113	16175	0.2349423000333373
R1	cpdb	0	network_modules	218	TRUE	3.1988530018466863e-12	44	26	8	0.3076923076923077	0.18181818181818182	GO:1900047	GO:BP	negative regulation of hemostasis	16175	20349		0.2857142857142857	0.32558139534883723	44	16131	8	18	36	16113	16175	0.2349423000333373
R1	cpdb	0	network_modules	218	TRUE	3.696545555395449e-12	10	24	6	0.25	0.6	REAC:R-HSA-159740	REAC	Gamma-carboxylation of protein precursors	10916	1031		0.047619047619047616	0.09090909090909091	10	10906	6	18	4	10888	10916	0.38648110433168553
R1	cpdb	0	network_modules	218	TRUE	4.700216967922126e-12	46	26	8	0.3076923076923077	0.17391304347826086	GO:0050819	GO:BP	negative regulation of coagulation	16175	13281		0.3333333333333333	0.3488372093023256	46	16129	8	18	38	16111	16175	0.22969918139399828
R1	cpdb	0	network_modules	218	TRUE	4.880080839962869e-12	22	24	7	0.2916666666666667	0.3181818181818182	REAC:R-HSA-140875	REAC	Common Pathway of Fibrin Clot Formation	10916	388		0.09523809523809523	0.13636363636363635	22	10894	7	17	15	10877	10916	0.30316967089427577
R1	cpdb	0	network_modules	218	TRUE	5.413205021918342e-12	24	26	7	0.2692307692307692	0.2916666666666667	GO:0042730	GO:BP	fibrinolysis	16175	10330		0.35714285714285715	0.37209302325581395	24	16151	7	19	17	16132	16175	0.27911130466209727
R1	cpdb	0	network_modules	218	TRUE	8.12089731160216e-12	11	24	6	0.25	0.5454545454545454	REAC:R-HSA-159854	REAC	Gamma-carboxylation, transport, and amino-terminal cleavage of proteins	10916	1032		0.14285714285714285	0.18181818181818182	11	10905	6	18	5	10887	10916	0.36837663750251887
R1	cpdb	0	network_modules	218	TRUE	1.1814260472128798e-11	12	26	6	0.23076923076923078	0.5	GO:0051918	GO:BP	negative regulation of fibrinolysis	16175	13994		0.38095238095238093	0.3953488372093023	12	16163	6	20	6	16143	16175	0.33898931050503
R1	cpdb	0	network_modules	218	TRUE	6.859618596427151e-11	63	26	8	0.3076923076923077	0.12698412698412698	GO:0061045	GO:BP	negative regulation of wound healing	16175	15161		0.40476190476190477	0.4186046511627907	63	16112	8	18	55	16094	16175	0.19570287649766174
R1	cpdb	0	network_modules	218	TRUE	1.037677164794138e-10	112	26	9	0.34615384615384615	0.08035714285714286	GO:0061041	GO:BP	regulation of wound healing	16175	15157		0.42857142857142855	0.4418604651162791	112	16063	9	17	103	16046	16175	0.16414570369488005
R1	cpdb	0	network_modules	218	TRUE	1.5740220072415508e-10	17	26	6	0.23076923076923078	0.35294117647058826	GO:0051917	GO:BP	regulation of fibrinolysis	16175	13993		0.4523809523809524	0.46511627906976744	17	16158	6	20	11	16138	16175	0.28446925638609755
R1	cpdb	0	network_modules	218	TRUE	4.0914921592303223e-10	78	26	8	0.3076923076923077	0.10256410256410256	GO:1903035	GO:BP	negative regulation of response to wounding	16175	22715		0.47619047619047616	0.4883720930232558	78	16097	8	18	70	16079	16175	0.17542629999455236
R1	cpdb	0	network_modules	218	TRUE	4.701024062740039e-10	132	26	9	0.34615384615384615	0.06818181818181818	GO:1903034	GO:BP	regulation of response to wounding	16175	22714		0.5	0.5116279069767442	132	16043	9	17	123	16026	16175	0.15074267876146072
R1	cpdb	0	network_modules	218	TRUE	1.2734854995867407e-9	9	24	5	0.20833333333333334	0.5555555555555556	REAC:R-HSA-159763	REAC	Transport of gamma-carboxylated protein precursors from the endoplasmic reticulum to the Golgi apparatus	10916	2594		0.19047619047619047	0.22727272727272727	9	10907	5	19	4	10888	10916	0.3393735999676263
R1	cpdb	0	network_modules	218	TRUE	1.7445215376681408e-9	23	24	6	0.25	0.2608695652173913	REAC:R-HSA-140837	REAC	Intrinsic Pathway of Fibrin Clot Formation	10916	1269		0.23809523809523808	0.2727272727272727	23	10893	6	18	17	10875	10916	0.25377096255148307
R1	cpdb	0	network_modules	218	TRUE	2.5432744536180762e-9	10	24	5	0.20833333333333334	0.5	REAC:R-HSA-159782	REAC	Removal of aminoterminal propeptides from gamma-carboxylated proteins	10916	2057		0.2857142857142857	0.3181818181818182	10	10906	5	19	5	10887	10916	0.32183068544476817
R1	cpdb	0	network_modules	218	TRUE	2.685638078048405e-9	54	26	7	0.2692307692307692	0.12962962962962962	GO:0090303	GO:BP	positive regulation of wound healing	16175	18186		0.5238095238095238	0.5348837209302325	54	16121	7	19	47	16102	16175	0.18495710181739605
R1	cpdb	0	network_modules	218	TRUE	5.146760928311613e-9	59	26	7	0.2692307692307692	0.11864406779661017	GO:1903036	GO:BP	positive regulation of response to wounding	16175	22716		0.5476190476190477	0.5581395348837209	59	16116	7	19	52	16097	16175	0.1767681647035606
R1	cpdb	0	network_modules	218	TRUE	1.0491731465448563e-8	60	24	7	0.2916666666666667	0.11666666666666667	REAC:R-HSA-163841	REAC	Gamma carboxylation, hypusinylation, hydroxylation, and arylsulfatase activation	10916	1030		0.3333333333333333	0.36363636363636365	60	10856	7	17	53	10839	10916	0.1816892017299255
R1	cpdb	0	network_modules	218	TRUE	1.2932389674336658e-8	13	24	5	0.20833333333333334	0.38461538461538464	REAC:R-HSA-75205	REAC	Dissolution of Fibrin Clot	10916	780		0.38095238095238093	0.4090909090909091	13	10903	5	19	8	10884	10916	0.2819289649687074
R1	cpdb	0	network_modules	218	TRUE	3.158244054489871e-7	54	26	6	0.23076923076923078	0.1111111111111111	GO:0031638	GO:BP	zymogen activation	16175	7248		0.5714285714285714	0.5813953488372093	54	16121	6	20	48	16101	16175	0.15820290428834174
R1	cpdb	0	network_modules	218	TRUE	7.861396669089227e-7	198	26	8	0.3076923076923077	0.04040404040404041	GO:0016485	GO:BP	protein processing	16175	5233		0.5952380952380952	0.6046511627906976	198	15977	8	18	190	15959	16175	0.10781115134725792
R1	cpdb	0	network_modules	218	TRUE	2.2775048636460767e-6	479	26	10	0.38461538461538464	0.020876826722338204	GO:0040017	GO:BP	positive regulation of locomotion	16175	9905		0.6190476190476191	0.627906976744186	479	15696	10	16	469	15680	16175	0.08402846480966303
R1	cpdb	0	network_modules	218	TRUE	9.918460603596112e-6	16	24	4	0.16666666666666666	0.25	REAC:R-HSA-9671793	REAC	Diseases of hemostasis	10916	766		0.42857142857142855	0.5	16	10900	4	20	12	10880	10916	0.20270038548412667
R1	cpdb	0	network_modules	218	TRUE	9.918460603596112e-6	16	24	4	0.16666666666666666	0.25	REAC:R-HSA-9651496	REAC	Defects of contact activation system (CAS) and kallikrein/kinin system (KKS)	10916	716		0.42857142857142855	0.5	16	10900	4	20	12	10880	10916	0.20270038548412667
R1	cpdb	0	network_modules	218	TRUE	1.708962521461949e-5	17	26	4	0.15384615384615385	0.23529411764705882	GO:0010755	GO:BP	regulation of plasminogen activation	16175	4376		0.6428571428571429	0.6511627906976745	17	16158	4	22	13	16136	16175	0.1892123372480318
R1	cpdb	0	network_modules	218	TRUE	2.627527602447465e-5	450	26	9	0.34615384615384615	0.02	GO:0030335	GO:BP	positive regulation of cell migration	16175	6781		0.6666666666666666	0.6744186046511628	450	15725	9	17	441	15708	16175	0.0776673359265424
R1	cpdb	0	network_modules	218	TRUE	2.874028462237263e-5	5	24	3	0.125	0.6	REAC:R-HSA-140834	REAC	Extrinsic Pathway of Fibrin Clot Formation	10916	890		0.5238095238095238	0.5454545454545454	5	10911	3	21	2	10890	10916	0.2732207860080411
R1	cpdb	0	network_modules	218	TRUE	3.33957124155531e-5	319	26	8	0.3076923076923077	0.025078369905956112	GO:0032102	GO:BP	negative regulation of response to external stimulus	16175	7366		0.6904761904761905	0.6976744186046512	319	15856	8	18	311	15838	16175	0.08310248464087576
R1	cpdb	0	network_modules	218	TRUE	3.824839642430272e-5	470	26	9	0.34615384615384615	0.019148936170212766	GO:2000147	GO:BP	positive regulation of cell motility	16175	25495		0.7142857142857143	0.7209302325581395	470	15705	9	17	461	15688	16175	0.0757498737134377
R1	cpdb	0	network_modules	218	TRUE	4.8383716031946735e-5	483	26	9	0.34615384615384615	0.018633540372670808	GO:0051604	GO:BP	protein maturation	16175	13821		0.7380952380952381	0.7441860465116279	483	15692	9	17	474	15675	16175	0.07456498629761248
R1	cpdb	0	network_modules	218	TRUE	7.572069088463398e-5	24	26	4	0.15384615384615385	0.16666666666666666	GO:0031639	GO:BP	plasminogen activation	16175	7249		0.7619047619047619	0.7674418604651163	24	16151	4	22	20	16129	16175	0.15882928177839048
R1	cpdb	0	network_modules	218	TRUE	1.0030087000119869e-4	7	24	3	0.125	0.42857142857142855	REAC:R-HSA-9662001	REAC	Defective factor VIII causes hemophilia A	10916	694		0.5714285714285714	0.5909090909090909	7	10909	3	21	4	10888	10916	0.2305951410568881
R1	cpdb	0	network_modules	218	TRUE	1.0908953540075933e-4	531	26	9	0.34615384615384615	0.01694915254237288	GO:0032103	GO:BP	positive regulation of response to external stimulus	16175	7367		0.7857142857142857	0.7906976744186046	531	15644	9	17	522	15627	16175	0.07055577955367243
R1	cpdb	0	network_modules	218	TRUE	1.7846535808571944e-4	7	26	3	0.11538461538461539	0.42857142857142855	GO:0010757	GO:BP	negative regulation of plasminogen activation	16175	4378		0.8095238095238095	0.813953488372093	7	16168	3	23	4	16145	16175	0.22176700751010106
R1	cpdb	0	network_modules	218	TRUE	2.4002782571709713e-4	9	24	3	0.125	0.3333333333333333	REAC:R-HSA-9668250	REAC	Defective factor IX causes hemophilia B	10916	692		0.6190476190476191	0.6363636363636364	9	10907	3	21	6	10886	10916	0.20308479792044035
R1	cpdb	0	network_modules	218	TRUE	3.686730556648346e-4	35	26	4	0.15384615384615385	0.11428571428571428	GO:0048008	GO:BP	platelet-derived growth factor receptor signaling pathway	16175	12464		0.8333333333333334	0.8372093023255814	35	16140	4	22	31	16118	16175	0.13098070495541675
R1	cpdb	0	network_modules	218	TRUE	0.0012395813627350488	47	26	4	0.15384615384615385	0.0851063829787234	GO:0070613	GO:BP	regulation of protein processing	16175	16212		0.8571428571428571	0.8604651162790697	47	16128	4	22	43	16106	16175	0.11251866153783563
R1	cpdb	0	network_modules	218	TRUE	0.0014692681652890226	49	26	4	0.15384615384615385	0.08163265306122448	GO:1903317	GO:BP	regulation of protein maturation	16175	22901		0.8809523809523809	0.8837209302325582	49	16126	4	22	45	16104	16175	0.11011499520393349
R1	cpdb	0	network_modules	218	TRUE	0.0019248929231394638	124	24	5	0.20833333333333334	0.04032258064516129	REAC:R-HSA-381426	REAC	Regulation of Insulin-like Growth Factor (IGF) transport and uptake by Insulin-like Growth Factor Binding Proteins (IGFBPs)	10916	1981		0.6666666666666666	0.6818181818181818	124	10792	5	19	119	10773	10916	0.0872493335807208
R1	cpdb	0	network_modules	218	TRUE	0.0020818706000104658	126	24	5	0.20833333333333334	0.03968253968253968	REAC:R-HSA-114608	REAC	Platelet degranulation 	10916	1764		0.7142857142857143	0.7272727272727273	126	10790	5	19	121	10771	10916	0.0864816133429679
R1	cpdb	0	network_modules	218	TRUE	0.0025184726951162505	131	24	5	0.20833333333333334	0.03816793893129771	REAC:R-HSA-76005	REAC	Response to elevated platelet cytosolic Ca2+	10916	2090		0.7619047619047619	0.7727272727272727	131	10785	5	19	126	10766	10916	0.08463734430757461
R1	cpdb	0	network_modules	218	TRUE	0.002814183851497351	781	26	9	0.34615384615384615	0.011523687580025609	GO:0030334	GO:BP	regulation of cell migration	16175	6780		0.9047619047619048	0.9069767441860465	781	15394	9	17	772	15377	16175	0.05575487689430545
R1	cpdb	0	network_modules	218	TRUE	0.00411224180584779	18	26	3	0.11538461538461539	0.16666666666666666	GO:0050927	GO:BP	positive regulation of positive chemotaxis	16175	13369		0.9285714285714286	0.9302325581395349	18	16157	3	23	15	16134	16175	0.13752465046393864
R1	cpdb	0	network_modules	218	TRUE	0.004283946519856877	3	24	2	0.08333333333333333	0.6666666666666666	REAC:R-HSA-9673202	REAC	Defective F9 variant does not activate FX	10916	548		0.8095238095238095	0.9545454545454546	3	10913	2	22	1	10891	10916	0.23521593968333548
R1	cpdb	0	network_modules	218	TRUE	0.004283946519856877	3	24	2	0.08333333333333333	0.6666666666666666	REAC:R-HSA-9672396	REAC	Defective cofactor function of FVIIIa variant	10916	691		0.8095238095238095	0.9545454545454546	3	10913	2	22	1	10891	10916	0.23521593968333548
R1	cpdb	0	network_modules	218	TRUE	0.004283946519856877	3	24	2	0.08333333333333333	0.6666666666666666	REAC:R-HSA-9672383	REAC	Defective factor IX causes thrombophilia	10916	693		0.8095238095238095	0.9545454545454546	3	10913	2	22	1	10891	10916	0.23521593968333548
R1	cpdb	0	network_modules	218	TRUE	0.004283946519856877	3	24	2	0.08333333333333333	0.6666666666666666	REAC:R-HSA-9672391	REAC	Defective F8 cleavage by thrombin	10916	543		0.8095238095238095	0.9545454545454546	3	10913	2	22	1	10891	10916	0.23521593968333548
R1	cpdb	0	network_modules	218	TRUE	0.00487808005922128	19	26	3	0.11538461538461539	0.15789473684210525	GO:0050926	GO:BP	regulation of positive chemotaxis	16175	13368		0.9523809523809523	0.9534883720930233	19	16156	3	23	16	16133	16175	0.13378838606206206
R1	cpdb	0	network_modules	218	TRUE	0.004883090870667491	259	24	6	0.25	0.023166023166023165	REAC:R-HSA-76002	REAC	Platelet activation, signaling and aggregation	10916	1762		1	1	259	10657	6	18	253	10639	10916	0.06978810291667714
R1	cpdb	0	network_modules	218	TRUE	0.0066811333727300375	21	26	3	0.11538461538461539	0.14285714285714285	GO:1903318	GO:BP	negative regulation of protein maturation	16175	22902		0.9761904761904762	1	21	16154	3	23	18	16131	16175	0.12712823401015022
R1	cpdb	0	network_modules	218	TRUE	0.0066811333727300375	21	26	3	0.11538461538461539	0.14285714285714285	GO:0010955	GO:BP	negative regulation of protein processing	16175	4532		0.9761904761904762	1	21	16154	3	23	18	16131	16175	0.12712823401015022
R1	cpdb	0	network_modules	220	TRUE	4.6176580114234345e-20	54	24	12	0.5	0.2222222222222222	REAC:R-HSA-186797	REAC	Signaling by PDGF	10916	2291		0	0.043478260869565216	54	10862	12	12	42	10850	10916	0.33121909464399146
R1	cpdb	0	network_modules	220	TRUE	1.1901380781616196e-17	298	24	16	0.6666666666666666	0.053691275167785234	REAC:R-HSA-1474244	REAC	Extracellular matrix organization	10916	889		0.045454545454545456	0.08695652173913043	298	10618	16	8	282	10610	10916	0.18417736391549308
R1	cpdb	0	network_modules	220	TRUE	3.828020366135003e-17	60	24	11	0.4583333333333333	0.18333333333333332	REAC:R-HSA-2022090	REAC	Assembly of collagen fibrils and other multimeric structures	10916	177		0.09090909090909091	0.13043478260869565	60	10856	11	13	49	10843	10916	0.2875057372943425
R1	cpdb	0	network_modules	220	TRUE	3.902539042438054e-16	89	19	11	0.5789473684210527	0.12359550561797752	KEGG:04512	KEGG	ECM-receptor interaction	8484	314		0	0.14285714285714285	89	8395	11	8	78	8387	8484	0.2643359733277991
R1	cpdb	0	network_modules	220	TRUE	2.0207841103761325e-15	84	24	11	0.4583333333333333	0.13095238095238096	REAC:R-HSA-216083	REAC	Integrin cell surface interactions	10916	1216		0.13636363636363635	0.17391304347826086	84	10832	11	13	73	10819	10916	0.24207468365919654
R1	cpdb	0	network_modules	220	TRUE	3.951384772487738e-15	89	24	11	0.4583333333333333	0.12359550561797752	REAC:R-HSA-1474290	REAC	Collagen formation	10916	387		0.18181818181818182	0.21739130434782608	89	10827	11	13	78	10814	10916	0.2349917494828721
R1	cpdb	0	network_modules	220	TRUE	1.3055856895069745e-14	64	24	10	0.4166666666666667	0.15625	REAC:R-HSA-1442490	REAC	Collagen degradation	10916	386		0.22727272727272727	0.2608695652173913	64	10852	10	14	54	10838	10916	0.25258340436929094
R1	cpdb	0	network_modules	220	TRUE	2.130023105120287e-14	67	24	10	0.4166666666666667	0.14925373134328357	REAC:R-HSA-1650814	REAC	Collagen biosynthesis and modifying enzymes	10916	384		0.2727272727272727	0.30434782608695654	67	10849	10	14	57	10835	10916	0.2467327490807223
R1	cpdb	0	network_modules	220	TRUE	4.531868164147952e-14	44	24	9	0.375	0.20454545454545456	REAC:R-HSA-8948216	REAC	Collagen chain trimerization	10916	385		0.3181818181818182	0.34782608695652173	44	10872	9	15	35	10857	10916	0.27483506884045134
R1	cpdb	0	network_modules	220	TRUE	6.440785480630667e-14	202	19	12	0.631578947368421	0.0594059405940594	KEGG:04510	KEGG	Focal adhesion	8484	313		0.16666666666666666	0.2857142857142857	202	8282	12	7	190	8275	8484	0.18886849886585955
R1	cpdb	0	network_modules	220	TRUE	8.112322835545182e-14	76	24	10	0.4166666666666667	0.13157894736842105	REAC:R-HSA-3000178	REAC	ECM proteoglycans	10916	812		0.36363636363636365	0.391304347826087	76	10840	10	14	66	10826	10916	0.23129408811793073
R1	cpdb	0	network_modules	220	TRUE	1.3454731478104666e-12	356	19	13	0.6842105263157895	0.03651685393258427	KEGG:04151	KEGG	PI3K-Akt signaling pathway	8484	285		0.3333333333333333	0.42857142857142855	356	8128	13	6	343	8122	8484	0.15175768608054813
R1	cpdb	0	network_modules	220	TRUE	2.2620734171426362e-12	507	24	15	0.625	0.029585798816568046	REAC:R-HSA-9006934	REAC	Signaling by Receptor Tyrosine Kinases	10916	2302		0.4090909090909091	0.43478260869565216	507	10409	15	9	492	10400	10916	0.1290479351849488
R1	cpdb	0	network_modules	220	TRUE	2.07160192578438e-11	103	19	9	0.47368421052631576	0.08737864077669903	KEGG:04974	KEGG	Protein digestion and absorption	8484	405		0.5	0.5714285714285714	103	8381	9	10	94	8371	8484	0.1996688349335137
R1	cpdb	0	network_modules	220	TRUE	2.6877836731395757e-11	236	25	11	0.44	0.046610169491525424	GO:0030198	GO:BP	extracellular matrix organization	16175	6707		0	0.14285714285714285	236	15939	11	14	225	15925	16175	0.13958821768386756
R1	cpdb	0	network_modules	220	TRUE	2.8163409895398233e-11	237	25	11	0.44	0.046413502109704644	GO:0043062	GO:BP	extracellular structure organization	16175	10509		0.16666666666666666	0.2857142857142857	237	15938	11	14	226	15924	16175	0.13927754242773654
R1	cpdb	0	network_modules	220	TRUE	2.950443723925961e-11	238	25	11	0.44	0.046218487394957986	GO:0045229	GO:BP	external encapsulating structure organization	16175	11340		0.3333333333333333	0.42857142857142855	238	15937	11	14	227	15923	16175	0.13896879303033574
R1	cpdb	0	network_modules	220	TRUE	4.521878603069222e-11	140	24	10	0.4166666666666667	0.07142857142857142	REAC:R-HSA-1474228	REAC	Degradation of the extracellular matrix	10916	726		0.45454545454545453	0.4782608695652174	140	10776	10	14	130	10762	10916	0.16847420718136782
R1	cpdb	0	network_modules	220	TRUE	9.441907648840673e-11	59	24	8	0.3333333333333333	0.13559322033898305	REAC:R-HSA-3000171	REAC	Non-integrin membrane-ECM interactions	10916	1603		0.5	0.5217391304347826	59	10857	8	16	51	10841	10916	0.2099488342034589
R1	cpdb	0	network_modules	220	TRUE	7.511669596813163e-10	42	24	7	0.2916666666666667	0.16666666666666666	REAC:R-HSA-419037	REAC	NCAM1 interactions	10916	1512		0.5454545454545454	0.5652173913043478	42	10874	7	17	35	10857	10916	0.21823059564052816
R1	cpdb	0	network_modules	220	TRUE	9.239375692510509e-10	330	19	11	0.5789473684210527	0.03333333333333333	KEGG:05165	KEGG	Human papillomavirus infection	8484	446		0.6666666666666666	0.7142857142857143	330	8154	11	8	319	8146	8484	0.13232933374053502
R1	cpdb	0	network_modules	220	TRUE	1.145888490793591e-9	50	25	7	0.28	0.14	GO:0030199	GO:BP	collagen fibril organization	16175	6708		0.5	0.5714285714285714	50	16125	7	18	43	16107	16175	0.1962591617701741
R1	cpdb	0	network_modules	220	TRUE	5.0866118394826275e-9	27	24	6	0.25	0.2222222222222222	REAC:R-HSA-3000170	REAC	Syndecan interactions	10916	2367		0.5909090909090909	0.6086956521739131	27	10889	6	18	21	10871	10916	0.2339167214102728
R1	cpdb	0	network_modules	220	TRUE	9.280389760040066e-9	59	24	7	0.2916666666666667	0.11864406779661017	REAC:R-HSA-375165	REAC	NCAM signaling for neurite out-growth	10916	1511		0.6363636363636364	0.6521739130434783	59	10857	7	17	52	10840	10916	0.18327268332622454
R1	cpdb	0	network_modules	220	TRUE	1.0160106701223609e-8	30	24	6	0.25	0.2	REAC:R-HSA-8874081	REAC	MET activates PTK2 signaling	10916	1362		0.6818181818181818	0.6956521739130435	30	10886	6	18	24	10868	10916	0.22169704106231383
R1	cpdb	0	network_modules	220	TRUE	6.475442658583441e-8	40	24	6	0.25	0.15	REAC:R-HSA-8875878	REAC	MET promotes cell motility	10916	1368		0.7272727272727273	0.7391304347826086	40	10876	6	18	34	10858	10916	0.19137183078297443
R1	cpdb	0	network_modules	220	TRUE	3.5045003451493213e-6	76	24	6	0.25	0.07894736842105263	REAC:R-HSA-6806834	REAC	Signaling by MET	10916	2270		0.7727272727272727	0.782608695652174	76	10840	6	18	70	10822	10916	0.1372042667757778
R1	cpdb	0	network_modules	220	TRUE	1.6627216311848247e-5	18	24	4	0.16666666666666666	0.2222222222222222	REAC:R-HSA-2243919	REAC	Crosslinking of collagen fibrils	10916	417		0.8181818181818182	0.8260869565217391	18	10898	4	20	14	10878	10916	0.19091332250152282
R1	cpdb	0	network_modules	220	TRUE	2.204791538464772e-4	49	19	4	0.21052631578947367	0.08163265306122448	KEGG:05144	KEGG	Malaria	8484	436		0.8333333333333334	0.8571428571428571	49	8435	4	15	45	8420	8484	0.12801146621251006
R1	cpdb	0	network_modules	220	TRUE	4.7012349617342377e-4	11	24	3	0.125	0.2727272727272727	REAC:R-HSA-430116	REAC	GP1b-IX-V activation signalling	10916	1017		0.8636363636363636	0.8695652173913043	11	10905	3	21	8	10884	10916	0.1834428914126782
R1	cpdb	0	network_modules	220	TRUE	0.0012889349578752967	15	24	3	0.125	0.2	REAC:R-HSA-75892	REAC	Platelet Adhesion to exposed collagen	10916	1760		0.9090909090909091	0.9130434782608695	15	10901	3	21	12	10880	10916	0.15665558909033828
R1	cpdb	0	network_modules	220	TRUE	0.0027291990645073165	19	24	3	0.125	0.15789473684210525	REAC:R-HSA-3000480	REAC	Scavenging by Class A Receptors	10916	2180		0.9545454545454546	0.9565217391304348	19	10897	3	21	16	10876	10916	0.13880503843176983
R1	cpdb	0	network_modules	220	TRUE	0.002814649332430869	407	25	7	0.28	0.0171990171990172	GO:0009611	GO:BP	response to wounding	16175	3539		0.6666666666666666	0.7142857142857143	407	15768	7	18	400	15750	16175	0.06401860673906282
R1	cpdb	0	network_modules	220	TRUE	0.004883090870667491	259	24	6	0.25	0.023166023166023165	REAC:R-HSA-76002	REAC	Platelet activation, signaling and aggregation	10916	1762		1	1	259	10657	6	18	253	10639	10916	0.06978810291667714
R1	cpdb	0	network_modules	220	TRUE	0.005744308312897501	71	25	4	0.16	0.056338028169014086	GO:0032963	GO:BP	collagen metabolic process	16175	7947		0.8333333333333334	0.8571428571428571	71	16104	4	21	67	16083	16175	0.09261277582848856
R1	cpdb	0	network_modules	220	TRUE	0.007304864221620998	168	25	5	0.2	0.02976190476190476	GO:0043588	GO:BP	skin development	16175	10792		1	1	168	16007	5	20	163	15987	16175	0.07358476438959834
R1	cpdb	0	network_modules	220	TRUE	0.008775616898073376	124	19	4	0.21052631578947367	0.03225806451612903	KEGG:04611	KEGG	Platelet activation	8484	321		1	1	124	8360	4	15	120	8345	8484	0.07734065800408589
R1	cpdb	0	network_modules	221	TRUE	4.1255216090180315e-14	8	19	6	0.3157894736842105	0.75	GO:0097104	GO:BP	postsynaptic membrane assembly	16175	18497		0	0.01694915254237288	8	16167	6	13	2	16154	16175	0.48630795950149813
R1	cpdb	0	network_modules	221	TRUE	3.0898776014899195e-13	10	19	6	0.3157894736842105	0.6	GO:0097105	GO:BP	presynaptic membrane assembly	16175	18498		0.017241379310344827	0.03389830508474576	10	16165	6	13	4	16152	16175	0.4348233799074562
R1	cpdb	0	network_modules	221	TRUE	6.793045326239874e-13	11	19	6	0.3157894736842105	0.5454545454545454	GO:0097090	GO:BP	presynaptic membrane organization	16175	18486		0.034482758620689655	0.05084745762711865	11	16164	6	13	5	16151	16175	0.41451932207506453
R1	cpdb	0	network_modules	221	TRUE	7.338861999667229e-12	15	19	6	0.3157894736842105	0.4	GO:0007158	GO:BP	neuron cell-cell adhesion	16175	2722		0.05172413793103448	0.06779661016949153	15	16160	6	13	9	16147	16175	0.35473845522617686
R1	cpdb	0	network_modules	221	TRUE	1.0217377005699096e-11	6	19	5	0.2631578947368421	0.8333333333333334	GO:0016255	GO:BP	attachment of GPI anchor to protein	16175	5186		0.06896551724137931	0.0847457627118644	6	16169	5	14	1	16155	16175	0.46799451103489587
R1	cpdb	0	network_modules	221	TRUE	1.17340841887175e-11	16	19	6	0.3157894736842105	0.375	GO:0099068	GO:BP	postsynapse assembly	16175	19027		0.08620689655172414	0.1016949152542373	16	16159	6	13	10	16146	16175	0.3434172162259935
R1	cpdb	0	network_modules	221	TRUE	3.3505292137840084e-11	7	17	5	0.29411764705882354	0.7142857142857143	REAC:R-HSA-162791	REAC	Attachment of GPI anchor to uPAR	10916	188		0	0.2	7	10909	5	12	2	10897	10916	0.4578532840731716
R1	cpdb	0	network_modules	221	TRUE	1.0887855864682868e-10	22	19	6	0.3157894736842105	0.2727272727272727	GO:0001941	GO:BP	postsynaptic membrane organization	16175	553		0.10344827586206896	0.11864406779661017	22	16153	6	13	16	16140	16175	0.2925764112814896
R1	cpdb	0	network_modules	221	TRUE	1.0677626832250302e-9	31	19	6	0.3157894736842105	0.1935483870967742	GO:0099054	GO:BP	presynapse assembly	16175	19026		0.1206896551724138	0.13559322033898305	31	16144	6	13	25	16131	16175	0.246105667916037
R1	cpdb	0	network_modules	221	TRUE	1.3132628972519352e-9	32	19	6	0.3157894736842105	0.1875	GO:0099172	GO:BP	presynapse organization	16175	19080		0.13793103448275862	0.15254237288135594	32	16143	6	13	26	16130	16175	0.2421895347211356
R1	cpdb	0	network_modules	221	TRUE	1.3408541815768586e-8	91	17	7	0.4117647058823529	0.07692307692307693	REAC:R-HSA-163125	REAC	Post-translational modification: synthesis of GPI-anchored proteins	10916	1775		0.25	0.4	91	10825	7	10	84	10815	10916	0.17523723551297352
R1	cpdb	0	network_modules	221	TRUE	3.686480116952774e-8	54	19	6	0.3157894736842105	0.1111111111111111	GO:0071709	GO:BP	membrane assembly	16175	16873		0.15517241379310345	0.1694915254237288	54	16121	6	13	48	16108	16175	0.18575615008824078
R1	cpdb	0	network_modules	221	TRUE	5.465950837038831e-8	56	17	6	0.35294117647058826	0.10714285714285714	REAC:R-HSA-6794361	REAC	Neurexins and neuroligins	10916	1587		0.5	0.6	56	10860	6	11	50	10849	10916	0.19227780842927955
R1	cpdb	0	network_modules	221	TRUE	5.761371935007238e-8	58	19	6	0.3157894736842105	0.10344827586206896	GO:0044091	GO:BP	membrane biogenesis	16175	10913		0.1724137931034483	0.1864406779661017	58	16117	6	13	52	16104	16175	0.17911671017994313
R1	cpdb	0	network_modules	221	TRUE	6.642204748008857e-8	26	17	5	0.29411764705882354	0.19230769230769232	KEGG:00563	KEGG	Glycosylphosphatidylinositol (GPI)-anchor biosynthesis	8484	87		0	0.25	26	8458	5	12	21	8446	8484	0.23594565724787053
R1	cpdb	0	network_modules	221	TRUE	2.8416458091539514e-7	31	19	5	0.2631578947368421	0.16129032258064516	GO:0180046	GO:BP	GPI anchored protein biosynthesis	16175	20314		0.1896551724137931	0.22033898305084745	31	16144	5	14	26	16130	16175	0.2048375991779781
R1	cpdb	0	network_modules	221	TRUE	2.8416458091539514e-7	31	19	5	0.2631578947368421	0.16129032258064516	GO:0098815	GO:BP	modulation of excitatory postsynaptic potential	16175	18902		0.1896551724137931	0.22033898305084745	31	16144	5	14	26	16130	16175	0.2048375991779781
R1	cpdb	0	network_modules	221	TRUE	7.711443210957148e-7	86	17	6	0.35294117647058826	0.06976744186046512	REAC:R-HSA-6794362	REAC	Protein-protein interactions at synapses	10916	1819		0.75	0.8	86	10830	6	11	80	10819	10916	0.15414498177952318
R1	cpdb	0	network_modules	221	TRUE	1.3048226310247709e-6	13	19	4	0.21052631578947367	0.3076923076923077	GO:0071625	GO:BP	vocalization behavior	16175	16805		0.22413793103448276	0.23728813559322035	13	16162	4	15	9	16147	16175	0.25379331972800295
R1	cpdb	0	network_modules	221	TRUE	1.4574586634949572e-6	98	19	6	0.3157894736842105	0.061224489795918366	GO:0099173	GO:BP	postsynapse organization	16175	19081		0.2413793103448276	0.2542372881355932	98	16077	6	13	92	16064	16175	0.13687462283926724
R1	cpdb	0	network_modules	221	TRUE	1.7992947695938487e-6	44	19	5	0.2631578947368421	0.11363636363636363	GO:0060079	GO:BP	excitatory postsynaptic potential	16175	14338		0.25862068965517243	0.2711864406779661	44	16131	5	14	39	16117	16175	0.17147505364430812
R1	cpdb	0	network_modules	221	TRUE	3.1479237644494206e-6	49	19	5	0.2631578947368421	0.10204081632653061	GO:0140238	GO:BP	presynaptic endocytosis	16175	19709		0.27586206896551724	0.3050847457627119	49	16126	5	14	44	16112	16175	0.16232327035948615
R1	cpdb	0	network_modules	221	TRUE	3.1479237644494206e-6	49	19	5	0.2631578947368421	0.10204081632653061	GO:0048488	GO:BP	synaptic vesicle endocytosis	16175	12781		0.27586206896551724	0.3050847457627119	49	16126	5	14	44	16112	16175	0.16232327035948615
R1	cpdb	0	network_modules	221	TRUE	3.8722752980537766e-6	51	19	5	0.2631578947368421	0.09803921568627451	GO:0099565	GO:BP	chemical synaptic transmission, postsynaptic	16175	19143		0.3103448275862069	0.3220338983050847	51	16124	5	14	46	16110	16175	0.15904286313869703
R1	cpdb	0	network_modules	221	TRUE	4.273900633640756e-6	117	19	6	0.3157894736842105	0.05128205128205128	GO:0099504	GO:BP	synaptic vesicle cycle	16175	19100		0.3275862068965517	0.3389830508474576	117	16058	6	13	111	16045	16175	0.12486756155970305
R1	cpdb	0	network_modules	221	TRUE	5.23742605029058e-6	121	19	6	0.3157894736842105	0.049586776859504134	GO:0099003	GO:BP	vesicle-mediated transport in synapse	16175	18999		0.3448275862068966	0.3559322033898305	121	16054	6	13	115	16041	16175	0.12270316498608605
R1	cpdb	0	network_modules	221	TRUE	6.374389400076091e-6	125	19	6	0.3157894736842105	0.048	GO:0007416	GO:BP	synapse assembly	16175	2911		0.3620689655172414	0.3728813559322034	125	16050	6	13	119	16037	16175	0.12064214941828154
R1	cpdb	0	network_modules	221	TRUE	7.041973282382614e-6	19	19	4	0.21052631578947367	0.21052631578947367	GO:2000311	GO:BP	regulation of AMPA receptor activity	16175	25633		0.3793103448275862	0.3898305084745763	19	16156	4	15	15	16141	16175	0.20959786815392034
R1	cpdb	0	network_modules	221	TRUE	8.205117060267641e-6	59	19	5	0.2631578947368421	0.0847457627118644	GO:0036465	GO:BP	synaptic vesicle recycling	16175	9613		0.39655172413793105	0.4067796610169492	59	16116	5	14	54	16102	16175	0.1476230303354876
R1	cpdb	0	network_modules	221	TRUE	9.73614723232607e-6	61	19	5	0.2631578947368421	0.08196721311475409	GO:0060078	GO:BP	regulation of postsynaptic membrane potential	16175	14337		0.41379310344827586	0.423728813559322	61	16114	5	14	56	16100	16175	0.1451226427881961
R1	cpdb	0	network_modules	221	TRUE	1.3260424550822056e-5	22	19	4	0.21052631578947367	0.18181818181818182	GO:2000463	GO:BP	positive regulation of excitatory postsynaptic potential	16175	25775		0.43103448275862066	0.4406779661016949	22	16153	4	15	18	16138	16175	0.19462907597893775
R1	cpdb	0	network_modules	221	TRUE	1.604017671524277e-5	23	19	4	0.21052631578947367	0.17391304347826086	GO:0051968	GO:BP	positive regulation of synaptic transmission, glutamatergic	16175	14037		0.4482758620689655	0.4576271186440678	23	16152	4	15	19	16137	16175	0.19030061956360644
R1	cpdb	0	network_modules	221	TRUE	2.0048809635779984e-5	153	17	6	0.35294117647058826	0.0392156862745098	KEGG:04514	KEGG	Cell adhesion molecules	8484	315		0.3333333333333333	0.5	153	8331	6	11	147	8320	8484	0.11276922129404535
R1	cpdb	0	network_modules	221	TRUE	2.436930084021909e-5	73	19	5	0.2631578947368421	0.0684931506849315	GO:0031644	GO:BP	regulation of nervous system process	16175	7254		0.46551724137931033	0.4745762711864407	73	16102	5	14	68	16088	16175	0.13232944952438924
R1	cpdb	0	network_modules	221	TRUE	2.6511132254884823e-5	283	19	7	0.3684210526315789	0.024734982332155476	GO:0050808	GO:BP	synapse organization	16175	13274		0.4827586206896552	0.4915254237288136	283	15892	7	12	276	15880	16175	0.09178799366769042
R1	cpdb	0	network_modules	221	TRUE	3.7055600885495715e-5	6	19	3	0.15789473684210525	0.5	GO:0097119	GO:BP	postsynaptic density protein 95 clustering	16175	18509		0.5	0.5084745762711864	6	16169	3	16	3	16153	16175	0.28053246336363274
R1	cpdb	0	network_modules	221	TRUE	4.2831891398518676e-5	29	19	4	0.21052631578947367	0.13793103448275862	GO:0035176	GO:BP	social behavior	16175	8870		0.5172413793103449	0.5254237288135594	29	16146	4	15	25	16131	16175	0.16920558544715944
R1	cpdb	0	network_modules	221	TRUE	5.66588766560375e-5	31	19	4	0.21052631578947367	0.12903225806451613	GO:0051703	GO:BP	biological process involved in intraspecies interaction between organisms	16175	13903		0.5344827586206896	0.5423728813559322	31	16144	4	15	27	16129	16175	0.16356953043991923
R1	cpdb	0	network_modules	221	TRUE	7.357507154260027e-5	33	19	4	0.21052631578947367	0.12121212121212122	GO:0051965	GO:BP	positive regulation of synapse assembly	16175	14034		0.5517241379310345	0.559322033898305	33	16142	4	15	29	16127	16175	0.15845125913874814
R1	cpdb	0	network_modules	221	TRUE	1.1839806984112223e-4	37	19	4	0.21052631578947367	0.10810810810810811	GO:0099601	GO:BP	regulation of neurotransmitter receptor activity	16175	19157		0.5689655172413793	0.576271186440678	37	16138	4	15	33	16123	16175	0.1494824391084959
R1	cpdb	0	network_modules	221	TRUE	1.5528732974810387e-4	9	19	3	0.15789473684210525	0.3333333333333333	GO:0032230	GO:BP	positive regulation of synaptic transmission, GABAergic	16175	7419		0.5862068965517241	0.5932203389830508	9	16166	3	16	6	16150	16175	0.2288053323123006
R1	cpdb	0	network_modules	221	TRUE	1.833641824222205e-4	15	17	3	0.17647058823529413	0.2	KEGG:00730	KEGG	Thiamine metabolism	8484	118		0.6666666666666666	0.75	15	8469	3	14	12	8455	8484	0.18633648526802568
R1	cpdb	0	network_modules	221	TRUE	5.187405781535591e-4	53	19	4	0.21052631578947367	0.07547169811320754	GO:0007612	GO:BP	learning	16175	3069		0.603448275862069	0.6101694915254238	53	16122	4	15	49	16107	16175	0.12436569153787577
R1	cpdb	0	network_modules	221	TRUE	5.239873698770351e-4	262	19	6	0.3157894736842105	0.022900763358778626	GO:0050804	GO:BP	modulation of chemical synaptic transmission	16175	13270		0.6206896551724138	0.6271186440677966	262	15913	6	13	256	15900	16175	0.08138740047592385
R1	cpdb	0	network_modules	221	TRUE	5.271488521564476e-4	13	19	3	0.15789473684210525	0.23076923076923078	GO:0097106	GO:BP	postsynaptic density organization	16175	18499		0.6379310344827587	0.6440677966101694	13	16162	3	16	10	16146	16175	0.19010183994272611
R1	cpdb	0	network_modules	221	TRUE	5.358472438434794e-4	263	19	6	0.3157894736842105	0.022813688212927757	GO:0099177	GO:BP	regulation of trans-synaptic signaling	16175	19085		0.6551724137931034	0.6610169491525424	263	15912	6	13	257	15899	16175	0.08121831304210961
R1	cpdb	0	network_modules	221	TRUE	6.032829438957584e-4	55	19	4	0.21052631578947367	0.07272727272727272	GO:0051966	GO:BP	regulation of synaptic transmission, glutamatergic	16175	14035		0.6724137931034483	0.6779661016949152	55	16120	4	15	51	16105	16175	0.12201829053407498
R1	cpdb	0	network_modules	221	TRUE	6.704188856927575e-4	14	19	3	0.15789473684210525	0.21428571428571427	GO:0099084	GO:BP	postsynaptic specialization organization	16175	19035		0.6896551724137931	0.6949152542372882	14	16161	3	16	11	16145	16175	0.1831202880115945
R1	cpdb	0	network_modules	221	TRUE	7.48808449052045e-4	58	19	4	0.21052631578947367	0.06896551724137931	GO:0051963	GO:BP	regulation of synapse assembly	16175	14032		0.7068965517241379	0.711864406779661	58	16117	4	15	54	16102	16175	0.11872539848693067
R1	cpdb	0	network_modules	221	TRUE	0.0011613724165297123	27	17	3	0.17647058823529413	0.1111111111111111	KEGG:00790	KEGG	Folate biosynthesis	8484	125		1	1	27	8457	3	14	24	8443	8484	0.13786026254429812
R1	cpdb	0	network_modules	221	TRUE	0.0014266924887667155	68	19	4	0.21052631578947367	0.058823529411764705	GO:1901890	GO:BP	positive regulation of cell junction assembly	16175	21834		0.7241379310344828	0.7288135593220338	68	16107	4	15	64	16092	16175	0.10935497523542277
R1	cpdb	0	network_modules	221	TRUE	0.0014984612348917467	18	19	3	0.15789473684210525	0.16666666666666666	GO:0032228	GO:BP	regulation of synaptic transmission, GABAergic	16175	7417		0.7413793103448276	0.7457627118644068	18	16157	3	16	15	16141	16175	0.16126254114621588
R1	cpdb	0	network_modules	221	TRUE	0.0017665773513739864	2	19	2	0.10526315789473684	1	GO:0090125	GO:BP	cell-cell adhesion involved in synapse maturation	16175	18038		0.7586206896551724	0.7627118644067796	2	16173	2	17	0	16156	16175	0.32427228087924065
R1	cpdb	0	network_modules	221	TRUE	0.001778102346443505	19	19	3	0.15789473684210525	0.15789473684210525	GO:1904861	GO:BP	excitatory synapse assembly	16175	24169		0.7758620689655172	0.7796610169491526	19	16156	3	16	16	16140	16175	0.15690439269751502
R1	cpdb	0	network_modules	221	TRUE	0.0019566019312268743	533	19	7	0.3684210526315789	0.013133208255159476	GO:0034330	GO:BP	cell junction organization	16175	8572		0.7931034482758621	0.7966101694915254	533	15642	7	12	526	15630	16175	0.06444611952967952
R1	cpdb	0	network_modules	221	TRUE	0.0022342722601088405	76	19	4	0.21052631578947367	0.05263157894736842	GO:0035249	GO:BP	synaptic transmission, glutamatergic	16175	8924		0.8103448275862069	0.8135593220338984	76	16099	4	15	72	16084	16175	0.10321712467386263
R1	cpdb	0	network_modules	221	TRUE	0.002360351988340398	182	19	5	0.2631578947368421	0.027472527472527472	GO:0032412	GO:BP	regulation of monoatomic ion transmembrane transporter activity	16175	7550		0.8275862068965517	0.8305084745762712	182	15993	5	14	177	15979	16175	0.08190151824500067
R1	cpdb	0	network_modules	221	TRUE	0.002658487944415774	346	19	6	0.3157894736842105	0.017341040462427744	GO:0034329	GO:BP	cell junction assembly	16175	8571		0.8448275862068966	0.847457627118644	346	15829	6	13	340	15816	16175	0.06977902232448707
R1	cpdb	0	network_modules	221	TRUE	0.002916667278735739	190	19	5	0.2631578947368421	0.02631578947368421	GO:0022898	GO:BP	regulation of transmembrane transporter activity	16175	6629		0.8620689655172413	0.864406779661017	190	15985	5	14	185	15971	16175	0.08002136687080401
R1	cpdb	0	network_modules	221	TRUE	0.004036321096718562	203	19	5	0.2631578947368421	0.024630541871921183	GO:0032409	GO:BP	regulation of transporter activity	16175	7547		0.8793103448275862	0.8813559322033898	203	15972	5	14	198	15958	16175	0.07720062996727771
R1	cpdb	0	network_modules	221	TRUE	0.005240033633439472	94	19	4	0.21052631578947367	0.0425531914893617	GO:0010469	GO:BP	regulation of signaling receptor activity	16175	4162		0.896551724137931	0.8983050847457628	94	16081	4	15	90	16066	16175	0.0923598294987878
R1	cpdb	0	network_modules	221	TRUE	0.005296018232941796	3	19	2	0.10526315789473684	0.6666666666666666	GO:0072553	GO:BP	terminal button organization	16175	17439		0.9137931034482759	0.9661016949152542	3	16172	2	17	1	16155	16175	0.26461970208734953
R1	cpdb	0	network_modules	221	TRUE	0.005296018232941796	3	19	2	0.10526315789473684	0.6666666666666666	GO:1900073	GO:BP	regulation of neuromuscular synaptic transmission	16175	20370		0.9137931034482759	0.9661016949152542	3	16172	2	17	1	16155	16175	0.26461970208734953
R1	cpdb	0	network_modules	221	TRUE	0.005296018232941796	3	19	2	0.10526315789473684	0.6666666666666666	GO:1900075	GO:BP	positive regulation of neuromuscular synaptic transmission	16175	20372		0.9137931034482759	0.9661016949152542	3	16172	2	17	1	16155	16175	0.26461970208734953
R1	cpdb	0	network_modules	221	TRUE	0.005296018232941796	3	19	2	0.10526315789473684	0.6666666666666666	GO:0097114	GO:BP	NMDA glutamate receptor clustering	16175	18504		0.9137931034482759	0.9661016949152542	3	16172	2	17	1	16155	16175	0.26461970208734953
R1	cpdb	0	network_modules	221	TRUE	0.0059404522446590575	97	19	4	0.21052631578947367	0.041237113402061855	GO:0050806	GO:BP	positive regulation of synaptic transmission	16175	13272		0.9827586206896551	0.9830508474576272	97	16078	4	15	93	16063	16175	0.09084646805947554
R1	cpdb	0	network_modules	221	TRUE	0.005971390823335007	28	19	3	0.15789473684210525	0.10714285714285714	GO:0034331	GO:BP	cell junction maintenance	16175	8573		1	1	28	16147	3	16	25	16131	16175	0.1288276952064913
R1	cpdb	0	network_modules	221	TRUE	0.006822061316041154	400	17	6	0.35294117647058826	0.015	REAC:R-HSA-112316	REAC	Neuronal System	10916	1590		1	1	400	10516	6	11	394	10505	10916	0.06648680057884111
R1	cpdb	0	network_modules	222	TRUE	3.1561771930345468e-6	193	11	6	0.5454545454545454	0.031088082901554404	KEGG:04814	KEGG	Motor proteins	8484	366		NA	1	193	8291	6	5	187	8286	8484	0.12631462618241238
R1	cpdb	0	network_modules	222	TRUE	3.749301561745323e-4	53	17	4	0.23529411764705882	0.07547169811320754	REAC:R-HSA-9662361	REAC	Sensory processing of sound by outer hair cells of the cochlea	10916	2203		0	0.3333333333333333	53	10863	4	13	49	10850	10916	0.13092951333171876
R1	cpdb	0	network_modules	222	TRUE	7.80695575462289e-4	632	27	9	0.3333333333333333	0.014240506329113924	GO:0030036	GO:BP	actin cytoskeleton organization	16175	6660		0	0.5	632	15543	9	18	623	15525	16175	0.062097352982174024
R1	cpdb	0	network_modules	222	TRUE	9.114116149700395e-4	66	17	4	0.23529411764705882	0.06060606060606061	REAC:R-HSA-9662360	REAC	Sensory processing of sound by inner hair cells of the cochlea	10916	2202		0.5	0.6666666666666666	66	10850	4	13	62	10837	10916	0.11679204944247584
R1	cpdb	0	network_modules	222	TRUE	0.0014439807027246106	74	17	4	0.23529411764705882	0.05405405405405406	REAC:R-HSA-9659379	REAC	Sensory processing of sound	10916	2201		1	1	74	10842	4	13	70	10829	10916	0.10998639327482326
R1	cpdb	0	network_modules	222	TRUE	0.002017875482003966	708	27	9	0.3333333333333333	0.012711864406779662	GO:0030029	GO:BP	actin filament-based process	16175	6653		1	1	708	15467	9	18	699	15449	16175	0.05787470884108665
R1	cpdb	0	network_modules	223	TRUE	3.423909558401982e-6	131	15	6	0.4	0.04580152671755725	KEGG:04142	KEGG	Lysosome	8484	279		NA	1	131	8353	6	9	125	8344	8484	0.13126124114143162
R1	cpdb	0	network_modules	223	TRUE	1.3976206986383632e-4	35	20	4	0.2	0.11428571428571428	REAC:R-HSA-432720	REAC	Lysosome Vesicle Biogenesis	10916	1341		0	0.5	35	10881	4	16	31	10865	10916	0.14913780108002858
R1	cpdb	0	network_modules	223	TRUE	0.002629246579655212	72	20	4	0.2	0.05555555555555555	REAC:R-HSA-199992	REAC	trans-Golgi Network Vesicle Budding	10916	2749		1	1	72	10844	4	16	68	10828	10916	0.10236460739328222
R1	cpdb	0	network_modules	224	TRUE	4.865772494890022e-12	11	22	6	0.2727272727272727	0.5454545454545454	REAC:R-HSA-5625970	REAC	RHO GTPases activate KTN1	10916	1855		0	0.1111111111111111	11	10905	6	16	5	10889	10916	0.384851279867675
R1	cpdb	0	network_modules	224	TRUE	5.1525833465094785e-11	60	22	8	0.36363636363636365	0.13333333333333333	REAC:R-HSA-983189	REAC	Kinesins	10916	1292		0.125	0.2222222222222222	60	10856	8	14	52	10842	10916	0.21768238168317922
R1	cpdb	0	network_modules	224	TRUE	1.4043670034552047e-10	193	19	10	0.5263157894736842	0.05181347150259067	KEGG:04814	KEGG	Motor proteins	8484	366		0	0.14285714285714285	193	8291	10	9	183	8282	8484	0.16000708126244675
R1	cpdb	0	network_modules	224	TRUE	3.296832304053283e-9	99	22	8	0.36363636363636365	0.08080808080808081	REAC:R-HSA-6811434	REAC	COPI-dependent Golgi-to-ER retrograde traffic	10916	277		0.25	0.3333333333333333	99	10817	8	14	91	10803	10916	0.16807712636127917
R1	cpdb	0	network_modules	224	TRUE	3.628314370350381e-8	133	22	8	0.36363636363636365	0.06015037593984962	REAC:R-HSA-8856688	REAC	Golgi-to-ER retrograde transport	10916	1084		0.375	0.4444444444444444	133	10783	8	14	125	10769	10916	0.14396339800776173
R1	cpdb	0	network_modules	224	TRUE	2.4781081458257034e-7	169	22	8	0.36363636363636365	0.047337278106508875	REAC:R-HSA-983231	REAC	Factors involved in megakaryocyte development and platelet production	10916	931		0.5	0.5555555555555556	169	10747	8	14	161	10733	10916	0.12672614410821284
R1	cpdb	0	network_modules	224	TRUE	5.631469072645798e-7	348	30	10	0.3333333333333333	0.028735632183908046	GO:0007018	GO:BP	microtubule-based movement	16175	2626		0	0.05263157894736842	348	15827	10	20	338	15807	16175	0.09264010872439886
R1	cpdb	0	network_modules	224	TRUE	1.0217938880687985e-6	202	22	8	0.36363636363636365	0.039603960396039604	REAC:R-HSA-6811442	REAC	Intra-Golgi and retrograde Golgi-to-ER traffic	10916	1262		0.625	0.6666666666666666	202	10714	8	14	194	10700	10916	0.11508379385929339
R1	cpdb	0	network_modules	224	TRUE	3.382454000523105e-5	4	30	3	0.1	0.75	GO:1990049	GO:BP	retrograde neuronal dense core vesicle transport	16175	25063		0.05555555555555555	0.10526315789473684	4	16171	3	27	1	16144	16175	0.2734715412069573
R1	cpdb	0	network_modules	224	TRUE	3.8855863345181715e-5	123	22	6	0.2727272727272727	0.04878048780487805	REAC:R-HSA-2132295	REAC	MHC class II antigen presentation	10916	1371		0.75	0.7777777777777778	123	10793	6	16	117	10777	10916	0.11131708186045267
R1	cpdb	0	network_modules	224	TRUE	3.967533169500533e-5	249	19	7	0.3684210526315789	0.028112449799196786	KEGG:05132	KEGG	Salmonella infection	8484	429		0.16666666666666666	0.2857142857142857	249	8235	7	12	242	8223	8484	0.09517525159947177
R1	cpdb	0	network_modules	224	TRUE	5.477901578758066e-5	185	30	7	0.23333333333333334	0.03783783783783784	GO:0030705	GO:BP	cytoskeleton-dependent intracellular transport	16175	6886		0.1111111111111111	0.15789473684210525	185	15990	7	23	178	15967	16175	0.08995496363438867
R1	cpdb	0	network_modules	224	TRUE	6.043639667107348e-5	265	19	7	0.3684210526315789	0.026415094339622643	KEGG:05012	KEGG	Parkinson disease	8484	412		0.3333333333333333	0.42857142857142855	265	8219	7	12	258	8207	8484	0.09183343113048377
R1	cpdb	0	network_modules	224	TRUE	7.028052114244225e-5	271	19	7	0.3684210526315789	0.025830258302583026	KEGG:05020	KEGG	Prion disease	8484	416		0.5	0.5714285714285714	271	8213	7	12	264	8201	8484	0.09065376282095769
R1	cpdb	0	network_modules	224	TRUE	8.445546892899441e-5	5	30	3	0.1	0.6	GO:0098971	GO:BP	anterograde dendritic transport of neurotransmitter receptor complex	16175	18983		0.16666666666666666	0.21052631578947367	5	16170	3	27	2	16143	16175	0.2444563448700135
R1	cpdb	0	network_modules	224	TRUE	1.5531545817711837e-4	305	19	7	0.3684210526315789	0.022950819672131147	KEGG:05016	KEGG	Huntington disease	8484	414		0.6666666666666666	0.7142857142857143	305	8179	7	12	298	8167	8484	0.08460923394648512
R1	cpdb	0	network_modules	224	TRUE	2.948544030394264e-4	7	30	3	0.1	0.42857142857142855	GO:0098937	GO:BP	anterograde dendritic transport	16175	18965		0.2222222222222222	0.3157894736842105	7	16168	3	27	4	16141	16175	0.20635983007136915
R1	cpdb	0	network_modules	224	TRUE	2.948544030394264e-4	7	30	3	0.1	0.42857142857142855	GO:0098935	GO:BP	dendritic transport	16175	18964		0.2222222222222222	0.3157894736842105	7	16168	3	27	4	16141	16175	0.20635983007136915
R1	cpdb	0	network_modules	224	TRUE	4.711763958306687e-4	8	30	3	0.1	0.375	GO:0099641	GO:BP	anterograde axonal protein transport	16175	19181		0.3333333333333333	0.42105263157894735	8	16167	3	27	5	16140	16175	0.1929180533726307
R1	cpdb	0	network_modules	224	TRUE	4.711763958306687e-4	8	30	3	0.1	0.375	GO:0099640	GO:BP	axo-dendritic protein transport	16175	19180		0.3333333333333333	0.42105263157894735	8	16167	3	27	5	16140	16175	0.1929180533726307
R1	cpdb	0	network_modules	224	TRUE	4.934059201219625e-4	363	19	7	0.3684210526315789	0.01928374655647383	KEGG:05014	KEGG	Amyotrophic lateral sclerosis	8484	413		0.8333333333333334	0.8571428571428571	363	8121	7	12	356	8109	8484	0.07623185661601481
R1	cpdb	0	network_modules	224	TRUE	6.501961977047479e-4	318	22	7	0.3181818181818182	0.0220125786163522	REAC:R-HSA-195258	REAC	RHO GTPase Effectors	10916	1846		0.875	0.8888888888888888	318	10598	7	15	311	10583	10916	0.07723764810312199
R1	cpdb	0	network_modules	224	TRUE	6.90265796797999e-4	382	19	7	0.3684210526315789	0.01832460732984293	KEGG:05010	KEGG	Alzheimer disease	8484	411		1	1	382	8102	7	12	375	8090	8484	0.0738872737230074
R1	cpdb	0	network_modules	224	TRUE	7.05879759773734e-4	9	30	3	0.1	0.3333333333333333	GO:1901950	GO:BP	dense core granule transport	16175	21890		0.4444444444444444	0.5263157894736842	9	16166	3	27	6	16139	16175	0.1817774998860541
R1	cpdb	0	network_modules	224	TRUE	7.05879759773734e-4	9	30	3	0.1	0.3333333333333333	GO:0099519	GO:BP	dense core granule cytoskeletal transport	16175	19108		0.4444444444444444	0.5263157894736842	9	16166	3	27	6	16139	16175	0.1817774998860541
R1	cpdb	0	network_modules	224	TRUE	0.0010071372341564253	10	30	3	0.1	0.3	GO:1905383	GO:BP	protein localization to presynapse	16175	24588		0.5555555555555556	0.5789473684210527	10	16165	3	27	7	16138	16175	0.17234739749830705
R1	cpdb	0	network_modules	224	TRUE	0.0015066854771267609	42	30	4	0.13333333333333333	0.09523809523809523	GO:0008089	GO:BP	anterograde axonal transport	16175	3120		0.6111111111111112	0.631578947368421	42	16133	4	26	38	16107	16175	0.11073918174450127
R1	cpdb	0	network_modules	224	TRUE	0.001841798306441217	12	30	3	0.1	0.25	GO:0099118	GO:BP	microtubule-based protein transport	16175	19049		0.6666666666666666	0.7368421052631579	12	16163	3	27	9	16136	16175	0.15714490440022097
R1	cpdb	0	network_modules	224	TRUE	0.001841798306441217	12	30	3	0.1	0.25	GO:0098840	GO:BP	protein transport along microtubule	16175	18910		0.6666666666666666	0.7368421052631579	12	16163	3	27	9	16136	16175	0.15714490440022097
R1	cpdb	0	network_modules	224	TRUE	0.002391340619388191	13	30	3	0.1	0.23076923076923078	GO:0032252	GO:BP	secretory granule localization	16175	7438		0.7777777777777778	0.8421052631578947	13	16162	3	27	10	16135	16175	0.15089056917534194
R1	cpdb	0	network_modules	224	TRUE	0.002391340619388191	13	30	3	0.1	0.23076923076923078	GO:0032253	GO:BP	dense core granule localization	16175	7439		0.7777777777777778	0.8421052631578947	13	16162	3	27	10	16135	16175	0.15089056917534194
R1	cpdb	0	network_modules	224	TRUE	0.004191805405569589	54	30	4	0.13333333333333333	0.07407407407407407	GO:0098930	GO:BP	axonal transport	16175	18959		0.8888888888888888	0.8947368421052632	54	16121	4	26	50	16095	16175	0.09714471169511268
R1	cpdb	0	network_modules	224	TRUE	0.0046647847133472016	16	30	3	0.1	0.1875	GO:0008090	GO:BP	retrograde axonal transport	16175	3121		0.9444444444444444	0.9473684210526315	16	16159	3	27	13	16132	16175	0.1357692171589587
R1	cpdb	0	network_modules	224	TRUE	0.005293281344862638	25	22	3	0.13636363636363635	0.12	REAC:R-HSA-264876	REAC	Insulin processing	10916	1209		1	1	25	10891	3	19	22	10872	10916	0.12604336433891292
R1	cpdb	0	network_modules	224	TRUE	0.00685498995336462	61	30	4	0.13333333333333333	0.06557377049180328	GO:0008088	GO:BP	axo-dendritic transport	16175	3119		1	1	61	16114	4	26	57	16088	16175	0.09111653819260836
R1	cpdb	0	network_modules	225	TRUE	0.004982325234183615	2	28	2	0.07142857142857142	1	GO:1904780	GO:BP	negative regulation of protein localization to centrosome	16175	24100		0	0.5	2	16173	2	26	0	16147	16175	0.2670463285603229
R1	cpdb	0	network_modules	225	TRUE	0.007494278947496301	144	28	5	0.17857142857142858	0.034722222222222224	GO:0007030	GO:BP	Golgi organization	16175	2635		1	1	144	16031	5	23	139	16008	16175	0.07521731390901049
R1	cpdb	0	network_modules	225	TRUE	0.007903423199387085	5	18	2	0.1111111111111111	0.4	REAC:R-HSA-112303	REAC	Electric Transmission Across Gap Junctions	10916	837		0	1	5	10911	2	16	3	10895	10916	0.21017088694923294
R1	cpdb	0	network_modules	225	TRUE	0.007903423199387085	5	18	2	0.1111111111111111	0.4	REAC:R-HSA-112307	REAC	Transmission across Electrical Synapses 	10916	2581		0	1	5	10911	2	16	3	10895	10916	0.21017088694923294
R1	cpdb	0	network_modules	226	TRUE	1.5128889442532223e-13	301	19	13	0.6842105263157895	0.04318936877076412	KEGG:04010	KEGG	MAPK signaling pathway	8484	243		0	0.1	301	8183	13	6	288	8177	8484	0.16614595110246738
R1	cpdb	0	network_modules	226	TRUE	6.702209442359875e-7	63	22	6	0.2727272727272727	0.09523809523809523	REAC:R-HSA-450294	REAC	MAP kinase activation	10916	1345		0	0.045454545454545456	63	10853	6	16	57	10837	10916	0.15837096928914063
R1	cpdb	0	network_modules	226	TRUE	1.3985352185946928e-6	71	22	6	0.2727272727272727	0.08450704225352113	REAC:R-HSA-448424	REAC	Interleukin-17 signaling	10916	1238		0.047619047619047616	0.09090909090909091	71	10845	6	16	65	10829	10916	0.14882740121821333
R1	cpdb	0	network_modules	226	TRUE	7.106101196113468e-6	113	19	6	0.3157894736842105	0.05309734513274336	KEGG:04668	KEGG	TNF signaling pathway	8484	342		0.1111111111111111	0.2	113	8371	6	13	107	8358	8484	0.12500252952413884
R1	cpdb	0	network_modules	226	TRUE	8.233452513325734e-6	95	22	6	0.2727272727272727	0.06315789473684211	REAC:R-HSA-975871	REAC	MyD88 cascade initiated on plasma membrane	10916	1497		0.09523809523809523	0.22727272727272727	95	10821	6	16	89	10805	10916	0.12774085813249605
R1	cpdb	0	network_modules	226	TRUE	8.233452513325734e-6	95	22	6	0.2727272727272727	0.06315789473684211	REAC:R-HSA-168142	REAC	Toll Like Receptor 10 (TLR10) Cascade	10916	2513		0.09523809523809523	0.22727272727272727	95	10821	6	16	89	10805	10916	0.12774085813249605
R1	cpdb	0	network_modules	226	TRUE	8.233452513325734e-6	95	22	6	0.2727272727272727	0.06315789473684211	REAC:R-HSA-168176	REAC	Toll Like Receptor 5 (TLR5) Cascade	10916	2517		0.09523809523809523	0.22727272727272727	95	10821	6	16	89	10805	10916	0.12774085813249605
R1	cpdb	0	network_modules	226	TRUE	1.159194702025094e-5	45	26	5	0.19230769230769232	0.1111111111111111	GO:0051403	GO:BP	stress-activated MAPK cascade	16175	13696		0	0.25	45	16130	5	21	40	16109	16175	0.1443785361774111
R1	cpdb	0	network_modules	226	TRUE	1.1915375031348355e-5	101	22	6	0.2727272727272727	0.0594059405940594	REAC:R-HSA-975138	REAC	TRAF6 mediated induction of NFkB and MAP kinases upon TLR7/8 or 9 activation	10916	2468		0.23809523809523808	0.2727272727272727	101	10815	6	16	95	10799	10916	0.12366486152196593
R1	cpdb	0	network_modules	226	TRUE	1.2644090485107139e-5	102	22	6	0.2727272727272727	0.058823529411764705	REAC:R-HSA-975155	REAC	MyD88 dependent cascade initiated on endosome	10916	1500		0.2857142857142857	0.3181818181818182	102	10814	6	16	96	10798	10916	0.1230200694547796
R1	cpdb	0	network_modules	226	TRUE	1.3409234833983034e-5	103	22	6	0.2727272727272727	0.05825242718446602	REAC:R-HSA-168164	REAC	Toll Like Receptor 3 (TLR3) Cascade	10916	2515		0.3333333333333333	0.4090909090909091	103	10813	6	16	97	10797	10916	0.1223845068197179
R1	cpdb	0	network_modules	226	TRUE	1.3409234833983034e-5	103	22	6	0.2727272727272727	0.05825242718446602	REAC:R-HSA-168181	REAC	Toll Like Receptor 7/8 (TLR7/8) Cascade	10916	2518		0.3333333333333333	0.4090909090909091	103	10813	6	16	97	10797	10916	0.1223845068197179
R1	cpdb	0	network_modules	226	TRUE	1.5937631731545256e-5	106	22	6	0.2727272727272727	0.05660377358490566	REAC:R-HSA-168138	REAC	Toll Like Receptor 9 (TLR9) Cascade	10916	2519		0.42857142857142855	0.45454545454545453	106	10810	6	16	100	10794	10916	0.12053101654765232
R1	cpdb	0	network_modules	226	TRUE	1.6863083299643483e-5	107	22	6	0.2727272727272727	0.056074766355140186	REAC:R-HSA-166166	REAC	MyD88-independent TLR4 cascade 	10916	1501		0.47619047619047616	0.5454545454545454	107	10809	6	16	101	10793	10916	0.11993022839493787
R1	cpdb	0	network_modules	226	TRUE	1.6863083299643483e-5	107	22	6	0.2727272727272727	0.056074766355140186	REAC:R-HSA-937061	REAC	TRIF (TICAM1)-mediated TLR4 signaling 	10916	2471		0.47619047619047616	0.5454545454545454	107	10809	6	16	101	10793	10916	0.11993022839493787
R1	cpdb	0	network_modules	226	TRUE	1.9993972771539603e-5	50	26	5	0.19230769230769232	0.1	GO:0031098	GO:BP	stress-activated protein kinase signaling cascade	16175	7024		0.3333333333333333	0.5	50	16125	5	21	45	16104	16175	0.1367673059403245
R1	cpdb	0	network_modules	226	TRUE	2.2182401239306153e-5	112	22	6	0.2727272727272727	0.05357142857142857	REAC:R-HSA-168188	REAC	Toll Like Receptor TLR6:TLR2 Cascade	10916	2521		0.5714285714285714	0.6363636363636364	112	10804	6	16	106	10788	10916	0.11704551112680608
R1	cpdb	0	network_modules	226	TRUE	2.2182401239306153e-5	112	22	6	0.2727272727272727	0.05357142857142857	REAC:R-HSA-166058	REAC	MyD88:MAL(TIRAP) cascade initiated on plasma membrane	10916	1502		0.5714285714285714	0.6363636363636364	112	10804	6	16	106	10788	10916	0.11704551112680608
R1	cpdb	0	network_modules	226	TRUE	2.5990068771978872e-5	115	22	6	0.2727272727272727	0.05217391304347826	REAC:R-HSA-168179	REAC	Toll Like Receptor TLR1:TLR2 Cascade	10916	2520		0.6666666666666666	0.7272727272727273	115	10801	6	16	109	10785	10916	0.11540381767046903
R1	cpdb	0	network_modules	226	TRUE	2.5990068771978872e-5	115	22	6	0.2727272727272727	0.05217391304347826	REAC:R-HSA-181438	REAC	Toll Like Receptor 2 (TLR2) Cascade	10916	2514		0.6666666666666666	0.7272727272727273	115	10801	6	16	109	10785	10916	0.11540381767046903
R1	cpdb	0	network_modules	226	TRUE	9.520545916801192e-5	143	22	6	0.2727272727272727	0.04195804195804196	REAC:R-HSA-166016	REAC	Toll Like Receptor 4 (TLR4) Cascade	10916	2516		0.7619047619047619	0.7727272727272727	143	10773	6	16	137	10757	10916	0.10261127483334681
R1	cpdb	0	network_modules	226	TRUE	1.0922963689141811e-4	141	26	6	0.23076923076923078	0.0425531914893617	GO:0007254	GO:BP	JNK cascade	16175	2787		0.6666666666666666	0.75	141	16034	6	20	135	16014	16175	0.0958478742342058
R1	cpdb	0	network_modules	226	TRUE	1.2520684938188508e-4	31	22	4	0.18181818181818182	0.12903225806451613	REAC:R-HSA-450282	REAC	MAPK targets/ Nuclear events mediated by MAP kinases	10916	1349		0.8095238095238095	0.8181818181818182	31	10885	4	18	27	10867	10916	0.15114247524712943
R1	cpdb	0	network_modules	226	TRUE	2.1385714183578113e-4	164	22	6	0.2727272727272727	0.036585365853658534	REAC:R-HSA-168898	REAC	Toll-like Receptor Cascades	10916	2522		0.8571428571428571	0.8636363636363636	164	10752	6	16	158	10736	10916	0.09519954447415935
R1	cpdb	0	network_modules	226	TRUE	3.0561228005881476e-4	214	19	6	0.3157894736842105	0.028037383177570093	KEGG:05417	KEGG	Lipid and atherosclerosis	8484	494		0.2222222222222222	0.3	214	8270	6	13	208	8257	8484	0.08779068124507035
R1	cpdb	0	network_modules	226	TRUE	5.722736954500739e-4	194	22	6	0.2727272727272727	0.030927835051546393	REAC:R-HSA-2559583	REAC	Cellular Senescence	10916	331		0.9047619047619048	0.9090909090909091	194	10722	6	16	188	10706	10916	0.08671740660138805
R1	cpdb	0	network_modules	226	TRUE	5.891890734909814e-4	136	19	5	0.2631578947368421	0.03676470588235294	KEGG:05135	KEGG	Yersinia infection	8484	432		0.3333333333333333	0.4	136	8348	5	14	131	8334	8484	0.09322336336888641
R1	cpdb	0	network_modules	226	TRUE	6.327369803508313e-4	138	19	5	0.2631578947368421	0.036231884057971016	KEGG:05418	KEGG	Fluid shear stress and atherosclerosis	8484	495		0.4444444444444444	0.5	138	8346	5	14	133	8332	8484	0.09246816357559545
R1	cpdb	0	network_modules	226	TRUE	0.0013793783070338392	162	19	5	0.2631578947368421	0.030864197530864196	KEGG:05161	KEGG	Hepatitis B	8484	442		0.5555555555555556	0.6	162	8322	5	14	157	8308	8484	0.08448795325915305
R1	cpdb	0	network_modules	226	TRUE	0.003283067398675984	194	19	5	0.2631578947368421	0.02577319587628866	KEGG:05167	KEGG	Kaposi sarcoma-associated herpesvirus infection	8484	448		0.6666666666666666	0.7	194	8290	5	14	189	8276	8484	0.07615947406549617
R1	cpdb	0	network_modules	226	TRUE	0.003558113260900658	22	22	3	0.13636363636363635	0.13636363636363635	REAC:R-HSA-450321	REAC	JNK (c-Jun kinases) phosphorylation and  activation mediated by activated human TAK1	10916	1279		0.9523809523809523	1	22	10894	3	19	19	10875	10916	0.1346195570539246
R1	cpdb	0	network_modules	226	TRUE	0.003558113260900658	22	22	3	0.13636363636363635	0.13636363636363635	REAC:R-HSA-198753	REAC	ERK/MAPK targets	10916	828		0.9523809523809523	1	22	10894	3	19	19	10875	10916	0.1346195570539246
R1	cpdb	0	network_modules	226	TRUE	0.003858378929372795	595	26	8	0.3076923076923077	0.013445378151260505	GO:0000165	GO:BP	MAPK cascade	16175	55		1	1	595	15580	8	18	587	15562	16175	0.0577479267060696
R1	cpdb	0	network_modules	226	TRUE	0.00442535931239757	104	19	4	0.21052631578947367	0.038461538461538464	KEGG:04625	KEGG	C-type lectin receptor signaling pathway	8484	330		0.7777777777777778	0.8	104	8380	4	15	100	8365	8484	0.08536460006280136
R1	cpdb	0	network_modules	226	TRUE	0.005721752794323996	218	19	5	0.2631578947368421	0.022935779816513763	KEGG:05166	KEGG	Human T-cell leukemia virus 1 infection	8484	447		0.8888888888888888	0.9	218	8266	5	14	213	8252	8484	0.07110219517341952
R1	cpdb	0	network_modules	226	TRUE	0.007239949171139809	118	19	4	0.21052631578947367	0.03389830508474576	KEGG:04722	KEGG	Neurotrophin signaling pathway	8484	352		1	1	118	8366	4	15	114	8351	8484	0.07954022920316041
R1	cpdb	0	network_modules	227	TRUE	2.149034396486014e-11	52	27	8	0.2962962962962963	0.15384615384615385	GO:0005977	GO:BP	glycogen metabolic process	16175	1852		0	0.09090909090909091	52	16123	8	19	44	16104	16175	0.2117047227607773
R1	cpdb	0	network_modules	227	TRUE	2.5284358973499312e-11	53	27	8	0.2962962962962963	0.1509433962264151	GO:0044042	GO:BP	glucan metabolic process	16175	10891		0.1	0.18181818181818182	53	16122	8	19	45	16103	16175	0.20966026508188526
R1	cpdb	0	network_modules	227	TRUE	9.554853977199199e-11	62	27	8	0.2962962962962963	0.12903225806451613	GO:0006112	GO:BP	energy reserve metabolic process	16175	1971		0.2	0.2727272727272727	62	16113	8	19	54	16094	16175	0.19353254638020298
R1	cpdb	0	network_modules	227	TRUE	2.4091329986818966e-10	37	27	7	0.25925925925925924	0.1891891891891892	GO:0005978	GO:BP	glycogen biosynthetic process	16175	1853		0.3	0.45454545454545453	37	16138	7	20	30	16118	16175	0.2199512902202457
R1	cpdb	0	network_modules	227	TRUE	2.4091329986818966e-10	37	27	7	0.25925925925925924	0.1891891891891892	GO:0009250	GO:BP	glucan biosynthetic process	16175	3415		0.3	0.45454545454545453	37	16138	7	20	30	16118	16175	0.2199512902202457
R1	cpdb	0	network_modules	227	TRUE	2.978356986813294e-10	71	27	8	0.2962962962962963	0.11267605633802817	GO:0005976	GO:BP	polysaccharide metabolic process	16175	1851		0.5	0.5454545454545454	71	16104	8	19	63	16085	16175	0.18055726483670093
R1	cpdb	0	network_modules	227	TRUE	3.5448889842541094e-9	53	27	7	0.25925925925925924	0.1320754716981132	GO:0000271	GO:BP	polysaccharide biosynthetic process	16175	74		0.6	0.6363636363636364	53	16122	7	20	46	16102	16175	0.1831596689398548
R1	cpdb	0	network_modules	227	TRUE	3.7226277277010174e-9	108	20	8	0.4	0.07407407407407407	KEGG:04931	KEGG	Insulin resistance	8484	388		0	0.16666666666666666	108	8376	8	12	100	8364	8484	0.16792356598744823
R1	cpdb	0	network_modules	227	TRUE	9.88101188798817e-9	14	21	5	0.23809523809523808	0.35714285714285715	REAC:R-HSA-3322077	REAC	Glycogen synthesis	10916	1073		0	0.05555555555555555	14	10902	5	16	9	10886	10916	0.2905008925076168
R1	cpdb	0	network_modules	227	TRUE	1.4803398714645175e-8	15	21	5	0.23809523809523808	0.3333333333333333	REAC:R-HSA-3229121	REAC	Glycogen storage diseases	10916	1072		0.058823529411764705	0.1111111111111111	15	10901	5	16	10	10885	10916	0.2805548257817498
R1	cpdb	0	network_modules	227	TRUE	2.5472334582997824e-8	137	20	8	0.4	0.058394160583941604	KEGG:04910	KEGG	Insulin signaling pathway	8484	367		0.2	0.3333333333333333	137	8347	8	12	129	8335	8484	0.14803557628786132
R1	cpdb	0	network_modules	227	TRUE	2.587213134442863e-7	25	21	5	0.23809523809523808	0.2	REAC:R-HSA-8982491	REAC	Glycogen metabolism	10916	1064		0.11764705882352941	0.16666666666666666	25	10891	5	16	20	10875	10916	0.2165751997709923
R1	cpdb	0	network_modules	227	TRUE	1.1444672762835888e-6	33	21	5	0.23809523809523808	0.15151515151515152	REAC:R-HSA-5663084	REAC	Diseases of carbohydrate metabolism	10916	763		0.17647058823529413	0.2222222222222222	33	10883	5	16	28	10867	10916	0.18798770979694032
R1	cpdb	0	network_modules	227	TRUE	5.286001531555089e-6	147	27	7	0.25925925925925924	0.047619047619047616	GO:0016051	GO:BP	carbohydrate biosynthetic process	16175	5083		0.7	0.7272727272727273	147	16028	7	20	140	16008	16175	0.1077967605087837
R1	cpdb	0	network_modules	227	TRUE	8.342915282478255e-6	252	27	8	0.2962962962962963	0.031746031746031744	GO:0015980	GO:BP	energy derivation by oxidation of organic compounds	16175	5060		0.8	0.8181818181818182	252	15923	8	19	244	15904	16175	0.09268774793346857
R1	cpdb	0	network_modules	227	TRUE	3.947179023062925e-5	25	21	4	0.19047619047619047	0.16	REAC:R-HSA-2173788	REAC	Downregulation of TGF-beta receptor signaling	10916	788		0.23529411764705882	0.2777777777777778	25	10891	4	17	21	10874	10916	0.17283946985331305
R1	cpdb	0	network_modules	227	TRUE	7.968026699543146e-5	36	20	4	0.2	0.1111111111111111	KEGG:00500	KEGG	Starch and sucrose metabolism	8484	62		0.4	0.5	36	8448	4	16	32	8432	8484	0.14639164928254725
R1	cpdb	0	network_modules	227	TRUE	1.0807985964196085e-4	8	21	3	0.14285714285714285	0.375	REAC:R-HSA-9726840	REAC	SHOC2 M1731 mutant abolishes MRAS complex function	10916	2141		0.29411764705882354	0.4444444444444444	8	10908	3	18	5	10890	10916	0.2305739593349801
R1	cpdb	0	network_modules	227	TRUE	1.0807985964196085e-4	8	21	3	0.14285714285714285	0.375	REAC:R-HSA-9726842	REAC	Gain-of-function MRAS complexes activate RAF signaling	10916	1028		0.29411764705882354	0.4444444444444444	8	10908	3	18	5	10890	10916	0.2305739593349801
R1	cpdb	0	network_modules	227	TRUE	1.0807985964196085e-4	8	21	3	0.14285714285714285	0.375	REAC:R-HSA-9660537	REAC	Signaling by MRAS-complex mutants	10916	2271		0.29411764705882354	0.4444444444444444	8	10908	3	18	5	10890	10916	0.2305739593349801
R1	cpdb	0	network_modules	227	TRUE	1.548638433142093e-4	367	27	8	0.2962962962962963	0.021798365122615803	GO:0005975	GO:BP	carbohydrate metabolic process	16175	1850		0.9	0.9090909090909091	367	15808	8	19	359	15789	16175	0.07513156710052178
R1	cpdb	0	network_modules	227	TRUE	1.6191924748631408e-4	9	21	3	0.14285714285714285	0.3333333333333333	REAC:R-HSA-3785653	REAC	Myoclonic epilepsy of Lafora	10916	1503		0.47058823529411764	0.5	9	10907	3	18	6	10889	10916	0.2172570517816213
R1	cpdb	0	network_modules	227	TRUE	1.718351437789702e-4	372	27	8	0.2962962962962963	0.021505376344086023	GO:0006091	GO:BP	generation of precursor metabolites and energy	16175	1954		1	1	372	15803	8	19	364	15784	16175	0.07455242308236762
R1	cpdb	0	network_modules	227	TRUE	2.205944013397169e-4	92	21	5	0.23809523809523808	0.05434782608695652	REAC:R-HSA-170834	REAC	Signaling by TGF-beta Receptor Complex	10916	2308		0.5294117647058824	0.5555555555555556	92	10824	5	16	87	10808	10916	0.11029880511088
R1	cpdb	0	network_modules	227	TRUE	4.960142773376133e-4	46	21	4	0.19047619047619047	0.08695652173913043	REAC:R-HSA-2173789	REAC	TGF-beta receptor signaling activates SMADs	10916	2428		0.5882352941176471	0.6111111111111112	46	10870	4	17	42	10853	10916	0.12623813806760262
R1	cpdb	0	network_modules	227	TRUE	8.961996463755438e-4	122	21	5	0.23809523809523808	0.040983606557377046	REAC:R-HSA-9006936	REAC	Signaling by TGFB family members	10916	2310		0.6470588235294118	0.6666666666666666	122	10794	5	16	117	10778	10916	0.09476746498429615
R1	cpdb	0	network_modules	227	TRUE	0.0011155137831363822	2	21	2	0.09523809523809523	1	REAC:R-HSA-3814836	REAC	Glycogen storage disease type XV (GYG1)	10916	1071		0.7058823529411765	0.8333333333333334	2	10914	2	19	0	10895	10916	0.3083379587911699
R1	cpdb	0	network_modules	227	TRUE	0.0011155137831363822	2	21	2	0.09523809523809523	1	REAC:R-HSA-3828062	REAC	Glycogen storage disease type 0 (muscle GYS1)	10916	1066		0.7058823529411765	0.8333333333333334	2	10914	2	19	0	10895	10916	0.3083379587911699
R1	cpdb	0	network_modules	227	TRUE	0.0011155137831363822	2	21	2	0.09523809523809523	1	REAC:R-HSA-3858516	REAC	Glycogen storage disease type 0 (liver GYS2)	10916	1065		0.7058823529411765	0.8333333333333334	2	10914	2	19	0	10895	10916	0.3083379587911699
R1	cpdb	0	network_modules	227	TRUE	0.0015940294859519244	157	20	5	0.25	0.03184713375796178	KEGG:04390	KEGG	Hippo signaling pathway	8484	310		0.6	0.6666666666666666	157	8327	5	15	152	8312	8484	0.08349770628446947
R1	cpdb	0	network_modules	227	TRUE	0.003342657390845911	3	21	2	0.09523809523809523	0.6666666666666666	REAC:R-HSA-3878781	REAC	Glycogen storage disease type IV (GBE1)	10916	1068		0.8823529411764706	0.8888888888888888	3	10913	2	19	1	10894	10916	0.25152578306476736
R1	cpdb	0	network_modules	227	TRUE	0.0038297198916125894	24	21	3	0.14285714285714285	0.125	REAC:R-HSA-163560	REAC	Triglyceride catabolism	10916	2606		0.9411764705882353	0.9444444444444444	24	10892	3	18	21	10874	10916	0.1318457729520745
R1	cpdb	0	network_modules	227	TRUE	0.003936350230600984	288	21	6	0.2857142857142857	0.020833333333333332	REAC:R-HSA-71387	REAC	Metabolism of carbohydrates	10916	1422		1	1	288	10628	6	15	282	10613	10916	0.07103820300033235
R1	cpdb	0	network_modules	227	TRUE	0.005332150669505349	202	20	5	0.25	0.024752475247524754	KEGG:05415	KEGG	Diabetic cardiomyopathy	8484	492		0.8	0.8333333333333334	202	8282	5	15	197	8267	8484	0.07212051967185862
R1	cpdb	0	network_modules	227	TRUE	0.005718606279308709	205	20	5	0.25	0.024390243902439025	KEGG:05205	KEGG	Proteoglycans in cancer	8484	457		1	1	205	8279	5	15	200	8264	8484	0.0714918941042806
R1	cpdb	0	network_modules	228	TRUE	1.9427945740360192e-11	75	16	8	0.5	0.10666666666666667	KEGG:04918	KEGG	Thyroid hormone synthesis	8484	375		0	0.037037037037037035	75	8409	8	8	67	8401	8484	0.228081604345014
R1	cpdb	0	network_modules	228	TRUE	5.266866365114324e-9	85	16	7	0.4375	0.08235294117647059	KEGG:04911	KEGG	Insulin secretion	8484	368		0.038461538461538464	0.07407407407407407	85	8399	7	9	78	8390	8484	0.18657950342785615
R1	cpdb	0	network_modules	228	TRUE	1.4583576922796528e-8	98	16	7	0.4375	0.07142857142857142	KEGG:04925	KEGG	Aldosterone synthesis and secretion	8484	382		0.07692307692307693	0.1111111111111111	98	8386	7	9	91	8377	8484	0.17327551745199474
R1	cpdb	0	network_modules	228	TRUE	3.3915886571454835e-7	153	16	7	0.4375	0.0457516339869281	KEGG:04261	KEGG	Adrenergic signaling in cardiomyocytes	8484	297		0.11538461538461539	0.14814814814814814	153	8331	7	9	146	8322	8484	0.13701646675308238
R1	cpdb	0	network_modules	228	TRUE	5.509093081225255e-7	164	16	7	0.4375	0.042682926829268296	KEGG:04022	KEGG	cGMP-PKG signaling pathway	8484	251		0.15384615384615385	0.18518518518518517	164	8320	7	9	157	8311	8484	0.13201977498648473
R1	cpdb	0	network_modules	228	TRUE	4.636047643467438e-6	223	16	7	0.4375	0.03139013452914798	KEGG:04024	KEGG	cAMP signaling pathway	8484	252		0.19230769230769232	0.2222222222222222	223	8261	7	9	216	8252	8484	0.1117302250528957
R1	cpdb	0	network_modules	228	TRUE	1.0669993319316446e-4	49	16	4	0.25	0.08163265306122448	KEGG:05030	KEGG	Cocaine addiction	8484	418		0.23076923076923078	0.25925925925925924	49	8435	4	12	45	8423	8484	0.1400937415177388
R1	cpdb	0	network_modules	228	TRUE	1.4822665818691074e-4	9	20	3	0.15	0.3333333333333333	REAC:R-HSA-8874211	REAC	CREB3 factors activate genes	10916	286		0	0.5	9	10907	3	17	6	10890	10916	0.22267354999920771
R1	cpdb	0	network_modules	228	TRUE	3.145681603701791e-4	64	16	4	0.25	0.0625	KEGG:04927	KEGG	Cortisol synthesis and secretion	8484	384		0.2692307692307692	0.2962962962962963	64	8420	4	12	60	8408	8484	0.12180295527580326
R1	cpdb	0	network_modules	228	TRUE	4.2558085263428387e-4	69	16	4	0.25	0.057971014492753624	KEGG:05031	KEGG	Amphetamine addiction	8484	419		0.3076923076923077	0.3333333333333333	69	8415	4	12	65	8403	8484	0.1170564415227
R1	cpdb	0	network_modules	228	TRUE	5.983750011687414e-4	23	16	3	0.1875	0.13043478260869565	KEGG:04964	KEGG	Proximal tubule bicarbonate reclamation	8484	399		0.34615384615384615	0.37037037037037035	23	8461	3	13	20	8448	8484	0.15447976872054858
R1	cpdb	0	network_modules	228	TRUE	0.0011107166360677365	187	16	5	0.3125	0.026737967914438502	KEGG:05034	KEGG	Alcoholism	8484	422		0.38461538461538464	0.4074074074074074	187	8297	5	11	182	8286	8484	0.08599495697949046
R1	cpdb	0	network_modules	228	TRUE	0.0011749518642782415	89	16	4	0.25	0.0449438202247191	KEGG:04211	KEGG	Longevity regulating pathway	8484	288		0.4230769230769231	0.4444444444444444	89	8395	4	12	85	8383	8484	0.1021851805703158
R1	cpdb	0	network_modules	228	TRUE	0.001652232337180095	97	16	4	0.25	0.041237113402061855	KEGG:05215	KEGG	Prostate cancer	8484	466		0.46153846153846156	0.48148148148148145	97	8387	4	12	93	8375	8484	0.0975418270735957
R1	cpdb	0	network_modules	228	TRUE	0.0022588228160006028	105	16	4	0.25	0.0380952380952381	KEGG:04928	KEGG	Parathyroid hormone synthesis, secretion and action	8484	385		0.5	0.5185185185185185	105	8379	4	12	101	8367	8484	0.09342634303223506
R1	cpdb	0	network_modules	228	TRUE	0.002329522131005491	218	16	5	0.3125	0.022935779816513763	KEGG:05166	KEGG	Human T-cell leukemia virus 1 infection	8484	447		0.5384615384615384	0.5555555555555556	218	8266	5	11	213	8255	8484	0.07879167833101404
R1	cpdb	0	network_modules	228	TRUE	0.002433019159163842	107	16	4	0.25	0.037383177570093455	KEGG:04922	KEGG	Glucagon signaling pathway	8484	379		0.5769230769230769	0.5925925925925926	107	8377	4	12	103	8365	8484	0.09246830276162256
R1	cpdb	0	network_modules	228	TRUE	0.002583323692936051	37	16	3	0.1875	0.08108108108108109	KEGG:04960	KEGG	Aldosterone-regulated sodium reabsorption	8484	396		0.6153846153846154	0.6296296296296297	37	8447	3	13	34	8434	8484	0.12080880798354592
R1	cpdb	0	network_modules	228	TRUE	0.003014936326148593	113	16	4	0.25	0.035398230088495575	KEGG:04668	KEGG	TNF signaling pathway	8484	342		0.6538461538461539	0.7037037037037037	113	8371	4	12	109	8359	8484	0.08974399168379095
R1	cpdb	0	network_modules	228	TRUE	0.003014936326148593	113	16	4	0.25	0.035398230088495575	KEGG:04725	KEGG	Cholinergic synapse	8484	355		0.6538461538461539	0.7037037037037037	113	8371	4	12	109	8359	8484	0.08974399168379095
R1	cpdb	0	network_modules	228	TRUE	0.003815919602468806	120	16	4	0.25	0.03333333333333333	KEGG:04935	KEGG	Growth hormone synthesis, secretion and action	8484	392		0.7307692307692307	0.7407407407407407	120	8364	4	12	116	8352	8484	0.0868198478065531
R1	cpdb	0	network_modules	228	TRUE	0.0043679518402388534	44	16	3	0.1875	0.06818181818181818	KEGG:04962	KEGG	Vasopressin-regulated water reabsorption	8484	398		0.7692307692307693	0.7777777777777778	44	8440	3	13	41	8427	8484	0.11032962188422568
R1	cpdb	0	network_modules	228	TRUE	0.0050620109123938216	129	16	4	0.25	0.031007751937984496	KEGG:04926	KEGG	Relaxin signaling pathway	8484	383		0.8076923076923077	0.8148148148148148	129	8355	4	12	125	8343	8484	0.08340475644254185
R1	cpdb	0	network_modules	228	TRUE	0.005329369969977046	47	16	3	0.1875	0.06382978723404255	KEGG:04973	KEGG	Carbohydrate digestion and absorption	8484	404		0.8461538461538461	0.8518518518518519	47	8437	3	13	44	8424	8484	0.10656229954922701
R1	cpdb	0	network_modules	228	TRUE	0.005374937441689823	131	16	4	0.25	0.030534351145038167	KEGG:04728	KEGG	Dopaminergic synapse	8484	358		0.8846153846153846	0.8888888888888888	131	8353	4	12	127	8341	8484	0.08269243004513013
R1	cpdb	0	network_modules	228	TRUE	0.006218887038763601	136	16	4	0.25	0.029411764705882353	KEGG:04915	KEGG	Estrogen signaling pathway	8484	372		0.9230769230769231	0.9259259259259259	136	8348	4	12	132	8336	8484	0.08097843949199907
R1	cpdb	0	network_modules	228	TRUE	0.006974921103044978	92	20	4	0.2	0.043478260869565216	REAC:R-HSA-381119	REAC	Unfolded Protein Response (UPR)	10916	2624		1	1	92	10824	4	16	88	10808	10916	0.08978198753849509
R1	cpdb	0	network_modules	228	TRUE	0.007646405720044567	53	16	3	0.1875	0.05660377358490566	KEGG:04961	KEGG	Endocrine and other factor-regulated calcium reabsorption	8484	397		0.9615384615384616	0.9629629629629629	53	8431	3	13	50	8418	8484	0.09999489366414151
R1	cpdb	0	network_modules	228	TRUE	0.009818959584523196	153	16	4	0.25	0.026143790849673203	KEGG:04934	KEGG	Cushing syndrome	8484	391		1	1	153	8331	4	12	149	8319	8484	0.0757705392539701
R1	cpdb	0	network_modules	229	TRUE	8.091222833914851e-4	27	15	3	0.2	0.1111111111111111	KEGG:05310	KEGG	Asthma	8484	481		NA	1	27	8457	3	12	24	8445	8484	0.14706318670281238
R1	cpdb	0	network_modules	229	TRUE	0.004101533137935027	3	17	2	0.11764705882352941	0.6666666666666666	GO:0016068	GO:BP	type I hypersensitivity	16175	5096		0	0.5	3	16172	2	15	1	16157	16175	0.27978750803920066
R1	cpdb	0	network_modules	229	TRUE	0.00803672324036974	756	17	7	0.4117647058823529	0.009259259259259259	GO:0050776	GO:BP	regulation of immune response	16175	13250		1	1	756	15419	7	10	749	15409	16175	0.05609312559065015
R1	cpdb	0	network_modules	230	TRUE	5.518365450705189e-5	155	19	6	0.3157894736842105	0.03870967741935484	REAC:R-HSA-9013148	REAC	CDC42 GTPase cycle	10916	269		0	0.3333333333333333	155	10761	6	13	149	10748	10916	0.10644170350266584
R1	cpdb	0	network_modules	230	TRUE	1.2426250958134626e-4	449	19	8	0.42105263157894735	0.017817371937639197	REAC:R-HSA-9012999	REAC	RHO GTPase cycle	10916	1847		0.5	0.6666666666666666	449	10467	8	11	441	10456	10916	0.07988130010706962
R1	cpdb	0	network_modules	230	TRUE	1.5223192658193866e-4	184	19	6	0.3157894736842105	0.03260869565217391	REAC:R-HSA-9013149	REAC	RAC1 GTPase cycle	10916	1836		1	1	184	10732	6	13	178	10719	10916	0.09696436776235932
R1	cpdb	0	network_modules	230	TRUE	5.213482768961655e-4	48	8	3	0.375	0.0625	KEGG:00330	KEGG	Arginine and proline metabolism	8484	36		NA	1	48	8436	3	5	45	8431	8484	0.1512830648411892
R1	cpdb	0	network_modules	231	TRUE	9.170794596307162e-9	25	28	6	0.21428571428571427	0.24	REAC:R-HSA-8982491	REAC	Glycogen metabolism	10916	1064		0	0.25	25	10891	6	22	19	10869	10916	0.22490092497775127
R1	cpdb	0	network_modules	231	TRUE	1.7132304728205503e-8	288	28	11	0.39285714285714285	0.03819444444444445	REAC:R-HSA-71387	REAC	Metabolism of carbohydrates	10916	1422		0.3333333333333333	0.5	288	10628	11	17	277	10611	10916	0.11595499545559321
R1	cpdb	0	network_modules	231	TRUE	1.87343618500483e-8	107	24	8	0.3333333333333333	0.07476635514018691	KEGG:04922	KEGG	Glucagon signaling pathway	8484	379		0	0.09090909090909091	107	8377	8	16	99	8361	8484	0.1530780194291554
R1	cpdb	0	network_modules	231	TRUE	5.0026093426486e-8	14	28	5	0.17857142857142858	0.35714285714285715	REAC:R-HSA-70221	REAC	Glycogen breakdown (glycogenolysis)	10916	1063		0.6666666666666666	0.75	14	10902	5	23	9	10879	10916	0.2512076979449383
R1	cpdb	0	network_modules	231	TRUE	5.536182382556034e-8	367	31	11	0.3548387096774194	0.02997275204359673	GO:0005975	GO:BP	carbohydrate metabolic process	16175	1850		0	0.037037037037037035	367	15808	11	20	356	15788	16175	0.09774206377487168
R1	cpdb	0	network_modules	231	TRUE	8.406883498384905e-8	123	31	8	0.25806451612903225	0.06504065040650407	GO:0016052	GO:BP	carbohydrate catabolic process	16175	5084		0.038461538461538464	0.07407407407407407	123	16052	8	23	115	16029	16175	0.1263400759388781
R1	cpdb	0	network_modules	231	TRUE	1.3629400609584882e-6	32	24	5	0.20833333333333334	0.15625	KEGG:00052	KEGG	Galactose metabolism	8484	7		0.1	0.18181818181818182	32	8452	5	19	27	8433	8484	0.17774210695660503
R1	cpdb	0	network_modules	231	TRUE	1.4703794388086798e-6	372	31	10	0.3225806451612903	0.026881720430107527	GO:0006091	GO:BP	generation of precursor metabolites and energy	16175	1954		0.07692307692307693	0.1111111111111111	372	15803	10	21	362	15782	16175	0.08757785703763063
R1	cpdb	0	network_modules	231	TRUE	2.532502250997867e-6	36	24	5	0.20833333333333334	0.1388888888888889	KEGG:00500	KEGG	Starch and sucrose metabolism	8484	62		0.2	0.2727272727272727	36	8448	5	19	31	8429	8484	0.16723020888784992
R1	cpdb	0	network_modules	231	TRUE	5.0111918198853515e-6	11	31	4	0.12903225806451613	0.36363636363636365	GO:0006002	GO:BP	fructose 6-phosphate metabolic process	16175	1877		0.11538461538461539	0.14814814814814814	11	16164	4	27	7	16137	16175	0.2157506449565878
R1	cpdb	0	network_modules	231	TRUE	6.8496961296825e-6	34	31	5	0.16129032258064516	0.14705882352941177	GO:0019320	GO:BP	hexose catabolic process	16175	5683		0.15384615384615385	0.18518518518518517	34	16141	5	26	29	16115	16175	0.1523091749897457
R1	cpdb	0	network_modules	231	TRUE	1.068717565078752e-5	37	31	5	0.16129032258064516	0.13513513513513514	GO:0046365	GO:BP	monosaccharide catabolic process	16175	12096		0.19230769230769232	0.2222222222222222	37	16138	5	26	32	16112	16175	0.1458474132454226
R1	cpdb	0	network_modules	231	TRUE	2.7453401424471503e-5	16	31	4	0.12903225806451613	0.25	GO:0006735	GO:BP	NADH regeneration	16175	2436		0.23076923076923078	0.3333333333333333	16	16159	4	27	12	16132	16175	0.17848775739942768
R1	cpdb	0	network_modules	231	TRUE	2.7453401424471503e-5	16	31	4	0.12903225806451613	0.25	GO:0061621	GO:BP	canonical glycolysis	16175	15590		0.23076923076923078	0.3333333333333333	16	16159	4	27	12	16132	16175	0.17848775739942768
R1	cpdb	0	network_modules	231	TRUE	2.7453401424471503e-5	16	31	4	0.12903225806451613	0.25	GO:0061718	GO:BP	glucose catabolic process to pyruvate	16175	15628		0.23076923076923078	0.3333333333333333	16	16159	4	27	12	16132	16175	0.17848775739942768
R1	cpdb	0	network_modules	231	TRUE	3.585265105467106e-5	17	31	4	0.12903225806451613	0.23529411764705882	GO:0061615	GO:BP	glycolytic process through fructose-6-phosphate	16175	15586		0.34615384615384615	0.4074074074074074	17	16158	4	27	13	16131	16175	0.17308030765138657
R1	cpdb	0	network_modules	231	TRUE	3.585265105467106e-5	17	31	4	0.12903225806451613	0.23529411764705882	GO:0061620	GO:BP	glycolytic process through glucose-6-phosphate	16175	15589		0.34615384615384615	0.4074074074074074	17	16158	4	27	13	16131	16175	0.17308030765138657
R1	cpdb	0	network_modules	231	TRUE	5.82327343409275e-5	19	31	4	0.12903225806451613	0.21052631578947367	GO:0006007	GO:BP	glucose catabolic process	16175	1882		0.4230769230769231	0.48148148148148145	19	16156	4	27	15	16129	16175	0.16356953043991923
R1	cpdb	0	network_modules	231	TRUE	5.82327343409275e-5	19	31	4	0.12903225806451613	0.21052631578947367	GO:0019677	GO:BP	NAD catabolic process	16175	5995		0.4230769230769231	0.48148148148148145	19	16156	4	27	15	16129	16175	0.16356953043991923
R1	cpdb	0	network_modules	231	TRUE	6.245095004507453e-5	52	31	5	0.16129032258064516	0.09615384615384616	GO:0005977	GO:BP	glycogen metabolic process	16175	1852		0.5	0.5185185185185185	52	16123	5	26	47	16097	16175	0.12236563988949499
R1	cpdb	0	network_modules	231	TRUE	6.886379865208175e-5	53	31	5	0.16129032258064516	0.09433962264150944	GO:0044042	GO:BP	glucan metabolic process	16175	10891		0.5384615384615384	0.5555555555555556	53	16122	5	26	48	16096	16175	0.1211621033789035
R1	cpdb	0	network_modules	231	TRUE	1.0077714976190104e-4	74	24	5	0.20833333333333334	0.06756756756756757	KEGG:01230	KEGG	Biosynthesis of amino acids	8484	188		0.3	0.36363636363636365	74	8410	5	19	69	8391	8484	0.11433831363377438
R1	cpdb	0	network_modules	231	TRUE	1.031654464802363e-4	137	24	6	0.25	0.043795620437956206	KEGG:04910	KEGG	Insulin signaling pathway	8484	367		0.4	0.45454545454545453	137	8347	6	18	131	8329	8484	0.09881812673086766
R1	cpdb	0	network_modules	231	TRUE	1.3226533058591388e-4	34	24	4	0.16666666666666666	0.11764705882352941	KEGG:00051	KEGG	Fructose and mannose metabolism	8484	6		0.5	0.5454545454545454	34	8450	4	20	30	8430	8484	0.13712975899585117
R1	cpdb	0	network_modules	231	TRUE	1.5342055915332472e-4	62	31	5	0.16129032258064516	0.08064516129032258	GO:0006112	GO:BP	energy reserve metabolic process	16175	1971		0.5769230769230769	0.5925925925925926	62	16113	5	26	57	16087	16175	0.1116601397366097
R1	cpdb	0	network_modules	231	TRUE	2.6086573192878737e-4	27	31	4	0.12903225806451613	0.14814814814814814	GO:0006734	GO:BP	NADH metabolic process	16175	2435		0.6153846153846154	0.6296296296296297	27	16148	4	27	23	16121	16175	0.13671672362323156
R1	cpdb	0	network_modules	231	TRUE	3.049822781913359e-4	71	31	5	0.16129032258064516	0.07042253521126761	GO:0005976	GO:BP	polysaccharide metabolic process	16175	1851		0.6538461538461539	0.6666666666666666	71	16104	5	26	66	16078	16175	0.10400369159282653
R1	cpdb	0	network_modules	231	TRUE	6.844211317210239e-4	109	24	5	0.20833333333333334	0.045871559633027525	KEGG:04066	KEGG	HIF-1 signaling pathway	8484	257		0.6	0.6363636363636364	109	8375	5	19	104	8356	8484	0.09245496922385539
R1	cpdb	0	network_modules	231	TRUE	7.378869745449136e-4	9	31	3	0.0967741935483871	0.3333333333333333	GO:0030388	GO:BP	fructose 1,6-bisphosphate metabolic process	16175	6785		0.6923076923076923	0.7037037037037037	9	16166	3	28	6	16138	16175	0.17879375653184976
R1	cpdb	0	network_modules	231	TRUE	8.890413672366116e-4	115	24	5	0.20833333333333334	0.043478260869565216	KEGG:01200	KEGG	Carbon metabolism	8484	184		0.7	0.7272727272727273	115	8369	5	19	110	8350	8484	0.08971730168750879
R1	cpdb	0	network_modules	231	TRUE	0.0010527557327575444	10	31	3	0.0967741935483871	0.3	GO:0005980	GO:BP	glycogen catabolic process	16175	1855		0.7307692307692307	0.7407407407407407	10	16165	3	28	7	16137	16175	0.16951490682277326
R1	cpdb	0	network_modules	231	TRUE	0.001445659935609165	11	31	3	0.0967741935483871	0.2727272727272727	GO:0000272	GO:BP	polysaccharide catabolic process	16175	75		0.7692307692307693	0.8148148148148148	11	16164	3	28	8	16136	16175	0.1615272001831636
R1	cpdb	0	network_modules	231	TRUE	0.001445659935609165	11	31	3	0.0967741935483871	0.2727272727272727	GO:0009251	GO:BP	glucan catabolic process	16175	3416		0.7692307692307693	0.8148148148148148	11	16164	3	28	8	16136	16175	0.1615272001831636
R1	cpdb	0	network_modules	231	TRUE	0.001754809379958621	300	31	7	0.22580645161290322	0.023333333333333334	GO:0044282	GO:BP	small molecule catabolic process	16175	10949		0.8461538461538461	0.8518518518518519	300	15875	7	24	293	15851	16175	0.06731566143532113
R1	cpdb	0	network_modules	231	TRUE	0.002053829175535343	67	24	4	0.16666666666666666	0.05970149253731343	KEGG:00010	KEGG	Glycolysis / Gluconeogenesis	8484	2		0.8	0.8181818181818182	67	8417	4	20	63	8397	8484	0.09553708148896829
R1	cpdb	0	network_modules	231	TRUE	0.0024429787944733735	70	24	4	0.16666666666666666	0.05714285714285714	KEGG:05230	KEGG	Central carbon metabolism in cancer	8484	478		0.9	0.9090909090909091	70	8414	4	20	66	8394	8484	0.09327589700498445
R1	cpdb	0	network_modules	231	TRUE	0.0048833012831647725	55	31	4	0.12903225806451613	0.07272727272727272	GO:0019674	GO:BP	NAD metabolic process	16175	5993		0.8846153846153846	0.8888888888888888	55	16120	4	27	51	16093	16175	0.09457052400565402
R1	cpdb	0	network_modules	231	TRUE	0.005201499278149621	31	24	3	0.125	0.0967741935483871	KEGG:00030	KEGG	Pentose phosphate pathway	8484	4		1	1	31	8453	3	21	28	8432	8484	0.10711751990440231
R1	cpdb	0	network_modules	231	TRUE	0.008398008154656375	68	28	4	0.14285714285714285	0.058823529411764705	REAC:R-HSA-70171	REAC	Glycolysis	10916	1074		1	1	68	10848	4	24	64	10824	10916	0.08805988695565897
R1	cpdb	0	network_modules	231	TRUE	0.008859838847230326	247	31	6	0.1935483870967742	0.024291497975708502	GO:0006520	GO:BP	amino acid metabolic process	16175	2241		0.9230769230769231	0.9259259259259259	247	15928	6	25	241	15903	16175	0.06370712269508991
R1	cpdb	0	network_modules	231	TRUE	0.009651900058666597	742	31	9	0.2903225806451613	0.012129380053908356	GO:0019752	GO:BP	carboxylic acid metabolic process	16175	6036		0.9615384615384616	0.9629629629629629	742	15433	9	22	733	15411	16175	0.051201332508026054
R1	cpdb	0	network_modules	231	TRUE	0.009937588176639686	252	31	6	0.1935483870967742	0.023809523809523808	GO:0015980	GO:BP	energy derivation by oxidation of organic compounds	16175	5060		1	1	252	15923	6	25	246	15898	16175	0.06297246432117037
R1	cpdb	0	network_modules	232	TRUE	1.4869310920146797e-16	414	26	16	0.6153846153846154	0.03864734299516908	GO:0061061	GO:BP	muscle structure development	16175	15177		0	0.043478260869565216	414	15761	16	10	398	15751	16175	0.14985221704659968
R1	cpdb	0	network_modules	232	TRUE	2.2858400458848436e-13	96	26	10	0.38461538461538464	0.10416666666666667	GO:0032989	GO:BP	cellular anatomical entity morphogenesis	16175	7969		0.045454545454545456	0.13043478260869565	96	16079	10	16	86	16063	16175	0.19781796232550883
R1	cpdb	0	network_modules	232	TRUE	2.2858400458848436e-13	96	26	10	0.38461538461538464	0.10416666666666667	GO:0010927	GO:BP	cellular component assembly involved in morphogenesis	16175	4511		0.045454545454545456	0.13043478260869565	96	16079	10	16	86	16063	16175	0.19781796232550883
R1	cpdb	0	network_modules	232	TRUE	2.49566975330538e-13	59	26	9	0.34615384615384615	0.15254237288135594	GO:0030239	GO:BP	myofibril assembly	16175	6736		0.13636363636363635	0.17391304347826086	59	16116	9	17	50	16099	16175	0.22796700908815906
R1	cpdb	0	network_modules	232	TRUE	1.9359834118245407e-12	118	26	10	0.38461538461538464	0.0847457627118644	GO:0055001	GO:BP	muscle cell development	16175	14190		0.18181818181818182	0.21739130434782608	118	16057	10	16	108	16041	16175	0.17790779089353875
R1	cpdb	0	network_modules	232	TRUE	2.457610843817689e-11	708	26	15	0.5769230769230769	0.0211864406779661	GO:0030029	GO:BP	actin filament-based process	16175	6653		0.22727272727272727	0.2608695652173913	708	15467	15	11	693	15456	16175	0.10456573020986971
R1	cpdb	0	network_modules	232	TRUE	4.7804704611584245e-11	103	26	9	0.34615384615384615	0.08737864077669903	GO:0055002	GO:BP	striated muscle cell development	16175	14191		0.2727272727272727	0.30434782608695654	103	16072	9	17	94	16055	16175	0.17139969539276337
R1	cpdb	0	network_modules	232	TRUE	8.32774510136164e-11	34	26	7	0.2692307692307692	0.20588235294117646	GO:0045214	GO:BP	sarcomere organization	16175	11327		0.3181818181818182	0.34782608695652173	34	16141	7	19	27	16122	16175	0.23403139259719757
R1	cpdb	0	network_modules	232	TRUE	8.440655679289435e-11	250	26	11	0.4230769230769231	0.044	GO:0042692	GO:BP	muscle cell differentiation	16175	10302		0.36363636363636365	0.391304347826087	250	15925	11	15	239	15910	16175	0.13258822055224476
R1	cpdb	0	network_modules	232	TRUE	1.458589746921419e-10	632	26	14	0.5384615384615384	0.022151898734177215	GO:0030036	GO:BP	actin cytoskeleton organization	16175	6660		0.4090909090909091	0.43478260869565216	632	15543	14	12	618	15531	16175	0.10341203023300646
R1	cpdb	0	network_modules	232	TRUE	5.516317015255776e-9	173	26	9	0.34615384615384615	0.05202312138728324	GO:0031032	GO:BP	actomyosin structure organization	16175	7004		0.45454545454545453	0.4782608695652174	173	16002	9	17	164	15985	16175	0.13085386052710432
R1	cpdb	0	network_modules	232	TRUE	6.12090577462213e-9	175	26	9	0.34615384615384615	0.05142857142857143	GO:0051146	GO:BP	striated muscle cell differentiation	16175	13529		0.5	0.5217391304347826	175	16000	9	17	166	15983	16175	0.1300641483235233
R1	cpdb	0	network_modules	232	TRUE	8.724965648001107e-9	182	26	9	0.34615384615384615	0.04945054945054945	GO:0007517	GO:BP	muscle organ development	16175	2999		0.5454545454545454	0.5652173913043478	182	15993	9	17	173	15976	16175	0.12740166777169218
R1	cpdb	0	network_modules	232	TRUE	3.301308989114282e-8	748	26	13	0.5	0.017379679144385027	GO:0097435	GO:BP	supramolecular fiber organization	16175	18657		0.5909090909090909	0.6086956521739131	748	15427	13	13	735	15414	16175	0.08669395037141796
R1	cpdb	0	network_modules	232	TRUE	2.4665244646990896e-6	343	26	9	0.34615384615384615	0.026239067055393587	GO:0140694	GO:BP	membraneless organelle assembly	16175	19860		0.6363636363636364	0.6521739130434783	343	15832	9	17	334	15815	16175	0.09050184660167862
R1	cpdb	0	network_modules	232	TRUE	1.4403035052417402e-5	36	12	4	0.3333333333333333	0.1111111111111111	REAC:R-HSA-390522	REAC	Striated Muscle Contraction	10916	2356		0	0.5	36	10880	4	8	32	10872	10916	0.19096601470384308
R1	cpdb	0	network_modules	232	TRUE	1.4756627270369136e-5	770	26	11	0.4230769230769231	0.014285714285714285	GO:0048646	GO:BP	anatomical structure formation involved in morphogenesis	16175	12904		0.6818181818181818	0.6956521739130435	770	15405	11	15	759	15390	16175	0.07075549552495408
R1	cpdb	0	network_modules	232	TRUE	2.23784990623889e-5	303	26	8	0.3076923076923077	0.026402640264026403	GO:0003012	GO:BP	muscle system process	16175	1463		0.7272727272727273	0.7391304347826086	303	15872	8	18	295	15854	16175	0.08551814572872286
R1	cpdb	0	network_modules	232	TRUE	3.775527863861459e-5	207	26	7	0.2692307692307692	0.033816425120772944	GO:0014706	GO:BP	striated muscle tissue development	16175	4643		0.7727272727272727	0.782608695652174	207	15968	7	19	200	15949	16175	0.09154234528240339
R1	cpdb	0	network_modules	232	TRUE	5.922093197042092e-5	221	26	7	0.2692307692307692	0.03167420814479638	GO:0060537	GO:BP	muscle tissue development	16175	14726		0.8181818181818182	0.8260869565217391	221	15954	7	19	214	15935	16175	0.08833507764008432
R1	cpdb	0	network_modules	232	TRUE	2.917810495646966e-4	97	11	4	0.36363636363636365	0.041237113402061855	KEGG:05410	KEGG	Hypertrophic cardiomyopathy	8484	489		0	0.5	97	8387	4	7	93	8380	8484	0.11936647170775842
R1	cpdb	0	network_modules	232	TRUE	3.5667714108525856e-4	102	11	4	0.36363636363636365	0.0392156862745098	KEGG:05414	KEGG	Dilated cardiomyopathy	8484	491		1	1	102	8382	4	7	98	8375	8484	0.11624393791893836
R1	cpdb	0	network_modules	232	TRUE	0.003430526248101933	17	26	3	0.11538461538461539	0.17647058823529413	GO:0055003	GO:BP	cardiac myofibril assembly	16175	14192		0.8636363636363636	0.8695652173913043	17	16158	3	23	14	16135	16175	0.14158387767899894
R1	cpdb	0	network_modules	232	TRUE	0.003450794777497106	2	26	2	0.07692307692307693	1	GO:0043503	GO:BP	skeletal muscle fiber adaptation	16175	10741		0.9090909090909091	0.9130434782608695	2	16173	2	24	0	16149	16175	0.27714423421480233
R1	cpdb	0	network_modules	232	TRUE	0.00380100012755407	258	26	6	0.23076923076923078	0.023255813953488372	GO:0006936	GO:BP	muscle contraction	16175	2575		0.9545454545454546	0.9565217391304348	258	15917	6	20	252	15897	16175	0.06880020755566646
R1	cpdb	0	network_modules	232	TRUE	0.007727800711620386	22	26	3	0.11538461538461539	0.13636363636363635	GO:0014888	GO:BP	striated muscle adaptation	16175	4764		1	1	22	16153	3	23	19	16130	16175	0.12414189032667687
R1	cpdb	0	network_modules	232	TRUE	0.009486506111647216	59	12	3	0.25	0.05084745762711865	REAC:R-HSA-3000171	REAC	Non-integrin membrane-ECM interactions	10916	1603		1	1	59	10857	3	9	56	10848	10916	0.11066952303953095
R1	cpdb	0	network_modules	233	TRUE	7.256034238089633e-12	92	19	9	0.47368421052631576	0.09782608695652174	KEGG:04640	KEGG	Hematopoietic cell lineage	8484	333		0	0.5	92	8392	9	10	83	8382	8484	0.21172320771166608
R1	cpdb	0	network_modules	233	TRUE	4.526213216412858e-5	81	19	5	0.2631578947368421	0.06172839506172839	KEGG:04662	KEGG	B cell receptor signaling pathway	8484	339		1	1	81	8403	5	14	76	8389	8484	0.12355819000536934
R1	cpdb	0	network_modules	233	TRUE	0.0011249079895029898	236	23	6	0.2608695652173913	0.025423728813559324	GO:0070661	GO:BP	leukocyte proliferation	16175	16242		0	0.14285714285714285	236	15939	6	17	230	15922	16175	0.07750614917817927
R1	cpdb	0	network_modules	233	TRUE	0.002554117226310345	17	23	3	0.13043478260869565	0.17647058823529413	GO:0050855	GO:BP	regulation of B cell receptor signaling pathway	16175	13303		0.16666666666666666	0.2857142857142857	17	16158	3	20	14	16138	16175	0.15068034991580065
R1	cpdb	0	network_modules	233	TRUE	0.0025874516992498466	147	23	5	0.21739130434782608	0.034013605442176874	GO:0019724	GO:BP	B cell mediated immunity	16175	6019		0.3333333333333333	0.42857142857142855	147	16028	5	18	142	16010	16175	0.0828309558747512
R1	cpdb	0	network_modules	233	TRUE	0.005514040857390643	27	21	3	0.14285714285714285	0.1111111111111111	REAC:R-HSA-3000170	REAC	Syndecan interactions	10916	2367		0	0.5	27	10889	3	18	24	10871	10916	0.12407960141264007
R1	cpdb	0	network_modules	233	TRUE	0.005642090175856925	76	23	4	0.17391304347826086	0.05263157894736842	GO:0042100	GO:BP	B cell proliferation	16175	9966		0.5	0.5714285714285714	76	16099	4	19	72	16080	16175	0.09337405402441767
R1	cpdb	0	network_modules	233	TRUE	0.007625315185891984	30	21	3	0.14285714285714285	0.1	REAC:R-HSA-3000157	REAC	Laminin interactions	10916	1303		1	1	30	10886	3	18	27	10868	10916	0.11749798984366094
R1	cpdb	0	network_modules	233	TRUE	0.008425307479274191	334	23	6	0.2608695652173913	0.017964071856287425	GO:0002443	GO:BP	leukocyte mediated immunity	16175	966		0.6666666666666666	0.7142857142857143	334	15841	6	17	328	15824	16175	0.06374416512757984
R1	cpdb	0	network_modules	233	TRUE	0.008575044865241972	25	23	3	0.13043478260869565	0.12	GO:0002455	GO:BP	humoral immune response mediated by circulating immunoglobulin	16175	978		0.8333333333333334	0.8571428571428571	25	16150	3	20	22	16130	16175	0.12380987150270771
R1	cpdb	0	network_modules	233	TRUE	0.009872734183507115	536	23	7	0.30434782608695654	0.013059701492537313	GO:0002252	GO:BP	immune effector process	16175	784		1	1	536	15639	7	16	529	15623	16175	0.05717606960275411
R1	cpdb	0	network_modules	234	TRUE	8.907667260966485e-20	9	24	8	0.3333333333333333	0.8888888888888888	GO:0000301	GO:BP	retrograde transport, vesicle recycling within Golgi	16175	87		0	0.14285714285714285	9	16166	8	16	1	16150	16175	0.5439773992663135
R1	cpdb	0	network_modules	234	TRUE	1.0118578124220323e-18	49	22	11	0.5	0.22448979591836735	REAC:R-HSA-6811440	REAC	Retrograde transport at the Trans-Golgi-Network	10916	2096		0	0.125	49	10867	11	11	38	10856	10916	0.3331054688055916
R1	cpdb	0	network_modules	234	TRUE	5.035867654041382e-16	34	24	9	0.375	0.2647058823529412	GO:0006891	GO:BP	intra-Golgi vesicle-mediated transport	16175	2546		0.16666666666666666	0.2857142857142857	34	16141	9	15	25	16126	16175	0.31385970891124276
R1	cpdb	0	network_modules	234	TRUE	1.8728165331174832e-14	44	22	9	0.4090909090909091	0.20454545454545456	REAC:R-HSA-6811438	REAC	Intra-Golgi traffic	10916	1263		0.14285714285714285	0.25	44	10872	9	13	35	10859	10916	0.2872894104334813
R1	cpdb	0	network_modules	234	TRUE	6.675127657847723e-14	144	24	11	0.4583333333333333	0.0763888888888889	GO:0007030	GO:BP	Golgi organization	16175	2635		0.3333333333333333	0.42857142857142855	144	16031	11	13	133	16018	16175	0.1844384183656639
R1	cpdb	0	network_modules	234	TRUE	2.1307791341519714e-13	202	22	12	0.5454545454545454	0.0594059405940594	REAC:R-HSA-6811442	REAC	Intra-Golgi and retrograde Golgi-to-ER traffic	10916	1262		0.2857142857142857	0.375	202	10714	12	10	190	10704	10916	0.17571092062769486
R1	cpdb	0	network_modules	234	TRUE	2.384624487256833e-12	284	24	12	0.5	0.04225352112676056	GO:0048193	GO:BP	Golgi vesicle transport	16175	12570		0.5	0.5714285714285714	284	15891	12	12	272	15879	16175	0.14159912287184226
R1	cpdb	0	network_modules	234	TRUE	4.6334766149362706e-11	155	22	10	0.45454545454545453	0.06451612903225806	REAC:R-HSA-199977	REAC	ER to Golgi Anterograde Transport	10916	823		0.42857142857142855	0.5	155	10761	10	12	145	10749	10916	0.16725656965409053
R1	cpdb	0	network_modules	234	TRUE	5.683892547752339e-11	102	22	9	0.4090909090909091	0.08823529411764706	REAC:R-HSA-6807878	REAC	COPI-mediated anterograde transport	10916	279		0.5714285714285714	0.625	102	10814	9	13	93	10801	10916	0.18671230423795043
R1	cpdb	0	network_modules	234	TRUE	2.923593244661207e-10	186	22	10	0.45454545454545453	0.053763440860215055	REAC:R-HSA-948021	REAC	Transport to the Golgi and subsequent modification	10916	2604		0.7142857142857143	0.75	186	10730	10	12	176	10718	10916	0.15191795528157206
R1	cpdb	0	network_modules	234	TRUE	1.1735328889565738e-8	204	24	9	0.375	0.04411764705882353	GO:0070085	GO:BP	glycosylation	16175	15903		0.6666666666666666	0.7142857142857143	204	15971	9	15	195	15956	16175	0.12518226479880126
R1	cpdb	0	network_modules	234	TRUE	4.0113016638567295e-8	305	22	10	0.45454545454545453	0.03278688524590164	REAC:R-HSA-446203	REAC	Asparagine N-linked glycosylation	10916	169		0.8571428571428571	0.875	305	10611	10	12	295	10599	10916	0.11632655318491006
R1	cpdb	0	network_modules	234	TRUE	9.499808486963176e-8	522	24	11	0.4583333333333333	0.0210727969348659	GO:0010256	GO:BP	endomembrane system organization	16175	4029		0.8333333333333334	0.8571428571428571	522	15653	11	13	511	15640	16175	0.0929369154846937
R1	cpdb	0	network_modules	234	TRUE	1.787597124326885e-5	52	24	5	0.20833333333333334	0.09615384615384616	GO:0006890	GO:BP	retrograde vesicle-mediated transport, Golgi to endoplasmic reticulum	16175	2545		1	1	52	16123	5	19	47	16104	16175	0.13967877754323357
R1	cpdb	0	network_modules	234	TRUE	0.004086488663090117	23	22	3	0.13636363636363635	0.13043478260869565	REAC:R-HSA-373753	REAC	Nephrin family interactions	10916	1582		1	1	23	10893	3	19	20	10874	10916	0.13157678726397642
R1	cpdb	0	network_modules	235	TRUE	5.223190621066397e-7	10	20	4	0.2	0.4	GO:0038180	GO:BP	nerve growth factor signaling pathway	16175	9754		0	0.06666666666666667	10	16165	4	16	6	16149	16175	0.28223013347539827
R1	cpdb	0	network_modules	235	TRUE	1.8022011466096374e-5	22	20	4	0.2	0.18181818181818182	GO:0038179	GO:BP	neurotrophin signaling pathway	16175	9753		0.07142857142857142	0.26666666666666666	22	16153	4	16	18	16137	16175	0.18964190325095334
R1	cpdb	0	network_modules	235	TRUE	1.8022011466096374e-5	22	20	4	0.2	0.18181818181818182	GO:1990090	GO:BP	cellular response to nerve growth factor stimulus	16175	25079		0.07142857142857142	0.26666666666666666	22	16153	4	16	18	16137	16175	0.18964190325095334
R1	cpdb	0	network_modules	235	TRUE	1.8022011466096374e-5	22	20	4	0.2	0.18181818181818182	GO:1990089	GO:BP	response to nerve growth factor	16175	25078		0.07142857142857142	0.26666666666666666	22	16153	4	16	18	16137	16175	0.18964190325095334
R1	cpdb	0	network_modules	235	TRUE	5.608930406706209e-5	80	20	5	0.25	0.0625	GO:0043524	GO:BP	negative regulation of neuron apoptotic process	16175	10753		0.2857142857142857	0.3333333333333333	80	16095	5	15	75	16080	16175	0.12290718945556875
R1	cpdb	0	network_modules	235	TRUE	1.7956786030155764e-4	38	20	4	0.2	0.10526315789473684	GO:0021675	GO:BP	nerve development	16175	6258		0.35714285714285715	0.4	38	16137	4	16	34	16121	16175	0.1436484536060909
R1	cpdb	0	network_modules	235	TRUE	2.2954287516003088e-4	118	9	4	0.4444444444444444	0.03389830508474576	KEGG:04722	KEGG	Neurotrophin signaling pathway	8484	352		0	0.25	118	8366	4	5	114	8361	8484	0.11980129397169025
R1	cpdb	0	network_modules	235	TRUE	2.9902927650913083e-4	43	20	4	0.2	0.09302325581395349	GO:0007422	GO:BP	peripheral nervous system development	16175	2917		0.42857142857142855	0.4666666666666667	43	16132	4	16	39	16116	16175	0.13484848291506996
R1	cpdb	0	network_modules	235	TRUE	4.3106712223424214e-4	120	20	5	0.25	0.041666666666666664	GO:0043523	GO:BP	regulation of neuron apoptotic process	16175	10752		0.5	0.5333333333333333	120	16055	5	15	115	16040	16175	0.0994642626333011
R1	cpdb	0	network_modules	235	TRUE	6.653602589956959e-4	128	19	5	0.2631578947368421	0.0390625	REAC:R-HSA-6809371	REAC	Formation of the cornified envelope	10916	969		0	0.2	128	10788	5	14	123	10774	10916	0.09752858588568156
R1	cpdb	0	network_modules	235	TRUE	7.460310241967931e-4	131	19	5	0.2631578947368421	0.03816793893129771	REAC:R-HSA-166520	REAC	Signaling by NTRKs	10916	2287		0.25	0.4	131	10785	5	14	126	10771	10916	0.09631339599122798
R1	cpdb	0	network_modules	235	TRUE	7.49561356231132e-4	356	9	5	0.5555555555555556	0.014044943820224719	KEGG:04151	KEGG	PI3K-Akt signaling pathway	8484	285		0.3333333333333333	0.5	356	8128	5	4	351	8124	8484	0.08347479079461034
R1	cpdb	0	network_modules	235	TRUE	8.338912928269503e-4	137	20	5	0.25	0.0364963503649635	GO:0051402	GO:BP	neuron apoptotic process	16175	13695		0.5714285714285714	0.6	137	16038	5	15	132	16023	16175	0.09273458853427527
R1	cpdb	0	network_modules	235	TRUE	0.0010888998864454044	59	20	4	0.2	0.06779661016949153	GO:0007613	GO:BP	memory	16175	3070		0.6428571428571429	0.6666666666666666	59	16116	4	16	55	16100	16175	0.11460072766735739
R1	cpdb	0	network_modules	235	TRUE	0.0018566290623475562	21	19	3	0.15789473684210525	0.14285714285714285	REAC:R-HSA-9006115	REAC	Signaling by NTRK2 (TRKB)	10916	2285		0.5	0.6	21	10895	3	16	18	10879	10916	0.14863028800788033
R1	cpdb	0	network_modules	235	TRUE	0.003503215481853689	235	9	4	0.4444444444444444	0.01702127659574468	KEGG:04014	KEGG	Ras signaling pathway	8484	247		0.6666666666666666	0.75	235	8249	4	5	231	8244	8484	0.08275383564272067
R1	cpdb	0	network_modules	235	TRUE	0.0036774992665816212	185	20	5	0.25	0.02702702702702703	GO:0018105	GO:BP	peptidyl-serine phosphorylation	16175	5324		0.7142857142857143	0.7333333333333333	185	15990	5	15	180	15975	16175	0.07894017104408858
R1	cpdb	0	network_modules	235	TRUE	0.00391171295483803	81	20	4	0.2	0.04938271604938271	GO:0033138	GO:BP	positive regulation of peptidyl-serine phosphorylation	16175	8053		0.7857142857142857	0.8	81	16094	4	16	77	16078	16175	0.09719606833924284
R1	cpdb	0	network_modules	235	TRUE	0.005005239260608023	197	20	5	0.25	0.025380710659898477	GO:0018209	GO:BP	peptidyl-serine modification	16175	5368		0.8571428571428571	0.8666666666666667	197	15978	5	15	192	15963	16175	0.0762888656963043
R1	cpdb	0	network_modules	235	TRUE	0.005473410724453834	4	19	2	0.10526315789473684	0.5	REAC:R-HSA-9026527	REAC	Activated NTRK2 signals through PLCG1	10916	63		0.75	0.8	4	10912	2	17	2	10895	10916	0.22885826432368842
R1	cpdb	0	network_modules	235	TRUE	0.005964926348183441	90	20	4	0.2	0.044444444444444446	GO:0045664	GO:BP	regulation of neuron differentiation	16175	11515		0.9285714285714286	0.9333333333333333	90	16085	4	16	86	16069	16175	0.09197088786869284
R1	cpdb	0	network_modules	235	TRUE	0.008364712557848777	215	19	5	0.2631578947368421	0.023255813953488372	REAC:R-HSA-6805567	REAC	Keratinization	10916	1288		1	1	215	10701	5	14	210	10687	10916	0.07316218859739172
R1	cpdb	0	network_modules	235	TRUE	0.009185586181021034	301	9	4	0.4444444444444444	0.013289036544850499	KEGG:04010	KEGG	MAPK signaling pathway	8484	243		1	1	301	8183	4	5	297	8178	8484	0.07204430094717251
R1	cpdb	0	network_modules	235	TRUE	0.009826384889742653	102	20	4	0.2	0.0392156862745098	GO:0033135	GO:BP	regulation of peptidyl-serine phosphorylation	16175	8051		1	1	102	16073	4	16	98	16057	16175	0.08609409264244511
R1	cpdb	0	network_modules	237	TRUE	8.766814517674781e-14	32	20	8	0.4	0.25	REAC:R-HSA-352230	REAC	Amino acid transport across the plasma membrane	10916	141		0	0.09090909090909091	32	10884	8	12	24	10872	10916	0.3146597422091132
R1	cpdb	0	network_modules	237	TRUE	1.338857071151473e-12	45	23	8	0.34782608695652173	0.17777777777777778	GO:0015804	GO:BP	neutral amino acid transport	16175	4918		0	0.02631578947368421	45	16130	8	15	37	16115	16175	0.24719866077362265
R1	cpdb	0	network_modules	237	TRUE	3.3779847756581446e-12	25	20	7	0.35	0.28	REAC:R-HSA-210991	REAC	Basigin interactions	10916	207		0.1	0.18181818181818182	25	10891	7	13	18	10878	10916	0.3116434511919873
R1	cpdb	0	network_modules	237	TRUE	2.3700217415685292e-11	63	23	8	0.34782608695652173	0.12698412698412698	GO:0015807	GO:BP	L-amino acid transport	16175	4921		0.02702702702702703	0.05263157894736842	63	16112	8	15	55	16097	16175	0.20836348476255442
R1	cpdb	0	network_modules	237	TRUE	9.355058671077973e-10	98	23	8	0.34782608695652173	0.08163265306122448	GO:0006865	GO:BP	amino acid transport	16175	2527		0.05405405405405406	0.07894736842105263	98	16077	8	15	90	16062	16175	0.16619198962423906
R1	cpdb	0	network_modules	237	TRUE	1.3868889709509013e-9	10	23	5	0.21739130434782608	0.5	GO:0015820	GO:BP	L-leucine transport	16175	4932		0.08108108108108109	0.13157894736842105	10	16165	5	18	5	16147	16175	0.32908835955922744
R1	cpdb	0	network_modules	237	TRUE	1.3868889709509013e-9	10	23	5	0.21739130434782608	0.5	GO:0000101	GO:BP	sulfur amino acid transport	16175	45		0.08108108108108109	0.13157894736842105	10	16165	5	18	5	16147	16175	0.32908835955922744
R1	cpdb	0	network_modules	237	TRUE	2.1630668764224408e-9	105	20	8	0.4	0.0761904761904762	REAC:R-HSA-425393	REAC	Transport of inorganic cations/anions and amino acids/oligopeptides	10916	2596		0.2	0.2727272727272727	105	10811	8	12	97	10799	10916	0.1713587039939983
R1	cpdb	0	network_modules	237	TRUE	4.350709667695598e-9	12	23	5	0.21739130434782608	0.4166666666666667	GO:0015803	GO:BP	branched-chain amino acid transport	16175	4917		0.13513513513513514	0.15789473684210525	12	16163	5	18	7	16145	16175	0.30026241482314386
R1	cpdb	0	network_modules	237	TRUE	9.010174210763441e-9	72	23	7	0.30434782608695654	0.09722222222222222	GO:0003333	GO:BP	amino acid transmembrane transport	16175	1753		0.16216216216216217	0.18421052631578946	72	16103	7	16	65	16087	16175	0.16999917933006045
R1	cpdb	0	network_modules	237	TRUE	1.645056523840451e-8	15	23	5	0.21739130434782608	0.3333333333333333	GO:0015802	GO:BP	basic amino acid transport	16175	4916		0.1891891891891892	0.21052631578947367	15	16160	5	18	10	16142	16175	0.2683578602474453
R1	cpdb	0	network_modules	237	TRUE	4.6805342326869397e-8	18	23	5	0.21739130434782608	0.2777777777777778	GO:0051923	GO:BP	sulfation	16175	13996		0.21621621621621623	0.23684210526315788	18	16157	5	18	13	16139	16175	0.244788910752183
R1	cpdb	0	network_modules	237	TRUE	8.279329082041104e-8	49	23	6	0.2608695652173913	0.12244897959183673	GO:1902475	GO:BP	L-alpha-amino acid transmembrane transport	16175	22305		0.24324324324324326	0.2631578947368421	49	16126	6	17	43	16109	16175	0.17704526416372712
R1	cpdb	0	network_modules	237	TRUE	1.6616575141211966e-6	248	23	8	0.34782608695652173	0.03225806451612903	GO:0046942	GO:BP	carboxylic acid transport	16175	12438		0.2702702702702703	0.2894736842105263	248	15927	8	15	240	15912	16175	0.10211410953085434
R1	cpdb	0	network_modules	237	TRUE	1.7153848886171043e-6	249	23	8	0.34782608695652173	0.0321285140562249	GO:0015849	GO:BP	organic acid transport	16175	4958		0.2972972972972973	0.3157894736842105	249	15926	8	15	241	15911	16175	0.10189310473159367
R1	cpdb	0	network_modules	237	TRUE	1.9374078987233872e-6	245	20	8	0.4	0.0326530612244898	REAC:R-HSA-425407	REAC	SLC-mediated transmembrane transport	10916	2146		0.3	0.36363636363636365	245	10671	8	12	237	10659	10916	0.10920452022235752
R1	cpdb	0	network_modules	237	TRUE	3.084507605558772e-6	39	23	5	0.21739130434782608	0.1282051282051282	GO:0072348	GO:BP	sulfur compound transport	16175	17365		0.32432432432432434	0.34210526315789475	39	16136	5	18	34	16118	16175	0.16541055639416424
R1	cpdb	0	network_modules	237	TRUE	3.805165595151127e-6	3	23	3	0.13043478260869565	1	GO:1903801	GO:BP	L-leucine import across plasma membrane	16175	23291		0.35135135135135137	0.3684210526315789	3	16172	3	20	0	16152	16175	0.3609341674135441
R1	cpdb	0	network_modules	237	TRUE	8.468567905203938e-6	16	23	4	0.17391304347826086	0.25	GO:0034035	GO:BP	purine ribonucleoside bisphosphate metabolic process	16175	8379		0.3783783783783784	0.5	16	16159	4	19	12	16140	16175	0.20757868218122585
R1	cpdb	0	network_modules	237	TRUE	8.468567905203938e-6	16	23	4	0.17391304347826086	0.25	GO:0034032	GO:BP	purine nucleoside bisphosphate metabolic process	16175	8376		0.3783783783783784	0.5	16	16159	4	19	12	16140	16175	0.20757868218122585
R1	cpdb	0	network_modules	237	TRUE	8.468567905203938e-6	16	23	4	0.17391304347826086	0.25	GO:0033875	GO:BP	ribonucleoside bisphosphate metabolic process	16175	8366		0.3783783783783784	0.5	16	16159	4	19	12	16140	16175	0.20757868218122585
R1	cpdb	0	network_modules	237	TRUE	8.468567905203938e-6	16	23	4	0.17391304347826086	0.25	GO:0033865	GO:BP	nucleoside bisphosphate metabolic process	16175	8363		0.3783783783783784	0.5	16	16159	4	19	12	16140	16175	0.20757868218122585
R1	cpdb	0	network_modules	237	TRUE	8.468567905203938e-6	16	23	4	0.17391304347826086	0.25	GO:0050427	GO:BP	3'-phosphoadenosine 5'-phosphosulfate metabolic process	16175	13184		0.3783783783783784	0.5	16	16159	4	19	12	16140	16175	0.20757868218122585
R1	cpdb	0	network_modules	237	TRUE	9.718112683880695e-6	191	20	7	0.35	0.03664921465968586	REAC:R-HSA-202733	REAC	Cell surface interactions at the vascular wall	10916	327		0.4	0.45454545454545453	191	10725	7	13	184	10712	10916	0.10864878717836869
R1	cpdb	0	network_modules	237	TRUE	1.0153572927749531e-5	107	23	6	0.2608695652173913	0.056074766355140186	GO:1905039	GO:BP	carboxylic acid transmembrane transport	16175	24314		0.5135135135135135	0.5263157894736842	107	16068	6	17	101	16051	16175	0.11835613178949077
R1	cpdb	0	network_modules	237	TRUE	1.1356534648277671e-5	109	23	6	0.2608695652173913	0.05504587155963303	GO:1903825	GO:BP	organic acid transmembrane transport	16175	23308		0.5405405405405406	0.5526315789473685	109	16066	6	17	103	16049	16175	0.11721553598814728
R1	cpdb	0	network_modules	237	TRUE	1.4266229279586585e-5	326	23	8	0.34782608695652173	0.024539877300613498	GO:0015711	GO:BP	organic anion transport	16175	4831		0.5675675675675675	0.5789473684210527	326	15849	8	15	318	15834	16175	0.0879881177371601
R1	cpdb	0	network_modules	237	TRUE	1.520654477389479e-5	4	23	3	0.13043478260869565	0.75	GO:0015829	GO:BP	valine transport	16175	4941		0.5945945945945946	0.631578947368421	4	16171	3	20	1	16151	16175	0.31243945056984906
R1	cpdb	0	network_modules	237	TRUE	1.520654477389479e-5	4	23	3	0.13043478260869565	0.75	GO:0015827	GO:BP	tryptophan transport	16175	4939		0.5945945945945946	0.631578947368421	4	16171	3	20	1	16151	16175	0.31243945056984906
R1	cpdb	0	network_modules	237	TRUE	2.3971717563439126e-5	23	20	4	0.2	0.17391304347826086	REAC:R-HSA-156584	REAC	Cytosolic sulfonation of small molecules	10916	429		0.5	0.5454545454545454	23	10893	4	16	19	10877	10916	0.18490035392667054
R1	cpdb	0	network_modules	237	TRUE	2.532302579740532e-5	103	14	5	0.35714285714285715	0.04854368932038835	KEGG:04974	KEGG	Protein digestion and absorption	8484	405		NA	1	103	8381	5	9	98	8372	8484	0.12807916937902947
R1	cpdb	0	network_modules	237	TRUE	3.7981101092723623e-5	5	23	3	0.13043478260869565	0.6	GO:0015811	GO:BP	L-cystine transport	16175	4924		0.6486486486486487	0.6578947368421053	5	16170	3	20	2	16150	16175	0.2793302689624588
R1	cpdb	0	network_modules	237	TRUE	1.3268737583468042e-4	7	23	3	0.13043478260869565	0.42857142857142855	GO:0006068	GO:BP	ethanol catabolic process	16175	1935		0.6756756756756757	0.7105263157894737	7	16168	3	20	4	16148	16175	0.23586742795786067
R1	cpdb	0	network_modules	237	TRUE	1.3268737583468042e-4	7	23	3	0.13043478260869565	0.42857142857142855	GO:0006067	GO:BP	ethanol metabolic process	16175	1934		0.6756756756756757	0.7105263157894737	7	16168	3	20	4	16148	16175	0.23586742795786067
R1	cpdb	0	network_modules	237	TRUE	1.648246537066434e-4	32	23	4	0.17391304347826086	0.125	GO:0072337	GO:BP	modified amino acid transport	16175	17357		0.7297297297297297	0.7368421052631579	32	16143	4	19	28	16124	16175	0.14601296872133598
R1	cpdb	0	network_modules	237	TRUE	2.121028969227953e-4	8	23	3	0.13043478260869565	0.375	GO:0070327	GO:BP	thyroid hormone transport	16175	16058		0.7567567567567568	0.7631578947368421	8	16167	3	20	5	16147	16175	0.22053567159107504
R1	cpdb	0	network_modules	237	TRUE	2.7941145902101626e-4	94	23	5	0.21739130434782608	0.05319148936170213	GO:0015695	GO:BP	organic cation transport	16175	4816		0.7837837837837838	0.7894736842105263	94	16081	5	18	89	16063	16175	0.10503860402481022
R1	cpdb	0	network_modules	237	TRUE	3.178592664005211e-4	9	23	3	0.13043478260869565	0.3333333333333333	GO:0015801	GO:BP	aromatic amino acid transport	16175	4915		0.8108108108108109	0.8157894736842105	9	16166	3	20	6	16146	16175	0.20783052589345608
R1	cpdb	0	network_modules	237	TRUE	4.5366352113520247e-4	10	23	3	0.13043478260869565	0.3	GO:0034310	GO:BP	primary alcohol catabolic process	16175	8564		0.8378378378378378	0.8421052631578947	10	16165	3	20	7	16145	16175	0.1970775909841018
R1	cpdb	0	network_modules	237	TRUE	5.66099022255854e-4	215	20	6	0.3	0.027906976744186046	REAC:R-HSA-211859	REAC	Biological oxidations	10916	227		0.6	0.6363636363636364	215	10701	6	14	209	10687	10916	0.08642573444387207
R1	cpdb	0	network_modules	237	TRUE	0.001077468589760431	2	20	2	0.1	1	REAC:R-HSA-5660883	REAC	Defective SLC7A9 causes cystinuria (CSNU)	10916	673		0.7	0.9090909090909091	2	10914	2	18	0	10896	10916	0.3159668878483986
R1	cpdb	0	network_modules	237	TRUE	0.001077468589760431	2	20	2	0.1	1	REAC:R-HSA-5660862	REAC	Defective SLC7A7 causes lysinuric protein intolerance (LPI)	10916	672		0.7	0.9090909090909091	2	10914	2	18	0	10896	10916	0.3159668878483986
R1	cpdb	0	network_modules	237	TRUE	0.001077468589760431	2	20	2	0.1	1	REAC:R-HSA-5619113	REAC	Defective SLC3A1 causes cystinuria (CSNU)	10916	654		0.7	0.9090909090909091	2	10914	2	18	0	10896	10916	0.3159668878483986
R1	cpdb	0	network_modules	237	TRUE	0.002554117226310345	17	23	3	0.13043478260869565	0.17647058823529413	GO:0032328	GO:BP	alanine transport	16175	7487		0.8648648648648649	0.868421052631579	17	16158	3	20	14	16138	16175	0.15068034991580065
R1	cpdb	0	network_modules	237	TRUE	0.00293052110335139	2	23	2	0.08695652173913043	1	GO:0015828	GO:BP	tyrosine transport	16175	4940		0.8918918918918919	0.8947368421052632	2	16173	2	21	0	16152	16175	0.29469240258173435
R1	cpdb	0	network_modules	237	TRUE	0.007553043285001973	24	23	3	0.13043478260869565	0.125	GO:0046164	GO:BP	alcohol catabolic process	16175	11934		0.918918918918919	0.9210526315789473	24	16151	3	20	21	16131	16175	0.12641961913648028
R1	cpdb	0	network_modules	237	TRUE	0.007918938645475231	95	20	4	0.2	0.042105263157894736	REAC:R-HSA-5619102	REAC	SLC transporter disorders	10916	2145		1	1	95	10821	4	16	91	10805	10916	0.08823848456947206
R1	cpdb	0	network_modules	237	TRUE	0.008783952978863854	3	23	2	0.08695652173913043	0.6666666666666666	GO:0015821	GO:BP	methionine transport	16175	4933		0.9459459459459459	1	3	16172	2	21	1	16151	16175	0.24045145819458102
R1	cpdb	0	network_modules	237	TRUE	0.008783952978863854	3	23	2	0.08695652173913043	0.6666666666666666	GO:0015823	GO:BP	phenylalanine transport	16175	4935		0.9459459459459459	1	3	16172	2	21	1	16151	16175	0.24045145819458102
R1	cpdb	0	network_modules	237	TRUE	0.008783952978863854	3	23	2	0.08695652173913043	0.6666666666666666	GO:1902024	GO:BP	L-histidine transport	16175	21951		0.9459459459459459	1	3	16172	2	21	1	16151	16175	0.24045145819458102
R1	cpdb	0	network_modules	238	TRUE	1.1227118468201732e-12	11	18	6	0.3333333333333333	0.5454545454545454	REAC:R-HSA-112308	REAC	Presynaptic depolarization and calcium channel opening	10916	1790		0	0.08333333333333333	11	10905	6	12	5	10893	10916	0.42567784537568376
R1	cpdb	0	network_modules	238	TRUE	1.4686131485569063e-10	301	18	11	0.6111111111111112	0.036544850498338874	KEGG:04010	KEGG	MAPK signaling pathway	8484	243		0	0.1	301	8183	11	7	290	8176	8484	0.14348404474684345
R1	cpdb	0	network_modules	238	TRUE	2.7896101204673987e-10	249	21	10	0.47619047619047616	0.040160642570281124	GO:0070588	GO:BP	calcium ion transmembrane transport	16175	16193		0	0.02631578947368421	249	15926	10	11	239	15915	16175	0.13494907064007416
R1	cpdb	0	network_modules	238	TRUE	3.864928226570583e-9	324	21	10	0.47619047619047616	0.030864197530864196	GO:0006816	GO:BP	calcium ion transport	16175	2495		0.02702702702702703	0.05263157894736842	324	15851	10	11	314	15840	16175	0.11738965992606343
R1	cpdb	0	network_modules	238	TRUE	5.095248574114227e-9	74	21	7	0.3333333333333333	0.0945945945945946	GO:0070509	GO:BP	calcium ion import	16175	16164		0.05405405405405406	0.07894736842105263	74	16101	7	14	67	16087	16175	0.17565011307283132
R1	cpdb	0	network_modules	238	TRUE	1.2967496368858838e-8	84	18	7	0.3888888888888889	0.08333333333333333	KEGG:05412	KEGG	Arrhythmogenic right ventricular cardiomyopathy	8484	490		0.1111111111111111	0.2	84	8400	7	11	77	8389	8484	0.17649964543654525
R1	cpdb	0	network_modules	238	TRUE	1.6672120882063878e-8	87	18	7	0.3888888888888889	0.08045977011494253	KEGG:04260	KEGG	Cardiac muscle contraction	8484	296		0.2222222222222222	0.3	87	8397	7	11	80	8386	8484	0.17329898609958852
R1	cpdb	0	network_modules	238	TRUE	2.1992854806807144e-8	44	21	6	0.2857142857142857	0.13636363636363635	GO:0098703	GO:BP	calcium ion import across plasma membrane	16175	18835		0.08108108108108109	0.10526315789473684	44	16131	6	15	38	16116	16175	0.19589989369402297
R1	cpdb	0	network_modules	238	TRUE	2.9136367298179984e-8	46	21	6	0.2857142857142857	0.13043478260869565	GO:1902656	GO:BP	calcium ion import into cytosol	16175	22422		0.10810810810810811	0.13157894736842105	46	16129	6	15	40	16114	16175	0.19152203653245378
R1	cpdb	0	network_modules	238	TRUE	3.623550466098849e-8	97	18	7	0.3888888888888889	0.07216494845360824	KEGG:05410	KEGG	Hypertrophic cardiomyopathy	8484	489		0.3333333333333333	0.4	97	8387	7	11	90	8376	8484	0.1637097207963146
R1	cpdb	0	network_modules	238	TRUE	5.1792485910128905e-8	102	18	7	0.3888888888888889	0.06862745098039216	KEGG:05414	KEGG	Dilated cardiomyopathy	8484	491		0.4444444444444444	0.5	102	8382	7	11	95	8371	8484	0.15944507962245094
R1	cpdb	0	network_modules	238	TRUE	2.1517470134481903e-7	487	21	10	0.47619047619047616	0.02053388090349076	GO:0098916	GO:BP	anterograde trans-synaptic signaling	16175	18949		0.13513513513513514	0.18421052631578946	487	15688	10	11	477	15677	16175	0.09411971485175777
R1	cpdb	0	network_modules	238	TRUE	2.1517470134481903e-7	487	21	10	0.47619047619047616	0.02053388090349076	GO:0007268	GO:BP	chemical synaptic transmission	16175	2796		0.13513513513513514	0.18421052631578946	487	15688	10	11	477	15677	16175	0.09411971485175777
R1	cpdb	0	network_modules	238	TRUE	2.377870472982676e-7	492	21	10	0.47619047619047616	0.02032520325203252	GO:0099537	GO:BP	trans-synaptic signaling	16175	19116		0.1891891891891892	0.21052631578947367	492	15683	10	11	482	15672	16175	0.09359026915699406
R1	cpdb	0	network_modules	238	TRUE	3.786933976274228e-7	516	21	10	0.47619047619047616	0.01937984496124031	GO:0099536	GO:BP	synaptic signaling	16175	19115		0.21621621621621623	0.23684210526315788	516	15659	10	11	506	15648	16175	0.09115342275650362
R1	cpdb	0	network_modules	238	TRUE	8.961544417752331e-7	153	18	7	0.3888888888888889	0.0457516339869281	KEGG:04261	KEGG	Adrenergic signaling in cardiomyocytes	8484	297		0.5555555555555556	0.6	153	8331	7	11	146	8320	8484	0.12850131417977603
R1	cpdb	0	network_modules	238	TRUE	1.086669988449093e-6	575	21	10	0.47619047619047616	0.017391304347826087	GO:0098662	GO:BP	inorganic cation transmembrane transport	16175	18818		0.24324324324324326	0.2631578947368421	575	15600	10	11	565	15589	16175	0.08580317503638933
R1	cpdb	0	network_modules	238	TRUE	1.1239394874831107e-6	577	21	10	0.47619047619047616	0.01733102253032929	GO:0098655	GO:BP	monoatomic cation transmembrane transport	16175	18811		0.2702702702702703	0.2894736842105263	577	15598	10	11	567	15587	16175	0.0856357946337593
R1	cpdb	0	network_modules	238	TRUE	1.2364378103660837e-6	160	21	7	0.3333333333333333	0.04375	GO:0097553	GO:BP	calcium ion transmembrane import into cytosol	16175	18700		0.2972972972972973	0.3157894736842105	160	16015	7	14	153	16001	16175	0.1178382300161627
R1	cpdb	0	network_modules	238	TRUE	1.6802705654506858e-6	42	18	5	0.2777777777777778	0.11904761904761904	REAC:R-HSA-419037	REAC	NCAM1 interactions	10916	1512		0.09090909090909091	0.16666666666666666	42	10874	5	13	37	10861	10916	0.17982373170722019
R1	cpdb	0	network_modules	238	TRUE	2.6337814541585095e-6	630	21	10	0.47619047619047616	0.015873015873015872	GO:0098660	GO:BP	inorganic ion transmembrane transport	16175	18816		0.32432432432432434	0.34210526315789475	630	15545	10	11	620	15534	16175	0.08148348889449988
R1	cpdb	0	network_modules	238	TRUE	4.175066075431247e-6	15	21	4	0.19047619047619047	0.26666666666666666	GO:0061577	GO:BP	calcium ion transmembrane transport via high voltage-gated calcium channel	16175	15567		0.35135135135135137	0.3684210526315789	15	16160	4	17	11	16143	16175	0.22452706826232097
R1	cpdb	0	network_modules	238	TRUE	4.840845973159243e-6	671	21	10	0.47619047619047616	0.014903129657228018	GO:0034220	GO:BP	monoatomic ion transmembrane transport	16175	8508		0.3783783783783784	0.39473684210526316	671	15504	10	11	661	15493	16175	0.07860082352862045
R1	cpdb	0	network_modules	238	TRUE	5.274412541819342e-6	677	21	10	0.47619047619047616	0.014771048744460856	GO:0030001	GO:BP	metal ion transport	16175	6646		0.40540540540540543	0.42105263157894735	677	15498	10	11	667	15487	16175	0.07820010287232142
R1	cpdb	0	network_modules	238	TRUE	9.192973074407795e-6	117	21	6	0.2857142857142857	0.05128205128205128	GO:0099587	GO:BP	inorganic ion import across plasma membrane	16175	19152		0.43243243243243246	0.47368421052631576	117	16058	6	15	111	16043	16175	0.11848698672504285
R1	cpdb	0	network_modules	238	TRUE	9.192973074407795e-6	117	21	6	0.2857142857142857	0.05128205128205128	GO:0098659	GO:BP	inorganic cation import across plasma membrane	16175	18815		0.43243243243243246	0.47368421052631576	117	16058	6	15	111	16043	16175	0.11848698672504285
R1	cpdb	0	network_modules	238	TRUE	9.722833220271024e-6	59	18	5	0.2777777777777778	0.0847457627118644	REAC:R-HSA-375165	REAC	NCAM signaling for neurite out-growth	10916	1511		0.18181818181818182	0.25	59	10857	5	13	54	10844	10916	0.15097648018063037
R1	cpdb	0	network_modules	238	TRUE	1.3699369106282043e-5	125	21	6	0.2857142857142857	0.048	GO:1903169	GO:BP	regulation of calcium ion transmembrane transport	16175	22802		0.4864864864864865	0.5	125	16050	6	15	119	16035	16175	0.11445763869038038
R1	cpdb	0	network_modules	238	TRUE	1.374913488590074e-5	748	21	10	0.47619047619047616	0.013368983957219251	GO:0006812	GO:BP	monoatomic cation transport	16175	2492		0.5135135135135135	0.5263157894736842	748	15427	10	11	738	15416	16175	0.07381362710499213
R1	cpdb	0	network_modules	238	TRUE	3.094209960477747e-5	154	18	6	0.3333333333333333	0.03896103896103896	KEGG:04921	KEGG	Oxytocin signaling pathway	8484	378		0.6666666666666666	0.7	154	8330	6	12	148	8318	8484	0.1088618379270202
R1	cpdb	0	network_modules	238	TRUE	6.305856058411914e-5	282	21	7	0.3333333333333333	0.024822695035460994	GO:0042391	GO:BP	regulation of membrane potential	16175	10141		0.5405405405405406	0.5526315789473685	282	15893	7	14	275	15879	16175	0.08702312640026802
R1	cpdb	0	network_modules	238	TRUE	8.277093995792989e-5	30	21	4	0.19047619047619047	0.13333333333333333	GO:0007528	GO:BP	neuromuscular junction development	16175	3010		0.5675675675675675	0.5789473684210527	30	16145	4	17	26	16128	16175	0.15806124023028648
R1	cpdb	0	network_modules	238	TRUE	1.1741570910551069e-4	179	21	6	0.2857142857142857	0.0335195530726257	GO:0051924	GO:BP	regulation of calcium ion transport	16175	13997		0.5945945945945946	0.6052631578947368	179	15996	6	15	173	15981	16175	0.09465811428722407
R1	cpdb	0	network_modules	238	TRUE	1.2960015766036082e-4	182	21	6	0.2857142857142857	0.03296703296703297	GO:0098739	GO:BP	import across plasma membrane	16175	18866		0.6216216216216216	0.631578947368421	182	15993	6	15	176	15978	16175	0.09382012737702182
R1	cpdb	0	network_modules	238	TRUE	2.9762910584213236e-4	354	21	7	0.3333333333333333	0.01977401129943503	GO:0034762	GO:BP	regulation of transmembrane transport	16175	8731		0.6486486486486487	0.6578947368421053	354	15821	7	14	347	15807	16175	0.07675036321916096
R1	cpdb	0	network_modules	238	TRUE	3.0304523141550346e-4	41	21	4	0.19047619047619047	0.0975609756097561	GO:1904645	GO:BP	response to amyloid-beta	16175	23985		0.6756756756756757	0.6842105263157895	41	16134	4	17	37	16117	16175	0.1347638576034627
R1	cpdb	0	network_modules	238	TRUE	5.038643886992433e-4	229	21	6	0.2857142857142857	0.026200873362445413	GO:1904062	GO:BP	regulation of monoatomic cation transmembrane transport	16175	23501		0.7027027027027027	0.7105263157894737	229	15946	6	15	223	15931	16175	0.08287636508454413
R1	cpdb	0	network_modules	238	TRUE	5.178902898320579e-4	130	18	5	0.2777777777777778	0.038461538461538464	REAC:R-HSA-5576891	REAC	Cardiac conduction	10916	306		0.2727272727272727	0.3333333333333333	130	10786	5	13	125	10773	10916	0.09960740589845755
R1	cpdb	0	network_modules	238	TRUE	5.222292692891012e-4	15	18	3	0.16666666666666666	0.2	REAC:R-HSA-5576893	REAC	Phase 2 - plateau phase	10916	1734		0.36363636363636365	0.4166666666666667	15	10901	3	15	12	10886	10916	0.1813430115663804
R1	cpdb	0	network_modules	238	TRUE	5.348274603948405e-4	251	18	6	0.3333333333333333	0.02390438247011952	KEGG:04020	KEGG	Calcium signaling pathway	8484	250		0.7777777777777778	0.8	251	8233	6	12	245	8221	8484	0.08266004180476487
R1	cpdb	0	network_modules	238	TRUE	7.592393087502107e-4	259	18	6	0.3333333333333333	0.023166023166023165	REAC:R-HSA-112315	REAC	Transmission across Chemical Synapses	10916	2580		0.45454545454545453	0.5	259	10657	6	12	253	10645	10916	0.08267407684081453
R1	cpdb	0	network_modules	238	TRUE	8.674550187610935e-4	53	21	4	0.19047619047619047	0.07547169811320754	GO:0007612	GO:BP	learning	16175	3069		0.7297297297297297	0.7368421052631579	53	16122	4	17	49	16105	16175	0.11810580819897083
R1	cpdb	0	network_modules	238	TRUE	0.0011097973496928186	262	21	6	0.2857142857142857	0.022900763358778626	GO:0050804	GO:BP	modulation of chemical synaptic transmission	16175	13270		0.7567567567567568	0.7894736842105263	262	15913	6	15	256	15898	16175	0.07697904115512313
R1	cpdb	0	network_modules	238	TRUE	0.0011097973496928186	262	21	6	0.2857142857142857	0.022900763358778626	GO:0034765	GO:BP	regulation of monoatomic ion transmembrane transport	16175	8734		0.7567567567567568	0.7894736842105263	262	15913	6	15	256	15898	16175	0.07697904115512313
R1	cpdb	0	network_modules	238	TRUE	0.0011347952983469178	263	21	6	0.2857142857142857	0.022813688212927757	GO:0099177	GO:BP	regulation of trans-synaptic signaling	16175	19085		0.8108108108108109	0.8157894736842105	263	15912	6	15	257	15897	16175	0.07681734303792206
R1	cpdb	0	network_modules	238	TRUE	0.001740595064970278	283	21	6	0.2857142857142857	0.02120141342756184	GO:0050808	GO:BP	synapse organization	16175	13274		0.8378378378378378	0.8421052631578947	283	15892	6	15	277	15877	16175	0.07375977167753275
R1	cpdb	0	network_modules	238	TRUE	0.0017767332990771783	284	21	6	0.2857142857142857	0.02112676056338028	GO:0010959	GO:BP	regulation of metal ion transport	16175	4536		0.8648648648648649	0.868421052631579	284	15891	6	15	278	15876	16175	0.0736151430175781
R1	cpdb	0	network_modules	238	TRUE	0.002111437707561702	78	18	4	0.2222222222222222	0.05128205128205128	REAC:R-HSA-422356	REAC	Regulation of insulin secretion	10916	2040		0.5454545454545454	0.5833333333333334	78	10838	4	14	74	10824	10916	0.10377624772396946
R1	cpdb	0	network_modules	238	TRUE	0.003252053773825658	740	21	8	0.38095238095238093	0.010810810810810811	GO:0098657	GO:BP	import into cell	16175	18813		0.8918918918918919	0.8947368421052632	740	15435	8	13	732	15422	16175	0.05784320067690577
R1	cpdb	0	network_modules	238	TRUE	0.0037099673309459137	28	18	3	0.16666666666666666	0.10714285714285714	REAC:R-HSA-400042	REAC	Adrenaline,noradrenaline inhibits insulin secretion	10916	124		0.6363636363636364	0.6666666666666666	28	10888	3	15	25	10873	10916	0.13185183744980994
R1	cpdb	0	network_modules	238	TRUE	0.004597283072575831	203	18	5	0.2777777777777778	0.024630541871921183	REAC:R-HSA-397014	REAC	Muscle contraction	10916	1496		0.7272727272727273	0.75	203	10713	5	13	198	10700	10916	0.07796978559150623
R1	cpdb	0	network_modules	238	TRUE	0.0048306643420380204	23	21	3	0.14285714285714285	0.13043478260869565	GO:1901385	GO:BP	regulation of voltage-gated calcium channel activity	16175	21435		0.918918918918919	0.9210526315789473	23	16152	3	18	20	16134	16175	0.13533007461701302
R1	cpdb	0	network_modules	238	TRUE	0.005130995641596108	341	21	6	0.2857142857142857	0.017595307917888565	GO:0043269	GO:BP	regulation of monoatomic ion transport	16175	10593		0.9459459459459459	0.9473684210526315	341	15834	6	15	335	15819	16175	0.06641777958070443
R1	cpdb	0	network_modules	238	TRUE	0.005593915822268855	32	18	3	0.16666666666666666	0.09375	REAC:R-HSA-5576892	REAC	Phase 0 - rapid depolarisation	10916	1732		0.8181818181818182	0.8333333333333334	32	10884	3	15	29	10869	10916	0.12308330519546264
R1	cpdb	0	network_modules	238	TRUE	0.007072180275692065	46	18	3	0.16666666666666666	0.06521739130434782	KEGG:04930	KEGG	Type II diabetes mellitus	8484	387		0.8888888888888888	0.9	46	8438	3	15	43	8423	8484	0.10124755433568058
R1	cpdb	0	network_modules	238	TRUE	0.007077170072321803	3	21	2	0.09523809523809523	0.6666666666666666	GO:0098912	GO:BP	membrane depolarization during atrial cardiac muscle cell action potential	16175	18945		0.972972972972973	0.9736842105263158	3	16172	2	19	1	16153	16175	0.25167235521278336
R1	cpdb	0	network_modules	238	TRUE	0.0073371534378839235	90	21	4	0.19047619047619047	0.044444444444444446	GO:0061337	GO:BP	cardiac conduction	16175	15419		1	1	90	16085	4	17	86	16068	16175	0.08962874583382072
R1	cpdb	0	network_modules	238	TRUE	0.007414114945439972	107	18	4	0.2222222222222222	0.037383177570093455	REAC:R-HSA-163685	REAC	Integration of energy metabolism	10916	1213		0.9090909090909091	0.9166666666666666	107	10809	4	14	103	10795	10916	0.08762687685852931
R1	cpdb	0	network_modules	238	TRUE	0.008638359070402253	131	18	4	0.2222222222222222	0.030534351145038167	KEGG:04728	KEGG	Dopaminergic synapse	8484	358		1	1	131	8353	4	14	127	8339	8484	0.07733077225804369
R1	cpdb	0	network_modules	238	TRUE	0.00918374642216264	400	18	6	0.3333333333333333	0.015	REAC:R-HSA-112316	REAC	Neuronal System	10916	1590		1	1	400	10516	6	12	394	10504	10916	0.06417617335925294
R1	cpdb	0	network_modules	239	TRUE	0.0031066748563433064	397	26	7	0.2692307692307692	0.017632241813602016	GO:0008380	GO:BP	RNA splicing	16175	3186		NA	1	397	15778	7	19	390	15759	16175	0.06345229223238992
R1	cpdb	0	network_modules	240	TRUE	8.943139015632971e-5	6	24	3	0.125	0.5	GO:0038043	GO:BP	interleukin-5-mediated signaling pathway	16175	9677		NA	1	6	16169	3	21	3	16148	16175	0.249489518890329
R1	cpdb	0	network_modules	240	TRUE	7.774881098938205e-4	67	19	4	0.21052631578947367	0.05970149253731343	KEGG:04664	KEGG	Fc epsilon RI signaling pathway	8484	340		0	0.5	67	8417	4	15	63	8402	8484	0.10845503635359485
R1	cpdb	0	network_modules	240	TRUE	0.0016544188122074187	81	19	4	0.21052631578947367	0.04938271604938271	KEGG:04662	KEGG	B cell receptor signaling pathway	8484	339		1	1	81	8403	4	15	77	8388	8484	0.09791626138313522
R1	cpdb	0	network_modules	240	TRUE	0.003342657390845911	3	21	2	0.09523809523809523	0.6666666666666666	REAC:R-HSA-9753510	REAC	Signaling by RAS GAP mutants	10916	2297		0	1	3	10913	2	19	1	10894	10916	0.25152578306476736
R1	cpdb	0	network_modules	240	TRUE	0.003342657390845911	3	21	2	0.09523809523809523	0.6666666666666666	REAC:R-HSA-9649913	REAC	RAS GTPase cycle mutants	10916	1842		0	1	3	10913	2	19	1	10894	10916	0.25152578306476736
R1	cpdb	0	network_modules	240	TRUE	0.003342657390845911	3	21	2	0.09523809523809523	0.6666666666666666	REAC:R-HSA-9753512	REAC	Signaling by RAS GTPase mutants	10916	2298		0	1	3	10913	2	19	1	10894	10916	0.25152578306476736
R1	cpdb	0	network_modules	241	TRUE	3.126448725716962e-7	181	14	7	0.5	0.03867403314917127	KEGG:04360	KEGG	Axon guidance	8484	305		0	0.25	181	8303	7	7	174	8296	8484	0.1346785697862919
R1	cpdb	0	network_modules	241	TRUE	1.3023108724791107e-6	40	18	5	0.2777777777777778	0.125	REAC:R-HSA-3928662	REAC	EPHB-mediated forward signaling	10916	821		0	0.25	40	10876	5	13	35	10863	10916	0.1843707828021446
R1	cpdb	0	network_modules	241	TRUE	2.605494464947379e-6	44	20	5	0.25	0.11363636363636363	GO:0048013	GO:BP	ephrin receptor signaling pathway	16175	12469		0	0.2	44	16131	5	15	39	16116	16175	0.16704649971738939
R1	cpdb	0	network_modules	241	TRUE	3.751027631181343e-6	17	18	4	0.2222222222222222	0.23529411764705882	REAC:R-HSA-3928664	REAC	Ephrin signaling	10916	849		0.3333333333333333	0.5	17	10899	4	14	13	10885	10916	0.2274268832846812
R1	cpdb	0	network_modules	241	TRUE	5.20465708058493e-6	510	20	9	0.45	0.01764705882352941	GO:0007169	GO:BP	cell surface receptor protein tyrosine kinase signaling pathway	16175	2733		0.25	0.4	510	15665	9	11	501	15654	16175	0.08425966011909551
R1	cpdb	0	network_modules	241	TRUE	1.4365577872266105e-5	92	14	5	0.35714285714285715	0.05434782608695652	KEGG:04640	KEGG	Hematopoietic cell lineage	8484	333		0.3333333333333333	0.5	92	8392	5	9	87	8383	8484	0.13594005861998606
R1	cpdb	0	network_modules	241	TRUE	6.0934949963799155e-5	235	14	6	0.42857142857142855	0.02553191489361702	KEGG:04014	KEGG	Ras signaling pathway	8484	247		0.6666666666666666	0.75	235	8249	6	8	229	8241	8484	0.09931031551395235
R1	cpdb	0	network_modules	241	TRUE	8.275610989426744e-5	90	18	5	0.2777777777777778	0.05555555555555555	REAC:R-HSA-2682334	REAC	EPH-Ephrin signaling	10916	818		0.6666666666666666	0.75	90	10826	5	13	85	10813	10916	0.12113874108053665
R1	cpdb	0	network_modules	241	TRUE	2.2957744602277995e-4	790	20	9	0.45	0.01139240506329114	GO:0007167	GO:BP	enzyme-linked receptor protein signaling pathway	16175	2731		0.5	0.6	790	15385	9	11	781	15374	16175	0.0654877791363701
R1	cpdb	0	network_modules	241	TRUE	2.5840324430519563e-4	301	14	6	0.42857142857142855	0.019933554817275746	KEGG:04010	KEGG	MAPK signaling pathway	8484	243		1	1	301	8183	6	8	295	8175	8484	0.08639301439903592
R1	cpdb	0	network_modules	241	TRUE	3.231245580928552e-4	49	18	4	0.2222222222222222	0.08163265306122448	REAC:R-HSA-3928665	REAC	EPH-ephrin mediated repulsion of cells	10916	819		1	1	49	10867	4	14	45	10853	10916	0.13237273909613484
R1	cpdb	0	network_modules	241	TRUE	0.0032142660622238458	180	20	5	0.25	0.027777777777777776	GO:0046777	GO:BP	protein autophosphorylation	16175	12365		0.75	0.8	180	15995	5	15	175	15980	16175	0.08012022494856298
R1	cpdb	0	network_modules	241	TRUE	0.007636173493387966	28	20	3	0.15	0.10714285714285714	GO:0030224	GO:BP	monocyte differentiation	16175	6732		1	1	28	16147	3	17	25	16130	16175	0.1254963317171805
R1	cpdb	0	network_modules	242	TRUE	6.954712883196308e-4	44	2	2	1	0.045454545454545456	KEGG:04672	KEGG	Intestinal immune network for IgA production	8484	344		0	0.5	44	8440	2	0	42	8440	8484	0.2126722123208959
R1	cpdb	0	network_modules	242	TRUE	0.008548562516470026	153	2	2	1	0.013071895424836602	KEGG:04514	KEGG	Cell adhesion molecules	8484	315		1	1	153	8331	2	0	151	8331	8484	0.11331012420409978
R1	cpdb	0	network_modules	243	TRUE	1.83348516976628e-8	93	10	6	0.6	0.06451612903225806	KEGG:04520	KEGG	Adherens junction	8484	316		NA	1	93	8391	6	4	87	8387	8484	0.19433523408999104
R1	cpdb	0	network_modules	243	TRUE	2.375669099487975e-5	449	16	8	0.5	0.017817371937639197	REAC:R-HSA-9012999	REAC	RHO GTPase cycle	10916	1847		0	0.5	449	10467	8	8	441	10459	10916	0.08852450183178799
R1	cpdb	0	network_modules	243	TRUE	1.730528253412187e-4	346	20	7	0.35	0.02023121387283237	GO:0034329	GO:BP	cell junction assembly	16175	8571		0	0.16666666666666666	346	15829	7	13	339	15816	16175	0.07991355001908858
R1	cpdb	0	network_modules	243	TRUE	3.9446742306873116e-4	46	20	4	0.2	0.08695652173913043	GO:0044331	GO:BP	cell-cell adhesion mediated by cadherin	16175	10957		0.2	0.3333333333333333	46	16129	4	16	42	16113	16175	0.13026669629403015
R1	cpdb	0	network_modules	243	TRUE	0.0010316268764931065	143	20	5	0.25	0.03496503496503497	GO:0007043	GO:BP	cell-cell junction assembly	16175	2647		0.4	0.5	143	16032	5	15	138	16017	16175	0.09064581602597127
R1	cpdb	0	network_modules	243	TRUE	0.0022061676644972426	745	20	8	0.4	0.010738255033557046	GO:0098609	GO:BP	cell-cell adhesion	16175	18805		0.6	0.6666666666666666	745	15430	8	12	737	15418	16175	0.05941223747122508
R1	cpdb	0	network_modules	243	TRUE	0.002778939086827115	94	16	4	0.25	0.0425531914893617	REAC:R-HSA-9013423	REAC	RAC3 GTPase cycle	10916	1838		1	1	94	10822	4	12	90	10810	10916	0.10009437457925137
R1	cpdb	0	network_modules	243	TRUE	0.003127411349317719	179	20	5	0.25	0.027932960893854747	GO:0045216	GO:BP	cell-cell junction organization	16175	11328		0.8	0.8333333333333334	179	15996	5	15	174	15981	16175	0.08036199493410265
R1	cpdb	0	network_modules	243	TRUE	0.0031829833432179314	533	20	7	0.35	0.013133208255159476	GO:0034330	GO:BP	cell junction organization	16175	8572		1	1	533	15642	7	13	526	15629	16175	0.06249150155196778
R1	cpdb	0	network_modules	245	TRUE	7.118307599411996e-13	53	16	8	0.5	0.1509433962264151	REAC:R-HSA-9662361	REAC	Sensory processing of sound by outer hair cells of the cochlea	10916	2203		0	0.3333333333333333	53	10863	8	8	45	10855	10916	0.2729163887809923
R1	cpdb	0	network_modules	245	TRUE	4.5737363935185805e-12	66	16	8	0.5	0.12121212121212122	REAC:R-HSA-9662360	REAC	Sensory processing of sound by inner hair cells of the cochlea	10916	2202		0.5	0.6666666666666666	66	10850	8	8	58	10842	10916	0.24412361310325245
R1	cpdb	0	network_modules	245	TRUE	1.1939019618597897e-11	74	16	8	0.5	0.10810810810810811	REAC:R-HSA-9659379	REAC	Sensory processing of sound	10916	2201		1	1	74	10842	8	8	66	10834	10916	0.23029326243694614
R1	cpdb	0	network_modules	245	TRUE	4.5265456586832985e-10	22	23	6	0.2608695652173913	0.2727272727272727	GO:0042490	GO:BP	mechanoreceptor differentiation	16175	10219		0	0.04	22	16153	6	17	16	16136	16175	0.2657114568532298
R1	cpdb	0	network_modules	245	TRUE	1.198426781793888e-9	101	23	8	0.34782608695652173	0.07920792079207921	GO:0007605	GO:BP	sensory perception of sound	16175	3064		0.041666666666666664	0.08	101	16074	8	15	93	16059	16175	0.16363161384183375
R1	cpdb	0	network_modules	245	TRUE	1.923296436363637e-9	107	23	8	0.34782608695652173	0.07476635514018691	GO:0050954	GO:BP	sensory perception of mechanical stimulus	16175	13396		0.08333333333333333	0.12	107	16068	8	15	99	16053	16175	0.15883463207377357
R1	cpdb	0	network_modules	245	TRUE	6.346259040820478e-8	19	23	5	0.21739130434782608	0.2631578947368421	GO:0060113	GO:BP	inner ear receptor cell differentiation	16175	14359		0.125	0.16	19	16156	5	18	14	16138	16175	0.2381992940954729
R1	cpdb	0	network_modules	245	TRUE	1.6424139567511498e-7	7	23	4	0.17391304347826086	0.5714285714285714	GO:0050957	GO:BP	equilibrioception	16175	13399		0.16666666666666666	0.2	7	16168	4	19	3	16149	16175	0.31475163206046586
R1	cpdb	0	network_modules	245	TRUE	1.8296669498814382e-7	23	23	5	0.21739130434782608	0.21739130434782608	GO:0035315	GO:BP	hair cell differentiation	16175	8965		0.20833333333333334	0.24	23	16152	5	18	18	16134	16175	0.216276891272046
R1	cpdb	0	network_modules	245	TRUE	9.844698114106879e-7	139	23	7	0.30434782608695654	0.050359712230215826	GO:0050953	GO:BP	sensory perception of light stimulus	16175	13395		0.25	0.28	139	16036	7	16	132	16020	16175	0.12091236722653022
R1	cpdb	0	network_modules	245	TRUE	4.544607971584322e-6	42	23	5	0.21739130434782608	0.11904761904761904	GO:0001895	GO:BP	retina homeostasis	16175	520		0.2916666666666667	0.32	42	16133	5	18	37	16115	16175	0.1592708921525513
R1	cpdb	0	network_modules	245	TRUE	4.666481912176006e-6	14	23	4	0.17391304347826086	0.2857142857142857	GO:0042491	GO:BP	inner ear auditory receptor cell differentiation	16175	10220		0.3333333333333333	0.36	14	16161	4	19	10	16142	16175	0.22205587943404823
R1	cpdb	0	network_modules	245	TRUE	6.357402401971473e-6	15	23	4	0.17391304347826086	0.26666666666666666	GO:0060119	GO:BP	inner ear receptor cell development	16175	14365		0.375	0.44	15	16160	4	19	11	16141	16175	0.21445635286507317
R1	cpdb	0	network_modules	245	TRUE	6.357402401971473e-6	15	23	4	0.17391304347826086	0.26666666666666666	GO:0050885	GO:BP	neuromuscular process controlling balance	16175	13329		0.375	0.44	15	16160	4	19	11	16141	16175	0.21445635286507317
R1	cpdb	0	network_modules	245	TRUE	3.393413963920659e-5	62	23	5	0.21739130434782608	0.08064516129032258	GO:0048839	GO:BP	inner ear development	16175	13083		0.4583333333333333	0.48	62	16113	5	18	57	16095	16175	0.13041493101221222
R1	cpdb	0	network_modules	245	TRUE	7.269321227840943e-5	72	23	5	0.21739130434782608	0.06944444444444445	GO:0043583	GO:BP	ear development	16175	10787		0.5	0.52	72	16103	5	18	67	16085	16175	0.12070705112843226
R1	cpdb	0	network_modules	245	TRUE	1.873827317738152e-4	33	23	4	0.17391304347826086	0.12121212121212122	GO:0045494	GO:BP	photoreceptor cell maintenance	16175	11413		0.5416666666666666	0.56	33	16142	4	19	29	16123	16175	0.14373638289442384
R1	cpdb	0	network_modules	245	TRUE	4.5366352113520247e-4	10	23	3	0.13043478260869565	0.3	GO:0060117	GO:BP	auditory receptor cell development	16175	14363		0.5833333333333334	0.6	10	16165	3	20	7	16145	16175	0.1970775909841018
R1	cpdb	0	network_modules	245	TRUE	5.978266467806023e-4	529	23	8	0.34782608695652173	0.015122873345935728	GO:0007600	GO:BP	sensory perception	16175	3059		0.625	0.64	529	15646	8	15	521	15631	16175	0.06685644945621155
R1	cpdb	0	network_modules	245	TRUE	0.0010782258618815804	13	23	3	0.13043478260869565	0.23076923076923078	GO:0060122	GO:BP	inner ear receptor cell stereocilium organization	16175	14368		0.6666666666666666	0.68	13	16162	3	20	10	16142	16175	0.17261754808735671
R1	cpdb	0	network_modules	245	TRUE	0.0021811597977939236	142	23	5	0.21739130434782608	0.035211267605633804	GO:0009913	GO:BP	epidermal cell differentiation	16175	3769		0.7083333333333334	0.72	142	16033	5	18	137	16015	16175	0.08438853511066824
R1	cpdb	0	network_modules	245	TRUE	0.002982645033309725	279	23	6	0.2608695652173913	0.021505376344086023	GO:0007423	GO:BP	sensory organ development	16175	2918		0.75	0.76	279	15896	6	17	273	15879	16175	0.07060951947159412
R1	cpdb	0	network_modules	245	TRUE	0.003051212635880357	152	23	5	0.21739130434782608	0.03289473684210526	GO:0001894	GO:BP	tissue homeostasis	16175	519		0.7916666666666666	0.84	152	16023	5	18	147	16005	16175	0.08134902115096028
R1	cpdb	0	network_modules	245	TRUE	0.003051212635880357	152	23	5	0.21739130434782608	0.03289473684210526	GO:0060249	GO:BP	anatomical structure homeostasis	16175	14466		0.7916666666666666	0.84	152	16023	5	18	147	16005	16175	0.08134902115096028
R1	cpdb	0	network_modules	245	TRUE	0.003062098350953939	18	23	3	0.13043478260869565	0.16666666666666666	GO:0030050	GO:BP	vesicle transport along actin filament	16175	6669		0.875	0.88	18	16157	3	20	15	16137	16175	0.14636953661026184
R1	cpdb	0	network_modules	245	TRUE	0.004270000937332811	20	23	3	0.13043478260869565	0.15	GO:0099515	GO:BP	actin filament-based transport	16175	19105		0.9166666666666666	0.92	20	16155	3	20	17	16135	16175	0.13873415606930908
R1	cpdb	0	network_modules	245	TRUE	0.0045413350903164606	72	23	4	0.17391304347826086	0.05555555555555555	GO:0050905	GO:BP	neuromuscular process	16175	13347		0.9583333333333334	0.96	72	16103	4	19	68	16084	16175	0.09606098702761817
R1	cpdb	0	network_modules	245	TRUE	0.007118520689539895	510	23	7	0.30434782608695654	0.013725490196078431	GO:0048871	GO:BP	multicellular organismal-level homeostasis	16175	13114		1	1	510	15665	7	16	503	15649	16175	0.05891383434705859
R1	cpdb	0	network_modules	246	TRUE	7.206975818385241e-11	131	12	8	0.6666666666666666	0.061068702290076333	KEGG:04728	KEGG	Dopaminergic synapse	8484	358		0	0.1111111111111111	131	8353	8	4	123	8349	8484	0.19878016341771765
R1	cpdb	0	network_modules	246	TRUE	9.321852671963823e-7	64	12	5	0.4166666666666667	0.078125	KEGG:04929	KEGG	GnRH secretion	8484	386		0.125	0.2222222222222222	64	8420	5	7	59	8413	8484	0.1779533755376407
R1	cpdb	0	network_modules	246	TRUE	4.987727706433551e-6	89	12	5	0.4166666666666667	0.056179775280898875	KEGG:05032	KEGG	Morphine addiction	8484	420		0.25	0.3333333333333333	89	8395	5	7	84	8388	8484	0.15004017742057646
R1	cpdb	0	network_modules	246	TRUE	1.2414164370319064e-5	29	14	4	0.2857142857142857	0.13793103448275862	REAC:R-HSA-1296041	REAC	Activation of G protein gated Potassium channels	10916	82		0	0.3333333333333333	29	10887	4	10	25	10877	10916	0.1970589748743744
R1	cpdb	0	network_modules	246	TRUE	1.2414164370319064e-5	29	14	4	0.2857142857142857	0.13793103448275862	REAC:R-HSA-1296059	REAC	G protein gated Potassium channels	10916	995		0	0.3333333333333333	29	10887	4	10	25	10877	10916	0.1970589748743744
R1	cpdb	0	network_modules	246	TRUE	1.2414164370319064e-5	29	14	4	0.2857142857142857	0.13793103448275862	REAC:R-HSA-997272	REAC	Inhibition  of voltage gated Ca2+ channels via Gbeta/gamma subunits	10916	1188		0	0.3333333333333333	29	10887	4	10	25	10877	10916	0.1970589748743744
R1	cpdb	0	network_modules	246	TRUE	2.724719115808117e-5	35	14	4	0.2857142857142857	0.11428571428571428	REAC:R-HSA-1296065	REAC	Inwardly rectifying K+ channels	10916	1271		0.375	0.4444444444444444	35	10881	4	10	31	10871	10916	0.17907573946245858
R1	cpdb	0	network_modules	246	TRUE	6.374679767693354e-5	148	12	5	0.4166666666666667	0.033783783783783786	KEGG:04723	KEGG	Retrograde endocannabinoid signaling	8484	353		0.375	0.4444444444444444	148	8336	5	7	143	8329	8484	0.11476332843960407
R1	cpdb	0	network_modules	246	TRUE	6.384403358503586e-5	43	14	4	0.2857142857142857	0.09302325581395349	REAC:R-HSA-977444	REAC	GABA B receptor activation	10916	1010		0.5	0.6666666666666666	43	10873	4	10	39	10863	10916	0.16120116203088514
R1	cpdb	0	network_modules	246	TRUE	6.384403358503586e-5	43	14	4	0.2857142857142857	0.09302325581395349	REAC:R-HSA-991365	REAC	Activation of GABAB receptors	10916	83		0.5	0.6666666666666666	43	10873	4	10	39	10863	10916	0.16120116203088514
R1	cpdb	0	network_modules	246	TRUE	8.03380039649845e-5	43	15	4	0.26666666666666666	0.09302325581395349	GO:1990573	GO:BP	potassium ion import across plasma membrane	16175	25222		0	0.045454545454545456	43	16132	4	11	39	16121	16175	0.15620984207140975
R1	cpdb	0	network_modules	246	TRUE	1.0491063943698689e-4	262	15	6	0.4	0.022900763358778626	GO:0034765	GO:BP	regulation of monoatomic ion transmembrane transport	16175	8734		0.047619047619047616	0.09090909090909091	262	15913	6	9	256	15904	16175	0.09262964134726213
R1	cpdb	0	network_modules	246	TRUE	2.491371313212925e-4	60	14	4	0.2857142857142857	0.06666666666666667	REAC:R-HSA-977443	REAC	GABA receptor activation	10916	1011		0.75	0.7777777777777778	60	10856	4	10	56	10846	10916	0.13581870372401986
R1	cpdb	0	network_modules	246	TRUE	4.3588056803774985e-4	97	12	4	0.3333333333333333	0.041237113402061855	KEGG:04713	KEGG	Circadian entrainment	8484	348		0.5	0.5555555555555556	97	8387	4	8	93	8379	8484	0.11395415392624185
R1	cpdb	0	network_modules	246	TRUE	4.974881639663867e-4	341	15	6	0.4	0.017595307917888565	GO:0043269	GO:BP	regulation of monoatomic ion transport	16175	10593		0.09523809523809523	0.13636363636363635	341	15834	6	9	335	15825	16175	0.08036039501274057
R1	cpdb	0	network_modules	246	TRUE	6.197975903449928e-4	354	15	6	0.4	0.01694915254237288	GO:0034762	GO:BP	regulation of transmembrane transport	16175	8731		0.14285714285714285	0.18181818181818182	354	15821	6	9	348	15812	16175	0.07873608776152591
R1	cpdb	0	network_modules	246	TRUE	7.724707410734263e-4	112	12	4	0.3333333333333333	0.03571428571428571	KEGG:04726	KEGG	Serotonergic synapse	8484	356		0.625	0.6666666666666666	112	8372	4	8	108	8364	8484	0.10556107247905439
R1	cpdb	0	network_modules	246	TRUE	9.865681961127668e-4	198	15	5	0.3333333333333333	0.025252525252525252	GO:0006813	GO:BP	potassium ion transport	16175	2493		0.19047619047619047	0.22727272727272727	198	15977	5	10	193	15967	16175	0.08896492386601777
R1	cpdb	0	network_modules	246	TRUE	0.0011148721588836801	2	15	2	0.13333333333333333	1	GO:0001975	GO:BP	response to amphetamine	16175	580		0.23809523809523808	0.2727272727272727	2	16173	2	13	0	16160	16175	0.36500158742720296
R1	cpdb	0	network_modules	246	TRUE	0.001665017405776032	136	12	4	0.3333333333333333	0.029411764705882353	KEGG:04915	KEGG	Estrogen signaling pathway	8484	372		0.75	0.7777777777777778	136	8348	4	8	132	8340	8484	0.0950850043386643
R1	cpdb	0	network_modules	246	TRUE	0.0021885017105569586	103	14	4	0.2857142857142857	0.038834951456310676	REAC:R-HSA-1296071	REAC	Potassium Channels	10916	1780		0.875	0.8888888888888888	103	10813	4	10	99	10803	10916	0.10240707950118615
R1	cpdb	0	network_modules	246	TRUE	0.0025864295500052786	27	15	3	0.2	0.1111111111111111	GO:0007212	GO:BP	G protein-coupled dopamine receptor signaling pathway	16175	2766		0.2857142857142857	0.3181818181818182	27	16148	3	12	24	16136	16175	0.14801920198550775
R1	cpdb	0	network_modules	246	TRUE	0.002641216696325394	740	15	7	0.4666666666666667	0.00945945945945946	GO:0098657	GO:BP	import into cell	16175	18813		0.3333333333333333	0.36363636363636365	740	15435	7	8	733	15427	16175	0.06137571789983239
R1	cpdb	0	network_modules	246	TRUE	0.002714344384756515	154	12	4	0.3333333333333333	0.025974025974025976	KEGG:04921	KEGG	Oxytocin signaling pathway	8484	378		0.875	0.8888888888888888	154	8330	4	8	150	8322	8484	0.08885383791505559
R1	cpdb	0	network_modules	246	TRUE	0.003342824188508391	3	15	2	0.13333333333333333	0.6666666666666666	GO:0051586	GO:BP	positive regulation of dopamine uptake involved in synaptic transmission	16175	13803		0.38095238095238093	0.5	3	16172	2	13	1	16159	16175	0.29789344298100395
R1	cpdb	0	network_modules	246	TRUE	0.003342824188508391	3	15	2	0.13333333333333333	0.6666666666666666	GO:0014075	GO:BP	response to amine	16175	4640		0.38095238095238093	0.5	3	16172	2	13	1	16159	16175	0.29789344298100395
R1	cpdb	0	network_modules	246	TRUE	0.003342824188508391	3	15	2	0.13333333333333333	0.6666666666666666	GO:0051944	GO:BP	positive regulation of catecholamine uptake involved in synaptic transmission	16175	14014		0.38095238095238093	0.5	3	16172	2	13	1	16159	16175	0.29789344298100395
R1	cpdb	0	network_modules	246	TRUE	0.004635263440329214	117	15	4	0.26666666666666666	0.03418803418803419	GO:0099587	GO:BP	inorganic ion import across plasma membrane	16175	19152		0.5238095238095238	0.5909090909090909	117	16058	4	11	113	16047	16175	0.093273070226945
R1	cpdb	0	network_modules	246	TRUE	0.004635263440329214	117	15	4	0.26666666666666666	0.03418803418803419	GO:0098659	GO:BP	inorganic cation import across plasma membrane	16175	18815		0.5238095238095238	0.5909090909090909	117	16058	4	11	113	16047	16175	0.093273070226945
R1	cpdb	0	network_modules	246	TRUE	0.004792936273151985	5	14	2	0.14285714285714285	0.4	REAC:R-HSA-390651	REAC	Dopamine receptors	10916	783		1	1	5	10911	2	12	3	10899	10916	0.23848684005241802
R1	cpdb	0	network_modules	246	TRUE	0.005619419136904304	282	15	5	0.3333333333333333	0.01773049645390071	GO:0042391	GO:BP	regulation of membrane potential	16175	10141		0.6190476190476191	0.6363636363636364	282	15893	5	10	277	15883	16175	0.07353431056289386
R1	cpdb	0	network_modules	246	TRUE	0.006682065795610729	4	15	2	0.13333333333333333	0.5	GO:0048149	GO:BP	behavioral response to ethanol	16175	12550		0.6666666666666666	0.7272727272727273	4	16171	2	13	2	16158	16175	0.25787147420379075
R1	cpdb	0	network_modules	246	TRUE	0.006682065795610729	4	15	2	0.13333333333333333	0.5	GO:0048148	GO:BP	behavioral response to cocaine	16175	12549		0.6666666666666666	0.7272727272727273	4	16171	2	13	2	16158	16175	0.25787147420379075
R1	cpdb	0	network_modules	246	TRUE	0.007094645745790315	197	12	4	0.3333333333333333	0.02030456852791878	KEGG:05130	KEGG	Pathogenic Escherichia coli infection	8484	427		1	1	197	8287	4	8	193	8279	8484	0.07749732553067994
R1	cpdb	0	network_modules	246	TRUE	0.007413973931031235	38	15	3	0.2	0.07894736842105263	GO:1903351	GO:BP	cellular response to dopamine	16175	22934		0.7619047619047619	0.8181818181818182	38	16137	3	12	35	16125	16175	0.1243839630022159
R1	cpdb	0	network_modules	246	TRUE	0.007413973931031235	38	15	3	0.2	0.07894736842105263	GO:1903350	GO:BP	response to dopamine	16175	22933		0.7619047619047619	0.8181818181818182	38	16137	3	12	35	16125	16175	0.1243839630022159
R1	cpdb	0	network_modules	246	TRUE	0.008673366523155073	40	15	3	0.2	0.075	GO:0071867	GO:BP	response to monoamine	16175	16949		0.8571428571428571	1	40	16135	3	12	37	16123	16175	0.12116615688344903
R1	cpdb	0	network_modules	246	TRUE	0.008673366523155073	40	15	3	0.2	0.075	GO:0071870	GO:BP	cellular response to catecholamine stimulus	16175	16952		0.8571428571428571	1	40	16135	3	12	37	16123	16175	0.12116615688344903
R1	cpdb	0	network_modules	246	TRUE	0.008673366523155073	40	15	3	0.2	0.075	GO:0071869	GO:BP	response to catecholamine	16175	16951		0.8571428571428571	1	40	16135	3	12	37	16123	16175	0.12116615688344903
R1	cpdb	0	network_modules	246	TRUE	0.008673366523155073	40	15	3	0.2	0.075	GO:0071868	GO:BP	cellular response to monoamine stimulus	16175	16950		0.8571428571428571	1	40	16135	3	12	37	16123	16175	0.12116615688344903
R1	cpdb	0	network_modules	248	TRUE	1.0459590084461666e-16	108	27	12	0.4444444444444444	0.1111111111111111	GO:0061640	GO:BP	cytoskeleton-dependent cytokinesis	16175	15599		0	0.25	108	16067	12	15	96	16052	16175	0.21980168467010472
R1	cpdb	0	network_modules	248	TRUE	4.146056268042345e-14	175	27	12	0.4444444444444444	0.06857142857142857	GO:0000910	GO:BP	cytokinesis	16175	243		0.3333333333333333	0.5	175	16000	12	15	163	15985	16175	0.17139666913096785
R1	cpdb	0	network_modules	248	TRUE	6.36798104549775e-12	265	27	12	0.4444444444444444	0.045283018867924525	GO:0051301	GO:BP	cell division	16175	13632		0.6666666666666666	0.75	265	15910	12	15	253	15895	16175	0.13788422258649782
R1	cpdb	0	network_modules	248	TRUE	2.5853638198028906e-9	77	16	7	0.4375	0.09090909090909091	KEGG:05100	KEGG	Bacterial invasion of epithelial cells	8484	423		0	0.3333333333333333	77	8407	7	9	70	8398	8484	0.19637139512142465
R1	cpdb	0	network_modules	248	TRUE	9.09869831710548e-6	246	16	7	0.4375	0.028455284552845527	KEGG:05131	KEGG	Shigellosis	8484	428		0.5	0.6666666666666666	246	8238	7	9	239	8229	8484	0.10582501804548726
R1	cpdb	0	network_modules	248	TRUE	2.700304993945406e-4	140	16	5	0.3125	0.03571428571428571	KEGG:04120	KEGG	Ubiquitin mediated proteolysis	8484	270		1	1	140	8344	5	11	135	8333	8484	0.10099697142078368
R1	cpdb	0	network_modules	248	TRUE	0.005022563213032467	62	27	4	0.14814814814814814	0.06451612903225806	GO:1902017	GO:BP	regulation of cilium assembly	16175	21945		1	1	62	16113	4	23	58	16090	16175	0.09549803695534717
R1	cpdb	0	network_modules	248	TRUE	0.005928091413834963	308	13	5	0.38461538461538464	0.016233766233766232	REAC:R-HSA-983168	REAC	Antigen processing: Ubiquitination & Proteasome degradation	10916	154		NA	1	308	10608	5	8	303	10600	10916	0.07432033909680154
R1	cpdb	0	network_modules	249	TRUE	5.475174372588745e-35	51	27	18	0.6666666666666666	0.35294117647058826	REAC:R-HSA-5620920	REAC	Cargo trafficking to the periciliary membrane	10916	310		0	0.125	51	10865	18	9	33	10856	10916	0.48339919233347345
R1	cpdb	0	network_modules	249	TRUE	9.866711654423142e-30	200	27	21	0.7777777777777778	0.105	REAC:R-HSA-5617833	REAC	Cilium Assembly	10916	361		0.14285714285714285	0.25	200	10716	21	6	179	10710	10916	0.28198285607597023
R1	cpdb	0	network_modules	249	TRUE	3.772978305710896e-26	292	27	21	0.7777777777777778	0.07191780821917808	REAC:R-HSA-1852241	REAC	Organelle biogenesis and maintenance	10916	1646		0.2857142857142857	0.375	292	10624	21	6	271	10618	10916	0.2317779474794701
R1	cpdb	0	network_modules	249	TRUE	1.2506111237699888e-24	23	27	12	0.4444444444444444	0.5217391304347826	REAC:R-HSA-5620922	REAC	BBSome-mediated cargo-targeting to cilium	10916	199		0.42857142857142855	0.5	23	10893	12	15	11	10878	10916	0.4803606744799084
R1	cpdb	0	network_modules	249	TRUE	3.0959757547853244e-15	9	32	7	0.21875	0.7777777777777778	GO:0090522	GO:BP	vesicle tethering involved in exocytosis	16175	18337		0	0.014925373134328358	9	16166	7	25	2	16141	16175	0.41195197819863566
R1	cpdb	0	network_modules	249	TRUE	9.491545412580205e-15	178	32	13	0.40625	0.07303370786516854	GO:0051650	GO:BP	establishment of vesicle localization	16175	13863		0.015151515151515152	0.029850746268656716	178	15997	13	19	165	15978	16175	0.16868041674031273
R1	cpdb	0	network_modules	249	TRUE	1.6994075188003256e-14	186	32	13	0.40625	0.06989247311827956	GO:0051648	GO:BP	vesicle localization	16175	13861		0.030303030303030304	0.04477611940298507	186	15989	13	19	173	15970	16175	0.16484774878181124
R1	cpdb	0	network_modules	249	TRUE	3.491253196963918e-14	343	32	15	0.46875	0.043731778425655975	GO:0060271	GO:BP	cilium assembly	16175	14488		0.045454545454545456	0.05970149253731343	343	15832	15	17	328	15815	16175	0.13830833926936317
R1	cpdb	0	network_modules	249	TRUE	9.992122392880916e-14	368	32	15	0.46875	0.04076086956521739	GO:0044782	GO:BP	cilium organization	16175	11155		0.06060606060606061	0.07462686567164178	368	15807	15	17	353	15790	16175	0.1331717936221912
R1	cpdb	0	network_modules	249	TRUE	3.3779459293875286e-13	503	32	16	0.5	0.03180914512922465	GO:0120031	GO:BP	plasma membrane bounded cell projection assembly	16175	19467		0.07575757575757576	0.08955223880597014	503	15672	16	16	487	15656	16175	0.12027174647143649
R1	cpdb	0	network_modules	249	TRUE	4.749634214606381e-13	514	32	16	0.5	0.0311284046692607	GO:0030031	GO:BP	cell projection assembly	16175	6655		0.09090909090909091	0.1044776119402985	514	15661	16	16	498	15645	16175	0.11884699117245544
R1	cpdb	0	network_modules	249	TRUE	1.622141494894859e-11	519	32	15	0.46875	0.028901734104046242	GO:0051640	GO:BP	organelle localization	16175	13853		0.10606060606060606	0.11940298507462686	519	15656	15	17	504	15639	16175	0.11031889631591496
R1	cpdb	0	network_modules	249	TRUE	2.065129121054095e-10	57	32	8	0.25	0.14035087719298245	GO:0006893	GO:BP	Golgi to plasma membrane transport	16175	2548		0.12121212121212122	0.13432835820895522	57	16118	8	24	49	16094	16175	0.18518630447743917
R1	cpdb	0	network_modules	249	TRUE	2.1950247465668668e-10	31	32	7	0.21875	0.22580645161290322	GO:0099022	GO:BP	vesicle tethering	16175	19011		0.13636363636363635	0.14925373134328357	31	16144	7	25	24	16119	16175	0.2207328841398855
R1	cpdb	0	network_modules	249	TRUE	3.556419960327566e-10	33	32	7	0.21875	0.21212121212121213	GO:0045494	GO:BP	photoreceptor cell maintenance	16175	11413		0.15151515151515152	0.16417910447761194	33	16142	7	25	26	16117	16175	0.21383071795391043
R1	cpdb	0	network_modules	249	TRUE	4.873504457145796e-10	410	32	13	0.40625	0.03170731707317073	GO:0051656	GO:BP	establishment of organelle localization	16175	13869		0.16666666666666666	0.1791044776119403	410	15765	13	19	397	15746	16175	0.10789511124643252
R1	cpdb	0	network_modules	249	TRUE	6.921132215864801e-10	36	32	7	0.21875	0.19444444444444445	GO:0006904	GO:BP	vesicle docking involved in exocytosis	16175	2556		0.18181818181818182	0.19402985074626866	36	16139	7	25	29	16114	16175	0.20457112037738312
R1	cpdb	0	network_modules	249	TRUE	9.791819866257796e-10	18	32	6	0.1875	0.3333333333333333	GO:0051904	GO:BP	pigment granule transport	16175	13987		0.19696969696969696	0.22388059701492538	18	16157	6	26	12	16131	16175	0.24890095217273667
R1	cpdb	0	network_modules	249	TRUE	9.791819866257796e-10	18	32	6	0.1875	0.3333333333333333	GO:0032402	GO:BP	melanosome transport	16175	7546		0.19696969696969696	0.22388059701492538	18	16157	6	26	12	16131	16175	0.24890095217273667
R1	cpdb	0	network_modules	249	TRUE	1.1597013949501276e-9	70	32	8	0.25	0.11428571428571428	GO:0140056	GO:BP	organelle localization by membrane tethering	16175	19654		0.22727272727272727	0.23880597014925373	70	16105	8	24	62	16081	16175	0.16663031760881128
R1	cpdb	0	network_modules	249	TRUE	1.4291390352447568e-9	19	32	6	0.1875	0.3157894736842105	GO:0032401	GO:BP	establishment of melanosome localization	16175	7545		0.24242424242424243	0.26865671641791045	19	16156	6	26	13	16130	16175	0.2421895347211356
R1	cpdb	0	network_modules	249	TRUE	1.4291390352447568e-9	19	32	6	0.1875	0.3157894736842105	GO:0051905	GO:BP	establishment of pigment granule localization	16175	13988		0.24242424242424243	0.26865671641791045	19	16156	6	26	13	16130	16175	0.2421895347211356
R1	cpdb	0	network_modules	249	TRUE	2.140186358291353e-9	21	27	6	0.2222222222222222	0.2857142857142857	REAC:R-HSA-5620916	REAC	VxPx cargo-targeting to cilium	10916	2667		0.5714285714285714	0.625	21	10895	6	21	15	10874	10916	0.2503453727392346
R1	cpdb	0	network_modules	249	TRUE	2.2186803163102527e-9	42	32	7	0.21875	0.16666666666666666	GO:0001895	GO:BP	retina homeostasis	16175	520		0.2727272727272727	0.2835820895522388	42	16133	7	25	35	16108	16175	0.18910674300798871
R1	cpdb	0	network_modules	249	TRUE	2.850401691042619e-9	21	32	6	0.1875	0.2857142857142857	GO:0051875	GO:BP	pigment granule localization	16175	13962		0.2878787878787879	0.31343283582089554	21	16154	6	26	15	16128	16175	0.23022957434431301
R1	cpdb	0	network_modules	249	TRUE	2.850401691042619e-9	21	32	6	0.1875	0.2857142857142857	GO:0032400	GO:BP	melanosome localization	16175	7544		0.2878787878787879	0.31343283582089554	21	16154	6	26	15	16128	16175	0.23022957434431301
R1	cpdb	0	network_modules	249	TRUE	3.142926777658076e-9	44	32	7	0.21875	0.1590909090909091	GO:0090148	GO:BP	membrane fission	16175	18057		0.3181818181818182	0.3283582089552239	44	16131	7	25	37	16106	16175	0.18466463832037547
R1	cpdb	0	network_modules	249	TRUE	3.514146699117907e-9	80	32	8	0.25	0.1	GO:0022406	GO:BP	membrane docking	16175	6597		0.3333333333333333	0.34328358208955223	80	16095	8	24	72	16071	16175	0.15552443661968857
R1	cpdb	0	network_modules	249	TRUE	4.762727453736381e-9	83	32	8	0.25	0.0963855421686747	GO:0000281	GO:BP	mitotic cytokinesis	16175	79		0.3484848484848485	0.3582089552238806	83	16092	8	24	75	16068	16175	0.15258654467238747
R1	cpdb	0	network_modules	249	TRUE	6.938853430567983e-9	25	27	6	0.2222222222222222	0.24	REAC:R-HSA-264876	REAC	Insulin processing	10916	1209		0.7142857142857143	0.75	25	10891	6	21	19	10870	10916	0.2291057358856875
R1	cpdb	0	network_modules	249	TRUE	1.639708897309744e-8	55	32	7	0.21875	0.12727272727272726	GO:0048278	GO:BP	vesicle docking	16175	12620		0.36363636363636365	0.373134328358209	55	16120	7	25	48	16095	16175	0.16470528859088082
R1	cpdb	0	network_modules	249	TRUE	1.8714135447284454e-8	56	32	7	0.21875	0.125	GO:0140029	GO:BP	exocytic process	16175	19642		0.3787878787878788	0.3880597014925373	56	16119	7	25	49	16094	16175	0.16318628252601391
R1	cpdb	0	network_modules	249	TRUE	2.1969543720876705e-8	100	32	8	0.25	0.08	GO:0006892	GO:BP	post-Golgi vesicle-mediated transport	16175	2547		0.3939393939393939	0.40298507462686567	100	16075	8	24	92	16051	16175	0.13848946947230226
R1	cpdb	0	network_modules	249	TRUE	2.7416637681818982e-8	59	32	7	0.21875	0.11864406779661017	GO:0006903	GO:BP	vesicle targeting	16175	2555		0.4090909090909091	0.417910447761194	59	16116	7	25	52	16091	16175	0.15886117383202747
R1	cpdb	0	network_modules	249	TRUE	4.112183017942851e-8	108	32	8	0.25	0.07407407407407407	GO:0061640	GO:BP	cytoskeleton-dependent cytokinesis	16175	15599		0.42424242424242425	0.43283582089552236	108	16067	8	24	100	16043	16175	0.13302433462814192
R1	cpdb	0	network_modules	249	TRUE	1.0325891747480093e-7	72	27	7	0.25925925925925924	0.09722222222222222	REAC:R-HSA-1445148	REAC	Translocation of SLC2A4 (GLUT4) to the plasma membrane	10916	2578		0.8571428571428571	0.875	72	10844	7	20	65	10824	10916	0.15542926969623763
R1	cpdb	0	network_modules	249	TRUE	1.6717554538441852e-7	39	32	6	0.1875	0.15384615384615385	GO:1905515	GO:BP	non-motile cilium assembly	16175	24691		0.4393939393939394	0.44776119402985076	39	16136	6	26	33	16110	16175	0.16802628175560647
R1	cpdb	0	network_modules	249	TRUE	2.8093875119787123e-7	137	32	8	0.25	0.058394160583941604	GO:0098876	GO:BP	vesicle-mediated transport to the plasma membrane	16175	18924		0.45454545454545453	0.4626865671641791	137	16038	8	24	129	16014	16175	0.11734459717806466
R1	cpdb	0	network_modules	249	TRUE	1.98225521600899e-6	175	32	8	0.25	0.045714285714285714	GO:0000910	GO:BP	cytokinesis	16175	243		0.4696969696969697	0.47761194029850745	175	16000	8	24	167	15976	16175	0.10293771330994028
R1	cpdb	0	network_modules	249	TRUE	2.0202425578519363e-6	58	32	6	0.1875	0.10344827586206896	GO:0033059	GO:BP	cellular pigmentation	16175	8013		0.48484848484848486	0.4925373134328358	58	16117	6	26	52	16091	16175	0.1369892108150538
R1	cpdb	0	network_modules	249	TRUE	1.4044722235492682e-5	594	32	11	0.34375	0.018518518518518517	GO:0051668	GO:BP	localization within membrane	16175	13880		0.5	0.5074626865671642	594	15581	11	21	583	15560	16175	0.07267957166264818
R1	cpdb	0	network_modules	249	TRUE	1.5692154479168086e-5	81	32	6	0.1875	0.07407407407407407	GO:0043473	GO:BP	pigmentation	16175	10719		0.5151515151515151	0.5223880597014925	81	16094	6	26	75	16068	16175	0.11510577820291178
R1	cpdb	0	network_modules	249	TRUE	1.9130760916460152e-5	88	27	6	0.2222222222222222	0.06818181818181818	REAC:R-HSA-2980736	REAC	Peptide hormone metabolism	10916	1725		1	1	88	10828	6	21	82	10807	10916	0.11925473991822978
R1	cpdb	0	network_modules	249	TRUE	2.2898547296534864e-5	152	32	7	0.21875	0.046052631578947366	GO:0060249	GO:BP	anatomical structure homeostasis	16175	14466		0.5303030303030303	0.5522388059701493	152	16023	7	25	145	15998	16175	0.09660779757805438
R1	cpdb	0	network_modules	249	TRUE	2.2898547296534864e-5	152	32	7	0.21875	0.046052631578947366	GO:0001894	GO:BP	tissue homeostasis	16175	519		0.5303030303030303	0.5522388059701493	152	16023	7	25	145	15998	16175	0.09660779757805438
R1	cpdb	0	network_modules	249	TRUE	4.131875314962112e-5	4	32	3	0.09375	0.75	GO:0038108	GO:BP	negative regulation of appetite by leptin-mediated signaling pathway	16175	9702		0.5606060606060606	0.5671641791044776	4	16171	3	29	1	16142	16175	0.2647603185637826
R1	cpdb	0	network_modules	249	TRUE	5.1399759834456564e-05	265	32	8	0.25	0.03018867924528302	GO:0051301	GO:BP	cell division	16175	13632		0.5757575757575758	0.582089552238806	265	15910	8	24	257	15886	16175	0.08193566807938506
R1	cpdb	0	network_modules	249	TRUE	8.783340045803175e-5	284	32	8	0.25	0.028169014084507043	GO:0048193	GO:BP	Golgi vesicle transport	16175	12570		0.5909090909090909	0.5970149253731343	284	15891	8	24	276	15867	16175	0.07879652224380507
R1	cpdb	0	network_modules	249	TRUE	1.491368754073204e-4	59	32	5	0.15625	0.0847457627118644	GO:0061512	GO:BP	protein localization to cilium	16175	15514		0.6060606060606061	0.6119402985074627	59	16116	5	27	54	16089	16175	0.11270258348500817
R1	cpdb	0	network_modules	249	TRUE	3.600824481175372e-4	7	32	3	0.09375	0.42857142857142855	GO:0060296	GO:BP	regulation of cilium beat frequency involved in ciliary motility	16175	14510		0.6212121212121212	0.6567164179104478	7	16168	3	29	4	16139	16175	0.19976152254110363
R1	cpdb	0	network_modules	249	TRUE	3.600824481175372e-4	7	32	3	0.09375	0.42857142857142855	GO:0021544	GO:BP	subpallium development	16175	6128		0.6212121212121212	0.6567164179104478	7	16168	3	29	4	16139	16175	0.19976152254110363
R1	cpdb	0	network_modules	249	TRUE	3.600824481175372e-4	7	32	3	0.09375	0.42857142857142855	GO:0021756	GO:BP	striatum development	16175	6337		0.6212121212121212	0.6567164179104478	7	16168	3	29	4	16139	16175	0.19976152254110363
R1	cpdb	0	network_modules	249	TRUE	5.144535683993714e-4	145	32	6	0.1875	0.041379310344827586	GO:0045444	GO:BP	fat cell differentiation	16175	11377		0.6666666666666666	0.6716417910447762	145	16030	6	26	139	16004	16175	0.08433368848823677
R1	cpdb	0	network_modules	249	TRUE	5.753571925095902e-4	8	32	3	0.09375	0.375	GO:0032108	GO:BP	negative regulation of response to nutrient levels	16175	7369		0.6818181818181818	0.7164179104477612	8	16167	3	29	5	16138	16175	0.18674177234759662
R1	cpdb	0	network_modules	249	TRUE	5.753571925095902e-4	8	32	3	0.09375	0.375	GO:0032096	GO:BP	negative regulation of response to food	16175	7360		0.6818181818181818	0.7164179104477612	8	16167	3	29	5	16138	16175	0.18674177234759662
R1	cpdb	0	network_modules	249	TRUE	5.753571925095902e-4	8	32	3	0.09375	0.375	GO:0032099	GO:BP	negative regulation of appetite	16175	7363		0.6818181818181818	0.7164179104477612	8	16167	3	29	5	16138	16175	0.18674177234759662
R1	cpdb	0	network_modules	249	TRUE	7.87172402662871e-4	82	32	5	0.15625	0.06097560975609756	GO:0007368	GO:BP	determination of left/right symmetry	16175	2870		0.7272727272727273	0.7313432835820896	82	16093	5	27	77	16066	16175	0.09477577663058799
R1	cpdb	0	network_modules	249	TRUE	8.364655092880647e-4	83	32	5	0.15625	0.060240963855421686	GO:0060972	GO:BP	left/right pattern formation	16175	15099		0.7424242424242424	0.746268656716418	83	16092	5	27	78	16065	16175	0.09416751039677992
R1	cpdb	0	network_modules	249	TRUE	8.618753117235394e-4	9	32	3	0.09375	0.3333333333333333	GO:0033210	GO:BP	leptin-mediated signaling pathway	16175	8076		0.7575757575757576	0.7611940298507462	9	16166	3	29	6	16137	16175	0.17595055271848542
R1	cpdb	0	network_modules	249	TRUE	9.700740334914644e-4	263	32	7	0.21875	0.026615969581749048	GO:0006887	GO:BP	exocytosis	16175	2543		0.7727272727272727	0.7761194029850746	263	15912	7	25	256	15887	16175	0.07128385949090962
R1	cpdb	0	network_modules	249	TRUE	0.001185854169087845	89	32	5	0.15625	0.056179775280898875	GO:0009855	GO:BP	determination of bilateral symmetry	16175	3727		0.7878787878787878	0.8059701492537313	89	16086	5	27	84	16059	16175	0.09073164008154677
R1	cpdb	0	network_modules	249	TRUE	0.001185854169087845	89	32	5	0.15625	0.056179775280898875	GO:0009799	GO:BP	specification of symmetry	16175	3683		0.7878787878787878	0.8059701492537313	89	16086	5	27	84	16059	16175	0.09073164008154677
R1	cpdb	0	network_modules	249	TRUE	0.001688419813370325	11	32	3	0.09375	0.2727272727272727	GO:0044320	GO:BP	cellular response to leptin stimulus	16175	10955		0.8181818181818182	0.8208955223880597	11	16164	3	29	8	16135	16175	0.15895193423622508
R1	cpdb	0	network_modules	249	TRUE	0.001969605595718576	42	32	4	0.125	0.09523809523809523	GO:0001947	GO:BP	heart looping	16175	558		0.8333333333333334	0.835820895522388	42	16133	4	28	38	16105	16175	0.10708741260816522
R1	cpdb	0	network_modules	249	TRUE	0.00285565441826092	46	32	4	0.125	0.08695652173913043	GO:0003143	GO:BP	embryonic heart tube morphogenesis	16175	1575		0.8484848484848485	0.8656716417910447	46	16129	4	28	42	16101	16175	0.10213149644093024
R1	cpdb	0	network_modules	249	TRUE	0.00285565441826092	46	32	4	0.125	0.08695652173913043	GO:0061371	GO:BP	determination of heart left/right asymmetry	16175	15443		0.8484848484848485	0.8656716417910447	46	16129	4	28	42	16101	16175	0.10213149644093024
R1	cpdb	0	network_modules	249	TRUE	0.0029187302892246902	13	32	3	0.09375	0.23076923076923078	GO:0032095	GO:BP	regulation of response to food	16175	7359		0.8787878787878788	0.8805970149253731	13	16162	3	29	10	16133	16175	0.14602929542180088
R1	cpdb	0	network_modules	249	TRUE	0.0037097536379917273	14	32	3	0.09375	0.21428571428571427	GO:0044321	GO:BP	response to leptin	16175	10956		0.8939393939393939	0.8955223880597015	14	16161	3	29	11	16132	16175	0.14062810170400844
R1	cpdb	0	network_modules	249	TRUE	0.004630958190475777	15	32	3	0.09375	0.2	GO:0003356	GO:BP	regulation of cilium beat frequency	16175	1776		0.9090909090909091	0.9104477611940298	15	16160	3	29	12	16131	16175	0.135773426201086
R1	cpdb	0	network_modules	249	TRUE	0.0046983231258118496	52	32	4	0.125	0.07692307692307693	GO:0035050	GO:BP	embryonic heart tube development	16175	8784		0.9242424242424242	0.9253731343283582	52	16123	4	28	48	16095	16175	0.09578487470907045
R1	cpdb	0	network_modules	249	TRUE	0.005576234529139214	2	32	2	0.0625	1	GO:0051877	GO:BP	pigment granule aggregation in cell center	16175	13964		0.9393939393939394	0.9402985074626866	2	16173	2	30	0	16143	16175	0.2497680244466571
R1	cpdb	0	network_modules	249	TRUE	0.005691979037495032	16	32	3	0.09375	0.1875	GO:0048854	GO:BP	brain morphogenesis	16175	13098		0.9545454545454546	0.9701492537313433	16	16159	3	29	13	16130	16175	0.1313785603442454
R1	cpdb	0	network_modules	249	TRUE	0.005691979037495032	16	32	3	0.09375	0.1875	GO:0032098	GO:BP	regulation of appetite	16175	7362		0.9545454545454546	0.9701492537313433	16	16159	3	29	13	16130	16175	0.1313785603442454
R1	cpdb	0	network_modules	249	TRUE	0.009630869533254517	136	32	5	0.15625	0.03676470588235294	GO:0048562	GO:BP	embryonic organ morphogenesis	16175	12835		0.9848484848484849	0.9850746268656716	136	16039	5	27	131	16012	16175	0.07208863086331889
R1	cpdb	0	network_modules	249	TRUE	0.009809493645624893	19	32	3	0.09375	0.15789473684210525	GO:0032094	GO:BP	response to food	16175	7358		1	1	19	16156	3	29	16	16127	16175	0.12033134874051403
R1	cpdb	0	network_modules	250	TRUE	1.2911673501604452e-20	8	21	8	0.38095238095238093	1	REAC:R-HSA-68952	REAC	DNA replication initiation	10916	448		0	0.022727272727272728	8	10908	8	13	0	10895	10916	0.6168454971036483
R1	cpdb	0	network_modules	250	TRUE	4.7027743287868404e-17	36	15	9	0.6	0.25	KEGG:03030	KEGG	DNA replication	8484	214		0	0.3333333333333333	36	8448	9	6	27	8442	8484	0.38571894362121223
R1	cpdb	0	network_modules	250	TRUE	1.7457595967062815e-13	33	21	8	0.38095238095238093	0.24242424242424243	REAC:R-HSA-68962	REAC	Activation of the pre-replicative complex	10916	107		0.023255813953488372	0.045454545454545456	33	10883	8	13	25	10870	10916	0.3022308764313828
R1	cpdb	0	network_modules	250	TRUE	2.282280138306063e-13	147	26	11	0.4230769230769231	0.07482993197278912	GO:0006261	GO:BP	DNA-templated DNA replication	16175	2078		0	0.14285714285714285	147	16028	11	15	136	16013	16175	0.17504448369649483
R1	cpdb	0	network_modules	250	TRUE	6.078752114843077e-13	231	26	12	0.46153846153846156	0.05194805194805195	GO:0006260	GO:BP	DNA replication	16175	2077		0.16666666666666666	0.2857142857142857	231	15944	12	14	219	15930	16175	0.151255375534504
R1	cpdb	0	network_modules	250	TRUE	1.93385190242129e-12	121	21	10	0.47619047619047616	0.08264462809917356	REAC:R-HSA-69239	REAC	Synthesis of DNA	10916	2376		0.046511627906976744	0.06818181818181818	121	10795	10	11	111	10784	10916	0.19503265447449644
R1	cpdb	0	network_modules	250	TRUE	2.670341939546718e-12	187	21	11	0.5238095238095238	0.058823529411764705	REAC:R-HSA-69306	REAC	DNA Replication	10916	445		0.06976744186046512	0.09090909090909091	187	10729	11	10	176	10719	10916	0.17143195761678667
R1	cpdb	0	network_modules	250	TRUE	9.908084330294038e-12	5	26	5	0.19230769230769232	1	GO:0006269	GO:BP	DNA replication, synthesis of primer	16175	2084		0.3333333333333333	0.42857142857142855	5	16170	5	21	0	16149	16175	0.4382441580420007
R1	cpdb	0	network_modules	250	TRUE	3.8024938762425866e-11	162	21	10	0.47619047619047616	0.06172839506172839	REAC:R-HSA-69242	REAC	S Phase	10916	2111		0.09302325581395349	0.11363636363636363	162	10754	10	11	152	10743	10916	0.1675125852553606
R1	cpdb	0	network_modules	250	TRUE	3.0035966111316985e-10	130	21	9	0.42857142857142855	0.06923076923076923	REAC:R-HSA-69206	REAC	G1/S Transition	10916	1002		0.11627906976744186	0.13636363636363635	130	10786	9	12	121	10774	10916	0.16863273522705297
R1	cpdb	0	network_modules	250	TRUE	9.228492705283933e-10	147	21	9	0.42857142857142855	0.061224489795918366	REAC:R-HSA-453279	REAC	Mitotic G1 phase and G1/S transition	10916	1480		0.13953488372093023	0.1590909090909091	147	10769	9	12	138	10757	10916	0.158114289602086
R1	cpdb	0	network_modules	250	TRUE	1.8835140344152765e-9	159	21	9	0.42857142857142855	0.05660377358490566	REAC:R-HSA-69002	REAC	DNA Replication Pre-Initiation	10916	446		0.16279069767441862	0.18181818181818182	159	10757	9	12	150	10745	10916	0.15171261088997792
R1	cpdb	0	network_modules	250	TRUE	1.4803398714645175e-8	15	21	5	0.23809523809523808	0.3333333333333333	REAC:R-HSA-69183	REAC	Processive synthesis on the lagging strand	10916	1802		0.18604651162790697	0.20454545454545456	15	10901	5	16	10	10885	10916	0.2805548257817498
R1	cpdb	0	network_modules	250	TRUE	7.596145873225156e-8	20	21	5	0.23809523809523808	0.25	REAC:R-HSA-69186	REAC	Lagging Strand Synthesis	10916	1302		0.20930232558139536	0.22727272727272727	20	10896	5	16	15	10880	10916	0.2425531091117754
R1	cpdb	0	network_modules	250	TRUE	9.95775015424168e-8	21	21	5	0.23809523809523808	0.23809523809523808	REAC:R-HSA-5651801	REAC	PCNA-Dependent Long Patch Base Excision Repair	10916	1658		0.23255813953488372	0.25	21	10895	5	16	16	10879	10916	0.23662667453397146
R1	cpdb	0	network_modules	250	TRUE	1.2496852773627134e-7	51	21	6	0.2857142857142857	0.11764705882352941	REAC:R-HSA-180786	REAC	Extension of Telomeres	10916	887		0.2558139534883721	0.2727272727272727	51	10865	6	15	45	10850	10916	0.18093859313302668
R1	cpdb	0	network_modules	250	TRUE	2.587213134442863e-7	25	21	5	0.23809523809523808	0.2	REAC:R-HSA-110373	REAC	Resolution of AP sites via the multiple-nucleotide patch replacement pathway	10916	2073		0.27906976744186046	0.3181818181818182	25	10891	5	16	20	10875	10916	0.2165751997709923
R1	cpdb	0	network_modules	250	TRUE	2.587213134442863e-7	25	21	5	0.23809523809523808	0.2	REAC:R-HSA-5696397	REAC	Gap-filling DNA repair synthesis and ligation in GG-NER	10916	1037		0.27906976744186046	0.3181818181818182	25	10891	5	16	20	10875	10916	0.2165751997709923
R1	cpdb	0	network_modules	250	TRUE	5.443074581620389e-7	44	15	5	0.3333333333333333	0.11363636363636363	KEGG:03410	KEGG	Base excision repair	8484	237		0.5	0.6666666666666666	44	8440	5	10	39	8430	8484	0.19226544279132562
R1	cpdb	0	network_modules	250	TRUE	9.722526382672424e-7	32	21	5	0.23809523809523808	0.15625	REAC:R-HSA-69190	REAC	DNA strand elongation	10916	449		0.32558139534883723	0.3409090909090909	32	10884	5	16	27	10868	10916	0.19096804377470977
R1	cpdb	0	network_modules	250	TRUE	1.3401475481206427e-6	34	21	5	0.23809523809523808	0.14705882352941177	REAC:R-HSA-174417	REAC	Telomere C-strand (Lagging Strand) Synthesis	10916	2486		0.3488372093023256	0.36363636363636365	34	10882	5	16	29	10866	10916	0.18513888454370933
R1	cpdb	0	network_modules	250	TRUE	1.8112432451447183e-6	36	21	5	0.23809523809523808	0.1388888888888889	REAC:R-HSA-73933	REAC	Resolution of Abasic Sites (AP sites)	10916	2075		0.37209302325581395	0.38636363636363635	36	10880	5	16	31	10864	10916	0.1797988903305315
R1	cpdb	0	network_modules	250	TRUE	1.9377443602630953e-6	32	26	5	0.19230769230769232	0.15625	GO:0006270	GO:BP	DNA replication initiation	16175	2085		0.5	0.5714285714285714	32	16143	5	21	27	16122	16175	0.171868684863401
R1	cpdb	0	network_modules	250	TRUE	2.2646650952583986e-6	13	21	4	0.19047619047619047	0.3076923076923077	REAC:R-HSA-113501	REAC	Inhibition of replication initiation of damaged DNA by RB1/E2F1	10916	1198		0.3953488372093023	0.4318181818181818	13	10903	4	17	9	10886	10916	0.24095265289158788
R1	cpdb	0	network_modules	250	TRUE	2.2646650952583986e-6	13	21	4	0.19047619047619047	0.3076923076923077	REAC:R-HSA-174430	REAC	Telomere C-strand synthesis initiation	10916	2487		0.3953488372093023	0.4318181818181818	13	10903	4	17	9	10886	10916	0.24095265289158788
R1	cpdb	0	network_modules	250	TRUE	2.932117099079724e-6	61	15	5	0.3333333333333333	0.08196721311475409	KEGG:03420	KEGG	Nucleotide excision repair	8484	238		1	1	61	8423	5	10	56	8413	8484	0.16245773889619164
R1	cpdb	0	network_modules	250	TRUE	3.16657872860657e-6	14	21	4	0.19047619047619047	0.2857142857142857	REAC:R-HSA-69166	REAC	Removal of the Flap Intermediate	10916	2058		0.4418604651162791	0.5	14	10902	4	17	10	10885	10916	0.23208605732703347
R1	cpdb	0	network_modules	250	TRUE	3.16657872860657e-6	14	21	4	0.19047619047619047	0.2857142857142857	REAC:R-HSA-69091	REAC	Polymerase switching	10916	1769		0.4418604651162791	0.5	14	10902	4	17	10	10885	10916	0.23208605732703347
R1	cpdb	0	network_modules	250	TRUE	3.16657872860657e-6	14	21	4	0.19047619047619047	0.2857142857142857	REAC:R-HSA-69109	REAC	Leading Strand Synthesis	10916	1308		0.4418604651162791	0.5	14	10902	4	17	10	10885	10916	0.23208605732703347
R1	cpdb	0	network_modules	250	TRUE	9.822774130339301e-6	15	26	4	0.15384615384615385	0.26666666666666666	GO:0006271	GO:BP	DNA strand elongation involved in DNA replication	16175	2086		0.6666666666666666	0.7142857142857143	15	16160	4	22	11	16138	16175	0.20158244598059116
R1	cpdb	0	network_modules	250	TRUE	1.4634218666230482e-5	111	21	6	0.2857142857142857	0.05405405405405406	REAC:R-HSA-157579	REAC	Telomere Maintenance	10916	2489		0.5116279069767442	0.5227272727272727	111	10805	6	15	105	10790	10916	0.12058113315675267
R1	cpdb	0	network_modules	250	TRUE	2.0461444381733738e-05	4	26	3	0.11538461538461539	0.75	GO:0006272	GO:BP	leading strand elongation	16175	2087		0.8333333333333334	0.8571428571428571	4	16171	3	23	1	16148	16175	0.2938162617423233
R1	cpdb	0	network_modules	250	TRUE	2.2910586988732763e-5	22	21	4	0.19047619047619047	0.18181818181818182	REAC:R-HSA-113510	REAC	E2F mediated regulation of DNA replication	10916	809		0.5348837209302325	0.5454545454545454	22	10894	4	17	18	10877	10916	0.18449116021832385
R1	cpdb	0	network_modules	250	TRUE	3.267107270261379e-5	63	21	5	0.23809523809523808	0.07936507936507936	REAC:R-HSA-6782210	REAC	Gap-filling DNA repair synthesis and ligation in TC-NER	10916	1038		0.5581395348837209	0.5681818181818182	63	10853	5	16	58	10837	10916	0.13465058910660682
R1	cpdb	0	network_modules	250	TRUE	4.6590310299835156e-5	26	21	4	0.19047619047619047	0.15384615384615385	REAC:R-HSA-174411	REAC	Polymerase switching on the C-strand of the telomere	10916	1770		0.5813953488372093	0.5909090909090909	26	10890	4	17	22	10873	10916	0.1694083176691205
R1	cpdb	0	network_modules	250	TRUE	5.378056836405385e-5	138	21	6	0.2857142857142857	0.043478260869565216	REAC:R-HSA-73886	REAC	Chromosome Maintenance	10916	357		0.6046511627906976	0.6136363636363636	138	10778	6	15	132	10763	10916	0.10730712524253161
R1	cpdb	0	network_modules	250	TRUE	6.432100101261763e-5	72	21	5	0.23809523809523808	0.06944444444444445	REAC:R-HSA-9710421	REAC	Defective pyroptosis	10916	702		0.627906976744186	0.6363636363636364	72	10844	5	16	67	10828	10916	0.12555917490737178
R1	cpdb	0	network_modules	250	TRUE	8.497996228273028e-5	30	21	4	0.19047619047619047	0.13333333333333333	REAC:R-HSA-110314	REAC	Recognition of DNA damage by PCNA-containing replication complex	10916	1948		0.6511627906976745	0.6590909090909091	30	10886	4	17	26	10869	10916	0.1574322341033721
R1	cpdb	0	network_modules	250	TRUE	9.027405736736335e-5	77	21	5	0.23809523809523808	0.06493506493506493	REAC:R-HSA-6781827	REAC	Transcription-Coupled Nucleotide Excision Repair (TC-NER)	10916	2541		0.6744186046511628	0.6818181818181818	77	10839	5	16	72	10823	10916	0.12120187588671101
R1	cpdb	0	network_modules	250	TRUE	1.1123014206002465e-4	32	21	4	0.19047619047619047	0.125	REAC:R-HSA-5656169	REAC	Termination of translesion DNA synthesis	10916	2492		0.6976744186046512	0.7045454545454546	32	10884	4	17	28	10867	10916	0.15229832562815024
R1	cpdb	0	network_modules	250	TRUE	1.3984911954457446e-4	84	21	5	0.23809523809523808	0.05952380952380952	REAC:R-HSA-5696399	REAC	Global Genome Nucleotide Excision Repair (GG-NER)	10916	1047		0.7209302325581395	0.7272727272727273	84	10832	5	16	79	10816	10916	0.1157572693930799
R1	cpdb	0	network_modules	250	TRUE	1.7659587633362016e-4	88	21	5	0.23809523809523808	0.056818181818181816	REAC:R-HSA-73884	REAC	Base Excision Repair	10916	205		0.7441860465116279	0.75	88	10828	5	16	83	10812	10916	0.11293681067116342
R1	cpdb	0	network_modules	250	TRUE	2.5220278333946456e-4	39	21	4	0.19047619047619047	0.10256410256410256	REAC:R-HSA-110313	REAC	Translesion synthesis by Y family DNA polymerases bypasses lesions on DNA template	10916	2577		0.7674418604651163	0.7727272727272727	39	10877	4	17	35	10860	10916	0.13752764767893022
R1	cpdb	0	network_modules	250	TRUE	3.0974574472329133e-4	41	21	4	0.19047619047619047	0.0975609756097561	REAC:R-HSA-5696400	REAC	Dual Incision in GG-NER	10916	807		0.7906976744186046	0.7954545454545454	41	10875	4	17	37	10858	10916	0.13401221435125507
R1	cpdb	0	network_modules	250	TRUE	3.8741771024098417e-4	103	21	5	0.23809523809523808	0.04854368932038835	REAC:R-HSA-9645723	REAC	Diseases of programmed cell death	10916	771		0.813953488372093	0.8181818181818182	103	10813	5	16	98	10797	10916	0.10383820753588419
R1	cpdb	0	network_modules	250	TRUE	4.6401890099829443e-4	37	26	4	0.15384615384615385	0.10810810810810811	GO:0022616	GO:BP	DNA strand elongation	16175	6623		1	1	37	16138	4	22	33	16116	16175	0.1272955503413058
R1	cpdb	0	network_modules	250	TRUE	5.13233137827192e-4	109	21	5	0.23809523809523808	0.045871559633027525	REAC:R-HSA-5696398	REAC	Nucleotide Excision Repair	10916	1622		0.8372093023255814	0.8409090909090909	109	10807	5	16	104	10791	10916	0.10072513494160679
R1	cpdb	0	network_modules	250	TRUE	5.899671262984014e-4	48	21	4	0.19047619047619047	0.08333333333333333	REAC:R-HSA-73893	REAC	DNA Damage Bypass	10916	438		0.8604651162790697	0.8636363636363636	48	10868	4	17	44	10851	10916	0.12346999470348081
R1	cpdb	0	network_modules	250	TRUE	0.0013209900058017351	132	21	5	0.23809523809523808	0.03787878787878788	REAC:R-HSA-5693567	REAC	HDR through Homologous Recombination (HRR) or Single Strand Annealing (SSA)	10916	1098		0.8837209302325582	0.8863636363636364	132	10784	5	16	127	10768	10916	0.09078135426712895
R1	cpdb	0	network_modules	250	TRUE	0.0016431774913585066	138	21	5	0.23809523809523808	0.036231884057971016	REAC:R-HSA-5693538	REAC	Homology Directed Repair	10916	1130		0.9069767441860465	0.9090909090909091	138	10778	5	16	133	10762	10916	0.08859463316375153
R1	cpdb	0	network_modules	250	TRUE	0.0018883564732547647	64	21	4	0.19047619047619047	0.0625	REAC:R-HSA-6782135	REAC	Dual incision in TC-NER	10916	808		0.9302325581395349	0.9318181818181818	64	10852	4	17	60	10835	10916	0.1061640590383211
R1	cpdb	0	network_modules	250	TRUE	0.0024083152210921653	68	21	4	0.19047619047619047	0.058823529411764705	REAC:R-HSA-5685942	REAC	HDR through Homologous Recombination (HRR)	10916	1097		0.9534883720930233	0.9545454545454546	68	10848	4	17	64	10831	10916	0.10280878388052324
R1	cpdb	0	network_modules	250	TRUE	0.0042907904113894235	168	21	5	0.23809523809523808	0.02976190476190476	REAC:R-HSA-5693532	REAC	DNA Double-Strand Break Repair	10916	443		0.9767441860465116	0.9772727272727273	168	10748	5	16	163	10732	10916	0.07942752431027306
R1	cpdb	0	network_modules	250	TRUE	0.008383421726908953	329	21	6	0.2857142857142857	0.0182370820668693	REAC:R-HSA-73894	REAC	DNA Repair	10916	444		1	1	329	10587	6	15	323	10572	10916	0.06562866800947906
R1	cpdb	0	network_modules	251	TRUE	1.476864688687156e-14	19	14	7	0.5	0.3684210526315789	REAC:R-HSA-5625900	REAC	RHO GTPases activate CIT	10916	1853		0	0.1	19	10897	7	7	12	10890	10916	0.4283509277723646
R1	cpdb	0	network_modules	251	TRUE	2.2434146549912998e-13	708	21	15	0.7142857142857143	0.0211864406779661	GO:0030029	GO:BP	actin filament-based process	16175	6653		0	0.14285714285714285	708	15467	15	6	693	15461	16175	0.11816867759149394
R1	cpdb	0	network_modules	251	TRUE	2.2295993052505097e-12	632	21	14	0.6666666666666666	0.022151898734177215	GO:0030036	GO:BP	actin cytoskeleton organization	16175	6660		0.16666666666666666	0.2857142857142857	632	15543	14	7	618	15536	16175	0.11677953298662282
R1	cpdb	0	network_modules	251	TRUE	1.0829469339488427e-11	19	14	6	0.42857142857142855	0.3157894736842105	REAC:R-HSA-5627117	REAC	RHO GTPases Activate ROCKs	10916	1850		0.1111111111111111	0.2	19	10897	6	8	13	10889	10916	0.3669441732801637
R1	cpdb	0	network_modules	251	TRUE	2.163169646358101e-11	21	14	6	0.42857142857142855	0.2857142857142857	REAC:R-HSA-5627123	REAC	RHO GTPases activate PAKs	10916	1856		0.2222222222222222	0.3	21	10895	6	8	15	10887	10916	0.34891572768820006
R1	cpdb	0	network_modules	251	TRUE	1.418410513500362e-10	193	14	9	0.6428571428571429	0.046632124352331605	KEGG:04814	KEGG	Motor proteins	8484	366		0	0.2	193	8291	9	5	184	8286	8484	0.16908633173988882
R1	cpdb	0	network_modules	251	TRUE	7.486192048973486e-9	20	14	5	0.35714285714285715	0.25	REAC:R-HSA-416572	REAC	Sema4D induced cell migration and growth-cone collapse	10916	2191		0.3333333333333333	0.4	20	10896	5	9	15	10887	10916	0.2977379390103213
R1	cpdb	0	network_modules	251	TRUE	2.0466865443987348e-8	24	14	5	0.35714285714285715	0.20833333333333334	REAC:R-HSA-400685	REAC	Sema4D in semaphorin signaling	10916	2190		0.4444444444444444	0.5	24	10892	5	9	19	10883	10916	0.2715658549146352
R1	cpdb	0	network_modules	251	TRUE	4.7194427760835764e-8	28	14	5	0.35714285714285715	0.17857142857142858	REAC:R-HSA-3928663	REAC	EPHA-mediated growth cone collapse	10916	820		0.5555555555555556	0.6	28	10888	5	9	23	10879	10916	0.2512076979449383
R1	cpdb	0	network_modules	251	TRUE	2.9036706893405444e-7	93	14	6	0.42857142857142855	0.06451612903225806	REAC:R-HSA-5625740	REAC	RHO GTPases activate PKNs	10916	1857		0.6666666666666666	0.7	93	10823	6	8	87	10815	10916	0.16378043781119067
R1	cpdb	0	network_modules	251	TRUE	5.644751782676607e-7	197	14	7	0.5	0.03553299492385787	KEGG:05130	KEGG	Pathogenic Escherichia coli infection	8484	427		0.25	0.4	197	8287	7	7	190	8280	8484	0.12870904150077903
R1	cpdb	0	network_modules	251	TRUE	1.5108077451254198e-6	227	14	7	0.5	0.030837004405286344	KEGG:04810	KEGG	Regulation of actin cytoskeleton	8484	365		0.5	0.6	227	8257	7	7	220	8250	8484	0.11922951885785878
R1	cpdb	0	network_modules	251	TRUE	2.071274035790081e-6	133	14	6	0.42857142857142855	0.045112781954887216	KEGG:04270	KEGG	Vascular smooth muscle contraction	8484	298		0.75	0.8	133	8351	6	8	127	8343	8484	0.13513485739281225
R1	cpdb	0	network_modules	251	TRUE	3.5715880040579764e-6	64	14	5	0.35714285714285715	0.078125	REAC:R-HSA-373755	REAC	Semaphorin interactions	10916	2193		0.7777777777777778	0.8	64	10852	5	9	59	10843	10916	0.16488565790953247
R1	cpdb	0	network_modules	251	TRUE	6.330862655230859e-6	110	21	6	0.2857142857142857	0.05454545454545454	GO:0030048	GO:BP	actin filament-based movement	16175	6667		0.3333333333333333	0.42857142857142855	110	16065	6	15	104	16050	16175	0.12236211814862992
R1	cpdb	0	network_modules	251	TRUE	1.5097466710393984e-5	318	14	7	0.5	0.0220125786163522	REAC:R-HSA-195258	REAC	RHO GTPase Effectors	10916	1846		0.8888888888888888	0.9	318	10598	7	7	311	10591	10916	0.10033409330398697
R1	cpdb	0	network_modules	251	TRUE	2.0221058269963326e-5	90	14	5	0.35714285714285715	0.05555555555555555	REAC:R-HSA-2682334	REAC	EPH-Ephrin signaling	10916	818		1	1	90	10826	5	9	85	10817	10916	0.13826675420666473
R1	cpdb	0	network_modules	251	TRUE	3.370254655669843e-5	407	21	8	0.38095238095238093	0.019656019656019656	GO:0007015	GO:BP	actin filament organization	16175	2624		0.5	0.5714285714285714	407	15768	8	13	399	15755	16175	0.08190722996858316
R1	cpdb	0	network_modules	251	TRUE	2.4141500214123725e-4	748	21	9	0.42857142857142855	0.012032085561497326	GO:0097435	GO:BP	supramolecular fiber organization	16175	18657		0.6666666666666666	0.7142857142857143	748	15427	9	12	739	15415	16175	0.0656383390479726
R1	cpdb	0	network_modules	251	TRUE	3.037982622386586e-4	170	14	5	0.35714285714285715	0.029411764705882353	KEGG:04530	KEGG	Tight junction	8484	317		1	1	170	8314	5	9	165	8305	8484	0.09780450851848028
R1	cpdb	0	network_modules	251	TRUE	0.0022350730008551182	18	21	3	0.14285714285714285	0.16666666666666666	GO:0030050	GO:BP	vesicle transport along actin filament	16175	6669		0.8333333333333334	0.8571428571428571	18	16157	3	18	15	16139	16175	0.1532861548213182
R1	cpdb	0	network_modules	251	TRUE	0.003117317923436404	20	21	3	0.14285714285714285	0.15	GO:0099515	GO:BP	actin filament-based transport	16175	19105		1	1	20	16155	3	18	17	16137	16175	0.14530215429655982
R1	cpdb	0	network_modules	253	TRUE	0.0025122880252617915	22	18	3	0.16666666666666666	0.13636363636363635	GO:1990090	GO:BP	cellular response to nerve growth factor stimulus	16175	25079		0	1	22	16153	3	15	19	16138	16175	0.14971050876290892
R1	cpdb	0	network_modules	253	TRUE	0.0025122880252617915	22	18	3	0.16666666666666666	0.13636363636363635	GO:1990089	GO:BP	response to nerve growth factor	16175	25078		0	1	22	16153	3	15	19	16138	16175	0.14971050876290892
R1	cpdb	0	network_modules	253	TRUE	0.005720235538810698	7	11	2	0.18181818181818182	0.2857142857142857	REAC:R-HSA-170984	REAC	ARMS-mediated activation	10916	33		NA	1	7	10909	2	9	5	10900	10916	0.22730470180250678
R1	cpdb	0	network_modules	254	TRUE	7.019390561162774e-6	120	18	6	0.3333333333333333	0.05	KEGG:04152	KEGG	AMPK signaling pathway	8484	286		0	0.5	120	8364	6	12	114	8352	8484	0.12463733243767626
R1	cpdb	0	network_modules	254	TRUE	7.374126225306171e-5	29	21	4	0.19047619047619047	0.13793103448275862	REAC:R-HSA-380972	REAC	Energy dependent regulation of mTOR by LKB1-AMPK	10916	843		0	0.5	29	10887	4	17	25	10870	10916	0.1601943588154428
R1	cpdb	0	network_modules	254	TRUE	3.0974574472329133e-4	41	21	4	0.19047619047619047	0.0975609756097561	REAC:R-HSA-165159	REAC	MTOR signalling	10916	1387		1	1	41	10875	4	17	37	10858	10916	0.13401221435125507
R1	cpdb	0	network_modules	254	TRUE	8.297518437866668e-4	155	18	5	0.2777777777777778	0.03225806451612903	KEGG:04150	KEGG	mTOR signaling pathway	8484	284		1	1	155	8329	5	13	150	8316	8484	0.08934832342064386
R1	cpdb	0	network_modules	254	TRUE	0.003276358997535711	2	25	2	0.08	1	GO:0005986	GO:BP	sucrose biosynthetic process	16175	1861		NA	1	2	16173	2	23	0	16150	16175	0.282641522315189
R1	cpdb	0	network_modules	255	TRUE	1.6145992506094254e-10	32	6	5	0.8333333333333334	0.15625	KEGG:04130	KEGG	SNARE interactions in vesicular transport	8484	272		NA	1	32	8452	5	1	27	8451	8484	0.36001736440799603
R1	cpdb	0	network_modules	255	TRUE	3.116359135931284e-7	17	11	4	0.36363636363636365	0.23529411764705882	GO:0048499	GO:BP	synaptic vesicle membrane organization	16175	12788		0	0.058823529411764705	17	16158	4	7	13	16151	16175	0.2919162100770297
R1	cpdb	0	network_modules	255	TRUE	3.955332584680499e-6	99	11	5	0.45454545454545453	0.050505050505050504	GO:0006906	GO:BP	vesicle fusion	16175	2557		0.0625	0.11764705882352941	99	16076	5	6	94	16070	16175	0.14998551999683632
R1	cpdb	0	network_modules	255	TRUE	4.377637499367728e-6	101	11	5	0.45454545454545453	0.04950495049504951	GO:0090174	GO:BP	organelle membrane fusion	16175	18081		0.125	0.17647058823529413	101	16074	5	6	96	16068	16175	0.14846137976648188
R1	cpdb	0	network_modules	255	TRUE	1.967723319432931e-5	136	11	5	0.45454545454545453	0.03676470588235294	GO:0048284	GO:BP	organelle fusion	16175	12626		0.1875	0.23529411764705882	136	16039	5	6	131	16033	16175	0.1274608358455214
R1	cpdb	0	network_modules	255	TRUE	2.5160217077946503e-5	315	11	6	0.5454545454545454	0.01904761904761905	GO:0016050	GO:BP	vesicle organization	16175	5082		0.25	0.29411764705882354	315	15860	6	5	309	15855	16175	0.09929528183668694
R1	cpdb	0	network_modules	255	TRUE	2.6925045489335406e-5	10	11	3	0.2727272727272727	0.3	REAC:R-HSA-168799	REAC	Neurotoxicity of clostridium toxins	10916	1592		0	0.14285714285714285	10	10906	3	8	7	10898	10916	0.28535245537118925
R1	cpdb	0	network_modules	255	TRUE	4.04846985824832e-5	157	11	5	0.45454545454545453	0.03184713375796178	GO:0061025	GO:BP	membrane fusion	16175	15142		0.3125	0.35294117647058826	157	16018	5	6	152	16012	16175	0.11836279467215677
R1	cpdb	0	network_modules	255	TRUE	5.476940491998577e-5	58	11	4	0.36363636363636365	0.06896551724137931	GO:0016079	GO:BP	synaptic vesicle exocytosis	16175	5106		0.375	0.4117647058823529	58	16117	4	7	54	16110	16175	0.15713525328209607
R1	cpdb	0	network_modules	255	TRUE	5.83005056387813e-5	12	11	3	0.2727272727272727	0.25	GO:0099500	GO:BP	vesicle fusion to plasma membrane	16175	19098		0.4375	0.5294117647058824	12	16163	3	8	9	16155	16175	0.2605914563273623
R1	cpdb	0	network_modules	255	TRUE	5.83005056387813e-5	12	11	3	0.2727272727272727	0.25	GO:0031629	GO:BP	synaptic vesicle fusion to presynaptic active zone membrane	16175	7242		0.4375	0.5294117647058824	12	16163	3	8	9	16155	16175	0.2605914563273623
R1	cpdb	0	network_modules	255	TRUE	5.118215521354521e-4	25	11	3	0.2727272727272727	0.12	REAC:R-HSA-5339562	REAC	Uptake and actions of bacterial toxins	10916	2626		0.16666666666666666	0.2857142857142857	25	10891	3	8	22	10883	10916	0.17968397710091152
R1	cpdb	0	network_modules	255	TRUE	5.192553207777368e-4	101	11	4	0.36363636363636365	0.039603960396039604	GO:0099643	GO:BP	signal release from synapse	16175	19183		0.5625	0.6470588235294118	101	16074	4	7	97	16067	16175	0.11835553229490517
R1	cpdb	0	network_modules	255	TRUE	5.192553207777368e-4	101	11	4	0.36363636363636365	0.039603960396039604	GO:0007269	GO:BP	neurotransmitter secretion	16175	2797		0.5625	0.6470588235294118	101	16074	4	7	97	16067	16175	0.11835553229490517
R1	cpdb	0	network_modules	255	TRUE	8.189759573515327e-4	3	11	2	0.18181818181818182	0.6666666666666666	REAC:R-HSA-5250989	REAC	Toxicity of botulinum toxin type G (botG)	10916	2529		0.3333333333333333	0.42857142857142855	3	10913	2	9	1	10904	10916	0.3478521475178262
R1	cpdb	0	network_modules	255	TRUE	9.376241116844702e-4	117	11	4	0.36363636363636365	0.03418803418803419	GO:0099504	GO:BP	synaptic vesicle cycle	16175	19100		0.6875	0.7058823529411765	117	16058	4	7	113	16051	16175	0.10971572532270496
R1	cpdb	0	network_modules	255	TRUE	0.0010729353743321563	121	11	4	0.36363636363636365	0.03305785123966942	GO:0099003	GO:BP	vesicle-mediated transport in synapse	16175	18999		0.75	0.7647058823529411	121	16054	4	7	117	16047	16175	0.1078255732705053
R1	cpdb	0	network_modules	255	TRUE	0.0019354913925633318	657	11	6	0.5454545454545454	0.0091324200913242	GO:0061024	GO:BP	membrane organization	16175	15141		0.8125	0.8235294117647058	657	15518	6	5	651	15513	16175	0.06671388530424949
R1	cpdb	0	network_modules	255	TRUE	0.002212613228838988	145	11	4	0.36363636363636365	0.027586206896551724	GO:0006836	GO:BP	neurotransmitter transport	16175	2506		0.875	0.8823529411764706	145	16030	4	7	141	16023	16175	0.09816173938722489
R1	cpdb	0	network_modules	255	TRUE	0.002726919122012445	5	11	2	0.18181818181818182	0.4	REAC:R-HSA-5250981	REAC	Toxicity of botulinum toxin type F (botF)	10916	2528		0.5	0.7142857142857143	5	10911	2	9	3	10902	10916	0.2691978540546046
R1	cpdb	0	network_modules	255	TRUE	0.002726919122012445	5	11	2	0.18181818181818182	0.4	REAC:R-HSA-5250955	REAC	Toxicity of botulinum toxin type D (botD)	10916	2526		0.5	0.7142857142857143	5	10911	2	9	3	10902	10916	0.2691978540546046
R1	cpdb	0	network_modules	255	TRUE	0.003358386498810814	161	11	4	0.36363636363636365	0.024844720496894408	GO:0045055	GO:BP	regulated exocytosis	16175	11253		0.9375	0.9411764705882353	161	16014	4	7	157	16007	16175	0.09294311351807574
R1	cpdb	0	network_modules	255	TRUE	0.007226808882267088	56	11	3	0.2727272727272727	0.05357142857142857	GO:0140029	GO:BP	exocytic process	16175	19642		1	1	56	16119	3	8	53	16111	16175	0.11958681005429418
R1	cpdb	0	network_modules	255	TRUE	0.00995564079168206	66	11	3	0.2727272727272727	0.045454545454545456	REAC:R-HSA-9824439	REAC	Bacterial Infection Pathways	10916	204		0.8333333333333334	1	66	10850	3	8	63	10842	10916	0.10925779683386518
R1	cpdb	0	network_modules	255	TRUE	0.00995564079168206	66	11	3	0.2727272727272727	0.045454545454545456	REAC:R-HSA-9662360	REAC	Sensory processing of sound by inner hair cells of the cochlea	10916	2202		0.8333333333333334	1	66	10850	3	8	63	10842	10916	0.10925779683386518
R1	cpdb	0	network_modules	256	TRUE	2.5467135266035087e-17	64	22	11	0.5	0.171875	REAC:R-HSA-211897	REAC	Cytochrome P450 - arranged by substrate type	10916	423		0	0.07142857142857142	64	10852	11	11	53	10841	10916	0.2908598109615232
R1	cpdb	0	network_modules	256	TRUE	3.0278370183792226e-15	116	23	11	0.4782608695652174	0.09482758620689655	GO:0006805	GO:BP	xenobiotic metabolic process	16175	2487		0	0.023255813953488372	116	16059	11	12	105	16047	16175	0.2106735719057315
R1	cpdb	0	network_modules	256	TRUE	6.154872111453192e-15	6	23	6	0.2608695652173913	1	GO:0016098	GO:BP	monoterpenoid metabolic process	16175	5116		0.023809523809523808	0.046511627906976744	6	16169	6	17	0	16152	16175	0.5104853458755896
R1	cpdb	0	network_modules	256	TRUE	6.587606898893691e-15	103	22	11	0.5	0.10679611650485436	REAC:R-HSA-211945	REAC	Phase I - Functionalization of compounds	10916	1737		0.07692307692307693	0.14285714285714285	103	10813	11	11	92	10802	10916	0.22802654987238596
R1	cpdb	0	network_modules	256	TRUE	3.532774689550995e-14	144	23	11	0.4782608695652174	0.0763888888888889	GO:0071466	GO:BP	cellular response to xenobiotic stimulus	16175	16699		0.047619047619047616	0.06976744186046512	144	16031	11	12	133	16019	16175	0.18855495510238496
R1	cpdb	0	network_modules	256	TRUE	4.5460601494585977e-13	215	22	12	0.5454545454545454	0.05581395348837209	REAC:R-HSA-211859	REAC	Biological oxidations	10916	227		0.15384615384615385	0.21428571428571427	215	10701	12	10	203	10691	10916	0.17003417808121554
R1	cpdb	0	network_modules	256	TRUE	8.435910894301275e-13	191	23	11	0.4782608695652174	0.05759162303664921	GO:0009410	GO:BP	response to xenobiotic stimulus	16175	3475		0.07142857142857142	0.09302325581395349	191	15984	11	12	180	15972	16175	0.16294576672364872
R1	cpdb	0	network_modules	256	TRUE	3.73776336377923e-12	23	22	7	0.3181818181818182	0.30434782608695654	REAC:R-HSA-211981	REAC	Xenobiotics	10916	2677		0.23076923076923078	0.2857142857142857	23	10893	7	15	16	10878	10916	0.30976575938401446
R1	cpdb	0	network_modules	256	TRUE	1.1715080554632295e-11	242	23	11	0.4782608695652174	0.045454545454545456	GO:0008202	GO:BP	steroid metabolic process	16175	3129		0.09523809523809523	0.11627906976744186	242	15933	11	12	231	15921	16175	0.14401258092586477
R1	cpdb	0	network_modules	256	TRUE	4.0760931153884394e-11	6	22	5	0.22727272727272727	0.8333333333333334	REAC:R-HSA-9027307	REAC	Biosynthesis of maresin-like SPMs	10916	245		0.3076923076923077	0.35714285714285715	6	10910	5	17	1	10893	10916	0.4346992645097503
R1	cpdb	0	network_modules	256	TRUE	7.265465938434814e-11	67	20	8	0.4	0.11940298507462686	KEGG:05204	KEGG	Chemical carcinogenesis - DNA adducts	8484	456		0	0.125	67	8417	8	12	59	8405	8484	0.21533354428490106
R1	cpdb	0	network_modules	256	TRUE	1.1302927770882121e-10	18	23	6	0.2608695652173913	0.3333333333333333	GO:0019373	GO:BP	epoxygenase P450 pathway	16175	5734		0.11904761904761904	0.13953488372093023	18	16157	6	17	12	16140	16175	0.2939985978231436
R1	cpdb	0	network_modules	256	TRUE	1.7491178187216617e-10	80	23	8	0.34782608695652173	0.1	GO:0006721	GO:BP	terpenoid metabolic process	16175	2427		0.14285714285714285	0.16279069767441862	80	16095	8	15	72	16080	16175	0.18443653543841623
R1	cpdb	0	network_modules	256	TRUE	3.794480352306226e-10	8	22	5	0.22727272727272727	0.625	REAC:R-HSA-9018682	REAC	Biosynthesis of maresins	10916	246		0.38461538461538464	0.42857142857142855	8	10908	5	17	3	10891	10916	0.37619086717652606
R1	cpdb	0	network_modules	256	TRUE	8.598500482639177e-10	97	23	8	0.34782608695652173	0.08247422680412371	GO:0006720	GO:BP	isoprenoid metabolic process	16175	2426		0.16666666666666666	0.18604651162790697	97	16078	8	15	89	16063	16175	0.16707147465820862
R1	cpdb	0	network_modules	256	TRUE	1.0169053468795955e-9	99	23	8	0.34782608695652173	0.08080808080808081	GO:0001676	GO:BP	long-chain fatty acid metabolic process	16175	380		0.19047619047619047	0.20930232558139536	99	16076	8	15	91	16061	16175	0.16532573657230398
R1	cpdb	0	network_modules	256	TRUE	1.2596503931339968e-9	55	23	7	0.30434782608695654	0.12727272727272726	GO:0019369	GO:BP	arachidonate metabolic process	16175	5730		0.21428571428571427	0.23255813953488372	55	16120	7	16	48	16104	16175	0.19508413635673733
R1	cpdb	0	network_modules	256	TRUE	6.652922155363843e-9	33	23	6	0.2608695652173913	0.18181818181818182	GO:0008210	GO:BP	estrogen metabolic process	16175	3137		0.23809523809523808	0.2558139534883721	33	16142	6	17	27	16125	16175	0.2164576726245596
R1	cpdb	0	network_modules	256	TRUE	6.988263977795966e-9	68	20	7	0.35	0.10294117647058823	KEGG:00982	KEGG	Drug metabolism - cytochrome P450	8484	156		0.14285714285714285	0.25	68	8416	7	13	61	8403	8484	0.18643500445067157
R1	cpdb	0	network_modules	256	TRUE	8.290474428986676e-9	128	23	8	0.34782608695652173	0.0625	GO:0120254	GO:BP	olefinic compound metabolic process	16175	19583		0.2619047619047619	0.27906976744186046	128	16047	8	15	120	16032	16175	0.14476396116889437
R1	cpdb	0	network_modules	256	TRUE	1.286767269365988e-8	74	20	7	0.35	0.0945945945945946	KEGG:00980	KEGG	Metabolism of xenobiotics by cytochrome P450	8484	154		0.2857142857142857	0.375	74	8410	7	13	67	8397	8484	0.17841110488902978
R1	cpdb	0	network_modules	256	TRUE	2.9290832681158045e-8	16	22	5	0.22727272727272727	0.3125	REAC:R-HSA-9018677	REAC	Biosynthesis of DHA-derived SPMs	10916	230		0.46153846153846156	0.5	16	10900	5	17	11	10883	10916	0.265243848872855
R1	cpdb	0	network_modules	256	TRUE	5.730592336497055e-8	18	22	5	0.22727272727272727	0.2777777777777778	REAC:R-HSA-9018678	REAC	Biosynthesis of specialized proresolving mediators (SPMs)	10916	249		0.5384615384615384	0.5714285714285714	18	10898	5	17	13	10881	10916	0.2498943185544474
R1	cpdb	0	network_modules	256	TRUE	6.167188324102707e-8	43	22	6	0.2727272727272727	0.13953488372093023	REAC:R-HSA-9749641	REAC	Aspirin ADME	10916	171		0.6153846153846154	0.6428571428571429	43	10873	6	16	37	10857	10916	0.19283341785117603
R1	cpdb	0	network_modules	256	TRUE	8.27267206353091e-8	98	23	7	0.30434782608695654	0.07142857142857142	GO:0033559	GO:BP	unsaturated fatty acid metabolic process	16175	8288		0.2857142857142857	0.3023255813953488	98	16077	7	16	91	16061	16175	0.14504971670828365
R1	cpdb	0	network_modules	256	TRUE	8.453826392968477e-8	20	23	5	0.21739130434782608	0.25	GO:0042178	GO:BP	xenobiotic catabolic process	16175	10006		0.30952380952380953	0.32558139534883723	20	16155	5	18	15	16137	16175	0.23210875190499303
R1	cpdb	0	network_modules	256	TRUE	1.5022993397815278e-7	767	23	12	0.5217391304347826	0.01564537157757497	GO:0006082	GO:BP	organic acid metabolic process	16175	1947		0.3333333333333333	0.3488372093023256	767	15408	12	11	755	15397	16175	0.08421625518522279
R1	cpdb	0	network_modules	256	TRUE	1.6529165566580325e-7	108	23	7	0.30434782608695654	0.06481481481481481	GO:0006690	GO:BP	icosanoid metabolic process	16175	2398		0.35714285714285715	0.37209302325581395	108	16067	7	16	101	16051	16175	0.1379278909073841
R1	cpdb	0	network_modules	256	TRUE	2.6906108783349543e-7	62	20	6	0.3	0.0967741935483871	KEGG:00140	KEGG	Steroid hormone biosynthesis	8484	17		0.42857142857142855	0.5	62	8422	6	14	56	8408	8484	0.16704574078257775
R1	cpdb	0	network_modules	256	TRUE	2.871394968383294e-7	8	22	4	0.18181818181818182	0.5	REAC:R-HSA-2142670	REAC	Synthesis of epoxy (EET) and dihydroxyeicosatrienoic acids (DHET)	10916	2408		0.6923076923076923	0.7142857142857143	8	10908	4	18	4	10890	10916	0.3007092940183215
R1	cpdb	0	network_modules	256	TRUE	2.8835878558267996e-7	25	23	5	0.21739130434782608	0.2	GO:0042759	GO:BP	long-chain fatty acid biosynthetic process	16175	10351		0.38095238095238093	0.3953488372093023	25	16150	5	18	20	16132	16175	0.20733957626000896
R1	cpdb	0	network_modules	256	TRUE	3.67901022931884e-7	30	20	5	0.25	0.16666666666666666	KEGG:00591	KEGG	Linoleic acid metabolism	8484	93		0.5714285714285714	0.625	30	8454	5	15	25	8439	8484	0.20183173530794352
R1	cpdb	0	network_modules	256	TRUE	5.16168974760276e-7	9	22	4	0.18181818181818182	0.4444444444444444	REAC:R-HSA-2142816	REAC	Synthesis of (16-20)-hydroxyeicosatetraenoic acids (HETE)	10916	2370		0.7692307692307693	0.7857142857142857	9	10907	4	18	5	10889	10916	0.2833810065188784
R1	cpdb	0	network_modules	256	TRUE	9.507462573348775e-7	504	23	10	0.43478260869565216	0.01984126984126984	GO:0032787	GO:BP	monocarboxylic acid metabolic process	16175	7822		0.40476190476190477	0.4186046511627907	504	15671	10	13	494	15658	16175	0.08766127452243569
R1	cpdb	0	network_modules	256	TRUE	9.82672019594402e-7	10	23	4	0.17391304347826086	0.4	GO:0070989	GO:BP	oxidative demethylation	16175	16419		0.42857142857142855	0.4418604651162791	10	16165	4	19	6	16146	16175	0.26308297527166463
R1	cpdb	0	network_modules	256	TRUE	1.348305074149562e-6	11	22	4	0.18181818181818182	0.36363636363636365	REAC:R-HSA-211999	REAC	CYP2E1 reactions	10916	293		0.8461538461538461	0.8571428571428571	11	10905	4	18	7	10887	10916	0.2560917686948567
R1	cpdb	0	network_modules	256	TRUE	1.5427473046121714e-6	11	23	4	0.17391304347826086	0.36363636363636365	GO:0097267	GO:BP	omega-hydroxylase P450 pathway	16175	18564		0.4523809523809524	0.46511627906976744	11	16164	4	19	7	16145	16175	0.25075804274801294
R1	cpdb	0	network_modules	256	TRUE	2.1747354178051016e-6	742	23	11	0.4782608695652174	0.014824797843665768	GO:0019752	GO:BP	carboxylic acid metabolic process	16175	6036		0.47619047619047616	0.4883720930232558	742	15433	11	12	731	15421	16175	0.0779904027022174
R1	cpdb	0	network_modules	256	TRUE	2.8389893994498474e-6	761	23	11	0.4782608695652174	0.01445466491458607	GO:0043436	GO:BP	oxoacid metabolic process	16175	10693		0.5	0.5116279069767442	761	15414	11	12	750	15402	16175	0.07684875742650055
R1	cpdb	0	network_modules	256	TRUE	3.805165595151127e-6	3	23	3	0.13043478260869565	1	GO:0090345	GO:BP	organohalogen metabolic process	16175	18222		0.5238095238095238	0.5348837209302325	3	16172	3	20	0	16152	16175	0.3609341674135441
R1	cpdb	0	network_modules	256	TRUE	5.78107126813387e-6	179	23	7	0.30434782608695654	0.03910614525139665	GO:0042445	GO:BP	hormone metabolic process	16175	10185		0.5476190476190477	0.5581395348837209	179	15996	7	16	172	15980	16175	0.10579065616180111
R1	cpdb	0	network_modules	256	TRUE	6.357402401971473e-6	15	23	4	0.17391304347826086	0.26666666666666666	GO:0070988	GO:BP	demethylation	16175	16418		0.5714285714285714	0.5813953488372093	15	16160	4	19	11	16141	16175	0.21445635286507317
R1	cpdb	0	network_modules	256	TRUE	1.2039448959265165e-5	319	23	8	0.34782608695652173	0.025078369905956112	GO:0006631	GO:BP	fatty acid metabolic process	16175	2343		0.5952380952380952	0.6046511627906976	319	15856	8	15	311	15841	16175	0.08904608059334387
R1	cpdb	0	network_modules	256	TRUE	1.6863083299643483e-5	107	22	6	0.2727272727272727	0.056074766355140186	REAC:R-HSA-9748784	REAC	Drug ADME	10916	796		0.9230769230769231	0.9285714285714286	107	10809	6	16	101	10793	10916	0.11993022839493787
R1	cpdb	0	network_modules	256	TRUE	2.5440641085562742e-5	68	20	5	0.25	0.07352941176470588	KEGG:00830	KEGG	Retinol metabolism	8484	127		0.7142857142857143	0.75	68	8416	5	15	63	8401	8484	0.1319194403175118
R1	cpdb	0	network_modules	256	TRUE	5.836502990867852e-5	25	23	4	0.17391304347826086	0.16	GO:0042572	GO:BP	retinol metabolic process	16175	10248		0.6190476190476191	0.627906976744186	25	16150	4	19	21	16131	16175	0.16557472388135833
R1	cpdb	0	network_modules	256	TRUE	6.299836173416257e-5	70	23	5	0.21739130434782608	0.07142857142857142	GO:0001523	GO:BP	retinoid metabolic process	16175	329		0.6428571428571429	0.6511627906976745	70	16105	5	18	65	16087	16175	0.12248277249377823
R1	cpdb	0	network_modules	256	TRUE	6.604002651719223e-5	397	23	8	0.34782608695652173	0.020151133501259445	GO:1901615	GO:BP	organic hydroxy compound metabolic process	16175	21597		0.6666666666666666	0.6744186046511628	397	15778	8	15	389	15763	16175	0.07884159465054394
R1	cpdb	0	network_modules	256	TRUE	7.043001339623096e-5	257	23	7	0.30434782608695654	0.027237354085603113	GO:0006066	GO:BP	alcohol metabolic process	16175	1933		0.6904761904761905	0.6976744186046512	257	15918	7	16	250	15902	16175	0.08704994481789406
R1	cpdb	0	network_modules	256	TRUE	7.269321227840943e-5	72	23	5	0.21739130434782608	0.06944444444444445	GO:0016101	GO:BP	diterpenoid metabolic process	16175	5119		0.7142857142857143	0.7209302325581395	72	16103	5	18	67	16085	16175	0.12070705112843226
R1	cpdb	0	network_modules	256	TRUE	7.58917467893925e-5	6	23	3	0.13043478260869565	0.5	GO:0009820	GO:BP	alkaloid metabolic process	16175	3699		0.7380952380952381	0.7441860465116279	6	16169	3	20	3	16149	16175	0.2548792144510706
R1	cpdb	0	network_modules	256	TRUE	2.0671748747027026e-4	177	23	6	0.2608695652173913	0.03389830508474576	GO:0072330	GO:BP	monocarboxylic acid biosynthetic process	16175	17353		0.7619047619047619	0.7674418604651163	177	15998	6	17	171	15981	16175	0.09065428159259664
R1	cpdb	0	network_modules	256	TRUE	2.939452431637204e-4	482	23	8	0.34782608695652173	0.016597510373443983	GO:0044283	GO:BP	small molecule biosynthetic process	16175	10950		0.7857142857142857	0.7906976744186046	482	15693	8	15	474	15678	16175	0.070580147222212
R1	cpdb	0	network_modules	256	TRUE	7.10454925928789e-4	361	23	7	0.30434782608695654	0.019390581717451522	GO:0010817	GO:BP	regulation of hormone levels	16175	4429		0.8095238095238095	0.813953488372093	361	15814	7	16	354	15798	16175	0.07204685393594856
R1	cpdb	0	network_modules	256	TRUE	0.001254975831370671	127	23	5	0.21739130434782608	0.03937007874015748	GO:0006633	GO:BP	fatty acid biosynthetic process	16175	2344		0.8333333333333334	0.8372093023255814	127	16048	5	18	122	16030	16175	0.0895878296365466
R1	cpdb	0	network_modules	256	TRUE	0.0017452620275907388	59	22	4	0.18181818181818182	0.06779661016949153	REAC:R-HSA-2142753	REAC	Arachidonate metabolism	10916	165		1	1	59	10857	4	18	55	10839	10916	0.10812634213743627
R1	cpdb	0	network_modules	256	TRUE	0.0021097794597416306	625	23	8	0.34782608695652173	0.0128	GO:0008610	GO:BP	lipid biosynthetic process	16175	3206		0.8571428571428571	0.8604651162790697	625	15550	8	15	617	15535	16175	0.06053547654630788
R1	cpdb	0	network_modules	256	TRUE	0.002211739048194457	265	23	6	0.2608695652173913	0.022641509433962263	GO:0046394	GO:BP	carboxylic acid biosynthetic process	16175	12120		0.8809523809523809	0.8837209302325582	265	15910	6	17	259	15893	16175	0.07267607767748177
R1	cpdb	0	network_modules	256	TRUE	0.002361353843343183	268	23	6	0.2608695652173913	0.022388059701492536	GO:0016053	GO:BP	organic acid biosynthetic process	16175	5085		0.9047619047619048	0.9069767441860465	268	15907	6	17	262	15890	16175	0.0722201492333772
R1	cpdb	0	network_modules	256	TRUE	0.00293052110335139	2	23	2	0.08695652173913043	1	GO:0090346	GO:BP	organofluorine metabolic process	16175	18223		0.9285714285714286	0.9302325581395349	2	16173	2	21	0	16152	16175	0.29469240258173435
R1	cpdb	0	network_modules	256	TRUE	0.0036084566302266984	68	23	4	0.17391304347826086	0.058823529411764705	GO:0034308	GO:BP	primary alcohol metabolic process	16175	8562		0.9523809523809523	0.9534883720930233	68	16107	4	19	64	16088	16175	0.0989778935485079
R1	cpdb	0	network_modules	256	TRUE	0.004270000937332811	20	23	3	0.13043478260869565	0.15	GO:0006706	GO:BP	steroid catabolic process	16175	2413		0.9761904761904762	0.9767441860465116	20	16155	3	20	17	16135	16175	0.13873415606930908
R1	cpdb	0	network_modules	256	TRUE	0.007488090077388348	112	20	4	0.2	0.03571428571428571	KEGG:04726	KEGG	Serotonergic synapse	8484	356		0.8571428571428571	0.875	112	8372	4	16	108	8356	8484	0.0795569292563368
R1	cpdb	0	network_modules	256	TRUE	0.008230370606033845	43	20	3	0.15	0.06976744186046512	KEGG:00860	KEGG	Porphyrin metabolism	8484	128		1	1	43	8441	3	17	40	8424	8484	0.09921100454939548
R1	cpdb	0	network_modules	256	TRUE	0.008783952978863854	3	23	2	0.08695652173913043	0.6666666666666666	GO:0009822	GO:BP	alkaloid catabolic process	16175	3701		1	1	3	16172	2	21	1	16151	16175	0.24045145819458102
R1	cpdb	0	network_modules	257	TRUE	3.7546310757076914e-8	91	11	6	0.5454545454545454	0.06593406593406594	REAC:R-HSA-163125	REAC	Post-translational modification: synthesis of GPI-anchored proteins	10916	1775		0	0.2	91	10825	6	5	85	10820	10916	0.18762133459697972
R1	cpdb	0	network_modules	257	TRUE	7.866107937110044e-6	7	11	3	0.2727272727272727	0.42857142857142855	REAC:R-HSA-9664535	REAC	LTC4-CYSLTR mediated IL4 production	10916	1300		0.25	0.4	7	10909	3	8	4	10901	10916	0.3413593156786807
R1	cpdb	0	network_modules	257	TRUE	1.822862402658396e-4	18	11	3	0.2727272727272727	0.16666666666666666	REAC:R-HSA-5423646	REAC	Aflatoxin activation and detoxification	10916	128		0.5	0.6	18	10898	3	8	15	10890	10916	0.21219354140982122
R1	cpdb	0	network_modules	257	TRUE	2.966186295934519e-4	21	11	3	0.2727272727272727	0.14285714285714285	REAC:R-HSA-2142691	REAC	Synthesis of Leukotrienes (LT) and Eoxins (EX)	10916	2385		0.75	0.8	21	10895	3	8	18	10887	10916	0.19628089464160198
R1	cpdb	0	network_modules	257	TRUE	0.007100064629985672	59	11	3	0.2727272727272727	0.05084745762711865	REAC:R-HSA-2142753	REAC	Arachidonate metabolism	10916	165		1	1	59	10857	3	8	56	10849	10916	0.11579809117342912
R1	cpdb	0	network_modules	258	TRUE	0.004815206589211492	63	12	3	0.25	0.047619047619047616	KEGG:00561	KEGG	Glycerolipid metabolism	8484	85		NA	1	63	8421	3	9	60	8412	8484	0.10633859343337987
R1	cpdb	0	network_modules	259	TRUE	1.30848050339829e-6	16	15	4	0.26666666666666666	0.25	REAC:R-HSA-210993	REAC	Tie2 Signaling	10916	2509		0	0.3333333333333333	16	10900	4	11	12	10889	10916	0.25714482363597585
R1	cpdb	0	network_modules	259	TRUE	2.7735861754937867e-6	3	21	3	0.14285714285714285	1	GO:0048014	GO:BP	Tie signaling pathway	16175	12470		0	0.25	3	16172	3	18	0	16154	16175	0.3777540706266271
R1	cpdb	0	network_modules	259	TRUE	0.0012747176296718497	191	15	5	0.3333333333333333	0.02617801047120419	REAC:R-HSA-202733	REAC	Cell surface interactions at the vascular wall	10916	327		0.5	0.6666666666666666	191	10725	5	10	186	10715	10916	0.08935572762149349
R1	cpdb	0	network_modules	259	TRUE	0.0015364375000904867	16	21	3	0.14285714285714285	0.1875	GO:0072012	GO:BP	glomerulus vasculature development	16175	17048		0.3333333333333333	0.5	16	16159	3	18	13	16141	16175	0.16271627577867978
R1	cpdb	0	network_modules	259	TRUE	0.0018641168156595608	17	21	3	0.14285714285714285	0.17647058823529413	GO:0061437	GO:BP	renal system vasculature development	16175	15472		0.6666666666666666	1	17	16158	3	18	14	16140	16175	0.15779406522265696
R1	cpdb	0	network_modules	259	TRUE	0.0018641168156595608	17	21	3	0.14285714285714285	0.17647058823529413	GO:0061440	GO:BP	kidney vasculature development	16175	15475		0.6666666666666666	1	17	16158	3	18	14	16140	16175	0.15779406522265696
R1	cpdb	0	network_modules	259	TRUE	0.007338836739666397	42	15	3	0.2	0.07142857142857142	REAC:R-HSA-9696273	REAC	RND1 GTPase cycle	10916	1905		1	1	42	10874	3	12	39	10862	10916	0.11753044618573422
R1	cpdb	0	network_modules	259	TRUE	0.007728117517446573	301	15	5	0.3333333333333333	0.016611295681063124	KEGG:04010	KEGG	MAPK signaling pathway	8484	243		NA	1	301	8183	5	10	296	8173	8484	0.06776341454486688
R1	cpdb	0	network_modules	260	TRUE	1.5798383192521627e-19	67	20	12	0.6	0.1791044776119403	KEGG:00010	KEGG	Glycolysis / Gluconeogenesis	8484	2		0	0.25	67	8417	12	8	55	8409	8484	0.3251687988819732
R1	cpdb	0	network_modules	260	TRUE	6.174685666987479e-16	138	25	12	0.48	0.08695652173913043	GO:0019362	GO:BP	pyridine nucleotide metabolic process	16175	5724		0	0.030303030303030304	138	16037	12	13	126	16024	16175	0.20168770962666582
R1	cpdb	0	network_modules	260	TRUE	6.174685666987479e-16	138	25	12	0.48	0.08695652173913043	GO:0046496	GO:BP	nicotinamide nucleotide metabolic process	16175	12199		0	0.030303030303030304	138	16037	12	13	126	16024	16175	0.20168770962666582
R1	cpdb	0	network_modules	260	TRUE	9.597526994727804e-16	143	25	12	0.48	0.08391608391608392	GO:0072524	GO:BP	pyridine-containing compound metabolic process	16175	17426		0.03076923076923077	0.045454545454545456	143	16032	12	13	131	16019	16175	0.19803129696527777
R1	cpdb	0	network_modules	260	TRUE	1.0601257503368143e-15	96	25	11	0.44	0.11458333333333333	GO:0006090	GO:BP	pyruvate metabolic process	16175	1953		0.046153846153846156	0.06060606060606061	96	16079	11	14	85	16065	16175	0.22233998903785832
R1	cpdb	0	network_modules	260	TRUE	1.6681400811569546e-15	33	23	9	0.391304347826087	0.2727272727272727	REAC:R-HSA-70263	REAC	Gluconeogenesis	10916	1052		0	0.25	33	10883	9	14	24	10869	10916	0.3249891348017375
R1	cpdb	0	network_modules	260	TRUE	1.1268701460878011e-12	72	25	9	0.36	0.125	GO:0046032	GO:BP	ADP catabolic process	16175	11809		0.06153846153846154	0.09090909090909091	72	16103	9	16	63	16087	16175	0.21013938839408025
R1	cpdb	0	network_modules	260	TRUE	1.1268701460878011e-12	72	25	9	0.36	0.125	GO:0006096	GO:BP	glycolytic process	16175	1956		0.06153846153846154	0.09090909090909091	72	16103	9	16	63	16087	16175	0.21013938839408025
R1	cpdb	0	network_modules	260	TRUE	1.4606923302523247e-12	74	25	9	0.36	0.12162162162162163	GO:0009181	GO:BP	purine ribonucleoside diphosphate catabolic process	16175	3347		0.09230769230769231	0.13636363636363635	74	16101	9	16	65	16085	16175	0.20722099981113767
R1	cpdb	0	network_modules	260	TRUE	1.4606923302523247e-12	74	25	9	0.36	0.12162162162162163	GO:0009137	GO:BP	purine nucleoside diphosphate catabolic process	16175	3304		0.09230769230769231	0.13636363636363635	74	16101	9	16	65	16085	16175	0.20722099981113767
R1	cpdb	0	network_modules	260	TRUE	1.4606923302523247e-12	74	25	9	0.36	0.12162162162162163	GO:0046031	GO:BP	ADP metabolic process	16175	11808		0.09230769230769231	0.13636363636363635	74	16101	9	16	65	16085	16175	0.20722099981113767
R1	cpdb	0	network_modules	260	TRUE	1.8794830752106856e-12	76	25	9	0.36	0.11842105263157894	GO:0019364	GO:BP	pyridine nucleotide catabolic process	16175	5726		0.13846153846153847	0.16666666666666666	76	16099	9	16	67	16083	16175	0.204417791444623
R1	cpdb	0	network_modules	260	TRUE	1.8794830752106856e-12	76	25	9	0.36	0.11842105263157894	GO:0009179	GO:BP	purine ribonucleoside diphosphate metabolic process	16175	3345		0.13846153846153847	0.16666666666666666	76	16099	9	16	67	16083	16175	0.204417791444623
R1	cpdb	0	network_modules	260	TRUE	2.1263364335538735e-12	77	25	9	0.36	0.11688311688311688	GO:0009191	GO:BP	ribonucleoside diphosphate catabolic process	16175	3357		0.16923076923076924	0.19696969696969696	77	16098	9	16	68	16082	16175	0.20305703412797252
R1	cpdb	0	network_modules	260	TRUE	2.1263364335538735e-12	77	25	9	0.36	0.11688311688311688	GO:0009135	GO:BP	purine nucleoside diphosphate metabolic process	16175	3302		0.16923076923076924	0.19696969696969696	77	16098	9	16	68	16082	16175	0.20305703412797252
R1	cpdb	0	network_modules	260	TRUE	2.707883566873526e-12	79	25	9	0.36	0.11392405063291139	GO:0072526	GO:BP	pyridine-containing compound catabolic process	16175	17428		0.2	0.21212121212121213	79	16096	9	16	70	16080	16175	0.20041288732171966
R1	cpdb	0	network_modules	260	TRUE	3.8453879963622754e-12	82	25	9	0.36	0.10975609756097561	GO:0009134	GO:BP	nucleoside diphosphate catabolic process	16175	3301		0.2153846153846154	0.22727272727272727	82	16093	9	16	73	16077	16175	0.19662822375989067
R1	cpdb	0	network_modules	260	TRUE	5.388213013798191e-12	85	25	9	0.36	0.10588235294117647	GO:0009185	GO:BP	ribonucleoside diphosphate metabolic process	16175	3351		0.23076923076923078	0.24242424242424243	85	16090	9	16	76	16074	16175	0.1930442187571219
R1	cpdb	0	network_modules	260	TRUE	9.20127390070996e-12	90	25	9	0.36	0.1	GO:0009154	GO:BP	purine ribonucleotide catabolic process	16175	3321		0.24615384615384617	0.25757575757575757	90	16085	9	16	81	16069	16175	0.18747091342888292
R1	cpdb	0	network_modules	260	TRUE	1.0418843648614462e-11	27	25	7	0.28	0.25925925925925924	GO:0006734	GO:BP	NADH metabolic process	16175	2435		0.26153846153846155	0.2727272727272727	27	16148	7	18	20	16130	16175	0.26825509493622623
R1	cpdb	0	network_modules	260	TRUE	1.1298172450820034e-11	92	25	9	0.36	0.09782608695652174	GO:0009261	GO:BP	ribonucleotide catabolic process	16175	3426		0.27692307692307694	0.2878787878787879	92	16083	9	16	83	16067	16175	0.1853688283038888
R1	cpdb	0	network_modules	260	TRUE	1.2497504940254355e-11	93	25	9	0.36	0.0967741935483871	GO:0009132	GO:BP	nucleoside diphosphate metabolic process	16175	3299		0.2923076923076923	0.30303030303030304	93	16082	9	16	84	16066	16175	0.18434308866164129
R1	cpdb	0	network_modules	260	TRUE	1.5518952290963877e-11	55	25	8	0.32	0.14545454545454545	GO:0019674	GO:BP	NAD metabolic process	16175	5993		0.3076923076923077	0.3181818181818182	55	16120	8	17	47	16103	16175	0.21398072436554763
R1	cpdb	0	network_modules	260	TRUE	1.870408117015194e-11	86	23	9	0.391304347826087	0.10465116279069768	REAC:R-HSA-70326	REAC	Glucose metabolism	10916	1053		0.3333333333333333	0.5	86	10830	9	14	77	10816	10916	0.19928371142510237
R1	cpdb	0	network_modules	260	TRUE	2.237152252864723e-11	99	25	9	0.36	0.09090909090909091	GO:0006195	GO:BP	purine nucleotide catabolic process	16175	2024		0.3230769230769231	0.3333333333333333	99	16076	9	16	90	16060	16175	0.17851584502289328
R1	cpdb	0	network_modules	260	TRUE	3.111106139853051e-11	288	23	12	0.5217391304347826	0.041666666666666664	REAC:R-HSA-71387	REAC	Metabolism of carbohydrates	10916	1422		0.6666666666666666	0.75	288	10628	12	11	276	10617	10916	0.14201982193324394
R1	cpdb	0	network_modules	260	TRUE	3.245941703036915e-11	60	25	8	0.32	0.13333333333333333	GO:0006094	GO:BP	gluconeogenesis	16175	1955		0.3384615384615385	0.3484848484848485	60	16115	8	17	52	16098	16175	0.20470266498341533
R1	cpdb	0	network_modules	260	TRUE	4.7002783170146086e-11	469	25	13	0.52	0.02771855010660981	GO:0072521	GO:BP	purine-containing compound metabolic process	16175	17423		0.35384615384615387	0.36363636363636365	469	15706	13	12	456	15694	16175	0.11513156438623577
R1	cpdb	0	network_modules	260	TRUE	4.872469821513203e-11	349	25	12	0.48	0.034383954154727794	GO:0006163	GO:BP	purine nucleotide metabolic process	16175	1998		0.36923076923076925	0.3787878787878788	349	15826	12	13	337	15813	16175	0.12413567274018594
R1	cpdb	0	network_modules	260	TRUE	4.8994718705501375e-11	63	25	8	0.32	0.12698412698412698	GO:0019319	GO:BP	hexose biosynthetic process	16175	5682		0.38461538461538464	0.3939393939393939	63	16112	8	17	55	16095	16175	0.19967078823823403
R1	cpdb	0	network_modules	260	TRUE	6.373316591104776e-11	65	25	8	0.32	0.12307692307692308	GO:0046364	GO:BP	monosaccharide biosynthetic process	16175	12095		0.4	0.4090909090909091	65	16110	8	17	57	16093	16175	0.19651023428449277
R1	cpdb	0	network_modules	260	TRUE	9.703776754890055e-11	116	25	9	0.36	0.07758620689655173	GO:0072523	GO:BP	purine-containing compound catabolic process	16175	17425		0.4153846153846154	0.42424242424242425	116	16059	9	16	107	16043	16175	0.16451419241182969
R1	cpdb	0	network_modules	260	TRUE	1.0503013341801928e-10	117	25	9	0.36	0.07692307692307693	GO:0009166	GO:BP	nucleotide catabolic process	16175	3332		0.4307692307692308	0.4393939393939394	117	16058	9	16	108	16042	16175	0.1637860279111621
R1	cpdb	0	network_modules	260	TRUE	1.0548907290119448e-10	115	20	9	0.45	0.0782608695652174	KEGG:01200	KEGG	Carbon metabolism	8484	184		0.3333333333333333	0.5	115	8369	9	11	106	8358	8484	0.18347281377519006
R1	cpdb	0	network_modules	260	TRUE	1.6645493086741692e-10	123	25	9	0.36	0.07317073170731707	GO:0016052	GO:BP	carbohydrate catabolic process	16175	5084		0.4461538461538462	0.45454545454545453	123	16052	9	16	114	16036	16175	0.15960315253303295
R1	cpdb	0	network_modules	260	TRUE	1.7196313860067898e-10	388	25	12	0.48	0.030927835051546393	GO:0009117	GO:BP	nucleotide metabolic process	16175	3286		0.46153846153846156	0.4696969696969697	388	15787	12	13	376	15774	16175	0.11725705484262468
R1	cpdb	0	network_modules	260	TRUE	2.2210358290569249e-10	68	23	8	0.34782608695652173	0.11764705882352941	REAC:R-HSA-70171	REAC	Glycolysis	10916	1074		1	1	68	10848	8	15	60	10833	10916	0.19949777837563365
R1	cpdb	0	network_modules	260	TRUE	4.3394506327608103e-10	558	25	13	0.52	0.023297491039426525	GO:0055086	GO:BP	nucleobase-containing small molecule metabolic process	16175	14237		0.47692307692307695	0.48484848484848486	558	15617	13	12	545	15605	16175	0.10466547141061489
R1	cpdb	0	network_modules	260	TRUE	5.109227079558119e-10	139	25	9	0.36	0.06474820143884892	GO:1901292	GO:BP	nucleoside phosphate catabolic process	16175	21367		0.49230769230769234	0.5	139	16036	9	16	130	16020	16175	0.14978985016224028
R1	cpdb	0	network_modules	260	TRUE	3.781231245604409e-9	504	25	12	0.48	0.023809523809523808	GO:0032787	GO:BP	monocarboxylic acid metabolic process	16175	7822		0.5076923076923077	0.5151515151515151	504	15671	12	13	492	15658	16175	0.1016381468818987
R1	cpdb	0	network_modules	260	TRUE	5.581760516694359e-9	521	25	12	0.48	0.023032629558541268	GO:0006753	GO:BP	nucleoside phosphate metabolic process	16175	2450		0.5230769230769231	0.5303030303030303	521	15654	12	13	509	15641	16175	0.09978624949634825
R1	cpdb	0	network_modules	260	TRUE	6.539960556672765e-9	184	25	9	0.36	0.04891304347826087	GO:0046034	GO:BP	ATP metabolic process	16175	11811		0.5384615384615384	0.5454545454545454	184	15991	9	16	175	15975	16175	0.12934186310378215
R1	cpdb	0	network_modules	260	TRUE	6.868216108350142e-9	185	25	9	0.36	0.04864864864864865	GO:0046434	GO:BP	organophosphate catabolic process	16175	12142		0.5538461538461539	0.5606060606060606	185	15990	9	16	176	15974	16175	0.12897297461584997
R1	cpdb	0	network_modules	260	TRUE	9.413252369086403e-9	119	25	8	0.32	0.06722689075630252	GO:0006006	GO:BP	glucose metabolic process	16175	1881		0.5692307692307692	0.5757575757575758	119	16056	8	17	111	16039	16175	0.14394100618691147
R1	cpdb	0	network_modules	260	TRUE	1.1566401959811873e-8	196	25	9	0.36	0.04591836734693878	GO:1901136	GO:BP	carbohydrate derivative catabolic process	16175	21244		0.5846153846153846	0.5909090909090909	196	15979	9	16	187	15963	16175	0.1251001476013608
R1	cpdb	0	network_modules	260	TRUE	1.2674449548571587e-8	198	25	9	0.36	0.045454545454545456	GO:0009205	GO:BP	purine ribonucleoside triphosphate metabolic process	16175	3371		0.6	0.6060606060606061	198	15977	9	16	189	15961	16175	0.12443027331264465
R1	cpdb	0	network_modules	260	TRUE	1.286767269365988e-8	74	20	7	0.35	0.0945945945945946	KEGG:01230	KEGG	Biosynthesis of amino acids	8484	188		0.6666666666666666	0.75	74	8410	7	13	67	8397	8484	0.17841110488902978
R1	cpdb	0	network_modules	260	TRUE	1.451270928627017e-8	201	25	9	0.36	0.04477611940298507	GO:0009144	GO:BP	purine nucleoside triphosphate metabolic process	16175	3311		0.6153846153846154	0.6212121212121212	201	15974	9	16	192	15958	16175	0.1234439225823931
R1	cpdb	0	network_modules	260	TRUE	1.601840270472051e-8	742	25	13	0.52	0.01752021563342318	GO:0019752	GO:BP	carboxylic acid metabolic process	16175	6036		0.6307692307692307	0.6363636363636364	742	15433	13	12	729	15421	16175	0.08916519178673062
R1	cpdb	0	network_modules	260	TRUE	1.65829087195977e-8	204	25	9	0.36	0.04411764705882353	GO:0009199	GO:BP	ribonucleoside triphosphate metabolic process	16175	3365		0.6461538461538462	0.6515151515151515	204	15971	9	16	195	15955	16175	0.12247900076365353
R1	cpdb	0	network_modules	260	TRUE	2.200870359867944e-8	761	25	13	0.52	0.017082785808147174	GO:0043436	GO:BP	oxoacid metabolic process	16175	10693		0.6615384615384615	0.6666666666666666	761	15414	13	12	748	15402	16175	0.08788103648877413
R1	cpdb	0	network_modules	260	TRUE	2.428916996085396e-8	767	25	13	0.52	0.01694915254237288	GO:0006082	GO:BP	organic acid metabolic process	16175	1947		0.676923076923077	0.6818181818181818	767	15408	13	12	754	15396	16175	0.08748500128181581
R1	cpdb	0	network_modules	260	TRUE	2.658693296235948e-8	215	25	9	0.36	0.04186046511627907	GO:0009141	GO:BP	nucleoside triphosphate metabolic process	16175	3308		0.6923076923076923	0.696969696969697	215	15960	9	16	206	15944	16175	0.11911215237844502
R1	cpdb	0	network_modules	260	TRUE	3.55488564784774e-8	16	25	5	0.2	0.3125	GO:0061718	GO:BP	glucose catabolic process to pyruvate	16175	15628		0.7076923076923077	0.7424242424242424	16	16159	5	20	11	16139	16175	0.24907921360072902
R1	cpdb	0	network_modules	260	TRUE	3.55488564784774e-8	16	25	5	0.2	0.3125	GO:0006735	GO:BP	NADH regeneration	16175	2436		0.7076923076923077	0.7424242424242424	16	16159	5	20	11	16139	16175	0.24907921360072902
R1	cpdb	0	network_modules	260	TRUE	3.55488564784774e-8	16	25	5	0.2	0.3125	GO:0061621	GO:BP	canonical glycolysis	16175	15590		0.7076923076923077	0.7424242424242424	16	16159	5	20	11	16139	16175	0.24907921360072902
R1	cpdb	0	network_modules	260	TRUE	5.0308958875042895e-8	17	25	5	0.2	0.29411764705882354	GO:0061620	GO:BP	glycolytic process through glucose-6-phosphate	16175	15589		0.7538461538461538	0.7727272727272727	17	16158	5	20	12	16138	16175	0.24157473854590025
R1	cpdb	0	network_modules	260	TRUE	5.0308958875042895e-8	17	25	5	0.2	0.29411764705882354	GO:0061615	GO:BP	glycolytic process through fructose-6-phosphate	16175	15586		0.7538461538461538	0.7727272727272727	17	16158	5	20	12	16138	16175	0.24157473854590025
R1	cpdb	0	network_modules	260	TRUE	5.208422666904828e-8	147	25	8	0.32	0.05442176870748299	GO:0016051	GO:BP	carbohydrate biosynthetic process	16175	5083		0.7846153846153846	0.7878787878787878	147	16028	8	17	139	16011	16175	0.1289041924182571
R1	cpdb	0	network_modules	260	TRUE	5.807508098900297e-8	149	25	8	0.32	0.053691275167785234	GO:0019318	GO:BP	hexose metabolic process	16175	5681		0.8	0.803030303030303	149	16026	8	17	141	16009	16175	0.12799320756865276
R1	cpdb	0	network_modules	260	TRUE	9.434177766954616e-8	19	25	5	0.2	0.2631578947368421	GO:0006007	GO:BP	glucose catabolic process	16175	1882		0.8153846153846154	0.8333333333333334	19	16156	5	20	14	16136	16175	0.2283789428751201
R1	cpdb	0	network_modules	260	TRUE	9.434177766954616e-8	19	25	5	0.2	0.2631578947368421	GO:0019677	GO:BP	NAD catabolic process	16175	5995		0.8153846153846154	0.8333333333333334	19	16156	5	20	14	16136	16175	0.2283789428751201
R1	cpdb	0	network_modules	260	TRUE	1.1040331703087334e-7	367	25	10	0.4	0.027247956403269755	GO:0005975	GO:BP	carbohydrate metabolic process	16175	1850		0.8461538461538461	0.8484848484848485	367	15808	10	15	357	15793	16175	0.09969092259331029
R1	cpdb	0	network_modules	260	TRUE	1.1954215625236794e-7	163	25	8	0.32	0.049079754601226995	GO:0005996	GO:BP	monosaccharide metabolic process	16175	1871		0.8615384615384616	0.8636363636363636	163	16012	8	17	155	15995	16175	0.12208571547484318
R1	cpdb	0	network_modules	260	TRUE	1.2607049797854092e-7	372	25	10	0.4	0.026881720430107527	GO:0006091	GO:BP	generation of precursor metabolites and energy	16175	1954		0.8769230769230769	0.8787878787878788	372	15803	10	15	362	15788	16175	0.09895321773308907
R1	cpdb	0	network_modules	260	TRUE	1.7823202663184965e-7	266	25	9	0.36	0.03383458646616541	GO:0009150	GO:BP	purine ribonucleotide metabolic process	16175	3317		0.8923076923076924	0.8939393939393939	266	15909	9	16	257	15893	16175	0.10628252866357465
R1	cpdb	0	network_modules	260	TRUE	2.0320957051029283e-7	109	20	7	0.35	0.06422018348623854	KEGG:04066	KEGG	HIF-1 signaling pathway	8484	257		1	1	109	8375	7	13	102	8362	8484	0.14552857708707465
R1	cpdb	0	network_modules	260	TRUE	2.474512179333694e-7	276	25	9	0.36	0.03260869565217391	GO:0009259	GO:BP	ribonucleotide metabolic process	16175	3424		0.9076923076923077	0.9090909090909091	276	15899	9	16	267	15883	16175	0.10418434391692528
R1	cpdb	0	network_modules	260	TRUE	3.0908082145669663e-7	283	25	9	0.36	0.03180212014134275	GO:0019693	GO:BP	ribose phosphate metabolic process	16175	6010		0.9230769230769231	0.9242424242424242	283	15892	9	16	274	15876	16175	0.1027805671394688
R1	cpdb	0	network_modules	260	TRUE	2.222912102147208e-6	34	25	5	0.2	0.14705882352941177	GO:0019320	GO:BP	hexose catabolic process	16175	5683		0.9384615384615385	0.9393939393939394	34	16141	5	20	29	16121	16175	0.1700061913114113
R1	cpdb	0	network_modules	260	TRUE	3.4714994003011533e-6	37	25	5	0.2	0.13513513513513514	GO:0046365	GO:BP	monosaccharide catabolic process	16175	12096		0.9538461538461539	0.9545454545454546	37	16138	5	20	32	16118	16175	0.16283077233420043
R1	cpdb	0	network_modules	260	TRUE	1.742768366800608e-5	448	25	9	0.36	0.020089285714285716	GO:0034655	GO:BP	nucleobase-containing compound catabolic process	16175	8711		0.9692307692307692	0.9696969696969697	448	15727	9	16	439	15711	16175	0.07967099833043574
R1	cpdb	0	network_modules	260	TRUE	3.282524199998762e-5	482	25	9	0.36	0.01867219917012448	GO:0044283	GO:BP	small molecule biosynthetic process	16175	10950		0.9846153846153847	0.9848484848484849	482	15693	9	16	473	15677	16175	0.07640641314865955
R1	cpdb	0	network_modules	260	TRUE	3.6301449741634644e-4	300	25	7	0.28	0.023333333333333334	GO:0044282	GO:BP	small molecule catabolic process	16175	10949		1	1	300	15875	7	18	293	15857	16175	0.07624369437561992
R1	cpdb	0	network_modules	261	TRUE	4.9967995143879104e-8	298	17	9	0.5294117647058824	0.030201342281879196	REAC:R-HSA-1474244	REAC	Extracellular matrix organization	10916	889		0	0.3333333333333333	298	10618	9	8	289	10610	10916	0.12169314215463094
R1	cpdb	0	network_modules	261	TRUE	3.1091909997788025e-5	25	20	4	0.2	0.16	GO:1902692	GO:BP	regulation of neuroblast proliferation	16175	22446		0	0.1111111111111111	25	16150	4	16	21	16134	16175	0.17775027503475063
R1	cpdb	0	network_modules	261	TRUE	2.457720188151276e-4	41	20	4	0.2	0.0975609756097561	GO:0007405	GO:BP	neuroblast proliferation	16175	2902		0.125	0.2222222222222222	41	16134	4	16	37	16118	16175	0.13817627281659906
R1	cpdb	0	network_modules	261	TRUE	4.348860574101986e-4	236	20	6	0.3	0.025423728813559324	GO:0030198	GO:BP	extracellular matrix organization	16175	6707		0.25	0.3333333333333333	236	15939	6	14	230	15925	16175	0.083750579306198
R1	cpdb	0	network_modules	261	TRUE	4.458477244143321e-4	237	20	6	0.3	0.02531645569620253	GO:0043062	GO:BP	extracellular structure organization	16175	10509		0.375	0.4444444444444444	237	15938	6	14	231	15924	16175	0.08355822151328578
R1	cpdb	0	network_modules	261	TRUE	4.570357979551209e-4	238	20	6	0.3	0.025210084033613446	GO:0045229	GO:BP	external encapsulating structure organization	16175	11340		0.5	0.5555555555555556	238	15937	6	14	232	15923	16175	0.08336704388955249
R1	cpdb	0	network_modules	261	TRUE	4.6961371791283613e-4	48	20	4	0.2	0.08333333333333333	GO:2000177	GO:BP	regulation of neural precursor cell proliferation	16175	25509		0.625	0.6666666666666666	48	16127	4	16	44	16111	16175	0.12745185725072544
R1	cpdb	0	network_modules	261	TRUE	5.88631426783052e-4	140	17	5	0.29411764705882354	0.03571428571428571	REAC:R-HSA-1474228	REAC	Degradation of the extracellular matrix	10916	726		0.5	0.6666666666666666	140	10776	5	12	135	10764	10916	0.09873244837708021
R1	cpdb	0	network_modules	261	TRUE	0.0016069969661759978	76	17	4	0.23529411764705882	0.05263157894736842	REAC:R-HSA-3000178	REAC	ECM proteoglycans	10916	812		1	1	76	10840	4	13	72	10827	10916	0.10845254289089505
R1	cpdb	0	network_modules	261	TRUE	0.002274774027430532	19	20	3	0.15	0.15789473684210525	GO:0002052	GO:BP	positive regulation of neuroblast proliferation	16175	651		0.75	0.7777777777777778	19	16156	3	17	16	16139	16175	0.15287588680262662
R1	cpdb	0	network_modules	261	TRUE	0.0037214917260370846	80	20	4	0.2	0.05	GO:0061351	GO:BP	neural precursor cell proliferation	16175	15426		0.875	0.8888888888888888	80	16095	4	16	76	16079	16175	0.09782962667482041
R1	cpdb	0	network_modules	261	TRUE	0.00937356760218706	224	20	5	0.25	0.022321428571428572	GO:0006959	GO:BP	humoral immune response	16175	2590		1	1	224	15951	5	15	219	15936	16175	0.07110145523563621
R1	cpdb	0	network_modules	262	TRUE	7.884371993690678e-13	59	24	9	0.375	0.15254237288135594	REAC:R-HSA-8943724	REAC	Regulation of PTEN gene transcription	10916	1999		0	0.0625	59	10857	9	15	50	10842	10916	0.23662498508069324
R1	cpdb	0	network_modules	262	TRUE	1.2023034730756419e-12	19	27	7	0.25925925925925924	0.3684210526315789	GO:0042659	GO:BP	regulation of cell fate specification	16175	10274		0	0.1	19	16156	7	20	12	16136	16175	0.3080953764393584
R1	cpdb	0	network_modules	262	TRUE	3.6840240498580266e-11	29	27	7	0.25925925925925924	0.2413793103448276	GO:0010453	GO:BP	regulation of cell fate commitment	16175	4149		0.1111111111111111	0.2	29	16146	7	20	22	16126	16175	0.248860423759654
R1	cpdb	0	network_modules	262	TRUE	1.2857161509932135e-9	116	17	8	0.47058823529411764	0.06896551724137931	KEGG:03082	KEGG	ATP-dependent chromatin remodeling	8484	219		NA	1	116	8368	8	9	108	8359	8484	0.1763016365148366
R1	cpdb	0	network_modules	262	TRUE	1.7391774532888319e-9	47	24	7	0.2916666666666667	0.14893617021276595	REAC:R-HSA-73762	REAC	RNA Polymerase I Transcription Initiation	10916	1885		0.06666666666666667	0.125	47	10869	7	17	40	10852	10916	0.20601532394082242
R1	cpdb	0	network_modules	262	TRUE	2.1790866486304366e-9	138	24	9	0.375	0.06521739130434782	REAC:R-HSA-6807070	REAC	PTEN Regulation	10916	1703		0.13333333333333333	0.1875	138	10778	9	15	129	10763	10916	0.15224553355376377
R1	cpdb	0	network_modules	262	TRUE	6.918301546524453e-9	791	27	14	0.5185185185185185	0.017699115044247787	GO:0000122	GO:BP	negative regulation of transcription by RNA polymerase II	16175	48		0.2222222222222222	0.3	791	15384	14	13	777	15371	16175	0.08904031914605101
R1	cpdb	0	network_modules	262	TRUE	9.94638066376433e-9	61	27	7	0.25925925925925924	0.11475409836065574	GO:2000736	GO:BP	regulation of stem cell differentiation	16175	25999		0.3333333333333333	0.4	61	16114	7	20	54	16094	16175	0.17043968502483453
R1	cpdb	0	network_modules	262	TRUE	1.5149850933888664e-8	109	24	8	0.3333333333333333	0.07339449541284404	REAC:R-HSA-73854	REAC	RNA Polymerase I Promoter Clearance	10916	1881		0.2	0.25	109	10807	8	16	101	10791	10916	0.1526580369401487
R1	cpdb	0	network_modules	262	TRUE	1.580344708980084e-8	65	27	7	0.25925925925925924	0.1076923076923077	GO:0001708	GO:BP	cell fate specification	16175	400		0.4444444444444444	0.5	65	16110	7	20	58	16090	16175	0.1649727827631759
R1	cpdb	0	network_modules	262	TRUE	1.6316629692705864e-8	110	24	8	0.3333333333333333	0.07272727272727272	REAC:R-HSA-73864	REAC	RNA Polymerase I Transcription	10916	1884		0.26666666666666666	0.3125	110	10806	8	16	102	10790	10916	0.15192652881217567
R1	cpdb	0	network_modules	262	TRUE	5.2823805889820695e-8	75	24	7	0.2916666666666667	0.09333333333333334	REAC:R-HSA-427389	REAC	ERCC6 (CSB) and EHMT2 (G9a) positively regulate rRNA expression	10916	827		0.3333333333333333	0.375	75	10841	7	17	68	10824	10916	0.16183928104641335
R1	cpdb	0	network_modules	262	TRUE	2.654117087572515e-7	94	24	7	0.2916666666666667	0.07446808510638298	REAC:R-HSA-3214815	REAC	HDACs deacetylate histones	10916	1092		0.4	0.4375	94	10822	7	17	87	10805	10916	0.1438034041803817
R1	cpdb	0	network_modules	262	TRUE	4.654946811660072e-7	175	27	8	0.2962962962962963	0.045714285714285714	GO:0045165	GO:BP	cell fate commitment	16175	11307		0.5555555555555556	0.6	175	16000	8	19	167	15981	16175	0.11283896883909396
R1	cpdb	0	network_modules	262	TRUE	4.988426893456544e-7	253	24	9	0.375	0.03557312252964427	REAC:R-HSA-1257604	REAC	PIP3 activates AKT signaling	10916	1679		0.4666666666666667	0.5	253	10663	9	15	244	10648	10916	0.10975886534513703
R1	cpdb	0	network_modules	262	TRUE	5.234096761668003e-7	529	27	11	0.4074074074074074	0.020793950850661626	GO:0006325	GO:BP	chromatin organization	16175	2122		0.6666666666666666	0.7	529	15646	11	16	518	15630	16175	0.08614380034246985
R1	cpdb	0	network_modules	262	TRUE	5.43325336476263e-7	104	24	7	0.2916666666666667	0.0673076923076923	REAC:R-HSA-5250913	REAC	Positive epigenetic regulation of rRNA expression	10916	1771		0.5333333333333333	0.5625	104	10812	7	17	97	10795	10916	0.13633561810352104
R1	cpdb	0	network_modules	262	TRUE	9.139899407878722e-7	271	24	9	0.375	0.033210332103321034	REAC:R-HSA-3247509	REAC	Chromatin modifying enzymes	10916	355		0.6	0.6875	271	10645	9	15	262	10630	10916	0.10564326628399592
R1	cpdb	0	network_modules	262	TRUE	9.139899407878722e-7	271	24	9	0.375	0.033210332103321034	REAC:R-HSA-4839726	REAC	Chromatin organization	10916	356		0.6	0.6875	271	10645	9	15	262	10630	10916	0.10564326628399592
R1	cpdb	0	network_modules	262	TRUE	1.0531384333951897e-6	185	24	8	0.3333333333333333	0.043243243243243246	REAC:R-HSA-212165	REAC	Epigenetic regulation of gene expression	10916	852		0.7333333333333333	0.75	185	10731	8	16	177	10715	10916	0.11506050130658751
R1	cpdb	0	network_modules	262	TRUE	1.3970293630402659e-6	30	24	5	0.20833333333333334	0.16666666666666666	REAC:R-HSA-6804758	REAC	Regulation of TP53 Activity through Acetylation	10916	2013		0.8	0.8125	30	10886	5	19	25	10867	10916	0.1843368320306321
R1	cpdb	0	network_modules	262	TRUE	1.8129385330325807e-6	293	24	9	0.375	0.030716723549488054	REAC:R-HSA-9006925	REAC	Intracellular signaling by second messengers	10916	1266		0.8666666666666667	0.875	293	10623	9	15	284	10608	10916	0.10111955284514239
R1	cpdb	0	network_modules	262	TRUE	6.6765001908429795e-6	152	27	7	0.25925925925925924	0.046052631578947366	GO:0048863	GO:BP	stem cell differentiation	16175	13106		0.7777777777777778	0.8	152	16023	7	20	145	16003	16175	0.10589449278376438
R1	cpdb	0	network_modules	262	TRUE	7.06143265609447e-6	150	24	7	0.2916666666666667	0.04666666666666667	REAC:R-HSA-9679191	REAC	Potential therapeutics for SARS	10916	1782		0.9333333333333333	0.9375	150	10766	7	17	143	10749	10916	0.11206518333542781
R1	cpdb	0	network_modules	262	TRUE	7.858319667017377e-4	454	27	8	0.2962962962962963	0.01762114537444934	GO:0006338	GO:BP	chromatin remodeling	16175	2126		0.8888888888888888	0.9	454	15721	8	19	446	15702	16175	0.0664053961475199
R1	cpdb	0	network_modules	262	TRUE	0.0014116110841080967	12	27	3	0.1111111111111111	0.25	GO:0070828	GO:BP	heterochromatin organization	16175	16326		1	1	12	16163	3	24	9	16139	16175	0.16575368276393845
R1	cpdb	0	network_modules	262	TRUE	0.006654818744165733	160	24	5	0.20833333333333334	0.03125	REAC:R-HSA-5633007	REAC	Regulation of TP53 Activity	10916	2012		1	1	160	10756	5	19	155	10737	10916	0.075649426084886
R1	cpdb	0	network_modules	263	TRUE	8.137882671281611e-18	10	33	8	0.24242424242424243	0.8	GO:0006086	GO:BP	acetyl-CoA biosynthetic process from pyruvate	16175	1951		0	0.04	10	16165	8	25	2	16140	16175	0.4398471822685656
R1	cpdb	0	network_modules	263	TRUE	2.6388286405834054e-15	16	28	8	0.2857142857142857	0.5	REAC:R-HSA-204174	REAC	Regulation of pyruvate dehydrogenase (PDH) complex	10916	2047		0	0.16666666666666666	16	10900	8	20	8	10880	10916	0.37678490907256823
R1	cpdb	0	network_modules	263	TRUE	2.6388286405834054e-15	16	28	8	0.2857142857142857	0.5	REAC:R-HSA-9861718	REAC	Regulation of pyruvate metabolism	10916	2048		0	0.16666666666666666	16	10900	8	20	8	10880	10916	0.37678490907256823
R1	cpdb	0	network_modules	263	TRUE	4.354131065510205e-15	17	33	8	0.24242424242424243	0.47058823529411764	GO:0006085	GO:BP	acetyl-CoA biosynthetic process	16175	1950		0.041666666666666664	0.08	17	16158	8	25	9	16133	16175	0.33681656414404665
R1	cpdb	0	network_modules	263	TRUE	5.48324496720841e-13	28	33	8	0.24242424242424243	0.2857142857142857	GO:0006084	GO:BP	acetyl-CoA metabolic process	16175	1949		0.08333333333333333	0.12	28	16147	8	25	20	16122	16175	0.26179504777210555
R1	cpdb	0	network_modules	263	TRUE	1.172949305817422e-12	30	28	8	0.2857142857142857	0.26666666666666666	REAC:R-HSA-70268	REAC	Pyruvate metabolism	10916	1832		0.18181818181818182	0.25	30	10886	8	20	22	10866	10916	0.2740993402598011
R1	cpdb	0	network_modules	263	TRUE	2.0425062768542655e-11	42	33	8	0.24242424242424243	0.19047619047619047	GO:0071616	GO:BP	acyl-CoA biosynthetic process	16175	16800		0.125	0.2	42	16133	8	25	34	16108	16175	0.2130784919750895
R1	cpdb	0	network_modules	263	TRUE	2.0425062768542655e-11	42	33	8	0.24242424242424243	0.19047619047619047	GO:0035384	GO:BP	thioester biosynthetic process	16175	9013		0.125	0.2	42	16133	8	25	34	16108	16175	0.2130784919750895
R1	cpdb	0	network_modules	263	TRUE	2.8449505744776868e-11	43	28	8	0.2857142857142857	0.18604651162790697	REAC:R-HSA-5362517	REAC	Signaling by Retinoic Acid	10916	2303		0.2727272727272727	0.3333333333333333	43	10873	8	20	35	10853	10916	0.2281193884824926
R1	cpdb	0	network_modules	263	TRUE	3.362093317722276e-10	141	28	10	0.35714285714285715	0.07092198581560284	REAC:R-HSA-3214847	REAC	HATs acetylate histones	10916	1087		0.36363636363636365	0.4166666666666667	141	10775	10	18	131	10757	10916	0.15459448924548047
R1	cpdb	0	network_modules	263	TRUE	1.0439671937787371e-8	88	33	8	0.24242424242424243	0.09090909090909091	GO:0006637	GO:BP	acyl-CoA metabolic process	16175	2348		0.20833333333333334	0.28	88	16087	8	25	80	16062	16175	0.14566737170107194
R1	cpdb	0	network_modules	263	TRUE	1.0439671937787371e-8	88	33	8	0.24242424242424243	0.09090909090909091	GO:0035383	GO:BP	thioester metabolic process	16175	9012		0.20833333333333334	0.28	88	16087	8	25	80	16062	16175	0.14566737170107194
R1	cpdb	0	network_modules	263	TRUE	2.130023685015062e-8	96	33	8	0.24242424242424243	0.08333333333333333	GO:0006090	GO:BP	pyruvate metabolic process	16175	1953		0.2916666666666667	0.32	96	16079	8	25	88	16054	16175	0.13920944037910252
R1	cpdb	0	network_modules	263	TRUE	3.0482484519379424e-8	30	28	6	0.21428571428571427	0.2	REAC:R-HSA-6804758	REAC	Regulation of TP53 Activity through Acetylation	10916	2013		0.45454545454545453	0.5	30	10886	6	22	24	10864	10916	0.20490896938115924
R1	cpdb	0	network_modules	263	TRUE	2.2232801978506997e-7	271	28	10	0.35714285714285715	0.03690036900369004	REAC:R-HSA-4839726	REAC	Chromatin organization	10916	356		0.5454545454545454	0.6666666666666666	271	10645	10	18	261	10627	10916	0.10830872762176384
R1	cpdb	0	network_modules	263	TRUE	2.2232801978506997e-7	271	28	10	0.35714285714285715	0.03690036900369004	REAC:R-HSA-3247509	REAC	Chromatin modifying enzymes	10916	355		0.5454545454545454	0.6666666666666666	271	10645	10	18	261	10627	10916	0.10830872762176384
R1	cpdb	0	network_modules	263	TRUE	5.348675867731913e-7	143	33	8	0.24242424242424243	0.055944055944055944	GO:0043604	GO:BP	amide biosynthetic process	16175	10796		0.3333333333333333	0.36	143	16032	8	25	135	16007	16175	0.112824330374679
R1	cpdb	0	network_modules	263	TRUE	1.0226650724700564e-6	19	14	4	0.2857142857142857	0.21052631578947367	KEGG:00785	KEGG	Lipoic acid metabolism	8484	124		0	0.14285714285714285	19	8465	4	10	15	8455	8484	0.24380752831709956
R1	cpdb	0	network_modules	263	TRUE	1.1861999589449466e-6	158	33	8	0.24242424242424243	0.05063291139240506	GO:0044272	GO:BP	sulfur compound biosynthetic process	16175	10944		0.375	0.4	158	16017	8	25	150	15992	16175	0.10695913107400166
R1	cpdb	0	network_modules	263	TRUE	3.204287200396148e-6	177	28	8	0.2857142857142857	0.04519774011299435	REAC:R-HSA-1428517	REAC	Aerobic respiration and respiratory electron transport	10916	127		0.7272727272727273	0.75	177	10739	8	20	169	10719	10916	0.10820765481762741
R1	cpdb	0	network_modules	263	TRUE	4.120663535148763e-6	31	28	5	0.17857142857142858	0.16129032258064516	REAC:R-HSA-389661	REAC	Glyoxylate metabolism and glycine degradation	10916	1081		0.8181818181818182	0.8333333333333334	31	10885	5	23	26	10862	10916	0.16746466635390922
R1	cpdb	0	network_modules	263	TRUE	7.155915385856493e-6	30	14	4	0.2857142857142857	0.13333333333333333	KEGG:00020	KEGG	Citrate cycle (TCA cycle)	8484	3		0.16666666666666666	0.2857142857142857	30	8454	4	10	26	8444	8484	0.19326566687580515
R1	cpdb	0	network_modules	263	TRUE	1.0654653886421087e-5	33	14	4	0.2857142857142857	0.12121212121212122	KEGG:01210	KEGG	2-Oxocarboxylic acid metabolism	8484	185		0.3333333333333333	0.42857142857142855	33	8451	4	10	29	8441	8484	0.18407332955728625
R1	cpdb	0	network_modules	263	TRUE	1.6191555796766356e-5	220	33	8	0.24242424242424243	0.03636363636363636	GO:0072522	GO:BP	purine-containing compound biosynthetic process	16175	17424		0.4166666666666667	0.44	220	15955	8	25	212	15930	16175	0.08932284136615828
R1	cpdb	0	network_modules	263	TRUE	1.6786468456748786e-5	140	33	7	0.21212121212121213	0.05	GO:0071897	GO:BP	DNA biosynthetic process	16175	16970		0.4583333333333333	0.48	140	16035	7	26	133	16009	16175	0.09931519017165592
R1	cpdb	0	network_modules	263	TRUE	2.499034392592067e-5	202	14	6	0.42857142857142855	0.0297029702970297	KEGG:05415	KEGG	Diabetic cardiomyopathy	8484	492		0.5	0.5714285714285714	202	8282	6	8	196	8274	8484	0.10793922752802573
R1	cpdb	0	network_modules	263	TRUE	2.637183376390395e-5	85	33	6	0.18181818181818182	0.07058823529411765	GO:2000278	GO:BP	regulation of DNA biosynthetic process	16175	25603		0.5	0.52	85	16090	6	27	79	16063	16175	0.11041680909776606
R1	cpdb	0	network_modules	263	TRUE	4.583135618433456e-5	47	14	4	0.2857142857142857	0.0851063829787234	KEGG:00620	KEGG	Pyruvate metabolism	8484	99		0.6666666666666666	0.7142857142857143	47	8437	4	10	43	8427	8484	0.15346471630333697
R1	cpdb	0	network_modules	263	TRUE	4.682574559868202e-5	4	33	3	0.09090909090909091	0.75	GO:0010510	GO:BP	regulation of acetyl-CoA biosynthetic process from pyruvate	16175	4185		0.5416666666666666	0.6	4	16171	3	30	1	16141	16175	0.2607044656113692
R1	cpdb	0	network_modules	263	TRUE	4.682574559868202e-5	4	33	3	0.09090909090909091	0.75	GO:0050812	GO:BP	regulation of acyl-CoA biosynthetic process	16175	13276		0.5416666666666666	0.6	4	16171	3	30	1	16141	16175	0.2607044656113692
R1	cpdb	0	network_modules	263	TRUE	5.946681506315473e-5	260	33	8	0.24242424242424243	0.03076923076923077	GO:1901293	GO:BP	nucleoside phosphate biosynthetic process	16175	21368		0.625	0.64	260	15915	8	25	252	15890	16175	0.08137915845865935
R1	cpdb	0	network_modules	263	TRUE	1.3457124166243743e-4	289	33	8	0.24242424242424243	0.02768166089965398	GO:0006790	GO:BP	sulfur compound metabolic process	16175	2476		0.6666666666666666	0.68	289	15886	8	25	281	15861	16175	0.07664667179403636
R1	cpdb	0	network_modules	263	TRUE	1.3877481780211762e-4	112	33	6	0.18181818181818182	0.05357142857142857	GO:0006275	GO:BP	regulation of DNA replication	16175	2090		0.7083333333333334	0.72	112	16063	6	27	106	16036	16175	0.09536191171121751
R1	cpdb	0	network_modules	263	TRUE	1.470144824401518e-4	290	28	8	0.2857142857142857	0.027586206896551724	REAC:R-HSA-9006931	REAC	Signaling by Nuclear Receptors	10916	2289		0.9090909090909091	0.9166666666666666	290	10626	8	20	282	10606	10916	0.08172069867516353
R1	cpdb	0	network_modules	263	TRUE	1.932549016702055e-4	67	14	4	0.2857142857142857	0.05970149253731343	KEGG:00010	KEGG	Glycolysis / Gluconeogenesis	8484	2		0.8333333333333334	0.8571428571428571	67	8417	4	10	63	8407	8484	0.1276044530230568
R1	cpdb	0	network_modules	263	TRUE	5.220352882306305e-4	231	33	7	0.21212121212121213	0.030303030303030304	GO:0006260	GO:BP	DNA replication	16175	2077		0.75	0.76	231	15944	7	26	224	15918	16175	0.07539314656869753
R1	cpdb	0	network_modules	263	TRUE	7.73151330395134e-4	504	33	9	0.2727272727272727	0.017857142857142856	GO:0032787	GO:BP	monocarboxylic acid metabolic process	16175	7822		0.7916666666666666	0.8	504	15671	9	24	495	15647	16175	0.06286349249613186
R1	cpdb	0	network_modules	263	TRUE	8.681254681478071e-4	160	28	6	0.21428571428571427	0.0375	REAC:R-HSA-5633007	REAC	Regulation of TP53 Activity	10916	2012		1	1	160	10756	6	22	154	10734	10916	0.08423746200799744
R1	cpdb	0	network_modules	263	TRUE	0.0012937871154756167	389	33	8	0.24242424242424243	0.02056555269922879	GO:0043603	GO:BP	amide metabolic process	16175	10795		0.8333333333333334	0.84	389	15786	8	25	381	15761	16175	0.06444870942316273
R1	cpdb	0	network_modules	263	TRUE	0.0013930881492977857	10	33	3	0.09090909090909091	0.3	GO:0042762	GO:BP	regulation of sulfur metabolic process	16175	10354		0.875	0.88	10	16165	3	30	7	16135	16175	0.1642398307076278
R1	cpdb	0	network_modules	263	TRUE	0.0016654916880452174	115	14	4	0.2857142857142857	0.034782608695652174	KEGG:01200	KEGG	Carbon metabolism	8484	184		1	1	115	8369	4	10	111	8359	8484	0.09568867511719895
R1	cpdb	0	network_modules	263	TRUE	0.003665734011873725	309	33	7	0.21212121212121213	0.022653721682847898	GO:1903706	GO:BP	regulation of hemopoiesis	16175	23220		0.9166666666666666	0.92	309	15866	7	26	302	15840	16175	0.0637538862430494
R1	cpdb	0	network_modules	263	TRUE	0.005229927459173298	469	33	8	0.24242424242424243	0.017057569296375266	GO:0072521	GO:BP	purine-containing compound metabolic process	16175	17423		0.9583333333333334	0.96	469	15706	8	25	461	15681	16175	0.057511746142784516
R1	cpdb	0	network_modules	263	TRUE	0.009984340967553164	512	33	8	0.24242424242424243	0.015625	GO:0090407	GO:BP	organophosphate biosynthetic process	16175	18274		1	1	512	15663	8	25	504	15638	16175	0.054432698861522195
R1	cpdb	0	network_modules	264	TRUE	5.57404912264497e-9	39	17	6	0.35294117647058826	0.15384615384615385	REAC:R-HSA-110313	REAC	Translesion synthesis by Y family DNA polymerases bypasses lesions on DNA template	10916	2577		0	0.027777777777777776	39	10877	6	11	33	10866	10916	0.2312551766993187
R1	cpdb	0	network_modules	264	TRUE	1.0901075075583677e-8	38	22	6	0.2727272727272727	0.15789473684210525	GO:0000731	GO:BP	DNA synthesis involved in DNA repair	16175	208		0	0.125	38	16137	6	16	32	16121	16175	0.20610908515556176
R1	cpdb	0	network_modules	264	TRUE	2.0802466041532794e-8	48	17	6	0.35294117647058826	0.125	REAC:R-HSA-73893	REAC	DNA Damage Bypass	10916	438		0.02857142857142857	0.05555555555555555	48	10868	6	11	42	10857	10916	0.20804476428881882
R1	cpdb	0	network_modules	264	TRUE	2.4923630341809865e-7	26	22	5	0.22727272727272727	0.19230769230769232	GO:0019985	GO:BP	translesion synthesis	16175	6075		0.14285714285714285	0.25	26	16149	5	17	21	16132	16175	0.20789035553360857
R1	cpdb	0	network_modules	264	TRUE	3.140068529092468e-7	32	17	5	0.29411764705882354	0.15625	REAC:R-HSA-5656169	REAC	Termination of translesion DNA synthesis	10916	2492		0.05714285714285714	0.08333333333333333	32	10884	5	12	27	10872	10916	0.21271403718306225
R1	cpdb	0	network_modules	264	TRUE	1.2203389409942367e-6	35	22	5	0.22727272727272727	0.14285714285714285	GO:0006301	GO:BP	postreplication repair	16175	2108		0.2857142857142857	0.375	35	16140	5	17	30	16123	16175	0.17878698491202705
R1	cpdb	0	network_modules	264	TRUE	1.3302823344585388e-6	14	17	4	0.23529411764705882	0.2857142857142857	REAC:R-HSA-69109	REAC	Leading Strand Synthesis	10916	1308		0.08571428571428572	0.2222222222222222	14	10902	4	13	10	10889	10916	0.2582348989999625
R1	cpdb	0	network_modules	264	TRUE	1.3302823344585388e-6	14	17	4	0.23529411764705882	0.2857142857142857	REAC:R-HSA-5358606	REAC	Mismatch repair (MMR) directed by MSH2:MSH3 (MutSbeta)	10916	1458		0.08571428571428572	0.2222222222222222	14	10902	4	13	10	10889	10916	0.2582348989999625
R1	cpdb	0	network_modules	264	TRUE	1.3302823344585388e-6	14	17	4	0.23529411764705882	0.2857142857142857	REAC:R-HSA-5358565	REAC	Mismatch repair (MMR) directed by MSH2:MSH6 (MutSalpha)	10916	1459		0.08571428571428572	0.2222222222222222	14	10902	4	13	10	10889	10916	0.2582348989999625
R1	cpdb	0	network_modules	264	TRUE	1.3302823344585388e-6	14	17	4	0.23529411764705882	0.2857142857142857	REAC:R-HSA-69166	REAC	Removal of the Flap Intermediate	10916	2058		0.08571428571428572	0.2222222222222222	14	10902	4	13	10	10889	10916	0.2582348989999625
R1	cpdb	0	network_modules	264	TRUE	1.3302823344585388e-6	14	17	4	0.23529411764705882	0.2857142857142857	REAC:R-HSA-69091	REAC	Polymerase switching	10916	1769		0.08571428571428572	0.2222222222222222	14	10902	4	13	10	10889	10916	0.2582348989999625
R1	cpdb	0	network_modules	264	TRUE	1.8122918271795783e-6	15	17	4	0.23529411764705882	0.26666666666666666	REAC:R-HSA-5358508	REAC	Mismatch Repair	10916	1457		0.22857142857142856	0.2777777777777778	15	10901	4	13	11	10888	10916	0.2493923886799581
R1	cpdb	0	network_modules	264	TRUE	1.8122918271795783e-6	15	17	4	0.23529411764705882	0.26666666666666666	REAC:R-HSA-69183	REAC	Processive synthesis on the lagging strand	10916	1802		0.22857142857142856	0.2777777777777778	15	10901	4	13	11	10888	10916	0.2493923886799581
R1	cpdb	0	network_modules	264	TRUE	2.327539216924694e-6	23	14	4	0.2857142857142857	0.17391304347826086	KEGG:03430	KEGG	Mismatch repair	8484	239		0	0.2	23	8461	4	10	19	8451	8484	0.22127874885205148
R1	cpdb	0	network_modules	264	TRUE	3.1538705262661352e-6	17	17	4	0.23529411764705882	0.23529411764705882	REAC:R-HSA-174437	REAC	Removal of the Flap Intermediate from the C-strand	10916	2059		0.2857142857142857	0.3055555555555556	17	10899	4	13	13	10886	10916	0.2341013476681617
R1	cpdb	0	network_modules	264	TRUE	5.126512662182518e-6	19	17	4	0.23529411764705882	0.21052631578947367	REAC:R-HSA-174414	REAC	Processive synthesis on the C-strand of the telomere	10916	1801		0.3142857142857143	0.3333333333333333	19	10897	4	13	15	10884	10916	0.22128443376954463
R1	cpdb	0	network_modules	264	TRUE	6.402030015981178e-6	20	17	4	0.23529411764705882	0.2	REAC:R-HSA-69186	REAC	Lagging Strand Synthesis	10916	1302		0.34285714285714286	0.3611111111111111	20	10896	4	13	16	10883	10916	0.2156066814307826
R1	cpdb	0	network_modules	264	TRUE	7.900848293750745e-6	21	17	4	0.23529411764705882	0.19047619047619047	REAC:R-HSA-5651801	REAC	PCNA-Dependent Long Patch Base Excision Repair	10916	1658		0.37142857142857144	0.3888888888888889	21	10895	4	13	17	10882	10916	0.2103376649462788
R1	cpdb	0	network_modules	264	TRUE	1.5294102485521784e-5	36	14	4	0.2857142857142857	0.1111111111111111	KEGG:03030	KEGG	DNA replication	8484	214		0.25	0.4	36	8448	4	10	32	8438	8484	0.1760469203274353
R1	cpdb	0	network_modules	264	TRUE	1.5725411220419285e-5	68	17	5	0.29411764705882354	0.07352941176470588	REAC:R-HSA-5685942	REAC	HDR through Homologous Recombination (HRR)	10916	1097		0.4	0.4166666666666667	68	10848	5	12	63	10836	10916	0.14450714475691437
R1	cpdb	0	network_modules	264	TRUE	1.66357550424349e-5	25	17	4	0.23529411764705882	0.16	REAC:R-HSA-5696397	REAC	Gap-filling DNA repair synthesis and ligation in GG-NER	10916	1037		0.42857142857142855	0.4722222222222222	25	10891	4	13	21	10878	10916	0.19251030009600836
R1	cpdb	0	network_modules	264	TRUE	1.66357550424349e-5	25	17	4	0.23529411764705882	0.16	REAC:R-HSA-110373	REAC	Resolution of AP sites via the multiple-nucleotide patch replacement pathway	10916	2073		0.42857142857142855	0.4722222222222222	25	10891	4	13	21	10878	10916	0.19251030009600836
R1	cpdb	0	network_modules	264	TRUE	1.9641685464961194e-5	26	17	4	0.23529411764705882	0.15384615384615385	REAC:R-HSA-174411	REAC	Polymerase switching on the C-strand of the telomere	10916	1770		0.4857142857142857	0.5	26	10890	4	13	22	10877	10916	0.18870632552317113
R1	cpdb	0	network_modules	264	TRUE	2.6169716749031772e-5	41	14	4	0.2857142857142857	0.0975609756097561	KEGG:03440	KEGG	Homologous recombination	8484	240		0.5	0.6	41	8443	4	10	37	8433	8484	0.16466679475412263
R1	cpdb	0	network_modules	264	TRUE	3.3965204048665454e-5	140	22	6	0.2727272727272727	0.04285714285714286	GO:0071897	GO:BP	DNA biosynthetic process	16175	16970		0.42857142857142855	0.5	140	16035	6	16	134	16019	16175	0.10520897510543141
R1	cpdb	0	network_modules	264	TRUE	3.498072343075221e-5	44	14	4	0.2857142857142857	0.09090909090909091	KEGG:03410	KEGG	Base excision repair	8484	237		0.75	0.8	44	8440	4	10	40	8430	8484	0.15878216094399775
R1	cpdb	0	network_modules	264	TRUE	3.5868192157967106e-5	30	17	4	0.23529411764705882	0.13333333333333333	REAC:R-HSA-110314	REAC	Recognition of DNA damage by PCNA-containing replication complex	10916	1948		0.5142857142857142	0.5277777777777778	30	10886	4	13	26	10873	10916	0.17543186401320432
R1	cpdb	0	network_modules	264	TRUE	4.1102177786986956e-5	798	22	10	0.45454545454545453	0.012531328320802004	GO:0006974	GO:BP	DNA damage response	16175	2601		0.5714285714285714	0.625	798	15377	10	12	788	15365	16175	0.06905132232698345
R1	cpdb	0	network_modules	264	TRUE	4.6975383582513e-5	32	17	4	0.23529411764705882	0.125	REAC:R-HSA-69190	REAC	DNA strand elongation	10916	449		0.5428571428571428	0.5555555555555556	32	10884	4	13	28	10871	10916	0.1697429358822571
R1	cpdb	0	network_modules	264	TRUE	6.0466502638053744e-5	34	17	4	0.23529411764705882	0.11764705882352941	REAC:R-HSA-174417	REAC	Telomere C-strand (Lagging Strand) Synthesis	10916	2486		0.5714285714285714	0.5833333333333334	34	10882	4	13	30	10869	10916	0.16456011069494617
R1	cpdb	0	network_modules	264	TRUE	7.66557210772258e-5	36	17	4	0.23529411764705882	0.1111111111111111	REAC:R-HSA-73933	REAC	Resolution of Abasic Sites (AP sites)	10916	2075		0.6	0.6111111111111112	36	10880	4	13	32	10867	10916	0.15981216925385214
R1	cpdb	0	network_modules	264	TRUE	1.0596173750484318e-4	329	17	7	0.4117647058823529	0.02127659574468085	REAC:R-HSA-73894	REAC	DNA Repair	10916	444		0.6285714285714286	0.6388888888888888	329	10587	7	10	322	10577	10916	0.08815513148182402
R1	cpdb	0	network_modules	264	TRUE	1.3115960084659836e-4	41	17	4	0.23529411764705882	0.0975609756097561	REAC:R-HSA-5696400	REAC	Dual Incision in GG-NER	10916	807		0.6571428571428571	0.6666666666666666	41	10875	4	13	37	10862	10916	0.14948949807296916
R1	cpdb	0	network_modules	264	TRUE	1.3232672396662032e-4	61	14	4	0.2857142857142857	0.06557377049180328	KEGG:03420	KEGG	Nucleotide excision repair	8484	238		1	1	61	8423	4	10	57	8413	8484	0.1340255865209101
R1	cpdb	0	network_modules	264	TRUE	3.2058126310376616e-4	51	17	4	0.23529411764705882	0.0784313725490196	REAC:R-HSA-180786	REAC	Extension of Telomeres	10916	887		0.6857142857142857	0.6944444444444444	51	10865	4	13	47	10852	10916	0.13356589738942665
R1	cpdb	0	network_modules	264	TRUE	3.528087783365912e-4	528	22	8	0.36363636363636365	0.015151515151515152	GO:0006281	GO:BP	DNA repair	16175	2095		0.7142857142857143	0.75	528	15647	8	14	520	15633	16175	0.06874100219976403
R1	cpdb	0	network_modules	264	TRUE	4.3990380371619e-4	132	17	5	0.29411764705882354	0.03787878787878788	REAC:R-HSA-5693567	REAC	HDR through Homologous Recombination (HRR) or Single Strand Annealing (SSA)	10916	1098		0.7142857142857143	0.7222222222222222	132	10784	5	12	127	10772	10916	0.10190742655813703
R1	cpdb	0	network_modules	264	TRUE	5.482026781158662e-4	138	17	5	0.29411764705882354	0.036231884057971016	REAC:R-HSA-73886	REAC	Chromosome Maintenance	10916	357		0.7428571428571429	0.7777777777777778	138	10778	5	12	133	10766	10916	0.09950086698269112
R1	cpdb	0	network_modules	264	TRUE	5.482026781158662e-4	138	17	5	0.29411764705882354	0.036231884057971016	REAC:R-HSA-5693538	REAC	Homology Directed Repair	10916	1130		0.7428571428571429	0.7777777777777778	138	10778	5	12	133	10766	10916	0.09950086698269112
R1	cpdb	0	network_modules	264	TRUE	6.441175188545482e-4	12	22	3	0.13636363636363635	0.25	GO:0042276	GO:BP	error-prone translesion synthesis	16175	10073		0.8571428571428571	0.875	12	16163	3	19	9	16144	16175	0.183825929278777
R1	cpdb	0	network_modules	264	TRUE	7.55431542670147e-4	63	17	4	0.23529411764705882	0.06349206349206349	REAC:R-HSA-6782210	REAC	Gap-filling DNA repair synthesis and ligation in TC-NER	10916	1038		0.8	0.8055555555555556	63	10853	4	13	59	10840	10916	0.11966723793003262
R1	cpdb	0	network_modules	264	TRUE	8.050240173179026e-4	64	17	4	0.23529411764705882	0.0625	REAC:R-HSA-6782135	REAC	Dual incision in TC-NER	10916	808		0.8285714285714286	0.8333333333333334	64	10852	4	13	60	10839	10916	0.11868673714864467
R1	cpdb	0	network_modules	264	TRUE	9.526521623122945e-4	129	22	5	0.22727272727272727	0.03875968992248062	GO:0009411	GO:BP	response to UV	16175	3476		1	1	129	16046	5	17	124	16029	16175	0.09098805454662032
R1	cpdb	0	network_modules	264	TRUE	0.0014447321262336585	168	17	5	0.29411764705882354	0.02976190476190476	REAC:R-HSA-5693532	REAC	DNA Double-Strand Break Repair	10916	443		0.8571428571428571	0.8611111111111112	168	10748	5	12	163	10736	10916	0.08942436116892491
R1	cpdb	0	network_modules	264	TRUE	0.0016934318674389707	77	17	4	0.23529411764705882	0.05194805194805195	REAC:R-HSA-6781827	REAC	Transcription-Coupled Nucleotide Excision Repair (TC-NER)	10916	2541		0.8857142857142857	0.8888888888888888	77	10839	4	13	73	10826	10916	0.1077077437336844
R1	cpdb	0	network_modules	264	TRUE	0.002398390563910218	84	17	4	0.23529411764705882	0.047619047619047616	REAC:R-HSA-5696399	REAC	Global Genome Nucleotide Excision Repair (GG-NER)	10916	1047		0.9142857142857143	0.9166666666666666	84	10832	4	13	80	10819	10916	0.10286580415150476
R1	cpdb	0	network_modules	264	TRUE	0.00288749753486914	88	17	4	0.23529411764705882	0.045454545454545456	REAC:R-HSA-73884	REAC	Base Excision Repair	10916	205		0.9428571428571428	0.9444444444444444	88	10828	4	13	84	10815	10916	0.10035748209352402
R1	cpdb	0	network_modules	264	TRUE	0.006751749720091856	109	17	4	0.23529411764705882	0.03669724770642202	REAC:R-HSA-5696398	REAC	Nucleotide Excision Repair	10916	1622		0.9714285714285714	0.9722222222222222	109	10807	4	13	105	10794	10916	0.08949668375081762
R1	cpdb	0	network_modules	264	TRUE	0.007254558418610976	111	17	4	0.23529411764705882	0.036036036036036036	REAC:R-HSA-157579	REAC	Telomere Maintenance	10916	2489		1	1	111	10805	4	13	107	10792	10916	0.08862282467038574
R1	cpdb	0	network_modules	265	TRUE	7.391984308645003e-25	37	30	13	0.43333333333333335	0.35135135135135137	GO:0016233	GO:BP	telomere capping	16175	5178		0	0.02	37	16138	13	17	24	16121	16175	0.38894092727783197
R1	cpdb	0	network_modules	265	TRUE	3.4437493107393487e-22	37	30	12	0.4	0.32432432432432434	GO:0032205	GO:BP	negative regulation of telomere maintenance	16175	7397		0.02040816326530612	0.04	37	16138	12	18	25	16120	16175	0.35886362228551044
R1	cpdb	0	network_modules	265	TRUE	1.0958866157792608e-20	13	21	9	0.42857142857142855	0.6923076923076923	REAC:R-HSA-174430	REAC	Telomere C-strand synthesis initiation	10916	2487		0	0.038461538461538464	13	10903	9	12	4	10891	10916	0.5440384493660381
R1	cpdb	0	network_modules	265	TRUE	1.2400937024529887e-19	84	30	13	0.43333333333333335	0.15476190476190477	GO:0010833	GO:BP	telomere maintenance via telomere lengthening	16175	4443		0.04081632653061224	0.06	84	16091	13	17	71	16074	16175	0.25676786629093523
R1	cpdb	0	network_modules	265	TRUE	2.2980559560716777e-18	71	30	12	0.4	0.16901408450704225	GO:0007004	GO:BP	telomere maintenance via telomerase	16175	2616		0.061224489795918366	0.1	71	16104	12	18	59	16086	16175	0.2579631417227007
R1	cpdb	0	network_modules	265	TRUE	2.2980559560716777e-18	71	30	12	0.4	0.16901408450704225	GO:0006278	GO:BP	RNA-templated DNA biosynthetic process	16175	2093		0.061224489795918366	0.1	71	16104	12	18	59	16086	16175	0.2579631417227007
R1	cpdb	0	network_modules	265	TRUE	3.8528763830989964e-18	30	30	10	0.3333333333333333	0.3333333333333333	GO:1904357	GO:BP	negative regulation of telomere maintenance via telomere lengthening	16175	23744		0.10204081632653061	0.12	30	16145	10	20	20	16125	16175	0.33209455971921137
R1	cpdb	0	network_modules	265	TRUE	4.274477596908693e-18	152	30	14	0.4666666666666667	0.09210526315789473	GO:0000723	GO:BP	telomere maintenance	16175	202		0.12244897959183673	0.14	152	16023	14	16	138	16007	16175	0.20429811888876429
R1	cpdb	0	network_modules	265	TRUE	1.6753416685096657e-17	120	30	13	0.43333333333333335	0.10833333333333334	GO:0051053	GO:BP	negative regulation of DNA metabolic process	16175	13463		0.14285714285714285	0.16	120	16055	13	17	107	16038	16175	0.2139501110743305
R1	cpdb	0	network_modules	265	TRUE	4.727698174427274e-17	26	21	9	0.42857142857142855	0.34615384615384615	REAC:R-HSA-174411	REAC	Polymerase switching on the C-strand of the telomere	10916	1770		0.04	0.07692307692307693	26	10890	9	12	17	10878	10916	0.3838502207810598
R1	cpdb	0	network_modules	265	TRUE	4.82091348639308e-17	90	30	12	0.4	0.13333333333333333	GO:2001251	GO:BP	negative regulation of chromosome organization	16175	26440		0.16326530612244897	0.18	90	16085	12	18	78	16067	16175	0.2285759292743918
R1	cpdb	0	network_modules	265	TRUE	5.744693845004207e-17	182	30	14	0.4666666666666667	0.07692307692307693	GO:0032200	GO:BP	telomere organization	16175	7392		0.1836734693877551	0.2	182	15993	14	16	168	15977	16175	0.18611968432249706
R1	cpdb	0	network_modules	265	TRUE	2.998846335177967e-16	104	30	12	0.4	0.11538461538461539	GO:0032204	GO:BP	regulation of telomere maintenance	16175	7396		0.20408163265306123	0.22	104	16071	12	18	92	16053	16175	0.2122609564202791
R1	cpdb	0	network_modules	265	TRUE	7.873557387686328e-16	34	21	9	0.42857142857142855	0.2647058823529412	REAC:R-HSA-174417	REAC	Telomere C-strand (Lagging Strand) Synthesis	10916	2486		0.08	0.11538461538461539	34	10882	9	12	25	10870	10916	0.3352132218755425
R1	cpdb	0	network_modules	265	TRUE	2.9869000503483334e-15	54	30	10	0.3333333333333333	0.18518518518518517	GO:0032210	GO:BP	regulation of telomere maintenance via telomerase	16175	7402		0.22448979591836735	0.24	54	16121	10	20	44	16101	16175	0.24660403747207346
R1	cpdb	0	network_modules	265	TRUE	1.2181537217251893e-14	140	30	12	0.4	0.08571428571428572	GO:0071897	GO:BP	DNA biosynthetic process	16175	16970		0.24489795918367346	0.26	140	16035	12	18	128	16017	16175	0.18211545898918713
R1	cpdb	0	network_modules	265	TRUE	1.5790863699284775e-14	63	30	10	0.3333333333333333	0.15873015873015872	GO:1904356	GO:BP	regulation of telomere maintenance via telomere lengthening	16175	23743		0.2653061224489796	0.28	63	16112	10	20	53	16092	16175	0.22798966228242226
R1	cpdb	0	network_modules	265	TRUE	2.3327005474363226e-14	22	30	8	0.26666666666666666	0.36363636363636365	GO:0032211	GO:BP	negative regulation of telomere maintenance via telomerase	16175	7403		0.2857142857142857	0.3	22	16153	8	22	14	16131	16175	0.31031010324423974
R1	cpdb	0	network_modules	265	TRUE	4.490420015856746e-14	51	21	9	0.42857142857142855	0.17647058823529413	REAC:R-HSA-180786	REAC	Extension of Telomeres	10916	887		0.12	0.15384615384615385	51	10865	9	12	42	10853	10916	0.2729118496005526
R1	cpdb	0	network_modules	265	TRUE	9.2874876888225e-14	229	30	13	0.43333333333333335	0.056768558951965066	GO:0033044	GO:BP	regulation of chromosome organization	16175	7999		0.30612244897959184	0.32	229	15946	13	17	216	15929	16175	0.15294608025501655
R1	cpdb	0	network_modules	265	TRUE	1.6097521707501089e-13	27	30	8	0.26666666666666666	0.2962962962962963	GO:2000279	GO:BP	negative regulation of DNA biosynthetic process	16175	25604		0.32653061224489793	0.34	27	16148	8	22	19	16126	16175	0.27982485786445094
R1	cpdb	0	network_modules	265	TRUE	3.0719958180287513e-13	545	30	16	0.5333333333333333	0.029357798165137616	GO:0051276	GO:BP	chromosome organization	16175	13613		0.3469387755102041	0.36	545	15630	16	14	529	15616	16175	0.11936164522106296
R1	cpdb	0	network_modules	265	TRUE	3.771372573611212e-13	85	30	10	0.3333333333333333	0.11764705882352941	GO:2000278	GO:BP	regulation of DNA biosynthetic process	16175	25603		0.3673469387755102	0.38	85	16090	10	20	75	16070	16175	0.1956031869579269
R1	cpdb	0	network_modules	265	TRUE	5.692380018435973e-13	31	30	8	0.26666666666666666	0.25806451612903225	GO:0070198	GO:BP	protein localization to chromosome, telomeric region	16175	15981		0.3877551020408163	0.4	31	16144	8	22	23	16122	16175	0.2609369914322863
R1	cpdb	0	network_modules	265	TRUE	1.6633944189317919e-12	98	30	10	0.3333333333333333	0.10204081632653061	GO:2001252	GO:BP	positive regulation of chromosome organization	16175	26441		0.40816326530612246	0.42	98	16077	10	20	88	16057	16175	0.18179529953076123
R1	cpdb	0	network_modules	265	TRUE	3.739706455516867e-12	304	30	13	0.43333333333333335	0.04276315789473684	GO:0010639	GO:BP	negative regulation of organelle organization	16175	4285		0.42857142857142855	0.44	304	15871	13	17	291	15854	16175	0.1315867747787275
R1	cpdb	0	network_modules	265	TRUE	5.333621324041614e-12	69	30	9	0.3	0.13043478260869565	GO:0032206	GO:BP	positive regulation of telomere maintenance	16175	7398		0.4489795918367347	0.46	69	16106	9	21	60	16085	16175	0.1956000620557054
R1	cpdb	0	network_modules	265	TRUE	1.1689777767212063e-11	246	30	12	0.4	0.04878048780487805	GO:0051054	GO:BP	positive regulation of DNA metabolic process	16175	13464		0.46938775510204084	0.48	246	15929	12	18	234	15911	16175	0.13553434989618637
R1	cpdb	0	network_modules	265	TRUE	7.025621661575865e-11	111	21	9	0.42857142857142855	0.08108108108108109	REAC:R-HSA-157579	REAC	Telomere Maintenance	10916	2489		0.16	0.19230769230769232	111	10805	9	12	102	10793	10916	0.18309662351719494
R1	cpdb	0	network_modules	265	TRUE	8.939608467552445e-11	17	21	6	0.2857142857142857	0.35294117647058826	REAC:R-HSA-174437	REAC	Removal of the Flap Intermediate from the C-strand	10916	2059		0.2	0.23076923076923078	17	10899	6	15	11	10884	10916	0.3163734536434215
R1	cpdb	0	network_modules	265	TRUE	1.9552177814303795e-10	19	21	6	0.2857142857142857	0.3157894736842105	REAC:R-HSA-174414	REAC	Processive synthesis on the C-strand of the telomere	10916	1801		0.24	0.2692307692307692	19	10897	6	15	13	10882	10916	0.29909381614420805
R1	cpdb	0	network_modules	265	TRUE	3.7458100474453607e-10	435	30	13	0.43333333333333335	0.029885057471264367	GO:0051052	GO:BP	regulation of DNA metabolic process	16175	13462		0.4897959183673469	0.5	435	15740	13	17	422	15723	16175	0.10830171158468646
R1	cpdb	0	network_modules	265	TRUE	5.186464235722062e-10	138	21	9	0.42857142857142855	0.06521739130434782	REAC:R-HSA-73886	REAC	Chromosome Maintenance	10916	357		0.28	0.3076923076923077	138	10778	9	12	129	10766	10916	0.16344460147887183
R1	cpdb	0	network_modules	265	TRUE	7.240301802035003e-10	23	21	6	0.2857142857142857	0.2608695652173913	REAC:R-HSA-171319	REAC	Telomere Extension By Telomerase	10916	2488		0.32	0.34615384615384615	23	10893	6	15	17	10878	10916	0.2715434130439799
R1	cpdb	0	network_modules	265	TRUE	6.699751596058825e-9	420	30	12	0.4	0.02857142857142857	GO:0010638	GO:BP	positive regulation of organelle organization	16175	4284		0.5102040816326531	0.52	420	15755	12	18	408	15737	16175	0.10138253082749998
R1	cpdb	0	network_modules	265	TRUE	1.5222836127412877e-8	583	30	13	0.43333333333333335	0.022298456260720412	GO:0051129	GO:BP	negative regulation of cellular component organization	16175	13513		0.5306122448979592	0.54	583	15592	13	17	570	15575	16175	0.09187733664570316
R1	cpdb	0	network_modules	265	TRUE	2.6892957191511877e-8	79	21	7	0.3333333333333333	0.08860759493670886	REAC:R-HSA-2559586	REAC	DNA Damage/Telomere Stress Induced Senescence	10916	441		0.36	0.38461538461538464	79	10837	7	14	72	10823	10916	0.16890296737090962
R1	cpdb	0	network_modules	265	TRUE	4.489684573067793e-8	329	21	10	0.47619047619047616	0.030395136778115502	REAC:R-HSA-73894	REAC	DNA Repair	10916	444		0.4	0.4230769230769231	329	10587	10	11	319	10576	10916	0.11454071607416735
R1	cpdb	0	network_modules	265	TRUE	4.749650802357563e-8	118	30	8	0.26666666666666666	0.06779661016949153	GO:0034502	GO:BP	protein localization to chromosome	16175	8668		0.5510204081632653	0.56	118	16057	8	22	110	16035	16175	0.1313816972650125
R1	cpdb	0	network_modules	265	TRUE	1.2496852773627134e-7	51	21	6	0.2857142857142857	0.11764705882352941	REAC:R-HSA-171306	REAC	Packaging Of Telomere Ends	10916	1712		0.44	0.46153846153846156	51	10865	6	15	45	10850	10916	0.18093859313302668
R1	cpdb	0	network_modules	265	TRUE	1.785814944100672e-7	54	21	6	0.2857142857142857	0.1111111111111111	REAC:R-HSA-73927	REAC	Depurination	10916	731		0.48	0.5769230769230769	54	10862	6	15	48	10847	10916	0.17569301158081765
R1	cpdb	0	network_modules	265	TRUE	1.785814944100672e-7	54	21	6	0.2857142857142857	0.1111111111111111	REAC:R-HSA-110330	REAC	Recognition and association of DNA glycosylase with site containing an affected purine	10916	1946		0.48	0.5769230769230769	54	10862	6	15	48	10847	10916	0.17569301158081765
R1	cpdb	0	network_modules	265	TRUE	1.785814944100672e-7	54	21	6	0.2857142857142857	0.1111111111111111	REAC:R-HSA-110331	REAC	Cleavage of the damaged purine	10916	373		0.48	0.5769230769230769	54	10862	6	15	48	10847	10916	0.17569301158081765
R1	cpdb	0	network_modules	265	TRUE	3.097126260182579e-7	59	21	6	0.2857142857142857	0.1016949152542373	REAC:R-HSA-110329	REAC	Cleavage of the damaged pyrimidine 	10916	374		0.6	0.6923076923076923	59	10857	6	15	53	10842	10916	0.16784803300683104
R1	cpdb	0	network_modules	265	TRUE	3.097126260182579e-7	59	21	6	0.2857142857142857	0.1016949152542373	REAC:R-HSA-110328	REAC	Recognition and association of DNA glycosylase with site containing an affected pyrimidine	10916	1947		0.6	0.6923076923076923	59	10857	6	15	53	10842	10916	0.16784803300683104
R1	cpdb	0	network_modules	265	TRUE	3.097126260182579e-7	59	21	6	0.2857142857142857	0.1016949152542373	REAC:R-HSA-73928	REAC	Depyrimidination	10916	732		0.6	0.6923076923076923	59	10857	6	15	53	10842	10916	0.16784803300683104
R1	cpdb	0	network_modules	265	TRUE	3.4371840407477204e-7	60	21	6	0.2857142857142857	0.1	REAC:R-HSA-73929	REAC	Base-Excision Repair, AP Site Formation	10916	206		0.72	0.7307692307692307	60	10856	6	15	54	10841	10916	0.16639668973072091
R1	cpdb	0	network_modules	265	TRUE	4.1486958186137303e-7	116	21	7	0.3333333333333333	0.0603448275862069	REAC:R-HSA-1500620	REAC	Meiosis	10916	1410		0.76	0.7692307692307693	116	10800	7	14	109	10786	10916	0.13817412008504004
R1	cpdb	0	network_modules	265	TRUE	4.92841441756651e-7	7	30	4	0.13333333333333333	0.5714285714285714	GO:0031848	GO:BP	protection from non-homologous end joining at telomere	16175	7275		0.5714285714285714	0.58	7	16168	4	26	3	16142	16175	0.2754454194619186
R1	cpdb	0	network_modules	265	TRUE	6.193883258303689e-7	66	21	6	0.2857142857142857	0.09090909090909091	REAC:R-HSA-9670095	REAC	Inhibition of DNA recombination at telomere	10916	1189		0.8	0.8076923076923077	66	10850	6	15	60	10835	10916	0.15838559315107711
R1	cpdb	0	network_modules	265	TRUE	1.4728026087968446e-6	76	21	6	0.2857142857142857	0.07894736842105263	REAC:R-HSA-1221632	REAC	Meiotic synapsis	10916	1412		0.84	0.8461538461538461	76	10840	6	15	70	10825	10916	0.1471824934943838
R1	cpdb	0	network_modules	265	TRUE	3.0249459355043343e-6	154	21	7	0.3333333333333333	0.045454545454545456	REAC:R-HSA-1474165	REAC	Reproduction	10916	2064		0.88	0.8846153846153846	154	10762	7	14	147	10748	10916	0.11883665445549058
R1	cpdb	0	network_modules	265	TRUE	3.5993982694820814e-6	88	21	6	0.2857142857142857	0.06818181818181818	REAC:R-HSA-73884	REAC	Base Excision Repair	10916	205		0.92	0.9230769230769231	88	10828	6	15	82	10813	10916	0.13631574993548906
R1	cpdb	0	network_modules	265	TRUE	1.4979142758706923e-5	194	21	7	0.3333333333333333	0.03608247422680412	REAC:R-HSA-2559583	REAC	Cellular Senescence	10916	331		0.96	0.9615384615384616	194	10722	7	14	187	10708	10916	0.1048586992683928
R1	cpdb	0	network_modules	265	TRUE	3.382454000523105e-5	4	30	3	0.1	0.75	GO:0032202	GO:BP	telomere assembly	16175	7394		0.5918367346938775	0.6	4	16171	3	27	1	16144	16175	0.2734715412069573
R1	cpdb	0	network_modules	265	TRUE	1.7404777125062888e-4	25	30	4	0.13333333333333333	0.16	GO:1904353	GO:BP	regulation of telomere capping	16175	23740		0.6122448979591837	0.62	25	16150	4	26	21	16124	16175	0.14461209876556172
R1	cpdb	0	network_modules	265	TRUE	3.251053170392964e-4	29	30	4	0.13333333333333333	0.13793103448275862	GO:0043247	GO:BP	telomere maintenance in response to DNA damage	16175	10583		0.6326530612244898	0.64	29	16146	4	26	25	16120	16175	0.13403361139905964
R1	cpdb	0	network_modules	265	TRUE	5.572397053243059e-4	33	30	4	0.13333333333333333	0.12121212121212122	GO:0032212	GO:BP	positive regulation of telomere maintenance via telomerase	16175	7404		0.6530612244897959	0.66	33	16142	4	26	29	16116	16175	0.1254273687512172
R1	cpdb	0	network_modules	265	TRUE	7.05879759773734e-4	9	30	3	0.1	0.3333333333333333	GO:0061820	GO:BP	telomeric D-loop disassembly	16175	15679		0.673469387755102	0.68	9	16166	3	27	6	16139	16175	0.1817774998860541
R1	cpdb	0	network_modules	265	TRUE	7.990644282809254e-4	36	30	4	0.13333333333333333	0.1111111111111111	GO:1904358	GO:BP	positive regulation of telomere maintenance via telomere lengthening	16175	23745		0.6938775510204082	0.7	36	16139	4	26	32	16113	16175	0.11992906603298022
R1	cpdb	0	network_modules	265	TRUE	0.0011155137831363822	2	21	2	0.09523809523809523	1	REAC:R-HSA-5545619	REAC	XAV939 stabilizes AXIN	10916	2675		1	1	2	10914	2	19	0	10895	10916	0.3083379587911699
R1	cpdb	0	network_modules	265	TRUE	0.001383080098492013	11	30	3	0.1	0.2727272727272727	GO:0090657	GO:BP	telomeric loop disassembly	16175	18391		0.7142857142857143	0.72	11	16164	3	27	8	16137	16175	0.16422965067086123
R1	cpdb	0	network_modules	265	TRUE	0.0016233014647364032	808	30	10	0.3333333333333333	0.012376237623762377	GO:0033365	GO:BP	protein localization to organelle	16175	8175		0.7346938775510204	0.74	808	15367	10	20	798	15347	16175	0.056073078991856914
R1	cpdb	0	network_modules	265	TRUE	0.003373072887493408	13	8	2	0.25	0.15384615384615385	KEGG:03450	KEGG	Non-homologous end-joining	8484	241		NA	1	13	8471	2	6	11	8465	8484	0.19515564093443705
R1	cpdb	0	network_modules	265	TRUE	0.0035976206371141437	52	30	4	0.13333333333333333	0.07692307692307693	GO:2000573	GO:BP	positive regulation of DNA biosynthetic process	16175	25874		0.7551020408163265	0.76	52	16123	4	26	48	16097	16175	0.09908326902742759
R1	cpdb	0	network_modules	265	TRUE	0.0048904476213216894	2	30	2	0.06666666666666667	1	GO:1905839	GO:BP	negative regulation of telomeric D-loop disassembly	16175	24949		0.7755102040816326	0.96	2	16173	2	28	0	16145	16175	0.2579752855695965
R1	cpdb	0	network_modules	265	TRUE	0.0048904476213216894	2	30	2	0.06666666666666667	1	GO:1905838	GO:BP	regulation of telomeric D-loop disassembly	16175	24948		0.7755102040816326	0.96	2	16173	2	28	0	16145	16175	0.2579752855695965
R1	cpdb	0	network_modules	265	TRUE	0.0048904476213216894	2	30	2	0.06666666666666667	1	GO:1905778	GO:BP	negative regulation of exonuclease activity	16175	24889		0.7755102040816326	0.96	2	16173	2	28	0	16145	16175	0.2579752855695965
R1	cpdb	0	network_modules	265	TRUE	0.0048904476213216894	2	30	2	0.06666666666666667	1	GO:1905777	GO:BP	regulation of exonuclease activity	16175	24888		0.7755102040816326	0.96	2	16173	2	28	0	16145	16175	0.2579752855695965
R1	cpdb	0	network_modules	265	TRUE	0.0048904476213216894	2	30	2	0.06666666666666667	1	GO:1904534	GO:BP	negative regulation of telomeric loop disassembly	16175	23893		0.7755102040816326	0.96	2	16173	2	28	0	16145	16175	0.2579752855695965
R1	cpdb	0	network_modules	265	TRUE	0.0048904476213216894	2	30	2	0.06666666666666667	1	GO:0072695	GO:BP	regulation of DNA recombination at telomere	16175	17506		0.7755102040816326	0.96	2	16173	2	28	0	16145	16175	0.2579752855695965
R1	cpdb	0	network_modules	265	TRUE	0.0048904476213216894	2	30	2	0.06666666666666667	1	GO:0048239	GO:BP	negative regulation of DNA recombination at telomere	16175	12598		0.7755102040816326	0.96	2	16173	2	28	0	16145	16175	0.2579752855695965
R1	cpdb	0	network_modules	265	TRUE	0.0048904476213216894	2	30	2	0.06666666666666667	1	GO:0032214	GO:BP	negative regulation of telomere maintenance via semi-conservative replication	16175	7406		0.7755102040816326	0.96	2	16173	2	28	0	16145	16175	0.2579752855695965
R1	cpdb	0	network_modules	265	TRUE	0.0048904476213216894	2	30	2	0.06666666666666667	1	GO:0032213	GO:BP	regulation of telomere maintenance via semi-conservative replication	16175	7405		0.7755102040816326	0.96	2	16173	2	28	0	16145	16175	0.2579752855695965
R1	cpdb	0	network_modules	265	TRUE	0.0048904476213216894	2	30	2	0.06666666666666667	1	GO:0031627	GO:BP	telomeric loop formation	16175	7241		0.7755102040816326	0.96	2	16173	2	28	0	16145	16175	0.2579752855695965
R1	cpdb	0	network_modules	265	TRUE	0.005657291870448967	17	30	3	0.1	0.17647058823529413	GO:0070200	GO:BP	establishment of protein localization to telomere	16175	15983		0.9795918367346939	0.98	17	16158	3	27	14	16131	16175	0.13163731595409278
R1	cpdb	0	network_modules	265	TRUE	0.007318324051961092	62	30	4	0.13333333333333333	0.06451612903225806	GO:0006303	GO:BP	double-strand break repair via nonhomologous end joining	16175	2110		1	1	62	16113	4	26	58	16087	16175	0.09033841697598959
R1	cpdb	0	network_modules	266	TRUE	2.385801577091393e-22	590	57	28	0.49122807017543857	0.04745762711864407	GO:0016071	GO:BP	mRNA metabolic process	16175	5098		0	0.020833333333333332	590	15585	28	29	562	15556	16175	0.14425184474790353
R1	cpdb	0	network_modules	266	TRUE	3.3524023170164493e-22	352	57	24	0.42105263157894735	0.06818181818181818	GO:0006397	GO:BP	mRNA processing	16175	2158		0.02127659574468085	0.041666666666666664	352	15823	24	33	328	15790	16175	0.1627419591233732
R1	cpdb	0	network_modules	266	TRUE	6.032003675252982e-21	397	57	24	0.42105263157894735	0.060453400503778336	GO:0008380	GO:BP	RNA splicing	16175	3186		0.0425531914893617	0.0625	397	15778	24	33	373	15745	16175	0.15239036313098037
R1	cpdb	0	network_modules	266	TRUE	4.863293932763246e-18	287	57	20	0.3508771929824561	0.06968641114982578	GO:0000398	GO:BP	mRNA splicing, via spliceosome	16175	121		0.06382978723404255	0.10416666666666667	287	15888	20	37	267	15851	16175	0.15006148034941005
R1	cpdb	0	network_modules	266	TRUE	4.863293932763246e-18	287	57	20	0.3508771929824561	0.06968641114982578	GO:0000377	GO:BP	RNA splicing, via transesterification reactions with bulged adenosine as nucleophile	16175	109		0.06382978723404255	0.10416666666666667	287	15888	20	37	267	15851	16175	0.15006148034941005
R1	cpdb	0	network_modules	266	TRUE	6.4186333819958515e-18	291	57	20	0.3508771929824561	0.06872852233676977	GO:0000375	GO:BP	RNA splicing, via transesterification reactions	16175	107		0.10638297872340426	0.125	291	15884	20	37	271	15847	16175	0.14893468359432888
R1	cpdb	0	network_modules	266	TRUE	5.867198573744497e-17	273	57	19	0.3333333333333333	0.0695970695970696	GO:1903311	GO:BP	regulation of mRNA metabolic process	16175	22895		0.1276595744680851	0.14583333333333334	273	15902	19	38	254	15864	16175	0.14609370488092563
R1	cpdb	0	network_modules	266	TRUE	1.806206943215753e-16	202	36	16	0.4444444444444444	0.07920792079207921	REAC:R-HSA-72163	REAC	mRNA Splicing - Major Pathway	10916	2707		0	0.25	202	10714	16	20	186	10694	10916	0.18180119695764546
R1	cpdb	0	network_modules	266	TRUE	3.142333612837198e-16	209	36	16	0.4444444444444444	0.07655502392344497	REAC:R-HSA-72172	REAC	mRNA Splicing	10916	2706		0.3333333333333333	0.5	209	10707	16	20	193	10687	10916	0.1785199957280806
R1	cpdb	0	network_modules	266	TRUE	7.935246400416648e-16	276	36	17	0.4722222222222222	0.06159420289855073	REAC:R-HSA-72203	REAC	Processing of Capped Intron-Containing Pre-mRNA	10916	1796		0.6666666666666666	0.75	276	10640	17	19	259	10621	10916	0.16376552608443437
R1	cpdb	0	network_modules	266	TRUE	2.2699891232012017e-15	84	57	13	0.22807017543859648	0.15476190476190477	GO:1903312	GO:BP	negative regulation of mRNA metabolic process	16175	22896		0.14893617021276595	0.16666666666666666	84	16091	13	44	71	16047	16175	0.1843996904711556
R1	cpdb	0	network_modules	266	TRUE	3.877233949497083e-14	175	57	15	0.2631578947368421	0.08571428571428572	GO:0043484	GO:BP	regulation of RNA splicing	16175	10730		0.1702127659574468	0.1875	175	16000	15	42	160	15958	16175	0.14505444363932068
R1	cpdb	0	network_modules	266	TRUE	6.083933638243476e-13	67	57	11	0.19298245614035087	0.16417910447761194	GO:1902373	GO:BP	negative regulation of mRNA catabolic process	16175	22245		0.19148936170212766	0.20833333333333334	67	16108	11	46	56	16062	16175	0.17484874625076452
R1	cpdb	0	network_modules	266	TRUE	3.0815936190718357e-12	77	57	11	0.19298245614035087	0.14285714285714285	GO:1902369	GO:BP	negative regulation of RNA catabolic process	16175	22241		0.2127659574468085	0.22916666666666666	77	16098	11	46	66	16052	16175	0.16261674173442225
R1	cpdb	0	network_modules	266	TRUE	8.661923308693973e-12	58	57	10	0.17543859649122806	0.1724137931034483	GO:0048255	GO:BP	mRNA stabilization	16175	12610		0.23404255319148937	0.25	58	16117	10	47	48	16070	16175	0.17097267025427934
R1	cpdb	0	network_modules	266	TRUE	1.3816733764556423e-11	174	23	11	0.4782608695652174	0.06321839080459771	KEGG:03040	KEGG	Spliceosome	8484	215		0	0.5	174	8310	11	12	163	8298	8484	0.16838699131959703
R1	cpdb	0	network_modules	266	TRUE	4.019697775511392e-11	67	57	10	0.17543859649122806	0.14925373134328357	GO:0043489	GO:BP	RNA stabilization	16175	10734		0.2553191489361702	0.2708333333333333	67	16108	10	47	57	16061	16175	0.158604742766645
R1	cpdb	0	network_modules	266	TRUE	4.355551143053278e-10	119	57	11	0.19298245614035087	0.09243697478991597	GO:0050684	GO:BP	regulation of mRNA processing	16175	13215		0.2765957446808511	0.2916666666666667	119	16056	11	46	108	16010	16175	0.12917290866049916
R1	cpdb	0	network_modules	266	TRUE	9.753726436483044e-10	172	57	12	0.21052631578947367	0.06976744186046512	GO:0061013	GO:BP	regulation of mRNA catabolic process	16175	15136		0.2978723404255319	0.3125	172	16003	12	45	160	15958	16175	0.11589320668880591
R1	cpdb	0	network_modules	266	TRUE	9.787910261433299e-10	11	57	6	0.10526315789473684	0.5454545454545454	GO:0070934	GO:BP	CRD-mediated mRNA stabilization	16175	16378		0.3191489361702128	0.3333333333333333	11	16164	6	51	5	16113	16175	0.23857057236901183
R1	cpdb	0	network_modules	266	TRUE	1.9522896255113237e-9	12	57	6	0.10526315789473684	0.5	GO:1900152	GO:BP	negative regulation of nuclear-transcribed mRNA catabolic process, deadenylation-dependent decay	16175	20436		0.3404255319148936	0.3541666666666667	12	16163	6	51	6	16112	16175	0.2282859689485638
R1	cpdb	0	network_modules	266	TRUE	8.71867476000625e-9	156	57	11	0.19298245614035087	0.07051282051282051	GO:0043488	GO:BP	regulation of mRNA stability	16175	10733		0.3617021276595745	0.375	156	16019	11	46	145	15973	16175	0.11155742879511414
R1	cpdb	0	network_modules	266	TRUE	1.048936483110502e-8	15	57	6	0.10526315789473684	0.4	GO:2000767	GO:BP	positive regulation of cytoplasmic translation	16175	26027		0.3829787234042553	0.3958333333333333	15	16160	6	51	9	16109	16175	0.20384177278406168
R1	cpdb	0	network_modules	266	TRUE	1.8363534465056947e-8	167	57	11	0.19298245614035087	0.0658682634730539	GO:0043487	GO:BP	regulation of RNA stability	16175	10732		0.40425531914893614	0.4166666666666667	167	16008	11	46	156	15962	16175	0.10745776008316749
R1	cpdb	0	network_modules	266	TRUE	2.4646821407267015e-8	125	57	10	0.17543859649122806	0.08	GO:1903313	GO:BP	positive regulation of mRNA metabolic process	16175	22897		0.425531914893617	0.4375	125	16050	10	47	115	16003	16175	0.1138922530057596
R1	cpdb	0	network_modules	266	TRUE	2.4703894469679458e-8	226	57	12	0.21052631578947367	0.05309734513274336	GO:0006402	GO:BP	mRNA catabolic process	16175	2163		0.44680851063829785	0.4583333333333333	226	15949	12	45	214	15904	16175	0.0995834988064349
R1	cpdb	0	network_modules	266	TRUE	1.1651018835257328e-7	67	57	8	0.14035087719298245	0.11940298507462686	GO:0000380	GO:BP	alternative mRNA splicing, via spliceosome	16175	112		0.46808510638297873	0.4791666666666667	67	16108	8	49	59	16059	16175	0.1261167357984059
R1	cpdb	0	network_modules	266	TRUE	2.8559456374104857e-7	279	57	12	0.21052631578947367	0.043010752688172046	GO:0006401	GO:BP	RNA catabolic process	16175	2162		0.48936170212765956	0.5	279	15896	12	45	267	15851	16175	0.08827980314181276
R1	cpdb	0	network_modules	266	TRUE	4.4550051554158665e-7	290	57	12	0.21052631578947367	0.041379310344827586	GO:0009895	GO:BP	negative regulation of catabolic process	16175	3755		0.5106382978723404	0.5208333333333334	290	15885	12	45	278	15840	16175	0.08631454441897407
R1	cpdb	0	network_modules	266	TRUE	4.6835410778755176e-7	26	57	6	0.10526315789473684	0.23076923076923078	GO:1900151	GO:BP	regulation of nuclear-transcribed mRNA catabolic process, deadenylation-dependent decay	16175	20435		0.5319148936170213	0.5416666666666666	26	16149	6	51	20	16098	16175	0.153872143100922
R1	cpdb	0	network_modules	266	TRUE	6.324194669906349e-7	299	57	12	0.21052631578947367	0.04013377926421405	GO:0141188	GO:BP	nucleic acid catabolic process	16175	20075		0.5531914893617021	0.5625	299	15876	12	45	287	15831	16175	0.08478401100817648
R1	cpdb	0	network_modules	266	TRUE	2.210818828383432e-6	33	57	6	0.10526315789473684	0.18181818181818182	GO:2000765	GO:BP	regulation of cytoplasmic translation	16175	26025		0.574468085106383	0.5833333333333334	33	16142	6	51	27	16091	16175	0.13604007445560387
R1	cpdb	0	network_modules	266	TRUE	2.58520013958562e-6	98	57	8	0.14035087719298245	0.08163265306122448	GO:0048024	GO:BP	regulation of mRNA splicing, via spliceosome	16175	12475		0.5957446808510638	0.6041666666666666	98	16077	8	49	90	16028	16175	0.10291085990090264
R1	cpdb	0	network_modules	266	TRUE	3.845051337423894e-6	434	57	13	0.22807017543859648	0.029953917050691243	GO:0010608	GO:BP	post-transcriptional regulation of gene expression	16175	4255		0.6170212765957447	0.625	434	15741	13	44	421	15697	16175	0.07405877127821035
R1	cpdb	0	network_modules	266	TRUE	8.072416123526399e-6	113	57	8	0.14035087719298245	0.07079646017699115	GO:0000956	GO:BP	nuclear-transcribed mRNA catabolic process	16175	264		0.6382978723404256	0.6458333333333334	113	16062	8	49	105	16013	16175	0.09522002395537481
R1	cpdb	0	network_modules	266	TRUE	4.712727589819461e-5	92	57	7	0.12280701754385964	0.07608695652173914	GO:0061157	GO:BP	mRNA destabilization	16175	15262		0.6595744680851063	0.6666666666666666	92	16083	7	50	85	16033	16175	0.09261405440375584
R1	cpdb	0	network_modules	266	TRUE	4.870479702114733e-5	54	57	6	0.10526315789473684	0.1111111111111111	GO:0000381	GO:BP	regulation of alternative mRNA splicing, via spliceosome	16175	113		0.6808510638297872	0.6875	54	16121	6	51	48	16070	16175	0.1050781934406696
R1	cpdb	0	network_modules	266	TRUE	5.8962077124238544e-5	95	57	7	0.12280701754385964	0.07368421052631578	GO:0050779	GO:BP	RNA destabilization	16175	13253		0.7021276595744681	0.7083333333333334	95	16080	7	50	88	16030	16175	0.09100415419678777
R1	cpdb	0	network_modules	266	TRUE	5.9137149667899256e-5	448	57	12	0.21052631578947367	0.026785714285714284	GO:0034655	GO:BP	nucleobase-containing compound catabolic process	16175	8711		0.723404255319149	0.7291666666666666	448	15727	12	45	436	15682	16175	0.06625365997782506
R1	cpdb	0	network_modules	266	TRUE	6.787883763876407e-5	57	57	6	0.10526315789473684	0.10526315789473684	GO:0000288	GO:BP	nuclear-transcribed mRNA catabolic process, deadenylation-dependent decay	16175	81		0.7446808510638298	0.75	57	16118	6	51	51	16067	16175	0.10209899360636361
R1	cpdb	0	network_modules	266	TRUE	6.817536010699608e-5	97	57	7	0.12280701754385964	0.07216494845360824	GO:0061014	GO:BP	positive regulation of mRNA catabolic process	16175	15137		0.7659574468085106	0.7708333333333334	97	16078	7	50	90	16028	16175	0.08997144391748511
R1	cpdb	0	network_modules	266	TRUE	7.122613169458215e-5	149	57	8	0.14035087719298245	0.053691275167785234	GO:0006403	GO:BP	RNA localization	16175	2164		0.7872340425531915	0.7916666666666666	149	16026	8	49	141	15977	16175	0.08163055296631609
R1	cpdb	0	network_modules	266	TRUE	3.9459198090362164e-4	25	36	4	0.1111111111111111	0.16	REAC:R-HSA-6803529	REAC	FGFR2 alternative splicing	10916	905		1	1	25	10891	4	32	21	10859	10916	0.13095097594214508
R1	cpdb	0	network_modules	266	TRUE	4.946372952774736e-4	545	57	12	0.21052631578947367	0.022018348623853212	GO:0051276	GO:BP	chromosome organization	16175	13613		0.8085106382978723	0.8125	545	15630	12	45	533	15585	16175	0.058278733351678144
R1	cpdb	0	network_modules	266	TRUE	0.0010651182411466524	90	57	6	0.10526315789473684	0.06666666666666667	GO:0006405	GO:BP	RNA export from nucleus	16175	2166		0.8297872340425532	0.8333333333333334	90	16085	6	51	84	16034	16175	0.07970493735651472
R1	cpdb	0	network_modules	266	TRUE	0.0014779177840397088	152	57	7	0.12280701754385964	0.046052631578947366	GO:0051168	GO:BP	nuclear export	16175	13551		0.851063829787234	0.8541666666666666	152	16023	7	50	145	15973	16175	0.06990093971360177
R1	cpdb	0	network_modules	266	TRUE	0.0019169824890381737	158	57	7	0.12280701754385964	0.04430379746835443	GO:0002181	GO:BP	cytoplasmic translation	16175	729		0.8723404255319149	0.875	158	16017	7	50	151	15967	16175	0.06834940950536371
R1	cpdb	0	network_modules	266	TRUE	0.0021143517550538346	7	57	3	0.05263157894736842	0.42857142857142855	GO:2000623	GO:BP	negative regulation of nuclear-transcribed mRNA catabolic process, nonsense-mediated decay	16175	25905		0.8936170212765957	0.8958333333333334	7	16168	3	54	4	16114	16175	0.14924836868783609
R1	cpdb	0	network_modules	266	TRUE	0.0038561843109368703	112	57	6	0.10526315789473684	0.05357142857142857	GO:0031047	GO:BP	regulatory ncRNA-mediated gene silencing	16175	7011		0.9148936170212766	0.9166666666666666	112	16063	6	51	106	16012	16175	0.07052272926907759
R1	cpdb	0	network_modules	266	TRUE	0.004275463315584631	114	57	6	0.10526315789473684	0.05263157894736842	GO:0050657	GO:BP	nucleic acid transport	16175	13197		0.9361702127659575	0.9583333333333334	114	16061	6	51	108	16010	16175	0.06981782681854734
R1	cpdb	0	network_modules	266	TRUE	0.004275463315584631	114	57	6	0.10526315789473684	0.05263157894736842	GO:0050658	GO:BP	RNA transport	16175	13198		0.9361702127659575	0.9583333333333334	114	16061	6	51	108	16010	16175	0.06981782681854734
R1	cpdb	0	network_modules	266	TRUE	0.004973444002405691	117	57	6	0.10526315789473684	0.05128205128205128	GO:0051236	GO:BP	establishment of RNA localization	16175	13586		0.9787234042553191	0.9791666666666666	117	16058	6	51	111	16007	16175	0.06879319513666507
R1	cpdb	0	network_modules	266	TRUE	0.005225719237291932	118	57	6	0.10526315789473684	0.05084745762711865	GO:0045727	GO:BP	positive regulation of translation	16175	11569		1	1	118	16057	6	51	112	16006	16175	0.06846000888853562
R1	cpdb	0	network_modules	266	TRUE	0.007429088058733668	96	23	4	0.17391304347826086	0.041666666666666664	KEGG:03015	KEGG	mRNA surveillance pathway	8484	210		1	1	96	8388	4	19	92	8369	8484	0.08014992197517544
R1	cpdb	0	network_modules	267	TRUE	2.2833255683102797e-17	44	20	10	0.5	0.22727272727272727	REAC:R-HSA-1566948	REAC	Elastic fibre formation	10916	836		0	0.2	44	10872	10	10	34	10862	10916	0.33536569954914286
R1	cpdb	0	network_modules	267	TRUE	7.965695640584339e-14	298	20	13	0.65	0.0436241610738255	REAC:R-HSA-1474244	REAC	Extracellular matrix organization	10916	889		0.25	0.4	298	10618	13	7	285	10611	10916	0.16371737971892245
R1	cpdb	0	network_modules	267	TRUE	7.144708838663996e-11	37	20	7	0.35	0.1891891891891892	REAC:R-HSA-2129379	REAC	Molecules associated with elastic fibres	10916	1490		0.5	0.6	37	10879	7	13	30	10866	10916	0.25550024265538634
R1	cpdb	0	network_modules	267	TRUE	1.4756966507089437e-5	20	21	4	0.19047619047619047	0.2	GO:0048048	GO:BP	embryonic eye morphogenesis	16175	12484		0	0.125	20	16155	4	17	16	16138	16175	0.19415907864427537
R1	cpdb	0	network_modules	267	TRUE	1.850454087737933e-5	236	21	7	0.3333333333333333	0.029661016949152543	GO:0030198	GO:BP	extracellular matrix organization	16175	6707		0.14285714285714285	0.25	236	15939	7	14	229	15925	16175	0.09584465580687529
R1	cpdb	0	network_modules	267	TRUE	1.9053133125775708e-5	237	21	7	0.3333333333333333	0.029535864978902954	GO:0043062	GO:BP	extracellular structure organization	16175	10509		0.2857142857142857	0.375	237	15938	7	14	230	15924	16175	0.09562668706648182
R1	cpdb	0	network_modules	267	TRUE	1.9615480121450153e-5	238	21	7	0.3333333333333333	0.029411764705882353	GO:0045229	GO:BP	external encapsulating structure organization	16175	11340		0.42857142857142855	0.5	238	15937	7	14	231	15923	16175	0.09541005994115133
R1	cpdb	0	network_modules	267	TRUE	6.839585566792891e-4	50	21	4	0.19047619047619047	0.08	GO:0030199	GO:BP	collagen fibril organization	16175	6708		0.5714285714285714	0.625	50	16125	4	17	46	16108	16175	0.12170652360703844
R1	cpdb	0	network_modules	267	TRUE	0.0014248467123260877	18	20	3	0.15	0.16666666666666666	REAC:R-HSA-2243919	REAC	Crosslinking of collagen fibrils	10916	417		0.75	0.8	18	10898	3	17	15	10881	10916	0.1566483883772208
R1	cpdb	0	network_modules	267	TRUE	0.0045798820337962075	80	21	4	0.19047619047619047	0.05	GO:0048592	GO:BP	eye morphogenesis	16175	12861		0.7142857142857143	0.75	80	16095	4	17	76	16078	16175	0.0953538489930183
R1	cpdb	0	network_modules	267	TRUE	0.006116467168286585	89	20	4	0.2	0.0449438202247191	REAC:R-HSA-1474290	REAC	Collagen formation	10916	387		1	1	89	10827	4	16	85	10811	10916	0.09140091303903125
R1	cpdb	0	network_modules	267	TRUE	0.007077170072321803	3	21	2	0.09523809523809523	0.6666666666666666	GO:0048050	GO:BP	post-embryonic eye morphogenesis	16175	12485		0.8571428571428571	1	3	16172	2	19	1	16153	16175	0.25167235521278336
R1	cpdb	0	network_modules	267	TRUE	0.007077170072321803	3	21	2	0.09523809523809523	0.6666666666666666	GO:0018057	GO:BP	peptidyl-lysine oxidation	16175	5312		0.8571428571428571	1	3	16172	2	19	1	16153	16175	0.25167235521278336
R1	cpdb	0	network_modules	268	TRUE	8.198323680992301e-5	32	7	3	0.42857142857142855	0.09375	KEGG:04136	KEGG	Autophagy - other	8484	273		NA	1	32	8452	3	4	29	8448	8484	0.1991397590817774
R1	cpdb	0	network_modules	268	TRUE	9.77069032285153e-4	19	16	3	0.1875	0.15789473684210525	GO:0044804	GO:BP	nucleophagy	16175	11165		NA	1	19	16156	3	13	16	16143	16175	0.17116905694947215
R1	cpdb	0	network_modules	269	TRUE	6.456087096540229e-4	2	16	2	0.125	1	REAC:R-HSA-5633231	REAC	Defective ALG14 causes ALG14-CMS	10916	480		NA	1	2	10914	2	14	0	10900	10916	0.35332655644370065
R1	cpdb	0	network_modules	270	TRUE	1.772873643341921e-5	5	20	3	0.15	0.6	REAC:R-HSA-114516	REAC	Disinhibition of SNARE formation	10916	775		0	0.16666666666666666	5	10911	3	17	2	10894	10916	0.2994268603985691
R1	cpdb	0	network_modules	270	TRUE	4.152959433058817e-5	96	16	5	0.3125	0.052083333333333336	KEGG:04666	KEGG	Fc gamma R-mediated phagocytosis	8484	341		0	0.0625	96	8388	5	11	91	8377	8484	0.12377648236198256
R1	cpdb	0	network_modules	270	TRUE	5.023221767054319e-4	13	20	3	0.15	0.23076923076923078	REAC:R-HSA-416993	REAC	Trafficking of GluR2-containing AMPA receptors	10916	2533		0.2	0.3333333333333333	13	10903	3	17	10	10886	10916	0.18485438162727327
R1	cpdb	0	network_modules	270	TRUE	7.972827623184886e-4	15	20	3	0.15	0.2	REAC:R-HSA-5099900	REAC	WNT5A-dependent internalization of FZD4	10916	2672		0.4	0.5	15	10901	3	17	12	10884	10916	0.17189394896130689
R1	cpdb	0	network_modules	270	TRUE	0.0011749518642782415	89	16	4	0.25	0.0449438202247191	KEGG:04727	KEGG	GABAergic synapse	8484	357		0.06666666666666667	0.1875	89	8395	4	12	85	8383	8484	0.1021851805703158
R1	cpdb	0	network_modules	270	TRUE	0.0011749518642782415	89	16	4	0.25	0.0449438202247191	KEGG:05032	KEGG	Morphine addiction	8484	420		0.06666666666666667	0.1875	89	8395	4	12	85	8383	8484	0.1021851805703158
R1	cpdb	0	network_modules	270	TRUE	0.001652232337180095	97	16	4	0.25	0.041237113402061855	KEGG:04070	KEGG	Phosphatidylinositol signaling system	8484	259		0.2	0.25	97	8387	4	12	93	8375	8484	0.0975418270735957
R1	cpdb	0	network_modules	270	TRUE	0.0017205809299422647	98	16	4	0.25	0.04081632653061224	KEGG:05231	KEGG	Choline metabolism in cancer	8484	479		0.26666666666666666	0.3125	98	8386	4	12	94	8374	8484	0.09700072550823531
R1	cpdb	0	network_modules	270	TRUE	0.0017324753795801165	205	16	5	0.3125	0.024390243902439025	KEGG:05205	KEGG	Proteoglycans in cancer	8484	457		0.3333333333333333	0.375	205	8279	5	11	200	8268	8484	0.08162149280824614
R1	cpdb	0	network_modules	270	TRUE	0.0022588228160006028	105	16	4	0.25	0.0380952380952381	KEGG:04928	KEGG	Parathyroid hormone synthesis, secretion and action	8484	385		0.4	0.4375	105	8379	4	12	101	8367	8484	0.09342634303223506
R1	cpdb	0	network_modules	270	TRUE	0.0023765987512186855	36	16	3	0.1875	0.08333333333333333	KEGG:05143	KEGG	African trypanosomiasis	8484	435		0.4666666666666667	0.5	36	8448	3	13	33	8435	8484	0.1225467869996816
R1	cpdb	0	network_modules	270	TRUE	0.002583323692936051	37	16	3	0.1875	0.08108108108108109	KEGG:04960	KEGG	Aldosterone-regulated sodium reabsorption	8484	396		0.5333333333333333	0.5625	37	8447	3	13	34	8434	8484	0.12080880798354592
R1	cpdb	0	network_modules	270	TRUE	0.003014936326148593	113	16	4	0.25	0.035398230088495575	KEGG:04725	KEGG	Cholinergic synapse	8484	355		0.6	0.625	113	8371	4	12	109	8359	8484	0.08974399168379095
R1	cpdb	0	network_modules	270	TRUE	0.003229802010221448	115	16	4	0.25	0.034782608695652174	KEGG:04724	KEGG	Glutamatergic synapse	8484	354		0.6666666666666666	0.6875	115	8369	4	12	111	8357	8484	0.08888219909324015
R1	cpdb	0	network_modules	270	TRUE	0.0033394490633070553	235	16	5	0.3125	0.02127659574468085	KEGG:04014	KEGG	Ras signaling pathway	8484	247		0.7333333333333333	0.75	235	8249	5	11	230	8238	8484	0.07543568715583594
R1	cpdb	0	network_modules	270	TRUE	0.003815919602468806	120	16	4	0.25	0.03333333333333333	KEGG:04071	KEGG	Sphingolipid signaling pathway	8484	260		0.8	0.8125	120	8364	4	12	116	8352	8484	0.0868198478065531
R1	cpdb	0	network_modules	270	TRUE	0.0050539975353607975	27	20	3	0.15	0.1111111111111111	REAC:R-HSA-399721	REAC	Glutamate binding, activation of AMPA receptors and synaptic plasticity	10916	1057		0.6	0.8333333333333334	27	10889	3	17	24	10872	10916	0.1272445913898661
R1	cpdb	0	network_modules	270	TRUE	0.0050539975353607975	27	20	3	0.15	0.1111111111111111	REAC:R-HSA-399719	REAC	Trafficking of AMPA receptors	10916	2532		0.6	0.8333333333333334	27	10889	3	17	24	10872	10916	0.1272445913898661
R1	cpdb	0	network_modules	270	TRUE	0.007155639488418272	141	16	4	0.25	0.028368794326241134	KEGG:05017	KEGG	Spinocerebellar ataxia	8484	415		0.8666666666666667	0.875	141	8343	4	12	137	8331	8484	0.0793531331212761
R1	cpdb	0	network_modules	270	TRUE	0.007646405720044567	53	16	3	0.1875	0.05660377358490566	KEGG:04961	KEGG	Endocrine and other factor-regulated calcium reabsorption	8484	397		0.9333333333333333	0.9375	53	8431	3	13	50	8418	8484	0.09999489366414151
R1	cpdb	0	network_modules	270	TRUE	0.007730513319576933	31	20	3	0.15	0.0967741935483871	REAC:R-HSA-445095	REAC	Interaction between L1 and Ankyrins	10916	1219		1	1	31	10885	3	17	28	10868	10916	0.11847864602131258
R1	cpdb	0	network_modules	270	TRUE	0.008634550394225641	148	16	4	0.25	0.02702702702702703	KEGG:04723	KEGG	Retrograde endocannabinoid signaling	8484	353		1	1	148	8336	4	12	144	8324	8484	0.0772123803281777
R1	cpdb	0	network_modules	271	TRUE	7.453716719393749e-4	2	13	2	0.15384615384615385	1	GO:0050653	GO:BP	chondroitin sulfate proteoglycan biosynthetic process, polysaccharide chain biosynthetic process	16175	13194		NA	1	2	16173	2	11	0	16162	16175	0.3920988599983004
R1	cpdb	0	network_modules	271	TRUE	0.006397519914748604	57	11	3	0.2727272727272727	0.05263157894736842	REAC:R-HSA-3371497	REAC	HSP90 chaperone cycle for steroid hormone receptors (SHR) in the presence of ligand	10916	1111		NA	1	57	10859	3	8	54	10851	10916	0.11788201083732425
R1	cpdb	0	network_modules	272	TRUE	1.1628176274253797e-7	283	16	8	0.5	0.028268551236749116	GO:0001501	GO:BP	skeletal system development	16175	318		0	0.038461538461538464	283	15892	8	8	275	15884	16175	0.11580180795164319
R1	cpdb	0	network_modules	272	TRUE	3.5058122196335544e-7	291	10	7	0.7	0.024054982817869417	KEGG:04060	KEGG	Cytokine-cytokine receptor interaction	8484	253		0	0.5	291	8193	7	3	284	8190	8484	0.1256513350409663
R1	cpdb	0	network_modules	272	TRUE	9.399304566589765e-7	217	16	7	0.4375	0.03225806451612903	GO:0090092	GO:BP	regulation of transmembrane receptor protein serine/threonine kinase signaling pathway	16175	18013		0.04	0.07692307692307693	217	15958	7	9	210	15949	16175	0.11599254329349283
R1	cpdb	0	network_modules	272	TRUE	2.976726636557483e-6	256	16	7	0.4375	0.02734375	GO:0090287	GO:BP	regulation of cellular response to growth factor stimulus	16175	18171		0.08	0.11538461538461539	256	15919	7	9	249	15910	16175	0.10631512882006465
R1	cpdb	0	network_modules	272	TRUE	4.2717034759949775e-6	107	10	5	0.5	0.04672897196261682	KEGG:04350	KEGG	TGF-beta signaling pathway	8484	304		1	1	107	8377	5	5	102	8372	8484	0.15003588263213113
R1	cpdb	0	network_modules	272	TRUE	4.895768763689498e-6	275	16	7	0.4375	0.025454545454545455	GO:0141091	GO:BP	transforming growth factor beta receptor superfamily signaling pathway	16175	20020		0.12	0.15384615384615385	275	15900	7	9	268	15891	16175	0.1023520475068343
R1	cpdb	0	network_modules	272	TRUE	7.0762769042132986e-6	290	16	7	0.4375	0.02413793103448276	GO:0007178	GO:BP	cell surface receptor protein serine/threonine kinase signaling pathway	16175	2740		0.16	0.19230769230769232	290	15885	7	9	283	15876	16175	0.0994970020867676
R1	cpdb	0	network_modules	272	TRUE	2.118335733372746e-5	298	10	6	0.6	0.020134228187919462	REAC:R-HSA-1474244	REAC	Extracellular matrix organization	10916	889		0	0.14285714285714285	298	10618	6	4	292	10614	10916	0.1064213939740033
R1	cpdb	0	network_modules	272	TRUE	4.746160529059777e-5	60	10	4	0.4	0.06666666666666667	REAC:R-HSA-2022090	REAC	Assembly of collagen fibrils and other multimeric structures	10916	177		0.16666666666666666	0.2857142857142857	60	10856	4	6	56	10850	10916	0.16157385152341414
R1	cpdb	0	network_modules	272	TRUE	6.194404114514461e-5	225	16	6	0.375	0.02666666666666667	GO:0003002	GO:BP	regionalization	16175	1453		0.2	0.23076923076923078	225	15950	6	10	219	15940	16175	0.09701535365212988
R1	cpdb	0	network_modules	272	TRUE	7.035814078762383e-5	15	10	3	0.3	0.2	REAC:R-HSA-2214320	REAC	Anchoring fibril formation	10916	146		0.3333333333333333	0.42857142857142855	15	10901	3	7	12	10894	10916	0.244106536843253
R1	cpdb	0	network_modules	272	TRUE	7.437144654334131e-5	67	10	4	0.4	0.05970149253731343	REAC:R-HSA-1650814	REAC	Collagen biosynthesis and modifying enzymes	10916	384		0.5	0.5714285714285714	67	10849	4	6	63	10843	10916	0.15270134047777878
R1	cpdb	0	network_modules	272	TRUE	8.107855117606482e-5	41	16	4	0.25	0.0975609756097561	GO:0009953	GO:BP	dorsal/ventral pattern formation	16175	3791		0.24	0.2692307692307692	41	16134	4	12	37	16122	16175	0.15486321189767238
R1	cpdb	0	network_modules	272	TRUE	9.548204348939796e-5	117	16	5	0.3125	0.042735042735042736	GO:0030509	GO:BP	BMP signaling pathway	16175	6825		0.28	0.3076923076923077	117	16058	5	11	112	16047	16175	0.11335422021956065
R1	cpdb	0	network_modules	272	TRUE	1.1578989907636946e-4	250	16	6	0.375	0.024	GO:0007389	GO:BP	pattern specification process	16175	2889		0.32	0.34615384615384615	250	15925	6	10	244	15915	16175	0.09171479946802229
R1	cpdb	0	network_modules	272	TRUE	1.2271323537039433e-4	123	16	5	0.3125	0.04065040650406504	GO:0071773	GO:BP	cellular response to BMP stimulus	16175	16902		0.36	0.4230769230769231	123	16052	5	11	118	16041	16175	0.11044121327087884
R1	cpdb	0	network_modules	272	TRUE	1.2271323537039433e-4	123	16	5	0.3125	0.04065040650406504	GO:0071772	GO:BP	response to BMP	16175	16901		0.36	0.4230769230769231	123	16052	5	11	118	16041	16175	0.11044121327087884
R1	cpdb	0	network_modules	272	TRUE	1.259986355540076e-4	18	10	3	0.3	0.16666666666666666	REAC:R-HSA-2243919	REAC	Crosslinking of collagen fibrils	10916	417		0.6666666666666666	0.7142857142857143	18	10898	3	7	15	10891	10916	0.22266332413927906
R1	cpdb	0	network_modules	272	TRUE	1.384643699388824e-4	126	16	5	0.3125	0.03968253968253968	GO:0090101	GO:BP	negative regulation of transmembrane receptor protein serine/threonine kinase signaling pathway	16175	18019		0.44	0.46153846153846156	126	16049	5	11	121	16038	16175	0.10906233024372941
R1	cpdb	0	network_modules	272	TRUE	1.8339837639447153e-4	50	16	4	0.25	0.08	GO:0030199	GO:BP	collagen fibril organization	16175	6708		0.48	0.5	50	16125	4	12	46	16113	16175	0.1399583334636824
R1	cpdb	0	network_modules	272	TRUE	2.3461879486693076e-4	89	10	4	0.4	0.0449438202247191	REAC:R-HSA-1474290	REAC	Collagen formation	10916	387		0.8333333333333334	0.8571428571428571	89	10827	4	6	85	10821	10916	0.1319465522729492
R1	cpdb	0	network_modules	272	TRUE	3.0598092598899053e-4	502	16	7	0.4375	0.013944223107569721	GO:0071363	GO:BP	cellular response to growth factor stimulus	16175	16615		0.52	0.5384615384615384	502	15673	7	9	495	15664	16175	0.0737550367535362
R1	cpdb	0	network_modules	272	TRUE	3.63620989974421e-4	790	16	8	0.5	0.010126582278481013	GO:0007167	GO:BP	enzyme-linked receptor protein signaling pathway	16175	2731		0.56	0.5769230769230769	790	15385	8	8	782	15377	16175	0.06586649574881058
R1	cpdb	0	network_modules	272	TRUE	3.8358017765334273e-4	519	16	7	0.4375	0.01348747591522158	GO:0070848	GO:BP	response to growth factor	16175	16340		0.6	0.6153846153846154	519	15656	7	9	512	15647	16175	0.07238875446525206
R1	cpdb	0	network_modules	272	TRUE	8.232914002026105e-4	18	16	3	0.1875	0.16666666666666666	GO:0061036	GO:BP	positive regulation of cartilage development	16175	15153		0.64	0.6538461538461539	18	16157	3	13	15	16144	16175	0.17591239566271397
R1	cpdb	0	network_modules	272	TRUE	0.001117166486298835	78	16	4	0.25	0.05128205128205128	GO:0030510	GO:BP	regulation of BMP signaling pathway	16175	6826		0.68	0.6923076923076923	78	16097	4	12	74	16085	16175	0.11136745890544113
R1	cpdb	0	network_modules	272	TRUE	0.0011487998552154855	20	16	3	0.1875	0.15	GO:0010463	GO:BP	mesenchymal cell proliferation	16175	4157		0.72	0.7307692307692307	20	16155	3	13	17	16142	16175	0.16678476462399863
R1	cpdb	0	network_modules	272	TRUE	0.0014401488872684439	140	10	4	0.4	0.02857142857142857	REAC:R-HSA-1474228	REAC	Degradation of the extracellular matrix	10916	726		1	1	140	10776	4	6	136	10770	10916	0.104194559226226
R1	cpdb	0	network_modules	272	TRUE	0.0031127643333393133	236	16	5	0.3125	0.0211864406779661	GO:0030198	GO:BP	extracellular matrix organization	16175	6707		0.76	0.7692307692307693	236	15939	5	11	231	15928	16175	0.07817987586884018
R1	cpdb	0	network_modules	272	TRUE	0.003178031846738902	237	16	5	0.3125	0.02109704641350211	GO:0043062	GO:BP	extracellular structure organization	16175	10509		0.8	0.8076923076923077	237	15938	5	11	232	15927	16175	0.07800102192470884
R1	cpdb	0	network_modules	272	TRUE	0.003244374013181599	238	16	5	0.3125	0.02100840336134454	GO:0045229	GO:BP	external encapsulating structure organization	16175	11340		0.84	0.8461538461538461	238	15937	5	11	233	15926	16175	0.07782326671221043
R1	cpdb	0	network_modules	272	TRUE	0.006536114093843217	35	16	3	0.1875	0.08571428571428572	GO:0060391	GO:BP	positive regulation of SMAD protein signal transduction	16175	14596		0.88	0.8846153846153846	35	16140	3	13	32	16127	16175	0.1255080059505054
R1	cpdb	0	network_modules	272	TRUE	0.006922361331561904	123	16	4	0.25	0.032520325203252036	GO:0017015	GO:BP	regulation of transforming growth factor beta receptor signaling pathway	16175	5276		0.92	0.9230769230769231	123	16052	4	12	119	16040	16175	0.0878020732116133
R1	cpdb	0	network_modules	272	TRUE	0.007126006216376415	36	16	3	0.1875	0.08333333333333333	GO:0061035	GO:BP	regulation of cartilage development	16175	15152		0.96	0.9615384615384616	36	16139	3	13	33	16126	16175	0.12371511443697349
R1	cpdb	0	network_modules	272	TRUE	0.007380774143950305	125	16	4	0.25	0.032	GO:1903844	GO:BP	regulation of cellular response to transforming growth factor beta stimulus	16175	23323		1	1	125	16050	4	12	121	16038	16175	0.08705781925638886
R1	cpdb	0	network_modules	273	TRUE	4.603031082189693e-9	152	28	9	0.32142857142857145	0.05921052631578947	GO:0141193	GO:BP	nuclear receptor-mediated signaling pathway	16175	20078		0	0.05	152	16023	9	19	143	16004	16175	0.13467342555998368
R1	cpdb	0	network_modules	273	TRUE	1.3500014796746667e-8	107	28	8	0.2857142857142857	0.07476635514018691	GO:0030518	GO:BP	nuclear receptor-mediated steroid hormone signaling pathway	16175	6833		0.05263157894736842	0.1	107	16068	8	20	99	16048	16175	0.14337158238181838
R1	cpdb	0	network_modules	273	TRUE	1.5700138515930074e-8	109	28	8	0.2857142857142857	0.07339449541284404	GO:0043401	GO:BP	steroid hormone receptor signaling pathway	16175	10670		0.10526315789473684	0.15	109	16066	8	20	101	16046	16175	0.14199606296481906
R1	cpdb	0	network_modules	273	TRUE	1.922033911292448e-8	178	28	9	0.32142857142857145	0.05056179775280899	GO:0009755	GO:BP	hormone-mediated signaling pathway	16175	3652		0.15789473684210525	0.2	178	15997	9	19	169	15978	16175	0.12390913012865473
R1	cpdb	0	network_modules	273	TRUE	1.3365356830037393e-7	142	28	8	0.2857142857142857	0.056338028169014086	GO:0071383	GO:BP	cellular response to steroid hormone stimulus	16175	16635		0.21052631578947367	0.25	142	16033	8	20	134	16013	16175	0.12362438392182452
R1	cpdb	0	network_modules	273	TRUE	4.675215645159918e-7	166	28	8	0.2857142857142857	0.04819277108433735	GO:0048545	GO:BP	response to steroid hormone	16175	12826		0.2631578947368421	0.3	166	16009	8	20	158	15989	16175	0.11381157468514184
R1	cpdb	0	network_modules	273	TRUE	2.069231306055621e-6	41	19	5	0.2631578947368421	0.12195121951219512	REAC:R-HSA-383280	REAC	Nuclear Receptor transcription pathway	10916	1616		0	0.25	41	10875	5	14	36	10861	10916	0.17707347526295206
R1	cpdb	0	network_modules	273	TRUE	2.135272666402773e-6	302	28	9	0.32142857142857145	0.029801324503311258	GO:0030522	GO:BP	intracellular receptor signaling pathway	16175	6836		0.3157894736842105	0.35	302	15873	9	19	293	15854	16175	0.09314074757712777
R1	cpdb	0	network_modules	273	TRUE	6.993919055620823e-5	451	28	9	0.32142857142857145	0.019955654101995565	GO:0032870	GO:BP	cellular response to hormone stimulus	16175	7867		0.3684210526315789	0.4	451	15724	9	19	442	15705	16175	0.07424783848708913
R1	cpdb	0	network_modules	273	TRUE	1.4586534460353287e-4	345	28	8	0.2857142857142857	0.02318840579710145	GO:0071407	GO:BP	cellular response to organic cyclic compound	16175	16659		0.42105263157894735	0.45	345	15830	8	20	337	15810	16175	0.07620163864430794
R1	cpdb	0	network_modules	273	TRUE	2.362707949039409e-4	520	28	9	0.32142857142857145	0.01730769230769231	GO:0033993	GO:BP	response to lipid	16175	8371		0.47368421052631576	0.5	520	15655	9	19	511	15636	16175	0.06829169233306127
R1	cpdb	0	network_modules	273	TRUE	3.2048592500190083e-4	539	28	9	0.32142857142857145	0.016697588126159554	GO:0009725	GO:BP	response to hormone	16175	3623		0.5263157894736842	0.55	539	15636	9	19	530	15617	16175	0.06684543925115011
R1	cpdb	0	network_modules	273	TRUE	5.267817632765786e-4	408	28	8	0.2857142857142857	0.0196078431372549	GO:0071396	GO:BP	cellular response to lipid	16175	16648		0.5789473684210527	0.6	408	15767	8	20	400	15747	16175	0.06917738062185147
R1	cpdb	0	network_modules	273	TRUE	8.873720834135741e-4	437	28	8	0.2857142857142857	0.018306636155606407	GO:0014070	GO:BP	response to organic cyclic compound	16175	4635		0.631578947368421	0.65	437	15738	8	20	429	15718	16175	0.06644369299180011
R1	cpdb	0	network_modules	273	TRUE	0.0013093888251545815	11	28	3	0.10714285714285714	0.2727272727272727	GO:0045348	GO:BP	positive regulation of MHC class II biosynthetic process	16175	11371		0.6842105263157895	0.7	11	16164	3	25	8	16139	16175	0.17006090420272324
R1	cpdb	0	network_modules	273	TRUE	0.0017571473195241592	45	28	4	0.14285714285714285	0.08888888888888889	GO:0030521	GO:BP	androgen receptor signaling pathway	16175	6835		0.7368421052631579	0.75	45	16130	4	24	41	16106	16175	0.11074262035233712
R1	cpdb	0	network_modules	273	TRUE	0.0028161162321667828	24	19	3	0.15789473684210525	0.125	REAC:R-HSA-4090294	REAC	SUMOylation of intracellular receptors	10916	2175		0.3333333333333333	0.5	24	10892	3	16	21	10876	10916	0.13880503843176983
R1	cpdb	0	network_modules	273	TRUE	0.0030470865827980234	37	17	3	0.17647058823529413	0.08108108108108109	KEGG:05340	KEGG	Primary immunodeficiency	8484	488		NA	1	37	8447	3	14	34	8433	8484	0.11703423416121439
R1	cpdb	0	network_modules	273	TRUE	0.003594027106055537	15	28	3	0.10714285714285714	0.2	GO:0045346	GO:BP	regulation of MHC class II biosynthetic process	16175	11369		0.7894736842105263	0.8	15	16160	3	25	12	16135	16175	0.14531116107917666
R1	cpdb	0	network_modules	273	TRUE	0.004418291146288086	16	28	3	0.10714285714285714	0.1875	GO:0045342	GO:BP	MHC class II biosynthetic process	16175	11365		0.8421052631578947	0.85	16	16159	3	25	13	16134	16175	0.14061938357001555
R1	cpdb	0	network_modules	273	TRUE	0.004538085966070919	28	19	3	0.15789473684210525	0.10714285714285714	REAC:R-HSA-76071	REAC	RNA Polymerase III Transcription Initiation From Type 3 Promoter	10916	1902		0.6666666666666666	0.75	28	10888	3	16	25	10872	10916	0.12822959450115445
R1	cpdb	0	network_modules	273	TRUE	0.004982325234183615	2	28	2	0.07142857142857142	1	GO:0009177	GO:BP	pyrimidine deoxyribonucleoside monophosphate biosynthetic process	16175	3343		0.8947368421052632	1	2	16173	2	26	0	16147	16175	0.2670463285603229
R1	cpdb	0	network_modules	273	TRUE	0.004982325234183615	2	28	2	0.07142857142857142	1	GO:0006231	GO:BP	dTMP biosynthetic process	16175	2053		0.8947368421052632	1	2	16173	2	26	0	16147	16175	0.2670463285603229
R1	cpdb	0	network_modules	273	TRUE	0.004982325234183615	2	28	2	0.07142857142857142	1	GO:0046073	GO:BP	dTMP metabolic process	16175	11850		0.8947368421052632	1	2	16173	2	26	0	16147	16175	0.2670463285603229
R1	cpdb	0	network_modules	273	TRUE	0.009804028720571397	36	19	3	0.15789473684210525	0.08333333333333333	REAC:R-HSA-76046	REAC	RNA Polymerase III Transcription Initiation	10916	1899		1	1	36	10880	3	16	33	10864	10916	0.11259567942006121
R1	cpdb	0	network_modules	274	TRUE	1.921658957397913e-26	24	20	12	0.6	0.5	REAC:R-HSA-166208	REAC	mTORC1-mediated signalling	10916	2711		0	0.06666666666666667	24	10892	12	8	12	10884	10916	0.5468175725917888
R1	cpdb	0	network_modules	274	TRUE	5.548656346786501e-23	41	20	12	0.6	0.2926829268292683	REAC:R-HSA-165159	REAC	MTOR signalling	10916	1387		0.07142857142857142	0.13333333333333333	41	10875	12	8	29	10867	10916	0.4176019050860484
R1	cpdb	0	network_modules	274	TRUE	2.4781401381951754e-22	158	23	15	0.6521739130434783	0.0949367088607595	GO:0031929	GO:BP	TOR signaling	16175	7288		0	0.03571428571428571	158	16017	15	8	143	16009	16175	0.24648207658697888
R1	cpdb	0	network_modules	274	TRUE	9.284769423141586e-21	97	23	13	0.5652173913043478	0.13402061855670103	GO:0038202	GO:BP	TORC1 signaling	16175	9766		0.037037037037037035	0.07142857142857142	97	16078	13	10	84	16068	16175	0.2733230415729648
R1	cpdb	0	network_modules	274	TRUE	1.1795194442672044e-19	155	23	15	0.6521739130434783	0.0967741935483871	KEGG:04150	KEGG	mTOR signaling pathway	8484	284		0	0.25	155	8329	15	8	140	8321	8484	0.24678292037463873
R1	cpdb	0	network_modules	274	TRUE	1.866468619483237e-19	29	20	10	0.5	0.3448275862068966	REAC:R-HSA-380972	REAC	Energy dependent regulation of mTOR by LKB1-AMPK	10916	843		0.14285714285714285	0.2	29	10887	10	10	19	10877	10916	0.4139502810519839
R1	cpdb	0	network_modules	274	TRUE	1.5350970978485354e-18	141	23	13	0.5652173913043478	0.09219858156028368	GO:0032006	GO:BP	regulation of TOR signaling	16175	7313		0.07407407407407407	0.10714285714285714	141	16034	13	10	128	16024	16175	0.2259071156748386
R1	cpdb	0	network_modules	274	TRUE	4.266992637189e-18	40	23	10	0.43478260869565216	0.25	GO:0071230	GO:BP	cellular response to amino acid stimulus	16175	16492		0.1111111111111111	0.14285714285714285	40	16135	10	13	30	16122	16175	0.3284547224461513
R1	cpdb	0	network_modules	274	TRUE	1.2453720226844859e-17	44	23	10	0.43478260869565216	0.22727272727272727	GO:0071229	GO:BP	cellular response to acid chemical	16175	16491		0.14814814814814814	0.17857142857142858	44	16131	10	13	34	16118	16175	0.31302895071465775
R1	cpdb	0	network_modules	274	TRUE	2.042972587859584e-17	46	23	10	0.43478260869565216	0.21739130434782608	GO:0043200	GO:BP	response to amino acid	16175	10574		0.18518518518518517	0.21428571428571427	46	16129	10	13	36	16116	16175	0.30607971501201686
R1	cpdb	0	network_modules	274	TRUE	6.380473690829566e-17	51	23	10	0.43478260869565216	0.19607843137254902	GO:0001101	GO:BP	response to acid chemical	16175	287		0.2222222222222222	0.25	51	16124	10	13	41	16111	16175	0.29052585377259466
R1	cpdb	0	network_modules	274	TRUE	2.1047578200765913e-16	92	23	11	0.4782608695652174	0.11956521739130435	GO:1903432	GO:BP	regulation of TORC1 signaling	16175	23003		0.25925925925925924	0.2857142857142857	92	16083	11	12	81	16071	16175	0.23713004736741716
R1	cpdb	0	network_modules	274	TRUE	2.666896187627898e-16	55	20	10	0.5	0.18181818181818182	REAC:R-HSA-9639288	REAC	Amino acids regulate mTORC1	10916	142		0.21428571428571427	0.26666666666666666	55	10861	10	10	45	10851	10916	0.29950230319284565
R1	cpdb	0	network_modules	274	TRUE	5.709553115019537e-16	59	20	10	0.5	0.1694915254237288	REAC:R-HSA-8943724	REAC	Regulation of PTEN gene transcription	10916	1999		0.2857142857142857	0.3333333333333333	59	10857	10	10	49	10847	10916	0.2890106543552377
R1	cpdb	0	network_modules	274	TRUE	1.95351502735934e-15	70	23	10	0.43478260869565216	0.14285714285714285	GO:0032008	GO:BP	positive regulation of TOR signaling	16175	7315		0.2962962962962963	0.32142857142857145	70	16105	10	13	60	16092	16175	0.24745336765474857
R1	cpdb	0	network_modules	274	TRUE	2.4570838980338485e-14	84	20	10	0.5	0.11904761904761904	REAC:R-HSA-5628897	REAC	TP53 Regulates Metabolic Genes	10916	2452		0.35714285714285715	0.4	84	10832	10	10	74	10822	10916	0.24137103013646652
R1	cpdb	0	network_modules	274	TRUE	3.249600808029939e-14	134	20	11	0.55	0.08208955223880597	REAC:R-HSA-1632852	REAC	Macroautophagy	10916	1388		0.42857142857142855	0.4666666666666667	134	10782	11	9	123	10773	10916	0.20921975612474183
R1	cpdb	0	network_modules	274	TRUE	1.0780347326128769e-13	149	20	11	0.55	0.0738255033557047	REAC:R-HSA-9612973	REAC	Autophagy	10916	193		0.5	0.5333333333333333	149	10767	11	9	138	10758	10916	0.19804004848029047
R1	cpdb	0	network_modules	274	TRUE	6.659441976398401e-13	187	23	11	0.4782608695652174	0.058823529411764705	GO:0031669	GO:BP	cellular response to nutrient levels	16175	7272		0.3333333333333333	0.35714285714285715	187	15988	11	12	176	15976	16175	0.16474597517314224
R1	cpdb	0	network_modules	274	TRUE	6.693126606744089e-13	253	20	12	0.6	0.04743083003952569	REAC:R-HSA-1257604	REAC	PIP3 activates AKT signaling	10916	1679		0.5714285714285714	0.6	253	10663	12	8	241	10655	10916	0.1642432727839384
R1	cpdb	0	network_modules	274	TRUE	3.930876793885921e-12	293	20	12	0.6	0.040955631399317405	REAC:R-HSA-9006925	REAC	Intracellular signaling by second messengers	10916	1266		0.6428571428571429	0.6666666666666666	293	10623	12	8	281	10615	10916	0.1519366127095105
R1	cpdb	0	network_modules	274	TRUE	4.204205769371031e-12	138	20	10	0.5	0.07246376811594203	REAC:R-HSA-6807070	REAC	PTEN Regulation	10916	1703		0.7142857142857143	0.7333333333333333	138	10778	10	10	128	10768	10916	0.18688930544191934
R1	cpdb	0	network_modules	274	TRUE	4.64724392653224e-12	52	23	8	0.34782608695652173	0.15384615384615385	GO:1904263	GO:BP	positive regulation of TORC1 signaling	16175	23657		0.37037037037037035	0.39285714285714285	52	16123	8	15	44	16108	16175	0.2297205808437466
R1	cpdb	0	network_modules	274	TRUE	1.5662109807023345e-11	157	20	10	0.5	0.06369426751592357	REAC:R-HSA-9711097	REAC	Cellular response to starvation	10916	337		0.7857142857142857	0.8	157	10759	10	10	147	10749	10916	0.17474448366072337
R1	cpdb	0	network_modules	274	TRUE	2.8174306194196377e-11	262	23	11	0.4782608695652174	0.04198473282442748	GO:0031667	GO:BP	response to nutrient levels	16175	7271		0.4074074074074074	0.42857142857142855	262	15913	11	12	251	15901	16175	0.13812414484065097
R1	cpdb	0	network_modules	274	TRUE	2.0584775495396238e-10	138	23	9	0.391304347826087	0.06521739130434782	GO:0009267	GO:BP	cellular response to starvation	16175	3432		0.4444444444444444	0.4642857142857143	138	16037	9	14	129	16023	16175	0.1570488860657061
R1	cpdb	0	network_modules	274	TRUE	7.509524615786121e-10	159	23	9	0.391304347826087	0.05660377358490566	GO:0042594	GO:BP	response to starvation	16175	10254		0.48148148148148145	0.5	159	16016	9	14	150	16002	16175	0.14590991987432408
R1	cpdb	0	network_modules	274	TRUE	1.8208157190510564e-9	359	20	11	0.55	0.03064066852367688	REAC:R-HSA-3700989	REAC	Transcriptional Regulation by TP53	10916	2546		0.8571428571428571	0.8666666666666667	359	10557	11	9	348	10548	10916	0.12422600662528256
R1	cpdb	0	network_modules	274	TRUE	5.560808682619155e-8	46	23	6	0.2608695652173913	0.13043478260869565	GO:0034198	GO:BP	cellular response to amino acid starvation	16175	8499		0.5185185185185185	0.5357142857142857	46	16129	6	17	40	16112	16175	0.18284173451966199
R1	cpdb	0	network_modules	274	TRUE	7.272096971317896e-8	48	23	6	0.2608695652173913	0.125	GO:1990928	GO:BP	response to amino acid starvation	16175	25341		0.5555555555555556	0.5714285714285714	48	16127	6	17	42	16110	16175	0.1789173227863711
R1	cpdb	0	network_modules	274	TRUE	4.246717386819379e-7	165	23	8	0.34782608695652173	0.048484848484848485	KEGG:04140	KEGG	Autophagy - animal	8484	277		0.3333333333333333	0.5	165	8319	8	15	157	8304	8484	0.12397949718230361
R1	cpdb	0	network_modules	274	TRUE	1.2631770166956047e-6	76	23	6	0.2608695652173913	0.07894736842105263	GO:0010507	GO:BP	negative regulation of autophagy	16175	4182		0.5925925925925926	0.6071428571428571	76	16099	6	17	70	16082	16175	0.14135744847876244
R1	cpdb	0	network_modules	274	TRUE	9.643400575710525e-6	246	23	8	0.34782608695652173	0.032520325203252036	KEGG:05131	KEGG	Shigellosis	8484	428		0.6666666666666666	0.75	246	8238	8	15	238	8223	8484	0.09906834593043941
R1	cpdb	0	network_modules	274	TRUE	1.3596327396624244e-5	324	23	8	0.34782608695652173	0.024691358024691357	GO:0010506	GO:BP	regulation of autophagy	16175	4181		0.6296296296296297	0.6428571428571429	324	15851	8	15	316	15836	16175	0.08828700270763541
R1	cpdb	0	network_modules	274	TRUE	3.386210032821756e-4	491	23	8	0.34782608695652173	0.016293279022403257	GO:0006914	GO:BP	autophagy	16175	2563		0.6666666666666666	0.7142857142857143	491	15684	8	15	483	15669	16175	0.06982796803189889
R1	cpdb	0	network_modules	274	TRUE	3.386210032821756e-4	491	23	8	0.34782608695652173	0.016293279022403257	GO:0061919	GO:BP	process utilizing autophagic mechanism	16175	15723		0.6666666666666666	0.7142857142857143	491	15684	8	15	483	15669	16175	0.06982796803189889
R1	cpdb	0	network_modules	274	TRUE	4.5366352113520247e-4	10	23	3	0.13043478260869565	0.3	GO:1990253	GO:BP	cellular response to leucine starvation	16175	25122		0.7407407407407407	0.75	10	16165	3	20	7	16145	16175	0.1970775909841018
R1	cpdb	0	network_modules	274	TRUE	8.301744332282029e-4	12	23	3	0.13043478260869565	0.25	GO:0071233	GO:BP	cellular response to L-leucine	16175	16495		0.7777777777777778	0.8214285714285714	12	16163	3	20	9	16143	16175	0.1797461662402991
R1	cpdb	0	network_modules	274	TRUE	8.301744332282029e-4	12	23	3	0.13043478260869565	0.25	GO:0043201	GO:BP	response to L-leucine	16175	10575		0.7777777777777778	0.8214285714285714	12	16163	3	20	9	16143	16175	0.1797461662402991
R1	cpdb	0	network_modules	274	TRUE	0.0035094784688445447	24	20	3	0.15	0.125	REAC:R-HSA-3371571	REAC	HSF1-dependent transactivation	10916	1110		0.9285714285714286	0.9333333333333333	24	10892	3	17	21	10875	10916	0.13519606957514896
R1	cpdb	0	network_modules	274	TRUE	0.0036328697091528943	19	23	3	0.13043478260869565	0.15789473684210525	GO:0033123	GO:BP	positive regulation of purine nucleotide catabolic process	16175	8047		0.8518518518518519	0.9285714285714286	19	16156	3	20	16	16136	16175	0.14240194503174
R1	cpdb	0	network_modules	274	TRUE	0.0036328697091528943	19	23	3	0.13043478260869565	0.15789473684210525	GO:0045821	GO:BP	positive regulation of glycolytic process	16175	11641		0.8518518518518519	0.9285714285714286	19	16156	3	20	16	16136	16175	0.14240194503174
R1	cpdb	0	network_modules	274	TRUE	0.0036328697091528943	19	23	3	0.13043478260869565	0.15789473684210525	GO:0030813	GO:BP	positive regulation of nucleotide catabolic process	16175	6916		0.8518518518518519	0.9285714285714286	19	16156	3	20	16	16136	16175	0.14240194503174
R1	cpdb	0	network_modules	274	TRUE	0.0037317503458478966	290	23	6	0.2608695652173913	0.020689655172413793	GO:0009895	GO:BP	negative regulation of catabolic process	16175	3755		0.9629629629629629	0.9642857142857143	290	15885	6	17	284	15868	16175	0.06908800585949386
R1	cpdb	0	network_modules	274	TRUE	0.0044976964357209	26	20	3	0.15	0.11538461538461539	REAC:R-HSA-5674400	REAC	Constitutive Signaling by AKT1 E17K in Cancer	10916	400		1	1	26	10890	3	17	23	10873	10916	0.12974307774804228
R1	cpdb	0	network_modules	274	TRUE	0.005529483279602017	89	23	4	0.17391304347826086	0.0449438202247191	KEGG:04211	KEGG	Longevity regulating pathway	8484	288		1	1	89	8395	4	19	85	8376	8484	0.08362974670685844
R1	cpdb	0	network_modules	274	TRUE	0.008783952978863854	3	23	2	0.08695652173913043	0.6666666666666666	GO:1905857	GO:BP	positive regulation of pentose-phosphate shunt	16175	24967		1	1	3	16172	2	21	1	16151	16175	0.24045145819458102
R1	cpdb	0	network_modules	275	TRUE	5.015621422624356e-22	270	25	17	0.68	0.06296296296296296	GO:0016197	GO:BP	endosomal transport	16175	5169		0	0.058823529411764705	270	15905	17	8	253	15897	16175	0.20370151897701075
R1	cpdb	0	network_modules	275	TRUE	2.020518533984921e-19	248	21	16	0.7619047619047619	0.06451612903225806	KEGG:04144	KEGG	Endocytosis	8484	280		NA	1	248	8236	16	5	232	8231	8484	0.2166578720588081
R1	cpdb	0	network_modules	275	TRUE	5.0051150969096294e-18	94	25	12	0.48	0.1276595744680851	GO:0042147	GO:BP	retrograde transport, endosome to Golgi	16175	9990		0.0625	0.11764705882352941	94	16081	12	13	82	16068	16175	0.245447522166791
R1	cpdb	0	network_modules	275	TRUE	2.9404837918187883e-16	130	25	12	0.48	0.09230769230769231	GO:0016482	GO:BP	cytosolic transport	16175	5232		0.125	0.17647058823529413	130	16045	12	13	118	16032	16175	0.2079669677917227
R1	cpdb	0	network_modules	275	TRUE	3.251259323117159e-10	79	25	8	0.32	0.10126582278481013	GO:0032456	GO:BP	endocytic recycling	16175	7571		0.1875	0.23529411764705882	79	16096	8	17	71	16079	16175	0.17783852483962487
R1	cpdb	0	network_modules	275	TRUE	4.474794994188456e-10	137	25	9	0.36	0.06569343065693431	GO:0098876	GO:BP	vesicle-mediated transport to the plasma membrane	16175	18924		0.25	0.29411764705882354	137	16038	9	16	128	16022	16175	0.15092292313864622
R1	cpdb	0	network_modules	275	TRUE	2.9505485686440474e-9	27	25	6	0.24	0.2222222222222222	GO:0034315	GO:BP	regulation of Arp2/3 complex-mediated actin nucleation	16175	8569		0.3125	0.35294117647058826	27	16148	6	19	21	16129	16175	0.229703107725267
R1	cpdb	0	network_modules	275	TRUE	1.0973340222331317e-8	33	25	6	0.24	0.18181818181818182	GO:0051125	GO:BP	regulation of actin nucleation	16175	13509		0.375	0.4117647058823529	33	16142	6	19	27	16123	16175	0.20748944578682144
R1	cpdb	0	network_modules	275	TRUE	5.150342719802007e-8	42	25	6	0.24	0.14285714285714285	GO:0034314	GO:BP	Arp2/3 complex-mediated actin nucleation	16175	8568		0.4375	0.47058823529411764	42	16133	6	19	36	16114	16175	0.18354085618067106
R1	cpdb	0	network_modules	275	TRUE	1.547614606038866e-7	50	25	6	0.24	0.12	GO:0045010	GO:BP	actin nucleation	16175	11227		0.5	0.5294117647058824	50	16125	6	19	44	16106	16175	0.1679091555935046
R1	cpdb	0	network_modules	275	TRUE	1.0661806705518441e-5	26	15	4	0.26666666666666666	0.15384615384615385	REAC:R-HSA-3238698	REAC	WNT ligand biogenesis and trafficking	10916	2668		NA	1	26	10890	4	11	22	10879	10916	0.20111646530644461
R1	cpdb	0	network_modules	275	TRUE	1.970614591686502e-4	594	25	9	0.36	0.015151515151515152	GO:0051668	GO:BP	localization within membrane	16175	13880		0.5625	0.5882352941176471	594	15581	9	16	585	15565	16175	0.06762565686661215
R1	cpdb	0	network_modules	275	TRUE	5.383951285790455e-4	318	25	7	0.28	0.0220125786163522	GO:1902903	GO:BP	regulation of supramolecular fiber organization	16175	22602		0.625	0.6470588235294118	318	15857	7	18	311	15839	16175	0.07378106322168175
R1	cpdb	0	network_modules	275	TRUE	0.0010537701711884307	215	25	6	0.24	0.027906976744186046	GO:0110053	GO:BP	regulation of actin filament organization	16175	19377		0.6875	0.7058823529411765	215	15960	6	19	209	15941	16175	0.07788592417470719
R1	cpdb	0	network_modules	275	TRUE	0.004317398928101591	274	25	6	0.24	0.021897810218978103	GO:0032956	GO:BP	regulation of actin cytoskeleton organization	16175	7940		0.75	0.7647058823529411	274	15901	6	19	268	15882	16175	0.06800843321968869
R1	cpdb	0	network_modules	275	TRUE	0.004719916059510908	440	25	7	0.28	0.015909090909090907	GO:0051493	GO:BP	regulation of cytoskeleton organization	16175	13748		0.8125	0.8235294117647058	440	15735	7	18	433	15717	16175	0.06114221103279891
R1	cpdb	0	network_modules	275	TRUE	0.005082251396427945	156	25	5	0.2	0.03205128205128205	GO:0016241	GO:BP	regulation of macroautophagy	16175	5183		0.875	0.8823529411764706	156	16019	5	20	151	15999	16175	0.0766325769613761
R1	cpdb	0	network_modules	275	TRUE	0.008085042301513865	23	25	3	0.12	0.13043478260869565	GO:0036010	GO:BP	protein localization to endosome	16175	9391		0.9375	0.9411764705882353	23	16152	3	22	20	16130	16175	0.12380987150270771
R1	cpdb	0	network_modules	275	TRUE	0.008465714564649106	308	25	6	0.24	0.01948051948051948	GO:0032970	GO:BP	regulation of actin filament-based process	16175	7953		1	1	308	15867	6	19	302	15848	16175	0.0636085535737493
R1	cpdb	0	network_modules	276	TRUE	1.8600708627092628e-5	10	10	3	0.3	0.3	REAC:R-HSA-9840309	REAC	Glycosphingolipid biosynthesis	10916	1077		0	0.5	10	10906	3	7	7	10899	10916	0.2993581514762516
R1	cpdb	0	network_modules	276	TRUE	0.002312539505700123	46	10	3	0.3	0.06521739130434782	REAC:R-HSA-1660662	REAC	Glycosphingolipid metabolism	10916	1079		1	1	46	10870	3	7	43	10863	10916	0.13826578064370965
R1	cpdb	0	network_modules	277	TRUE	3.4580453203524584e-4	382	12	6	0.5	0.015706806282722512	KEGG:05010	KEGG	Alzheimer disease	8484	411		0	0.5	382	8102	6	6	376	8096	8484	0.08257662965294023
R1	cpdb	0	network_modules	277	TRUE	0.002899738316776353	31	15	3	0.2	0.0967741935483871	REAC:R-HSA-2122948	REAC	Activated NOTCH1 Transmits Signal to the Nucleus	10916	58		NA	1	31	10885	3	12	28	10873	10916	0.13743584695889785
R1	cpdb	0	network_modules	277	TRUE	0.00781883048350152	202	12	4	0.3333333333333333	0.019801980198019802	KEGG:05415	KEGG	Diabetic cardiomyopathy	8484	492		1	1	202	8282	4	8	198	8274	8484	0.07640980184509015
R1	cpdb	0	network_modules	278	TRUE	4.815614351951445e-7	16	14	4	0.2857142857142857	0.25	KEGG:00450	KEGG	Selenocompound metabolism	8484	58		0	0.5	16	8468	4	10	12	8458	8484	0.26596738251745433
R1	cpdb	0	network_modules	278	TRUE	1.1620509831086633e-6	3	18	3	0.16666666666666666	1	REAC:R-HSA-2408550	REAC	Metabolism of ingested H2SeO4 and H2SeO3 into H2Se	10916	1426		0	0.5	3	10913	3	15	0	10898	10916	0.4079676238240486
R1	cpdb	0	network_modules	278	TRUE	9.290279180855125e-5	6	25	3	0.12	0.5	GO:0009452	GO:BP	7-methylguanosine RNA capping	16175	3499		0	0.2	6	16169	3	22	3	16147	16175	0.2444260585285185
R1	cpdb	0	network_modules	278	TRUE	9.290279180855125e-5	6	25	3	0.12	0.5	GO:0006370	GO:BP	7-methylguanosine mRNA capping	16175	2145		0	0.2	6	16169	3	22	3	16147	16175	0.2444260585285185
R1	cpdb	0	network_modules	278	TRUE	3.0710500420283546e-4	117	18	5	0.2777777777777778	0.042735042735042736	REAC:R-HSA-2408522	REAC	Selenoamino acid metabolism	10916	2187		1	1	117	10799	5	13	112	10786	10916	0.10540223383476112
R1	cpdb	0	network_modules	278	TRUE	0.0016770806674558068	14	25	3	0.12	0.21428571428571427	GO:0036260	GO:BP	RNA capping	16175	9521		0.2222222222222222	0.3	14	16161	3	22	11	16139	16175	0.15939229457778828
R1	cpdb	0	network_modules	278	TRUE	0.003276358997535711	2	25	2	0.08	1	GO:0050428	GO:BP	3'-phosphoadenosine 5'-phosphosulfate biosynthetic process	16175	13185		0.3333333333333333	0.9	2	16173	2	23	0	16150	16175	0.282641522315189
R1	cpdb	0	network_modules	278	TRUE	0.003276358997535711	2	25	2	0.08	1	GO:0000103	GO:BP	sulfate assimilation	16175	46		0.3333333333333333	0.9	2	16173	2	23	0	16150	16175	0.282641522315189
R1	cpdb	0	network_modules	278	TRUE	0.003276358997535711	2	25	2	0.08	1	GO:0034033	GO:BP	purine nucleoside bisphosphate biosynthetic process	16175	8377		0.3333333333333333	0.9	2	16173	2	23	0	16150	16175	0.282641522315189
R1	cpdb	0	network_modules	278	TRUE	0.003276358997535711	2	25	2	0.08	1	GO:0034030	GO:BP	ribonucleoside bisphosphate biosynthetic process	16175	8374		0.3333333333333333	0.9	2	16173	2	23	0	16150	16175	0.282641522315189
R1	cpdb	0	network_modules	278	TRUE	0.003276358997535711	2	25	2	0.08	1	GO:0033866	GO:BP	nucleoside bisphosphate biosynthetic process	16175	8364		0.3333333333333333	0.9	2	16173	2	23	0	16150	16175	0.282641522315189
R1	cpdb	0	network_modules	278	TRUE	0.003276358997535711	2	25	2	0.08	1	GO:0034036	GO:BP	purine ribonucleoside bisphosphate biosynthetic process	16175	8380		0.3333333333333333	0.9	2	16173	2	23	0	16150	16175	0.282641522315189
R1	cpdb	0	network_modules	278	TRUE	0.006513382086249753	10	14	2	0.14285714285714285	0.2	KEGG:00920	KEGG	Sulfur metabolism	8484	140		1	1	10	8474	2	12	8	8462	8484	0.16787365669114482
R1	cpdb	0	network_modules	278	TRUE	0.009819758219721055	3	25	2	0.08	0.6666666666666666	GO:1904257	GO:BP	zinc ion import into Golgi lumen	16175	23651		1	1	3	16172	2	23	1	16149	16175	0.23060434694047444
R1	cpdb	0	network_modules	279	TRUE	2.5511803462604707e-11	16	21	6	0.2857142857142857	0.375	GO:0006744	GO:BP	ubiquinone biosynthetic process	16175	2443		0	0.125	16	16159	6	15	10	16144	16175	0.3265670982103641
R1	cpdb	0	network_modules	279	TRUE	2.5511803462604707e-11	16	21	6	0.2857142857142857	0.375	GO:1901663	GO:BP	quinone biosynthetic process	16175	21630		0	0.125	16	16159	6	15	10	16144	16175	0.3265670982103641
R1	cpdb	0	network_modules	279	TRUE	5.904694471751728e-11	18	21	6	0.2857142857142857	0.3333333333333333	GO:0006743	GO:BP	ubiquinone metabolic process	16175	2442		0.13333333333333333	0.1875	18	16157	6	15	12	16142	16175	0.30777575256789563
R1	cpdb	0	network_modules	279	TRUE	2.365689636714321e-10	22	21	6	0.2857142857142857	0.2727272727272727	GO:1901661	GO:BP	quinone metabolic process	16175	21628		0.2	0.25	22	16153	6	15	16	16138	16175	0.2781861793327175
R1	cpdb	0	network_modules	279	TRUE	1.6369585959216628e-8	42	21	6	0.2857142857142857	0.14285714285714285	GO:0042181	GO:BP	ketone biosynthetic process	16175	10009		0.26666666666666666	0.3125	42	16133	6	15	36	16118	16175	0.20058510742726193
R1	cpdb	0	network_modules	279	TRUE	6.88147650284924e-8	8	16	4	0.25	0.5	REAC:R-HSA-2142789	REAC	Ubiquinol biosynthesis	10916	2618		0	0.25	8	10908	4	12	4	10896	10916	0.3529049304966047
R1	cpdb	0	network_modules	279	TRUE	8.772934046111034e-8	11	14	4	0.2857142857142857	0.36363636363636365	KEGG:00130	KEGG	Ubiquinone and other terpenoid-quinone biosynthesis	8484	16		0	0.3333333333333333	11	8473	4	10	7	8463	8484	0.3213399256027747
R1	cpdb	0	network_modules	279	TRUE	2.321235737372187e-6	17	16	4	0.25	0.23529411764705882	REAC:R-HSA-162710	REAC	Synthesis of glycosylphosphatidylinositol (GPI)	10916	2409		0.3333333333333333	0.5	17	10899	4	12	13	10887	10916	0.24138964752167505
R1	cpdb	0	network_modules	279	TRUE	3.7736460219160896e-6	19	16	4	0.25	0.21052631578947367	REAC:R-HSA-8978934	REAC	Metabolism of cofactors	10916	1423		0.6666666666666666	0.75	19	10897	4	12	15	10885	10916	0.22818429863846065
R1	cpdb	0	network_modules	279	TRUE	3.9184875488012245e-6	26	14	4	0.2857142857142857	0.15384615384615385	KEGG:00563	KEGG	Glycosylphosphatidylinositol (GPI)-anchor biosynthesis	8484	87		0.5	0.6666666666666666	26	8458	4	10	22	8448	8484	0.20789831864948868
R1	cpdb	0	network_modules	279	TRUE	1.7347200939337667e-5	130	21	6	0.2857142857142857	0.046153846153846156	GO:0046467	GO:BP	membrane lipid biosynthetic process	16175	12175		0.3333333333333333	0.375	130	16045	6	15	124	16030	16175	0.11212761085562033
R1	cpdb	0	network_modules	279	TRUE	2.9778455706485844e-5	67	21	5	0.23809523809523808	0.07462686567164178	GO:0009247	GO:BP	glycolipid biosynthetic process	16175	3412		0.4	0.4375	67	16108	5	16	62	16092	16175	0.1313361812876564
R1	cpdb	0	network_modules	279	TRUE	4.5305553069393134e-5	26	21	4	0.19047619047619047	0.15384615384615385	GO:0006506	GO:BP	GPI anchor biosynthetic process	16175	2232		0.4666666666666667	0.5	26	16149	4	17	22	16132	16175	0.16998655088032633
R1	cpdb	0	network_modules	279	TRUE	5.314003458354746e-5	27	21	4	0.19047619047619047	0.14814814814814814	GO:0006505	GO:BP	GPI anchor metabolic process	16175	2231		0.5333333333333333	0.5625	27	16148	4	17	23	16131	16175	0.16675951241866255
R1	cpdb	0	network_modules	279	TRUE	8.34074229514262e-5	169	21	6	0.2857142857142857	0.03550295857988166	GO:0042180	GO:BP	ketone metabolic process	16175	10008		0.6	0.625	169	16006	6	15	163	15991	16175	0.09760719008419066
R1	cpdb	0	network_modules	279	TRUE	9.49533433906798e-5	31	21	4	0.19047619047619047	0.12903225806451613	GO:0180046	GO:BP	GPI anchored protein biosynthesis	16175	20314		0.6666666666666666	0.6875	31	16144	4	17	27	16127	16175	0.15544481683557218
R1	cpdb	0	network_modules	279	TRUE	1.2136731628508401e-4	180	21	6	0.2857142857142857	0.03333333333333333	GO:0006643	GO:BP	membrane lipid metabolic process	16175	2354		0.7333333333333333	0.75	180	15995	6	15	174	15980	16175	0.09437651044943127
R1	cpdb	0	network_modules	279	TRUE	1.4853137333130782e-4	92	21	5	0.23809523809523808	0.05434782608695652	GO:0006664	GO:BP	glycolipid metabolic process	16175	2373		0.8	0.8125	92	16083	5	16	87	16067	16175	0.11142598840609291
R1	cpdb	0	network_modules	279	TRUE	1.568408932550844e-4	93	21	5	0.23809523809523808	0.053763440860215055	GO:1903509	GO:BP	liposaccharide metabolic process	16175	23059		0.8666666666666667	0.875	93	16082	5	16	88	16066	16175	0.1107992683467475
R1	cpdb	0	network_modules	279	TRUE	0.0010482472383557555	136	21	5	0.23809523809523808	0.03676470588235294	GO:0046488	GO:BP	phosphatidylinositol metabolic process	16175	12192		0.9333333333333333	0.9375	136	16039	5	16	131	16023	16175	0.09069693169027872
R1	cpdb	0	network_modules	279	TRUE	0.002442003517450967	91	16	4	0.25	0.04395604395604396	REAC:R-HSA-163125	REAC	Post-translational modification: synthesis of GPI-anchored proteins	10916	1775		1	1	91	10825	4	12	87	10813	10916	0.10183261231854963
R1	cpdb	0	network_modules	279	TRUE	0.005099790796476949	153	14	4	0.2857142857142857	0.026143790849673203	KEGG:01240	KEGG	Biosynthesis of cofactors	8484	190		1	1	153	8331	4	10	149	8321	8484	0.08177963431763084
R1	cpdb	0	network_modules	279	TRUE	0.005310464405558549	189	21	5	0.23809523809523808	0.026455026455026454	GO:0046474	GO:BP	glycerophospholipid biosynthetic process	16175	12181		1	1	189	15986	5	16	184	15970	16175	0.07596433329290213
R1	cpdb	0	network_modules	281	TRUE	1.7349600714096818e-48	30	31	21	0.6774193548387096	0.7	REAC:R-HSA-77387	REAC	Insulin receptor recycling	10916	1210		0	0.1	30	10886	21	10	9	10876	10916	0.6877450435094435
R1	cpdb	0	network_modules	281	TRUE	5.3736604066708244e-48	31	31	21	0.6774193548387096	0.6774193548387096	REAC:R-HSA-917977	REAC	Transferrin endocytosis and recycling	10916	2564		0.1111111111111111	0.2	31	10885	21	10	10	10875	10916	0.676500659386252
R1	cpdb	0	network_modules	281	TRUE	8.712451761456664e-43	36	31	20	0.6451612903225806	0.5555555555555556	REAC:R-HSA-1222556	REAC	ROS and RNS production in phagocytes	10916	1910		0.2222222222222222	0.3	36	10880	20	11	16	10869	10916	0.5974575549554014
R1	cpdb	0	network_modules	281	TRUE	8.113968547672211e-42	50	28	21	0.75	0.42	KEGG:05110	KEGG	Vibrio cholerae infection	8484	424		0	0.09090909090909091	50	8434	21	7	29	8427	8484	0.5594103758626093
R1	cpdb	0	network_modules	281	TRUE	1.7321012960833701e-41	134	28	25	0.8928571428571429	0.1865671641791045	KEGG:00190	KEGG	Oxidative phosphorylation	8484	18		0.1	0.18181818181818182	134	8350	25	3	109	8347	8484	0.40479225658232326
R1	cpdb	0	network_modules	281	TRUE	2.525244403689146e-40	57	31	21	0.6774193548387096	0.3684210526315789	REAC:R-HSA-917937	REAC	Iron uptake and transport	10916	1277		0.3333333333333333	0.4	57	10859	21	10	36	10849	10916	0.49773113726869406
R1	cpdb	0	network_modules	281	TRUE	4.82006992775666e-40	27	28	18	0.6428571428571429	0.6666666666666666	KEGG:04966	KEGG	Collecting duct acid secretion	8484	400		0.2	0.2727272727272727	27	8457	18	10	9	8447	8484	0.6535311651128638
R1	cpdb	0	network_modules	281	TRUE	4.572012091648436e-38	70	28	21	0.75	0.3	KEGG:05120	KEGG	Epithelial cell signaling in Helicobacter pylori infection	8484	426		0.3	0.36363636363636365	70	8414	21	7	49	8407	8484	0.4718500293747306
R1	cpdb	0	network_modules	281	TRUE	1.2666359011295525e-37	73	31	21	0.6774193548387096	0.2876712328767123	REAC:R-HSA-74752	REAC	Signaling by Insulin receptor	10916	2260		0.4444444444444444	0.5	73	10843	21	10	52	10833	10916	0.4391804257567235
R1	cpdb	0	network_modules	281	TRUE	1.1639845493226018e-35	88	28	21	0.75	0.23863636363636365	KEGG:05323	KEGG	Rheumatoid arthritis	8484	485		0.4	0.45454545454545453	88	8396	21	7	67	8389	8484	0.42008067937733135
R1	cpdb	0	network_modules	281	TRUE	2.451590683041661e-34	78	28	20	0.7142857142857143	0.2564102564102564	KEGG:04721	KEGG	Synaptic vesicle cycle	8484	351		0.5	0.5454545454545454	78	8406	20	8	58	8398	8484	0.4251096298961946
R1	cpdb	0	network_modules	281	TRUE	1.0042308872173139e-33	32	33	16	0.48484848484848486	0.5	GO:0007035	GO:BP	vacuolar acidification	16175	2640		0	0.02702702702702703	32	16143	16	17	16	16126	16175	0.491344173241383
R1	cpdb	0	network_modules	281	TRUE	1.2734230063742232e-32	55	31	18	0.5806451612903226	0.32727272727272727	REAC:R-HSA-9639288	REAC	Amino acids regulate mTORC1	10916	142		0.5555555555555556	0.6	55	10861	18	13	37	10848	10916	0.43385013332128364
R1	cpdb	0	network_modules	281	TRUE	1.0664847245105561e-30	45	33	16	0.48484848484848486	0.35555555555555557	GO:0051452	GO:BP	intracellular pH reduction	16175	13713		0.027777777777777776	0.05405405405405406	45	16130	16	17	29	16113	16175	0.41381480264720666
R1	cpdb	0	network_modules	281	TRUE	1.589803083575166e-30	147	28	21	0.75	0.14285714285714285	KEGG:04145	KEGG	Phagosome	8484	281		0.6	0.6363636363636364	147	8337	21	7	126	8330	8484	0.3231052138799693
R1	cpdb	0	network_modules	281	TRUE	4.291263638378132e-30	66	33	17	0.5151515151515151	0.25757575757575757	GO:1902600	GO:BP	proton transmembrane transport	16175	22372		0.05555555555555555	0.08108108108108109	66	16109	17	16	49	16093	16175	0.36249138540707276
R1	cpdb	0	network_modules	281	TRUE	1.7084417365227728e-28	80	33	17	0.5151515151515151	0.2125	GO:0051453	GO:BP	regulation of intracellular pH	16175	13714		0.08333333333333333	0.10810810810810811	80	16095	17	16	63	16079	16175	0.3288344686044672
R1	cpdb	0	network_modules	281	TRUE	1.809448092252732e-28	182	31	21	0.6774193548387096	0.11538461538461539	REAC:R-HSA-983712	REAC	Ion channel transport	10916	1272		0.6666666666666666	0.7	182	10734	21	10	161	10724	10916	0.27539027028312063
R1	cpdb	0	network_modules	281	TRUE	2.7226394558294556e-28	82	33	17	0.5151515151515151	0.2073170731707317	GO:0030641	GO:BP	regulation of cellular pH	16175	6868		0.1111111111111111	0.13513513513513514	82	16093	17	16	65	16077	16175	0.3247409994744699
R1	cpdb	0	network_modules	281	TRUE	5.350757232878306e-28	85	33	17	0.5151515151515151	0.2	GO:0006885	GO:BP	regulation of pH	16175	2541		0.1388888888888889	0.16216216216216217	85	16090	17	16	68	16074	16175	0.3188725442425486
R1	cpdb	0	network_modules	281	TRUE	2.6405136117093233e-25	156	33	18	0.5454545454545454	0.11538461538461539	GO:0016241	GO:BP	regulation of macroautophagy	16175	5183		0.16666666666666666	0.1891891891891892	156	16019	18	15	138	16004	16175	0.24788681580760027
R1	cpdb	0	network_modules	281	TRUE	1.4992299248490573e-23	157	31	18	0.5806451612903226	0.11464968152866242	REAC:R-HSA-9711097	REAC	Cellular response to starvation	10916	337		0.7777777777777778	0.8	157	10759	18	13	139	10746	10916	0.25381206276793766
R1	cpdb	0	network_modules	281	TRUE	7.608883795906762e-23	330	28	21	0.75	0.06363636363636363	KEGG:05165	KEGG	Human papillomavirus infection	8484	446		0.7	0.7272727272727273	330	8154	21	7	309	8147	8484	0.21163501842967836
R1	cpdb	0	network_modules	281	TRUE	1.2289457601015522e-21	309	33	19	0.5757575757575758	0.061488673139158574	GO:0016236	GO:BP	macroautophagy	16175	5179		0.19444444444444445	0.21621621621621623	309	15866	19	14	290	15852	16175	0.18386326737998196
R1	cpdb	0	network_modules	281	TRUE	1.4476160354856985e-19	21	33	10	0.30303030303030304	0.47619047619047616	GO:0007042	GO:BP	lysosomal lumen acidification	16175	2646		0.2222222222222222	0.24324324324324326	21	16154	10	23	11	16131	16175	0.3788735411988812
R1	cpdb	0	network_modules	281	TRUE	2.0146198353255372e-19	324	33	18	0.5454545454545454	0.05555555555555555	GO:0010506	GO:BP	regulation of autophagy	16175	4181		0.25	0.2702702702702703	324	15851	18	15	306	15836	16175	0.16956310206765432
R1	cpdb	0	network_modules	281	TRUE	6.496156010488633e-19	507	31	21	0.6774193548387096	0.04142011834319527	REAC:R-HSA-9006934	REAC	Signaling by Receptor Tyrosine Kinases	10916	2302		0.8888888888888888	0.9	507	10409	21	10	486	10399	10916	0.16000478819700537
R1	cpdb	0	network_modules	281	TRUE	5.33737431251711e-18	28	33	10	0.30303030303030304	0.35714285714285715	GO:0035751	GO:BP	regulation of lysosomal lumen pH	16175	9214		0.2777777777777778	0.2972972972972973	28	16147	10	23	18	16124	16175	0.32771451752075603
R1	cpdb	0	network_modules	281	TRUE	8.63833949604916e-18	491	33	19	0.5757575757575758	0.038696537678207736	GO:0061919	GO:BP	process utilizing autophagic mechanism	16175	15723		0.3055555555555556	0.35135135135135137	491	15684	19	14	472	15670	16175	0.14373754464634955
R1	cpdb	0	network_modules	281	TRUE	8.63833949604916e-18	491	33	19	0.5757575757575758	0.038696537678207736	GO:0006914	GO:BP	autophagy	16175	2563		0.3055555555555556	0.35135135135135137	491	15684	19	14	472	15670	16175	0.14373754464634955
R1	cpdb	0	network_modules	281	TRUE	2.4043240064013327e-17	422	33	18	0.5454545454545454	0.04265402843601896	GO:0030003	GO:BP	intracellular monoatomic cation homeostasis	16175	6648		0.3611111111111111	0.3783783783783784	422	15753	18	15	404	15738	16175	0.1473185115150421
R1	cpdb	0	network_modules	281	TRUE	2.849035411639088e-17	426	33	18	0.5454545454545454	0.04225352112676056	GO:0006873	GO:BP	intracellular monoatomic ion homeostasis	16175	2531		0.3888888888888889	0.40540540540540543	426	15749	18	15	408	15734	16175	0.14657403879726805
R1	cpdb	0	network_modules	281	TRUE	8.927076591552551e-17	12	33	8	0.24242424242424243	0.6666666666666666	GO:0048388	GO:BP	endosomal lumen acidification	16175	12723		0.4166666666666667	0.4594594594594595	12	16163	8	25	4	16138	16175	0.40134321533403366
R1	cpdb	0	network_modules	281	TRUE	8.927076591552551e-17	12	33	8	0.24242424242424243	0.6666666666666666	GO:0061795	GO:BP	Golgi lumen acidification	16175	15668		0.4166666666666667	0.4594594594594595	12	16163	8	25	4	16138	16175	0.40134321533403366
R1	cpdb	0	network_modules	281	TRUE	1.4826476010010078e-16	467	33	18	0.5454545454545454	0.03854389721627409	GO:0055080	GO:BP	monoatomic cation homeostasis	16175	14233		0.4722222222222222	0.4864864864864865	467	15708	18	15	449	15693	16175	0.13949019077132271
R1	cpdb	0	network_modules	281	TRUE	2.0097382157793152e-16	475	33	18	0.5454545454545454	0.037894736842105266	GO:0050801	GO:BP	monoatomic ion homeostasis	16175	13267		0.5	0.5135135135135135	475	15700	18	15	457	15685	16175	0.13821332639002834
R1	cpdb	0	network_modules	281	TRUE	1.6257022976614342e-15	534	33	18	0.5454545454545454	0.033707865168539325	GO:0055082	GO:BP	intracellular chemical homeostasis	16175	14235		0.5277777777777778	0.5405405405405406	534	15641	18	15	516	15626	16175	0.12967709173371794
R1	cpdb	0	network_modules	281	TRUE	6.056597935855012e-15	575	33	18	0.5454545454545454	0.03130434782608696	GO:0098662	GO:BP	inorganic cation transmembrane transport	16175	18818		0.5555555555555556	0.5675675675675675	575	15600	18	15	557	15585	16175	0.12451347924079224
R1	cpdb	0	network_modules	281	TRUE	6.441574109354983e-15	577	33	18	0.5454545454545454	0.03119584055459272	GO:0098655	GO:BP	monoatomic cation transmembrane transport	16175	18811		0.5833333333333334	0.5945945945945946	577	15598	18	15	559	15583	16175	0.12427532291981555
R1	cpdb	0	network_modules	281	TRUE	2.5067531880975408e-14	623	33	18	0.5454545454545454	0.028892455858747994	GO:0019725	GO:BP	cellular homeostasis	16175	6020		0.6111111111111112	0.6216216216216216	623	15552	18	15	605	15537	16175	0.11910789765705367
R1	cpdb	0	network_modules	281	TRUE	3.0541794335117447e-14	630	33	18	0.5454545454545454	0.02857142857142857	GO:0098660	GO:BP	inorganic ion transmembrane transport	16175	18816		0.6388888888888888	0.6486486486486487	630	15545	18	15	612	15530	16175	0.11836986667000218
R1	cpdb	0	network_modules	281	TRUE	9.291537479976157e-14	671	33	18	0.5454545454545454	0.026825633383010434	GO:0034220	GO:BP	monoatomic ion transmembrane transport	16175	8508		0.6666666666666666	0.6756756756756757	671	15504	18	15	653	15489	16175	0.11427330806693725
R1	cpdb	0	network_modules	281	TRUE	6.267034126795286e-13	748	33	18	0.5454545454545454	0.02406417112299465	GO:0006812	GO:BP	monoatomic cation transport	16175	2492		0.6944444444444444	0.7027027027027027	748	15427	18	15	730	15412	16175	0.10747677406608737
R1	cpdb	0	network_modules	281	TRUE	8.872969562147338e-13	763	33	18	0.5454545454545454	0.023591087811271297	GO:0048878	GO:BP	chemical homeostasis	16175	13119		0.7222222222222222	0.7297297297297297	763	15412	18	15	745	15397	16175	0.10626906893763906
R1	cpdb	0	network_modules	281	TRUE	4.200324826691753e-12	96	33	10	0.30303030303030304	0.10416666666666667	GO:0007040	GO:BP	lysosome organization	16175	2644		0.75	0.7837837837837838	96	16079	10	23	86	16056	16175	0.17488522303535425
R1	cpdb	0	network_modules	281	TRUE	4.200324826691753e-12	96	33	10	0.30303030303030304	0.10416666666666667	GO:0080171	GO:BP	lytic vacuole organization	16175	17845		0.75	0.7837837837837838	96	16079	10	23	86	16056	16175	0.17488522303535425
R1	cpdb	0	network_modules	281	TRUE	3.097615889876988e-11	11	33	6	0.18181818181818182	0.5454545454545454	GO:0036295	GO:BP	cellular response to increased oxygen levels	16175	9546		0.8055555555555556	0.8108108108108109	11	16164	6	27	5	16137	16175	0.3141678068289171
R1	cpdb	0	network_modules	281	TRUE	5.4865057016297116e-11	155	28	11	0.39285714285714285	0.07096774193548387	KEGG:04150	KEGG	mTOR signaling pathway	8484	284		0.8	0.8181818181818182	155	8329	11	17	144	8312	8484	0.16094894758667946
R1	cpdb	0	network_modules	281	TRUE	6.186363406370848e-11	12	33	6	0.18181818181818182	0.5	GO:0036296	GO:BP	response to increased oxygen levels	16175	9547		0.8333333333333334	0.8378378378378378	12	16163	6	27	6	16136	16175	0.30069941346699086
R1	cpdb	0	network_modules	281	TRUE	8.062344001341247e-9	202	33	10	0.30303030303030304	0.04950495049504951	GO:0007033	GO:BP	vacuole organization	16175	2638		0.8611111111111112	0.8648648648648649	202	15973	10	23	192	15950	16175	0.11829391957389494
R1	cpdb	0	network_modules	281	TRUE	1.0439671937787371e-8	88	33	8	0.24242424242424243	0.09090909090909091	GO:0007032	GO:BP	endosome organization	16175	2637		0.8888888888888888	0.8918918918918919	88	16087	8	25	80	16062	16175	0.14566737170107194
R1	cpdb	0	network_modules	281	TRUE	1.2844522642968218e-8	131	28	9	0.32142857142857145	0.06870229007633588	KEGG:04142	KEGG	Lysosome	8484	279		0.9	0.9090909090909091	131	8353	9	19	122	8334	8484	0.1428053007250897
R1	cpdb	0	network_modules	281	TRUE	1.7089666351388347e-7	175	28	9	0.32142857142857145	0.05142857142857143	KEGG:05152	KEGG	Tuberculosis	8484	440		1	1	175	8309	9	19	166	8290	8484	0.12178219422558909
R1	cpdb	0	network_modules	281	TRUE	3.465390692898664e-6	61	33	6	0.18181818181818182	0.09836065573770492	GO:0006879	GO:BP	intracellular iron ion homeostasis	16175	2535		0.9166666666666666	0.918918918918919	61	16114	6	27	55	16087	16175	0.13133802462584396
R1	cpdb	0	network_modules	281	TRUE	8.903457192913552e-5	104	33	6	0.18181818181818182	0.057692307692307696	GO:0071453	GO:BP	cellular response to oxygen levels	16175	16687		0.9444444444444444	0.9459459459459459	104	16071	6	27	98	16044	16175	0.09921688714613518
R1	cpdb	0	network_modules	281	TRUE	2.60663829723145e-4	315	33	8	0.24242424242424243	0.025396825396825397	GO:0016050	GO:BP	vesicle organization	16175	5082		0.9722222222222222	0.972972972972973	315	15860	8	25	307	15835	16175	0.07294956371277153
R1	cpdb	0	network_modules	281	TRUE	0.001693521603606657	171	33	6	0.18181818181818182	0.03508771929824561	GO:0070482	GO:BP	response to oxygen levels	16175	16143		1	1	171	16004	6	27	165	15977	16175	0.07570620694032472
R1	cpdb	0	network_modules	281	TRUE	0.0054806957006219795	18	31	3	0.0967741935483871	0.16666666666666666	REAC:R-HSA-163210	REAC	Formation of ATP by chemiosmotic coupling	10916	944		1	1	18	10898	3	28	15	10870	10916	0.12511698162669982
R1	cpdb	0	network_modules	282	TRUE	5.808732420584431e-12	103	18	9	0.5	0.08737864077669903	REAC:R-HSA-211945	REAC	Phase I - Functionalization of compounds	10916	1737		0	0.14285714285714285	103	10813	9	9	94	10804	10916	0.2062199190716913
R1	cpdb	0	network_modules	282	TRUE	3.8962255478051135e-10	55	20	7	0.35	0.12727272727272726	GO:0019369	GO:BP	arachidonate metabolic process	16175	5730		0	0.05555555555555555	55	16120	7	13	48	16107	16175	0.2094932882362232
R1	cpdb	0	network_modules	282	TRUE	1.5862875265085658e-9	64	18	7	0.3888888888888889	0.109375	REAC:R-HSA-211897	REAC	Cytochrome P450 - arranged by substrate type	10916	423		0.16666666666666666	0.2857142857142857	64	10852	7	11	57	10841	10916	0.20389645736213202
R1	cpdb	0	network_modules	282	TRUE	2.1087676883029594e-9	128	20	8	0.4	0.0625	GO:0120254	GO:BP	olefinic compound metabolic process	16175	19583		0.058823529411764705	0.1111111111111111	128	16047	8	12	120	16035	16175	0.15569900715544174
R1	cpdb	0	network_modules	282	TRUE	4.8572884481246536e-9	215	18	9	0.5	0.04186046511627907	REAC:R-HSA-211859	REAC	Biological oxidations	10916	227		0.3333333333333333	0.42857142857142855	215	10701	9	9	206	10692	10916	0.14047896424015544
R1	cpdb	0	network_modules	282	TRUE	2.0973731209676862e-8	18	20	5	0.25	0.2777777777777778	GO:0019373	GO:BP	epoxygenase P450 pathway	16175	5734		0.11764705882352941	0.16666666666666666	18	16157	5	15	13	16142	16175	0.26265864724786114
R1	cpdb	0	network_modules	282	TRUE	2.5767985989085122e-8	98	20	7	0.35	0.07142857142857142	GO:0033559	GO:BP	unsaturated fatty acid metabolic process	16175	8288		0.17647058823529413	0.2222222222222222	98	16077	7	13	91	16064	16175	0.15594611128013944
R1	cpdb	0	network_modules	282	TRUE	2.770900728826242e-8	99	20	7	0.35	0.0707070707070707	GO:0001676	GO:BP	long-chain fatty acid metabolic process	16175	380		0.23529411764705882	0.2777777777777778	99	16076	7	13	92	16063	16175	0.1551334408752378
R1	cpdb	0	network_modules	282	TRUE	5.156954104452322e-8	108	20	7	0.35	0.06481481481481481	GO:0006690	GO:BP	icosanoid metabolic process	16175	2398		0.29411764705882354	0.3333333333333333	108	16067	7	13	101	16054	16175	0.1483301607376345
R1	cpdb	0	network_modules	282	TRUE	6.773284301928767e-8	23	18	5	0.2777777777777778	0.21739130434782608	REAC:R-HSA-211981	REAC	Xenobiotics	10916	2677		0.5	0.5714285714285714	23	10893	5	13	18	10880	10916	0.24433148875898153
R1	cpdb	0	network_modules	282	TRUE	2.1557493933792847e-6	15	18	4	0.2222222222222222	0.26666666666666666	REAC:R-HSA-211935	REAC	Fatty acids	10916	936		0.6666666666666666	0.7142857142857143	15	10901	4	14	11	10887	10916	0.24229320290385836
R1	cpdb	0	network_modules	282	TRUE	4.731782546364831e-6	67	15	5	0.3333333333333333	0.07462686567164178	KEGG:05204	KEGG	Chemical carcinogenesis - DNA adducts	8484	456		0	0.2	67	8417	5	10	62	8407	8484	0.1547319165285557
R1	cpdb	0	network_modules	282	TRUE	6.271181944105873e-6	116	20	6	0.3	0.05172413793103448	GO:0006805	GO:BP	xenobiotic metabolic process	16175	2487		0.35294117647058826	0.3888888888888889	116	16059	6	14	110	16045	16175	0.12210425962374406
R1	cpdb	0	network_modules	282	TRUE	7.838124071696251e-6	74	15	5	0.3333333333333333	0.06756756756756757	KEGG:00980	KEGG	Metabolism of xenobiotics by cytochrome P450	8484	154		0.25	0.4	74	8410	5	10	69	8400	8484	0.1469195675157578
R1	cpdb	0	network_modules	282	TRUE	2.306464841817896e-5	144	20	6	0.3	0.041666666666666664	GO:0071466	GO:BP	cellular response to xenobiotic stimulus	16175	16699		0.4117647058823529	0.4444444444444444	144	16031	6	14	138	16017	16175	0.10903917032421206
R1	cpdb	0	network_modules	282	TRUE	4.74348219972756e-5	6	20	3	0.15	0.5	GO:0009804	GO:BP	coumarin metabolic process	16175	3688		0.47058823529411764	0.5555555555555556	6	16169	3	17	3	16152	16175	0.27340379576328244
R1	cpdb	0	network_modules	282	TRUE	4.74348219972756e-5	6	20	3	0.15	0.5	GO:0009698	GO:BP	phenylpropanoid metabolic process	16175	3601		0.47058823529411764	0.5555555555555556	6	16169	3	17	3	16152	16175	0.27340379576328244
R1	cpdb	0	network_modules	282	TRUE	9.93781784363197e-5	319	20	7	0.35	0.0219435736677116	GO:0006631	GO:BP	fatty acid metabolic process	16175	2343		0.5882352941176471	0.6111111111111112	319	15856	7	13	312	15843	16175	0.0835783059725386
R1	cpdb	0	network_modules	282	TRUE	1.1196863745289113e-4	504	20	8	0.4	0.015873015873015872	GO:0032787	GO:BP	monocarboxylic acid metabolic process	16175	7822		0.6470588235294118	0.6666666666666666	504	15671	8	12	496	15659	16175	0.07469321312373406
R1	cpdb	0	network_modules	282	TRUE	1.2448313843254315e-4	191	20	6	0.3	0.031413612565445025	GO:0009410	GO:BP	response to xenobiotic stimulus	16175	3475		0.7058823529411765	0.7222222222222222	191	15984	6	14	185	15970	16175	0.09387020928811046
R1	cpdb	0	network_modules	282	TRUE	1.901628062032523e-4	11	18	3	0.16666666666666666	0.2727272727272727	REAC:R-HSA-211999	REAC	CYP2E1 reactions	10916	293		0.8333333333333334	0.8571428571428571	11	10905	3	15	8	10890	10916	0.21219354140982122
R1	cpdb	0	network_modules	282	TRUE	2.532890188986026e-4	12	18	3	0.16666666666666666	0.25	REAC:R-HSA-211958	REAC	Miscellaneous substrates	10916	1455		1	1	12	10904	3	15	9	10889	10916	0.20305681265188247
R1	cpdb	0	network_modules	282	TRUE	3.0592398440602056e-4	68	15	4	0.26666666666666666	0.058823529411764705	KEGG:00830	KEGG	Retinol metabolism	8484	127		0.5	0.6	68	8416	4	11	64	8405	8484	0.12207817773555966
R1	cpdb	0	network_modules	282	TRUE	3.286716547135475e-4	44	20	4	0.2	0.09090909090909091	GO:0019748	GO:BP	secondary metabolic process	16175	6032		0.7647058823529411	0.7777777777777778	44	16131	4	16	40	16115	16175	0.13326967450420388
R1	cpdb	0	network_modules	282	TRUE	0.0021401472827615228	742	20	8	0.4	0.01078167115902965	GO:0019752	GO:BP	carboxylic acid metabolic process	16175	6036		0.8235294117647058	0.8333333333333334	742	15433	8	12	734	15421	16175	0.05955762833349994
R1	cpdb	0	network_modules	282	TRUE	0.0025885670884508312	761	20	8	0.4	0.010512483574244415	GO:0043436	GO:BP	oxoacid metabolic process	16175	10693		0.8823529411764706	0.8888888888888888	761	15414	8	12	753	15402	16175	0.05865047772935041
R1	cpdb	0	network_modules	282	TRUE	0.0027459214364175116	767	20	8	0.4	0.010430247718383311	GO:0006082	GO:BP	organic acid metabolic process	16175	1947		0.9411764705882353	0.9444444444444444	767	15408	8	12	759	15396	16175	0.05837058842323638
R1	cpdb	0	network_modules	282	TRUE	0.002765848657560522	6	15	2	0.13333333333333333	0.3333333333333333	KEGG:00232	KEGG	Caffeine metabolism	8484	23		0.75	0.8	6	8478	2	13	4	8465	8484	0.2099601891181384
R1	cpdb	0	network_modules	282	TRUE	0.0056156173646279535	51	15	3	0.2	0.058823529411764705	KEGG:04913	KEGG	Ovarian steroidogenesis	8484	370		1	1	51	8433	3	12	48	8421	8484	0.1056161866392846
R1	cpdb	0	network_modules	282	TRUE	0.006403418026022153	3	20	2	0.1	0.6666666666666666	GO:0048252	GO:BP	lauric acid metabolic process	16175	12608		1	1	3	16172	2	18	1	16154	16175	0.25790340281345747
R1	cpdb	0	network_modules	283	TRUE	1.1276674621664878e-17	16	19	8	0.42105263157894735	0.5	GO:0090110	GO:BP	COPII-coated vesicle cargo loading	16175	18028		0	0.125	16	16159	8	11	8	16148	16175	0.45824932241034105
R1	cpdb	0	network_modules	283	TRUE	1.6099977140213493e-16	40	19	9	0.47368421052631576	0.225	GO:0090114	GO:BP	COPII-coated vesicle budding	16175	18031		0.14285714285714285	0.25	40	16135	9	10	31	16125	16175	0.32535339684906545
R1	cpdb	0	network_modules	283	TRUE	1.5736004715867e-14	34	19	8	0.42105263157894735	0.23529411764705882	GO:0035459	GO:BP	vesicle cargo loading	16175	9047		0.2857142857142857	0.375	34	16141	8	11	26	16130	16175	0.3136984191663067
R1	cpdb	0	network_modules	283	TRUE	6.385273031741249e-14	74	19	9	0.47368421052631576	0.12162162162162163	GO:0006900	GO:BP	vesicle budding from membrane	16175	2553		0.42857142857142855	0.5	74	16101	9	10	65	16091	16175	0.2383888170059331
R1	cpdb	0	network_modules	283	TRUE	8.514266090300079e-13	29	15	7	0.4666666666666667	0.2413793103448276	REAC:R-HSA-983170	REAC	Antigen Presentation: Folding, assembly and peptide loading of class I MHC	10916	151		0	0.07142857142857142	29	10887	7	8	22	10879	10916	0.3343876517087212
R1	cpdb	0	network_modules	283	TRUE	2.8980715648035826e-12	68	15	8	0.5333333333333333	0.11764705882352941	REAC:R-HSA-204005	REAC	COPII-mediated vesicle transport	10916	280		0.07692307692307693	0.14285714285714285	68	10848	8	7	60	10841	10916	0.2485094790421435
R1	cpdb	0	network_modules	283	TRUE	9.240341640112224e-12	126	19	9	0.47368421052631576	0.07142857142857142	GO:0006888	GO:BP	endoplasmic reticulum to Golgi vesicle-mediated transport	16175	2544		0.5714285714285714	0.625	126	16049	9	10	117	16039	16175	0.18173241901853918
R1	cpdb	0	network_modules	283	TRUE	1.2885891561399896e-9	168	13	8	0.6153846153846154	0.047619047619047616	KEGG:04141	KEGG	Protein processing in endoplasmic reticulum	8484	278		0	0.5	168	8316	8	5	160	8311	8484	0.1674692752730079
R1	cpdb	0	network_modules	283	TRUE	2.564496417200622e-9	155	15	8	0.5333333333333333	0.05161290322580645	REAC:R-HSA-199977	REAC	ER to Golgi Anterograde Transport	10916	823		0.15384615384615385	0.21428571428571427	155	10761	8	7	147	10754	10916	0.16276584955967363
R1	cpdb	0	network_modules	283	TRUE	1.1172511031015926e-8	186	15	8	0.5333333333333333	0.043010752688172046	REAC:R-HSA-948021	REAC	Transport to the Golgi and subsequent modification	10916	2604		0.23076923076923078	0.2857142857142857	186	10730	8	7	178	10723	10916	0.14798470688968396
R1	cpdb	0	network_modules	283	TRUE	1.4961934204299024e-8	284	19	9	0.47368421052631576	0.03169014084507042	GO:0048193	GO:BP	Golgi vesicle transport	16175	12570		0.7142857142857143	0.75	284	15891	9	10	275	15881	16175	0.11909799518903008
R1	cpdb	0	network_modules	283	TRUE	3.646607343260008e-8	123	15	7	0.4666666666666667	0.056910569105691054	REAC:R-HSA-2132295	REAC	MHC class II antigen presentation	10916	1371		0.3076923076923077	0.35714285714285715	123	10793	7	8	116	10785	10916	0.16004577992524288
R1	cpdb	0	network_modules	283	TRUE	3.782959786792514e-8	315	19	9	0.47368421052631576	0.02857142857142857	GO:0016050	GO:BP	vesicle organization	16175	5082		0.8571428571428571	0.875	315	15860	9	10	306	15850	16175	0.11272071013445045
R1	cpdb	0	network_modules	283	TRUE	1.7000247011633127e-7	33	15	5	0.3333333333333333	0.15151515151515152	REAC:R-HSA-5694530	REAC	Cargo concentration in the ER	10916	308		0.38461538461538464	0.42857142857142855	33	10883	5	10	28	10873	10916	0.22318589796482674
R1	cpdb	0	network_modules	283	TRUE	5.787564453958473e-7	305	15	8	0.5333333333333333	0.02622950819672131	REAC:R-HSA-446203	REAC	Asparagine N-linked glycosylation	10916	169		0.46153846153846156	0.5	305	10611	8	7	297	10604	10916	0.11375667005805568
R1	cpdb	0	network_modules	283	TRUE	1.0236410534683594e-6	657	19	10	0.5263157894736842	0.015220700152207	GO:0061024	GO:BP	membrane organization	16175	15141		1	1	657	15518	10	9	647	15509	16175	0.08437611464425357
R1	cpdb	0	network_modules	283	TRUE	2.024301941989132e-6	53	15	5	0.3333333333333333	0.09433962264150944	REAC:R-HSA-1655829	REAC	Regulation of cholesterol biosynthesis by SREBP (SREBF)	10916	2023		0.5384615384615384	0.5714285714285714	53	10863	5	10	48	10853	10916	0.17529500819546381
R1	cpdb	0	network_modules	283	TRUE	2.2594090370699298e-6	120	15	6	0.4	0.05	REAC:R-HSA-9705671	REAC	SARS-CoV-2 activates/modulates innate and adaptive immune responses	10916	2123		0.6153846153846154	0.6428571428571429	120	10796	6	9	114	10787	10916	0.13839210014080633
R1	cpdb	0	network_modules	283	TRUE	1.5362568861535632e-5	292	15	7	0.4666666666666667	0.023972602739726026	REAC:R-HSA-9694516	REAC	SARS-CoV-2 Infection	10916	2122		0.6923076923076923	0.7142857142857143	292	10624	7	8	285	10616	10916	0.10113726783378557
R1	cpdb	0	network_modules	283	TRUE	4.401185296673171e-5	197	15	6	0.4	0.030456852791878174	REAC:R-HSA-9705683	REAC	SARS-CoV-2-host interactions	10916	2128		0.7692307692307693	0.7857142857142857	197	10719	6	9	191	10710	10916	0.1064328700034355
R1	cpdb	0	network_modules	283	TRUE	9.321419383045515e-5	380	15	7	0.4666666666666667	0.018421052631578946	REAC:R-HSA-983169	REAC	Class I MHC mediated antigen processing & presentation	10916	368		0.8461538461538461	0.8571428571428571	380	10536	7	8	373	10528	10916	0.08739460871150842
R1	cpdb	0	network_modules	283	TRUE	3.351011341976559e-4	459	15	7	0.4666666666666667	0.015250544662309368	REAC:R-HSA-9679506	REAC	SARS-CoV Infections	10916	2112		0.9230769230769231	0.9285714285714286	459	10457	7	8	452	10449	10916	0.07848104811519194
R1	cpdb	0	network_modules	283	TRUE	3.8616745465660775e-4	197	13	5	0.38461538461538464	0.025380710659898477	KEGG:05130	KEGG	Pathogenic Escherichia coli infection	8484	427		1	1	197	8287	5	8	192	8279	8484	0.09400600553381656
R1	cpdb	0	network_modules	283	TRUE	4.136075593347101e-4	152	15	5	0.3333333333333333	0.03289473684210526	REAC:R-HSA-8957322	REAC	Metabolism of steroids	10916	1438		1	1	152	10764	5	10	147	10754	10916	0.10111468913250354
R1	cpdb	0	network_modules	284	TRUE	5.9267028519132406e-27	545	34	25	0.7352941176470589	0.045871559633027525	GO:0051276	GO:BP	chromosome organization	16175	13613		0	0.02040816326530612	545	15630	25	9	520	15621	16175	0.17845571445489147
R1	cpdb	0	network_modules	284	TRUE	5.5699204249462174e-24	53	34	14	0.4117647058823529	0.2641509433962264	GO:0007062	GO:BP	sister chromatid cohesion	16175	2660		0.020833333333333332	0.04081632653061224	53	16122	14	20	39	16102	16175	0.32805788904774663
R1	cpdb	0	network_modules	284	TRUE	1.166643211820262e-23	11	29	10	0.3448275862068966	0.9090909090909091	REAC:R-HSA-2468052	REAC	Establishment of Sister Chromatid Cohesion	10916	864		0	0.05263157894736842	11	10905	10	19	1	10886	10916	0.559281218550026
R1	cpdb	0	network_modules	284	TRUE	3.254944972388812e-20	29	34	11	0.3235294117647059	0.3793103448275862	GO:0007064	GO:BP	mitotic sister chromatid cohesion	16175	2662		0.041666666666666664	0.061224489795918366	29	16146	11	23	18	16123	16175	0.3490498198163781
R1	cpdb	0	network_modules	284	TRUE	1.3494589949874303e-17	10	29	8	0.27586206896551724	0.8	REAC:R-HSA-2470946	REAC	Cohesin Loading onto Chromatin	10916	383		0.05555555555555555	0.10526315789473684	10	10906	8	21	2	10885	10916	0.469054218242335
R1	cpdb	0	network_modules	284	TRUE	4.3036828761237456e-17	72	29	12	0.41379310344827586	0.16666666666666666	REAC:R-HSA-3108214	REAC	SUMOylation of DNA damage response and repair proteins	10916	2168		0.1111111111111111	0.15789473684210525	72	10844	12	17	60	10827	10916	0.25962845025435716
R1	cpdb	0	network_modules	284	TRUE	2.8284166131335975e-16	229	34	15	0.4411764705882353	0.06550218340611354	GO:0033044	GO:BP	regulation of chromosome organization	16175	7999		0.0625	0.08163265306122448	229	15946	15	19	214	15927	16175	0.16589065581847798
R1	cpdb	0	network_modules	284	TRUE	3.83966915709459e-16	13	29	8	0.27586206896551724	0.6153846153846154	REAC:R-HSA-68884	REAC	Mitotic Telophase/Cytokinesis	10916	1487		0.16666666666666666	0.21052631578947367	13	10903	8	21	5	10882	10916	0.41103309239998237
R1	cpdb	0	network_modules	284	TRUE	4.981646844725701e-15	157	15	11	0.7333333333333333	0.07006369426751592	KEGG:04110	KEGG	Cell cycle	8484	264		0	0.5	157	8327	11	4	146	8323	8484	0.22322231928377625
R1	cpdb	0	network_modules	284	TRUE	6.0350734268798175e-15	199	29	14	0.4827586206896552	0.07035175879396985	REAC:R-HSA-68877	REAC	Mitotic Prometaphase	10916	1484		0.2222222222222222	0.2631578947368421	199	10717	14	15	185	10702	10916	0.17920809568386617
R1	cpdb	0	network_modules	284	TRUE	6.9461095859877024e-15	361	34	16	0.47058823529411764	0.0443213296398892	GO:0007059	GO:BP	chromosome segregation	16175	2658		0.08333333333333333	0.10204081632653061	361	15814	16	18	345	15796	16175	0.13927834054741228
R1	cpdb	0	network_modules	284	TRUE	1.8662097392329975e-14	10	34	7	0.20588235294117646	0.7	GO:0034085	GO:BP	establishment of sister chromatid cohesion	16175	8396		0.10416666666666667	0.12244897959183673	10	16165	7	27	3	16138	16175	0.37900392323890936
R1	cpdb	0	network_modules	284	TRUE	2.8194437480094758e-14	178	34	13	0.38235294117647056	0.07303370786516854	GO:0000070	GO:BP	mitotic sister chromatid segregation	16175	24		0.125	0.14285714285714285	178	15997	13	21	165	15976	16175	0.16336939501324774
R1	cpdb	0	network_modules	284	TRUE	5.124576977262335e-14	11	34	7	0.20588235294117646	0.6363636363636364	GO:0140588	GO:BP	chromatin looping	16175	19829		0.14583333333333334	0.16326530612244897	11	16164	7	27	4	16137	16175	0.36126839618147044
R1	cpdb	0	network_modules	284	TRUE	1.5277948497835786e-13	406	29	16	0.5517241379310345	0.03940886699507389	REAC:R-HSA-68886	REAC	M Phase	10916	1343		0.2777777777777778	0.3157894736842105	406	10510	16	13	390	10497	10916	0.14033164240333176
R1	cpdb	0	network_modules	284	TRUE	2.295329539190721e-13	277	34	14	0.4117647058823529	0.05054151624548736	GO:0098813	GO:BP	nuclear chromosome segregation	16175	18900		0.16666666666666666	0.1836734693877551	277	15898	14	20	263	15878	16175	0.1396072474365986
R1	cpdb	0	network_modules	284	TRUE	3.835046824009485e-13	217	34	13	0.38235294117647056	0.059907834101382486	GO:0000819	GO:BP	sister chromatid segregation	16175	237		0.1875	0.20408163265306123	217	15958	13	21	204	15937	16175	0.14718103448483805
R1	cpdb	0	network_modules	284	TRUE	5.523433506512517e-13	379	34	15	0.4411764705882353	0.0395778364116095	GO:0000280	GO:BP	nuclear division	16175	78		0.20833333333333334	0.22448979591836735	379	15796	15	19	364	15777	16175	0.1267467644325718
R1	cpdb	0	network_modules	284	TRUE	7.878754614615378e-13	28	34	8	0.23529411764705882	0.2857142857142857	GO:0051984	GO:BP	positive regulation of chromosome segregation	16175	14046		0.22916666666666666	0.24489795918367346	28	16147	8	26	20	16121	16175	0.2578681656355263
R1	cpdb	0	network_modules	284	TRUE	2.1331433323304352e-12	171	29	12	0.41379310344827586	0.07017543859649122	REAC:R-HSA-3108232	REAC	SUMO E3 ligases SUMOylate target proteins	10916	2163		0.3333333333333333	0.3684210526315789	171	10745	12	17	159	10728	10916	0.16547405078155375
R1	cpdb	0	network_modules	284	TRUE	2.518125552381525e-12	8	34	6	0.17647058823529413	0.75	GO:1905821	GO:BP	positive regulation of chromosome condensation	16175	24931		0.25	0.2653061224489796	8	16167	6	28	2	16139	16175	0.36325554538171534
R1	cpdb	0	network_modules	284	TRUE	2.7035115276734176e-12	252	34	13	0.38235294117647056	0.051587301587301584	GO:0140014	GO:BP	mitotic nuclear division	16175	19633		0.2708333333333333	0.2857142857142857	252	15923	13	21	239	15902	16175	0.13592632492439066
R1	cpdb	0	network_modules	284	TRUE	2.9119592547111656e-12	424	34	15	0.4411764705882353	0.03537735849056604	GO:0048285	GO:BP	organelle fission	16175	12627		0.2916666666666667	0.30612244897959184	424	15751	15	19	409	15732	16175	0.1192040735043437
R1	cpdb	0	network_modules	284	TRUE	3.24258911681322e-12	177	29	12	0.41379310344827586	0.06779661016949153	REAC:R-HSA-2990846	REAC	SUMOylation	10916	2167		0.3888888888888889	0.42105263157894735	177	10739	12	17	165	10722	10916	0.16246604637378328
R1	cpdb	0	network_modules	284	TRUE	4.891616632400493e-12	18	34	7	0.20588235294117646	0.3888888888888889	GO:0007076	GO:BP	mitotic chromosome condensation	16175	2665		0.3125	0.32653061224489793	18	16157	7	27	11	16130	16175	0.2818819296714994
R1	cpdb	0	network_modules	284	TRUE	1.8829914384086496e-11	10	34	6	0.17647058823529413	0.6	GO:0060623	GO:BP	regulation of chromosome condensation	16175	14800		0.3333333333333333	0.3469387755102041	10	16165	6	28	4	16137	16175	0.3246974302735963
R1	cpdb	0	network_modules	284	TRUE	2.3607505126875237e-10	29	34	7	0.20588235294117646	0.2413793103448276	GO:1905820	GO:BP	positive regulation of chromosome separation	16175	24930		0.3541666666666667	0.3673469387755102	29	16146	7	27	22	16119	16175	0.22141530542373622
R1	cpdb	0	network_modules	284	TRUE	4.733092314735542e-10	209	34	11	0.3235294117647059	0.05263157894736842	GO:0090068	GO:BP	positive regulation of cell cycle process	16175	17994		0.375	0.3877551020408163	209	15966	11	23	198	15943	16175	0.12622933442945578
R1	cpdb	0	network_modules	284	TRUE	5.830611800808454e-10	98	34	9	0.2647058823529412	0.09183673469387756	GO:2001252	GO:BP	positive regulation of chromosome organization	16175	26441		0.3958333333333333	0.40816326530612246	98	16077	9	25	89	16052	16175	0.1529715552958722
R1	cpdb	0	network_modules	284	TRUE	1.0082224192394394e-9	35	34	7	0.20588235294117646	0.2	GO:0030261	GO:BP	chromosome condensation	16175	6749		0.4166666666666667	0.42857142857142855	35	16140	7	27	28	16113	16175	0.20121634401192165
R1	cpdb	0	network_modules	284	TRUE	1.053032530002165e-9	7	34	5	0.14705882352941177	0.7142857142857143	GO:0034087	GO:BP	establishment of mitotic sister chromatid cohesion	16175	8398		0.4375	0.4489795918367347	7	16168	5	29	2	16139	16175	0.32355827730659475
R1	cpdb	0	network_modules	284	TRUE	2.1545631451704384e-9	162	29	10	0.3448275862068966	0.06172839506172839	REAC:R-HSA-69242	REAC	S Phase	10916	2111		0.4444444444444444	0.47368421052631576	162	10754	10	19	152	10735	10916	0.14085189772942128
R1	cpdb	0	network_modules	284	TRUE	5.048906927036021e-9	76	29	8	0.27586206896551724	0.10526315789473684	REAC:R-HSA-1221632	REAC	Meiotic synapsis	10916	1412		0.5	0.5263157894736842	76	10840	8	21	68	10819	10916	0.16690812383708517
R1	cpdb	0	network_modules	284	TRUE	5.069568214808076e-9	124	34	9	0.2647058823529412	0.07258064516129033	GO:0051983	GO:BP	regulation of chromosome segregation	16175	14045		0.4583333333333333	0.46938775510204084	124	16051	9	25	115	16026	16175	0.1352561112920944
R1	cpdb	0	network_modules	284	TRUE	6.084349546006854e-9	264	34	11	0.3235294117647059	0.041666666666666664	GO:0045787	GO:BP	positive regulation of cell cycle	16175	11619		0.4791666666666667	0.4897959183673469	264	15911	11	23	253	15888	16175	0.11127567745231971
R1	cpdb	0	network_modules	284	TRUE	6.31052901739026e-9	123	29	9	0.3103448275862069	0.07317073170731707	REAC:R-HSA-2500257	REAC	Resolution of Sister Chromatid Cohesion	10916	2079		0.5555555555555556	0.5789473684210527	123	10793	9	20	114	10773	10916	0.1462405236412527
R1	cpdb	0	network_modules	284	TRUE	6.7726872489927604e-9	128	34	9	0.2647058823529412	0.0703125	GO:0018205	GO:BP	peptidyl-lysine modification	16175	5364		0.5	0.5102040816326531	128	16047	9	25	119	16022	16175	0.1330144565956393
R1	cpdb	0	network_modules	284	TRUE	1.4703078152330818e-8	11	29	5	0.1724137931034483	0.45454545454545453	REAC:R-HSA-2514853	REAC	Condensation of Prometaphase Chromosomes	10916	394		0.6111111111111112	0.631578947368421	11	10905	5	24	6	10881	10916	0.27882101597507336
R1	cpdb	0	network_modules	284	TRUE	2.531560699149683e-8	792	34	15	0.4411764705882353	0.01893939393939394	GO:0000278	GO:BP	mitotic cell cycle	16175	76		0.5208333333333334	0.5306122448979592	792	15383	15	19	777	15364	16175	0.08341733610059815
R1	cpdb	0	network_modules	284	TRUE	2.7110481522503944e-8	4	34	4	0.11764705882352941	1	GO:0034089	GO:BP	establishment of meiotic sister chromatid cohesion	16175	8400		0.5416666666666666	0.5510204081632653	4	16171	4	30	0	16141	16175	0.34267886307045897
R1	cpdb	0	network_modules	284	TRUE	3.10673913304041e-8	656	34	14	0.4117647058823529	0.021341463414634148	GO:1903047	GO:BP	mitotic cell cycle process	16175	22727		0.5625	0.5714285714285714	656	15519	14	20	642	15499	16175	0.08636791020008763
R1	cpdb	0	network_modules	284	TRUE	5.5823675905215624e-8	60	34	7	0.20588235294117646	0.11666666666666667	GO:0016925	GO:BP	protein sumoylation	16175	5258		0.5833333333333334	0.5918367346938775	60	16115	7	27	53	16088	16175	0.15263380927078526
R1	cpdb	0	network_modules	284	TRUE	1.5878770668933653e-7	116	29	8	0.27586206896551724	0.06896551724137931	REAC:R-HSA-1500620	REAC	Meiosis	10916	1410		0.6666666666666666	0.6842105263157895	116	10800	8	21	108	10779	10916	0.13350549372248172
R1	cpdb	0	network_modules	284	TRUE	1.7075514096950592e-7	70	34	7	0.20588235294117646	0.1	GO:1905818	GO:BP	regulation of chromosome separation	16175	24928		0.6041666666666666	0.6122448979591837	70	16105	7	27	63	16078	16175	0.14092305383080367
R1	cpdb	0	network_modules	284	TRUE	2.8639043032042387e-7	188	29	9	0.3103448275862069	0.047872340425531915	REAC:R-HSA-2467813	REAC	Separation of Sister Chromatids	10916	2204		0.7222222222222222	0.7368421052631579	188	10728	9	20	179	10708	10916	0.11628377388487364
R1	cpdb	0	network_modules	284	TRUE	3.086780443343148e-7	76	34	7	0.20588235294117646	0.09210526315789473	GO:0051304	GO:BP	chromosome separation	16175	13635		0.625	0.6326530612244898	76	16099	7	27	69	16072	16175	0.13502219652723138
R1	cpdb	0	network_modules	284	TRUE	1.28169237844947e-6	435	34	11	0.3235294117647059	0.02528735632183908	GO:0051052	GO:BP	regulation of DNA metabolic process	16175	13462		0.6458333333333334	0.6530612244897959	435	15740	11	23	424	15717	16175	0.08415801385838836
R1	cpdb	0	network_modules	284	TRUE	1.5265918484630238e-6	154	29	8	0.27586206896551724	0.05194805194805195	REAC:R-HSA-1474165	REAC	Reproduction	10916	2064		0.7777777777777778	0.7894736842105263	154	10762	8	21	146	10741	10916	0.11455009316998223
R1	cpdb	0	network_modules	284	TRUE	1.5735547915145897e-6	228	29	9	0.3103448275862069	0.039473684210526314	REAC:R-HSA-68882	REAC	Mitotic Anaphase	10916	1479		0.8333333333333334	0.8421052631578947	228	10688	9	20	219	10668	10916	0.10446682828327548
R1	cpdb	0	network_modules	284	TRUE	1.6351848143857947e-6	229	29	9	0.3103448275862069	0.039301310043668124	REAC:R-HSA-2555396	REAC	Mitotic Metaphase and Anaphase	10916	1482		0.8888888888888888	0.8947368421052632	229	10687	9	20	220	10667	10916	0.10421037069876657
R1	cpdb	0	network_modules	284	TRUE	2.878808810233599e-6	104	34	7	0.20588235294117646	0.0673076923076923	GO:0032204	GO:BP	regulation of telomere maintenance	16175	7396		0.6666666666666666	0.673469387755102	104	16071	7	27	97	16044	16175	0.11453026872148876
R1	cpdb	0	network_modules	284	TRUE	3.3200710703258647e-6	172	34	8	0.23529411764705882	0.046511627906976744	GO:0000724	GO:BP	double-strand break repair via homologous recombination	16175	203		0.6875	0.6938775510204082	172	16003	8	26	164	15977	16175	0.1005264107614963
R1	cpdb	0	network_modules	284	TRUE	3.9826773331546824e-6	176	34	8	0.23529411764705882	0.045454545454545456	GO:0000725	GO:BP	recombinational repair	16175	204		0.7083333333333334	0.7142857142857143	176	15999	8	26	168	15973	16175	0.099280518384865
R1	cpdb	0	network_modules	284	TRUE	4.57259065381634e-6	630	34	12	0.35294117647058826	0.01904761904761905	GO:0010564	GO:BP	regulation of cell cycle process	16175	4217		0.7291666666666666	0.7346938775510204	630	15545	12	22	618	15523	16175	0.0744854978360197
R1	cpdb	0	network_modules	284	TRUE	8.853930125524102e-6	11	34	4	0.11764705882352941	0.36363636363636365	GO:0051177	GO:BP	meiotic sister chromatid cohesion	16175	13557		0.75	0.7551020408163265	11	16164	4	30	7	16134	16175	0.20592596301999333
R1	cpdb	0	network_modules	284	TRUE	1.264968041117646e-5	298	34	9	0.2647058823529412	0.030201342281879196	GO:0006302	GO:BP	double-strand break repair	16175	2109		0.7708333333333334	0.7755102040816326	298	15877	9	25	289	15852	16175	0.08405422204113629
R1	cpdb	0	network_modules	284	TRUE	1.5674082089006534e-5	420	34	10	0.29411764705882354	0.023809523809523808	GO:0010638	GO:BP	positive regulation of organelle organization	16175	4284		0.7916666666666666	0.7959183673469388	420	15755	10	24	410	15731	16175	0.07738649090860913
R1	cpdb	0	network_modules	284	TRUE	4.0831110706263136e-5	152	34	7	0.20588235294117646	0.046052631578947366	GO:0000723	GO:BP	telomere maintenance	16175	202		0.8125	0.8163265306122449	152	16023	7	27	145	15996	16175	0.09346618541051033
R1	cpdb	0	network_modules	284	TRUE	6.328915606209968e-5	17	34	4	0.11764705882352941	0.23529411764705882	GO:0007063	GO:BP	regulation of sister chromatid cohesion	16175	2661		0.8333333333333334	0.8367346938775511	17	16158	4	30	13	16128	16175	0.16515210743572414
R1	cpdb	0	network_modules	284	TRUE	1.3614090354505592e-4	528	34	10	0.29411764705882354	0.01893939393939394	GO:0006281	GO:BP	DNA repair	16175	2095		0.8541666666666666	0.8571428571428571	528	15647	10	24	518	15623	16175	0.06753294141174716
R1	cpdb	0	network_modules	284	TRUE	1.4112237990598537e-4	182	34	7	0.20588235294117646	0.038461538461538464	GO:0032200	GO:BP	telomere organization	16175	7392		0.875	0.8775510204081632	182	15993	7	27	175	15966	16175	0.08468930881669505
R1	cpdb	0	network_modules	284	TRUE	1.5359722801588864e-4	281	34	8	0.23529411764705882	0.028469750889679714	GO:0006310	GO:BP	DNA recombination	16175	2115		0.8958333333333334	0.8979591836734694	281	15894	8	26	273	15868	16175	0.07655068864844469
R1	cpdb	0	network_modules	284	TRUE	6.92645072738134e-4	147	29	6	0.20689655172413793	0.04081632653061224	REAC:R-HSA-9018519	REAC	Estrogen-dependent gene expression	10916	866		0.9444444444444444	0.9473684210526315	147	10769	6	23	141	10746	10916	0.08661359625296199
R1	cpdb	0	network_modules	284	TRUE	0.0011777959722424531	9	34	3	0.08823529411764706	0.3333333333333333	GO:0045876	GO:BP	positive regulation of sister chromatid cohesion	16175	11682		0.9166666666666666	0.9183673469387755	9	16166	3	31	6	16135	16175	0.17064398330395733
R1	cpdb	0	network_modules	284	TRUE	0.002306882420340637	11	34	3	0.08823529411764706	0.2727272727272727	GO:0000722	GO:BP	telomere maintenance via recombination	16175	201		0.9375	0.9387755102040817	11	16164	3	31	8	16133	16175	0.15414515196616763
R1	cpdb	0	network_modules	284	TRUE	0.004121281177339753	131	15	4	0.26666666666666666	0.030534351145038167	KEGG:04114	KEGG	Oocyte meiosis	8484	268		1	1	131	8353	4	11	127	8342	8484	0.08575069250562355
R1	cpdb	0	network_modules	284	TRUE	0.0059874429678923695	798	34	10	0.29411764705882354	0.012531328320802004	GO:0006974	GO:BP	DNA damage response	16175	2601		0.9583333333333334	0.9591836734693877	798	15377	10	24	788	15353	16175	0.05187536958862705
R1	cpdb	0	network_modules	284	TRUE	0.006068804030900531	203	34	6	0.17647058823529413	0.029556650246305417	GO:0051321	GO:BP	meiotic cell cycle	16175	13648		0.9791666666666666	0.9795918367346939	203	15972	6	28	197	15944	16175	0.06758086543687168
R1	cpdb	0	network_modules	284	TRUE	0.006356273315805317	216	29	6	0.20689655172413793	0.027777777777777776	REAC:R-HSA-8939211	REAC	ESR-mediated signaling	10916	830		1	1	216	10700	6	23	210	10677	10916	0.06934010935603212
R1	cpdb	0	network_modules	284	TRUE	0.007875362653135244	638	34	9	0.2647058823529412	0.014106583072100314	GO:0018193	GO:BP	peptidyl-amino acid modification	16175	5353		1	1	638	15537	9	25	629	15512	16175	0.053114502055324496
R1	cpdb	0	network_modules	285	TRUE	1.9863489415034698e-16	54	13	9	0.6923076923076923	0.16666666666666666	REAC:R-HSA-5620924	REAC	Intraflagellar transport	10916	1267		0	0.1111111111111111	54	10862	9	4	45	10858	10916	0.3382947007392139
R1	cpdb	0	network_modules	285	TRUE	2.975547547031625e-13	200	13	10	0.7692307692307693	0.05	REAC:R-HSA-5617833	REAC	Cilium Assembly	10916	361		0.125	0.2222222222222222	200	10716	10	3	190	10713	10916	0.19333842632121018
R1	cpdb	0	network_modules	285	TRUE	1.3757524022872358e-11	292	13	10	0.7692307692307693	0.03424657534246575	REAC:R-HSA-1852241	REAC	Organelle biogenesis and maintenance	10916	1646		0.25	0.3333333333333333	292	10624	10	3	282	10621	10916	0.15889568761292697
R1	cpdb	0	network_modules	285	TRUE	3.793827021368766e-11	165	25	10	0.4	0.06060606060606061	GO:0099111	GO:BP	microtubule-based transport	16175	19044		0	0.05263157894736842	165	16010	10	15	155	15995	16175	0.1526269388249845
R1	cpdb	0	network_modules	285	TRUE	7.056779786525856e-10	144	25	9	0.36	0.0625	GO:0010970	GO:BP	transport along microtubule	16175	4546		0.05555555555555555	0.10526315789473684	144	16031	9	16	135	16015	16175	0.14705982897922473
R1	cpdb	0	network_modules	285	TRUE	1.9008311470965207e-9	348	25	11	0.44	0.031609195402298854	GO:0007018	GO:BP	microtubule-based movement	16175	2626		0.1111111111111111	0.15789473684210525	348	15827	11	14	337	15813	16175	0.11348000126018569
R1	cpdb	0	network_modules	285	TRUE	6.868216108350142e-9	185	25	9	0.36	0.04864864864864865	GO:0030705	GO:BP	cytoskeleton-dependent intracellular transport	16175	6886		0.16666666666666666	0.21052631578947367	185	15990	9	16	176	15974	16175	0.12897297461584997
R1	cpdb	0	network_modules	285	TRUE	1.1338975540524637e-7	368	25	10	0.4	0.02717391304347826	GO:0044782	GO:BP	cilium organization	16175	11155		0.2222222222222222	0.2631578947368421	368	15807	10	15	358	15792	16175	0.09954221682168227
R1	cpdb	0	network_modules	285	TRUE	5.581927234242217e-7	113	13	6	0.46153846153846156	0.05309734513274336	REAC:R-HSA-5610787	REAC	Hedgehog 'off' state	10916	1112		0.375	0.4444444444444444	113	10803	6	7	107	10796	10916	0.15392425538404342
R1	cpdb	0	network_modules	285	TRUE	1.6901630625459284e-6	343	25	9	0.36	0.026239067055393587	GO:0060271	GO:BP	cilium assembly	16175	14488		0.2777777777777778	0.3157894736842105	343	15832	9	16	334	15816	16175	0.09252292390445757
R1	cpdb	0	network_modules	285	TRUE	2.9723208393566142e-6	149	13	6	0.46153846153846156	0.040268456375838924	REAC:R-HSA-5358351	REAC	Signaling by Hedgehog	10916	2258		0.5	0.5555555555555556	149	10767	6	7	143	10760	10916	0.13328825514709064
R1	cpdb	0	network_modules	285	TRUE	5.685551403053565e-6	193	7	5	0.7142857142857143	0.025906735751295335	KEGG:04814	KEGG	Motor proteins	8484	366		NA	1	193	8291	5	2	188	8289	8484	0.13327905494184195
R1	cpdb	0	network_modules	285	TRUE	6.2792442274857806e-6	14	25	4	0.16	0.2857142857142857	GO:0035721	GO:BP	intraciliary retrograde transport	16175	9191		0.3333333333333333	0.3684210526315789	14	16161	4	21	10	16140	16175	0.2129090639560078
R1	cpdb	0	network_modules	285	TRUE	9.650123436907821e-6	45	25	5	0.2	0.1111111111111111	GO:0042073	GO:BP	intraciliary transport	16175	9956		0.3888888888888889	0.42105263157894735	45	16130	5	20	40	16110	16175	0.14731636136587412
R1	cpdb	0	network_modules	285	TRUE	3.8975773410252785e-5	59	25	5	0.2	0.0847457627118644	GO:0061512	GO:BP	protein localization to cilium	16175	15514		0.4444444444444444	0.47368421052631576	59	16116	5	20	54	16096	16175	0.12814734111234577
R1	cpdb	0	network_modules	285	TRUE	4.649883605893815e-5	5	25	3	0.12	0.6	GO:0072383	GO:BP	plus-end-directed vesicle transport along microtubule	16175	17377		0.5	0.5263157894736842	5	16170	3	22	2	16148	16175	0.26788542285229483
R1	cpdb	0	network_modules	285	TRUE	4.741888442270012e-5	503	25	9	0.36	0.017892644135188866	GO:0120031	GO:BP	plasma membrane bounded cell projection assembly	16175	19467		0.5555555555555556	0.5789473684210527	503	15672	9	16	494	15656	16175	0.07455026117547738
R1	cpdb	0	network_modules	285	TRUE	5.7124366337704784e-5	514	25	9	0.36	0.017509727626459144	GO:0030031	GO:BP	cell projection assembly	16175	6655		0.6111111111111112	0.631578947368421	514	15661	9	16	505	15645	16175	0.0736215848173377
R1	cpdb	0	network_modules	285	TRUE	7.330376762390319e-5	137	25	6	0.24	0.043795620437956206	GO:0031503	GO:BP	protein-containing complex localization	16175	7188		0.6666666666666666	0.6842105263157895	137	16038	6	19	131	16019	16175	0.09940315637605172
R1	cpdb	0	network_modules	285	TRUE	9.290279180855125e-5	6	25	3	0.12	0.5	GO:0072386	GO:BP	plus-end-directed organelle transport along microtubule	16175	17380		0.7222222222222222	0.7368421052631579	6	16169	3	22	3	16147	16175	0.2444260585285185
R1	cpdb	0	network_modules	285	TRUE	1.8212438380323567e-4	60	13	4	0.3076923076923077	0.06666666666666667	REAC:R-HSA-983189	REAC	Kinesins	10916	1292		0.625	0.6666666666666666	60	10856	4	9	56	10847	10916	0.14113673376648866
R1	cpdb	0	network_modules	285	TRUE	6.819893922019735e-4	42	25	4	0.16	0.09523809523809523	GO:0047496	GO:BP	vesicle transport along microtubule	16175	12458		0.7777777777777778	0.7894736842105263	42	16133	4	21	38	16112	16175	0.12169141141562201
R1	cpdb	0	network_modules	285	TRUE	0.0013700798805043372	99	13	4	0.3076923076923077	0.04040404040404041	REAC:R-HSA-6811434	REAC	COPI-dependent Golgi-to-ER retrograde traffic	10916	277		0.75	0.7777777777777778	99	10817	4	9	95	10808	10916	0.10877134882369989
R1	cpdb	0	network_modules	285	TRUE	0.0025326210516013283	586	25	8	0.32	0.013651877133105802	GO:0000226	GO:BP	microtubule cytoskeleton organization	16175	61		0.8333333333333334	0.8421052631578947	586	15589	8	17	578	15572	16175	0.05975007984929373
R1	cpdb	0	network_modules	285	TRUE	0.0032520548004773774	123	13	4	0.3076923076923077	0.032520325203252036	REAC:R-HSA-2132295	REAC	MHC class II antigen presentation	10916	1371		0.875	0.8888888888888888	123	10793	4	9	119	10784	10916	0.09697338750905073
R1	cpdb	0	network_modules	285	TRUE	0.004432847126425254	133	13	4	0.3076923076923077	0.03007518796992481	REAC:R-HSA-8856688	REAC	Golgi-to-ER retrograde transport	10916	1084		1	1	133	10783	4	9	129	10774	10916	0.09301143441224813
R1	cpdb	0	network_modules	285	TRUE	0.0045503206429510215	67	25	4	0.16	0.05970149253731343	GO:0099518	GO:BP	vesicle cytoskeletal trafficking	16175	19107		0.8888888888888888	0.8947368421052632	67	16108	4	21	63	16087	16175	0.09547691433934445
R1	cpdb	0	network_modules	285	TRUE	0.006421430465886786	73	25	4	0.16	0.0547945205479452	GO:0072384	GO:BP	organelle transport along microtubule	16175	17378		0.9444444444444444	0.9473684210526315	73	16102	4	21	69	16081	16175	0.0912683899285039
R1	cpdb	0	network_modules	285	TRUE	0.00968607883817013	178	25	5	0.2	0.028089887640449437	GO:0051650	GO:BP	establishment of vesicle localization	16175	13863		1	1	178	15997	5	20	173	15977	16175	0.07127708106195758
R1	cpdb	0	network_modules	286	TRUE	5.388696018601498e-4	89	5	3	0.6	0.033707865168539325	KEGG:05235	KEGG	PD-L1 expression and PD-1 checkpoint pathway in cancer	8484	480		NA	1	89	8395	3	2	86	8393	8484	0.14050731045787554
R1	cpdb	0	network_modules	286	TRUE	0.001078869374398922	791	13	7	0.5384615384615384	0.008849557522123894	GO:0000122	GO:BP	negative regulation of transcription by RNA polymerase II	16175	48		0	0.5	791	15384	7	6	784	15378	16175	0.06437992952179478
R1	cpdb	0	network_modules	286	TRUE	0.00658766283619541	44	13	3	0.23076923076923078	0.06818181818181818	GO:0140467	GO:BP	integrated stress response signaling	16175	19788		1	1	44	16131	3	10	41	16121	16175	0.12417654470808295
R1	cpdb	0	network_modules	287	TRUE	1.2867641987394804e-14	6	26	6	0.23076923076923078	1	GO:0042791	GO:BP	5S class rRNA transcription by RNA polymerase III	16175	10369		0	0.125	6	16169	6	20	0	16149	16175	0.48008726733743734
R1	cpdb	0	network_modules	287	TRUE	5.913400803137035e-12	11	26	6	0.23076923076923078	0.5454545454545454	GO:0042797	GO:BP	tRNA transcription by RNA polymerase III	16175	10374		0.14285714285714285	0.25	11	16164	6	20	5	16144	16175	0.35414699254434573
R1	cpdb	0	network_modules	287	TRUE	1.1814260472128798e-11	12	26	6	0.23076923076923078	0.5	GO:0009304	GO:BP	tRNA transcription	16175	3451		0.2857142857142857	0.375	12	16163	6	20	6	16143	16175	0.33898931050503
R1	cpdb	0	network_modules	287	TRUE	3.4346626581558074e-11	27	12	6	0.5	0.2222222222222222	REAC:R-HSA-76066	REAC	RNA Polymerase III Transcription Initiation From Type 2 Promoter	10916	1901		0	0.2	27	10889	6	6	21	10883	10916	0.3322780272849926
R1	cpdb	0	network_modules	287	TRUE	4.369325162856295e-11	28	12	6	0.5	0.21428571428571427	REAC:R-HSA-76061	REAC	RNA Polymerase III Transcription Initiation From Type 1 Promoter	10916	1900		0.25	0.4	28	10888	6	6	22	10882	10916	0.32624544696043073
R1	cpdb	0	network_modules	287	TRUE	2.2504745459821253e-10	36	12	6	0.5	0.16666666666666666	REAC:R-HSA-76046	REAC	RNA Polymerase III Transcription Initiation	10916	1899		0.5	0.6	36	10880	6	6	30	10874	10916	0.2874031453712724
R1	cpdb	0	network_modules	287	TRUE	5.182856051905483e-10	41	12	6	0.5	0.14634146341463414	REAC:R-HSA-749476	REAC	RNA Polymerase III Abortive And Retractive Initiation	10916	1896		0.75	1	41	10875	6	6	35	10869	10916	0.2691224798797442
R1	cpdb	0	network_modules	287	TRUE	5.182856051905483e-10	41	12	6	0.5	0.14634146341463414	REAC:R-HSA-74158	REAC	RNA Polymerase III Transcription	10916	1898		0.75	1	41	10875	6	6	35	10869	10916	0.2691224798797442
R1	cpdb	0	network_modules	287	TRUE	7.448350427576778e-9	30	26	6	0.23076923076923078	0.2	GO:0009303	GO:BP	rRNA transcription	16175	3450		0.42857142857142855	0.5	30	16145	6	20	24	16125	16175	0.21347736252124527
R1	cpdb	0	network_modules	287	TRUE	3.9619364154381805e-7	56	26	6	0.23076923076923078	0.10714285714285714	GO:0006383	GO:BP	transcription by RNA polymerase III	16175	2148		0.5714285714285714	0.625	56	16119	6	20	50	16099	16175	0.15527733976484914
R1	cpdb	0	network_modules	287	TRUE	3.531210531785394e-5	205	26	7	0.2692307692307692	0.03414634146341464	GO:0016072	GO:BP	rRNA metabolic process	16175	5099		0.7142857142857143	0.75	205	15970	7	19	198	15951	16175	0.09202640135702722
R1	cpdb	0	network_modules	287	TRUE	5.632604653316585e-4	186	26	6	0.23076923076923078	0.03225806451612903	GO:0006399	GO:BP	tRNA metabolic process	16175	2160		0.8571428571428571	0.875	186	15989	6	20	180	15969	16175	0.082522095270454
R1	cpdb	0	network_modules	287	TRUE	9.26069592752925e-4	192	8	4	0.5	0.020833333333333332	KEGG:05202	KEGG	Transcriptional misregulation in cancer	8484	454		NA	1	192	8292	4	4	188	8288	8484	0.09861075447712572
R1	cpdb	0	network_modules	287	TRUE	0.0012520473418277992	512	26	8	0.3076923076923077	0.015625	GO:0009790	GO:BP	embryo development	16175	3677		1	1	512	15663	8	18	504	15645	16175	0.06326381583753041
R1	cpdb	0	network_modules	288	TRUE	1.2885891561399896e-9	168	13	8	0.6153846153846154	0.047619047619047616	KEGG:04141	KEGG	Protein processing in endoplasmic reticulum	8484	278		0	0.3333333333333333	168	8316	8	5	160	8311	8484	0.1674692752730079
R1	cpdb	0	network_modules	288	TRUE	3.330947679633133e-6	18	17	4	0.23529411764705882	0.2222222222222222	GO:0006613	GO:BP	cotranslational protein targeting to membrane	16175	2328		0	0.5	18	16157	4	13	14	16144	16175	0.2278297982764335
R1	cpdb	0	network_modules	288	TRUE	6.356269039185122e-5	113	14	5	0.35714285714285715	0.04424778761061947	REAC:R-HSA-1799339	REAC	SRP-dependent cotranslational protein targeting to membrane	10916	2157		0	0.5	113	10803	5	9	108	10794	10916	0.12278094293211299
R1	cpdb	0	network_modules	288	TRUE	0.0016961737595818447	42	13	3	0.23076923076923078	0.07142857142857142	KEGG:00513	KEGG	Various types of N-glycan biosynthesis	8484	66		0.5	0.6666666666666666	42	8442	3	10	39	8432	8484	0.12604268545130584
R1	cpdb	0	network_modules	288	TRUE	0.0034276272296246573	53	13	3	0.23076923076923078	0.05660377358490566	KEGG:00510	KEGG	N-Glycan biosynthesis	8484	63		1	1	53	8431	3	10	50	8421	8484	0.11163150019413247
R1	cpdb	0	network_modules	288	TRUE	0.0051095107526758134	106	17	4	0.23529411764705882	0.03773584905660377	GO:0006612	GO:BP	protein targeting to membrane	16175	2327		1	1	106	16069	4	13	102	16056	16175	0.09195412487642704
R1	cpdb	0	network_modules	288	TRUE	0.006833625888015841	292	14	5	0.35714285714285715	0.017123287671232876	REAC:R-HSA-72766	REAC	Translation	10916	2565		1	1	292	10624	5	9	287	10615	10916	0.07337869944757598
R1	cpdb	0	network_modules	289	TRUE	2.75469158704386e-7	13	13	4	0.3076923076923077	0.3076923076923077	REAC:R-HSA-400511	REAC	Synthesis, secretion, and inactivation of Glucose-dependent Insulinotropic Polypeptide (GIP)	10916	2416		0	0.16666666666666666	13	10903	4	9	9	10894	10916	0.3068668468099817
R1	cpdb	0	network_modules	289	TRUE	1.1750445553345665e-6	18	13	4	0.3076923076923077	0.2222222222222222	REAC:R-HSA-422085	REAC	Synthesis, secretion, and deacylation of Ghrelin	10916	2414		0.2	0.3333333333333333	18	10898	4	9	14	10889	10916	0.26045667547536644
R1	cpdb	0	network_modules	289	TRUE	2.293699263146321e-6	21	13	4	0.3076923076923077	0.19047619047619047	REAC:R-HSA-381771	REAC	Synthesis, secretion, and inactivation of Glucagon-like Peptide-1 (GLP-1)	10916	2415		0.4	0.5	21	10895	4	9	17	10886	10916	0.24095265289158788
R1	cpdb	0	network_modules	289	TRUE	2.4592433723697874e-6	13	22	4	0.18181818181818182	0.3076923076923077	GO:0006465	GO:BP	signal peptide processing	16175	2206		NA	1	13	16162	4	18	9	16144	16175	0.2357344771929859
R1	cpdb	0	network_modules	289	TRUE	4.064259394234297e-6	24	13	4	0.3076923076923077	0.16666666666666666	REAC:R-HSA-400508	REAC	Incretin synthesis, secretion, and inactivation	10916	1180		0.6	0.6666666666666666	24	10892	4	9	20	10883	10916	0.225218996265265
R1	cpdb	0	network_modules	289	TRUE	4.1613954939806305e-6	31	12	4	0.3333333333333333	0.12903225806451613	KEGG:03060	KEGG	Protein export	8484	217		NA	1	31	8453	4	8	27	8445	8484	0.20563821927700032
R1	cpdb	0	network_modules	289	TRUE	8.549245917340224e-4	88	13	4	0.3076923076923077	0.045454545454545456	REAC:R-HSA-2980736	REAC	Peptide hormone metabolism	10916	1725		0.8	0.8333333333333334	88	10828	4	9	84	10819	10916	0.11569993475079886
R1	cpdb	0	network_modules	289	TRUE	0.0023217785727029636	113	13	4	0.3076923076923077	0.035398230088495575	REAC:R-HSA-1799339	REAC	SRP-dependent cotranslational protein targeting to membrane	10916	2157		1	1	113	10803	4	9	109	10794	10916	0.10143898598918756
R1	cpdb	0	network_modules	290	TRUE	4.837775483934965e-12	92	23	9	0.391304347826087	0.09782608695652174	GO:0061157	GO:BP	mRNA destabilization	16175	15262		0	0.02857142857142857	92	16083	9	14	83	16069	16175	0.1934965756319773
R1	cpdb	0	network_modules	290	TRUE	6.527748808673124e-12	95	23	9	0.391304347826087	0.09473684210526316	GO:0050779	GO:BP	RNA destabilization	16175	13253		0.029411764705882353	0.05714285714285714	95	16080	9	14	86	16066	16175	0.19034302584368246
R1	cpdb	0	network_modules	290	TRUE	7.927283342416134e-12	97	23	9	0.391304347826087	0.09278350515463918	GO:0061014	GO:BP	positive regulation of mRNA catabolic process	16175	15137		0.058823529411764705	0.08571428571428572	97	16078	9	14	88	16064	16175	0.18832178804115984
R1	cpdb	0	network_modules	290	TRUE	8.29726768742633e-11	125	23	9	0.391304347826087	0.072	GO:1903313	GO:BP	positive regulation of mRNA metabolic process	16175	22897		0.08823529411764706	0.11428571428571428	125	16050	9	14	116	16036	16175	0.1652929677468829
R1	cpdb	0	network_modules	290	TRUE	2.73840767949598e-10	448	23	12	0.5217391304347826	0.026785714285714284	GO:0034655	GO:BP	nucleobase-containing compound catabolic process	16175	8711		0.11764705882352941	0.14285714285714285	448	15727	12	11	436	15716	16175	0.11360489225101142
R1	cpdb	0	network_modules	290	TRUE	6.312785192235677e-10	156	23	9	0.391304347826087	0.057692307692307696	GO:0043488	GO:BP	regulation of mRNA stability	16175	10733		0.14705882352941177	0.17142857142857143	156	16019	9	14	147	16005	16175	0.1473640376655948
R1	cpdb	0	network_modules	290	TRUE	1.1739195214259446e-9	167	23	9	0.391304347826087	0.05389221556886228	GO:0043487	GO:BP	regulation of RNA stability	16175	10732		0.17647058823529413	0.2	167	16008	9	14	158	15994	16175	0.14222311929786768
R1	cpdb	0	network_modules	290	TRUE	1.5348144644553164e-9	172	23	9	0.391304347826087	0.05232558139534884	GO:0061013	GO:BP	regulation of mRNA catabolic process	16175	15136		0.20588235294117646	0.22857142857142856	172	16003	9	14	163	15989	16175	0.14004884334816542
R1	cpdb	0	network_modules	290	TRUE	1.6382979058086738e-9	57	23	7	0.30434782608695654	0.12280701754385964	GO:0000288	GO:BP	nuclear-transcribed mRNA catabolic process, deadenylation-dependent decay	16175	81		0.23529411764705882	0.2571428571428571	57	16118	7	16	50	16102	16175	0.1915641971961505
R1	cpdb	0	network_modules	290	TRUE	2.82379374472751e-9	279	23	10	0.43478260869565216	0.035842293906810034	GO:0006401	GO:BP	RNA catabolic process	16175	2162		0.2647058823529412	0.2857142857142857	279	15896	10	13	269	15883	16175	0.12101539712997617
R1	cpdb	0	network_modules	290	TRUE	4.430670586435648e-9	31	23	6	0.2608695652173913	0.1935483870967742	GO:0000289	GO:BP	nuclear-transcribed mRNA poly(A) tail shortening	16175	82		0.29411764705882354	0.3142857142857143	31	16144	6	17	25	16127	16175	0.22342389856222764
R1	cpdb	0	network_modules	290	TRUE	5.621478921455743e-9	299	23	10	0.43478260869565216	0.033444816053511704	GO:0141188	GO:BP	nucleic acid catabolic process	16175	20075		0.3235294117647059	0.34285714285714286	299	15876	10	13	289	15863	16175	0.11662522665098597
R1	cpdb	0	network_modules	290	TRUE	6.441390157237938e-9	21	13	5	0.38461538461538464	0.23809523809523808	REAC:R-HSA-6804115	REAC	TP53 regulates transcription of additional cell cycle genes whose exact role in the p53 pathway remain uncertain	10916	2461		0	0.16666666666666666	21	10895	5	8	16	10887	10916	0.3015698121864779
R1	cpdb	0	network_modules	290	TRUE	1.677696761401299e-8	25	13	5	0.38461538461538464	0.2	REAC:R-HSA-429947	REAC	Deadenylation of mRNA	10916	453		0.2	0.5	25	10891	5	8	20	10883	10916	0.27617934943760347
R1	cpdb	0	network_modules	290	TRUE	1.677696761401299e-8	25	13	5	0.38461538461538464	0.2	REAC:R-HSA-9820841	REAC	M-decay: degradation of maternal mRNAs by maternally stored factors	10916	1344		0.2	0.5	25	10891	5	8	20	10883	10916	0.27617934943760347
R1	cpdb	0	network_modules	290	TRUE	1.807973138161156e-8	226	23	9	0.391304347826087	0.03982300884955752	GO:0006402	GO:BP	mRNA catabolic process	16175	2163		0.35294117647058826	0.37142857142857144	226	15949	9	14	217	15935	16175	0.12131037277787222
R1	cpdb	0	network_modules	290	TRUE	9.812246119082745e-8	273	23	9	0.391304347826087	0.03296703296703297	GO:1903311	GO:BP	regulation of mRNA metabolic process	16175	22895		0.38235294117647056	0.4	273	15902	9	14	264	15888	16175	0.10968680248732544
R1	cpdb	0	network_modules	290	TRUE	2.279473558980033e-7	113	23	7	0.30434782608695654	0.061946902654867256	GO:0000956	GO:BP	nuclear-transcribed mRNA catabolic process	16175	264		0.4117647058823529	0.42857142857142855	113	16062	7	16	106	16046	16175	0.1347228017490026
R1	cpdb	0	network_modules	290	TRUE	5.933557675286364e-7	49	13	5	0.38461538461538464	0.10204081632653061	REAC:R-HSA-6791312	REAC	TP53 Regulates Transcription of Cell Cycle Genes	10916	2454		0.6	0.6666666666666666	49	10867	5	8	44	10859	10916	0.19635299952189605
R1	cpdb	0	network_modules	290	TRUE	6.970457888977894e-7	69	23	6	0.2608695652173913	0.08695652173913043	GO:1902117	GO:BP	positive regulation of organelle assembly	16175	22030		0.4411764705882353	0.45714285714285713	69	16106	6	17	63	16089	16175	0.14857290483000465
R1	cpdb	0	network_modules	290	TRUE	1.1835045615852433e-6	56	13	5	0.38461538461538464	0.08928571428571429	REAC:R-HSA-429914	REAC	Deadenylation-dependent mRNA decay	10916	454		0.8	0.8333333333333334	56	10860	5	8	51	10852	10916	0.1834206502718188
R1	cpdb	0	network_modules	290	TRUE	1.5949042475930546e-6	79	11	5	0.45454545454545453	0.06329113924050633	KEGG:03018	KEGG	RNA degradation	8484	211		NA	1	79	8405	5	6	74	8399	8484	0.16702601900592717
R1	cpdb	0	network_modules	290	TRUE	5.886913527997513e-6	434	23	9	0.391304347826087	0.020737327188940093	GO:0010608	GO:BP	post-transcriptional regulation of gene expression	16175	4255		0.47058823529411764	0.4857142857142857	434	15741	9	14	425	15727	16175	0.08511364202349113
R1	cpdb	0	network_modules	290	TRUE	1.1063870258999345e-5	17	23	4	0.17391304347826086	0.23529411764705882	GO:0033962	GO:BP	P-body assembly	16175	8367		0.5	0.5142857142857142	17	16158	4	19	13	16139	16175	0.2013151332267259
R1	cpdb	0	network_modules	290	TRUE	1.3413886882035192e-5	477	23	9	0.391304347826087	0.018867924528301886	GO:0009896	GO:BP	positive regulation of catabolic process	16175	3756		0.5294117647058824	0.5428571428571428	477	15698	9	14	468	15684	16175	0.08070483297646669
R1	cpdb	0	network_modules	290	TRUE	1.520654477389479e-5	4	23	3	0.13043478260869565	0.75	GO:0010606	GO:BP	positive regulation of cytoplasmic mRNA processing body assembly	16175	4253		0.5588235294117647	0.6	4	16171	3	20	1	16151	16175	0.31243945056984906
R1	cpdb	0	network_modules	290	TRUE	1.520654477389479e-5	4	23	3	0.13043478260869565	0.75	GO:0062029	GO:BP	positive regulation of stress granule assembly	16175	15790		0.5588235294117647	0.6	4	16171	3	20	1	16151	16175	0.31243945056984906
R1	cpdb	0	network_modules	290	TRUE	3.7981101092723623e-5	5	23	3	0.13043478260869565	0.6	GO:0010603	GO:BP	regulation of cytoplasmic mRNA processing body assembly	16175	4250		0.6176470588235294	0.6285714285714286	5	16170	3	20	2	16150	16175	0.2793302689624588
R1	cpdb	0	network_modules	290	TRUE	5.443903358854856e-5	119	13	5	0.38461538461538464	0.04201680672268908	REAC:R-HSA-9816359	REAC	Maternal to zygotic transition (MZT)	10916	1394		1	1	119	10797	5	8	114	10789	10916	0.12427291390889984
R1	cpdb	0	network_modules	290	TRUE	7.58917467893925e-5	6	23	3	0.13043478260869565	0.5	GO:0062028	GO:BP	regulation of stress granule assembly	16175	15789		0.6470588235294118	0.6571428571428571	6	16169	3	20	3	16149	16175	0.2548792144510706
R1	cpdb	0	network_modules	290	TRUE	8.426608544481813e-5	590	23	9	0.391304347826087	0.015254237288135594	GO:0016071	GO:BP	mRNA metabolic process	16175	5098		0.6764705882352942	0.6857142857142857	590	15585	9	14	581	15571	16175	0.07142231147023624
R1	cpdb	0	network_modules	290	TRUE	2.772600494864732e-4	186	23	6	0.2608695652173913	0.03225806451612903	GO:1902115	GO:BP	regulation of organelle assembly	16175	22028		0.7058823529411765	0.7142857142857143	186	15989	6	17	180	15972	16175	0.08826178878698779
R1	cpdb	0	network_modules	290	TRUE	3.178592664005211e-4	9	23	3	0.13043478260869565	0.3333333333333333	GO:0061003	GO:BP	positive regulation of dendritic spine morphogenesis	16175	15127		0.7352941176470589	0.7428571428571429	9	16166	3	20	6	16146	16175	0.20783052589345608
R1	cpdb	0	network_modules	290	TRUE	5.030031705916976e-4	343	23	7	0.30434782608695654	0.02040816326530612	GO:0140694	GO:BP	membraneless organelle assembly	16175	19860		0.7647058823529411	0.7714285714285715	343	15832	7	16	336	15816	16175	0.07416257507091535
R1	cpdb	0	network_modules	290	TRUE	0.001037867282117926	50	23	4	0.17391304347826086	0.08	GO:0035195	GO:BP	miRNA-mediated post-transcriptional gene silencing	16175	8884		0.7941176470588235	0.8	50	16125	4	19	46	16106	16175	0.11611908903478071
R1	cpdb	0	network_modules	290	TRUE	0.0017256102488281684	412	23	7	0.30434782608695654	0.01699029126213592	GO:0044089	GO:BP	positive regulation of cellular component biogenesis	16175	10911		0.8235294117647058	0.8285714285714286	412	15763	7	16	405	15747	16175	0.06679420768799942
R1	cpdb	0	network_modules	290	TRUE	0.002485750255447424	62	23	4	0.17391304347826086	0.06451612903225806	GO:0035194	GO:BP	regulatory ncRNA-mediated post-transcriptional gene silencing	16175	8883		0.8529411764705882	0.8571428571428571	62	16113	4	19	58	16094	16175	0.10386379117253478
R1	cpdb	0	network_modules	290	TRUE	0.00293052110335139	2	23	2	0.08695652173913043	1	GO:0106288	GO:BP	regulation of deadenylation-dependent decapping of nuclear-transcribed mRNA	16175	19303		0.8823529411764706	0.8857142857142857	2	16173	2	21	0	16152	16175	0.29469240258173435
R1	cpdb	0	network_modules	290	TRUE	0.003062098350953939	18	23	3	0.13043478260869565	0.16666666666666666	GO:0050775	GO:BP	positive regulation of dendrite morphogenesis	16175	13249		0.9117647058823529	0.9142857142857143	18	16157	3	20	15	16137	16175	0.14636953661026184
R1	cpdb	0	network_modules	290	TRUE	0.003399392148099341	67	23	4	0.17391304347826086	0.05970149253731343	GO:0016441	GO:BP	post-transcriptional gene silencing	16175	5222		0.9411764705882353	0.9428571428571428	67	16108	4	19	63	16089	16175	0.09974702749516456
R1	cpdb	0	network_modules	290	TRUE	0.0036328697091528943	19	23	3	0.13043478260869565	0.15789473684210525	GO:0010770	GO:BP	positive regulation of cell morphogenesis	16175	4388		0.9705882352941176	0.9714285714285714	19	16156	3	20	16	16136	16175	0.14240194503174
R1	cpdb	0	network_modules	290	TRUE	0.0057575537717758475	22	23	3	0.13043478260869565	0.13636363636363635	GO:0060999	GO:BP	positive regulation of dendritic spine development	16175	15123		1	1	22	16153	3	20	19	16133	16175	0.13215941380754104
R1	cpdb	0	network_modules	291	TRUE	8.148549080889096e-15	131	13	10	0.7692307692307693	0.07633587786259542	KEGG:04142	KEGG	Lysosome	8484	279		NA	1	131	8353	10	3	121	8350	8484	0.23949609873184444
R1	cpdb	0	network_modules	291	TRUE	5.886030530677228e-8	125	18	7	0.3888888888888889	0.056	GO:0007041	GO:BP	lysosomal transport	16175	2645		0	0.07692307692307693	125	16050	7	11	118	16039	16175	0.14528340632052658
R1	cpdb	0	network_modules	291	TRUE	2.6949375675694314e-7	155	18	7	0.3888888888888889	0.04516129032258064	GO:0007034	GO:BP	vacuolar transport	16175	2639		0.08333333333333333	0.15384615384615385	155	16020	7	11	148	16009	16175	0.12995500656377426
R1	cpdb	0	network_modules	291	TRUE	1.1981502393008062e-6	100	18	6	0.3333333333333333	0.06	GO:0006892	GO:BP	post-Golgi vesicle-mediated transport	16175	2547		0.16666666666666666	0.23076923076923078	100	16075	6	12	94	16063	16175	0.13930698036581393
R1	cpdb	0	network_modules	291	TRUE	8.243091409201503e-5	202	18	6	0.3333333333333333	0.0297029702970297	GO:0007033	GO:BP	vacuole organization	16175	2638		0.25	0.3076923076923077	202	15973	6	12	196	15961	16175	0.09643316557841984
R1	cpdb	0	network_modules	291	TRUE	3.614046334002599e-4	12	18	3	0.16666666666666666	0.25	GO:0090160	GO:BP	Golgi to lysosome transport	16175	18068		0.3333333333333333	0.38461538461538464	12	16163	3	15	9	16148	16175	0.20340415639299522
R1	cpdb	0	network_modules	291	TRUE	4.339851463544884e-4	53	18	4	0.2222222222222222	0.07547169811320754	GO:0061462	GO:BP	protein localization to lysosome	16175	15493		0.4166666666666667	0.46153846153846156	53	16122	4	14	49	16108	16175	0.12787596678725893
R1	cpdb	0	network_modules	291	TRUE	6.172624816234677e-4	284	18	6	0.3333333333333333	0.02112676056338028	GO:0048193	GO:BP	Golgi vesicle transport	16175	12570		0.5	0.5384615384615384	284	15891	6	12	278	15879	16175	0.08024974352179699
R1	cpdb	0	network_modules	291	TRUE	0.0011991200161071288	524	18	7	0.3888888888888889	0.013358778625954198	GO:0006886	GO:BP	intracellular protein transport	16175	2542		0.5833333333333334	0.6153846153846154	524	15651	7	11	517	15640	16175	0.0672070388241116
R1	cpdb	0	network_modules	291	TRUE	0.0013348971559334717	18	18	3	0.16666666666666666	0.16666666666666666	GO:0006896	GO:BP	Golgi to vacuole transport	16175	2550		0.6666666666666666	0.6923076923076923	18	16157	3	15	15	16142	16175	0.16573827649522394
R1	cpdb	0	network_modules	291	TRUE	0.0020195529023687426	44	10	3	0.3	0.06818181818181818	REAC:R-HSA-8854214	REAC	TBC/RABGAPs	10916	2420		0	0.5	44	10872	3	7	41	10865	10916	0.14144782291483735
R1	cpdb	0	network_modules	291	TRUE	0.0020777005734889417	78	18	4	0.2222222222222222	0.05128205128205128	GO:0072665	GO:BP	protein localization to vacuole	16175	17485		0.75	0.7692307692307693	78	16097	4	14	74	16083	16175	0.10474658605702764
R1	cpdb	0	network_modules	291	TRUE	0.004229734428872005	26	18	3	0.16666666666666666	0.11538461538461539	GO:0006622	GO:BP	protein targeting to lysosome	16175	2336		0.8333333333333334	0.8461538461538461	26	16149	3	15	23	16134	16175	0.13752465046393864
R1	cpdb	0	network_modules	291	TRUE	0.004778617748471889	96	18	4	0.2222222222222222	0.041666666666666664	GO:0007040	GO:BP	lysosome organization	16175	2644		0.9166666666666666	1	96	16079	4	14	92	16065	16175	0.09398655639090372
R1	cpdb	0	network_modules	291	TRUE	0.004778617748471889	96	18	4	0.2222222222222222	0.041666666666666664	GO:0080171	GO:BP	lytic vacuole organization	16175	17845		0.9166666666666666	1	96	16079	4	14	92	16065	16175	0.09398655639090372
R1	cpdb	0	network_modules	291	TRUE	0.008972410937758036	72	10	3	0.3	0.041666666666666664	REAC:R-HSA-199992	REAC	trans-Golgi Network Vesicle Budding	10916	2749		1	1	72	10844	3	7	69	10837	10916	0.10975797112049128
R1	cpdb	0	network_modules	292	TRUE	3.83334136654976e-32	249	25	23	0.92	0.09236947791164658	KEGG:05132	KEGG	Salmonella infection	8484	429		0	0.16666666666666666	249	8235	23	2	226	8233	8484	0.2868712719372191
R1	cpdb	0	network_modules	292	TRUE	1.604137994425875e-27	193	25	20	0.8	0.10362694300518134	KEGG:04814	KEGG	Motor proteins	8484	366		0.2	0.3333333333333333	193	8291	20	5	173	8286	8484	0.2833938979740891
R1	cpdb	0	network_modules	292	TRUE	2.9680888954377146e-22	53	25	13	0.52	0.24528301886792453	REAC:R-HSA-6811436	REAC	COPI-independent Golgi-to-ER retrograde traffic	10916	278		0	0.02857142857142857	53	10863	13	12	40	10851	10916	0.3550717322294347
R1	cpdb	0	network_modules	292	TRUE	8.601213156210168e-22	57	25	13	0.52	0.22807017543859648	REAC:R-HSA-3371497	REAC	HSP90 chaperone cycle for steroid hormone receptors (SHR) in the presence of ligand	10916	1111		0.029411764705882353	0.05714285714285714	57	10859	13	12	44	10847	10916	0.3422059411638448
R1	cpdb	0	network_modules	292	TRUE	3.5205984980974617e-19	123	25	14	0.56	0.11382113821138211	REAC:R-HSA-2132295	REAC	MHC class II antigen presentation	10916	1371		0.058823529411764705	0.08571428571428572	123	10793	14	11	109	10782	10916	0.24907859271844776
R1	cpdb	0	network_modules	292	TRUE	3.1373099447610574e-18	102	25	13	0.52	0.12745098039215685	REAC:R-HSA-6807878	REAC	COPI-mediated anterograde transport	10916	279		0.08823529411764706	0.11428571428571428	102	10814	13	12	89	10802	10916	0.254293203575449
R1	cpdb	0	network_modules	292	TRUE	5.222666919671715e-18	44	25	11	0.44	0.25	KEGG:04962	KEGG	Vasopressin-regulated water reabsorption	8484	398		0.4	0.5	44	8440	11	14	33	8426	8484	0.329091660070522
R1	cpdb	0	network_modules	292	TRUE	1.1599502621992847e-16	133	25	13	0.52	0.09774436090225563	REAC:R-HSA-8856688	REAC	Golgi-to-ER retrograde transport	10916	1084		0.11764705882352941	0.14285714285714285	133	10783	13	12	120	10771	10916	0.22177390934520289
R1	cpdb	0	network_modules	292	TRUE	9.061715195897987e-16	155	25	13	0.52	0.08387096774193549	REAC:R-HSA-199977	REAC	ER to Golgi Anterograde Transport	10916	823		0.14705882352941177	0.17142857142857143	155	10761	13	12	142	10749	10916	0.20482684658957362
R1	cpdb	0	network_modules	292	TRUE	1.0255345317052641e-14	186	25	13	0.52	0.06989247311827956	REAC:R-HSA-948021	REAC	Transport to the Golgi and subsequent modification	10916	2604		0.17647058823529413	0.2	186	10730	13	12	173	10718	10916	0.186199045348969
R1	cpdb	0	network_modules	292	TRUE	3.052939067642725e-14	202	25	13	0.52	0.06435643564356436	REAC:R-HSA-6811442	REAC	Intra-Golgi and retrograde Golgi-to-ER traffic	10916	1262		0.20588235294117646	0.22857142857142856	202	10714	13	12	189	10702	10916	0.17828499778203635
R1	cpdb	0	network_modules	292	TRUE	6.653706065534113e-12	305	25	13	0.52	0.04262295081967213	REAC:R-HSA-446203	REAC	Asparagine N-linked glycosylation	10916	169		0.23529411764705882	0.2571428571428571	305	10611	13	12	292	10599	10916	0.14305039946685424
R1	cpdb	0	network_modules	292	TRUE	2.1452971408327415e-11	348	30	13	0.43333333333333335	0.03735632183908046	GO:0007018	GO:BP	microtubule-based movement	16175	2626		0	0.2	348	15827	13	17	335	15810	16175	0.1223497199586296
R1	cpdb	0	network_modules	292	TRUE	1.0850526977012822e-7	200	25	9	0.36	0.045	REAC:R-HSA-5617833	REAC	Cilium Assembly	10916	361		0.2647058823529412	0.2857142857142857	200	10716	9	16	191	10700	10916	0.12206345600205795
R1	cpdb	0	network_modules	292	TRUE	4.131695471825089e-7	305	25	10	0.4	0.03278688524590164	KEGG:05016	KEGG	Huntington disease	8484	414		0.6	0.6666666666666666	305	8179	10	15	295	8164	8484	0.10630951459830434
R1	cpdb	0	network_modules	292	TRUE	2.191778792968844e-6	363	25	10	0.4	0.027548209366391185	KEGG:05014	KEGG	Amyotrophic lateral sclerosis	8484	413		0.8	0.8333333333333334	363	8121	10	15	353	8106	8484	0.09595796804175694
R1	cpdb	0	network_modules	292	TRUE	3.0633250795631744e-6	292	25	9	0.36	0.030821917808219176	REAC:R-HSA-1852241	REAC	Organelle biogenesis and maintenance	10916	1646		0.29411764705882354	0.3142857142857143	292	10624	9	16	283	10608	10916	0.09895430930955013
R1	cpdb	0	network_modules	292	TRUE	3.0943789942969217e-6	199	25	8	0.32	0.04020100502512563	REAC:R-HSA-68877	REAC	Mitotic Prometaphase	10916	1484		0.3235294117647059	0.34285714285714286	199	10717	8	17	191	10700	10916	0.10807180065476568
R1	cpdb	0	network_modules	292	TRUE	1.4832249390156019e-5	44	25	5	0.2	0.11363636363636363	REAC:R-HSA-9646399	REAC	Aggrephagy	10916	129		0.35294117647058826	0.37142857142857144	44	10872	5	20	39	10852	10916	0.14818575429126632
R1	cpdb	0	network_modules	292	TRUE	1.3723110281274776e-4	68	25	5	0.2	0.07352941176470588	REAC:R-HSA-380284	REAC	Loss of proteins required for interphase microtubule organization from the centrosome	10916	1335		0.38235294117647056	0.42857142857142855	68	10848	5	20	63	10828	10916	0.11799355022452658
R1	cpdb	0	network_modules	292	TRUE	1.3723110281274776e-4	68	25	5	0.2	0.07352941176470588	REAC:R-HSA-380259	REAC	Loss of Nlp from mitotic centrosomes	10916	1331		0.38235294117647056	0.42857142857142855	68	10848	5	20	63	10828	10916	0.11799355022452658
R1	cpdb	0	network_modules	292	TRUE	1.706179466272273e-4	71	25	5	0.2	0.07042253521126761	REAC:R-HSA-8854518	REAC	AURKA Activation by TPX2	10916	41		0.4411764705882353	0.45714285714285713	71	10845	5	20	66	10825	10916	0.11532599521242272
R1	cpdb	0	network_modules	292	TRUE	3.107149460116991e-4	80	25	5	0.2	0.0625	REAC:R-HSA-9663891	REAC	Selective autophagy	10916	2186		0.47058823529411764	0.5428571428571428	80	10836	5	20	75	10816	10916	0.10822739537331079
R1	cpdb	0	network_modules	292	TRUE	3.107149460116991e-4	80	25	5	0.2	0.0625	REAC:R-HSA-380287	REAC	Centrosome maturation	10916	341		0.47058823529411764	0.5428571428571428	80	10836	5	20	75	10816	10916	0.10822739537331079
R1	cpdb	0	network_modules	292	TRUE	3.107149460116991e-4	80	25	5	0.2	0.0625	REAC:R-HSA-380270	REAC	Recruitment of mitotic centrosome proteins and complexes	10916	1951		0.47058823529411764	0.5428571428571428	80	10836	5	20	75	10816	10916	0.10822739537331079
R1	cpdb	0	network_modules	292	TRUE	3.2836528599483974e-4	144	30	6	0.2	0.041666666666666664	GO:0010970	GO:BP	transport along microtubule	16175	4546		0.25	0.4	144	16031	6	24	138	16007	16175	0.08769585257547852
R1	cpdb	0	network_modules	292	TRUE	4.2071995964566107e-4	85	25	5	0.2	0.058823529411764705	REAC:R-HSA-2565942	REAC	Regulation of PLK1 Activity at G2/M Transition	10916	1998		0.5588235294117647	0.5714285714285714	85	10831	5	20	80	10811	10916	0.10477056048410746
R1	cpdb	0	network_modules	292	TRUE	6.240249196511189e-4	92	25	5	0.2	0.05434782608695652	REAC:R-HSA-141444	REAC	Amplification  of signal from unattached  kinetochores via a MAD2  inhibitory signal	10916	143		0.5882352941176471	0.6285714285714286	92	10824	5	20	87	10804	10916	0.10040235280527318
R1	cpdb	0	network_modules	292	TRUE	6.240249196511189e-4	92	25	5	0.2	0.05434782608695652	REAC:R-HSA-141424	REAC	Amplification of signal from the kinetochores	10916	144		0.5882352941176471	0.6285714285714286	92	10824	5	20	87	10804	10916	0.10040235280527318
R1	cpdb	0	network_modules	292	TRUE	6.943977591204432e-4	94	25	5	0.2	0.05319148936170213	REAC:R-HSA-380320	REAC	Recruitment of NuMA to mitotic centrosomes	10916	1950		0.6470588235294118	0.6571428571428571	94	10822	5	20	89	10802	10916	0.09924267250771461
R1	cpdb	0	network_modules	292	TRUE	7.3337744901631e-4	165	30	6	0.2	0.03636363636363636	GO:0099111	GO:BP	microtubule-based transport	16175	19044		0.5	0.6	165	16010	6	24	159	15986	16175	0.08142210764730468
R1	cpdb	0	network_modules	292	TRUE	7.459075608587285e-4	406	25	8	0.32	0.019704433497536946	REAC:R-HSA-68886	REAC	M Phase	10916	1343		0.6764705882352942	0.6857142857142857	406	10510	8	17	398	10493	10916	0.0716020179035971
R1	cpdb	0	network_modules	292	TRUE	7.708811275023499e-4	96	25	5	0.2	0.052083333333333336	REAC:R-HSA-5620912	REAC	Anchoring of the basal body to the plasma membrane	10916	147		0.7058823529411765	0.7142857142857143	96	10820	5	20	91	10800	10916	0.09811850999793256
R1	cpdb	0	network_modules	292	TRUE	0.001383080098492013	11	30	3	0.1	0.2727272727272727	GO:0051127	GO:BP	positive regulation of actin nucleation	16175	13511		0.75	0.8	11	16164	3	27	8	16137	16175	0.16422965067086123
R1	cpdb	0	network_modules	292	TRUE	0.0014345193380717954	185	30	6	0.2	0.032432432432432434	GO:0030705	GO:BP	cytoskeleton-dependent intracellular transport	16175	6886		1	1	185	15990	6	24	179	15966	16175	0.07644187761826388
R1	cpdb	0	network_modules	292	TRUE	0.0014443221943249943	109	25	5	0.2	0.045871559633027525	REAC:R-HSA-69618	REAC	Mitotic Spindle Checkpoint	10916	1486		0.7352941176470589	0.7428571428571429	109	10807	5	20	104	10787	10916	0.09156319331904698
R1	cpdb	0	network_modules	292	TRUE	0.001795368418500884	318	25	7	0.28	0.0220125786163522	REAC:R-HSA-195258	REAC	RHO GTPase Effectors	10916	1846		0.7647058823529411	0.7714285714285715	318	10598	7	18	311	10580	10916	0.07146940742031244
R1	cpdb	0	network_modules	292	TRUE	0.0018800062571043127	115	25	5	0.2	0.043478260869565216	REAC:R-HSA-9648025	REAC	EML4 and NUDC in mitotic spindle formation	10916	817		0.7941176470588235	0.8	115	10801	5	20	110	10781	10916	0.08890941565031277
R1	cpdb	0	network_modules	292	TRUE	0.002205631590402499	54	25	4	0.16	0.07407407407407407	REAC:R-HSA-5620924	REAC	Intraflagellar transport	10916	1267		0.8235294117647058	0.8285714285714286	54	10862	4	21	50	10841	10916	0.10588353185730372
R1	cpdb	0	network_modules	292	TRUE	0.0026144729581462117	123	25	5	0.2	0.04065040650406504	REAC:R-HSA-2500257	REAC	Resolution of Sister Chromatid Cohesion	10916	2079		0.8529411764705882	0.8571428571428571	123	10793	5	20	118	10773	10916	0.0856686383078595
R1	cpdb	0	network_modules	292	TRUE	0.003839902259716822	147	25	5	0.2	0.034013605442176874	KEGG:04145	KEGG	Phagosome	8484	281		1	1	147	8337	5	20	142	8317	8484	0.07610664550437289
R1	cpdb	0	network_modules	292	TRUE	0.003972076024866229	134	25	5	0.2	0.03731343283582089	REAC:R-HSA-1632852	REAC	Macroautophagy	10916	1388		0.8823529411764706	0.8857142857142857	134	10782	5	20	129	10762	10916	0.08168050413915498
R1	cpdb	0	network_modules	292	TRUE	0.004118520138932167	135	25	5	0.2	0.037037037037037035	REAC:R-HSA-9609690	REAC	HCMV Early Events	10916	1088		0.9117647058823529	0.9142857142857143	135	10781	5	20	130	10761	10916	0.08134148182916746
R1	cpdb	0	network_modules	292	TRUE	0.004269155862967174	136	25	5	0.2	0.03676470588235294	REAC:R-HSA-5663220	REAC	RHO GTPases Activate Formins	10916	1848		0.9411764705882353	0.9428571428571428	136	10780	5	20	131	10760	10916	0.08100607012054849
R1	cpdb	0	network_modules	292	TRUE	0.006648977292077479	149	25	5	0.2	0.03355704697986577	REAC:R-HSA-9612973	REAC	Autophagy	10916	193		0.9705882352941176	0.9714285714285714	149	10767	5	20	144	10747	10916	0.07694657340849015
R1	cpdb	0	network_modules	292	TRUE	0.00909927804838727	159	25	5	0.2	0.031446540880503145	REAC:R-HSA-9609646	REAC	HCMV Infection	10916	1089		1	1	159	10757	5	20	154	10737	10916	0.07415584693748217
R1	cpdb	0	network_modules	293	TRUE	3.427401516733108e-13	24	16	7	0.4375	0.2916666666666667	REAC:R-HSA-5668599	REAC	RHO GTPases Activate NADPH Oxidases	10916	1849		0	0.038461538461538464	24	10892	7	9	17	10883	10916	0.35607451265219925
R1	cpdb	0	network_modules	293	TRUE	6.141957874940642e-13	94	16	9	0.5625	0.09574468085106383	REAC:R-HSA-4420097	REAC	VEGFA-VEGFR2 Pathway	10916	2634		0.04	0.07692307692307693	94	10822	9	7	85	10815	10916	0.22967575419347194
R1	cpdb	0	network_modules	293	TRUE	1.5772607249797602e-12	104	16	9	0.5625	0.08653846153846154	REAC:R-HSA-194138	REAC	Signaling by VEGF	10916	2313		0.08	0.11538461538461539	104	10812	9	7	95	10805	10916	0.2180942785933461
R1	cpdb	0	network_modules	293	TRUE	8.195109395690254e-12	36	16	7	0.4375	0.19444444444444445	REAC:R-HSA-1222556	REAC	ROS and RNS production in phagocytes	10916	1910		0.12	0.15384615384615385	36	10880	7	9	29	10871	10916	0.29015928976691996
R1	cpdb	0	network_modules	293	TRUE	1.679385086037876e-11	33	22	7	0.3181818181818182	0.21212121212121213	GO:0045730	GO:BP	respiratory burst	16175	11572		0	0.125	33	16142	7	15	26	16127	16175	0.25856818304572454
R1	cpdb	0	network_modules	293	TRUE	5.045235478107803e-11	88	16	8	0.5	0.09090909090909091	REAC:R-HSA-9013404	REAC	RAC2 GTPase cycle	10916	1837		0.16	0.19230769230769232	88	10828	8	8	80	10820	10916	0.21076843384585628
R1	cpdb	0	network_modules	293	TRUE	6.060137351867815e-11	8	16	5	0.3125	0.625	REAC:R-HSA-1236973	REAC	Cross-presentation of particulate exogenous antigens (phagosomes)	10916	415		0.2	0.23076923076923078	8	10908	5	11	3	10897	10916	0.4413905566749614
R1	cpdb	0	network_modules	293	TRUE	5.878710616233327e-10	449	16	11	0.6875	0.024498886414253896	REAC:R-HSA-9012999	REAC	RHO GTPase cycle	10916	1847		0.24	0.2692307692307692	449	10467	11	5	438	10462	10916	0.12469689634650391
R1	cpdb	0	network_modules	293	TRUE	2.05776052501976e-8	184	16	8	0.5	0.043478260869565216	REAC:R-HSA-9013149	REAC	RAC1 GTPase cycle	10916	1836		0.28	0.3076923076923077	184	10732	8	8	176	10724	10916	0.14379296016182963
R1	cpdb	0	network_modules	293	TRUE	6.072165468542121e-8	175	22	8	0.36363636363636365	0.045714285714285714	GO:0072593	GO:BP	reactive oxygen species metabolic process	16175	17457		0.14285714285714285	0.25	175	16000	8	14	167	15986	16175	0.12586348841686754
R1	cpdb	0	network_modules	293	TRUE	1.128294638345526e-7	55	22	6	0.2727272727272727	0.10909090909090909	GO:0006801	GO:BP	superoxide metabolic process	16175	2486		0.2857142857142857	0.375	55	16120	6	16	49	16104	16175	0.17074382435702912
R1	cpdb	0	network_modules	293	TRUE	1.788933432231319e-7	114	19	7	0.3684210526315789	0.06140350877192982	KEGG:04670	KEGG	Leukocyte transendothelial migration	8484	343		0	0.07692307692307693	114	8370	7	12	107	8358	8484	0.1460688454848897
R1	cpdb	0	network_modules	293	TRUE	1.8978273933403674e-7	188	19	8	0.42105263157894735	0.0425531914893617	KEGG:04613	KEGG	Neutrophil extracellular trap formation	8484	323		0.08333333333333333	0.15384615384615385	188	8296	8	11	180	8285	8484	0.12838296305585534
R1	cpdb	0	network_modules	293	TRUE	3.35171246723279e-7	202	19	8	0.42105263157894735	0.039603960396039604	KEGG:05415	KEGG	Diabetic cardiomyopathy	8484	492		0.16666666666666666	0.23076923076923078	202	8282	8	11	194	8271	8484	0.12344600853706697
R1	cpdb	0	network_modules	293	TRUE	3.9847115407048595e-7	36	16	5	0.3125	0.1388888888888889	REAC:R-HSA-3299685	REAC	Detoxification of Reactive Oxygen Species	10916	735		0.32	0.34615384615384615	36	10880	5	11	31	10869	10916	0.20662696192537508
R1	cpdb	0	network_modules	293	TRUE	4.639399372920229e-7	72	19	6	0.3157894736842105	0.08333333333333333	KEGG:05140	KEGG	Leishmaniasis	8484	433		0.25	0.3076923076923077	72	8412	6	13	66	8399	8484	0.1587138302939871
R1	cpdb	0	network_modules	293	TRUE	6.998064663604544e-7	13	16	4	0.25	0.3076923076923077	REAC:R-HSA-8849471	REAC	PTK6 Regulates RHO GTPases, RAS GTPase and MAP kinases	10916	1709		0.36	0.38461538461538464	13	10903	4	12	9	10891	10916	0.27639604590364947
R1	cpdb	0	network_modules	293	TRUE	1.0469227652986356e-6	34	22	5	0.22727272727272727	0.14705882352941177	GO:0042554	GO:BP	superoxide anion generation	16175	10244		0.42857142857142855	0.5	34	16141	5	17	29	16124	16175	0.18144135001331282
R1	cpdb	0	network_modules	293	TRUE	1.061991654093241e-6	147	19	7	0.3684210526315789	0.047619047619047616	KEGG:04145	KEGG	Phagosome	8484	281		0.3333333333333333	0.38461538461538464	147	8337	7	12	140	8325	8484	0.12747476336148394
R1	cpdb	0	network_modules	293	TRUE	2.5690181811270207e-6	507	16	9	0.5625	0.01775147928994083	REAC:R-HSA-9006934	REAC	Signaling by Receptor Tyrosine Kinases	10916	2302		0.4	0.4230769230769231	507	10409	9	7	498	10402	10916	0.09395010802516642
R1	cpdb	0	network_modules	293	TRUE	1.4161788388917239e-5	214	19	7	0.3684210526315789	0.03271028037383177	KEGG:05417	KEGG	Lipid and atherosclerosis	8484	494		0.4166666666666667	0.46153846153846156	214	8270	7	12	207	8258	8484	0.10369264417438365
R1	cpdb	0	network_modules	293	TRUE	2.8882098118282e-5	7	16	3	0.1875	0.42857142857142855	REAC:R-HSA-164944	REAC	Nef and signal transduction	10916	1562		0.44	0.46153846153846156	7	10909	3	13	4	10896	10916	0.28280181556864015
R1	cpdb	0	network_modules	293	TRUE	3.509703598941656e-5	77	19	5	0.2631578947368421	0.06493506493506493	KEGG:05100	KEGG	Bacterial invasion of epithelial cells	8484	423		0.5	0.5384615384615384	77	8407	5	14	72	8393	8484	0.12693224757756702
R1	cpdb	0	network_modules	293	TRUE	4.877180068056849e-5	318	16	7	0.4375	0.0220125786163522	REAC:R-HSA-195258	REAC	RHO GTPase Effectors	10916	1846		0.48	0.5	318	10598	7	9	311	10589	10916	0.09303298023686767
R1	cpdb	0	network_modules	293	TRUE	5.524924723415182e-5	94	16	5	0.3125	0.05319148936170213	REAC:R-HSA-9013423	REAC	RAC3 GTPase cycle	10916	1838		0.52	0.5384615384615384	94	10822	5	11	89	10811	10916	0.12601065050209548
R1	cpdb	0	network_modules	293	TRUE	7.028052114244225e-5	271	19	7	0.3684210526315789	0.025830258302583026	KEGG:05020	KEGG	Prion disease	8484	416		0.5833333333333334	0.6153846153846154	271	8213	7	12	264	8201	8484	0.09065376282095769
R1	cpdb	0	network_modules	293	TRUE	9.629184040111331e-5	105	16	5	0.3125	0.047619047619047616	REAC:R-HSA-1236975	REAC	Antigen processing-Cross presentation	10916	153		0.56	0.5769230769230769	105	10811	5	11	100	10800	10916	0.11889260657345854
R1	cpdb	0	network_modules	293	TRUE	1.531808215947535e-4	190	19	6	0.3157894736842105	0.031578947368421054	KEGG:04062	KEGG	Chemokine signaling pathway	8484	255		0.6666666666666666	0.6923076923076923	190	8294	6	13	184	8281	8484	0.09394138295471416
R1	cpdb	0	network_modules	293	TRUE	1.787331080739585e-4	185	22	6	0.2727272727272727	0.032432432432432434	GO:0006909	GO:BP	phagocytosis	16175	2559		0.5714285714285714	0.625	185	15990	6	16	179	15974	16175	0.09068626361977175
R1	cpdb	0	network_modules	293	TRUE	2.3653588911731933e-4	51	16	4	0.25	0.0784313725490196	REAC:R-HSA-9006927	REAC	Signaling by Non-Receptor Tyrosine Kinases	10916	2288		0.6	0.6538461538461539	51	10865	4	12	47	10853	10916	0.1378343179825488
R1	cpdb	0	network_modules	293	TRUE	2.3653588911731933e-4	51	16	4	0.25	0.0784313725490196	REAC:R-HSA-8848021	REAC	Signaling by PTK6	10916	2295		0.6	0.6538461538461539	51	10865	4	12	47	10853	10916	0.1378343179825488
R1	cpdb	0	network_modules	293	TRUE	5.091556415499149e-4	132	19	5	0.2631578947368421	0.03787878787878788	KEGG:04380	KEGG	Osteoclast differentiation	8484	309		0.75	0.7692307692307693	132	8352	5	14	127	8338	8484	0.09478312009164856
R1	cpdb	0	network_modules	293	TRUE	5.891890734909814e-4	136	19	5	0.2631578947368421	0.03676470588235294	KEGG:05135	KEGG	Yersinia infection	8484	432		0.8333333333333334	0.8461538461538461	136	8348	5	14	131	8334	8484	0.09322336336888641
R1	cpdb	0	network_modules	293	TRUE	6.327369803508313e-4	138	19	5	0.2631578947368421	0.036231884057971016	KEGG:05418	KEGG	Fluid shear stress and atherosclerosis	8484	495		0.9166666666666666	0.9230769230769231	138	8346	5	14	133	8332	8484	0.09246816357559545
R1	cpdb	0	network_modules	293	TRUE	0.0010083826527424588	407	22	7	0.3181818181818182	0.0171990171990172	GO:0007015	GO:BP	actin filament organization	16175	2624		0.7142857142857143	0.75	407	15768	7	15	400	15753	16175	0.06904624920762466
R1	cpdb	0	network_modules	293	TRUE	0.0010672182176092021	74	16	4	0.25	0.05405405405405406	REAC:R-HSA-9013408	REAC	RHOG GTPase cycle	10916	1868		0.68	0.6923076923076923	74	10842	4	12	70	10830	10916	0.11356400664377637
R1	cpdb	0	network_modules	293	TRUE	0.0013814041026813941	632	22	8	0.36363636363636365	0.012658227848101266	GO:0030036	GO:BP	actin cytoskeleton organization	16175	6660		0.8571428571428571	0.875	632	15543	8	14	624	15529	16175	0.06181630526111775
R1	cpdb	0	network_modules	293	TRUE	0.0023709448219664943	27	16	3	0.1875	0.1111111111111111	REAC:R-HSA-164952	REAC	The role of Nef in HIV-1 replication and disease pathogenesis	10916	2504		0.72	0.7307692307692307	27	10889	3	13	24	10876	10916	0.1427146241737168
R1	cpdb	0	network_modules	293	TRUE	0.0030288433441596828	211	16	5	0.3125	0.023696682464454975	REAC:R-HSA-9711123	REAC	Cellular response to chemical stress	10916	333		0.76	0.7692307692307693	211	10705	5	11	206	10694	10916	0.08158232633502427
R1	cpdb	0	network_modules	293	TRUE	0.00323370117469791	96	19	4	0.21052631578947367	0.041666666666666664	KEGG:04666	KEGG	Fc gamma R-mediated phagocytosis	8484	341		1	1	96	8388	4	15	92	8373	8484	0.0892302779960104
R1	cpdb	0	network_modules	293	TRUE	0.0032413769328836326	708	22	8	0.36363636363636365	0.011299435028248588	GO:0030029	GO:BP	actin filament-based process	16175	6653		1	1	708	15467	8	14	700	15453	16175	0.057700056039092215
R1	cpdb	0	network_modules	293	TRUE	0.003318705412153515	215	16	5	0.3125	0.023255813953488372	REAC:R-HSA-9658195	REAC	Leishmania infection	10916	1310		0.8	0.8461538461538461	215	10701	5	11	210	10690	10916	0.08073392584314007
R1	cpdb	0	network_modules	293	TRUE	0.003318705412153515	215	16	5	0.3125	0.023255813953488372	REAC:R-HSA-9824443	REAC	Parasitic Infection Pathways	10916	1717		0.8	0.8461538461538461	215	10701	5	11	210	10690	10916	0.08073392584314007
R1	cpdb	0	network_modules	293	TRUE	0.005769793598411577	113	16	4	0.25	0.035398230088495575	REAC:R-HSA-9664417	REAC	Leishmania phagocytosis	10916	1312		0.88	0.9615384615384616	113	10803	4	12	109	10791	10916	0.09071373990788786
R1	cpdb	0	network_modules	293	TRUE	0.005769793598411577	113	16	4	0.25	0.035398230088495575	REAC:R-HSA-9664422	REAC	FCGR3A-mediated phagocytosis	10916	899		0.88	0.9615384615384616	113	10803	4	12	109	10791	10916	0.09071373990788786
R1	cpdb	0	network_modules	293	TRUE	0.005769793598411577	113	16	4	0.25	0.035398230088495575	REAC:R-HSA-9664407	REAC	Parasite infection	10916	1716		0.88	0.9615384615384616	113	10803	4	12	109	10791	10916	0.09071373990788786
R1	cpdb	0	network_modules	293	TRUE	0.006399346051466774	116	16	4	0.25	0.034482758620689655	REAC:R-HSA-2029482	REAC	Regulation of actin dynamics for phagocytic cup formation	10916	2020		1	1	116	10800	4	12	112	10788	10916	0.08944277804935469
R1	cpdb	0	network_modules	294	TRUE	1.0284168385250338e-10	153	16	9	0.5625	0.058823529411764705	KEGG:01240	KEGG	Biosynthesis of cofactors	8484	190		0	0.5	153	8331	9	7	144	8324	8484	0.1778470850858239
R1	cpdb	0	network_modules	294	TRUE	1.1085083407547973e-5	4	21	3	0.14285714285714285	0.75	GO:0006556	GO:BP	S-adenosylmethionine biosynthetic process	16175	2276		0	0.125	4	16171	3	18	1	16153	16175	0.3270129708505223
R1	cpdb	0	network_modules	294	TRUE	5.583469274232056e-5	158	21	6	0.2857142857142857	0.0379746835443038	GO:0044272	GO:BP	sulfur compound biosynthetic process	16175	10944		0.14285714285714285	0.25	158	16017	6	15	152	16002	16175	0.10116238645508664
R1	cpdb	0	network_modules	294	TRUE	7.460171469123932e-5	289	21	7	0.3333333333333333	0.02422145328719723	GO:0006790	GO:BP	sulfur compound metabolic process	16175	2476		0.2857142857142857	0.375	289	15886	7	14	282	15872	16175	0.0858638991861264
R1	cpdb	0	network_modules	294	TRUE	3.308903694711226e-4	10	21	3	0.14285714285714285	0.3	GO:0046500	GO:BP	S-adenosylmethionine metabolic process	16175	12203		0.42857142857142855	0.5	10	16165	3	18	7	16147	16175	0.20632147919649532
R1	cpdb	0	network_modules	294	TRUE	6.973212180514702e-4	14	21	3	0.14285714285714285	0.21428571428571427	REAC:R-HSA-156581	REAC	Methylation	10916	1447		NA	1	14	10902	3	18	11	10884	10916	0.1736712221464502
R1	cpdb	0	network_modules	294	TRUE	0.0010611567803614974	260	21	6	0.2857142857142857	0.023076923076923078	GO:1901293	GO:BP	nucleoside phosphate biosynthetic process	16175	21368		0.5714285714285714	0.625	260	15915	6	15	254	15900	16175	0.07730514105051624
R1	cpdb	0	network_modules	294	TRUE	0.0035531339489023	512	21	7	0.3333333333333333	0.013671875	GO:0090407	GO:BP	organophosphate biosynthetic process	16175	18274		0.7142857142857143	0.75	512	15663	7	14	505	15649	16175	0.06212799091674003
R1	cpdb	0	network_modules	294	TRUE	0.0039890416161404586	521	21	7	0.3333333333333333	0.013435700575815739	GO:0006753	GO:BP	nucleoside phosphate metabolic process	16175	2450		0.8571428571428571	0.875	521	15654	7	14	514	15640	16175	0.06149311461288618
R1	cpdb	0	network_modules	294	TRUE	0.006282823518761374	558	21	7	0.3333333333333333	0.012544802867383513	GO:0055086	GO:BP	nucleobase-containing small molecule metabolic process	16175	14237		1	1	558	15617	7	14	551	15603	16175	0.05903783206123132
R1	cpdb	0	network_modules	294	TRUE	0.0064197063823102744	50	16	3	0.1875	0.06	KEGG:00270	KEGG	Cysteine and methionine metabolism	8484	30		1	1	50	8434	3	13	47	8421	8484	0.10313354418746458
R1	cpdb	0	network_modules	295	TRUE	4.590060843295634e-6	168	13	6	0.46153846153846156	0.03571428571428571	KEGG:04141	KEGG	Protein processing in endoplasmic reticulum	8484	278		0	0.3333333333333333	168	8316	6	7	162	8309	8484	0.12420994841220534
R1	cpdb	0	network_modules	295	TRUE	5.0650210937992027e-5	53	13	4	0.3076923076923077	0.07547169811320754	KEGG:00510	KEGG	N-Glycan biosynthesis	8484	63		0.5	0.6666666666666666	53	8431	4	9	49	8422	8484	0.14987733662941977
R1	cpdb	0	network_modules	295	TRUE	1.7956786030155764e-4	38	20	4	0.2	0.10526315789473684	GO:0018279	GO:BP	protein N-linked glycosylation via asparagine	16175	5395		0	0.5	38	16137	4	16	34	16121	16175	0.1436484536060909
R1	cpdb	0	network_modules	295	TRUE	0.0016961737595818447	42	13	3	0.23076923076923078	0.07142857142857142	KEGG:00513	KEGG	Various types of N-glycan biosynthesis	8484	66		1	1	42	8442	3	10	39	8432	8484	0.12604268545130584
R1	cpdb	0	network_modules	295	TRUE	0.0019345842916182248	68	20	4	0.2	0.058823529411764705	GO:0006487	GO:BP	protein N-linked glycosylation	16175	2221		1	1	68	16107	4	16	64	16091	16175	0.10647503569317335
R1	cpdb	0	network_modules	295	TRUE	0.004987685671796811	37	15	3	0.2	0.08108108108108109	REAC:R-HSA-9694548	REAC	Maturation of spike protein	10916	1408		NA	1	37	10879	3	12	34	10867	10916	0.12548369539109486
R1	cpdb	0	network_modules	296	TRUE	3.3892571235920224e-4	117	9	4	0.4444444444444444	0.03418803418803419	GO:0035725	GO:BP	sodium ion transmembrane transport	16175	9195		0	0.1111111111111111	117	16058	4	5	113	16053	16175	0.12173535831852951
R1	cpdb	0	network_modules	296	TRUE	5.106364219639779e-4	30	9	3	0.3333333333333333	0.1	GO:0006884	GO:BP	cell volume homeostasis	16175	2540		0.125	0.2222222222222222	30	16145	3	6	27	16139	16175	0.1817774998860541
R1	cpdb	0	network_modules	296	TRUE	0.0011598426727128799	159	9	4	0.4444444444444444	0.025157232704402517	GO:0006814	GO:BP	sodium ion transport	16175	2494		0.25	0.3333333333333333	159	16016	4	5	155	16011	16175	0.10394242291498663
R1	cpdb	0	network_modules	296	TRUE	0.002033283187741105	183	9	4	0.4444444444444444	0.02185792349726776	GO:0071805	GO:BP	potassium ion transmembrane transport	16175	16918		0.375	0.4444444444444444	183	15992	4	5	179	15987	16175	0.09662873127487513
R1	cpdb	0	network_modules	296	TRUE	0.0022639520201949872	188	9	4	0.4444444444444444	0.02127659574468085	GO:0071674	GO:BP	mononuclear cell migration	16175	16847		0.5	0.5555555555555556	188	15987	4	5	184	15982	16175	0.09528197276057217
R1	cpdb	0	network_modules	296	TRUE	0.0027830589807225745	198	9	4	0.4444444444444444	0.020202020202020204	GO:0006813	GO:BP	potassium ion transport	16175	2493		0.625	0.6666666666666666	198	15977	4	5	194	15972	16175	0.0927410811334572
R1	cpdb	0	network_modules	296	TRUE	0.0028966644554025813	200	9	4	0.4444444444444444	0.02	GO:0030595	GO:BP	leukocyte chemotaxis	16175	6861		0.75	0.7777777777777778	200	15975	4	5	196	15970	16175	0.09225558609464156
R1	cpdb	0	network_modules	296	TRUE	0.009080520564939215	77	9	3	0.3333333333333333	0.03896103896103896	GO:0071677	GO:BP	positive regulation of mononuclear cell migration	16175	16850		0.875	0.8888888888888888	77	16098	3	6	74	16092	16175	0.11263274650641636
R1	cpdb	0	network_modules	296	TRUE	0.00995473712078291	273	9	4	0.4444444444444444	0.014652014652014652	GO:0060326	GO:BP	cell chemotaxis	16175	14538		1	1	273	15902	4	5	269	15897	16175	0.0783178536170622
R1	cpdb	0	network_modules	298	TRUE	2.406072651694606e-8	129	16	7	0.4375	0.05426356589147287	GO:0007204	GO:BP	positive regulation of cytosolic calcium ion concentration	16175	2759		0	0.09090909090909091	129	16046	7	9	122	16037	16175	0.1519521901521842
R1	cpdb	0	network_modules	298	TRUE	6.0869251942462094e-6	251	15	7	0.4666666666666667	0.027888446215139442	KEGG:04020	KEGG	Calcium signaling pathway	8484	250		0	0.25	251	8233	7	8	244	8225	8484	0.1085617396873396
R1	cpdb	0	network_modules	298	TRUE	9.771665771137553e-6	328	13	7	0.5384615384615384	0.021341463414634148	REAC:R-HSA-373076	REAC	Class A/1 (Rhodopsin-like receptors)	10916	365		0	0.25	328	10588	7	6	321	10582	10916	0.10283376252409424
R1	cpdb	0	network_modules	298	TRUE	1.0168772534800623e-5	5	16	3	0.1875	0.6	GO:0150099	GO:BP	neuron-glial cell signaling	16175	20139		0.1	0.18181818181818182	5	16170	3	13	2	16157	16175	0.33507476086645344
R1	cpdb	0	network_modules	298	TRUE	3.538174087102205e-5	9	13	3	0.23076923076923078	0.3333333333333333	REAC:R-HSA-390696	REAC	Adrenoceptors	10916	125		0.3333333333333333	0.5	9	10907	3	10	6	10897	10916	0.27663797046372274
R1	cpdb	0	network_modules	298	TRUE	9.950015721055327e-5	460	13	7	0.5384615384615384	0.015217391304347827	REAC:R-HSA-500792	REAC	GPCR ligand binding	10916	1019		0.6666666666666666	0.75	460	10456	7	6	453	10450	10916	0.08530286850239677
R1	cpdb	0	network_modules	298	TRUE	3.6813963209937937e-4	14	16	3	0.1875	0.21428571428571427	GO:0099560	GO:BP	synaptic membrane adhesion	16175	19138		0.2	0.36363636363636365	14	16161	3	13	11	16148	16175	0.1997058364840359
R1	cpdb	0	network_modules	298	TRUE	3.6813963209937937e-4	14	16	3	0.1875	0.21428571428571427	GO:0045907	GO:BP	positive regulation of vasoconstriction	16175	11703		0.2	0.36363636363636365	14	16161	3	13	11	16148	16175	0.1997058364840359
R1	cpdb	0	network_modules	298	TRUE	6.699854799579379e-4	181	15	5	0.3333333333333333	0.027624309392265192	KEGG:04360	KEGG	Axon guidance	8484	305		0.3333333333333333	0.5	181	8303	5	10	176	8293	8484	0.09087129098366344
R1	cpdb	0	network_modules	298	TRUE	0.0013394583334122192	21	16	3	0.1875	0.14285714285714285	GO:0071880	GO:BP	adenylate cyclase-activating adrenergic receptor signaling pathway	16175	16961		0.4	0.45454545454545453	21	16154	3	13	18	16141	16175	0.16271627577867978
R1	cpdb	0	network_modules	298	TRUE	0.002610604688637331	26	16	3	0.1875	0.11538461538461539	GO:0071875	GO:BP	adrenergic receptor signaling pathway	16175	16957		0.5	0.5454545454545454	26	16149	3	13	23	16136	16175	0.14601571742775804
R1	cpdb	0	network_modules	298	TRUE	0.004372703892369185	133	15	4	0.26666666666666666	0.03007518796992481	KEGG:04270	KEGG	Vascular smooth muscle contraction	8484	298		0.6666666666666666	0.75	133	8351	4	11	129	8340	8484	0.08503383195204782
R1	cpdb	0	network_modules	298	TRUE	0.004726971342761029	42	13	3	0.23076923076923078	0.07142857142857142	REAC:R-HSA-375280	REAC	Amine ligand-binding receptors	10916	139		1	1	42	10874	3	10	39	10864	10916	0.12656652430947055
R1	cpdb	0	network_modules	298	TRUE	0.005611552465660323	774	16	7	0.4375	0.00904392764857881	GO:0007186	GO:BP	G protein-coupled receptor signaling pathway	16175	2744		0.6	0.6363636363636364	774	15401	7	9	767	15392	16175	0.057441394034850844
R1	cpdb	0	network_modules	298	TRUE	0.005979481751801745	34	16	3	0.1875	0.08823529411764706	GO:0019229	GO:BP	regulation of vasoconstriction	16175	5603		0.7	0.7272727272727273	34	16141	3	13	31	16128	16175	0.1273788682887789
R1	cpdb	0	network_modules	298	TRUE	0.007048630844640989	4	16	2	0.125	0.5	GO:0001996	GO:BP	positive regulation of heart rate by epinephrine-norepinephrine	16175	600		0.8	0.9090909090909091	4	16171	2	14	2	16157	16175	0.24965977593568692
R1	cpdb	0	network_modules	298	TRUE	0.007048630844640989	4	16	2	0.125	0.5	GO:0003321	GO:BP	positive regulation of blood pressure by epinephrine-norepinephrine	16175	1741		0.8	0.9090909090909091	4	16171	2	14	2	16157	16175	0.24965977593568692
R1	cpdb	0	network_modules	298	TRUE	0.0075444415689372235	153	15	4	0.26666666666666666	0.026143790849673203	KEGG:04514	KEGG	Cell adhesion molecules	8484	315		1	1	153	8331	4	11	149	8320	8484	0.07863107662724728
R1	cpdb	0	network_modules	298	TRUE	0.007750094765573821	37	16	3	0.1875	0.08108108108108109	GO:0003044	GO:BP	regulation of systemic arterial blood pressure mediated by a chemical signal	16175	1495		1	1	37	16138	3	13	34	16125	16175	0.12199489618678971
R1	cpdb	0	network_modules	299	TRUE	5.873585968554873e-15	774	15	14	0.9333333333333333	0.01808785529715762	GO:0007186	GO:BP	G protein-coupled receptor signaling pathway	16175	2744		0	0.06666666666666667	774	15401	14	1	760	15400	16175	0.12638743358607454
R1	cpdb	0	network_modules	299	TRUE	1.2049961157981682e-14	328	14	12	0.8571428571428571	0.036585365853658534	REAC:R-HSA-373076	REAC	Class A/1 (Rhodopsin-like receptors)	10916	365		0	0.16666666666666666	328	10588	12	2	316	10586	10916	0.17361453404717772
R1	cpdb	0	network_modules	299	TRUE	7.230279405178992e-13	460	14	12	0.8571428571428571	0.02608695652173913	REAC:R-HSA-500792	REAC	GPCR ligand binding	10916	1019		0.2	0.3333333333333333	460	10456	12	2	448	10454	10916	0.14536903109765245
R1	cpdb	0	network_modules	299	TRUE	3.1709215275221876e-12	365	13	11	0.8461538461538461	0.030136986301369864	KEGG:04080	KEGG	Neuroactive ligand-receptor interaction	8484	263		0	0.25	365	8119	11	2	354	8117	8484	0.15505795542421588
R1	cpdb	0	network_modules	299	TRUE	7.730778811473257e-11	217	15	9	0.6	0.041474654377880185	GO:0007188	GO:BP	adenylate cyclase-modulating G protein-coupled receptor signaling pathway	16175	2746		0.07142857142857142	0.13333333333333333	217	15958	9	6	208	15952	16175	0.15533900893976518
R1	cpdb	0	network_modules	299	TRUE	1.3918618749698867e-7	10	15	4	0.26666666666666666	0.4	GO:0098664	GO:BP	G protein-coupled serotonin receptor signaling pathway	16175	18819		0.14285714285714285	0.2	10	16165	4	11	6	16154	16175	0.32609345663964423
R1	cpdb	0	network_modules	299	TRUE	2.61974790730274e-7	12	14	4	0.2857142857142857	0.3333333333333333	REAC:R-HSA-390666	REAC	Serotonin receptors	10916	2209		0.4	0.5	12	10904	4	10	8	10894	10916	0.30778586344036574
R1	cpdb	0	network_modules	299	TRUE	4.045736676878701e-7	42	14	5	0.35714285714285715	0.11904761904761904	REAC:R-HSA-375280	REAC	Amine ligand-binding receptors	10916	139		0.6	0.6666666666666666	42	10874	5	9	37	10865	10916	0.20449985241407267
R1	cpdb	0	network_modules	299	TRUE	5.289944355365527e-7	14	14	4	0.2857142857142857	0.2857142857142857	REAC:R-HSA-419408	REAC	Lysosphingolipid and LPA receptors	10916	1342		0.8	0.8333333333333334	14	10902	4	10	10	10892	10916	0.28479702282674213
R1	cpdb	0	network_modules	299	TRUE	2.461331749961432e-6	140	15	6	0.4	0.04285714285714286	GO:0007189	GO:BP	adenylate cyclase-activating G protein-coupled receptor signaling pathway	16175	2747		0.21428571428571427	0.26666666666666666	140	16035	6	9	134	16026	16175	0.12871529647454963
R1	cpdb	0	network_modules	299	TRUE	3.129527869739496e-5	7	15	3	0.2	0.42857142857142855	GO:0007198	GO:BP	adenylate cyclase-inhibiting serotonin receptor signaling pathway	16175	2756		0.2857142857142857	0.3333333333333333	7	16168	3	12	4	16156	16175	0.29233533147126006
R1	cpdb	0	network_modules	299	TRUE	3.33069717556992e-5	120	13	5	0.38461538461538464	0.041666666666666664	KEGG:04071	KEGG	Sphingolipid signaling pathway	8484	260		0.3333333333333333	0.5	120	8364	5	8	115	8356	8484	0.12290278103354939
R1	cpdb	0	network_modules	299	TRUE	2.3741196546625418e-4	56	15	4	0.26666666666666666	0.07142857142857142	GO:0007187	GO:BP	G protein-coupled receptor signaling pathway, coupled to cyclic nucleotide second messenger	16175	2745		0.35714285714285715	0.4	56	16119	4	11	52	16108	16175	0.136521026573879
R1	cpdb	0	network_modules	299	TRUE	7.072146164648378e-4	223	13	5	0.38461538461538464	0.02242152466367713	KEGG:04024	KEGG	cAMP signaling pathway	8484	252		0.6666666666666666	0.75	223	8261	5	8	218	8253	8484	0.08774455290036186
R1	cpdb	0	network_modules	299	TRUE	0.0010215289726539852	112	13	4	0.3076923076923077	0.03571428571428571	KEGG:04726	KEGG	Serotonergic synapse	8484	356		1	1	112	8372	4	9	108	8363	8484	0.10107724180305423
R1	cpdb	0	network_modules	299	TRUE	0.0021009342151664984	96	15	4	0.26666666666666666	0.041666666666666664	GO:0007200	GO:BP	phospholipase C-activating G protein-coupled receptor signaling pathway	16175	2758		0.42857142857142855	0.4666666666666667	96	16079	4	11	92	16068	16175	0.10341838362824629
R1	cpdb	0	network_modules	299	TRUE	0.003342824188508391	3	15	2	0.13333333333333333	0.6666666666666666	GO:0014062	GO:BP	regulation of serotonin secretion	16175	4632		0.5	0.5333333333333333	3	16172	2	13	1	16159	16175	0.29789344298100395
R1	cpdb	0	network_modules	299	TRUE	0.006682065795610729	4	15	2	0.13333333333333333	0.5	GO:0001820	GO:BP	serotonin secretion	16175	477		0.5714285714285714	0.6	4	16171	2	13	2	16158	16175	0.25787147420379075
R1	cpdb	0	network_modules	299	TRUE	0.007413973931031235	38	15	3	0.2	0.07894736842105263	GO:1903351	GO:BP	cellular response to dopamine	16175	22934		0.6428571428571429	0.7333333333333333	38	16137	3	12	35	16125	16175	0.1243839630022159
R1	cpdb	0	network_modules	299	TRUE	0.007413973931031235	38	15	3	0.2	0.07894736842105263	GO:1903350	GO:BP	response to dopamine	16175	22933		0.6428571428571429	0.7333333333333333	38	16137	3	12	35	16125	16175	0.1243839630022159
R1	cpdb	0	network_modules	299	TRUE	0.008673366523155073	40	15	3	0.2	0.075	GO:0071868	GO:BP	cellular response to monoamine stimulus	16175	16950		0.7857142857142857	1	40	16135	3	12	37	16123	16175	0.12116615688344903
R1	cpdb	0	network_modules	299	TRUE	0.008673366523155073	40	15	3	0.2	0.075	GO:0071869	GO:BP	response to catecholamine	16175	16951		0.7857142857142857	1	40	16135	3	12	37	16123	16175	0.12116615688344903
R1	cpdb	0	network_modules	299	TRUE	0.008673366523155073	40	15	3	0.2	0.075	GO:0071870	GO:BP	cellular response to catecholamine stimulus	16175	16952		0.7857142857142857	1	40	16135	3	12	37	16123	16175	0.12116615688344903
R1	cpdb	0	network_modules	299	TRUE	0.008673366523155073	40	15	3	0.2	0.075	GO:0071867	GO:BP	response to monoamine	16175	16949		0.7857142857142857	1	40	16135	3	12	37	16123	16175	0.12116615688344903
R1	cpdb	0	network_modules	299	TRUE	0.009405797123115846	312	14	5	0.35714285714285715	0.016025641025641024	REAC:R-HSA-418594	REAC	G alpha (i) signalling events	10916	987		1	1	312	10604	5	9	307	10595	10916	0.07066075230408725
R1	cpdb	0	network_modules	300	TRUE	3.781305042195105e-7	13	14	4	0.2857142857142857	0.3076923076923077	REAC:R-HSA-2564830	REAC	Cytosolic iron-sulfur cluster assembly	10916	427		NA	1	13	10903	4	10	9	10893	10916	0.2956294686627167
R1	cpdb	0	network_modules	300	TRUE	1.4668406750367057e-4	29	25	4	0.16	0.13793103448275862	GO:0031163	GO:BP	metallo-sulfur cluster assembly	16175	7078		0	0.5	29	16146	4	21	25	16125	16175	0.1471372225785833
R1	cpdb	0	network_modules	300	TRUE	1.4668406750367057e-4	29	25	4	0.16	0.13793103448275862	GO:0016226	GO:BP	iron-sulfur cluster assembly	16175	5177		0	0.5	29	16146	4	21	25	16125	16175	0.1471372225785833
R1	cpdb	0	network_modules	300	TRUE	0.0013775193493629088	50	10	3	0.3	0.06	KEGG:00565	KEGG	Ether lipid metabolism	8484	89		0	0.5	50	8434	3	7	47	8427	8484	0.13199556259439335
R1	cpdb	0	network_modules	300	TRUE	0.001632464525617017	52	25	4	0.16	0.07692307692307693	GO:0031122	GO:BP	cytoplasmic microtubule organization	16175	7047		0.6666666666666666	0.75	52	16123	4	21	48	16102	16175	0.10897036144172943
R1	cpdb	0	network_modules	300	TRUE	0.003004551327721982	193	10	4	0.4	0.02072538860103627	KEGG:04814	KEGG	Motor proteins	8484	366		1	1	193	8291	4	6	189	8285	8484	0.08691706625604982
R1	cpdb	0	network_modules	300	TRUE	0.0031234301241226206	17	25	3	0.12	0.17647058823529413	GO:0097428	GO:BP	protein maturation by iron-sulfur cluster transfer	16175	18654		1	1	17	16158	3	22	14	16136	16175	0.14443436822943198
R1	cpdb	0	network_modules	301	TRUE	6.930077344634957e-16	31	27	9	0.3333333333333333	0.2903225806451613	GO:0099022	GO:BP	vesicle tethering	16175	19011		0	0.058823529411764705	31	16144	9	18	22	16126	16175	0.3098524207096329
R1	cpdb	0	network_modules	301	TRUE	3.2199988905189636e-15	36	27	9	0.3333333333333333	0.25	GO:0006901	GO:BP	vesicle coating	16175	2554		0.0625	0.11764705882352941	36	16139	9	18	27	16121	16175	0.28730718665285176
R1	cpdb	0	network_modules	301	TRUE	7.992848574422495e-15	248	15	12	0.8	0.04838709677419355	KEGG:04144	KEGG	Endocytosis	8484	280		NA	1	248	8236	12	3	236	8233	8484	0.19256181647543943
R1	cpdb	0	network_modules	301	TRUE	9.274539146093311e-15	120	20	11	0.55	0.09166666666666666	REAC:R-HSA-9007101	REAC	Rab regulation of trafficking	10916	1939		0	0.16666666666666666	120	10796	11	9	109	10787	10916	0.22147121667840525
R1	cpdb	0	network_modules	301	TRUE	7.529297558827973e-14	126	27	11	0.4074074074074074	0.0873015873015873	GO:0006888	GO:BP	endoplasmic reticulum to Golgi vesicle-mediated transport	16175	2544		0.125	0.17647058823529413	126	16049	11	16	115	16033	16175	0.18586694308326432
R1	cpdb	0	network_modules	301	TRUE	4.1997140901108176e-13	59	27	9	0.3333333333333333	0.15254237288135594	GO:0006903	GO:BP	vesicle targeting	16175	2555		0.1875	0.23529411764705882	59	16116	9	18	50	16098	16175	0.22362086047147814
R1	cpdb	0	network_modules	301	TRUE	3.638669623253378e-12	74	27	9	0.3333333333333333	0.12162162162162163	GO:0006900	GO:BP	vesicle budding from membrane	16175	2553		0.25	0.29411764705882354	74	16101	9	18	65	16083	16175	0.19920550565646333
R1	cpdb	0	network_modules	301	TRUE	4.991078337381376e-12	88	20	9	0.45	0.10227272727272728	REAC:R-HSA-8876198	REAC	RAB GEFs exchange GTP for GDP on RABs	10916	1834		0.2	0.3333333333333333	88	10828	9	11	79	10817	10916	0.21173433792799634
R1	cpdb	0	network_modules	301	TRUE	5.824370667938543e-12	23	27	7	0.25925925925925924	0.30434782608695654	GO:0048207	GO:BP	vesicle targeting, rough ER to cis-Golgi	16175	12583		0.3125	0.4117647058823529	23	16152	7	20	16	16132	16175	0.27979213013039206
R1	cpdb	0	network_modules	301	TRUE	5.824370667938543e-12	23	27	7	0.25925925925925924	0.30434782608695654	GO:0048208	GO:BP	COPII vesicle coating	16175	12584		0.3125	0.4117647058823529	23	16152	7	20	16	16132	16175	0.27979213013039206
R1	cpdb	0	network_modules	301	TRUE	1.462671051841406e-11	284	27	12	0.4444444444444444	0.04225352112676056	GO:0048193	GO:BP	Golgi vesicle transport	16175	12570		0.4375	0.47058823529411764	284	15891	12	15	272	15876	16175	0.1329059494556934
R1	cpdb	0	network_modules	301	TRUE	4.8000433120887335e-11	30	27	7	0.25925925925925924	0.23333333333333334	GO:0048199	GO:BP	vesicle targeting, to, from or within Golgi	16175	12575		0.5	0.5294117647058824	30	16145	7	20	23	16125	16175	0.24462642038130689
R1	cpdb	0	network_modules	301	TRUE	2.2649737047592854e-10	178	27	10	0.37037037037037035	0.056179775280898875	GO:0051650	GO:BP	establishment of vesicle localization	16175	13863		0.5625	0.5882352941176471	178	15997	10	17	168	15980	16175	0.1408556237609804
R1	cpdb	0	network_modules	301	TRUE	3.5280507565211763e-10	186	27	10	0.37037037037037035	0.053763440860215055	GO:0051648	GO:BP	vesicle localization	16175	13861		0.625	0.6470588235294118	186	15989	10	17	176	15972	16175	0.13763795641667237
R1	cpdb	0	network_modules	301	TRUE	4.348412368717874e-10	40	27	7	0.25925925925925924	0.175	GO:0090114	GO:BP	COPII-coated vesicle budding	16175	18031		0.6875	0.7058823529411765	40	16135	7	20	33	16115	16175	0.211409345791381
R1	cpdb	0	network_modules	301	TRUE	1.982296652418263e-9	315	27	11	0.4074074074074074	0.03492063492063492	GO:0016050	GO:BP	vesicle organization	16175	5082		0.75	0.7647058823529411	315	15860	11	16	304	15844	16175	0.1147933041507977
R1	cpdb	0	network_modules	301	TRUE	6.512898453456699e-9	68	20	7	0.35	0.10294117647058823	REAC:R-HSA-204005	REAC	COPII-mediated vesicle transport	10916	280		0.4	0.5	68	10848	7	13	61	10835	10916	0.1871907697505198
R1	cpdb	0	network_modules	301	TRUE	3.436915437694308e-8	410	27	11	0.4074074074074074	0.026829268292682926	GO:0051656	GO:BP	establishment of organelle localization	16175	13869		0.8125	0.8235294117647058	410	15765	11	16	399	15749	16175	0.09939374557692734
R1	cpdb	0	network_modules	301	TRUE	4.274009261161682e-7	519	27	11	0.4074074074074074	0.02119460500963391	GO:0051640	GO:BP	organelle localization	16175	13853		0.875	0.8823529411764706	519	15656	11	16	508	15640	16175	0.08708541218437738
R1	cpdb	0	network_modules	301	TRUE	2.2791761883203586e-6	155	20	7	0.35	0.04516129032258064	REAC:R-HSA-199977	REAC	ER to Golgi Anterograde Transport	10916	823		0.6	0.6666666666666666	155	10761	7	13	148	10748	10916	0.12160021914429209
R1	cpdb	0	network_modules	301	TRUE	8.089417235386442e-6	186	20	7	0.35	0.03763440860215054	REAC:R-HSA-948021	REAC	Transport to the Golgi and subsequent modification	10916	2604		0.8	0.8333333333333334	186	10730	7	13	179	10717	10916	0.11022541425924963
R1	cpdb	0	network_modules	301	TRUE	8.043538801521703e-5	657	27	10	0.37037037037037035	0.015220700152207	GO:0061024	GO:BP	membrane organization	16175	15141		0.9375	0.9411764705882353	657	15518	10	17	647	15501	16175	0.06830521380962908
R1	cpdb	0	network_modules	301	TRUE	2.3777619057488525e-4	305	20	7	0.35	0.022950819672131147	REAC:R-HSA-446203	REAC	Asparagine N-linked glycosylation	10916	169		1	1	305	10611	7	13	298	10598	10916	0.08372455143063309
R1	cpdb	0	network_modules	301	TRUE	0.006059652159880835	263	27	6	0.2222222222222222	0.022813688212927757	GO:0006887	GO:BP	exocytosis	16175	2543		1	1	263	15912	6	21	257	15891	16175	0.06659089128279888
R1	cpdb	0	network_modules	302	TRUE	6.30429161665783e-5	10	14	3	0.21428571428571427	0.3	REAC:R-HSA-111367	REAC	SLBP independent Processing of Histone Pre-mRNAs	10916	2144		0	0.25	10	10906	3	11	7	10895	10916	0.2527401907718344
R1	cpdb	0	network_modules	302	TRUE	8.66184679648183e-5	11	14	3	0.21428571428571427	0.2727272727272727	REAC:R-HSA-77588	REAC	SLBP Dependent Processing of Replication-Dependent Histone Pre-mRNAs	10916	2143		0.3333333333333333	0.5	11	10905	3	11	8	10894	10916	0.24088589845447983
R1	cpdb	0	network_modules	302	TRUE	1.7637346519261835e-4	6	31	3	0.0967741935483871	0.5	GO:0006398	GO:BP	mRNA 3'-end processing by stem-loop binding and cleavage	16175	2159		0	0.5	6	16169	3	28	3	16141	16175	0.21937848589216366
R1	cpdb	0	network_modules	302	TRUE	3.446363856863182e-4	65	14	4	0.2857142857142857	0.06153846153846154	REAC:R-HSA-73856	REAC	RNA Polymerase II Transcription Termination	10916	1895		0.6666666666666666	0.75	65	10851	4	10	61	10841	10916	0.13030710196217885
R1	cpdb	0	network_modules	302	TRUE	0.0016977936561572006	28	14	3	0.21428571428571427	0.10714285714285714	REAC:R-HSA-75067	REAC	Processing of Capped Intronless Pre-mRNA	10916	1797		1	1	28	10888	3	11	25	10877	10916	0.14999771673998716
R1	cpdb	0	network_modules	302	TRUE	0.00987212164066852	20	31	3	0.0967741935483871	0.15	GO:0008334	GO:BP	histone mRNA metabolic process	16175	3165		1	1	20	16155	3	28	17	16127	16175	0.11913131732422176
R1	cpdb	0	network_modules	303	TRUE	0.008189363407425222	20	8	2	0.25	0.1	KEGG:00670	KEGG	One carbon pool by folate	8484	114		NA	1	20	8464	2	6	18	8458	8484	0.15688186613930497
R1	cpdb	0	network_modules	304	TRUE	1.4429930170550263e-33	34	18	15	0.8333333333333334	0.4411764705882353	KEGG:04710	KEGG	Circadian rhythm	8484	345		NA	1	34	8450	15	3	19	8447	8484	0.6052783475145105
R1	cpdb	0	network_modules	304	TRUE	1.4251577560225365e-22	68	24	13	0.5416666666666666	0.19117647058823528	GO:0032922	GO:BP	circadian regulation of gene expression	16175	7913		0	0.03225806451612903	68	16107	13	11	55	16096	16175	0.3202113367037508
R1	cpdb	0	network_modules	304	TRUE	9.985792539052787e-22	162	24	15	0.625	0.09259259259259259	GO:0007623	GO:BP	circadian rhythm	16175	3080		0.03333333333333333	0.06451612903225806	162	16013	15	9	147	16004	16175	0.23807870064991857
R1	cpdb	0	network_modules	304	TRUE	7.237062820757112e-21	184	24	15	0.625	0.08152173913043478	GO:0048511	GO:BP	rhythmic process	16175	12796		0.06666666666666667	0.0967741935483871	184	15991	15	9	169	15982	16175	0.22305199572544945
R1	cpdb	0	network_modules	304	TRUE	2.3954286610073942e-20	98	24	13	0.5416666666666666	0.1326530612244898	GO:0042752	GO:BP	regulation of circadian rhythm	16175	10345		0.1	0.12903225806451613	98	16077	13	11	85	16066	16175	0.2660612698685809
R1	cpdb	0	network_modules	304	TRUE	1.0691483629903346e-17	67	20	11	0.55	0.16417910447761194	REAC:R-HSA-400253	REAC	Circadian Clock	10916	363		0	0.25	67	10849	11	9	56	10840	10916	0.29833321832793047
R1	cpdb	0	network_modules	304	TRUE	3.2101091984256187e-12	24	24	7	0.2916666666666667	0.2916666666666667	GO:0009648	GO:BP	photoperiodism	16175	3566		0.13333333333333333	0.16129032258064516	24	16151	7	17	17	16134	16175	0.29061410026210965
R1	cpdb	0	network_modules	304	TRUE	4.317217614097774e-11	6	24	5	0.20833333333333334	0.8333333333333334	GO:2000323	GO:BP	negative regulation of glucocorticoid receptor signaling pathway	16175	25645		0.16666666666666666	0.1935483870967742	6	16169	5	19	1	16150	16175	0.4163109143989407
R1	cpdb	0	network_modules	304	TRUE	1.5095465620281888e-10	7	24	5	0.20833333333333334	0.7142857142857143	GO:2000322	GO:BP	regulation of glucocorticoid receptor signaling pathway	16175	25644		0.2	0.22580645161290322	7	16168	5	19	2	16149	16175	0.3853263463660893
R1	cpdb	0	network_modules	304	TRUE	8.405526865534196e-10	23	24	6	0.25	0.2608695652173913	GO:0043153	GO:BP	entrainment of circadian clock by photoperiod	16175	10557		0.23333333333333334	0.25806451612903225	23	16152	6	18	17	16134	16175	0.25429388213019977
R1	cpdb	0	network_modules	304	TRUE	1.9115640644454037e-9	26	24	6	0.25	0.23076923076923078	GO:0009649	GO:BP	entrainment of circadian clock	16175	3567		0.26666666666666666	0.2903225806451613	26	16149	6	18	20	16131	16175	0.239017297034195
R1	cpdb	0	network_modules	304	TRUE	3.3080129640261837e-9	11	24	5	0.20833333333333334	0.45454545454545453	GO:0042921	GO:BP	nuclear receptor-mediated glucocorticoid signaling pathway	16175	10445		0.3	0.3548387096774194	11	16164	5	19	6	16145	16175	0.3070564438264654
R1	cpdb	0	network_modules	304	TRUE	3.3080129640261837e-9	11	24	5	0.20833333333333334	0.45454545454545453	GO:0031958	GO:BP	nuclear receptor-mediated corticosteroid signaling pathway	16175	7302		0.3	0.3548387096774194	11	16164	5	19	6	16145	16175	0.3070564438264654
R1	cpdb	0	network_modules	304	TRUE	3.1951485775023775e-7	27	20	5	0.25	0.18518518518518517	REAC:R-HSA-1368108	REAC	BMAL1:CLOCK,NPAS2 activates circadian gene expression	10916	203		0.3333333333333333	0.5	27	10889	5	15	22	10874	10916	0.2134965759658583
R1	cpdb	0	network_modules	304	TRUE	4.229856119736689e-7	791	24	12	0.5	0.015170670037926675	GO:0000122	GO:BP	negative regulation of transcription by RNA polymerase II	16175	48		0.36666666666666664	0.3870967741935484	791	15384	12	12	779	15372	16175	0.08063017858997049
R1	cpdb	0	network_modules	304	TRUE	1.192982905931243e-6	31	24	5	0.20833333333333334	0.16129032258064516	GO:0033144	GO:BP	negative regulation of intracellular steroid hormone receptor signaling pathway	16175	8058		0.4	0.41935483870967744	31	16144	5	19	26	16125	16175	0.181931881867387
R1	cpdb	0	network_modules	304	TRUE	8.019683818215157e-6	178	24	7	0.2916666666666667	0.03932584269662921	GO:0009755	GO:BP	hormone-mediated signaling pathway	16175	3652		0.43333333333333335	0.45161290322580644	178	15997	7	17	171	15980	16175	0.10370616867914402
R1	cpdb	0	network_modules	304	TRUE	3.47743880354021e-5	220	24	7	0.2916666666666667	0.031818181818181815	GO:0009416	GO:BP	response to light stimulus	16175	3480		0.4666666666666667	0.4838709677419355	220	15955	7	17	213	15938	16175	0.09254169644108584
R1	cpdb	0	network_modules	304	TRUE	4.055932885691725e-5	61	24	5	0.20833333333333334	0.08196721311475409	GO:0033143	GO:BP	regulation of intracellular steroid hormone receptor signaling pathway	16175	8057		0.5	0.5161290322580645	61	16114	5	19	56	16095	16175	0.12864968833138613
R1	cpdb	0	network_modules	304	TRUE	1.2342971344852672e-4	408	24	8	0.3333333333333333	0.0196078431372549	GO:0071396	GO:BP	cellular response to lipid	16175	16648		0.5333333333333333	0.5483870967741935	408	15767	8	16	400	15751	16175	0.07574435709064858
R1	cpdb	0	network_modules	304	TRUE	2.684165597062792e-4	41	20	4	0.2	0.0975609756097561	REAC:R-HSA-383280	REAC	Nuclear Receptor transcription pathway	10916	1616		0.6666666666666666	0.75	41	10875	4	16	37	10859	10916	0.1374468858241915
R1	cpdb	0	network_modules	304	TRUE	2.904635564147676e-4	300	24	7	0.2916666666666667	0.023333333333333334	GO:0009314	GO:BP	response to radiation	16175	3460		0.5666666666666667	0.5806451612903226	300	15875	7	17	293	15858	16175	0.07803428534537005
R1	cpdb	0	network_modules	304	TRUE	4.694360666328932e-4	47	20	4	0.2	0.0851063829787234	REAC:R-HSA-9707616	REAC	Heme signaling	10916	1117		1	1	47	10869	4	16	43	10853	10916	0.12805001625440218
R1	cpdb	0	network_modules	304	TRUE	5.34501193424152e-4	10	24	3	0.125	0.3	GO:0042754	GO:BP	negative regulation of circadian rhythm	16175	10347		0.6	0.6451612903225806	10	16165	3	21	7	16144	16175	0.19289414781169373
R1	cpdb	0	network_modules	304	TRUE	5.34501193424152e-4	10	24	3	0.125	0.3	GO:0051775	GO:BP	response to redox state	16175	13928		0.6	0.6451612903225806	10	16165	3	21	7	16144	16175	0.19289414781169373
R1	cpdb	0	network_modules	304	TRUE	6.927797419248009e-4	107	24	5	0.20833333333333334	0.04672897196261682	GO:0030518	GO:BP	nuclear receptor-mediated steroid hormone signaling pathway	16175	6833		0.6666666666666666	0.6774193548387096	107	16068	5	19	102	16049	16175	0.09592293449922787
R1	cpdb	0	network_modules	304	TRUE	7.598393850199763e-4	109	24	5	0.20833333333333334	0.045871559633027525	GO:0043401	GO:BP	steroid hormone receptor signaling pathway	16175	10670		0.7	0.7096774193548387	109	16066	5	19	104	16047	16175	0.09498648886102821
R1	cpdb	0	network_modules	304	TRUE	7.888064458692495e-4	520	24	8	0.3333333333333333	0.015384615384615385	GO:0033993	GO:BP	response to lipid	16175	8371		0.7333333333333333	0.7419354838709677	520	15655	8	16	512	15639	16175	0.06581960466855549
R1	cpdb	0	network_modules	304	TRUE	0.0016150142932310726	14	24	3	0.125	0.21428571428571427	GO:0042753	GO:BP	positive regulation of circadian rhythm	16175	10346		0.7666666666666667	0.7741935483870968	14	16161	3	21	11	16140	16175	0.16272131740802678
R1	cpdb	0	network_modules	304	TRUE	0.0020168021160694542	15	24	3	0.125	0.2	GO:0042634	GO:BP	regulation of hair cycle	16175	10267		0.8	0.8064516129032258	15	16160	3	21	12	16139	16175	0.15713029557594074
R1	cpdb	0	network_modules	304	TRUE	0.0028212425804743082	142	24	5	0.20833333333333334	0.035211267605633804	GO:0071383	GO:BP	cellular response to steroid hormone stimulus	16175	16635		0.8333333333333334	0.8387096774193549	142	16033	5	19	137	16014	16175	0.08246313471246118
R1	cpdb	0	network_modules	304	TRUE	0.0032968362412703106	2	24	2	0.08333333333333333	1	GO:0071483	GO:BP	cellular response to blue light	16175	16716		0.8666666666666667	0.9032258064516129	2	16173	2	22	0	16151	16175	0.28847872656338225
R1	cpdb	0	network_modules	304	TRUE	0.0032968362412703106	2	24	2	0.08333333333333333	1	GO:0009785	GO:BP	blue light signaling pathway	16175	3672		0.8666666666666667	0.9032258064516129	2	16173	2	22	0	16151	16175	0.28847872656338225
R1	cpdb	0	network_modules	304	TRUE	0.003944586604494704	152	24	5	0.20833333333333334	0.03289473684210526	GO:0141193	GO:BP	nuclear receptor-mediated signaling pathway	16175	20078		0.9333333333333333	0.9354838709677419	152	16023	5	19	147	16004	16175	0.07948224485517424
R1	cpdb	0	network_modules	304	TRUE	0.0044825572103734	451	24	7	0.2916666666666667	0.015521064301552107	GO:0032870	GO:BP	cellular response to hormone stimulus	16175	7867		0.9666666666666667	0.967741935483871	451	15724	7	17	444	15707	16175	0.06176309913989986
R1	cpdb	0	network_modules	304	TRUE	0.0060785703325781665	166	24	5	0.20833333333333334	0.030120481927710843	GO:0048545	GO:BP	response to steroid hormone	16175	12826		1	1	166	16009	5	19	161	15990	16175	0.07575896509727265
R1	cpdb	0	network_modules	305	TRUE	4.3036828761237456e-17	72	29	12	0.41379310344827586	0.16666666666666666	REAC:R-HSA-199992	REAC	trans-Golgi Network Vesicle Budding	10916	2749		0	0.045454545454545456	72	10844	12	17	60	10827	10916	0.25962845025435716
R1	cpdb	0	network_modules	305	TRUE	5.816927553366196e-17	144	29	14	0.4827586206896552	0.09722222222222222	REAC:R-HSA-8856828	REAC	Clathrin-mediated endocytosis	10916	372		0.047619047619047616	0.09090909090909091	144	10772	14	15	130	10757	10916	0.21241077401673
R1	cpdb	0	network_modules	305	TRUE	1.6693293778780937e-16	21	29	9	0.3103448275862069	0.42857142857142855	REAC:R-HSA-164938	REAC	Nef-mediates down modulation of cell surface receptors by recruiting them to clathrin adapters	10916	1565		0.09523809523809523	0.13636363636363635	21	10895	9	20	12	10875	10916	0.3632696834965918
R1	cpdb	0	network_modules	305	TRUE	2.6355350981378827e-15	27	29	9	0.3103448275862069	0.3333333333333333	REAC:R-HSA-164952	REAC	The role of Nef in HIV-1 replication and disease pathogenesis	10916	2504		0.14285714285714285	0.18181818181818182	27	10889	9	20	18	10869	10916	0.31989088965995693
R1	cpdb	0	network_modules	305	TRUE	1.428028183475506e-14	533	36	18	0.5	0.03377110694183865	GO:0006897	GO:BP	endocytosis	16175	2551		0	0.045454545454545456	533	15642	18	18	515	15624	16175	0.1235688257930689
R1	cpdb	0	network_modules	305	TRUE	2.3705808209710696e-14	54	29	10	0.3448275862068966	0.18518518518518517	REAC:R-HSA-432722	REAC	Golgi Associated Vesicle Biogenesis	10916	1082		0.19047619047619047	0.22727272727272727	54	10862	10	19	44	10843	10916	0.25002484340425896
R1	cpdb	0	network_modules	305	TRUE	3.9182658613805095e-14	35	29	9	0.3103448275862069	0.2571428571428571	REAC:R-HSA-432720	REAC	Lysosome Vesicle Biogenesis	10916	1341		0.23809523809523808	0.2727272727272727	35	10881	9	20	26	10861	10916	0.2803975930642959
R1	cpdb	0	network_modules	305	TRUE	4.539874861034778e-12	740	36	18	0.5	0.024324324324324326	GO:0098657	GO:BP	import into cell	16175	18813		0.047619047619047616	0.09090909090909091	740	15435	18	18	722	15417	16175	0.10267940835083483
R1	cpdb	0	network_modules	305	TRUE	1.4756088852783665e-11	10	29	6	0.20689655172413793	0.6	REAC:R-HSA-164940	REAC	Nef mediated downregulation of MHC class I complex cell surface expression	10916	1564		0.2857142857142857	0.3181818181818182	10	10906	6	23	4	10883	10916	0.35139995582055766
R1	cpdb	0	network_modules	305	TRUE	2.387645500594742e-11	104	29	10	0.3448275862068966	0.09615384615384616	REAC:R-HSA-8856825	REAC	Cargo recognition for clathrin-mediated endocytosis	10916	309		0.3333333333333333	0.36363636363636365	104	10812	10	19	94	10793	10916	0.17814459545179306
R1	cpdb	0	network_modules	305	TRUE	1.3313187094528444e-10	123	29	10	0.3448275862068966	0.08130081300813008	REAC:R-HSA-2132295	REAC	MHC class II antigen presentation	10916	1371		0.38095238095238093	0.4090909090909091	123	10793	10	19	113	10774	10916	0.1631016573492062
R1	cpdb	0	network_modules	305	TRUE	1.6553999366895763e-9	131	23	9	0.391304347826087	0.06870229007633588	KEGG:04142	KEGG	Lysosome	8484	279		0	0.2	131	8353	9	14	122	8339	8484	0.15893773372657047
R1	cpdb	0	network_modules	305	TRUE	7.857019632076218e-9	126	29	9	0.3103448275862069	0.07142857142857142	REAC:R-HSA-162909	REAC	Host Interactions of HIV factors	10916	1132		0.42857142857142855	0.45454545454545453	126	10790	9	20	117	10770	10916	0.14437637061290248
R1	cpdb	0	network_modules	305	TRUE	5.942545933339054e-8	221	36	10	0.2777777777777778	0.04524886877828054	GO:0006898	GO:BP	receptor-mediated endocytosis	16175	2552		0.09523809523809523	0.13636363636363635	221	15954	10	26	211	15928	16175	0.10745308796852038
R1	cpdb	0	network_modules	305	TRUE	3.025356471920475e-7	16	36	5	0.1388888888888889	0.3125	GO:0048268	GO:BP	clathrin coat assembly	16175	12619		0.14285714285714285	0.18181818181818182	16	16159	5	31	11	16128	16175	0.20718263100741482
R1	cpdb	0	network_modules	305	TRUE	4.953328187265163e-7	248	23	9	0.391304347826087	0.036290322580645164	KEGG:04144	KEGG	Endocytosis	8484	280		0.25	0.4	248	8236	9	14	239	8222	8484	0.11206388782521677
R1	cpdb	0	network_modules	305	TRUE	8.01522292945338e-7	19	36	5	0.1388888888888889	0.2631578947368421	GO:1903232	GO:BP	melanosome assembly	16175	22844		0.19047619047619047	0.22727272727272727	19	16156	5	31	14	16125	16175	0.1898857373553742
R1	cpdb	0	network_modules	305	TRUE	8.979533331037592e-7	44	36	6	0.16666666666666666	0.13636363636363635	GO:0072583	GO:BP	clathrin-dependent endocytosis	16175	17454		0.23809523809523808	0.2727272727272727	44	16131	6	30	38	16101	16175	0.1486627564609764
R1	cpdb	0	network_modules	305	TRUE	1.4007358950631921e-6	225	29	9	0.3103448275862069	0.04	REAC:R-HSA-162906	REAC	HIV Infection	10916	1102		0.47619047619047616	0.5	225	10691	9	20	216	10671	10916	0.10524604309977871
R1	cpdb	0	network_modules	305	TRUE	2.9064847794289807e-6	24	36	5	0.1388888888888889	0.20833333333333334	GO:0060155	GO:BP	platelet dense granule organization	16175	14393		0.2857142857142857	0.3181818181818182	24	16151	5	31	19	16120	16175	0.16859892755212125
R1	cpdb	0	network_modules	305	TRUE	9.87750514597317e-6	13	29	4	0.13793103448275862	0.3076923076923077	REAC:R-HSA-5140745	REAC	WNT5A-dependent internalization of FZD2, FZD5 and ROR2	10916	2671		0.5238095238095238	0.5454545454545454	13	10903	4	25	9	10878	10916	0.20462547263076947
R1	cpdb	0	network_modules	305	TRUE	1.3803161782382689e-5	14	29	4	0.13793103448275862	0.2857142857142857	REAC:R-HSA-177504	REAC	Retrograde neurotrophin signalling	10916	2095		0.5714285714285714	0.5909090909090909	14	10902	4	25	10	10877	10916	0.1970589748743744
R1	cpdb	0	network_modules	305	TRUE	1.8787994767816448e-5	15	29	4	0.13793103448275862	0.26666666666666666	REAC:R-HSA-5099900	REAC	WNT5A-dependent internalization of FZD4	10916	2672		0.6190476190476191	0.6363636363636364	15	10901	4	25	11	10876	10916	0.19025815438509427
R1	cpdb	0	network_modules	305	TRUE	2.500474593165192e-5	16	29	4	0.13793103448275862	0.25	REAC:R-HSA-8866427	REAC	VLDLR internalisation and degradation	10916	2639		0.6666666666666666	0.6818181818181818	16	10900	4	25	12	10875	10916	0.18410152929061982
R1	cpdb	0	network_modules	305	TRUE	3.8437910257319564e-5	39	36	5	0.1388888888888889	0.1282051282051282	GO:0048753	GO:BP	pigment granule organization	16175	13004		0.3333333333333333	0.4090909090909091	39	16136	5	31	34	16105	16175	0.13142829399450512
R1	cpdb	0	network_modules	305	TRUE	3.8437910257319564e-5	39	36	5	0.1388888888888889	0.1282051282051282	GO:0032438	GO:BP	melanosome organization	16175	7566		0.3333333333333333	0.4090909090909091	39	16136	5	31	34	16105	16175	0.13142829399450512
R1	cpdb	0	network_modules	305	TRUE	5.2959596417717967e-05	19	29	4	0.13793103448275862	0.21052631578947367	REAC:R-HSA-8964038	REAC	LDL clearance	10916	1295		0.7142857142857143	0.7272727272727273	19	10897	4	25	15	10872	10916	0.16862612409021815
R1	cpdb	0	network_modules	305	TRUE	5.795313042419712e-5	210	23	7	0.30434782608695654	0.03333333333333333	KEGG:05170	KEGG	Human immunodeficiency virus 1 infection	8484	451		0.5	0.6	210	8274	7	16	203	8258	8484	0.09382450250540118
R1	cpdb	0	network_modules	305	TRUE	6.97210601025076e-5	4	36	3	0.08333333333333333	0.75	GO:0110010	GO:BP	basolateral protein secretion	16175	19342		0.42857142857142855	0.45454545454545453	4	16171	3	33	1	16138	16175	0.24956682001728187
R1	cpdb	0	network_modules	305	TRUE	1.699380480989403e-4	52	36	5	0.1388888888888889	0.09615384615384616	GO:0033363	GO:BP	secretory granule organization	16175	8173		0.47619047619047616	0.5	52	16123	5	31	47	16092	16175	0.113195568035782
R1	cpdb	0	network_modules	305	TRUE	2.0485375706182893e-4	7	29	3	0.10344827586206896	0.42857142857142855	REAC:R-HSA-182218	REAC	Nef Mediated CD8 Down-regulation	10916	1561		0.7619047619047619	0.7727272727272727	7	10909	3	26	4	10883	10916	0.20959922600760542
R1	cpdb	0	network_modules	305	TRUE	2.967490878165834e-4	58	36	5	0.1388888888888889	0.08620689655172414	GO:0033059	GO:BP	cellular pigmentation	16175	8013		0.5238095238095238	0.5454545454545454	58	16117	5	31	53	16086	16175	0.10690767952150994
R1	cpdb	0	network_modules	305	TRUE	4.898939357862951e-4	9	29	3	0.10344827586206896	0.3333333333333333	REAC:R-HSA-167590	REAC	Nef Mediated CD4 Down-regulation	10916	1560		0.8095238095238095	0.8181818181818182	9	10907	3	26	6	10881	10916	0.18453663061859446
R1	cpdb	0	network_modules	305	TRUE	6.144248526851965e-4	315	36	8	0.2222222222222222	0.025396825396825397	GO:0016050	GO:BP	vesicle organization	16175	5082		0.5714285714285714	0.5909090909090909	315	15860	8	28	307	15832	16175	0.06929571006970048
R1	cpdb	0	network_modules	305	TRUE	7.074629780428618e-4	53	23	4	0.17391304347826086	0.07547169811320754	KEGG:04961	KEGG	Endocrine and other factor-regulated calcium reabsorption	8484	397		0.75	0.8	53	8431	4	19	49	8412	8484	0.11094844736667987
R1	cpdb	0	network_modules	305	TRUE	7.801335699325698e-4	36	29	4	0.13793103448275862	0.1111111111111111	REAC:R-HSA-8964043	REAC	Plasma lipoprotein clearance	10916	1757		0.8571428571428571	0.8636363636363636	36	10880	4	25	32	10855	10916	0.12119777219875617
R1	cpdb	0	network_modules	305	TRUE	9.701339779040485e-4	8	36	3	0.08333333333333333	0.375	GO:0072318	GO:BP	clathrin coat disassembly	16175	17346		0.6190476190476191	0.7272727272727273	8	16167	3	33	5	16134	16175	0.17596691334509712
R1	cpdb	0	network_modules	305	TRUE	9.701339779040485e-4	8	36	3	0.08333333333333333	0.375	GO:0098884	GO:BP	postsynaptic neurotransmitter receptor internalization	16175	18929		0.6190476190476191	0.7272727272727273	8	16167	3	33	5	16134	16175	0.17596691334509712
R1	cpdb	0	network_modules	305	TRUE	9.701339779040485e-4	8	36	3	0.08333333333333333	0.375	GO:0140239	GO:BP	postsynaptic endocytosis	16175	19710		0.6190476190476191	0.7272727272727273	8	16167	3	33	5	16134	16175	0.17596691334509712
R1	cpdb	0	network_modules	305	TRUE	0.0012761921296067316	12	29	3	0.10344827586206896	0.25	REAC:R-HSA-190873	REAC	Gap junction degradation	10916	1034		0.9047619047619048	0.9090909090909091	12	10904	3	26	9	10878	10916	0.15940735486820992
R1	cpdb	0	network_modules	305	TRUE	0.0014529744823829867	9	36	3	0.08333333333333333	0.3333333333333333	GO:0072319	GO:BP	vesicle uncoating	16175	17347		0.7619047619047619	0.7727272727272727	9	16166	3	33	6	16133	16175	0.16578450819462554
R1	cpdb	0	network_modules	305	TRUE	0.0015993807013050313	81	36	5	0.1388888888888889	0.06172839506172839	GO:0043473	GO:BP	pigmentation	16175	10719		0.8095238095238095	0.8181818181818182	81	16094	5	31	76	16063	16175	0.08957817094880777
R1	cpdb	0	network_modules	305	TRUE	0.0025208946176748528	48	29	4	0.13793103448275862	0.08333333333333333	REAC:R-HSA-437239	REAC	Recycling pathway of L1	10916	1954		0.9523809523809523	0.9545454545454546	48	10868	4	25	44	10843	10916	0.10416078684667725
R1	cpdb	0	network_modules	305	TRUE	0.002739943297283656	49	29	4	0.13793103448275862	0.08163265306122448	REAC:R-HSA-3928665	REAC	EPH-ephrin mediated repulsion of cells	10916	819		1	1	49	10867	4	25	45	10842	10916	0.10302645800178968
R1	cpdb	0	network_modules	305	TRUE	0.0032948800658956488	78	23	4	0.17391304347826086	0.05128205128205128	KEGG:04721	KEGG	Synaptic vesicle cycle	8484	351		1	1	78	8406	4	19	74	8387	8484	0.08998210259838092
R1	cpdb	0	network_modules	305	TRUE	0.004558985155889481	100	36	5	0.1388888888888889	0.05	GO:0006892	GO:BP	post-Golgi vesicle-mediated transport	16175	2547		0.8571428571428571	0.8636363636363636	100	16075	5	31	95	16044	16175	0.07996021657653764
R1	cpdb	0	network_modules	305	TRUE	0.00624821086171651	14	36	3	0.08333333333333333	0.21428571428571427	GO:0099590	GO:BP	neurotransmitter receptor internalization	16175	19154		0.9047619047619048	0.9090909090909091	14	16161	3	33	11	16128	16175	0.13244742079327596
R1	cpdb	0	network_modules	305	TRUE	0.007028268158106259	49	36	4	0.1111111111111111	0.08163265306122448	GO:0048488	GO:BP	synaptic vesicle endocytosis	16175	12781		0.9523809523809523	1	49	16126	4	32	45	16094	16175	0.09288556095502297
R1	cpdb	0	network_modules	305	TRUE	0.007028268158106259	49	36	4	0.1111111111111111	0.08163265306122448	GO:0140238	GO:BP	presynaptic endocytosis	16175	19709		0.9523809523809523	1	49	16126	4	32	45	16094	16175	0.09288556095502297
R1	cpdb	0	network_modules	306	TRUE	9.955493138054687e-18	26	22	9	0.4090909090909091	0.34615384615384615	GO:0006506	GO:BP	GPI anchor biosynthetic process	16175	2232		0	0.04	26	16149	9	13	17	16136	16175	0.375387285947472
R1	cpdb	0	network_modules	306	TRUE	1.4922422913775543e-17	27	22	9	0.4090909090909091	0.3333333333333333	GO:0006505	GO:BP	GPI anchor metabolic process	16175	2231		0.041666666666666664	0.08	27	16148	9	13	18	16135	16175	0.36832559709151047
R1	cpdb	0	network_modules	306	TRUE	6.400204139733614e-17	31	22	9	0.4090909090909091	0.2903225806451613	GO:0180046	GO:BP	GPI anchored protein biosynthesis	16175	20314		0.08333333333333333	0.12	31	16144	9	13	22	16131	16175	0.3435761796080431
R1	cpdb	0	network_modules	306	TRUE	4.846272494733908e-14	26	12	7	0.5833333333333334	0.2692307692307692	KEGG:00563	KEGG	Glycosylphosphatidylinositol (GPI)-anchor biosynthesis	8484	87		0	0.5	26	8458	7	5	19	8453	8484	0.3950999464834769
R1	cpdb	0	network_modules	306	TRUE	1.3224359367444995e-13	67	22	9	0.4090909090909091	0.13432835820895522	GO:0009247	GO:BP	glycolipid biosynthetic process	16175	3412		0.125	0.16	67	16108	9	13	58	16095	16175	0.23268631716420962
R1	cpdb	0	network_modules	306	TRUE	2.638577200029934e-12	92	22	9	0.4090909090909091	0.09782608695652174	GO:0006664	GO:BP	glycolipid metabolic process	16175	2373		0.16666666666666666	0.2	92	16083	9	13	83	16070	16175	0.19796610601771625
R1	cpdb	0	network_modules	306	TRUE	2.9191590398409354e-12	93	22	9	0.4090909090909091	0.0967741935483871	GO:1903509	GO:BP	liposaccharide metabolic process	16175	23059		0.20833333333333334	0.24	93	16082	9	13	84	16069	16175	0.19687484033288874
R1	cpdb	0	network_modules	306	TRUE	8.236169269317022e-12	17	15	6	0.4	0.35294117647058826	REAC:R-HSA-162710	REAC	Synthesis of glycosylphosphatidylinositol (GPI)	10916	2409		0	0.14285714285714285	17	10899	6	9	11	10890	10916	0.37482109308828
R1	cpdb	0	network_modules	306	TRUE	2.275365678986282e-11	116	22	9	0.4090909090909091	0.07758620689655173	GO:0006661	GO:BP	phosphatidylinositol biosynthetic process	16175	2370		0.25	0.28	116	16059	9	13	107	16046	16175	0.17578414574905402
R1	cpdb	0	network_modules	306	TRUE	3.2882770261838637e-11	91	15	8	0.5333333333333333	0.08791208791208792	REAC:R-HSA-163125	REAC	Post-translational modification: synthesis of GPI-anchored proteins	10916	1775		0.16666666666666666	0.2857142857142857	91	10825	8	7	83	10818	10916	0.21418946960002253
R1	cpdb	0	network_modules	306	TRUE	6.504523776170069e-11	130	22	9	0.4090909090909091	0.06923076923076923	GO:0046467	GO:BP	membrane lipid biosynthetic process	16175	12175		0.2916666666666667	0.32	130	16045	9	13	121	16032	16175	0.16576397328880652
R1	cpdb	0	network_modules	306	TRUE	9.845117630718056e-11	136	22	9	0.4090909090909091	0.0661764705882353	GO:0046488	GO:BP	phosphatidylinositol metabolic process	16175	12192		0.3333333333333333	0.36	136	16039	9	13	127	16026	16175	0.16194655478708606
R1	cpdb	0	network_modules	306	TRUE	1.2707521774032956e-9	180	22	9	0.4090909090909091	0.05	GO:0006643	GO:BP	membrane lipid metabolic process	16175	2354		0.375	0.4	180	15995	9	13	171	15982	16175	0.14000480627334416
R1	cpdb	0	network_modules	306	TRUE	1.97778053503752e-9	189	22	9	0.4090909090909091	0.047619047619047616	GO:0046474	GO:BP	glycerophospholipid biosynthetic process	16175	12181		0.4166666666666667	0.44	189	15986	9	13	180	15973	16175	0.13647807134736434
R1	cpdb	0	network_modules	306	TRUE	7.1820280137938365e-9	218	22	9	0.4090909090909091	0.04128440366972477	GO:0008654	GO:BP	phospholipid biosynthetic process	16175	3225		0.4583333333333333	0.48	218	15957	9	13	209	15944	16175	0.12661818086169685
R1	cpdb	0	network_modules	306	TRUE	9.935237527007362e-9	226	22	9	0.4090909090909091	0.03982300884955752	GO:0045017	GO:BP	glycerolipid biosynthetic process	16175	11231		0.5	0.52	226	15949	9	13	217	15936	16175	0.1242326363849398
R1	cpdb	0	network_modules	306	TRUE	4.738206075258554e-8	269	22	9	0.4090909090909091	0.03345724907063197	GO:0006650	GO:BP	glycerophospholipid metabolic process	16175	2360		0.5416666666666666	0.56	269	15906	9	13	260	15893	16175	0.11325780555568062
R1	cpdb	0	network_modules	306	TRUE	2.7704560427983046e-7	328	22	9	0.4090909090909091	0.027439024390243903	GO:0006644	GO:BP	phospholipid metabolic process	16175	2355		0.5833333333333334	0.6	328	15847	9	13	319	15834	16175	0.10180263676294943
R1	cpdb	0	network_modules	306	TRUE	3.5218901025709164e-7	337	22	9	0.4090909090909091	0.026706231454005934	GO:0046486	GO:BP	glycerolipid metabolic process	16175	12190		0.625	0.64	337	15838	9	13	328	15825	16175	0.10031881910807186
R1	cpdb	0	network_modules	306	TRUE	6.601829600208044e-7	3	15	3	0.2	1	REAC:R-HSA-4719377	REAC	Defective DPM2 causes DPM2-CDG	10916	536		0.3333333333333333	0.8571428571428571	3	10913	3	12	0	10901	10916	0.44696764849941306
R1	cpdb	0	network_modules	306	TRUE	6.601829600208044e-7	3	15	3	0.2	1	REAC:R-HSA-162699	REAC	Synthesis of dolichyl-phosphate mannose	10916	2406		0.3333333333333333	0.8571428571428571	3	10913	3	12	0	10901	10916	0.44696764849941306
R1	cpdb	0	network_modules	306	TRUE	6.601829600208044e-7	3	15	3	0.2	1	REAC:R-HSA-4719360	REAC	Defective DPM3 causes DPM3-CDG	10916	537		0.3333333333333333	0.8571428571428571	3	10913	3	12	0	10901	10916	0.44696764849941306
R1	cpdb	0	network_modules	306	TRUE	6.601829600208044e-7	3	15	3	0.2	1	REAC:R-HSA-4717374	REAC	Defective DPM1 causes DPM1-CDG	10916	535		0.3333333333333333	0.8571428571428571	3	10913	3	12	0	10901	10916	0.44696764849941306
R1	cpdb	0	network_modules	306	TRUE	8.337563935942474e-6	483	22	9	0.4090909090909091	0.018633540372670808	GO:0051604	GO:BP	protein maturation	16175	13821		0.6666666666666666	0.68	483	15692	9	13	474	15679	16175	0.0822278658417111
R1	cpdb	0	network_modules	306	TRUE	1.3850308530372782e-5	512	22	9	0.4090909090909091	0.017578125	GO:0090407	GO:BP	organophosphate biosynthetic process	16175	18274		0.7083333333333334	0.72	512	15663	9	13	503	15650	16175	0.07956117551871425
R1	cpdb	0	network_modules	306	TRUE	1.4327598383229331e-5	514	22	9	0.4090909090909091	0.017509727626459144	GO:1901137	GO:BP	carbohydrate derivative biosynthetic process	16175	21245		0.75	0.76	514	15661	9	13	505	15648	16175	0.07938529155249235
R1	cpdb	0	network_modules	306	TRUE	2.9459287822291964e-5	5	22	3	0.13636363636363635	0.6	GO:0019348	GO:BP	dolichol metabolic process	16175	5711		0.7916666666666666	0.8	5	16170	3	19	2	16151	16175	0.2856287946220628
R1	cpdb	0	network_modules	306	TRUE	7.762582571276405e-5	625	22	9	0.4090909090909091	0.0144	GO:0008610	GO:BP	lipid biosynthetic process	16175	3206		0.8333333333333334	0.84	625	15550	9	13	616	15537	16175	0.07093403055989356
R1	cpdb	0	network_modules	306	TRUE	1.645363116300115e-4	8	22	3	0.13636363636363635	0.375	GO:0016093	GO:BP	polyprenol metabolic process	16175	5113		0.875	0.88	8	16167	3	19	5	16148	16175	0.2255224840135997
R1	cpdb	0	network_modules	306	TRUE	2.9742366987012964e-4	15	15	3	0.2	0.2	REAC:R-HSA-5609975	REAC	Diseases associated with glycosylation precursor biosynthesis	10916	751		1	1	15	10901	3	12	12	10889	10916	0.19889918356114117
R1	cpdb	0	network_modules	306	TRUE	0.0019821535752296933	17	22	3	0.13636363636363635	0.17647058823529413	GO:0035268	GO:BP	protein mannosylation	16175	8932		0.9166666666666666	0.96	17	16158	3	19	14	16139	16175	0.15411649072490274
R1	cpdb	0	network_modules	306	TRUE	0.0019821535752296933	17	22	3	0.13636363636363635	0.17647058823529413	GO:0035269	GO:BP	protein O-linked mannosylation	16175	8933		0.9166666666666666	0.96	17	16158	3	19	14	16139	16175	0.15411649072490274
R1	cpdb	0	network_modules	306	TRUE	0.002376488672544942	18	22	3	0.13636363636363635	0.16666666666666666	GO:0097502	GO:BP	mannosylation	16175	18684		1	1	18	16157	3	19	15	16138	16175	0.14971050876290892
R1	cpdb	0	network_modules	306	TRUE	0.002863306504235894	53	12	3	0.25	0.05660377358490566	KEGG:00510	KEGG	N-Glycan biosynthesis	8484	63		1	1	53	8431	3	9	50	8422	8484	0.11643155680496282
R1	cpdb	0	network_modules	307	TRUE	8.51792966012595e-33	96	30	20	0.6666666666666666	0.20833333333333334	REAC:R-HSA-5620912	REAC	Anchoring of the basal body to the plasma membrane	10916	147		0	0.07142857142857142	96	10820	20	10	76	10810	10916	0.3698982708572595
R1	cpdb	0	network_modules	307	TRUE	3.3302100741818578e-31	586	58	34	0.5862068965517241	0.05802047781569966	GO:0000226	GO:BP	microtubule cytoskeleton organization	16175	61		0	0.022222222222222223	586	15589	34	24	552	15565	16175	0.17656461885152447
R1	cpdb	0	network_modules	307	TRUE	4.580150728749281e-31	68	30	18	0.6	0.2647058823529412	REAC:R-HSA-380259	REAC	Loss of Nlp from mitotic centrosomes	10916	1331		0.07692307692307693	0.21428571428571427	68	10848	18	12	50	10836	10916	0.39616800054396906
R1	cpdb	0	network_modules	307	TRUE	4.580150728749281e-31	68	30	18	0.6	0.2647058823529412	REAC:R-HSA-380284	REAC	Loss of proteins required for interphase microtubule organization from the centrosome	10916	1335		0.07692307692307693	0.21428571428571427	68	10848	18	12	50	10836	10916	0.39616800054396906
R1	cpdb	0	network_modules	307	TRUE	1.1139614367002388e-30	71	30	18	0.6	0.2535211267605634	REAC:R-HSA-8854518	REAC	AURKA Activation by TPX2	10916	41		0.23076923076923078	0.2857142857142857	71	10845	18	12	53	10833	10916	0.38758206878681767
R1	cpdb	0	network_modules	307	TRUE	1.2614300968805688e-29	80	30	18	0.6	0.225	REAC:R-HSA-380287	REAC	Centrosome maturation	10916	341		0.3076923076923077	0.42857142857142855	80	10836	18	12	62	10824	10916	0.36477444116813185
R1	cpdb	0	network_modules	307	TRUE	1.2614300968805688e-29	80	30	18	0.6	0.225	REAC:R-HSA-380270	REAC	Recruitment of mitotic centrosome proteins and complexes	10916	1951		0.3076923076923077	0.42857142857142855	80	10836	18	12	62	10824	10916	0.36477444116813185
R1	cpdb	0	network_modules	307	TRUE	4.2619373892326905e-29	85	30	18	0.6	0.21176470588235294	REAC:R-HSA-2565942	REAC	Regulation of PLK1 Activity at G2/M Transition	10916	1998		0.46153846153846156	0.5	85	10831	18	12	67	10819	10916	0.35369130178112884
R1	cpdb	0	network_modules	307	TRUE	6.880278265935625e-29	129	58	22	0.3793103448275862	0.17054263565891473	GO:0007098	GO:BP	centrosome cycle	16175	2681		0.022727272727272728	0.044444444444444446	129	16046	22	36	107	16010	16175	0.25044012184533115
R1	cpdb	0	network_modules	307	TRUE	3.15209716353435e-28	94	30	18	0.6	0.19148936170212766	REAC:R-HSA-380320	REAC	Recruitment of NuMA to mitotic centrosomes	10916	1950		0.5384615384615384	0.5714285714285714	94	10822	18	12	76	10810	10916	0.3360047242867087
R1	cpdb	0	network_modules	307	TRUE	1.2759841941067052e-27	146	58	22	0.3793103448275862	0.1506849315068493	GO:0031023	GO:BP	microtubule organizing center organization	16175	6997		0.045454545454545456	0.06666666666666667	146	16029	22	36	124	15993	16175	0.2348667667238119
R1	cpdb	0	network_modules	307	TRUE	5.799277796432275e-26	200	30	20	0.6666666666666666	0.1	REAC:R-HSA-5617833	REAC	Cilium Assembly	10916	361		0.6153846153846154	0.6428571428571429	200	10716	20	10	180	10706	10916	0.25378430659304474
R1	cpdb	0	network_modules	307	TRUE	1.420329620393015e-22	292	30	20	0.6666666666666666	0.0684931506849315	REAC:R-HSA-1852241	REAC	Organelle biogenesis and maintenance	10916	1646		0.6923076923076923	0.7142857142857143	292	10624	20	10	272	10614	10916	0.20819876100611662
R1	cpdb	0	network_modules	307	TRUE	3.6355379131521017e-22	195	30	18	0.6	0.09230769230769231	REAC:R-HSA-69275	REAC	G2/M Transition	10916	1008		0.7692307692307693	0.7857142857142857	195	10721	18	12	177	10709	10916	0.23071706966401773
R1	cpdb	0	network_modules	307	TRUE	4.396404304257163e-22	197	30	18	0.6	0.09137055837563451	REAC:R-HSA-453274	REAC	Mitotic G2-G2/M phases	10916	1481		0.8461538461538461	0.8571428571428571	197	10719	18	12	179	10707	10916	0.22949209156744027
R1	cpdb	0	network_modules	307	TRUE	5.305720106860304e-22	199	30	18	0.6	0.09045226130653267	REAC:R-HSA-68877	REAC	Mitotic Prometaphase	10916	1484		0.9230769230769231	0.9285714285714286	199	10717	18	12	181	10705	10916	0.22828536362508156
R1	cpdb	0	network_modules	307	TRUE	5.591962534961802e-18	406	30	19	0.6333333333333333	0.046798029556650245	REAC:R-HSA-68886	REAC	M Phase	10916	1343		1	1	406	10510	19	11	387	10499	10916	0.16537659268558658
R1	cpdb	0	network_modules	307	TRUE	2.009655234350298e-17	42	58	12	0.20689655172413793	0.2857142857142857	GO:0007099	GO:BP	centriole replication	16175	2682		0.06818181818181818	0.08888888888888889	42	16133	12	46	30	16087	16175	0.24082536973896346
R1	cpdb	0	network_modules	307	TRUE	9.371703557198092e-17	47	58	12	0.20689655172413793	0.2553191489361702	GO:0098534	GO:BP	centriole assembly	16175	18792		0.09090909090909091	0.1111111111111111	47	16128	12	46	35	16082	16175	0.2273461731609209
R1	cpdb	0	network_modules	307	TRUE	2.798270994680482e-16	71	58	13	0.22413793103448276	0.18309859154929578	GO:0051298	GO:BP	centrosome duplication	16175	13629		0.11363636363636363	0.13333333333333333	71	16104	13	45	58	16059	16175	0.19940953955515256
R1	cpdb	0	network_modules	307	TRUE	6.378944128814277e-15	343	58	19	0.3275862068965517	0.05539358600583091	GO:0140694	GO:BP	membraneless organelle assembly	16175	19860		0.13636363636363635	0.15555555555555556	343	15832	19	39	324	15793	16175	0.1275741124240469
R1	cpdb	0	network_modules	307	TRUE	1.9021888077702375e-12	176	58	14	0.2413793103448276	0.07954545454545454	GO:0007051	GO:BP	spindle organization	16175	2650		0.1590909090909091	0.17777777777777778	176	15999	14	44	162	15955	16175	0.133284975537332
R1	cpdb	0	network_modules	307	TRUE	7.447032117597366e-12	113	58	12	0.20689655172413793	0.10619469026548672	GO:0051225	GO:BP	spindle assembly	16175	13578		0.18181818181818182	0.2	113	16062	12	46	101	16016	16175	0.14398348253139492
R1	cpdb	0	network_modules	307	TRUE	6.191931684243388e-11	343	58	16	0.27586206896551724	0.04664723032069971	GO:0060271	GO:BP	cilium assembly	16175	14488		0.20454545454545456	0.2222222222222222	343	15832	16	42	327	15790	16175	0.10603665193656686
R1	cpdb	0	network_modules	307	TRUE	7.48304314199974e-11	46	58	9	0.15517241379310345	0.1956521739130435	GO:0007020	GO:BP	microtubule nucleation	16175	2628		0.22727272727272727	0.24444444444444444	46	16129	9	49	37	16080	16175	0.17159900518846777
R1	cpdb	0	network_modules	307	TRUE	8.979486935500731e-11	232	58	14	0.2413793103448276	0.0603448275862069	GO:0032886	GO:BP	regulation of microtubule-based process	16175	7882		0.25	0.26666666666666666	232	15943	14	44	218	15899	16175	0.11454661358457474
R1	cpdb	0	network_modules	307	TRUE	1.8376886263839101e-10	368	58	16	0.27586206896551724	0.043478260869565216	GO:0044782	GO:BP	cilium organization	16175	11155		0.2727272727272727	0.28888888888888886	368	15807	16	42	352	15765	16175	0.10183062563285884
R1	cpdb	0	network_modules	307	TRUE	8.324582510261395e-10	88	58	10	0.1724137931034483	0.11363636363636363	GO:0046785	GO:BP	microtubule polymerization	16175	12369		0.29545454545454547	0.3111111111111111	88	16087	10	48	78	16039	16175	0.13617091095308675
R1	cpdb	0	network_modules	307	TRUE	8.454702011139555e-10	124	58	11	0.1896551724137931	0.08870967741935484	GO:0031109	GO:BP	microtubule polymerization or depolymerization	16175	7034		0.3181818181818182	0.3333333333333333	124	16051	11	47	113	16004	16175	0.12516977795658987
R1	cpdb	0	network_modules	307	TRUE	2.1287464293243458e-8	503	58	16	0.27586206896551724	0.03180914512922465	GO:0120031	GO:BP	plasma membrane bounded cell projection assembly	16175	19467		0.3409090909090909	0.35555555555555557	503	15672	16	42	487	15630	16175	0.08458994778295102
R1	cpdb	0	network_modules	307	TRUE	2.942514601702172e-8	514	58	16	0.27586206896551724	0.0311284046692607	GO:0030031	GO:BP	cell projection assembly	16175	6655		0.36363636363636365	0.37777777777777777	514	15661	16	42	498	15619	16175	0.08347670917427337
R1	cpdb	0	network_modules	307	TRUE	3.6306815271359306e-8	361	58	14	0.2413793103448276	0.038781163434903045	GO:0007059	GO:BP	chromosome segregation	16175	2658		0.38636363636363635	0.4	361	15814	14	44	347	15770	16175	0.0889624260467891
R1	cpdb	0	network_modules	307	TRUE	6.269728282213772e-8	19	58	6	0.10344827586206896	0.3157894736842105	GO:0010968	GO:BP	regulation of microtubule nucleation	16175	4544		0.4090909090909091	0.4222222222222222	19	16156	6	52	13	16104	16175	0.17911671017994313
R1	cpdb	0	network_modules	307	TRUE	2.247149449140577e-7	43	58	7	0.1206896551724138	0.16279069767441862	GO:0010824	GO:BP	regulation of centrosome duplication	16175	4434		0.4318181818181818	0.4444444444444444	43	16132	7	51	36	16081	16175	0.13751016013006578
R1	cpdb	0	network_modules	307	TRUE	2.3070939345692668e-7	23	58	6	0.10344827586206896	0.2608695652173913	GO:0046599	GO:BP	regulation of centriole replication	16175	12249		0.45454545454545453	0.4666666666666667	23	16152	6	52	17	16100	16175	0.16242443708778265
R1	cpdb	0	network_modules	307	TRUE	5.064028845000153e-7	48	58	7	0.1206896551724138	0.14583333333333334	GO:0046605	GO:BP	regulation of centrosome cycle	16175	12255		0.4772727272727273	0.4888888888888889	48	16127	7	51	41	16076	16175	0.12983052669861003
R1	cpdb	0	network_modules	307	TRUE	1.0121788906011095e-6	238	58	11	0.1896551724137931	0.046218487394957986	GO:0051258	GO:BP	protein polymerization	16175	13605		0.5	0.5111111111111111	238	15937	11	47	227	15890	16175	0.08715981301984121
R1	cpdb	0	network_modules	307	TRUE	1.6459839425307017e-6	31	58	6	0.10344827586206896	0.1935483870967742	GO:0071539	GO:BP	protein localization to centrosome	16175	16751		0.5227272727272727	0.5333333333333333	31	16144	6	52	25	16092	16175	0.13926166465961398
R1	cpdb	0	network_modules	307	TRUE	2.0202425578519392e-6	32	58	6	0.10344827586206896	0.1875	GO:1905508	GO:BP	protein localization to microtubule organizing center	16175	24684		0.5454545454545454	0.5555555555555556	32	16143	6	52	26	16091	16175	0.1369892108150538
R1	cpdb	0	network_modules	307	TRUE	3.5442097499675424e-6	147	58	9	0.15517241379310345	0.061224489795918366	GO:0070507	GO:BP	regulation of microtubule cytoskeleton organization	16175	16162		0.5681818181818182	0.5777777777777777	147	16028	9	49	138	15979	16175	0.09234671199516468
R1	cpdb	0	network_modules	307	TRUE	5.704962329913208e-6	440	58	13	0.22413793103448276	0.029545454545454545	GO:0051493	GO:BP	regulation of cytoskeleton organization	16175	13748		0.5909090909090909	0.6	440	15735	13	45	427	15690	16175	0.07262403737026808
R1	cpdb	0	network_modules	307	TRUE	2.6175970690311597e-5	48	58	6	0.10344827586206896	0.125	GO:0072698	GO:BP	protein localization to microtubule cytoskeleton	16175	17509		0.6136363636363636	0.6222222222222222	48	16127	6	52	42	16075	16175	0.11081576977545635
R1	cpdb	0	network_modules	307	TRUE	2.7207654949229408e-5	9	58	4	0.06896551724137931	0.4444444444444444	GO:0046601	GO:BP	positive regulation of centriole replication	16175	12251		0.6363636363636364	0.6444444444444445	9	16166	4	54	5	16112	16175	0.17402335501910338
R1	cpdb	0	network_modules	307	TRUE	3.3709362079413136e-5	50	58	6	0.10344827586206896	0.12	GO:0044380	GO:BP	protein localization to cytoskeleton	16175	10982		0.6590909090909091	0.6666666666666666	50	16125	6	52	44	16073	16175	0.10844995116648602
R1	cpdb	0	network_modules	307	TRUE	3.908980293060106e-5	88	58	7	0.1206896551724138	0.07954545454545454	GO:0031110	GO:BP	regulation of microtubule polymerization or depolymerization	16175	7035		0.6818181818181818	0.6888888888888889	88	16087	7	51	81	16036	16175	0.09398857974770305
R1	cpdb	0	network_modules	307	TRUE	5.611415456499008e-5	748	58	15	0.25862068965517243	0.020053475935828877	GO:0097435	GO:BP	supramolecular fiber organization	16175	18657		0.7045454545454546	0.7111111111111111	748	15427	15	43	733	15384	16175	0.06066400438617874
R1	cpdb	0	network_modules	307	TRUE	8.398652336364618e-5	58	58	6	0.10344827586206896	0.10344827586206896	GO:0031113	GO:BP	regulation of microtubule polymerization	16175	7038		0.7272727272727273	0.7333333333333333	58	16117	6	52	52	16065	16175	0.10022186896252192
R1	cpdb	0	network_modules	307	TRUE	1.2093305698654205e-4	793	58	15	0.25862068965517243	0.018915510718789406	GO:0044087	GO:BP	regulation of cellular component biogenesis	16175	10909		0.75	0.7555555555555555	793	15382	15	43	778	15339	16175	0.05823081800956059
R1	cpdb	0	network_modules	307	TRUE	2.900586972127132e-4	15	58	4	0.06896551724137931	0.26666666666666666	GO:0010457	GO:BP	centriole-centriole cohesion	16175	4153		0.7727272727272727	0.7777777777777778	15	16160	4	54	11	16106	16175	0.1340918667894994
R1	cpdb	0	network_modules	307	TRUE	4.5363599363653034e-4	186	58	8	0.13793103448275862	0.043010752688172046	GO:1902115	GO:BP	regulation of organelle assembly	16175	22028		0.7954545454545454	0.8	186	15989	8	50	178	15939	16175	0.07113861502750504
R1	cpdb	0	network_modules	307	TRUE	6.401937630247137e-4	5	58	3	0.05172413793103448	0.6	GO:0051418	GO:BP	microtubule nucleation by microtubule organizing center	16175	13704		0.8181818181818182	0.8444444444444444	5	16170	3	55	2	16115	16175	0.17545517050353496
R1	cpdb	0	network_modules	307	TRUE	6.401937630247137e-4	5	58	3	0.05172413793103448	0.6	GO:1903724	GO:BP	positive regulation of centriole elongation	16175	23236		0.8181818181818182	0.8444444444444444	5	16170	3	55	2	16115	16175	0.17545517050353496
R1	cpdb	0	network_modules	307	TRUE	0.002229265584475294	7	58	3	0.05172413793103448	0.42857142857142855	GO:1903722	GO:BP	regulation of centriole elongation	16175	23234		0.8636363636363636	0.8666666666666667	7	16168	3	55	4	16113	16175	0.1479392195758419
R1	cpdb	0	network_modules	307	TRUE	0.0024524956336602773	161	58	7	0.1206896551724138	0.043478260869565216	GO:0032271	GO:BP	regulation of protein polymerization	16175	7452		0.8863636363636364	0.8888888888888888	161	16014	7	51	154	15963	16175	0.06691789255318109
R1	cpdb	0	network_modules	307	TRUE	0.002631978250664613	318	58	9	0.15517241379310345	0.02830188679245283	GO:1902903	GO:BP	regulation of supramolecular fiber organization	16175	22602		0.9090909090909091	0.9111111111111111	318	15857	9	49	309	15808	16175	0.058555984923631746
R1	cpdb	0	network_modules	307	TRUE	0.00355773142986298	8	58	3	0.05172413793103448	0.375	GO:0061511	GO:BP	centriole elongation	16175	15513		0.9318181818181818	0.9333333333333333	8	16167	3	55	5	16112	16175	0.13822194201041574
R1	cpdb	0	network_modules	307	TRUE	0.004235469790151234	656	58	12	0.20689655172413793	0.018292682926829267	GO:1903047	GO:BP	mitotic cell cycle process	16175	22727		0.9545454545454546	0.9555555555555556	656	15519	12	46	644	15473	16175	0.05058589672842787
R1	cpdb	0	network_modules	307	TRUE	0.006895016374179388	69	58	5	0.08620689655172414	0.07246376811594203	GO:1902117	GO:BP	positive regulation of organelle assembly	16175	22030		0.9772727272727273	0.9777777777777777	69	16106	5	53	64	16053	16175	0.07542222451939982
R1	cpdb	0	network_modules	307	TRUE	0.007723238479117679	124	58	6	0.10344827586206896	0.04838709677419355	GO:0007052	GO:BP	mitotic spindle organization	16175	2651		1	1	124	16051	6	52	118	15999	16175	0.0658777500988283
R1	cpdb	0	network_modules	308	TRUE	7.719954687521703e-5	103	8	4	0.5	0.038834951456310676	KEGG:04137	KEGG	Mitophagy - animal	8484	274		NA	1	103	8381	4	4	99	8377	8484	0.1368605916727982
R1	cpdb	0	network_modules	308	TRUE	0.009263156579506477	364	22	6	0.2727272727272727	0.016483516483516484	GO:0007005	GO:BP	mitochondrion organization	16175	2617		NA	1	364	15811	6	16	358	15795	16175	0.06226250765737481
R1	cpdb	0	network_modules	311	TRUE	0.007297920072366088	41	4	2	0.5	0.04878048780487805	KEGG:03440	KEGG	Homologous recombination	8484	240		NA	1	41	8443	2	2	39	8441	8484	0.15507594204819208
R1	cpdb	0	network_modules	312	TRUE	4.6410277188974823e-4	144	16	5	0.3125	0.034722222222222224	REAC:R-HSA-8856828	REAC	Clathrin-mediated endocytosis	10916	372		NA	1	144	10772	5	11	139	10761	10916	0.10050778233967875
R1	cpdb	0	network_modules	312	TRUE	0.00121675956579644	19	17	3	0.17647058823529413	0.15789473684210525	GO:0097320	GO:BP	plasma membrane tubulation	16175	18595		NA	1	19	16156	3	14	16	16142	16175	0.16599808314375786
R1	cpdb	0	network_modules	313	TRUE	1.2227186754548603e-28	36	27	14	0.5185185185185185	0.3888888888888889	GO:1905168	GO:BP	positive regulation of double-strand break repair via homologous recombination	16175	24413		0	0.05	36	16139	14	13	22	16126	16175	0.44799519949179284
R1	cpdb	0	network_modules	313	TRUE	4.265154725889208e-26	116	16	15	0.9375	0.12931034482758622	KEGG:03082	KEGG	ATP-dependent chromatin remodeling	8484	219		NA	1	116	8368	15	1	101	8367	8484	0.3457969377398202
R1	cpdb	0	network_modules	313	TRUE	2.4394566055317795e-25	57	27	14	0.5185185185185185	0.24561403508771928	GO:0045911	GO:BP	positive regulation of DNA recombination	16175	11705		0.05263157894736842	0.1	57	16118	14	13	43	16105	16175	0.35536646365427693
R1	cpdb	0	network_modules	313	TRUE	7.551566216918104e-24	71	27	14	0.5185185185185185	0.19718309859154928	GO:0010569	GO:BP	regulation of double-strand break repair via homologous recombination	16175	4222		0.10526315789473684	0.15	71	16104	14	13	57	16091	16175	0.31801153366000934
R1	cpdb	0	network_modules	313	TRUE	9.859188505278544e-23	84	27	14	0.5185185185185185	0.16666666666666666	GO:2000781	GO:BP	positive regulation of double-strand break repair	16175	26037		0.15789473684210525	0.2	84	16091	14	13	70	16078	16175	0.2920305769242664
R1	cpdb	0	network_modules	313	TRUE	1.6838204957771447e-21	141	18	14	0.7777777777777778	0.09929078014184398	REAC:R-HSA-3214847	REAC	HATs acetylate histones	10916	1087		0	0.3333333333333333	141	10775	14	4	127	10771	10916	0.27529015186987427
R1	cpdb	0	network_modules	313	TRUE	8.334753903749669e-21	113	27	14	0.5185185185185185	0.12389380530973451	GO:0000018	GO:BP	regulation of DNA recombination	16175	6		0.21052631578947367	0.25	113	16062	14	13	99	16049	16175	0.25113135491393984
R1	cpdb	0	network_modules	313	TRUE	4.657784180366943e-20	127	27	14	0.5185185185185185	0.11023622047244094	GO:0045739	GO:BP	positive regulation of DNA repair	16175	11579		0.2631578947368421	0.3	127	16048	14	13	113	16035	16175	0.23658771404328147
R1	cpdb	0	network_modules	313	TRUE	5.2258419628262735e-20	128	27	14	0.5185185185185185	0.109375	GO:2000779	GO:BP	regulation of double-strand break repair	16175	26035		0.3157894736842105	0.35	128	16047	14	13	114	16034	16175	0.23564054268691403
R1	cpdb	0	network_modules	313	TRUE	5.750052282062772e-19	207	27	15	0.5555555555555556	0.07246376811594203	GO:0006282	GO:BP	regulation of DNA repair	16175	2096		0.3684210526315789	0.4	207	15968	15	12	192	15956	16175	0.19745249354635858
R1	cpdb	0	network_modules	313	TRUE	3.840135147722805e-18	172	27	14	0.5185185185185185	0.08139534883720931	GO:0000724	GO:BP	double-strand break repair via homologous recombination	16175	203		0.42105263157894735	0.45	172	16003	14	13	158	15990	16175	0.2024729970379072
R1	cpdb	0	network_modules	313	TRUE	5.34956397530756e-18	176	27	14	0.5185185185185185	0.07954545454545454	GO:0000725	GO:BP	recombinational repair	16175	204		0.47368421052631576	0.5	176	15999	14	13	162	15986	16175	0.2000864918278966
R1	cpdb	0	network_modules	313	TRUE	8.10421999956514e-18	246	27	15	0.5555555555555556	0.06097560975609756	GO:0051054	GO:BP	positive regulation of DNA metabolic process	16175	13464		0.5263157894736842	0.55	246	15929	15	12	231	15917	16175	0.18054175332722344
R1	cpdb	0	network_modules	313	TRUE	2.091774010800661e-17	271	18	14	0.7777777777777778	0.05166051660516605	REAC:R-HSA-3247509	REAC	Chromatin modifying enzymes	10916	355		0.5	1	271	10645	14	4	257	10641	10916	0.19666908399594082
R1	cpdb	0	network_modules	313	TRUE	2.091774010800661e-17	271	18	14	0.7777777777777778	0.05166051660516605	REAC:R-HSA-4839726	REAC	Chromatin organization	10916	356		0.5	1	271	10645	14	4	257	10641	10916	0.19666908399594082
R1	cpdb	0	network_modules	313	TRUE	4.226159773494747e-15	281	27	14	0.5185185185185185	0.0498220640569395	GO:0006310	GO:BP	DNA recombination	16175	2115		0.5789473684210527	0.6	281	15894	14	13	267	15881	16175	0.1568416242315042
R1	cpdb	0	network_modules	313	TRUE	9.676928323013686e-15	298	27	14	0.5185185185185185	0.04697986577181208	GO:0006302	GO:BP	double-strand break repair	16175	2109		0.631578947368421	0.65	298	15877	14	13	284	15864	16175	0.15206419989518022
R1	cpdb	0	network_modules	313	TRUE	4.435272844586043e-14	435	27	15	0.5555555555555556	0.034482758620689655	GO:0051052	GO:BP	regulation of DNA metabolic process	16175	13462		0.6842105263157895	0.7	435	15740	15	12	420	15728	16175	0.13362818473941357
R1	cpdb	0	network_modules	313	TRUE	4.749789857555628e-14	437	27	15	0.5555555555555556	0.034324942791762014	GO:0080135	GO:BP	regulation of cellular response to stress	16175	17817		0.7368421052631579	0.75	437	15738	15	12	422	15726	16175	0.13329933545202785
R1	cpdb	0	network_modules	313	TRUE	7.926190603939892e-13	528	27	15	0.5555555555555556	0.028409090909090908	GO:0006281	GO:BP	DNA repair	16175	2095		0.7894736842105263	0.8	528	15647	15	12	513	15635	16175	0.12032708483608126
R1	cpdb	0	network_modules	313	TRUE	1.301598905760446e-11	798	27	16	0.5925925925925926	0.020050125313283207	GO:0006974	GO:BP	DNA damage response	16175	2601		0.8421052631578947	0.85	798	15377	16	11	782	15366	16175	0.1025734676809686
R1	cpdb	0	network_modules	313	TRUE	2.3631756814995142e-6	454	27	10	0.37037037037037035	0.022026431718061675	GO:0006338	GO:BP	chromatin remodeling	16175	2126		0.8947368421052632	0.9	454	15721	10	17	444	15704	16175	0.08474394735351151
R1	cpdb	0	network_modules	313	TRUE	1.0274986698652601e-5	529	27	10	0.37037037037037035	0.01890359168241966	GO:0006325	GO:BP	chromatin organization	16175	2122		0.9473684210526315	0.95	529	15646	10	17	519	15629	16175	0.0776290182538896
R1	cpdb	0	network_modules	313	TRUE	0.005200935261179129	18	27	3	0.1111111111111111	0.16666666666666666	GO:0018394	GO:BP	peptidyl-lysine acetylation	16175	5418		1	1	18	16157	3	24	15	16133	16175	0.13490749891953285
R1	cpdb	0	network_modules	314	TRUE	2.925661046578164e-90	46	46	39	0.8478260869565217	0.8478260869565217	KEGG:03050	KEGG	Proteasome	8484	216		0	0.125	46	8438	39	7	7	8431	8484	0.8469965064872164
R1	cpdb	0	network_modules	314	TRUE	3.733642109867608e-90	49	48	39	0.8125	0.7959183673469388	REAC:R-HSA-1236978	REAC	Cross-presentation of soluble exogenous antigens (endosomes)	10916	416		0	0.007575757575757576	49	10867	39	9	10	10858	10916	0.803292709014623
R1	cpdb	0	network_modules	314	TRUE	1.695739687291995e-89	50	48	39	0.8125	0.78	REAC:R-HSA-211733	REAC	Regulation of activated PAK-2p34 by proteasome mediated degradation	10916	2021		0.007633587786259542	0.015151515151515152	50	10866	39	9	11	10857	10916	0.7951656392935006
R1	cpdb	0	network_modules	314	TRUE	7.20107381294661e-89	51	48	39	0.8125	0.7647058823529411	REAC:R-HSA-350562	REAC	Regulation of ornithine decarboxylase (ODC)	10916	2046		0.015267175572519083	0.022727272727272728	51	10865	39	9	12	10856	10916	0.7872782573425536
R1	cpdb	0	network_modules	314	TRUE	2.8781032541916667e-88	52	48	39	0.8125	0.75	REAC:R-HSA-349425	REAC	Autodegradation of the E3 ubiquitin ligase COP1	10916	191		0.022900763358778626	0.06818181818181818	52	10864	39	9	13	10855	10916	0.7796189884340502
R1	cpdb	0	network_modules	314	TRUE	2.8781032541916667e-88	52	48	39	0.8125	0.75	REAC:R-HSA-69601	REAC	Ubiquitin Mediated Degradation of Phosphorylated Cdc25A	10916	2619		0.022900763358778626	0.06818181818181818	52	10864	39	9	13	10855	10916	0.7796189884340502
R1	cpdb	0	network_modules	314	TRUE	2.8781032541916667e-88	52	48	39	0.8125	0.75	REAC:R-HSA-75815	REAC	Ubiquitin-dependent degradation of Cyclin D	10916	2620		0.022900763358778626	0.06818181818181818	52	10864	39	9	13	10855	10916	0.7796189884340502
R1	cpdb	0	network_modules	314	TRUE	2.8781032541916667e-88	52	48	39	0.8125	0.75	REAC:R-HSA-180534	REAC	Vpu mediated degradation of CD4	10916	2666		0.022900763358778626	0.06818181818181818	52	10864	39	9	13	10855	10916	0.7796189884340502
R1	cpdb	0	network_modules	314	TRUE	2.8781032541916667e-88	52	48	39	0.8125	0.75	REAC:R-HSA-69610	REAC	p53-Independent DNA Damage Response	10916	2719		0.022900763358778626	0.06818181818181818	52	10864	39	9	13	10855	10916	0.7796189884340502
R1	cpdb	0	network_modules	314	TRUE	2.8781032541916667e-88	52	48	39	0.8125	0.75	REAC:R-HSA-69613	REAC	p53-Independent G1/S DNA damage checkpoint	10916	2720		0.022900763358778626	0.06818181818181818	52	10864	39	9	13	10855	10916	0.7796189884340502
R1	cpdb	0	network_modules	314	TRUE	1.0886876334453142e-87	53	48	39	0.8125	0.7358490566037735	REAC:R-HSA-180585	REAC	Vif-mediated degradation of APOBEC3G	10916	2646		0.06870229007633588	0.08333333333333333	53	10863	39	9	14	10854	10916	0.772177025741021
R1	cpdb	0	network_modules	314	TRUE	1.0886876334453142e-87	53	48	39	0.8125	0.7358490566037735	REAC:R-HSA-169911	REAC	Regulation of Apoptosis	10916	1964		0.06870229007633588	0.08333333333333333	53	10863	39	9	14	10854	10916	0.772177025741021
R1	cpdb	0	network_modules	314	TRUE	3.9161096590964696e-87	54	48	39	0.8125	0.7222222222222222	REAC:R-HSA-450408	REAC	AUF1 (hnRNP D0) binds and destabilizes mRNA	10916	40		0.08396946564885496	0.09090909090909091	54	10862	39	9	15	10853	10916	0.7649422660492823
R1	cpdb	0	network_modules	314	TRUE	1.3450752261731854e-86	55	48	39	0.8125	0.7090909090909091	REAC:R-HSA-8854050	REAC	FBXL7 down-regulates AURKA during mitotic entry and in early mitosis	10916	892		0.0916030534351145	0.11363636363636363	55	10861	39	9	16	10852	10916	0.7579052519277995
R1	cpdb	0	network_modules	314	TRUE	1.3450752261731854e-86	55	48	39	0.8125	0.7090909090909091	REAC:R-HSA-4641257	REAC	Degradation of AXIN	10916	719		0.0916030534351145	0.11363636363636363	55	10861	39	9	16	10852	10916	0.7579052519277995
R1	cpdb	0	network_modules	314	TRUE	1.3450752261731854e-86	55	48	39	0.8125	0.7090909090909091	REAC:R-HSA-174113	REAC	SCF-beta-TrCP mediated degradation of Emi1	10916	2130		0.0916030534351145	0.11363636363636363	55	10861	39	9	16	10852	10916	0.7579052519277995
R1	cpdb	0	network_modules	314	TRUE	4.427256362028249e-86	56	48	39	0.8125	0.6964285714285714	REAC:R-HSA-5362768	REAC	Hh mutants are degraded by ERAD	10916	1122		0.11450381679389313	0.12121212121212122	56	10860	39	9	17	10851	10916	0.7510571196043506
R1	cpdb	0	network_modules	314	TRUE	1.4008317648550408e-85	57	48	39	0.8125	0.6842105263157895	REAC:R-HSA-69541	REAC	Stabilization of p53	10916	2351		0.12213740458015267	0.13636363636363635	57	10859	39	9	18	10850	10916	0.7443895518929868
R1	cpdb	0	network_modules	314	TRUE	1.4008317648550408e-85	57	48	39	0.8125	0.6842105263157895	REAC:R-HSA-4641258	REAC	Degradation of DVL	10916	720		0.12213740458015267	0.13636363636363635	57	10859	39	9	18	10850	10916	0.7443895518929868
R1	cpdb	0	network_modules	314	TRUE	4.2727678996396857e-85	58	48	39	0.8125	0.6724137931034483	REAC:R-HSA-351202	REAC	Metabolism of polyamines	10916	1433		0.13740458015267176	0.14393939393939395	58	10858	39	9	19	10849	10916	0.7378947356046559
R1	cpdb	0	network_modules	314	TRUE	1.2594479252209564e-84	59	48	39	0.8125	0.6610169491525424	REAC:R-HSA-5387390	REAC	Hh mutants abrogate ligand secretion	10916	1121		0.1450381679389313	0.1590909090909091	59	10857	39	9	20	10848	10916	0.7315653229449605
R1	cpdb	0	network_modules	314	TRUE	1.2594479252209564e-84	59	48	39	0.8125	0.6610169491525424	REAC:R-HSA-5676590	REAC	NIK-->noncanonical NF-kB signaling	10916	1528		0.1450381679389313	0.1590909090909091	59	10857	39	9	20	10848	10916	0.7315653229449605
R1	cpdb	0	network_modules	314	TRUE	3.595514435047067e-84	60	48	39	0.8125	0.65	REAC:R-HSA-5607761	REAC	Dectin-1 mediated noncanonical NF-kB signaling	10916	456		0.16030534351145037	0.1893939393939394	60	10856	39	9	21	10847	10916	0.7253943964652804
R1	cpdb	0	network_modules	314	TRUE	3.595514435047067e-84	60	48	39	0.8125	0.65	REAC:R-HSA-5610780	REAC	Degradation of GLI1 by the proteasome	10916	722		0.16030534351145037	0.1893939393939394	60	10856	39	9	21	10847	10916	0.7253943964652804
R1	cpdb	0	network_modules	314	TRUE	3.595514435047067e-84	60	48	39	0.8125	0.65	REAC:R-HSA-5610783	REAC	Degradation of GLI2 by the proteasome	10916	723		0.16030534351145037	0.1893939393939394	60	10856	39	9	21	10847	10916	0.7253943964652804
R1	cpdb	0	network_modules	314	TRUE	3.595514435047067e-84	60	48	39	0.8125	0.65	REAC:R-HSA-5610785	REAC	GLI3 is processed to GLI3R by the proteasome	10916	1016		0.16030534351145037	0.1893939393939394	60	10856	39	9	21	10847	10916	0.7253943964652804
R1	cpdb	0	network_modules	314	TRUE	9.96132306171804e-84	61	48	39	0.8125	0.639344262295082	REAC:R-HSA-5678895	REAC	Defective CFTR causes cystic fibrosis	10916	505		0.19083969465648856	0.19696969696969696	61	10855	39	9	22	10846	10916	0.7193754371870544
R1	cpdb	0	network_modules	314	TRUE	1.8000993138068777e-82	64	48	39	0.8125	0.609375	REAC:R-HSA-4608870	REAC	Asymmetric localization of PCP proteins	10916	184		0.1984732824427481	0.20454545454545456	64	10852	39	9	25	10843	10916	0.7021705576136336
R1	cpdb	0	network_modules	314	TRUE	4.496609604301156e-82	65	48	39	0.8125	0.6	REAC:R-HSA-5358346	REAC	Hedgehog ligand biogenesis	10916	1114		0.20610687022900764	0.21212121212121213	65	10851	39	9	26	10842	10916	0.6967012821352002
R1	cpdb	0	network_modules	314	TRUE	1.0982824211659438e-81	66	48	39	0.8125	0.5909090909090909	REAC:R-HSA-69563	REAC	p53-Dependent G1 DNA Damage Response	10916	2717		0.21374045801526717	0.23484848484848486	66	10850	39	9	27	10841	10916	0.6913564235685504
R1	cpdb	0	network_modules	314	TRUE	1.0982824211659438e-81	66	48	39	0.8125	0.5909090909090909	REAC:R-HSA-69580	REAC	p53-Dependent G1/S DNA damage checkpoint	10916	2718		0.21374045801526717	0.23484848484848486	66	10850	39	9	27	10841	10916	0.6913564235685504
R1	cpdb	0	network_modules	314	TRUE	1.0982824211659438e-81	66	48	39	0.8125	0.5909090909090909	REAC:R-HSA-1234176	REAC	Oxygen-dependent proline hydroxylation of Hypoxia-inducible Factor Alpha	10916	1655		0.21374045801526717	0.23484848484848486	66	10850	39	9	27	10841	10916	0.6913564235685504
R1	cpdb	0	network_modules	314	TRUE	2.1758000173401066e-81	52	48	37	0.7708333333333334	0.7115384615384616	REAC:R-HSA-9762114	REAC	GSK3B and BTRC:CUL1-mediated-degradation of NFE2L2	10916	1026		0.2366412213740458	0.24242424242424243	52	10864	37	11	15	10853	10916	0.7394027415045177
R1	cpdb	0	network_modules	314	TRUE	2.625907657786262e-81	67	48	39	0.8125	0.582089552238806	REAC:R-HSA-5658442	REAC	Regulation of RAS by GAPs	10916	2003		0.24427480916030533	0.25757575757575757	67	10849	39	9	28	10840	10916	0.6861313245850769
R1	cpdb	0	network_modules	314	TRUE	2.625907657786262e-81	67	48	39	0.8125	0.582089552238806	REAC:R-HSA-1169091	REAC	Activation of NF-kappaB in B cells	10916	87		0.24427480916030533	0.25757575757575757	67	10849	39	9	28	10840	10916	0.6861313245850769
R1	cpdb	0	network_modules	314	TRUE	6.152320887839719e-81	68	48	39	0.8125	0.5735294117647058	REAC:R-HSA-69615	REAC	G1/S DNA Damage Checkpoints	10916	1001		0.2595419847328244	0.2727272727272727	68	10848	39	9	29	10839	10916	0.6810215684073986
R1	cpdb	0	network_modules	314	TRUE	6.152320887839719e-81	68	48	39	0.8125	0.5735294117647058	REAC:R-HSA-174154	REAC	APC/C:Cdc20 mediated degradation of Securin	10916	26		0.2595419847328244	0.2727272727272727	68	10848	39	9	29	10839	10916	0.6810215684073986
R1	cpdb	0	network_modules	314	TRUE	7.200232361335073e-81	53	48	37	0.7708333333333334	0.6981132075471698	REAC:R-HSA-9604323	REAC	Negative regulation of NOTCH4 signaling	10916	1576		0.2748091603053435	0.2803030303030303	53	10863	37	11	16	10852	10916	0.7323401505910186
R1	cpdb	0	network_modules	314	TRUE	1.413889267998957e-80	69	48	39	0.8125	0.5652173913043478	REAC:R-HSA-8948751	REAC	Regulation of PTEN stability and activity	10916	2002		0.2824427480916031	0.2878787878787879	69	10847	39	9	30	10838	10916	0.6760229630655452
R1	cpdb	0	network_modules	314	TRUE	6.974686932732475e-80	55	48	37	0.7708333333333334	0.6727272727272727	REAC:R-HSA-8941858	REAC	Regulation of RUNX3 expression and activity	10916	2006		0.2900763358778626	0.30303030303030304	55	10861	37	11	18	10850	10916	0.7187957903076774
R1	cpdb	0	network_modules	314	TRUE	6.974686932732475e-80	55	48	37	0.7708333333333334	0.6727272727272727	REAC:R-HSA-9824272	REAC	Somitogenesis	10916	2341		0.2900763358778626	0.30303030303030304	55	10861	37	11	18	10850	10916	0.7187957903076774
R1	cpdb	0	network_modules	314	TRUE	7.072243193135822e-80	71	48	39	0.8125	0.5492957746478874	REAC:R-HSA-8939902	REAC	Regulation of RUNX2 expression and activity	10916	2005		0.3053435114503817	0.3181818181818182	71	10845	39	9	32	10836	10916	0.666343475159414
R1	cpdb	0	network_modules	314	TRUE	7.072243193135822e-80	71	48	39	0.8125	0.5492957746478874	REAC:R-HSA-68949	REAC	Orc1 removal from chromatin	10916	1644		0.3053435114503817	0.3181818181818182	71	10845	39	9	32	10836	10916	0.666343475159414
R1	cpdb	0	network_modules	314	TRUE	3.3076277884278416e-79	73	48	39	0.8125	0.5342465753424658	REAC:R-HSA-174184	REAC	Cdc20:Phospho-APC/C mediated degradation of Cyclin A	10916	319		0.32061068702290074	0.3333333333333333	73	10843	39	9	34	10834	10916	0.6570632975412288
R1	cpdb	0	network_modules	314	TRUE	3.3076277884278416e-79	73	48	39	0.8125	0.5342465753424658	REAC:R-HSA-69017	REAC	CDK-mediated phosphorylation and removal of Cdc6	10916	272		0.32061068702290074	0.3333333333333333	73	10843	39	9	34	10834	10916	0.6570632975412288
R1	cpdb	0	network_modules	314	TRUE	6.987611213271851e-79	74	48	39	0.8125	0.527027027027027	REAC:R-HSA-179419	REAC	APC:Cdc20 mediated degradation of cell cycle proteins prior to satisfation of the cell cycle checkpoint	10916	29		0.33587786259541985	0.3484848484848485	74	10842	39	9	35	10833	10916	0.6525644802754913
R1	cpdb	0	network_modules	314	TRUE	6.987611213271851e-79	74	48	39	0.8125	0.527027027027027	REAC:R-HSA-174178	REAC	APC/C:Cdh1 mediated degradation of Cdc20 and other APC/C:Cdh1 targeted proteins in late mitosis/early G1	10916	28		0.33587786259541985	0.3484848484848485	74	10842	39	9	35	10833	10916	0.6525644802754913
R1	cpdb	0	network_modules	314	TRUE	1.4545742330580085e-78	75	48	39	0.8125	0.52	REAC:R-HSA-1234174	REAC	Cellular response to hypoxia	10916	335		0.3511450381679389	0.3560606060606061	75	10841	39	9	36	10832	10916	0.6481556443278517
R1	cpdb	0	network_modules	314	TRUE	2.9853559550246573e-78	76	48	39	0.8125	0.5131578947368421	REAC:R-HSA-176409	REAC	APC/C:Cdc20 mediated degradation of mitotic proteins	10916	27		0.35877862595419846	0.36363636363636365	76	10840	39	9	37	10831	10916	0.6438338218527617
R1	cpdb	0	network_modules	314	TRUE	6.044377510489817e-78	77	48	39	0.8125	0.5064935064935064	REAC:R-HSA-176814	REAC	Activation of APC/C and APC/C:Cdc20 mediated degradation of mitotic proteins	10916	74		0.366412213740458	0.3712121212121212	77	10839	39	9	38	10830	10916	0.6395961803128468
R1	cpdb	0	network_modules	314	TRUE	1.1264780669217113e-77	60	48	37	0.7708333333333334	0.6166666666666667	REAC:R-HSA-187577	REAC	SCF(Skp2)-mediated degradation of p27/p21	10916	2129		0.37404580152671757	0.3787878787878788	60	10856	37	11	23	10845	10916	0.687941315746079
R1	cpdb	0	network_modules	314	TRUE	1.2078969275077064e-77	78	48	39	0.8125	0.5	REAC:R-HSA-5619084	REAC	ABC transporter disorders	10916	7		0.3816793893129771	0.38636363636363635	78	10838	39	9	39	10829	10916	0.6354400146484739
R1	cpdb	0	network_modules	314	TRUE	1.5189091058328757e-77	102	48	41	0.8541666666666666	0.4019607843137255	REAC:R-HSA-5689603	REAC	UCH proteinases	10916	2615		0.3893129770992366	0.3939393939393939	102	10814	41	7	61	10807	10916	0.5835547085553523
R1	cpdb	0	network_modules	314	TRUE	2.3836651386766412e-77	79	48	39	0.8125	0.4936708860759494	REAC:R-HSA-8852276	REAC	The role of GTSE1 in G2/M progression after G2 checkpoint	10916	2503		0.3969465648854962	0.4015151515151515	79	10837	39	9	40	10828	10916	0.6313627399941779
R1	cpdb	0	network_modules	314	TRUE	4.647288265976381e-77	80	48	39	0.8125	0.4875	REAC:R-HSA-1168372	REAC	Downstream signaling events of B Cell Receptor (BCR)	10916	791		0.40458015267175573	0.4090909090909091	80	10836	39	9	41	10827	10916	0.6273618848973753
R1	cpdb	0	network_modules	314	TRUE	8.955370250063581e-77	81	48	39	0.8125	0.48148148148148145	REAC:R-HSA-176408	REAC	Regulation of APC/C activators between G1/S and early anaphase	10916	1963		0.4122137404580153	0.4166666666666667	81	10835	39	9	42	10826	10916	0.6234350849989336
R1	cpdb	0	network_modules	314	TRUE	3.2162564855720444e-76	83	48	39	0.8125	0.46987951807228917	REAC:R-HSA-195253	REAC	Degradation of beta-catenin by the destruction complex	10916	724		0.4198473282442748	0.42424242424242425	83	10833	39	9	44	10824	10916	0.6157946938538255
R1	cpdb	0	network_modules	314	TRUE	4.0622025227394866e-76	64	48	37	0.7708333333333334	0.578125	REAC:R-HSA-174084	REAC	Autodegradation of Cdh1 by Cdh1:APC/C	10916	190		0.42748091603053434	0.4318181818181818	64	10852	37	11	27	10841	10916	0.6659000854194387
R1	cpdb	0	network_modules	314	TRUE	1.1075790477031966e-75	85	48	39	0.8125	0.4588235294117647	REAC:R-HSA-5632684	REAC	Hedgehog 'on' state	10916	1113		0.4351145038167939	0.4393939393939394	85	10831	39	9	46	10822	10916	0.6084245791245724
R1	cpdb	0	network_modules	314	TRUE	2.024992283628425e-75	86	48	39	0.8125	0.45348837209302323	REAC:R-HSA-450531	REAC	Regulation of mRNA stability by proteins that bind AU-rich elements	10916	2043		0.44274809160305345	0.44696969696969696	86	10830	39	9	47	10821	10916	0.604835946608511
R1	cpdb	0	network_modules	314	TRUE	6.580880142161704e-75	88	48	39	0.8125	0.4431818181818182	REAC:R-HSA-453276	REAC	Regulation of mitotic cell cycle	10916	2044		0.45038167938931295	0.4621212121212121	88	10828	39	9	49	10819	10916	0.5978423629379073
R1	cpdb	0	network_modules	314	TRUE	6.580880142161704e-75	88	48	39	0.8125	0.4431818181818182	REAC:R-HSA-174143	REAC	APC/C-mediated degradation of cell cycle proteins	10916	24		0.45038167938931295	0.4621212121212121	88	10828	39	9	49	10819	10916	0.5978423629379073
R1	cpdb	0	network_modules	314	TRUE	1.1704474951921128e-74	89	48	39	0.8125	0.43820224719101125	REAC:R-HSA-5687128	REAC	MAPK6/MAPK4 signaling	10916	1353		0.46564885496183206	0.4696969696969697	89	10827	39	9	50	10818	10916	0.5944339615777592
R1	cpdb	0	network_modules	314	TRUE	2.063821780978346e-74	90	48	39	0.8125	0.43333333333333335	REAC:R-HSA-1236974	REAC	ER-Phagosome pathway	10916	824		0.4732824427480916	0.4772727272727273	90	10826	39	9	51	10817	10916	0.5910822992182989
R1	cpdb	0	network_modules	314	TRUE	2.2558919067182415e-74	69	48	37	0.7708333333333334	0.5362318840579711	REAC:R-HSA-9793380	REAC	Formation of paraxial mesoderm	10916	961		0.48091603053435117	0.48484848484848486	69	10847	37	11	32	10836	10916	0.6410832991127053
R1	cpdb	0	network_modules	314	TRUE	6.259187286269737e-74	92	48	39	0.8125	0.42391304347826086	REAC:R-HSA-69052	REAC	Switching of origins to a post-replicative state	10916	2365		0.48854961832061067	0.5	92	10824	39	9	53	10815	10916	0.5845430035531517
R1	cpdb	0	network_modules	314	TRUE	6.259187286269737e-74	92	48	39	0.8125	0.42391304347826086	REAC:R-HSA-4086400	REAC	PCP/CE pathway	10916	1659		0.48854961832061067	0.5	92	10824	39	9	53	10815	10916	0.5845430035531517
R1	cpdb	0	network_modules	314	TRUE	8.76772288419202e-73	97	48	39	0.8125	0.4020618556701031	REAC:R-HSA-5607764	REAC	CLEC7A (Dectin-1) signaling	10916	275		0.5038167938931297	0.5075757575757576	97	10819	39	9	58	10810	10916	0.569085311640063
R1	cpdb	0	network_modules	314	TRUE	1.4551526280493144e-72	98	48	39	0.8125	0.3979591836734694	REAC:R-HSA-202424	REAC	Downstream TCR signaling	10916	789		0.5114503816793893	0.5151515151515151	98	10818	39	9	59	10809	10916	0.5661359932930183
R1	cpdb	0	network_modules	314	TRUE	2.1996631852300802e-72	113	48	40	0.8333333333333334	0.35398230088495575	REAC:R-HSA-9020702	REAC	Interleukin-1 signaling	10916	1233		0.5190839694656488	0.5227272727272727	113	10803	40	8	73	10795	10916	0.5403660100680187
R1	cpdb	0	network_modules	314	TRUE	3.9296864601518503e-72	100	48	39	0.8125	0.39	REAC:R-HSA-5668541	REAC	TNFR2 non-canonical NF-kB pathway	10916	2450		0.5267175572519084	0.5303030303030303	100	10816	39	9	61	10807	10916	0.5603700504800209
R1	cpdb	0	network_modules	314	TRUE	1.6639761057129732e-71	103	48	39	0.8125	0.3786407766990291	REAC:R-HSA-382556	REAC	ABC-family proteins mediated transport	10916	9		0.5343511450381679	0.5378787878787878	103	10813	39	9	64	10804	10916	0.5520366883256489
R1	cpdb	0	network_modules	314	TRUE	4.2287047045612405e-71	105	48	39	0.8125	0.37142857142857144	REAC:R-HSA-1236975	REAC	Antigen processing-Cross presentation	10916	153		0.5419847328244275	0.5454545454545454	105	10811	39	9	66	10802	10916	0.5466797383792596
R1	cpdb	0	network_modules	314	TRUE	7.4755973632658e-71	81	48	37	0.7708333333333334	0.4567901234567901	REAC:R-HSA-9013694	REAC	Signaling by NOTCH4	10916	2283		0.549618320610687	0.553030303030303	81	10835	37	11	44	10824	10916	0.5911693827456961
R1	cpdb	0	network_modules	314	TRUE	1.3608735744577567e-70	82	48	37	0.7708333333333334	0.45121951219512196	REAC:R-HSA-69202	REAC	Cyclin E associated events during G1/S transition 	10916	421		0.5572519083969466	0.5606060606060606	82	10834	37	11	45	10823	10916	0.5875102405287874
R1	cpdb	0	network_modules	314	TRUE	4.379862082516918e-70	84	48	37	0.7708333333333334	0.44047619047619047	REAC:R-HSA-69656	REAC	Cyclin A:Cdk2-associated events at S phase entry	10916	419		0.5648854961832062	0.5681818181818182	84	10832	37	11	47	10821	10916	0.5803881803168266
R1	cpdb	0	network_modules	314	TRUE	1.426466433102091e-69	113	48	39	0.8125	0.34513274336283184	REAC:R-HSA-5610787	REAC	Hedgehog 'off' state	10916	1112		0.5725190839694656	0.5757575757575758	113	10803	39	9	74	10794	10916	0.5266869365505645
R1	cpdb	0	network_modules	314	TRUE	1.1029055660486747e-68	118	48	39	0.8125	0.3305084745762712	REAC:R-HSA-8878166	REAC	Transcriptional regulation by RUNX2	10916	2553		0.5801526717557252	0.5833333333333334	118	10798	39	9	79	10789	10916	0.5152324756468905
R1	cpdb	0	network_modules	314	TRUE	2.4265291162064162e-68	120	48	39	0.8125	0.325	REAC:R-HSA-202403	REAC	TCR signaling	10916	2422		0.5877862595419847	0.5909090909090909	120	10796	39	9	81	10787	10916	0.5108513777938487
R1	cpdb	0	network_modules	314	TRUE	3.5777003674040565e-68	121	48	39	0.8125	0.32231404958677684	REAC:R-HSA-69239	REAC	Synthesis of DNA	10916	2376		0.5954198473282443	0.5984848484848485	121	10795	39	9	82	10786	10916	0.508701456110261
R1	cpdb	0	network_modules	314	TRUE	1.1206111018557413e-67	124	48	39	0.8125	0.31451612903225806	REAC:R-HSA-9755511	REAC	KEAP1-NFE2L2 pathway	10916	1281		0.6030534351145038	0.6060606060606061	124	10792	39	9	85	10783	10916	0.5024076250184218
R1	cpdb	0	network_modules	314	TRUE	1.485745452068753e-67	95	48	37	0.7708333333333334	0.3894736842105263	REAC:R-HSA-9759194	REAC	Nuclear events mediated by NFE2L2	10916	1617		0.6106870229007634	0.6212121212121212	95	10821	37	11	58	10810	10916	0.5453096441643711
R1	cpdb	0	network_modules	314	TRUE	1.485745452068753e-67	95	48	37	0.7708333333333334	0.3894736842105263	REAC:R-HSA-8878159	REAC	Transcriptional regulation by RUNX3	10916	2554		0.6106870229007634	0.6212121212121212	95	10821	37	11	58	10810	10916	0.5453096441643711
R1	cpdb	0	network_modules	314	TRUE	2.3551109456668392e-67	126	48	39	0.8125	0.30952380952380953	REAC:R-HSA-162909	REAC	Host Interactions of HIV factors	10916	1132		0.6259541984732825	0.6287878787878788	126	10790	39	9	87	10781	10916	0.4983365089629274
R1	cpdb	0	network_modules	314	TRUE	6.989397483128435e-67	129	48	39	0.8125	0.3023255813953488	REAC:R-HSA-8939236	REAC	RUNX1 regulates transcription of genes involved in differentiation of HSCs	10916	1922		0.6335877862595419	0.6363636363636364	129	10787	39	9	90	10778	10916	0.4924072791259909
R1	cpdb	0	network_modules	314	TRUE	2.0980824981704522e-66	151	48	40	0.8333333333333334	0.26490066225165565	REAC:R-HSA-446652	REAC	Interleukin-1 family signaling	10916	1231		0.6412213740458015	0.6439393939393939	151	10765	40	8	111	10757	10916	0.46629743290430653
R1	cpdb	0	network_modules	314	TRUE	7.895447639141618e-66	136	48	39	0.8125	0.2867647058823529	REAC:R-HSA-5621481	REAC	C-type lectin receptors (CLRs)	10916	261		0.648854961832061	0.6590909090909091	136	10780	39	9	97	10771	10916	0.47933910621975845
R1	cpdb	0	network_modules	314	TRUE	7.895447639141618e-66	136	48	39	0.8125	0.2867647058823529	REAC:R-HSA-2871837	REAC	FCERI mediated NF-kB activation	10916	896		0.648854961832061	0.6590909090909091	136	10780	39	9	97	10771	10916	0.47933910621975845
R1	cpdb	0	network_modules	314	TRUE	1.536059271567479e-65	138	48	39	0.8125	0.2826086956521739	REAC:R-HSA-6807070	REAC	PTEN Regulation	10916	1703		0.6641221374045801	0.6666666666666666	138	10778	39	9	99	10769	10916	0.4757881205994554
R1	cpdb	0	network_modules	314	TRUE	7.723848033049364e-65	143	48	39	0.8125	0.2727272727272727	REAC:R-HSA-3858494	REAC	Beta-catenin independent WNT signaling	10916	216		0.6717557251908397	0.6742424242424242	143	10773	39	9	104	10764	10916	0.4672368702421368
R1	cpdb	0	network_modules	314	TRUE	4.925352160386163e-64	149	48	39	0.8125	0.26174496644295303	REAC:R-HSA-5358351	REAC	Signaling by Hedgehog	10916	2258		0.6793893129770993	0.6818181818181818	149	10767	39	9	110	10758	10916	0.45754545844429695
R1	cpdb	0	network_modules	314	TRUE	5.812539999990391e-64	114	48	37	0.7708333333333334	0.32456140350877194	REAC:R-HSA-9758941	REAC	Gastrulation	10916	1040		0.6870229007633588	0.6893939393939394	114	10802	37	11	77	10791	10916	0.49709704952964534
R1	cpdb	0	network_modules	314	TRUE	4.054486049457887e-63	298	48	44	0.9166666666666666	0.1476510067114094	REAC:R-HSA-5688426	REAC	Deubiquitination	10916	736		0.6946564885496184	0.696969696969697	298	10618	44	4	254	10614	10916	0.3627112203885412
R1	cpdb	0	network_modules	314	TRUE	2.0573183550179986e-62	162	48	39	0.8125	0.24074074074074073	REAC:R-HSA-69242	REAC	S Phase	10916	2111		0.7022900763358778	0.7045454545454546	162	10754	39	9	123	10745	10916	0.43841387916349095
R1	cpdb	0	network_modules	314	TRUE	2.70217221002406e-62	163	48	39	0.8125	0.2392638036809816	REAC:R-HSA-983705	REAC	Signaling by the B Cell Receptor (BCR)	10916	2328		0.7099236641221374	0.7121212121212122	163	10753	39	9	124	10744	10916	0.43703710680694974
R1	cpdb	0	network_modules	314	TRUE	7.891384764756544e-62	167	48	39	0.8125	0.23353293413173654	REAC:R-HSA-69481	REAC	G2/M Checkpoints	10916	1005		0.7175572519083969	0.7196969696969697	167	10749	39	9	128	10740	10916	0.4316533268180543
R1	cpdb	0	network_modules	314	TRUE	1.825529957079161e-61	130	48	37	0.7708333333333334	0.2846153846153846	REAC:R-HSA-69206	REAC	G1/S Transition	10916	1002		0.7251908396946565	0.7272727272727273	130	10786	37	11	93	10775	10916	0.4649495732113018
R1	cpdb	0	network_modules	314	TRUE	1.8679473444274177e-61	221	48	41	0.8541666666666666	0.18552036199095023	REAC:R-HSA-5689880	REAC	Ub-specific processing proteases	10916	2617		0.732824427480916	0.7348484848484849	221	10695	41	7	180	10688	10916	0.3935027673940844
R1	cpdb	0	network_modules	314	TRUE	2.23870840028951e-61	171	48	39	0.8125	0.22807017543859648	REAC:R-HSA-9010553	REAC	Regulation of expression of SLITs and ROBOs	10916	2031		0.7404580152671756	0.7424242424242424	171	10745	39	9	132	10736	10916	0.42645815576039026
R1	cpdb	0	network_modules	314	TRUE	3.731695837317434e-61	173	48	39	0.8125	0.2254335260115607	REAC:R-HSA-5619115	REAC	Disorders of transmembrane transporters	10916	778		0.7480916030534351	0.75	173	10743	39	9	134	10734	10916	0.4239278814388118
R1	cpdb	0	network_modules	314	TRUE	7.931377416941582e-61	176	48	39	0.8125	0.2215909090909091	REAC:R-HSA-109581	REAC	Apoptosis	10916	158		0.7557251908396947	0.7575757575757576	176	10740	39	9	137	10731	10916	0.42021301406383355
R1	cpdb	0	network_modules	314	TRUE	3.432593825192153e-60	182	48	39	0.8125	0.21428571428571427	REAC:R-HSA-2454202	REAC	Fc epsilon receptor (FCERI) signaling	10916	938		0.7633587786259542	0.7651515151515151	182	10734	39	9	143	10725	10916	0.41305856704663824
R1	cpdb	0	network_modules	314	TRUE	8.042617926708872e-60	142	48	37	0.7708333333333334	0.2605633802816901	REAC:R-HSA-68867	REAC	Assembly of the pre-replicative complex	10916	181		0.7709923664122137	0.7727272727272727	142	10774	37	11	105	10763	10916	0.44447316634335715
R1	cpdb	0	network_modules	314	TRUE	1.1168110471200034e-59	187	48	39	0.8125	0.20855614973262032	REAC:R-HSA-69306	REAC	DNA Replication	10916	445		0.7786259541984732	0.7803030303030303	187	10729	39	9	148	10720	10916	0.4073593273276788
R1	cpdb	0	network_modules	314	TRUE	1.4079786982365583e-59	188	48	39	0.8125	0.2074468085106383	REAC:R-HSA-2467813	REAC	Separation of Sister Chromatids	10916	2204		0.7862595419847328	0.7878787878787878	188	10728	39	9	149	10719	10916	0.4062466192527295
R1	cpdb	0	network_modules	314	TRUE	3.491741912370943e-59	147	48	37	0.7708333333333334	0.25170068027210885	REAC:R-HSA-453279	REAC	Mitotic G1 phase and G1/S transition	10916	1480		0.7938931297709924	0.7954545454545454	147	10769	37	11	110	10758	10916	0.4366860052092647
R1	cpdb	0	network_modules	314	TRUE	6.862339645158717e-59	195	48	39	0.8125	0.2	REAC:R-HSA-69275	REAC	G2/M Transition	10916	1008		0.8015267175572519	0.803030303030303	195	10721	39	9	156	10712	10916	0.39869683206671275
R1	cpdb	0	network_modules	314	TRUE	1.0664164251814461e-58	197	48	39	0.8125	0.19796954314720813	REAC:R-HSA-453274	REAC	Mitotic G2-G2/M phases	10916	1481		0.8091603053435115	0.8106060606060606	197	10719	39	9	158	10710	10916	0.3966133644711131
R1	cpdb	0	network_modules	314	TRUE	9.467083399381079e-58	159	48	37	0.7708333333333334	0.23270440251572327	REAC:R-HSA-69002	REAC	DNA Replication Pre-Initiation	10916	446		0.816793893129771	0.8181818181818182	159	10757	37	11	122	10746	10916	0.4195083940566211
R1	cpdb	0	network_modules	314	TRUE	1.105342988887146e-57	208	48	39	0.8125	0.1875	REAC:R-HSA-5357801	REAC	Programmed Cell Death	10916	1803		0.8244274809160306	0.8257575757575758	208	10708	39	9	169	10699	10916	0.38569190991919267
R1	cpdb	0	network_modules	314	TRUE	2.04222647263617e-57	211	48	39	0.8125	0.1848341232227488	REAC:R-HSA-9711123	REAC	Cellular response to chemical stress	10916	333		0.8320610687022901	0.8333333333333334	211	10705	39	9	172	10696	10916	0.38286120502260196
R1	cpdb	0	network_modules	314	TRUE	6.775002237765343e-57	217	48	39	0.8125	0.17972350230414746	REAC:R-HSA-376176	REAC	Signaling by ROBO receptors	10916	2301		0.8396946564885496	0.8409090909090909	217	10699	39	9	178	10690	10916	0.37737524038987236
R1	cpdb	0	network_modules	314	TRUE	3.169816206435753e-56	225	48	39	0.8125	0.17333333333333334	REAC:R-HSA-162906	REAC	HIV Infection	10916	1102		0.8473282442748091	0.8484848484848485	225	10691	39	9	186	10682	10916	0.3704014674484389
R1	cpdb	0	network_modules	314	TRUE	5.56637680018663e-56	228	48	39	0.8125	0.17105263157894737	REAC:R-HSA-68882	REAC	Mitotic Anaphase	10916	1479		0.8549618320610687	0.8560606060606061	228	10688	39	9	189	10679	10916	0.36788046574465483
R1	cpdb	0	network_modules	314	TRUE	6.703443658105786e-56	229	48	39	0.8125	0.1703056768558952	REAC:R-HSA-2555396	REAC	Mitotic Metaphase and Anaphase	10916	1482		0.8625954198473282	0.8636363636363636	229	10687	39	9	190	10678	10916	0.36705104650922704
R1	cpdb	0	network_modules	314	TRUE	9.695942872707293e-56	231	48	39	0.8125	0.16883116883116883	REAC:R-HSA-201681	REAC	TCF dependent signaling in response to WNT	10916	2421		0.8702290076335878	0.8712121212121212	231	10685	39	9	192	10676	10916	0.3654082256368563
R1	cpdb	0	network_modules	314	TRUE	1.0427321879120098e-55	470	51	43	0.8431372549019608	0.09148936170212765	GO:0010498	GO:BP	proteasomal protein catabolic process	16175	4177		0	0.07142857142857142	470	15705	43	8	427	15697	16175	0.2725788813162983
R1	cpdb	0	network_modules	314	TRUE	1.6756612055718355e-55	234	48	39	0.8125	0.16666666666666666	REAC:R-HSA-8878171	REAC	Transcriptional regulation by RUNX1	10916	2552		0.8778625954198473	0.8787878787878788	234	10682	39	9	195	10673	10916	0.36298318218972053
R1	cpdb	0	network_modules	314	TRUE	4.646046078088186e-55	308	48	41	0.8541666666666666	0.1331168831168831	REAC:R-HSA-983168	REAC	Antigen processing: Ubiquitination & Proteasome degradation	10916	154		0.8854961832061069	0.8863636363636364	308	10608	41	7	267	10601	10916	0.33149089724831976
R1	cpdb	0	network_modules	314	TRUE	9.832464551784155e-55	244	48	39	0.8125	0.1598360655737705	REAC:R-HSA-8951664	REAC	Neddylation	10916	1559		0.8931297709923665	0.8939393939393939	244	10672	39	9	205	10663	10916	0.35522185197492284
R1	cpdb	0	network_modules	314	TRUE	4.5222406879147703e-54	253	48	39	0.8125	0.1541501976284585	REAC:R-HSA-1257604	REAC	PIP3 activates AKT signaling	10916	1679		0.9007633587786259	0.9015151515151515	253	10663	39	9	214	10654	10916	0.34862949765489165
R1	cpdb	0	network_modules	314	TRUE	2.699023422245037e-53	264	48	39	0.8125	0.14772727272727273	REAC:R-HSA-5673001	REAC	RAF/MAP kinase cascade	10916	1841		0.9083969465648855	0.9090909090909091	264	10652	39	9	225	10643	10916	0.3410293470200296
R1	cpdb	0	network_modules	314	TRUE	4.0927894503347387e-53	673	51	45	0.8823529411764706	0.06686478454680535	GO:0051603	GO:BP	proteolysis involved in protein catabolic process	16175	13820		0.07692307692307693	0.14285714285714285	673	15502	45	6	628	15496	16175	0.23678606879093161
R1	cpdb	0	network_modules	314	TRUE	5.91985779257437e-53	269	48	39	0.8125	0.1449814126394052	REAC:R-HSA-5684996	REAC	MAPK1/MAPK3 signaling	10916	1351		0.916030534351145	0.9166666666666666	269	10647	39	9	230	10638	10916	0.33772803461984435
R1	cpdb	0	network_modules	314	TRUE	1.1779622985838358e-51	289	48	39	0.8125	0.13494809688581316	REAC:R-HSA-69620	REAC	Cell Cycle Checkpoints	10916	321		0.9236641221374046	0.9242424242424242	289	10627	39	9	250	10618	10916	0.32538047145189364
R1	cpdb	0	network_modules	314	TRUE	2.0854997375166866e-51	293	48	39	0.8125	0.13310580204778158	REAC:R-HSA-9006925	REAC	Intracellular signaling by second messengers	10916	1266		0.9312977099236641	0.9318181818181818	293	10623	39	9	254	10614	10916	0.3230619686638288
R1	cpdb	0	network_modules	314	TRUE	4.222953325279858e-51	380	48	41	0.8541666666666666	0.10789473684210527	REAC:R-HSA-983169	REAC	Class I MHC mediated antigen processing & presentation	10916	368		0.9389312977099237	0.9393939393939394	380	10536	41	7	339	10529	10916	0.29706532487033505
R1	cpdb	0	network_modules	314	TRUE	4.7316277468791726e-51	232	48	37	0.7708333333333334	0.15948275862068967	REAC:R-HSA-157118	REAC	Signaling by NOTCH	10916	2274		0.9465648854961832	0.946969696969697	232	10684	37	11	195	10673	10916	0.34539533108335646
R1	cpdb	0	network_modules	314	TRUE	1.12444912899498e-50	141	46	34	0.7391304347826086	0.24113475177304963	KEGG:05017	KEGG	Spinocerebellar ataxia	8484	415		0.14285714285714285	0.25	141	8343	34	12	107	8331	8484	0.4172857458764788
R1	cpdb	0	network_modules	314	TRUE	1.6520378782029305e-50	308	48	39	0.8125	0.1266233766233766	REAC:R-HSA-5683057	REAC	MAPK family signaling cascades	10916	1348		0.9541984732824428	0.9545454545454546	308	10608	39	9	269	10599	10916	0.3147682135517652
R1	cpdb	0	network_modules	314	TRUE	1.9552069655361425e-49	327	48	39	0.8125	0.11926605504587157	REAC:R-HSA-195721	REAC	Signaling by WNT	10916	2314		0.9618320610687023	0.9621212121212122	327	10589	39	9	288	10580	10916	0.30508210256575286
R1	cpdb	0	network_modules	314	TRUE	1.7474323439879302e-48	547	51	41	0.803921568627451	0.07495429616087751	GO:0006511	GO:BP	ubiquitin-dependent protein catabolic process	16175	2235		0.15384615384615385	0.21428571428571427	547	15628	41	10	506	15618	16175	0.2396056024664261
R1	cpdb	0	network_modules	314	TRUE	3.2257759652779414e-48	555	51	41	0.803921568627451	0.07387387387387387	GO:0019941	GO:BP	modification-dependent protein catabolic process	16175	6072		0.23076923076923078	0.2857142857142857	555	15620	41	10	514	15610	16175	0.23778054404303836
R1	cpdb	0	network_modules	314	TRUE	4.3676505824411207e-48	559	51	41	0.803921568627451	0.07334525939177101	GO:0043632	GO:BP	modification-dependent macromolecule catabolic process	16175	10812		0.3076923076923077	0.35714285714285715	559	15616	41	10	518	15606	16175	0.23688248276383692
R1	cpdb	0	network_modules	314	TRUE	2.481934721785953e-47	363	51	37	0.7254901960784313	0.10192837465564739	GO:0043161	GO:BP	proteasome-mediated ubiquitin-dependent protein catabolic process	16175	10561		0.38461538461538464	0.42857142857142855	363	15812	37	14	326	15798	16175	0.26695087008474344
R1	cpdb	0	network_modules	314	TRUE	3.103127771952199e-47	370	48	39	0.8125	0.10540540540540541	REAC:R-HSA-71291	REAC	Metabolism of amino acids and derivatives	10916	1421		0.9694656488549618	0.9696969696969697	370	10546	39	9	331	10537	10916	0.28594444382490536
R1	cpdb	0	network_modules	314	TRUE	1.3616759121400423e-45	406	48	39	0.8125	0.0960591133004926	REAC:R-HSA-68886	REAC	M Phase	10916	1343		0.9770992366412213	0.9772727272727273	406	10510	39	9	367	10501	10916	0.2722817911815655
R1	cpdb	0	network_modules	314	TRUE	4.439799518848535e-45	418	48	39	0.8125	0.09330143540669857	REAC:R-HSA-5663202	REAC	Diseases of signal transduction by growth factor receptors and second messengers	10916	773		0.9847328244274809	0.9848484848484849	418	10498	39	9	379	10489	10916	0.2681176027255573
R1	cpdb	0	network_modules	314	TRUE	5.606744328267827e-45	472	48	40	0.8333333333333334	0.0847457627118644	REAC:R-HSA-449147	REAC	Signaling by Interleukins	10916	2261		0.9923664122137404	0.9924242424242424	472	10444	40	8	432	10436	10916	0.2581568730628322
R1	cpdb	0	network_modules	314	TRUE	1.640812397820824e-40	265	46	34	0.7391304347826086	0.12830188679245283	KEGG:05012	KEGG	Parkinson disease	8484	412		0.2857142857142857	0.375	265	8219	34	12	231	8207	8484	0.30046669233510526
R1	cpdb	0	network_modules	314	TRUE	3.665965617131732e-40	271	46	34	0.7391304347826086	0.12546125461254612	KEGG:05020	KEGG	Prion disease	8484	416		0.42857142857142855	0.5	271	8213	34	12	237	8201	8484	0.2969334424650347
R1	cpdb	0	network_modules	314	TRUE	2.495800984773831e-38	305	46	34	0.7391304347826086	0.11147540983606558	KEGG:05016	KEGG	Huntington disease	8484	414		0.5714285714285714	0.625	305	8179	34	12	271	8167	8484	0.27888589850943823
R1	cpdb	0	network_modules	314	TRUE	1.6270102217163814e-37	363	46	35	0.7608695652173914	0.09641873278236915	KEGG:05014	KEGG	Amyotrophic lateral sclerosis	8484	413		0.7142857142857143	0.75	363	8121	35	11	328	8110	8484	0.26198503209156876
R1	cpdb	0	network_modules	314	TRUE	7.011275594673898e-35	382	46	34	0.7391304347826086	0.08900523560209424	KEGG:05010	KEGG	Alzheimer disease	8484	411		0.8571428571428571	0.875	382	8102	34	12	348	8090	8484	0.24714787264135082
R1	cpdb	0	network_modules	314	TRUE	7.489073600174192e-18	198	46	19	0.41304347826086957	0.09595959595959595	KEGG:05169	KEGG	Epstein-Barr virus infection	8484	450		1	1	198	8286	19	27	179	8259	8484	0.19058609550927233
R1	cpdb	0	network_modules	314	TRUE	5.984027052096922e-11	201	51	13	0.2549019607843137	0.06467661691542288	GO:1903050	GO:BP	regulation of proteolysis involved in protein catabolic process	16175	22729		0.46153846153846156	0.5	201	15974	13	38	188	15936	16175	0.12309934903335926
R1	cpdb	0	network_modules	314	TRUE	2.444242542683835e-10	171	51	12	0.23529411764705882	0.07017543859649122	GO:0061136	GO:BP	regulation of proteasomal protein catabolic process	16175	15243		0.5384615384615384	0.5714285714285714	171	16004	12	39	159	15965	16175	0.12357389217469401
R1	cpdb	0	network_modules	314	TRUE	2.512402646674765e-10	10	51	6	0.11764705882352941	0.6	GO:0043248	GO:BP	proteasome assembly	16175	10584		0.6153846153846154	0.6428571428571429	10	16165	6	45	4	16120	16175	0.2647877914328466
R1	cpdb	0	network_modules	314	TRUE	1.0079192157293799e-8	375	51	14	0.27450980392156865	0.037333333333333336	GO:0030162	GO:BP	regulation of proteolysis	16175	6690		0.6923076923076923	0.7142857142857143	375	15800	14	37	361	15763	16175	0.09392604030667087
R1	cpdb	0	network_modules	314	TRUE	2.595935455267765e-7	309	51	12	0.23529411764705882	0.038834951456310676	GO:0042176	GO:BP	regulation of protein catabolic process	16175	10004		0.7692307692307693	0.7857142857142857	309	15866	12	39	297	15827	16175	0.08882122325503299
R1	cpdb	0	network_modules	314	TRUE	3.483256351635003e-7	476	48	15	0.3125	0.031512605042016806	REAC:R-HSA-6798695	REAC	Neutrophil degranulation	10916	1597		1	1	476	10440	15	33	461	10407	10916	0.08750586755084647
R1	cpdb	0	network_modules	314	TRUE	4.921898976336775e-5	3	51	3	0.058823529411764705	1	GO:0070682	GO:BP	proteasome regulatory particle assembly	16175	16258		0.8461538461538461	0.8571428571428571	3	16172	3	48	0	16124	16175	0.24217542341424286
R1	cpdb	0	network_modules	314	TRUE	0.0012931500987431997	102	51	6	0.11764705882352941	0.058823529411764705	GO:1901800	GO:BP	positive regulation of proteasomal protein catabolic process	16175	21744		0.9230769230769231	0.9285714285714286	102	16073	6	45	96	16028	16175	0.07910422188333047
R1	cpdb	0	network_modules	314	TRUE	0.0028978391532697646	117	51	6	0.11764705882352941	0.05128205128205128	GO:1903052	GO:BP	positive regulation of proteolysis involved in protein catabolic process	16175	22731		1	1	117	16058	6	45	111	16013	16175	0.07327860381503179
R1	cpdb	0	network_modules	316	TRUE	6.449043844069214e-18	774	19	17	0.8947368421052632	0.021963824289405683	GO:0007186	GO:BP	G protein-coupled receptor signaling pathway	16175	2744		0	0.25	774	15401	17	2	757	15399	16175	0.13606103803330785
R1	cpdb	0	network_modules	316	TRUE	3.181170245681518e-14	213	19	12	0.631578947368421	0.056338028169014086	REAC:R-HSA-416476	REAC	G alpha (q) signalling events	10916	988		0	0.05263157894736842	213	10703	12	7	201	10696	10916	0.1847748079569639
R1	cpdb	0	network_modules	316	TRUE	2.5968356580653474e-7	312	19	9	0.47368421052631576	0.028846153846153848	REAC:R-HSA-418594	REAC	G alpha (i) signalling events	10916	987		0.05555555555555555	0.10526315789473684	312	10604	9	10	303	10594	10916	0.11154100314918283
R1	cpdb	0	network_modules	316	TRUE	5.614253490880159e-7	32	19	5	0.2631578947368421	0.15625	REAC:R-HSA-392518	REAC	Signal amplification	10916	2213		0.1111111111111111	0.15789473684210525	32	10884	5	14	27	10870	10916	0.20098746845284168
R1	cpdb	0	network_modules	316	TRUE	4.692658645024468e-6	48	19	5	0.2631578947368421	0.10416666666666667	REAC:R-HSA-418597	REAC	G alpha (z) signalling events	10916	990		0.16666666666666666	0.21052631578947367	48	10868	5	14	43	10854	10916	0.16330132239525794
R1	cpdb	0	network_modules	316	TRUE	6.0869251942462094e-6	251	15	7	0.4666666666666667	0.027888446215139442	KEGG:04020	KEGG	Calcium signaling pathway	8484	250		0	0.1111111111111111	251	8233	7	8	244	8225	8484	0.1085617396873396
R1	cpdb	0	network_modules	316	TRUE	2.170000602893615e-5	24	19	4	0.21052631578947367	0.16666666666666666	REAC:R-HSA-428930	REAC	Thromboxane signalling through TP receptor	10916	2507		0.2222222222222222	0.2631578947368421	24	10892	4	15	20	10877	10916	0.1857267465799551
R1	cpdb	0	network_modules	316	TRUE	5.602370318775593e-5	78	19	5	0.2631578947368421	0.0641025641025641	REAC:R-HSA-422356	REAC	Regulation of insulin secretion	10916	2040		0.2777777777777778	0.3157894736842105	78	10838	5	14	73	10824	10916	0.126918816162384
R1	cpdb	0	network_modules	316	TRUE	6.286678965652123e-5	112	15	5	0.3333333333333333	0.044642857142857144	KEGG:04726	KEGG	Serotonergic synapse	8484	356		0.125	0.2222222222222222	112	8372	5	10	107	8362	8484	0.11804176851754215
R1	cpdb	0	network_modules	316	TRUE	7.929998637932039e-5	8	19	3	0.15789473684210525	0.375	REAC:R-HSA-434316	REAC	Fatty Acids bound to GPR40 (FFAR1) regulate insulin secretion	10916	934		0.3333333333333333	0.3684210526315789	8	10908	3	16	5	10892	10916	0.24250264233086488
R1	cpdb	0	network_modules	316	TRUE	1.0426150086752779e-4	124	15	5	0.3333333333333333	0.04032258064516129	KEGG:04611	KEGG	Platelet activation	8484	321		0.25	0.3333333333333333	124	8360	5	10	119	8350	8484	0.1117692325893546
R1	cpdb	0	network_modules	316	TRUE	1.4843600865545984e-4	38	19	4	0.21052631578947367	0.10526315789473684	REAC:R-HSA-6814122	REAC	Cooperation of PDCL (PhLP1) and TRiC/CCT in G-protein beta folding	10916	410		0.3888888888888889	0.42105263157894735	38	10878	4	15	34	10863	10916	0.14678634821163425
R1	cpdb	0	network_modules	316	TRUE	1.4950766443627591e-4	460	19	8	0.42105263157894735	0.017391304347826087	REAC:R-HSA-500792	REAC	GPCR ligand binding	10916	1019		0.4444444444444444	0.47368421052631576	460	10456	8	11	452	10445	10916	0.0787524833272576
R1	cpdb	0	network_modules	316	TRUE	1.724375663009829e-4	217	19	6	0.3157894736842105	0.027649769585253458	GO:0007188	GO:BP	adenylate cyclase-modulating G protein-coupled receptor signaling pathway	16175	2746		0.3333333333333333	0.5	217	15958	6	13	211	15945	16175	0.09013201843454449
R1	cpdb	0	network_modules	316	TRUE	2.3288181911626814e-4	11	19	3	0.15789473684210525	0.2727272727272727	REAC:R-HSA-400451	REAC	Free fatty acids regulate insulin secretion	10916	979		0.5	0.5263157894736842	11	10905	3	16	8	10889	10916	0.2064737038345342
R1	cpdb	0	network_modules	316	TRUE	2.4391385651803763e-4	328	19	7	0.3684210526315789	0.021341463414634148	REAC:R-HSA-373076	REAC	Class A/1 (Rhodopsin-like receptors)	10916	365		0.5555555555555556	0.5789473684210527	328	10588	7	12	321	10576	10916	0.08276356697532929
R1	cpdb	0	network_modules	316	TRUE	2.734635806792688e-4	107	19	5	0.2631578947368421	0.04672897196261682	REAC:R-HSA-163685	REAC	Integration of energy metabolism	10916	1213		0.6111111111111112	0.631578947368421	107	10809	5	14	102	10795	10916	0.10738237453794713
R1	cpdb	0	network_modules	316	TRUE	3.24588179482756e-4	122	19	5	0.2631578947368421	0.040983606557377046	GO:0008277	GO:BP	regulation of G protein-coupled receptor signaling pathway	16175	3149		0.6666666666666666	0.75	122	16053	5	14	117	16039	16175	0.10131719296767036
R1	cpdb	0	network_modules	316	TRUE	4.137219718427653e-4	164	15	5	0.3333333333333333	0.03048780487804878	KEGG:04022	KEGG	cGMP-PKG signaling pathway	8484	251		0.375	0.4444444444444444	164	8320	5	10	159	8310	8484	0.09597987863172514
R1	cpdb	0	network_modules	316	TRUE	4.2880374156425136e-4	129	19	5	0.2631578947368421	0.03875968992248062	GO:0007204	GO:BP	positive regulation of cytosolic calcium ion concentration	16175	2759		1	1	129	16046	5	14	124	16032	16175	0.0983845758875178
R1	cpdb	0	network_modules	316	TRUE	8.579012790615321e-4	88	15	4	0.26666666666666666	0.045454545454545456	KEGG:04540	KEGG	Gap junction	8484	318		0.5	0.5555555555555556	88	8396	4	11	84	8385	8484	0.10646122312759992
R1	cpdb	0	network_modules	316	TRUE	0.001122334074880342	259	19	6	0.3157894736842105	0.023166023166023165	REAC:R-HSA-76002	REAC	Platelet activation, signaling and aggregation	10916	1762		0.6666666666666666	0.6842105263157895	259	10657	6	13	253	10644	10916	0.08013011793902458
R1	cpdb	0	network_modules	316	TRUE	0.0013891056274880052	365	15	6	0.4	0.01643835616438356	KEGG:04080	KEGG	Neuroactive ligand-receptor interaction	8484	263		0.625	0.6666666666666666	365	8119	6	9	359	8110	8484	0.07404125614865752
R1	cpdb	0	network_modules	316	TRUE	0.0023078008299753368	113	15	4	0.26666666666666666	0.035398230088495575	KEGG:04725	KEGG	Cholinergic synapse	8484	355		0.75	0.7777777777777778	113	8371	4	11	109	8360	8484	0.09300770217344963
R1	cpdb	0	network_modules	316	TRUE	0.0028161162321667828	24	19	3	0.15789473684210525	0.125	REAC:R-HSA-418592	REAC	ADP signalling through P2Y purinoceptor 1	10916	12		0.7222222222222222	0.7894736842105263	24	10892	3	16	21	10876	10916	0.13880503843176983
R1	cpdb	0	network_modules	316	TRUE	0.0028161162321667828	24	19	3	0.15789473684210525	0.125	REAC:R-HSA-202040	REAC	G-protein activation	10916	996		0.7222222222222222	0.7894736842105263	24	10892	3	16	21	10876	10916	0.13880503843176983
R1	cpdb	0	network_modules	316	TRUE	0.004372703892369185	133	15	4	0.26666666666666666	0.03007518796992481	KEGG:04270	KEGG	Vascular smooth muscle contraction	8484	298		0.875	0.8888888888888888	133	8351	4	11	129	8340	8484	0.08503383195204782
R1	cpdb	0	network_modules	316	TRUE	0.0046415161096473685	89	19	4	0.21052631578947367	0.0449438202247191	REAC:R-HSA-111885	REAC	Opioid Signalling	10916	1642		0.8333333333333334	0.8421052631578947	89	10827	4	15	85	10812	10916	0.09397031089042783
R1	cpdb	0	network_modules	316	TRUE	0.0050695324641646415	91	19	4	0.21052631578947367	0.04395604395604396	REAC:R-HSA-390466	REAC	Chaperonin-mediated protein folding	10916	345		0.8888888888888888	0.8947368421052632	91	10825	4	15	87	10810	10916	0.0928563744489722
R1	cpdb	0	network_modules	316	TRUE	0.006206190388915163	31	19	3	0.15789473684210525	0.0967741935483871	REAC:R-HSA-456926	REAC	Thrombin signalling through proteinase activated receptors (PARs)	10916	2506		0.9444444444444444	0.9473684210526315	31	10885	3	16	28	10869	10916	0.12166823169955589
R1	cpdb	0	network_modules	316	TRUE	0.006799077787441603	98	19	4	0.21052631578947367	0.04081632653061224	REAC:R-HSA-391251	REAC	Protein folding	10916	1812		1	1	98	10818	4	15	94	10803	10916	0.08922370608997554
R1	cpdb	0	network_modules	316	TRUE	0.008692063086597472	59	15	3	0.2	0.05084745762711865	KEGG:04730	KEGG	Long-term depression	8484	359		1	1	59	8425	3	12	56	8413	8484	0.09776411411303126
R1	cpdb	0	network_modules	317	TRUE	1.4333950330138056e-29	27	32	14	0.4375	0.5185185185185185	GO:0032511	GO:BP	late endosome to vacuole transport via multivesicular body sorting pathway	16175	7618		0	0.015873015873015872	27	16148	14	18	13	16130	16175	0.475339361620977
R1	cpdb	0	network_modules	317	TRUE	3.351458390344419e-28	32	32	14	0.4375	0.4375	GO:0036258	GO:BP	multivesicular body assembly	16175	9519		0.016129032258064516	0.031746031746031744	32	16143	14	18	18	16125	16175	0.4363849656197733
R1	cpdb	0	network_modules	317	TRUE	5.814897117227848e-28	33	32	14	0.4375	0.42424242424242425	GO:0036257	GO:BP	multivesicular body organization	16175	9518		0.03225806451612903	0.047619047619047616	33	16142	14	18	19	16124	16175	0.42967451651083355
R1	cpdb	0	network_modules	317	TRUE	9.021216993218022e-28	16	32	12	0.375	0.75	GO:0043328	GO:BP	protein transport to vacuole involved in ubiquitin-dependent protein catabolic process via the multivesicular body sorting pathway	16175	10635		0.04838709677419355	0.06349206349206349	16	16159	12	20	4	16139	16175	0.529717217002099
R1	cpdb	0	network_modules	317	TRUE	1.6441270042538407e-27	35	32	14	0.4375	0.4	GO:0043162	GO:BP	ubiquitin-dependent protein catabolic process via the multivesicular body sorting pathway	16175	10562		0.06451612903225806	0.07936507936507936	35	16140	14	18	21	16122	16175	0.4171249011928856
R1	cpdb	0	network_modules	317	TRUE	4.3190141836722394e-27	37	32	14	0.4375	0.3783783783783784	GO:0045324	GO:BP	late endosome to vacuole transport	16175	11357		0.08064516129032258	0.09523809523809523	37	16138	14	18	23	16120	16175	0.40560454916801497
R1	cpdb	0	network_modules	317	TRUE	9.63714901041172e-27	248	26	21	0.8076923076923077	0.0846774193548387	KEGG:04144	KEGG	Endocytosis	8484	280		0	0.5	248	8236	21	5	227	8231	8484	0.25621599574922943
R1	cpdb	0	network_modules	317	TRUE	2.481870682732029e-26	41	32	14	0.4375	0.34146341463414637	GO:0032509	GO:BP	endosome transport via multivesicular body sorting pathway	16175	7616		0.0967741935483871	0.1111111111111111	41	16134	14	18	27	16116	16175	0.38514009796384824
R1	cpdb	0	network_modules	317	TRUE	8.070773433478437e-26	44	32	14	0.4375	0.3181818181818182	GO:0090148	GO:BP	membrane fission	16175	18057		0.11290322580645161	0.12698412698412698	44	16131	14	18	30	16113	16175	0.3716545743213817
R1	cpdb	0	network_modules	317	TRUE	1.148773126629089e-25	88	32	16	0.5	0.18181818181818182	GO:0007032	GO:BP	endosome organization	16175	2637		0.12903225806451613	0.14285714285714285	88	16087	16	16	72	16071	16175	0.29934143862453555
R1	cpdb	0	network_modules	317	TRUE	2.391114636300746e-25	47	32	14	0.4375	0.2978723404255319	GO:0071985	GO:BP	multivesicular body sorting pathway	16175	17028		0.14516129032258066	0.15873015873015872	47	16128	14	18	33	16110	16175	0.3594777179579998
R1	cpdb	0	network_modules	317	TRUE	5.048928980734647e-25	31	28	13	0.4642857142857143	0.41935483870967744	REAC:R-HSA-917729	REAC	Endosomal Sorting Complex Required For Transport (ESCRT)	10916	841		0	0.041666666666666664	31	10885	13	15	18	10870	10916	0.4397381691717932
R1	cpdb	0	network_modules	317	TRUE	2.643923867926819e-19	56	32	12	0.375	0.21428571428571427	GO:0072666	GO:BP	establishment of protein localization to vacuole	16175	17486		0.16129032258064516	0.1746031746031746	56	16119	12	20	44	16099	16175	0.28162238852057003
R1	cpdb	0	network_modules	317	TRUE	1.809411059849433e-17	155	32	14	0.4375	0.09032258064516129	GO:0007034	GO:BP	vacuolar transport	16175	2639		0.1774193548387097	0.19047619047619047	155	16020	14	18	141	16002	16175	0.19556444762151123
R1	cpdb	0	network_modules	317	TRUE	2.0052399157071742e-17	78	32	12	0.375	0.15384615384615385	GO:0072665	GO:BP	protein localization to vacuole	16175	17485		0.1935483870967742	0.20634920634920634	78	16097	12	20	66	16077	16175	0.23791273271884067
R1	cpdb	0	network_modules	317	TRUE	1.953454407083935e-16	315	32	16	0.5	0.050793650793650794	GO:0016050	GO:BP	vesicle organization	16175	5082		0.20967741935483872	0.2222222222222222	315	15860	16	16	299	15844	16175	0.15482344547264987
R1	cpdb	0	network_modules	317	TRUE	2.5388101627369014e-16	24	32	9	0.28125	0.375	GO:0046755	GO:BP	viral budding	16175	12354		0.22580645161290322	0.23809523809523808	24	16151	9	23	15	16128	16175	0.32360640906911853
R1	cpdb	0	network_modules	317	TRUE	9.520774688323996e-16	270	32	15	0.46875	0.05555555555555555	GO:0016197	GO:BP	endosomal transport	16175	5169		0.24193548387096775	0.25396825396825395	270	15905	15	17	255	15888	16175	0.15709855333123396
R1	cpdb	0	network_modules	317	TRUE	2.553372226225728e-15	28	28	9	0.32142857142857145	0.32142857142857145	REAC:R-HSA-162588	REAC	Budding and maturation of HIV virion	10916	258		0.043478260869565216	0.08333333333333333	28	10888	9	19	19	10869	10916	0.3196835310171093
R1	cpdb	0	network_modules	317	TRUE	7.40273098498499e-15	33	32	9	0.28125	0.2727272727272727	GO:0019068	GO:BP	virion assembly	16175	5561		0.25806451612903225	0.2698412698412698	33	16142	9	23	24	16119	16175	0.27550037468445987
R1	cpdb	0	network_modules	317	TRUE	2.6671113470133107e-14	21	32	8	0.25	0.38095238095238093	GO:0039702	GO:BP	viral budding via host ESCRT complex	16175	9879		0.27419354838709675	0.2857142857142857	21	16154	8	24	13	16130	16175	0.30750786119440876
R1	cpdb	0	network_modules	317	TRUE	2.936615706452127e-14	657	32	18	0.5625	0.0273972602739726	GO:0061024	GO:BP	membrane organization	16175	15141		0.2903225806451613	0.30158730158730157	657	15518	18	14	639	15504	16175	0.1177060312273051
R1	cpdb	0	network_modules	317	TRUE	3.272246800404774e-13	309	32	14	0.4375	0.045307443365695796	GO:0016236	GO:BP	macroautophagy	16175	5179		0.3064516129032258	0.31746031746031744	309	15866	14	18	295	15848	16175	0.1360824677783958
R1	cpdb	0	network_modules	317	TRUE	5.499332931520503e-13	113	28	11	0.39285714285714285	0.09734513274336283	REAC:R-HSA-9610379	REAC	HCMV Late Events	10916	1090		0.08695652173913043	0.125	113	10803	11	17	102	10786	10916	0.19164372709509708
R1	cpdb	0	network_modules	317	TRUE	6.056651705833763e-13	522	32	16	0.5	0.03065134099616858	GO:0010256	GO:BP	endomembrane system organization	16175	4029		0.3225806451612903	0.3333333333333333	522	15653	16	16	506	15637	16175	0.1178382969479783
R1	cpdb	0	network_modules	317	TRUE	3.6148780472127117e-12	34	28	8	0.2857142857142857	0.23529411764705882	REAC:R-HSA-9615710	REAC	Late endosomal microautophagy	10916	1306		0.13043478260869565	0.16666666666666666	34	10882	8	20	26	10862	10916	0.2571853328066916
R1	cpdb	0	network_modules	317	TRUE	2.5561280942834837e-11	159	28	11	0.39285714285714285	0.06918238993710692	REAC:R-HSA-9609646	REAC	HCMV Infection	10916	1089		0.17391304347826086	0.20833333333333334	159	10757	11	17	148	10740	10916	0.16012191351061375
R1	cpdb	0	network_modules	317	TRUE	1.4567777864488968e-10	373	32	13	0.40625	0.03485254691689008	GO:0072594	GO:BP	establishment of protein localization to organelle	16175	17458		0.3387096774193548	0.3492063492063492	373	15802	13	19	360	15783	16175	0.11366599606997164
R1	cpdb	0	network_modules	317	TRUE	1.5849396376244466e-10	14	28	6	0.21428571428571427	0.42857142857142855	REAC:R-HSA-174495	REAC	Synthesis And Processing Of GAG, GAGPOL Polyproteins	10916	2368		0.21739130434782608	0.2916666666666667	14	10902	6	22	8	10880	10916	0.3018126885474139
R1	cpdb	0	network_modules	317	TRUE	1.5849396376244466e-10	14	28	6	0.21428571428571427	0.42857142857142855	REAC:R-HSA-174490	REAC	Membrane binding and targetting of GAG proteins	10916	1415		0.21739130434782608	0.2916666666666667	14	10902	6	22	8	10880	10916	0.3018126885474139
R1	cpdb	0	network_modules	317	TRUE	1.9733405544553295e-10	491	32	14	0.4375	0.028513238289205704	GO:0061919	GO:BP	process utilizing autophagic mechanism	16175	15723		0.3548387096774194	0.38095238095238093	491	15684	14	18	477	15666	16175	0.10565902010368466
R1	cpdb	0	network_modules	317	TRUE	1.9733405544553295e-10	491	32	14	0.4375	0.028513238289205704	GO:0006914	GO:BP	autophagy	16175	2563		0.3548387096774194	0.38095238095238093	491	15684	14	18	477	15666	16175	0.10565902010368466
R1	cpdb	0	network_modules	317	TRUE	4.2119024478640385e-10	16	28	6	0.21428571428571427	0.375	REAC:R-HSA-175474	REAC	Assembly Of The HIV Virion	10916	172		0.30434782608695654	0.3333333333333333	16	10900	6	22	10	10878	10916	0.28210295540230684
R1	cpdb	0	network_modules	317	TRUE	7.163286944500177e-10	673	32	15	0.46875	0.022288261515601784	GO:0051603	GO:BP	proteolysis involved in protein catabolic process	16175	13820		0.3870967741935484	0.3968253968253968	673	15502	15	17	658	15485	16175	0.09523544697071394
R1	cpdb	0	network_modules	317	TRUE	8.595642129728078e-10	547	32	14	0.4375	0.025594149908592323	GO:0006511	GO:BP	ubiquitin-dependent protein catabolic process	16175	2235		0.4032258064516129	0.4126984126984127	547	15628	14	18	533	15610	16175	0.09943094902113951
R1	cpdb	0	network_modules	317	TRUE	1.04687952396201e-9	555	32	14	0.4375	0.025225225225225224	GO:0019941	GO:BP	modification-dependent protein catabolic process	16175	6072		0.41935483870967744	0.42857142857142855	555	15620	14	18	541	15602	16175	0.09861603115606463
R1	cpdb	0	network_modules	317	TRUE	1.1540318103313795e-9	559	32	14	0.4375	0.025044722719141325	GO:0043632	GO:BP	modification-dependent macromolecule catabolic process	16175	10812		0.43548387096774194	0.4444444444444444	559	15616	14	18	545	15598	16175	0.09821487453446785
R1	cpdb	0	network_modules	317	TRUE	7.960792632246295e-9	132	28	9	0.32142857142857145	0.06818181818181818	REAC:R-HSA-162599	REAC	Late Phase of HIV Life Cycle	10916	1304		0.34782608695652173	0.375	132	10784	9	19	123	10765	10916	0.14352328615519233
R1	cpdb	0	network_modules	317	TRUE	1.8631280451816433e-8	145	28	9	0.32142857142857145	0.06206896551724138	REAC:R-HSA-162587	REAC	HIV Life Cycle	10916	1103		0.391304347826087	0.4166666666666667	145	10771	9	19	136	10752	10916	0.13649352356665198
R1	cpdb	0	network_modules	317	TRUE	5.0026093426486e-8	14	28	5	0.17857142857142858	0.35714285714285715	REAC:R-HSA-8875360	REAC	InlB-mediated entry of Listeria monocytogenes into host cell	10916	1203		0.43478260869565216	0.4583333333333333	14	10902	5	23	9	10879	10916	0.2512076979449383
R1	cpdb	0	network_modules	317	TRUE	2.1689934142604165e-7	524	32	12	0.375	0.022900763358778626	GO:0006886	GO:BP	intracellular protein transport	16175	2542		0.45161290322580644	0.4603174603174603	524	15651	12	20	512	15631	16175	0.0861555601586351
R1	cpdb	0	network_modules	317	TRUE	2.880172599405345e-7	19	28	5	0.17857142857142858	0.2631578947368421	REAC:R-HSA-8876384	REAC	Listeria monocytogenes entry into host cells	10916	1319		0.4782608695652174	0.5	19	10897	5	23	14	10874	10916	0.21512767331755636
R1	cpdb	0	network_modules	317	TRUE	3.8334815891282114e-7	20	28	5	0.17857142857142858	0.25	REAC:R-HSA-6807004	REAC	Negative regulation of MET activity	10916	1574		0.5217391304347826	0.5416666666666666	20	10896	5	23	15	10873	10916	0.2095815089933895
R1	cpdb	0	network_modules	317	TRUE	8.206098036822821e-7	149	28	8	0.2857142857142857	0.053691275167785234	REAC:R-HSA-9612973	REAC	Autophagy	10916	193		0.5652173913043478	0.5833333333333334	149	10767	8	20	141	10747	10916	0.11890497558382056
R1	cpdb	0	network_modules	317	TRUE	9.376217951177832e-7	225	28	9	0.32142857142857145	0.04	REAC:R-HSA-162906	REAC	HIV Infection	10916	1102		0.6086956521739131	0.625	225	10691	9	19	216	10672	10916	0.10736677247651245
R1	cpdb	0	network_modules	317	TRUE	9.895344834778207e-7	242	32	9	0.28125	0.0371900826446281	GO:0019058	GO:BP	viral life cycle	16175	5555		0.46774193548387094	0.47619047619047616	242	15933	9	23	233	15910	16175	0.09766148719958968
R1	cpdb	0	network_modules	317	TRUE	2.314895784396749e-6	808	32	13	0.40625	0.01608910891089109	GO:0033365	GO:BP	protein localization to organelle	16175	8175		0.4838709677419355	0.49206349206349204	808	15367	13	19	795	15348	16175	0.0728179291845569
R1	cpdb	0	network_modules	317	TRUE	3.4621263327544197e-6	30	28	5	0.17857142857142858	0.16666666666666666	REAC:R-HSA-182971	REAC	EGFR downregulation	10916	814		0.6521739130434783	0.6666666666666666	30	10886	5	23	25	10863	10916	0.1703137839418383
R1	cpdb	0	network_modules	317	TRUE	4.382272987494884e-6	66	28	6	0.21428571428571427	0.09090909090909091	REAC:R-HSA-9824439	REAC	Bacterial Infection Pathways	10916	204		0.6956521739130435	0.7083333333333334	66	10850	6	22	60	10828	10916	0.13622124738204472
R1	cpdb	0	network_modules	317	TRUE	1.0363017544562354e-5	76	28	6	0.21428571428571427	0.07894736842105263	REAC:R-HSA-6806834	REAC	Signaling by MET	10916	2270		0.7391304347826086	0.75	76	10840	6	22	70	10818	10916	0.1264432037628432
R1	cpdb	0	network_modules	317	TRUE	1.8801382985073205e-5	144	28	7	0.25	0.04861111111111111	REAC:R-HSA-8856828	REAC	Clathrin-mediated endocytosis	10916	372		0.782608695652174	0.7916666666666666	144	10772	7	21	137	10751	10916	0.10525338905513537
R1	cpdb	0	network_modules	317	TRUE	2.493542805552446e-5	15	32	4	0.125	0.26666666666666666	GO:1903543	GO:BP	positive regulation of exosomal secretion	16175	23093		0.5	0.5079365079365079	15	16160	4	28	11	16132	16175	0.1814833891275626
R1	cpdb	0	network_modules	317	TRUE	2.4957572156290545e-5	350	32	9	0.28125	0.025714285714285714	GO:0016032	GO:BP	viral process	16175	5071		0.5161290322580645	0.5238095238095238	350	15825	9	23	341	15802	16175	0.07944114282274496
R1	cpdb	0	network_modules	317	TRUE	4.03026473651712e-5	48	28	5	0.17857142857142858	0.10416666666666667	REAC:R-HSA-177929	REAC	Signaling by EGFR	10916	2229		0.8260869565217391	0.8333333333333334	48	10868	5	23	43	10845	10916	0.13349251371253526
R1	cpdb	0	network_modules	317	TRUE	4.335680017160987e-5	17	32	4	0.125	0.23529411764705882	GO:1903541	GO:BP	regulation of exosomal secretion	16175	23091		0.532258064516129	0.5396825396825397	17	16158	4	28	13	16130	16175	0.17031460968341863
R1	cpdb	0	network_modules	317	TRUE	5.179617160132527e-5	48	32	5	0.15625	0.10416666666666667	GO:0061097	GO:BP	regulation of protein tyrosine kinase activity	16175	15207		0.5483870967741935	0.5555555555555556	48	16127	5	27	43	16100	16175	0.12546488649828383
R1	cpdb	0	network_modules	317	TRUE	8.789581770407148e-5	20	32	4	0.125	0.2	GO:1990182	GO:BP	exosomal secretion	16175	25111		0.5645161290322581	0.5714285714285714	20	16155	4	28	16	16127	16175	0.15680190792955565
R1	cpdb	0	network_modules	317	TRUE	1.0842680151965999e-4	21	32	4	0.125	0.19047619047619047	GO:0097734	GO:BP	extracellular exosome biogenesis	16175	18749		0.5806451612903226	0.5873015873015873	21	16154	4	28	17	16126	16175	0.1529512874942173
R1	cpdb	0	network_modules	317	TRUE	1.250791519654451e-4	57	32	5	0.15625	0.08771929824561403	GO:0042058	GO:BP	regulation of epidermal growth factor receptor signaling pathway	16175	9945		0.5967741935483871	0.6031746031746031	57	16118	5	27	52	16091	16175	0.11474856207473226
R1	cpdb	0	network_modules	317	TRUE	1.5997686977409516e-4	23	32	4	0.125	0.17391304347826086	GO:0140112	GO:BP	extracellular vesicle biogenesis	16175	19667		0.6129032258064516	0.6190476190476191	23	16152	4	28	19	16124	16175	0.14601296872133598
R1	cpdb	0	network_modules	317	TRUE	2.060384700284936e-4	6	32	3	0.09375	0.5	GO:1903551	GO:BP	regulation of extracellular exosome assembly	16175	23098		0.6290322580645161	0.6349206349206349	6	16169	3	29	3	16140	16175	0.21590337641264376
R1	cpdb	0	network_modules	317	TRUE	2.0822083382316352e-4	63	32	5	0.15625	0.07936507936507936	GO:1901184	GO:BP	regulation of ERBB signaling pathway	16175	21287		0.6451612903225806	0.6507936507936508	63	16112	5	27	58	16085	16175	0.10890282648618382
R1	cpdb	0	network_modules	317	TRUE	2.2790576362250752e-4	25	32	4	0.125	0.16	GO:1902410	GO:BP	mitotic cytokinetic process	16175	22262		0.6612903225806451	0.6666666666666666	25	16150	4	28	21	16122	16175	0.13991925302498212
R1	cpdb	0	network_modules	317	TRUE	3.600824481175372e-4	7	32	3	0.09375	0.42857142857142855	GO:0071971	GO:BP	extracellular exosome assembly	16175	17016		0.6774193548387096	0.6825396825396826	7	16168	3	29	4	16139	16175	0.19976152254110363
R1	cpdb	0	network_modules	317	TRUE	4.255386772063249e-4	29	32	4	0.125	0.13793103448275862	GO:0035891	GO:BP	exit from host cell	16175	9315		0.6935483870967742	0.7142857142857143	29	16146	4	28	25	16118	16175	0.12966759380087375
R1	cpdb	0	network_modules	317	TRUE	4.255386772063249e-4	29	32	4	0.125	0.13793103448275862	GO:0019076	GO:BP	viral release from host cell	16175	5568		0.6935483870967742	0.7142857142857143	29	16146	4	28	25	16118	16175	0.12966759380087375
R1	cpdb	0	network_modules	317	TRUE	9.772492548709305e-4	507	28	9	0.32142857142857145	0.01775147928994083	REAC:R-HSA-9006934	REAC	Signaling by Receptor Tyrosine Kinases	10916	2302		0.8695652173913043	0.875	507	10409	9	19	498	10390	10916	0.06626219645585216
R1	cpdb	0	network_modules	317	TRUE	0.0013061252102117913	38	32	4	0.125	0.10526315789473684	GO:0032506	GO:BP	cytokinetic process	16175	7613		0.7258064516129032	0.7301587301587301	38	16137	4	28	34	16109	16175	0.11279607110152182
R1	cpdb	0	network_modules	317	TRUE	0.001553149170636082	175	32	6	0.1875	0.03428571428571429	GO:0050730	GO:BP	regulation of peptidyl-tyrosine phosphorylation	16175	13229		0.7419354838709677	0.746031746031746	175	16000	6	26	169	15974	16175	0.07603920744906331
R1	cpdb	0	network_modules	317	TRUE	0.001688419813370325	11	32	3	0.09375	0.2727272727272727	GO:0007175	GO:BP	negative regulation of epidermal growth factor-activated receptor activity	16175	2738		0.7580645161290323	0.7619047619047619	11	16164	3	29	8	16135	16175	0.15895193423622508
R1	cpdb	0	network_modules	317	TRUE	0.0018207749056702504	97	32	5	0.15625	0.05154639175257732	GO:0007173	GO:BP	epidermal growth factor receptor signaling pathway	16175	2736		0.7741935483870968	0.7777777777777778	97	16078	5	27	92	16051	16175	0.0866460345258733
R1	cpdb	0	network_modules	317	TRUE	0.001961197727042298	104	28	5	0.17857142857142858	0.04807692307692308	REAC:R-HSA-8856825	REAC	Cargo recognition for clathrin-mediated endocytosis	10916	309		0.9130434782608695	0.9166666666666666	104	10812	5	23	99	10789	10916	0.08824678475794258
R1	cpdb	0	network_modules	317	TRUE	0.0021968320775269134	62	26	4	0.15384615384615385	0.06451612903225806	KEGG:03250	KEGG	Viral life cycle - HIV-1	8484	223		1	1	62	8422	4	22	58	8400	8484	0.09538962037411214
R1	cpdb	0	network_modules	317	TRUE	0.002248199685490826	12	32	3	0.09375	0.25	GO:0032486	GO:BP	Rap protein signal transduction	16175	7597		0.7903225806451613	0.7936507936507936	12	16163	3	29	9	16134	16175	0.152088503044477
R1	cpdb	0	network_modules	317	TRUE	0.002820900719082938	112	28	5	0.17857142857142858	0.044642857142857144	REAC:R-HSA-187037	REAC	Signaling by NTRK1 (TRKA)	10916	2284		0.9565217391304348	0.9583333333333334	112	10804	5	23	107	10781	10916	0.08469940484509451
R1	cpdb	0	network_modules	317	TRUE	0.003692340225155554	49	32	4	0.125	0.08163265306122448	GO:0140238	GO:BP	presynaptic endocytosis	16175	19709		0.8064516129032258	0.8253968253968254	49	16126	4	28	45	16098	16175	0.09881458875773916
R1	cpdb	0	network_modules	317	TRUE	0.003692340225155554	49	32	4	0.125	0.08163265306122448	GO:0048488	GO:BP	synaptic vesicle endocytosis	16175	12781		0.8064516129032258	0.8253968253968254	49	16126	4	28	45	16098	16175	0.09881458875773916
R1	cpdb	0	network_modules	317	TRUE	0.0037117679345677725	112	32	5	0.15625	0.044642857142857144	GO:0038127	GO:BP	ERBB signaling pathway	16175	9716		0.8387096774193549	0.8412698412698413	112	16063	5	27	107	16036	16175	0.08017509306715084
R1	cpdb	0	network_modules	317	TRUE	0.0049993703613318875	214	32	6	0.1875	0.028037383177570093	GO:0018108	GO:BP	peptidyl-tyrosine phosphorylation	16175	5327		0.8548387096774194	0.8571428571428571	214	15961	6	26	208	15935	16175	0.06790662073168684
R1	cpdb	0	network_modules	317	TRUE	0.005135768688996438	215	32	6	0.1875	0.027906976744186046	GO:0018212	GO:BP	peptidyl-tyrosine modification	16175	5371		0.8709677419354839	0.8888888888888888	215	15960	6	26	209	15934	16175	0.06772660154320334
R1	cpdb	0	network_modules	317	TRUE	0.005135768688996438	215	32	6	0.1875	0.027906976744186046	GO:0032984	GO:BP	protein-containing complex disassembly	16175	7964		0.8709677419354839	0.8888888888888888	215	15960	6	26	209	15934	16175	0.06772660154320334
R1	cpdb	0	network_modules	317	TRUE	0.005576234529139214	2	32	2	0.0625	1	GO:0019075	GO:BP	virus maturation	16175	5567		0.9032258064516129	0.9047619047619048	2	16173	2	30	0	16143	16175	0.2497680244466571
R1	cpdb	0	network_modules	317	TRUE	0.005691979037495032	16	32	3	0.09375	0.1875	GO:0007176	GO:BP	regulation of epidermal growth factor-activated receptor activity	16175	2739		0.9193548387096774	0.9206349206349206	16	16159	3	29	13	16130	16175	0.1313785603442454
R1	cpdb	0	network_modules	317	TRUE	0.0058943178945131	55	32	4	0.125	0.07272727272727272	GO:0097352	GO:BP	autophagosome maturation	16175	18619		0.9354838709677419	0.9365079365079365	55	16120	4	28	51	16092	16175	0.09300274403543748
R1	cpdb	0	network_modules	317	TRUE	0.006051584551923458	131	28	5	0.17857142857142858	0.03816793893129771	REAC:R-HSA-166520	REAC	Signaling by NTRKs	10916	2287		1	1	131	10785	5	23	126	10762	10916	0.07757492487018094
R1	cpdb	0	network_modules	317	TRUE	0.006902398088350036	17	32	3	0.09375	0.17647058823529413	GO:0032510	GO:BP	endosome to lysosome transport via multivesicular body sorting pathway	16175	7617		0.9516129032258065	0.9682539682539683	17	16158	3	29	14	16129	16175	0.12737491874836507
R1	cpdb	0	network_modules	317	TRUE	0.006902398088350036	17	32	3	0.09375	0.17647058823529413	GO:0061952	GO:BP	midbody abscission	16175	15745		0.9516129032258065	0.9682539682539683	17	16158	3	29	14	16129	16175	0.12737491874836507
R1	cpdb	0	network_modules	317	TRUE	0.007822285512758627	59	32	4	0.125	0.06779661016949153	GO:0036465	GO:BP	synaptic vesicle recycling	16175	9613		0.9838709677419355	0.9841269841269841	59	16116	4	28	55	16088	16175	0.08962328831149852
R1	cpdb	0	network_modules	317	TRUE	0.009809493645624893	19	32	3	0.09375	0.15789473684210525	GO:0061099	GO:BP	negative regulation of protein tyrosine kinase activity	16175	15209		1	1	19	16156	3	29	16	16127	16175	0.12033134874051403
R1	cpdb	0	network_modules	319	TRUE	0.00803503207395748	328	13	5	0.38461538461538464	0.01524390243902439	REAC:R-HSA-373076	REAC	Class A/1 (Rhodopsin-like receptors)	10916	365		NA	1	328	10588	5	8	323	10580	10916	0.07171624431948669
R1	cpdb	0	network_modules	320	TRUE	1.4801596408713794e-29	590	38	28	0.7368421052631579	0.04745762711864407	GO:0016071	GO:BP	mRNA metabolic process	16175	5098		0	0.017857142857142856	590	15585	28	10	562	15575	16175	0.1812885486378431
R1	cpdb	0	network_modules	320	TRUE	2.07811345082242e-28	279	38	23	0.6052631578947368	0.08243727598566308	GO:0006401	GO:BP	RNA catabolic process	16175	2162		0.01818181818181818	0.03571428571428571	279	15896	23	15	256	15881	16175	0.21916265852803582
R1	cpdb	0	network_modules	320	TRUE	1.069430083950237e-27	299	38	23	0.6052631578947368	0.07692307692307693	GO:0141188	GO:BP	nucleic acid catabolic process	16175	20075		0.03636363636363636	0.05357142857142857	299	15876	23	15	276	15861	16175	0.21139380393048302
R1	cpdb	0	network_modules	320	TRUE	5.813307400587245e-27	15	32	12	0.375	0.8	REAC:R-HSA-430039	REAC	mRNA decay by 5' to 3' exoribonuclease	10916	2710		0	0.02564102564102564	15	10901	12	20	3	10881	10916	0.546893031829093
R1	cpdb	0	network_modules	320	TRUE	1.5467234823186204e-26	226	38	21	0.5526315789473685	0.09292035398230089	GO:0006402	GO:BP	mRNA catabolic process	16175	2163		0.05454545454545454	0.07142857142857142	226	15949	21	17	205	15932	16175	0.22269885405320455
R1	cpdb	0	network_modules	320	TRUE	2.502327716043479e-24	79	23	15	0.6521739130434783	0.189873417721519	KEGG:03018	KEGG	RNA degradation	8484	211		0	0.3333333333333333	79	8405	15	8	64	8397	8484	0.3489709386931347
R1	cpdb	0	network_modules	320	TRUE	1.370535497490625e-23	448	38	23	0.6052631578947368	0.05133928571428571	GO:0034655	GO:BP	nucleobase-containing compound catabolic process	16175	8711		0.07272727272727272	0.08928571428571429	448	15727	23	15	425	15712	16175	0.17079078246239573
R1	cpdb	0	network_modules	320	TRUE	4.151579564080175e-20	56	32	13	0.40625	0.23214285714285715	REAC:R-HSA-429914	REAC	Deadenylation-dependent mRNA decay	10916	454		0.02631578947368421	0.05128205128205128	56	10860	13	19	43	10841	10916	0.3044454927755689
R1	cpdb	0	network_modules	320	TRUE	2.3229835928907253e-19	67	38	13	0.34210526315789475	0.19402985074626866	GO:0016441	GO:BP	post-transcriptional gene silencing	16175	5222		0.09090909090909091	0.10714285714285714	67	16108	13	25	54	16083	16175	0.2553499168706753
R1	cpdb	0	network_modules	320	TRUE	7.912603558137239e-19	434	38	20	0.5263157894736842	0.04608294930875576	GO:0010608	GO:BP	post-transcriptional regulation of gene expression	16175	4255		0.10909090909090909	0.125	434	15741	20	18	414	15723	16175	0.1499980006912445
R1	cpdb	0	network_modules	320	TRUE	1.295807767423307e-16	50	38	11	0.2894736842105263	0.22	GO:0035195	GO:BP	miRNA-mediated post-transcriptional gene silencing	16175	8884		0.12727272727272726	0.14285714285714285	50	16125	11	27	39	16098	16175	0.2503434836529552
R1	cpdb	0	network_modules	320	TRUE	2.915218917728954e-16	112	38	13	0.34210526315789475	0.11607142857142858	GO:0031047	GO:BP	regulatory ncRNA-mediated gene silencing	16175	7011		0.14545454545454545	0.16071428571428573	112	16063	13	25	99	16038	16175	0.19614702974157552
R1	cpdb	0	network_modules	320	TRUE	3.289442092590944e-16	113	38	13	0.34210526315789475	0.11504424778761062	GO:0000956	GO:BP	nuclear-transcribed mRNA catabolic process	16175	264		0.16363636363636364	0.17857142857142858	113	16062	13	25	100	16037	16175	0.19524725279449823
R1	cpdb	0	network_modules	320	TRUE	1.7310104619354925e-15	62	38	11	0.2894736842105263	0.1774193548387097	GO:0035194	GO:BP	regulatory ncRNA-mediated post-transcriptional gene silencing	16175	8883		0.18181818181818182	0.19642857142857142	62	16113	11	27	51	16086	16175	0.22431617425633651
R1	cpdb	0	network_modules	320	TRUE	4.062968978190086e-15	15	38	8	0.21052631578947367	0.5333333333333333	GO:0110156	GO:BP	mRNA methylguanosine-cap decapping	16175	19450		0.2	0.21428571428571427	15	16160	8	30	7	16130	16175	0.33415464401158324
R1	cpdb	0	network_modules	320	TRUE	2.7491662295577906e-14	18	38	8	0.21052631578947367	0.4444444444444444	GO:0110154	GO:BP	RNA decapping	16175	19448		0.21818181818181817	0.23214285714285715	18	16157	8	30	10	16127	16175	0.3047984276111766
R1	cpdb	0	network_modules	320	TRUE	9.151411608416378e-14	172	38	13	0.34210526315789475	0.0755813953488372	GO:0061013	GO:BP	regulation of mRNA catabolic process	16175	15136		0.23636363636363636	0.25	172	16003	13	25	159	15978	16175	0.15682165987500307
R1	cpdb	0	network_modules	320	TRUE	1.3946768575753508e-12	156	38	12	0.3157894736842105	0.07692307692307693	GO:0043488	GO:BP	regulation of mRNA stability	16175	10733		0.2545454545454545	0.26785714285714285	156	16019	12	26	144	15993	16175	0.15200987545610886
R1	cpdb	0	network_modules	320	TRUE	2.7099967169142757e-12	291	38	14	0.3684210526315789	0.048109965635738834	GO:0000375	GO:BP	RNA splicing, via transesterification reactions	16175	107		0.2727272727272727	0.2857142857142857	291	15884	14	24	277	15860	16175	0.12793811196821867
R1	cpdb	0	network_modules	320	TRUE	3.1998969815210905e-12	167	38	12	0.3157894736842105	0.0718562874251497	GO:0043487	GO:BP	regulation of RNA stability	16175	10732		0.2909090909090909	0.30357142857142855	167	16008	12	26	155	15982	16175	0.14664228761692616
R1	cpdb	0	network_modules	320	TRUE	3.637966139188967e-12	8	32	6	0.1875	0.75	REAC:R-HSA-8948700	REAC	Competing endogenous RNAs (ceRNAs) regulate PTEN translation	10916	389		0.05263157894736842	0.07692307692307693	8	10908	6	26	2	10882	10916	0.3742201241575765
R1	cpdb	0	network_modules	320	TRUE	5.731872573731521e-12	125	38	11	0.2894736842105263	0.088	GO:1903313	GO:BP	positive regulation of mRNA metabolic process	16175	22897		0.3090909090909091	0.32142857142857145	125	16050	11	27	114	16023	16175	0.15613111946476502
R1	cpdb	0	network_modules	320	TRUE	6.370747824631758e-12	17	38	7	0.18421052631578946	0.4117647058823529	GO:0033962	GO:BP	P-body assembly	16175	8367		0.32727272727272727	0.3392857142857143	17	16158	7	31	10	16127	16175	0.2743063910074191
R1	cpdb	0	network_modules	320	TRUE	1.0407365382482002e-11	18	38	7	0.18421052631578946	0.3888888888888889	GO:0035278	GO:BP	miRNA-mediated gene silencing by inhibition of translation	16175	8938		0.34545454545454546	0.35714285714285715	18	16157	7	31	11	16126	16175	0.26649616086414607
R1	cpdb	0	network_modules	320	TRUE	1.0891603066765993e-11	9	32	6	0.1875	0.6666666666666666	REAC:R-HSA-9759811	REAC	Regulation of CDH11 mRNA translation by microRNAs	10916	1969		0.07894736842105263	0.1794871794871795	9	10907	6	26	3	10881	10916	0.3526612261278592
R1	cpdb	0	network_modules	320	TRUE	1.0891603066765993e-11	9	32	6	0.1875	0.6666666666666666	REAC:R-HSA-426486	REAC	Small interfering RNA (siRNA) biogenesis	10916	2335		0.07894736842105263	0.1794871794871795	9	10907	6	26	3	10881	10916	0.3526612261278592
R1	cpdb	0	network_modules	320	TRUE	1.0891603066765993e-11	9	32	6	0.1875	0.6666666666666666	REAC:R-HSA-8943723	REAC	Regulation of PTEN mRNA translation	10916	2001		0.07894736842105263	0.1794871794871795	9	10907	6	26	3	10881	10916	0.3526612261278592
R1	cpdb	0	network_modules	320	TRUE	1.0891603066765993e-11	9	32	6	0.1875	0.6666666666666666	REAC:R-HSA-9768778	REAC	Regulation of NPAS4 mRNA translation	10916	1996		0.07894736842105263	0.1794871794871795	9	10907	6	26	3	10881	10916	0.3526612261278592
R1	cpdb	0	network_modules	320	TRUE	1.3469641558395547e-11	92	38	10	0.2631578947368421	0.10869565217391304	GO:0061157	GO:BP	mRNA destabilization	16175	15262		0.36363636363636365	0.375	92	16083	10	28	82	16055	16175	0.16613994162061935
R1	cpdb	0	network_modules	320	TRUE	1.8786829260680637e-11	95	38	10	0.2631578947368421	0.10526315789473684	GO:0050779	GO:BP	RNA destabilization	16175	13253		0.38181818181818183	0.39285714285714285	95	16080	10	28	85	16052	16175	0.16339309971150107
R1	cpdb	0	network_modules	320	TRUE	2.330799057063147e-11	97	38	10	0.2631578947368421	0.10309278350515463	GO:0061014	GO:BP	positive regulation of mRNA catabolic process	16175	15137		0.4	0.4107142857142857	97	16078	10	28	87	16050	16175	0.16163220251714117
R1	cpdb	0	network_modules	320	TRUE	3.5108450279239094e-11	10	38	6	0.15789473684210525	0.6	GO:0070922	GO:BP	RISC complex assembly	16175	16373		0.41818181818181815	0.42857142857142855	10	16165	6	32	4	16133	16175	0.30704403615045606
R1	cpdb	0	network_modules	320	TRUE	3.775288380641974e-11	352	38	14	0.3684210526315789	0.03977272727272727	GO:0006397	GO:BP	mRNA processing	16175	2158		0.43636363636363634	0.44642857142857145	352	15823	14	24	338	15799	16175	0.11529527653374906
R1	cpdb	0	network_modules	320	TRUE	3.818495700143548e-11	273	38	13	0.34210526315789475	0.047619047619047616	GO:1903311	GO:BP	regulation of mRNA metabolic process	16175	22895		0.45454545454545453	0.4642857142857143	273	15902	13	25	260	15877	16175	0.12251931803569652
R1	cpdb	0	network_modules	320	TRUE	7.2715024553489e-11	287	38	13	0.34210526315789475	0.04529616724738676	GO:0000377	GO:BP	RNA splicing, via transesterification reactions with bulged adenosine as nucleophile	16175	109		0.4727272727272727	0.5	287	15888	13	25	274	15863	16175	0.11922816742900821
R1	cpdb	0	network_modules	320	TRUE	7.2715024553489e-11	287	38	13	0.34210526315789475	0.04529616724738676	GO:0000398	GO:BP	mRNA splicing, via spliceosome	16175	121		0.4727272727272727	0.5	287	15888	13	25	274	15863	16175	0.11922816742900821
R1	cpdb	0	network_modules	320	TRUE	1.9671729298847166e-10	397	38	14	0.3684210526315789	0.03526448362720403	GO:0008380	GO:BP	RNA splicing	16175	3186		0.509090909090909	0.5178571428571429	397	15778	14	24	383	15754	16175	0.10784663332884793
R1	cpdb	0	network_modules	320	TRUE	2.206871586536065e-10	13	32	6	0.1875	0.46153846153846156	REAC:R-HSA-9768759	REAC	Regulation of NPAS4 gene expression	10916	1994		0.18421052631578946	0.20512820512820512	13	10903	6	26	7	10877	10916	0.2929096004076661
R1	cpdb	0	network_modules	320	TRUE	5.937753078557557e-10	174	23	10	0.43478260869565216	0.05747126436781609	KEGG:03040	KEGG	Spliceosome	8484	215		0.5	0.6666666666666666	174	8310	10	13	164	8297	8484	0.1523932245616263
R1	cpdb	0	network_modules	320	TRUE	9.733584224427818e-10	57	38	8	0.21052631578947367	0.14035087719298245	GO:0000288	GO:BP	nuclear-transcribed mRNA catabolic process, deadenylation-dependent decay	16175	81		0.5272727272727272	0.5357142857142857	57	16118	8	30	49	16088	16175	0.16951454935803778
R1	cpdb	0	network_modules	320	TRUE	1.102563960667104e-9	7	32	5	0.15625	0.7142857142857143	REAC:R-HSA-426496	REAC	Post-transcriptional silencing by small RNAs	10916	1774		0.21052631578947367	0.23076923076923078	7	10909	5	27	2	10882	10916	0.3333010972356932
R1	cpdb	0	network_modules	320	TRUE	1.3252316513121153e-9	16	38	6	0.15789473684210525	0.375	GO:0031054	GO:BP	pre-miRNA processing	16175	7016		0.5454545454545454	0.5535714285714286	16	16159	6	32	10	16127	16175	0.24221206846938567
R1	cpdb	0	network_modules	320	TRUE	1.5786534695668618e-9	17	32	6	0.1875	0.35294117647058826	REAC:R-HSA-8934593	REAC	Regulation of RUNX1 Expression and Activity	10916	2004		0.23684210526315788	0.2564102564102564	17	10899	6	26	11	10873	10916	0.2556851384838674
R1	cpdb	0	network_modules	320	TRUE	4.673250454544172e-9	110	38	9	0.23684210526315788	0.08181818181818182	GO:0017148	GO:BP	negative regulation of translation	16175	5285		0.5636363636363636	0.5714285714285714	110	16065	9	29	101	16036	16175	0.13582951403959123
R1	cpdb	0	network_modules	320	TRUE	1.0321707543627985e-8	9	38	5	0.13157894736842105	0.5555555555555556	GO:0010501	GO:BP	RNA secondary structure unwinding	16175	4180		0.5818181818181818	0.5892857142857143	9	16166	5	33	4	16133	16175	0.269617537535014
R1	cpdb	0	network_modules	320	TRUE	1.2719470187966998e-8	23	32	6	0.1875	0.2608695652173913	REAC:R-HSA-203927	REAC	MicroRNA (miRNA) biogenesis	10916	1449		0.2631578947368421	0.28205128205128205	23	10893	6	26	17	10867	10916	0.21922996500944902
R1	cpdb	0	network_modules	320	TRUE	2.0608306636976724e-8	10	38	5	0.13157894736842105	0.5	GO:0000290	GO:BP	deadenylation-dependent decapping of nuclear-transcribed mRNA	16175	83		0.6	0.6071428571428571	10	16165	5	33	5	16132	16175	0.255668870279621
R1	cpdb	0	network_modules	320	TRUE	3.6993667692354113e-8	27	32	6	0.1875	0.2222222222222222	REAC:R-HSA-9759475	REAC	Regulation of CDH11 Expression and Function	10916	1966		0.2894736842105263	0.3076923076923077	27	10889	6	26	21	10863	10916	0.20197725168019998
R1	cpdb	0	network_modules	320	TRUE	5.763070071088495e-8	202	32	10	0.3125	0.04950495049504951	REAC:R-HSA-72163	REAC	mRNA Splicing - Major Pathway	10916	2707		0.3157894736842105	0.3333333333333333	202	10714	10	22	192	10692	10916	0.11828584228801468
R1	cpdb	0	network_modules	320	TRUE	6.041638867547265e-8	290	38	11	0.2894736842105263	0.03793103448275862	GO:0006417	GO:BP	regulation of translation	16175	2174		0.6181818181818182	0.625	290	15885	11	27	279	15858	16175	0.09930555450233201
R1	cpdb	0	network_modules	320	TRUE	7.375247897978717e-8	30	32	6	0.1875	0.2	REAC:R-HSA-9022692	REAC	Regulation of MECP2 expression and activity	10916	1983		0.34210526315789475	0.41025641025641024	30	10886	6	26	24	10860	10916	0.19135419865688197
R1	cpdb	0	network_modules	320	TRUE	7.375247897978717e-8	30	32	6	0.1875	0.2	REAC:R-HSA-9759476	REAC	Regulation of Homotypic Cell-Cell Adhesion	10916	1978		0.34210526315789475	0.41025641025641024	30	10886	6	26	24	10860	10916	0.19135419865688197
R1	cpdb	0	network_modules	320	TRUE	7.375247897978717e-8	30	32	6	0.1875	0.2	REAC:R-HSA-9764260	REAC	Regulation of Expression and Function of Type II Classical Cadherins	10916	1972		0.34210526315789475	0.41025641025641024	30	10886	6	26	24	10860	10916	0.19135419865688197
R1	cpdb	0	network_modules	320	TRUE	8.059194325702884e-8	209	32	10	0.3125	0.04784688995215311	REAC:R-HSA-72172	REAC	mRNA Splicing	10916	2706		0.42105263157894735	0.4358974358974359	209	10707	10	22	199	10685	10916	0.11607238615672007
R1	cpdb	0	network_modules	320	TRUE	1.3672833440767865e-7	33	32	6	0.1875	0.18181818181818182	REAC:R-HSA-9634815	REAC	Transcriptional Regulation by NPAS4	10916	2545		0.4473684210526316	0.46153846153846156	33	10883	6	26	27	10857	10916	0.18220277684289973
R1	cpdb	0	network_modules	320	TRUE	2.3898124284765477e-7	36	32	6	0.1875	0.16666666666666666	REAC:R-HSA-9029569	REAC	NR1H3 & NR1H2 regulate gene expression linked to cholesterol transport and efflux	10916	1547		0.47368421052631576	0.48717948717948717	36	10880	6	26	30	10854	10916	0.17421000848916993
R1	cpdb	0	network_modules	320	TRUE	3.7794137838409654e-7	566	38	13	0.34210526315789475	0.022968197879858657	GO:0006412	GO:BP	translation	16175	2170		0.6363636363636364	0.6428571428571429	566	15609	13	25	553	15584	16175	0.08110117009708605
R1	cpdb	0	network_modules	320	TRUE	5.864418277550227e-7	6	38	4	0.10526315789473684	0.6666666666666666	GO:0031087	GO:BP	deadenylation-independent decapping of nuclear-transcribed mRNA	16175	7023		0.6545454545454545	0.6607142857142857	6	16169	4	34	2	16135	16175	0.26433260699971134
R1	cpdb	0	network_modules	320	TRUE	6.098349040877417e-7	40	38	6	0.15789473684210525	0.15	GO:0035196	GO:BP	miRNA processing	16175	8885		0.6727272727272727	0.6785714285714286	40	16135	6	32	34	16103	16175	0.15185255354937816
R1	cpdb	0	network_modules	320	TRUE	9.810995970392464e-7	45	32	6	0.1875	0.13333333333333333	REAC:R-HSA-9024446	REAC	NR1H2 and NR1H3-mediated signaling	10916	1546		0.5	0.5128205128205128	45	10871	6	26	39	10845	10916	0.15518493370533834
R1	cpdb	0	network_modules	320	TRUE	1.2105304231424843e-6	276	32	10	0.3125	0.036231884057971016	REAC:R-HSA-72203	REAC	Processing of Capped Intron-Containing Pre-mRNA	10916	1796		0.5263157894736842	0.5384615384615384	276	10640	10	22	266	10618	10916	0.09920362548275624
R1	cpdb	0	network_modules	320	TRUE	1.3660627301981316e-6	7	38	4	0.10526315789473684	0.5714285714285714	GO:0031086	GO:BP	nuclear-transcribed mRNA catabolic process, deadenylation-independent decay	16175	7022		0.6909090909090909	0.6964285714285714	7	16168	4	34	3	16134	16175	0.2445877628243145
R1	cpdb	0	network_modules	320	TRUE	3.4211133969749964e-6	55	32	6	0.1875	0.10909090909090909	REAC:R-HSA-418990	REAC	Adherens junctions interactions	10916	121		0.5526315789473685	0.5641025641025641	55	10861	6	26	49	10835	10916	0.1397331009005314
R1	cpdb	0	network_modules	320	TRUE	5.273903512627393e-6	59	32	6	0.1875	0.1016949152542373	REAC:R-HSA-4086398	REAC	Ca2+ pathway	10916	296		0.5789473684210527	0.6153846153846154	59	10857	6	26	53	10831	10916	0.1346671161645769
R1	cpdb	0	network_modules	320	TRUE	5.273903512627393e-6	59	32	6	0.1875	0.1016949152542373	REAC:R-HSA-8986944	REAC	Transcriptional Regulation by MECP2	10916	2544		0.5789473684210527	0.6153846153846154	59	10857	6	26	53	10831	10916	0.1346671161645769
R1	cpdb	0	network_modules	320	TRUE	6.8188968974432965e-6	343	38	10	0.2631578947368421	0.029154518950437316	GO:0140694	GO:BP	membraneless organelle assembly	16175	19860		0.7090909090909091	0.7142857142857143	343	15832	10	28	333	15804	16175	0.08149661065093618
R1	cpdb	0	network_modules	320	TRUE	1.0271178469784231e-5	178	38	8	0.21052631578947367	0.0449438202247191	GO:0022618	GO:BP	protein-RNA complex assembly	16175	6625		0.7272727272727273	0.7321428571428571	178	15997	8	30	170	15967	16175	0.09280801957655695
R1	cpdb	0	network_modules	320	TRUE	1.1609340491574772e-5	477	38	11	0.2894736842105263	0.023060796645702306	GO:0009896	GO:BP	positive regulation of catabolic process	16175	3756		0.7454545454545455	0.75	477	15698	11	27	466	15671	16175	0.07457435529686743
R1	cpdb	0	network_modules	320	TRUE	1.180953018212271e-5	33	32	5	0.15625	0.15151515151515152	REAC:R-HSA-2559585	REAC	Oncogene Induced Senescence	10916	1640		0.631578947368421	0.6410256410256411	33	10883	5	27	28	10856	10916	0.15133801098292002
R1	cpdb	0	network_modules	320	TRUE	1.2577351021450066e-5	65	38	6	0.15789473684210525	0.09230769230769231	GO:0070918	GO:BP	regulatory ncRNA processing	16175	16370		0.7636363636363637	0.7678571428571429	65	16110	6	32	59	16078	16175	0.11802979785867003
R1	cpdb	0	network_modules	320	TRUE	1.5777812517219777e-5	188	38	8	0.21052631578947367	0.0425531914893617	GO:0071826	GO:BP	protein-RNA complex organization	16175	16929		0.7818181818181819	0.7857142857142857	188	15987	8	30	180	15957	16175	0.09005432439634167
R1	cpdb	0	network_modules	320	TRUE	2.8296069545382323e-5	39	32	5	0.15625	0.1282051282051282	REAC:R-HSA-8853884	REAC	Transcriptional Regulation by VENTX	10916	2547		0.6578947368421053	0.6666666666666666	39	10877	5	27	34	10850	10916	0.13874960229142197
R1	cpdb	0	network_modules	320	TRUE	3.159998435098792e-5	134	32	7	0.21875	0.05223880597014925	REAC:R-HSA-211000	REAC	Gene Silencing by RNA	10916	1041		0.6842105263157895	0.6923076923076923	134	10782	7	25	127	10757	10916	0.10167366671929347
R1	cpdb	0	network_modules	320	TRUE	4.520142165594229e-5	84	32	6	0.1875	0.07142857142857142	REAC:R-HSA-5628897	REAC	TP53 Regulates Metabolic Genes	10916	2452		0.7105263157894737	0.717948717948718	84	10832	6	26	78	10806	10916	0.11157110643469123
R1	cpdb	0	network_modules	320	TRUE	5.581035611023862e-5	87	32	6	0.1875	0.06896551724137931	REAC:R-HSA-421270	REAC	Cell-cell junction organization	10916	329		0.7368421052631579	0.7435897435897436	87	10829	6	26	81	10803	10916	0.10947818595171628
R1	cpdb	0	network_modules	320	TRUE	6.396083822716122e-5	89	32	6	0.1875	0.06741573033707865	REAC:R-HSA-5687128	REAC	MAPK6/MAPK4 signaling	10916	1353		0.7631578947368421	0.7692307692307693	89	10827	6	26	83	10801	10916	0.10814062706091901
R1	cpdb	0	network_modules	320	TRUE	7.800400531985477e-5	92	32	6	0.1875	0.06521739130434782	REAC:R-HSA-1912408	REAC	Pre-NOTCH Transcription and Translation	10916	1786		0.7894736842105263	0.7948717948717948	92	10824	6	26	86	10798	10916	0.10621458068667142
R1	cpdb	0	network_modules	320	TRUE	2.0256732123113275e-4	108	32	6	0.1875	0.05555555555555555	REAC:R-HSA-1912422	REAC	Pre-NOTCH Expression and Processing	10916	1783		0.8157894736842105	0.8205128205128205	108	10808	6	26	102	10782	10916	0.09730115324020651
R1	cpdb	0	network_modules	320	TRUE	2.788631377047729e-4	114	32	6	0.1875	0.05263157894736842	REAC:R-HSA-446728	REAC	Cell junction organization	10916	324		0.8421052631578947	0.8461538461538461	114	10802	6	26	108	10776	10916	0.09443911147866493
R1	cpdb	0	network_modules	320	TRUE	3.3409581859477537e-4	390	38	9	0.23684210526315788	0.023076923076923078	GO:0022613	GO:BP	ribonucleoprotein complex biogenesis	16175	6620		0.8	0.8035714285714286	390	15785	9	29	381	15756	16175	0.06729774475108719
R1	cpdb	0	network_modules	320	TRUE	5.651397961705433e-4	26	38	4	0.10526315789473684	0.15384615384615385	GO:1900151	GO:BP	regulation of nuclear-transcribed mRNA catabolic process, deadenylation-dependent decay	16175	20435		0.8181818181818182	0.8214285714285714	26	16149	4	34	22	16115	16175	0.12556209384511519
R1	cpdb	0	network_modules	320	TRUE	6.623095505450379e-4	27	38	4	0.10526315789473684	0.14814814814814814	GO:0060966	GO:BP	regulation of gene silencing by regulatory ncRNA	16175	15095		0.8363636363636363	0.8392857142857143	27	16148	4	34	23	16114	16175	0.12314525513013563
R1	cpdb	0	network_modules	320	TRUE	8.552069753006165e-4	138	32	6	0.1875	0.043478260869565216	REAC:R-HSA-6807070	REAC	PTEN Regulation	10916	1703		0.868421052631579	0.8717948717948718	138	10778	6	26	132	10752	10916	0.0848635391909708
R1	cpdb	0	network_modules	320	TRUE	0.0010068214734378776	8	38	3	0.07894736842105263	0.375	GO:0030422	GO:BP	siRNA processing	16175	6799		0.8545454545454545	0.8571428571428571	8	16167	3	35	5	16132	16175	0.17122741569813588
R1	cpdb	0	network_modules	320	TRUE	0.0010520738743805928	143	32	6	0.1875	0.04195804195804196	REAC:R-HSA-3858494	REAC	Beta-catenin independent WNT signaling	10916	216		0.8947368421052632	0.8974358974358975	143	10773	6	26	137	10747	10916	0.08316762321685182
R1	cpdb	0	network_modules	320	TRUE	0.001187219783591593	595	38	10	0.2631578947368421	0.01680672268907563	GO:0051248	GO:BP	negative regulation of protein metabolic process	16175	13595		0.8727272727272727	0.875	595	15580	10	28	585	15552	16175	0.058358832052197725
R1	cpdb	0	network_modules	320	TRUE	0.001234912022857389	147	32	6	0.1875	0.04081632653061224	REAC:R-HSA-9018519	REAC	Estrogen-dependent gene expression	10916	866		0.9210526315789473	0.9230769230769231	147	10769	6	26	141	10743	10916	0.08187113665315958
R1	cpdb	0	network_modules	320	TRUE	0.0013883874107100147	150	32	6	0.1875	0.04	REAC:R-HSA-1500931	REAC	Cell-Cell communication	10916	328		0.9473684210526315	0.9487179487179487	150	10766	6	26	144	10740	10916	0.08093157608925601
R1	cpdb	0	network_modules	320	TRUE	0.002536347180294578	95	32	5	0.15625	0.05263157894736842	REAC:R-HSA-8936459	REAC	RUNX1 regulates genes involved in megakaryocyte differentiation and platelet function	10916	1919		0.9736842105263158	0.9743589743589743	95	10821	5	27	90	10794	10916	0.08613499985810415
R1	cpdb	0	network_modules	320	TRUE	0.005100401817253113	13	38	3	0.07894736842105263	0.23076923076923078	GO:0060213	GO:BP	positive regulation of nuclear-transcribed mRNA poly(A) tail shortening	16175	14437		0.8909090909090909	0.8928571428571429	13	16162	3	35	10	16127	16175	0.1338132761058742
R1	cpdb	0	network_modules	320	TRUE	0.006480890017208707	14	38	3	0.07894736842105263	0.21428571428571427	GO:2000637	GO:BP	positive regulation of miRNA-mediated gene silencing	16175	25919		0.9090909090909091	0.9464285714285714	14	16161	3	35	11	16126	16175	0.1288476693809798
R1	cpdb	0	network_modules	320	TRUE	0.006480890017208707	14	38	3	0.07894736842105263	0.21428571428571427	GO:1900370	GO:BP	positive regulation of post-transcriptional gene silencing by RNA	16175	20621		0.9090909090909091	0.9464285714285714	14	16161	3	35	11	16126	16175	0.1288476693809798
R1	cpdb	0	network_modules	320	TRUE	0.006480890017208707	14	38	3	0.07894736842105263	0.21428571428571427	GO:0060148	GO:BP	positive regulation of post-transcriptional gene silencing	16175	14389		0.9090909090909091	0.9464285714285714	14	16161	3	35	11	16126	16175	0.1288476693809798
R1	cpdb	0	network_modules	320	TRUE	0.007429088058733668	96	23	4	0.17391304347826086	0.041666666666666664	KEGG:03015	KEGG	mRNA surveillance pathway	8484	210		1	1	96	8388	4	19	92	8369	8484	0.08014992197517544
R1	cpdb	0	network_modules	320	TRUE	0.008087971561124991	15	38	3	0.07894736842105263	0.2	GO:1900153	GO:BP	positive regulation of nuclear-transcribed mRNA catabolic process, deadenylation-dependent decay	16175	20437		0.9636363636363636	0.9821428571428571	15	16160	3	35	12	16125	16175	0.1243839630022159
R1	cpdb	0	network_modules	320	TRUE	0.008087971561124991	15	38	3	0.07894736842105263	0.2	GO:0060211	GO:BP	regulation of nuclear-transcribed mRNA poly(A) tail shortening	16175	14435		0.9636363636363636	0.9821428571428571	15	16160	3	35	12	16125	16175	0.1243839630022159
R1	cpdb	0	network_modules	320	TRUE	0.008142910417612755	2	38	2	0.05263157894736842	1	GO:0035279	GO:BP	miRNA-mediated gene silencing by mRNA destabilization	16175	8939		1	1	2	16173	2	36	0	16137	16175	0.22916025970014609
R1	cpdb	0	network_modules	320	TRUE	0.008581260989676215	122	32	5	0.15625	0.040983606557377046	REAC:R-HSA-2559580	REAC	Oxidative Stress Induced Senescence	10916	1654		1	1	122	10794	5	27	117	10767	10916	0.07482762301075627
R1	cpdb	0	network_modules	321	TRUE	0.0013068808799208405	43	9	3	0.3333333333333333	0.06976744186046512	REAC:R-HSA-1296072	REAC	Voltage gated Potassium channels	10916	2663		NA	1	43	10873	3	6	40	10867	10916	0.15105638958259368
R1	cpdb	0	network_modules	322	TRUE	1.4944684026925835e-9	155	21	9	0.42857142857142855	0.05806451612903226	REAC:R-HSA-9013148	REAC	CDC42 GTPase cycle	10916	269		0	0.3333333333333333	155	10761	9	12	146	10749	10916	0.15376513936845315
R1	cpdb	0	network_modules	322	TRUE	3.886359093330794e-8	449	21	11	0.5238095238095238	0.024498886414253896	REAC:R-HSA-9012999	REAC	RHO GTPase cycle	10916	1847		0.5	0.6666666666666666	449	10467	11	10	438	10457	10916	0.10670434298319267
R1	cpdb	0	network_modules	322	TRUE	1.0397299913141004e-5	184	21	7	0.3333333333333333	0.03804347826086957	REAC:R-HSA-9013149	REAC	RAC1 GTPase cycle	10916	1836		1	1	184	10732	7	14	177	10718	10916	0.10793267386437633
R1	cpdb	0	network_modules	322	TRUE	3.12265252131469e-5	61	23	5	0.21739130434782608	0.08196721311475409	GO:0046847	GO:BP	filopodium assembly	16175	12400		0	0.25	61	16114	5	18	56	16096	16175	0.1315135419748673
R1	cpdb	0	network_modules	322	TRUE	4.990849486326214e-4	248	18	6	0.3333333333333333	0.024193548387096774	KEGG:04144	KEGG	Endocytosis	8484	280		0	0.5	248	8236	6	12	242	8224	8484	0.08324014289187805
R1	cpdb	0	network_modules	322	TRUE	0.0011743009412384807	389	23	7	0.30434782608695654	0.017994858611825194	GO:0007264	GO:BP	small GTPase-mediated signal transduction	16175	2792		0.3333333333333333	0.5	389	15786	7	16	382	15770	16175	0.069040634206636
R1	cpdb	0	network_modules	322	TRUE	0.0013027580373003507	242	23	6	0.2608695652173913	0.024793388429752067	GO:0051056	GO:BP	regulation of small GTPase mediated signal transduction	16175	13466		0.6666666666666666	0.75	242	15933	6	17	236	15916	16175	0.07643840445478224
R1	cpdb	0	network_modules	322	TRUE	0.005200004480056074	227	18	5	0.2777777777777778	0.022026431718061675	KEGG:04810	KEGG	Regulation of actin cytoskeleton	8484	365		1	1	227	8257	5	13	222	8244	8484	0.07172733300166909
R1	cpdb	0	network_modules	322	TRUE	0.0053594799783599255	708	23	8	0.34782608695652173	0.011299435028248588	GO:0030029	GO:BP	actin filament-based process	16175	6653		1	1	708	15467	8	15	700	15452	16175	0.05608249117128287
R1	cpdb	0	network_modules	323	TRUE	1.274478075502062e-7	200	18	8	0.4444444444444444	0.04	REAC:R-HSA-5617833	REAC	Cilium Assembly	10916	361		0	0.07142857142857142	200	10716	8	10	192	10706	10916	0.12913076168971618
R1	cpdb	0	network_modules	323	TRUE	3.267267294801128e-7	586	24	11	0.4583333333333333	0.01877133105802048	GO:0000226	GO:BP	microtubule cytoskeleton organization	16175	61		0	0.1111111111111111	586	15589	11	13	575	15576	16175	0.08707877982839807
R1	cpdb	0	network_modules	323	TRUE	8.414012269299446e-7	129	24	7	0.2916666666666667	0.05426356589147287	GO:0007098	GO:BP	centrosome cycle	16175	2681		0.125	0.2222222222222222	129	16046	7	17	122	16029	16175	0.12294705127987891
R1	cpdb	0	network_modules	323	TRUE	2.009166542753669e-6	146	24	7	0.2916666666666667	0.04794520547945205	GO:0031023	GO:BP	microtubule organizing center organization	16175	6997		0.25	0.3333333333333333	146	16029	7	17	139	16012	16175	0.11520061175724533
R1	cpdb	0	network_modules	323	TRUE	2.0787889873844054e-6	96	18	6	0.3333333333333333	0.0625	REAC:R-HSA-5620912	REAC	Anchoring of the basal body to the plasma membrane	10916	147		0.07692307692307693	0.14285714285714285	96	10820	6	12	90	10808	10916	0.14126803194073287
R1	cpdb	0	network_modules	323	TRUE	2.5502671507626236e-6	292	18	8	0.4444444444444444	0.0273972602739726	REAC:R-HSA-1852241	REAC	Organelle biogenesis and maintenance	10916	1646		0.15384615384615385	0.21428571428571427	292	10624	8	10	284	10614	10916	0.10520827640262809
R1	cpdb	0	network_modules	323	TRUE	2.0063847404640457e-5	68	18	5	0.2777777777777778	0.07352941176470588	REAC:R-HSA-380284	REAC	Loss of proteins required for interphase microtubule organization from the centrosome	10916	1335		0.23076923076923078	0.35714285714285715	68	10848	5	13	63	10835	10916	0.14026338478626266
R1	cpdb	0	network_modules	323	TRUE	2.0063847404640457e-5	68	18	5	0.2777777777777778	0.07352941176470588	REAC:R-HSA-380259	REAC	Loss of Nlp from mitotic centrosomes	10916	1331		0.23076923076923078	0.35714285714285715	68	10848	5	13	63	10835	10916	0.14026338478626266
R1	cpdb	0	network_modules	323	TRUE	2.4985269256275505e-5	71	18	5	0.2777777777777778	0.07042253521126761	REAC:R-HSA-8854518	REAC	AURKA Activation by TPX2	10916	41		0.38461538461538464	0.42857142857142855	71	10845	5	13	66	10832	10916	0.13714813241783394
R1	cpdb	0	network_modules	323	TRUE	4.5720870458424764e-5	80	18	5	0.2777777777777778	0.0625	REAC:R-HSA-380270	REAC	Recruitment of mitotic centrosome proteins and complexes	10916	1951		0.46153846153846156	0.5714285714285714	80	10836	5	13	75	10823	10916	0.12886423622955964
R1	cpdb	0	network_modules	323	TRUE	4.5720870458424764e-5	80	18	5	0.2777777777777778	0.0625	REAC:R-HSA-380287	REAC	Centrosome maturation	10916	341		0.46153846153846156	0.5714285714285714	80	10836	5	13	75	10823	10916	0.12886423622955964
R1	cpdb	0	network_modules	323	TRUE	6.207379212331659e-5	85	18	5	0.2777777777777778	0.058823529411764705	REAC:R-HSA-2565942	REAC	Regulation of PLK1 Activity at G2/M Transition	10916	1998		0.6153846153846154	0.6428571428571429	85	10831	5	13	80	10818	10916	0.12483374316838951
R1	cpdb	0	network_modules	323	TRUE	8.789881571425708e-5	71	24	5	0.20833333333333334	0.07042253521126761	GO:0051298	GO:BP	centrosome duplication	16175	13629		0.375	0.4444444444444444	71	16104	5	19	66	16085	16175	0.11892269588884824
R1	cpdb	0	network_modules	323	TRUE	1.0294768362500592e-4	94	18	5	0.2777777777777778	0.05319148936170213	REAC:R-HSA-380320	REAC	Recruitment of NuMA to mitotic centrosomes	10916	1950		0.6923076923076923	0.7142857142857143	94	10822	5	13	89	10809	10916	0.11839402850329152
R1	cpdb	0	network_modules	323	TRUE	2.6334652989186614e-4	175	24	6	0.25	0.03428571428571429	GO:0000910	GO:BP	cytokinesis	16175	243		0.5	0.5555555555555556	175	16000	6	18	169	15982	16175	0.08912459369454138
R1	cpdb	0	network_modules	323	TRUE	6.277572331977316e-4	42	24	4	0.16666666666666666	0.09523809523809523	GO:0007099	GO:BP	centriole replication	16175	2682		0.625	0.6666666666666666	42	16133	4	20	38	16113	16175	0.12427888405333369
R1	cpdb	0	network_modules	323	TRUE	9.95415566087303e-4	47	24	4	0.16666666666666666	0.0851063829787234	GO:0098534	GO:BP	centriole assembly	16175	18792		0.75	0.7777777777777778	47	16128	4	20	43	16108	16175	0.11727929832485437
R1	cpdb	0	network_modules	323	TRUE	0.0011543295465079114	368	24	7	0.2916666666666667	0.019021739130434784	GO:0044782	GO:BP	cilium organization	16175	11155		0.875	0.8888888888888888	368	15807	7	17	361	15790	16175	0.06952122450706821
R1	cpdb	0	network_modules	323	TRUE	0.0014290049868812482	98	6	3	0.5	0.030612244897959183	KEGG:04750	KEGG	Inflammatory mediator regulation of TRP channels	8484	364		0	0.5	98	8386	3	3	95	8383	8484	0.12160689477519372
R1	cpdb	0	network_modules	323	TRUE	0.002999558676532561	265	24	6	0.25	0.022641509433962263	GO:0051301	GO:BP	cell division	16175	13632		1	1	265	15910	6	18	259	15892	16175	0.07094079411574442
R1	cpdb	0	network_modules	323	TRUE	0.003782574309559167	195	18	5	0.2777777777777778	0.02564102564102564	REAC:R-HSA-69275	REAC	G2/M Transition	10916	1008		0.7692307692307693	0.7857142857142857	195	10721	5	13	190	10708	10916	0.07974826619238193
R1	cpdb	0	network_modules	323	TRUE	0.0039746982992203165	197	18	5	0.2777777777777778	0.025380710659898477	REAC:R-HSA-453274	REAC	Mitotic G2-G2/M phases	10916	1481		0.8461538461538461	0.8571428571428571	197	10719	5	13	192	10706	10916	0.07929388678902319
R1	cpdb	0	network_modules	323	TRUE	0.004174383169339849	199	18	5	0.2777777777777778	0.02512562814070352	REAC:R-HSA-68877	REAC	Mitotic Prometaphase	10916	1484		0.9230769230769231	0.9285714285714286	199	10717	5	13	194	10704	10916	0.07884612182547963
R1	cpdb	0	network_modules	323	TRUE	0.00574109133235656	156	6	3	0.5	0.019230769230769232	KEGG:04148	KEGG	Efferocytosis	8484	283		1	1	156	8328	3	3	153	8325	8484	0.09536623206814952
R1	cpdb	0	network_modules	323	TRUE	0.007903423199387085	5	18	2	0.1111111111111111	0.4	REAC:R-HSA-5624138	REAC	Trafficking of myristoylated proteins to the cilium	10916	2534		1	1	5	10911	2	16	3	10895	10916	0.21017088694923294
R1	cpdb	0	network_modules	324	TRUE	6.944735513008754e-9	774	23	13	0.5652173913043478	0.016795865633074936	GO:0007186	GO:BP	G protein-coupled receptor signaling pathway	16175	2744		0	0.06666666666666667	774	15401	13	10	761	15391	16175	0.09146349735546845
R1	cpdb	0	network_modules	324	TRUE	1.2412717868777942e-8	365	21	11	0.5238095238095238	0.030136986301369864	KEGG:04080	KEGG	Neuroactive ligand-receptor interaction	8484	263		0	0.5	365	8119	11	10	354	8109	8484	0.11803300917342173
R1	cpdb	0	network_modules	324	TRUE	1.7071027262988203e-7	55	23	6	0.2608695652173913	0.10909090909090909	GO:0051966	GO:BP	regulation of synaptic transmission, glutamatergic	16175	14035		0.07142857142857142	0.13333333333333333	55	16120	6	17	49	16103	16175	0.1669000893259207
R1	cpdb	0	network_modules	324	TRUE	3.3520077280289563e-7	460	19	10	0.5263157894736842	0.021739130434782608	REAC:R-HSA-500792	REAC	GPCR ligand binding	10916	1019		0	0.16666666666666666	460	10456	10	9	450	10447	10916	0.10063017732635017
R1	cpdb	0	network_modules	324	TRUE	1.2631770166956047e-6	76	23	6	0.2608695652173913	0.07894736842105263	GO:0035249	GO:BP	synaptic transmission, glutamatergic	16175	8924		0.14285714285714285	0.2	76	16099	6	17	70	16082	16175	0.14135744847876244
R1	cpdb	0	network_modules	324	TRUE	3.336337716946882e-6	13	23	4	0.17391304347826086	0.3076923076923077	GO:0007216	GO:BP	G protein-coupled glutamate receptor signaling pathway	16175	2770		0.21428571428571427	0.26666666666666666	13	16162	4	19	9	16143	16175	0.2305134722841177
R1	cpdb	0	network_modules	324	TRUE	3.805165595151127e-6	3	23	3	0.13043478260869565	1	GO:0007206	GO:BP	phospholipase C-activating G protein-coupled glutamate receptor signaling pathway	16175	2760		0.2857142857142857	0.3333333333333333	3	16172	3	20	0	16152	16175	0.3609341674135441
R1	cpdb	0	network_modules	324	TRUE	4.007304091007556e-6	41	23	5	0.21739130434782608	0.12195121951219512	GO:0007215	GO:BP	glutamate receptor signaling pathway	16175	2769		0.35714285714285715	0.4	41	16134	5	18	36	16116	16175	0.16124291990109252
R1	cpdb	0	network_modules	324	TRUE	5.260483327746652e-6	96	23	6	0.2608695652173913	0.0625	GO:0007200	GO:BP	phospholipase C-activating G protein-coupled receptor signaling pathway	16175	2758		0.42857142857142855	0.4666666666666667	96	16079	6	17	90	16062	16175	0.12524445249419333
R1	cpdb	0	network_modules	324	TRUE	1.0378994929348394e-5	56	19	5	0.2631578947368421	0.08928571428571429	REAC:R-HSA-6794361	REAC	Neurexins and neuroligins	10916	1587		0.2	0.3333333333333333	56	10860	5	14	51	10846	10916	0.1508149668613228
R1	cpdb	0	network_modules	324	TRUE	1.1006839252517421e-5	328	19	8	0.42105263157894735	0.024390243902439025	REAC:R-HSA-373076	REAC	Class A/1 (Rhodopsin-like receptors)	10916	365		0.4	0.5	328	10588	8	11	320	10577	10916	0.09563685134555862
R1	cpdb	0	network_modules	324	TRUE	1.60960169003381e-5	115	21	6	0.2857142857142857	0.05217391304347826	KEGG:04724	KEGG	Glutamatergic synapse	8484	354		1	1	115	8369	6	15	109	8354	8484	0.11724267149889096
R1	cpdb	0	network_modules	324	TRUE	8.037538358470317e-5	262	23	7	0.30434782608695654	0.026717557251908396	GO:0050804	GO:BP	modulation of chemical synaptic transmission	16175	13270		0.5	0.5333333333333333	262	15913	7	16	255	15897	16175	0.08613645339864073
R1	cpdb	0	network_modules	324	TRUE	8.250089606133586e-5	263	23	7	0.30434782608695654	0.026615969581749048	GO:0099177	GO:BP	regulation of trans-synaptic signaling	16175	19085		0.5714285714285714	0.6	263	15912	7	16	256	15896	16175	0.08595679502807918
R1	cpdb	0	network_modules	324	TRUE	9.16300610044234e-5	86	19	5	0.2631578947368421	0.05813953488372093	REAC:R-HSA-6794362	REAC	Protein-protein interactions at synapses	10916	1819		0.6	0.6666666666666666	86	10830	5	14	81	10816	10916	0.12057004568011859
R1	cpdb	0	network_modules	324	TRUE	4.157503720516649e-4	40	23	4	0.17391304347826086	0.1	GO:0030534	GO:BP	adult behavior	16175	6837		0.6428571428571429	0.6666666666666666	40	16135	4	19	36	16116	16175	0.1302545681627528
R1	cpdb	0	network_modules	324	TRUE	0.0036328697091528943	19	23	3	0.13043478260869565	0.15789473684210525	GO:0008306	GO:BP	associative learning	16175	3162		0.7142857142857143	0.7333333333333333	19	16156	3	20	16	16136	16175	0.14240194503174
R1	cpdb	0	network_modules	324	TRUE	0.00524900839369854	487	23	7	0.30434782608695654	0.014373716632443531	GO:0098916	GO:BP	anterograde trans-synaptic signaling	16175	18949		0.7857142857142857	0.8666666666666667	487	15688	7	16	480	15672	16175	0.06055876429303704
R1	cpdb	0	network_modules	324	TRUE	0.00524900839369854	487	23	7	0.30434782608695654	0.014373716632443531	GO:0007268	GO:BP	chemical synaptic transmission	16175	2796		0.7857142857142857	0.8666666666666667	487	15688	7	16	480	15672	16175	0.06055876429303704
R1	cpdb	0	network_modules	324	TRUE	0.005615699256516029	492	23	7	0.30434782608695654	0.014227642276422764	GO:0099537	GO:BP	trans-synaptic signaling	16175	19116		0.9285714285714286	0.9333333333333333	492	15683	7	16	485	15667	16175	0.06019194075810616
R1	cpdb	0	network_modules	324	TRUE	0.007688681006482862	516	23	7	0.30434782608695654	0.013565891472868217	GO:0099536	GO:BP	synaptic signaling	16175	19115		1	1	516	15659	7	16	509	15643	16175	0.05850187880754493
R1	cpdb	0	network_modules	324	TRUE	0.007996551996032893	213	19	5	0.2631578947368421	0.023474178403755867	REAC:R-HSA-416476	REAC	G alpha (q) signalling events	10916	988		0.8	0.8333333333333334	213	10703	5	14	208	10689	10916	0.073553313407296525
R1	cpdb	0	network_modules	324	TRUE	0.009112879521845849	5	19	2	0.10526315789473684	0.4	REAC:R-HSA-390651	REAC	Dopamine receptors	10916	783		1	1	5	10911	2	17	3	10894	10916	0.2045276598933455
R1	cpdb	0	network_modules	325	TRUE	1.601042421827997e-6	158	13	6	0.46153846153846156	0.0379746835443038	GO:0140053	GO:BP	mitochondrial gene expression	16175	19653		0	0.25	158	16017	6	7	152	16010	16175	0.13027676333549532
R1	cpdb	0	network_modules	325	TRUE	1.2779665401965637e-4	87	9	4	0.4444444444444444	0.04597701149425287	REAC:R-HSA-5389840	REAC	Mitochondrial translation elongation	10916	1474		0	0.5	87	10829	4	5	83	10824	10916	0.1410058692751121
R1	cpdb	0	network_modules	325	TRUE	1.2779665401965637e-4	87	9	4	0.4444444444444444	0.04597701149425287	REAC:R-HSA-5368286	REAC	Mitochondrial translation initiation	10916	1475		0	0.5	87	10829	4	5	83	10824	10916	0.1410058692751121
R1	cpdb	0	network_modules	325	TRUE	1.2779665401965637e-4	87	9	4	0.4444444444444444	0.04597701149425287	REAC:R-HSA-5419276	REAC	Mitochondrial translation termination	10916	1476		0	0.5	87	10829	4	5	83	10824	10916	0.1410058692751121
R1	cpdb	0	network_modules	325	TRUE	1.6726222495740028e-4	93	9	4	0.4444444444444444	0.043010752688172046	REAC:R-HSA-5368287	REAC	Mitochondrial translation	10916	1473		0.6	0.6666666666666666	93	10823	4	5	89	10818	10916	0.13624746752800906
R1	cpdb	0	network_modules	325	TRUE	2.821914009965001e-4	16	13	3	0.23076923076923078	0.1875	GO:0006390	GO:BP	mitochondrial transcription	16175	2153		0.3333333333333333	0.5	16	16159	3	10	13	16149	16175	0.20730677807359252
R1	cpdb	0	network_modules	325	TRUE	6.456502789063093e-4	153	9	4	0.4444444444444444	0.026143790849673203	KEGG:03010	KEGG	Ribosome	8484	208		NA	1	153	8331	4	5	149	8326	8484	0.10442047559635673
R1	cpdb	0	network_modules	325	TRUE	0.0025135702064138007	6	9	2	0.2222222222222222	0.3333333333333333	REAC:R-HSA-6793080	REAC	rRNA modification in the mitochondrion	10916	2730		0.8	0.8333333333333334	6	10910	2	7	4	10903	10916	0.2716790073116455
R1	cpdb	0	network_modules	325	TRUE	0.003066683006724606	127	13	4	0.3076923076923077	0.031496062992125984	GO:0032543	GO:BP	mitochondrial translation	16175	7635		0.6666666666666666	0.75	127	16048	4	9	123	16039	16175	0.09634887699942779
R1	cpdb	0	network_modules	325	TRUE	0.0057155402409709045	42	13	3	0.23076923076923078	0.07142857142857142	GO:0000959	GO:BP	mitochondrial RNA metabolic process	16175	267		1	1	42	16133	3	10	39	16123	16175	0.127159775498747
R1	cpdb	0	network_modules	325	TRUE	0.007527820621271228	10	9	2	0.2222222222222222	0.2	REAC:R-HSA-8868766	REAC	rRNA processing in the mitochondrion	10916	2733		1	1	10	10906	2	7	8	10899	10916	0.21013230935567795
R1	cpdb	0	network_modules	326	TRUE	1.2465136188574519e-5	71	17	5	0.29411764705882354	0.07042253521126761	KEGG:04622	KEGG	RIG-I-like receptor signaling pathway	8484	327		NA	1	71	8413	5	12	66	8401	8484	0.1405530808942793
R1	cpdb	0	network_modules	326	TRUE	3.7279175096128554e-4	15	16	3	0.1875	0.2	REAC:R-HSA-918233	REAC	TRAF3-dependent IRF activation pathway	10916	2464		0	0.25	15	10901	3	13	12	10888	10916	0.19250331445187688
R1	cpdb	0	network_modules	326	TRUE	0.003282136692844115	30	16	3	0.1875	0.1	REAC:R-HSA-933541	REAC	TRAF6 mediated IRF7 activation	10916	2465		0.3333333333333333	0.5	30	10886	3	13	27	10873	10916	0.1352085064936884
R1	cpdb	0	network_modules	326	TRUE	0.007315714915479864	120	16	4	0.25	0.03333333333333333	REAC:R-HSA-9705671	REAC	SARS-CoV-2 activates/modulates innate and adaptive immune responses	10916	2123		0.6666666666666666	0.75	120	10796	4	12	116	10784	10916	0.08782107734167206
R1	cpdb	0	network_modules	326	TRUE	0.0079159691678501	40	16	3	0.1875	0.075	REAC:R-HSA-9692916	REAC	SARS-CoV-1 activates/modulates innate immune responses	10916	2115		1	1	40	10876	3	13	37	10863	10916	0.11656694615548616
R1	cpdb	0	network_modules	327	TRUE	1.4416569993232393e-4	12	15	3	0.2	0.25	REAC:R-HSA-9673324	REAC	WNT5:FZD7-mediated leishmania damping	10916	2670		0	0.6666666666666666	12	10904	3	12	9	10892	10916	0.22265309968803057
R1	cpdb	0	network_modules	327	TRUE	1.4416569993232393e-4	12	15	3	0.2	0.25	REAC:R-HSA-9664420	REAC	Killing mechanisms	10916	1291		0	0.6666666666666666	12	10904	3	12	9	10892	10916	0.22265309968803057
R1	cpdb	0	network_modules	327	TRUE	0.0013132544853823793	24	15	3	0.2	0.125	REAC:R-HSA-5668599	REAC	RHO GTPases Activate NADPH Oxidases	10916	1849		1	1	24	10892	3	12	21	10880	10916	0.15665558909033828
R1	cpdb	0	network_modules	327	TRUE	0.008832800280071943	33	18	3	0.16666666666666666	0.09090909090909091	GO:0045730	GO:BP	respiratory burst	16175	11572		0	0.5	33	16142	3	15	30	16127	16175	0.12177670909042501
R1	cpdb	0	network_modules	327	TRUE	0.009680847687859267	34	18	3	0.16666666666666666	0.08823529411764706	GO:0042554	GO:BP	superoxide anion generation	16175	10244		1	1	34	16141	3	15	31	16126	16175	0.11993117043636657
R1	cpdb	0	network_modules	328	TRUE	7.456826980842144e-5	67	25	5	0.2	0.07462686567164178	GO:0042982	GO:BP	amyloid precursor protein metabolic process	16175	10466		0	0.5	67	16108	5	20	62	16088	16175	0.11998050957042572
R1	cpdb	0	network_modules	328	TRUE	0.0017638918393886789	53	25	4	0.16	0.07547169811320754	GO:0050435	GO:BP	amyloid-beta metabolic process	16175	13189		1	1	53	16122	4	21	49	16101	16175	0.10789822777369211
R1	cpdb	0	network_modules	329	TRUE	1.593527885772327e-11	117	21	9	0.42857142857142855	0.07692307692307693	GO:0035725	GO:BP	sodium ion transmembrane transport	16175	9195		0	0.02	117	16058	9	12	108	16046	16175	0.17926929652421092
R1	cpdb	0	network_modules	329	TRUE	2.6659349781965053e-10	159	21	9	0.42857142857142855	0.05660377358490566	GO:0006814	GO:BP	sodium ion transport	16175	2494		0.02040816326530612	0.04	159	16016	9	12	150	16004	16175	0.15303270383386647
R1	cpdb	0	network_modules	329	TRUE	3.0870981423997082e-9	4	21	4	0.19047619047619047	1	GO:1903276	GO:BP	regulation of sodium ion export across plasma membrane	16175	22871		0.04081632653061224	0.08	4	16171	4	17	0	16154	16175	0.43620631540383864
R1	cpdb	0	network_modules	329	TRUE	3.0870981423997082e-9	4	21	4	0.19047619047619047	1	GO:1903278	GO:BP	positive regulation of sodium ion export across plasma membrane	16175	22873		0.04081632653061224	0.08	4	16171	4	17	0	16154	16175	0.43620631540383864
R1	cpdb	0	network_modules	329	TRUE	9.665732893247352e-9	15	21	5	0.23809523809523808	0.3333333333333333	GO:0036376	GO:BP	sodium ion export across plasma membrane	16175	9590		0.08163265306122448	0.1	15	16160	5	16	10	16144	16175	0.2809334568488402
R1	cpdb	0	network_modules	329	TRUE	1.3579495601617773e-7	24	21	5	0.23809523809523808	0.20833333333333334	GO:0055075	GO:BP	potassium ion homeostasis	16175	14231		0.10204081632653061	0.12	24	16151	5	16	19	16135	16175	0.2216380680633981
R1	cpdb	0	network_modules	329	TRUE	1.359007180607431e-7	117	21	7	0.3333333333333333	0.05982905982905983	GO:0099587	GO:BP	inorganic ion import across plasma membrane	16175	19152		0.12244897959183673	0.16	117	16058	7	14	110	16044	16175	0.13874775665809888
R1	cpdb	0	network_modules	329	TRUE	1.359007180607431e-7	117	21	7	0.3333333333333333	0.05982905982905983	GO:0098659	GO:BP	inorganic cation import across plasma membrane	16175	18815		0.12244897959183673	0.16	117	16058	7	14	110	16044	16175	0.13874775665809888
R1	cpdb	0	network_modules	329	TRUE	1.5838556111426336e-7	87	14	6	0.42857142857142855	0.06896551724137931	KEGG:04260	KEGG	Cardiac muscle contraction	8484	296		0	0.045454545454545456	87	8397	6	8	81	8389	8484	0.16881328036143894
R1	cpdb	0	network_modules	329	TRUE	7.526463871925167e-7	33	21	5	0.23809523809523808	0.15151515151515152	GO:0055078	GO:BP	sodium ion homeostasis	16175	14232		0.16326530612244897	0.18	33	16142	5	16	28	16126	16175	0.1886216574281695
R1	cpdb	0	network_modules	329	TRUE	1.086669988449093e-6	575	21	10	0.47619047619047616	0.017391304347826087	GO:0098662	GO:BP	inorganic cation transmembrane transport	16175	18818		0.1836734693877551	0.2	575	15600	10	11	565	15589	16175	0.08580317503638933
R1	cpdb	0	network_modules	329	TRUE	1.1239394874831107e-6	577	21	10	0.47619047619047616	0.01733102253032929	GO:0098655	GO:BP	monoatomic cation transmembrane transport	16175	18811		0.20408163265306123	0.22	577	15598	10	11	567	15587	16175	0.0856357946337593
R1	cpdb	0	network_modules	329	TRUE	2.327539216924694e-6	23	14	4	0.2857142857142857	0.17391304347826086	KEGG:04964	KEGG	Proximal tubule bicarbonate reclamation	8484	399		0.047619047619047616	0.09090909090909091	23	8461	4	10	19	8451	8484	0.22127874885205148
R1	cpdb	0	network_modules	329	TRUE	2.6337814541585095e-6	630	21	10	0.47619047619047616	0.015873015873015872	GO:0098660	GO:BP	inorganic ion transmembrane transport	16175	18816		0.22448979591836735	0.24	630	15545	10	11	620	15534	16175	0.08148348889449988
R1	cpdb	0	network_modules	329	TRUE	2.7735861754937867e-6	3	21	3	0.14285714285714285	1	GO:1903288	GO:BP	positive regulation of potassium ion import across plasma membrane	16175	22881		0.24489795918367346	0.26	3	16172	3	18	0	16154	16175	0.3777540706266271
R1	cpdb	0	network_modules	329	TRUE	3.027515324558423e-6	43	21	5	0.23809523809523808	0.11627906976744186	GO:1990573	GO:BP	potassium ion import across plasma membrane	16175	25222		0.2653061224489796	0.28	43	16132	5	16	38	16116	16175	0.16485796560430135
R1	cpdb	0	network_modules	329	TRUE	3.045159304852617e-6	182	21	7	0.3333333333333333	0.038461538461538464	GO:0098739	GO:BP	import across plasma membrane	16175	18866		0.2857142857142857	0.3	182	15993	7	14	175	15979	16175	0.11009786110855449
R1	cpdb	0	network_modules	329	TRUE	3.064292650754466e-6	14	21	4	0.19047619047619047	0.2857142857142857	GO:0030007	GO:BP	intracellular potassium ion homeostasis	16175	6649		0.30612244897959184	0.32	14	16161	4	17	10	16144	16175	0.23247620532266422
R1	cpdb	0	network_modules	329	TRUE	3.1638565458538568e-6	183	21	7	0.3333333333333333	0.03825136612021858	GO:0071805	GO:BP	potassium ion transmembrane transport	16175	16918		0.32653061224489793	0.34	183	15992	7	14	176	15978	16175	0.10977899179594887
R1	cpdb	0	network_modules	329	TRUE	4.840845973159243e-6	671	21	10	0.47619047619047616	0.014903129657228018	GO:0034220	GO:BP	monoatomic ion transmembrane transport	16175	8508		0.3469387755102041	0.36	671	15504	10	11	661	15493	16175	0.07860082352862045
R1	cpdb	0	network_modules	329	TRUE	5.274412541819342e-6	677	21	10	0.47619047619047616	0.014771048744460856	GO:0030001	GO:BP	metal ion transport	16175	6646		0.3673469387755102	0.38	677	15498	10	11	667	15487	16175	0.07820010287232142
R1	cpdb	0	network_modules	329	TRUE	5.47775693230269e-6	198	21	7	0.3333333333333333	0.03535353535353535	GO:0006813	GO:BP	potassium ion transport	16175	2493		0.3877551020408163	0.4	198	15977	7	14	191	15963	16175	0.10528426465848145
R1	cpdb	0	network_modules	329	TRUE	6.172527102153976e-6	54	18	5	0.2777777777777778	0.09259259259259259	REAC:R-HSA-5578775	REAC	Ion homeostasis	10916	1273		0	0.14285714285714285	54	10862	5	13	49	10849	10916	0.15804041864737928
R1	cpdb	0	network_modules	329	TRUE	6.783021835108376e-6	55	18	5	0.2777777777777778	0.09090909090909091	REAC:R-HSA-936837	REAC	Ion transport by P-type ATPases	10916	1275		0.16666666666666666	0.2857142857142857	55	10861	5	13	50	10848	10916	0.1565517227518621
R1	cpdb	0	network_modules	329	TRUE	7.2673607680968075e-6	17	21	4	0.19047619047619047	0.23529411764705882	GO:1902307	GO:BP	positive regulation of sodium ion transmembrane transport	16175	22194		0.40816326530612246	0.42	17	16158	4	17	13	16141	16175	0.21078192033344578
R1	cpdb	0	network_modules	329	TRUE	1.1085083407547973e-5	4	21	3	0.14285714285714285	0.75	GO:1903286	GO:BP	regulation of potassium ion import	16175	22879		0.42857142857142855	0.44	4	16171	3	18	1	16153	16175	0.3270129708505223
R1	cpdb	0	network_modules	329	TRUE	1.1815512631701021e-5	19	21	4	0.19047619047619047	0.21052631578947367	GO:0006883	GO:BP	intracellular sodium ion homeostasis	16175	2539		0.4489795918367347	0.46	19	16156	4	17	15	16139	16175	0.19926192322336936
R1	cpdb	0	network_modules	329	TRUE	1.374913488590074e-5	748	21	10	0.47619047619047616	0.013368983957219251	GO:0006812	GO:BP	monoatomic cation transport	16175	2492		0.46938775510204084	0.48	748	15427	10	11	738	15416	16175	0.07381362710499213
R1	cpdb	0	network_modules	329	TRUE	1.7131725361621925e-5	37	14	4	0.2857142857142857	0.10810810810810811	KEGG:04960	KEGG	Aldosterone-regulated sodium reabsorption	8484	396		0.09523809523809523	0.13636363636363635	37	8447	4	10	33	8437	8484	0.17358916837382968
R1	cpdb	0	network_modules	329	TRUE	1.8434812014258036e-5	61	21	5	0.23809523809523808	0.08196721311475409	GO:0002028	GO:BP	regulation of sodium ion transport	16175	630		0.4897959183673469	0.5	61	16114	5	16	56	16098	16175	0.1378364397423631
R1	cpdb	0	network_modules	329	TRUE	2.1744549124135144e-5	63	21	5	0.23809523809523808	0.07936507936507936	GO:0140115	GO:BP	export across plasma membrane	16175	19670		0.5102040816326531	0.52	63	16112	5	16	58	16096	16175	0.1355677582633078
R1	cpdb	0	network_modules	329	TRUE	4.5305553069393134e-5	26	21	4	0.19047619047619047	0.15384615384615385	GO:0010765	GO:BP	positive regulation of sodium ion transport	16175	4386		0.5306122448979592	0.54	26	16149	4	17	22	16132	16175	0.16998655088032633
R1	cpdb	0	network_modules	329	TRUE	4.583135618433456e-5	47	14	4	0.2857142857142857	0.0851063829787234	KEGG:04973	KEGG	Carbohydrate digestion and absorption	8484	404		0.14285714285714285	0.18181818181818182	47	8437	4	10	43	8427	8484	0.15346471630333697
R1	cpdb	0	network_modules	329	TRUE	7.481612590170515e-5	53	14	4	0.2857142857142857	0.07547169811320754	KEGG:04961	KEGG	Endocrine and other factor-regulated calcium reabsorption	8484	397		0.19047619047619047	0.22727272727272727	53	8431	4	10	49	8421	8484	0.14420369451533407
R1	cpdb	0	network_modules	329	TRUE	1.2376670651916656e-4	60	14	4	0.2857142857142857	0.06666666666666667	KEGG:04978	KEGG	Mineral absorption	8484	409		0.23809523809523808	0.2727272727272727	60	8424	4	10	56	8414	8484	0.13518701559180932
R1	cpdb	0	network_modules	329	TRUE	1.5075690630465493e-4	63	14	4	0.2857142857142857	0.06349206349206349	KEGG:00561	KEGG	Glycerolipid metabolism	8484	85		0.2857142857142857	0.3181818181818182	63	8421	4	10	59	8411	8484	0.1317850638565673
R1	cpdb	0	network_modules	329	TRUE	3.041408486010894e-4	75	14	4	0.2857142857142857	0.05333333333333334	KEGG:04918	KEGG	Thyroid hormone synthesis	8484	375		0.3333333333333333	0.36363636363636365	75	8409	4	10	71	8399	8484	0.12025482800877642
R1	cpdb	0	network_modules	329	TRUE	3.2073343617139416e-4	76	14	4	0.2857142857142857	0.05263157894736842	KEGG:04971	KEGG	Gastric acid secretion	8484	402		0.38095238095238093	0.4090909090909091	76	8408	4	10	72	8398	8484	0.11941730273561982
R1	cpdb	0	network_modules	329	TRUE	3.6867674972903045e-4	43	21	4	0.19047619047619047	0.09302325581395349	GO:1902305	GO:BP	regulation of sodium ion transmembrane transport	16175	22192		0.5510204081632653	0.56	43	16132	4	17	39	16115	16175	0.1315140753220829
R1	cpdb	0	network_modules	329	TRUE	4.3539829261923503e-4	114	21	5	0.23809523809523808	0.043859649122807015	GO:1904064	GO:BP	positive regulation of cation transmembrane transport	16175	23503		0.5714285714285714	0.58	114	16061	5	16	109	16045	16175	0.09958091782657073
R1	cpdb	0	network_modules	329	TRUE	0.00048627139105686683	46	21	4	0.19047619047619047	0.08695652173913043	GO:0086009	GO:BP	membrane repolarization	16175	17883		0.5918367346938775	0.6	46	16129	4	17	42	16112	16175	0.12703952246325517
R1	cpdb	0	network_modules	329	TRUE	5.018794037380761e-4	85	14	4	0.2857142857142857	0.047058823529411764	KEGG:04911	KEGG	Insulin secretion	8484	368		0.42857142857142855	0.45454545454545453	85	8399	4	10	81	8389	8484	0.11254579699891917
R1	cpdb	0	network_modules	329	TRUE	5.178902898320579e-4	130	18	5	0.2777777777777778	0.038461538461538464	REAC:R-HSA-5576891	REAC	Cardiac conduction	10916	306		0.3333333333333333	0.42857142857142855	130	10786	5	13	125	10773	10916	0.09960740589845755
R1	cpdb	0	network_modules	329	TRUE	6.029093955409525e-4	89	14	4	0.2857142857142857	0.0449438202247191	KEGG:04976	KEGG	Bile secretion	8484	407		0.47619047619047616	0.5	89	8395	4	10	85	8385	8484	0.10982566560587226
R1	cpdb	0	network_modules	329	TRUE	6.58710115382779e-4	91	14	4	0.2857142857142857	0.04395604395604396	KEGG:04970	KEGG	Salivary secretion	8484	401		0.5238095238095238	0.5454545454545454	91	8393	4	10	87	8383	8484	0.1085319844056652
R1	cpdb	0	network_modules	329	TRUE	7.756275277141651e-4	128	21	5	0.23809523809523808	0.0390625	GO:0034767	GO:BP	positive regulation of monoatomic ion transmembrane transport	16175	8736		0.6122448979591837	0.62	128	16047	5	16	123	16031	16175	0.09366621090440645
R1	cpdb	0	network_modules	329	TRUE	8.843943091416118e-4	98	14	4	0.2857142857142857	0.04081632653061224	KEGG:04925	KEGG	Aldosterone synthesis and secretion	8484	382		0.5714285714285714	0.5909090909090909	98	8386	4	10	94	8376	8484	0.10431374950669436
R1	cpdb	0	network_modules	329	TRUE	0.0010364807564711119	102	14	4	0.2857142857142857	0.0392156862745098	KEGG:04972	KEGG	Pancreatic secretion	8484	403		0.6190476190476191	0.6363636363636364	102	8382	4	10	98	8372	8484	0.10209644352782758
R1	cpdb	0	network_modules	329	TRUE	0.0010491648192699952	150	18	5	0.2777777777777778	0.03333333333333333	REAC:R-HSA-9679191	REAC	Potential therapeutics for SARS	10916	1782		0.5	0.5714285714285714	150	10766	5	13	145	10753	10916	0.09217592315237604
R1	cpdb	0	network_modules	329	TRUE	0.00107733561427611	103	14	4	0.2857142857142857	0.038834951456310676	KEGG:04974	KEGG	Protein digestion and absorption	8484	405		0.6666666666666666	0.6818181818181818	103	8381	4	10	99	8371	8484	0.10156192419840361
R1	cpdb	0	network_modules	329	TRUE	0.0011412158975566365	223	14	5	0.35714285714285715	0.02242152466367713	KEGG:04024	KEGG	cAMP signaling pathway	8484	252		0.7142857142857143	0.7272727272727273	223	8261	5	9	218	8252	8484	0.08408063495341905
R1	cpdb	0	network_modules	329	TRUE	0.0017050617767199892	282	21	6	0.2857142857142857	0.02127659574468085	GO:0042391	GO:BP	regulation of membrane potential	16175	10141		0.6326530612244898	0.64	282	15893	6	15	276	15878	16175	0.07390514209857715
R1	cpdb	0	network_modules	329	TRUE	0.0017767332990771783	284	21	6	0.2857142857142857	0.02112676056338028	GO:0010959	GO:BP	regulation of metal ion transport	16175	4536		0.6530612244897959	0.66	284	15891	6	15	278	15876	16175	0.0736151430175781
R1	cpdb	0	network_modules	329	TRUE	0.0019245499904974122	467	21	7	0.3333333333333333	0.014989293361884369	GO:0055080	GO:BP	monoatomic cation homeostasis	16175	14233		0.673469387755102	0.68	467	15708	7	14	460	15694	16175	0.06555828160997287
R1	cpdb	0	network_modules	329	TRUE	0.0020349940578194736	121	14	4	0.2857142857142857	0.03305785123966942	KEGG:04919	KEGG	Thyroid hormone signaling pathway	8484	376		0.7619047619047619	0.7727272727272727	121	8363	4	10	117	8353	8484	0.09307703003810083
R1	cpdb	0	network_modules	329	TRUE	0.0021558185425506055	475	21	7	0.3333333333333333	0.014736842105263158	GO:0050801	GO:BP	monoatomic ion homeostasis	16175	13267		0.6938775510204082	0.7	475	15700	7	14	468	15686	16175	0.06491480288232152
R1	cpdb	0	network_modules	329	TRUE	0.002449001606498958	43	14	3	0.21428571428571427	0.06976744186046512	KEGG:04975	KEGG	Fat digestion and absorption	8484	406		0.8095238095238095	0.8181818181818182	43	8441	3	11	40	8430	8484	0.11978142960694002
R1	cpdb	0	network_modules	329	TRUE	0.002566805051585079	163	21	5	0.23809523809523808	0.03067484662576687	GO:0043270	GO:BP	positive regulation of monoatomic ion transport	16175	10594		0.7142857142857143	0.72	163	16012	5	16	158	15996	16175	0.08231260707048062
R1	cpdb	0	network_modules	329	TRUE	0.002612750665537783	25	18	3	0.16666666666666666	0.12	REAC:R-HSA-210991	REAC	Basigin interactions	10916	207		0.6666666666666666	0.7142857142857143	25	10891	3	15	22	10876	10916	0.13975330669802405
R1	cpdb	0	network_modules	329	TRUE	0.0027040465453195446	182	18	5	0.2777777777777778	0.027472527472527472	REAC:R-HSA-983712	REAC	Ion channel transport	10916	1272		0.8333333333333334	0.8571428571428571	182	10734	5	13	177	10721	10916	0.08287529419669626
R1	cpdb	0	network_modules	329	TRUE	0.003117317923436404	20	21	3	0.14285714285714285	0.15	GO:0006670	GO:BP	sphingosine metabolic process	16175	2379		0.7346938775510204	0.74	20	16155	3	18	17	16137	16175	0.14530215429655982
R1	cpdb	0	network_modules	329	TRUE	0.003252053773825658	740	21	8	0.38095238095238093	0.010810810810810811	GO:0098657	GO:BP	import into cell	16175	18813		0.7551020408163265	0.76	740	15435	8	13	732	15422	16175	0.05784320067690577
R1	cpdb	0	network_modules	329	TRUE	0.003344084823733576	172	21	5	0.23809523809523808	0.029069767441860465	GO:0034764	GO:BP	positive regulation of transmembrane transport	16175	8733		0.7755102040816326	0.78	172	16003	5	16	167	15987	16175	0.07995708532311561
R1	cpdb	0	network_modules	329	TRUE	0.0036338352675194347	21	21	3	0.14285714285714285	0.14285714285714285	GO:1901018	GO:BP	positive regulation of potassium ion transmembrane transporter activity	16175	21140		0.7959183673469388	0.8	21	16154	3	18	18	16136	16175	0.14174286775500097
R1	cpdb	0	network_modules	329	TRUE	0.0038630686041777333	50	14	3	0.21428571428571427	0.06	KEGG:00565	KEGG	Ether lipid metabolism	8484	89		0.8571428571428571	0.8636363636363636	50	8434	3	11	47	8423	8484	0.11068856899779986
R1	cpdb	0	network_modules	329	TRUE	0.004204086732519456	22	21	3	0.14285714285714285	0.13636363636363635	GO:0046519	GO:BP	sphingoid metabolic process	16175	12217		0.8163265306122449	0.82	22	16153	3	18	19	16135	16175	0.13842777919895227
R1	cpdb	0	network_modules	329	TRUE	0.004413701351991548	182	21	5	0.23809523809523808	0.027472527472527472	GO:0032412	GO:BP	regulation of monoatomic ion transmembrane transporter activity	16175	7550		0.8367346938775511	0.84	182	15993	5	16	177	15977	16175	0.07754239364548914
R1	cpdb	0	network_modules	329	TRUE	0.0045798820337962075	80	21	4	0.19047619047619047	0.05	GO:0032414	GO:BP	positive regulation of ion transmembrane transporter activity	16175	7552		0.8571428571428571	0.86	80	16095	4	17	76	16078	16175	0.0953538489930183
R1	cpdb	0	network_modules	329	TRUE	0.004597283072575831	203	18	5	0.2777777777777778	0.024630541871921183	REAC:R-HSA-397014	REAC	Muscle contraction	10916	1496		1	1	203	10713	5	13	198	10700	10916	0.07796978559150623
R1	cpdb	0	network_modules	329	TRUE	0.0048697316300193106	54	14	3	0.21428571428571427	0.05555555555555555	KEGG:00600	KEGG	Sphingolipid metabolism	8484	95		0.9047619047619048	0.9090909090909091	54	8430	3	11	51	8419	8484	0.10629436119026468
R1	cpdb	0	network_modules	329	TRUE	0.005099790796476949	153	14	4	0.2857142857142857	0.026143790849673203	KEGG:04261	KEGG	Adrenergic signaling in cardiomyocytes	8484	297		0.9523809523809523	0.9545454545454546	153	8331	4	10	149	8321	8484	0.08177963431763084
R1	cpdb	0	network_modules	329	TRUE	0.005130995641596108	341	21	6	0.2857142857142857	0.017595307917888565	GO:0043269	GO:BP	regulation of monoatomic ion transport	16175	10593		0.8775510204081632	0.88	341	15834	6	15	335	15819	16175	0.06641777958070443
R1	cpdb	0	network_modules	329	TRUE	0.005449469286434882	190	21	5	0.23809523809523808	0.02631578947368421	GO:0022898	GO:BP	regulation of transmembrane transporter activity	16175	6629		0.8979591836734694	0.9	190	15985	5	16	185	15969	16175	0.07574584438206174
R1	cpdb	0	network_modules	329	TRUE	0.006263121718363735	25	21	3	0.14285714285714285	0.12	GO:0086064	GO:BP	cell communication by electrical coupling involved in cardiac conduction	16175	17918		0.9183673469387755	0.92	25	16150	3	18	22	16132	16175	0.1296985984599606
R1	cpdb	0	network_modules	329	TRUE	0.006679932170931595	164	14	4	0.2857142857142857	0.024390243902439025	KEGG:04022	KEGG	cGMP-PKG signaling pathway	8484	251		1	1	164	8320	4	10	160	8310	8484	0.07865877247384187
R1	cpdb	0	network_modules	329	TRUE	0.006707246274303021	88	21	4	0.19047619047619047	0.045454545454545456	GO:0032411	GO:BP	positive regulation of transporter activity	16175	7549		0.9387755102040817	0.94	88	16087	4	17	84	16070	16175	0.090696504251188
R1	cpdb	0	network_modules	329	TRUE	0.0075312984766152825	203	21	5	0.23809523809523808	0.024630541871921183	GO:0032409	GO:BP	regulation of transporter activity	16175	7547		0.9591836734693877	0.96	203	15972	5	16	198	15956	16175	0.07304986936719042
R1	cpdb	0	network_modules	329	TRUE	0.00795176636613489	27	21	3	0.14285714285714285	0.1111111111111111	GO:0034311	GO:BP	diol metabolic process	16175	8565		0.9795918367346939	0.98	27	16148	3	18	24	16130	16175	0.12470105400611571
R1	cpdb	0	network_modules	329	TRUE	0.00991701611104576	29	21	3	0.14285714285714285	0.10344827586206896	GO:1901381	GO:BP	positive regulation of potassium ion transmembrane transport	16175	21431		1	1	29	16146	3	18	26	16128	16175	0.12022627641589377
R1	cpdb	0	network_modules	330	TRUE	1.443140541644053e-86	71	47	39	0.8297872340425532	0.5492957746478874	GO:0045109	GO:BP	intermediate filament organization	16175	11280		0	0.05263157894736842	71	16104	39	8	32	16096	16175	0.6740159644843347
R1	cpdb	0	network_modules	330	TRUE	1.2986237786915316e-85	85	47	40	0.851063829787234	0.47058823529411764	GO:0045104	GO:BP	intermediate filament cytoskeleton organization	16175	11275		0.05555555555555555	0.10526315789473684	85	16090	40	7	45	16083	16175	0.6315208284145483
R1	cpdb	0	network_modules	330	TRUE	2.4268314414952987e-85	86	47	40	0.851063829787234	0.46511627906976744	GO:0045103	GO:BP	intermediate filament-based process	16175	11274		0.1111111111111111	0.15789473684210525	86	16089	40	7	46	16082	16175	0.6278120781091275
R1	cpdb	0	network_modules	330	TRUE	3.1948492912326994e-73	128	44	40	0.9090909090909091	0.3125	REAC:R-HSA-6809371	REAC	Formation of the cornified envelope	10916	969		0	0.5	128	10788	40	4	88	10784	10916	0.5303087798644408
R1	cpdb	0	network_modules	330	TRUE	6.142790229758188e-63	215	44	40	0.9090909090909091	0.18604651162790697	REAC:R-HSA-6805567	REAC	Keratinization	10916	1288		1	1	215	10701	40	4	175	10697	10916	0.407191252153929
R1	cpdb	0	network_modules	330	TRUE	2.908733725772445e-50	454	47	39	0.8297872340425532	0.08590308370044053	GO:0030855	GO:BP	epithelial cell differentiation	16175	6938		0.16666666666666666	0.21052631578947367	454	15721	39	8	415	15713	16175	0.2620337608833481
R1	cpdb	0	network_modules	330	TRUE	1.7903806689978728e-44	33	47	21	0.44680851063829785	0.6363636363636364	GO:0031424	GO:BP	keratinization	16175	7162		0.2222222222222222	0.2631578947368421	33	16142	21	26	12	16116	16175	0.5321096930912415
R1	cpdb	0	network_modules	330	TRUE	1.2934588874725685e-43	748	47	40	0.851063829787234	0.053475935828877004	GO:0097435	GO:BP	supramolecular fiber organization	16175	18657		0.2777777777777778	0.3157894736842105	748	15427	40	7	708	15420	16175	0.20687593809909005
R1	cpdb	0	network_modules	330	TRUE	1.0714621135916087e-42	701	47	39	0.8297872340425532	0.05563480741797432	GO:0060429	GO:BP	epithelium development	16175	14627		0.3333333333333333	0.3684210526315789	701	15474	39	8	662	15466	16175	0.20850337128919055
R1	cpdb	0	network_modules	330	TRUE	2.704446538612516e-41	231	47	30	0.6382978723404256	0.12987012987012986	GO:0008544	GO:BP	epidermis development	16175	3192		0.3888888888888889	0.42105263157894735	231	15944	30	17	201	15927	16175	0.2839189975433622
R1	cpdb	0	network_modules	330	TRUE	1.6356052094530512e-38	86	21	20	0.9523809523809523	0.23255813953488372	KEGG:05150	KEGG	Staphylococcus aureus infection	8484	439		0	0.5	86	8398	20	1	66	8397	8484	0.46856997891130503
R1	cpdb	0	network_modules	330	TRUE	7.1732940907398235e-37	168	47	26	0.5531914893617021	0.15476190476190477	GO:0043588	GO:BP	skin development	16175	10792		0.4444444444444444	0.47368421052631576	168	16007	26	21	142	15986	16175	0.28902623098144203
R1	cpdb	0	network_modules	330	TRUE	3.940509682980582e-34	136	21	20	0.9523809523809523	0.14705882352941177	KEGG:04915	KEGG	Estrogen signaling pathway	8484	372		1	1	136	8348	20	1	116	8347	8484	0.3713864359206762
R1	cpdb	0	network_modules	330	TRUE	8.779949139070605e-34	102	47	22	0.46808510638297873	0.21568627450980393	GO:0030216	GO:BP	keratinocyte differentiation	16175	6724		0.5	0.5263157894736842	102	16073	22	25	80	16048	16175	0.31491159783559225
R1	cpdb	0	network_modules	330	TRUE	2.4810535972133278e-30	142	47	22	0.46808510638297873	0.15492957746478872	GO:0009913	GO:BP	epidermal cell differentiation	16175	3769		0.5555555555555556	0.5789473684210527	142	16033	22	25	120	16008	16175	0.2657991763085265
R1	cpdb	0	network_modules	330	TRUE	2.557262349145877e-9	50	47	8	0.1702127659574468	0.16	GO:0042303	GO:BP	molting cycle	16175	10076		0.6111111111111112	0.6842105263157895	50	16125	8	39	42	16086	16175	0.16251768195708816
R1	cpdb	0	network_modules	330	TRUE	2.557262349145877e-9	50	47	8	0.1702127659574468	0.16	GO:0042633	GO:BP	hair cycle	16175	10266		0.6111111111111112	0.6842105263157895	50	16125	8	39	42	16086	16175	0.16251768195708816
R1	cpdb	0	network_modules	330	TRUE	2.495577589077246e-7	12	47	5	0.10638297872340426	0.4166666666666667	GO:0031069	GO:BP	hair follicle morphogenesis	16175	7018		0.7222222222222222	0.7368421052631579	12	16163	5	42	7	16121	16175	0.2094518678947536
R1	cpdb	0	network_modules	330	TRUE	6.28098848075779e-7	14	47	5	0.10638297872340426	0.35714285714285715	GO:0048730	GO:BP	epidermis morphogenesis	16175	12987		0.7777777777777778	0.7894736842105263	14	16161	5	42	9	16119	16175	0.19369976625529953
R1	cpdb	0	network_modules	330	TRUE	2.1652282828750066e-5	55	47	6	0.1276595744680851	0.10909090909090909	GO:0098773	GO:BP	skin epidermis development	16175	18887		0.8333333333333334	0.8421052631578947	55	16120	6	41	49	16079	16175	0.11523061481435996
R1	cpdb	0	network_modules	330	TRUE	6.076248144547648e-5	32	47	5	0.10638297872340426	0.15625	GO:0001942	GO:BP	hair follicle development	16175	554		0.8888888888888888	0.8947368421052632	32	16143	5	42	27	16101	16175	0.12683980133918543
R1	cpdb	0	network_modules	330	TRUE	7.145795795126062e-5	33	47	5	0.10638297872340426	0.15151515151515152	GO:0022405	GO:BP	hair cycle process	16175	6596		0.9444444444444444	1	33	16142	5	42	28	16100	16175	0.124833106478007
R1	cpdb	0	network_modules	330	TRUE	7.145795795126062e-5	33	47	5	0.10638297872340426	0.15151515151515152	GO:0022404	GO:BP	molting cycle process	16175	6595		0.9444444444444444	1	33	16142	5	42	28	16100	16175	0.124833106478007
R1	cpdb	0	network_modules	331	TRUE	4.190960955638903e-9	64	20	7	0.35	0.109375	REAC:R-HSA-8873719	REAC	RAB geranylgeranylation	10916	1835		0	0.16666666666666666	64	10852	7	13	57	10839	10916	0.19312189985155004
R1	cpdb	0	network_modules	331	TRUE	1.2382008883309175e-8	4	28	4	0.14285714285714285	1	GO:0006003	GO:BP	fructose 2,6-bisphosphate metabolic process	16175	1878		0	0.047619047619047616	4	16171	4	24	0	16147	16175	0.37768389309575967
R1	cpdb	0	network_modules	331	TRUE	1.904358098302474e-8	263	28	10	0.35714285714285715	0.03802281368821293	GO:0006887	GO:BP	exocytosis	16175	2543		0.05	0.09523809523809523	263	15912	10	18	253	15894	16175	0.1122387231863838
R1	cpdb	0	network_modules	331	TRUE	2.1687104752960665e-8	646	28	13	0.4642857142857143	0.020123839009287926	GO:0140352	GO:BP	export from cell	16175	19748		0.1	0.14285714285714285	646	15529	13	15	633	15514	16175	0.09024248902332625
R1	cpdb	0	network_modules	331	TRUE	3.216524153910325e-8	68	28	7	0.25	0.10294117647058823	GO:0045921	GO:BP	positive regulation of exocytosis	16175	11715		0.15	0.19047619047619047	68	16107	7	21	61	16086	16175	0.1581941338467877
R1	cpdb	0	network_modules	331	TRUE	4.368320250852699e-8	195	28	9	0.32142857142857145	0.046153846153846156	GO:1903532	GO:BP	positive regulation of secretion by cell	16175	23082		0.2	0.23809523809523808	195	15980	9	19	186	15961	16175	0.11804674044311958
R1	cpdb	0	network_modules	331	TRUE	8.85893033486281e-8	211	28	9	0.32142857142857145	0.04265402843601896	GO:0051047	GO:BP	positive regulation of secretion	16175	13457		0.25	0.2857142857142857	211	15964	9	19	202	15945	16175	0.11317663552383328
R1	cpdb	0	network_modules	331	TRUE	1.3298789177911864e-7	583	28	12	0.42857142857142855	0.02058319039451115	GO:0032940	GO:BP	secretion by cell	16175	7926		0.3	0.3333333333333333	583	15592	12	16	571	15576	16175	0.08769261107152361
R1	cpdb	0	network_modules	331	TRUE	1.8641483345179713e-7	148	28	8	0.2857142857142857	0.05405405405405406	GO:0017157	GO:BP	regulation of exocytosis	16175	5287		0.35	0.38095238095238093	148	16027	8	20	140	16007	16175	0.12095299427649693
R1	cpdb	0	network_modules	331	TRUE	4.57869787140453e-7	649	28	12	0.42857142857142855	0.01848998459167951	GO:0046903	GO:BP	secretion	16175	12430		0.4	0.42857142857142855	649	15526	12	16	637	15510	16175	0.08242479732308865
R1	cpdb	0	network_modules	331	TRUE	1.280771931277955e-6	404	28	10	0.35714285714285715	0.024752475247524754	GO:1903530	GO:BP	regulation of secretion by cell	16175	23080		0.45	0.47619047619047616	404	15771	10	18	394	15753	16175	0.08863644196339407
R1	cpdb	0	network_modules	331	TRUE	1.3574531990275234e-6	12	20	4	0.2	0.3333333333333333	REAC:R-HSA-9634600	REAC	Regulation of glycolysis by fructose 2,6-bisphosphate metabolism	10916	2038		0.2	0.3333333333333333	12	10904	4	16	8	10888	10916	0.25715663631504615
R1	cpdb	0	network_modules	331	TRUE	3.055288472145807e-6	442	28	10	0.35714285714285715	0.02262443438914027	GO:0051046	GO:BP	regulation of secretion	16175	13456		0.5	0.5238095238095238	442	15733	10	18	432	15715	16175	0.08424287242690133
R1	cpdb	0	network_modules	331	TRUE	4.072110200403239e-6	34	11	4	0.36363636363636365	0.11764705882352941	KEGG:00051	KEGG	Fructose and mannose metabolism	8484	6		0	0.5	34	8450	4	7	30	8443	8484	0.20509972321420933
R1	cpdb	0	network_modules	331	TRUE	1.7972047116567734e-5	120	20	6	0.3	0.05	REAC:R-HSA-9007101	REAC	Rab regulation of trafficking	10916	1939		0.4	0.5	120	10796	6	14	114	10782	10916	0.11874934470529809
R1	cpdb	0	network_modules	331	TRUE	3.93591601053802e-5	68	20	5	0.25	0.07352941176470588	REAC:R-HSA-70171	REAC	Glycolysis	10916	1074		0.6	0.6666666666666666	68	10848	5	15	63	10833	10916	0.1327385381618433
R1	cpdb	0	network_modules	331	TRUE	1.2565300128230636e-4	653	28	10	0.35714285714285715	0.015313935681470138	GO:0051050	GO:BP	positive regulation of transport	16175	13460		0.55	0.5714285714285714	653	15522	10	18	643	15504	16175	0.06701833303964061
R1	cpdb	0	network_modules	331	TRUE	1.2880223789843545e-4	86	20	5	0.25	0.05813953488372093	REAC:R-HSA-70326	REAC	Glucose metabolism	10916	1053		0.8	0.8333333333333334	86	10830	5	15	81	10815	10916	0.11733164504958277
R1	cpdb	0	network_modules	331	TRUE	1.4455530888168684e-4	88	20	5	0.25	0.056818181818181816	REAC:R-HSA-8876198	REAC	RAB GEFs exchange GTP for GDP on RABs	10916	1834		1	1	88	10828	5	15	83	10813	10916	0.11591359945023805
R1	cpdb	0	network_modules	331	TRUE	2.997994927709341e-4	250	28	7	0.25	0.028	GO:0009306	GO:BP	protein secretion	16175	3452		0.6	0.6190476190476191	250	15925	7	21	243	15904	16175	0.07917573006501405
R1	cpdb	0	network_modules	331	TRUE	3.080466870504601e-4	251	28	7	0.25	0.027888446215139442	GO:0035592	GO:BP	establishment of protein localization to extracellular region	16175	9108		0.65	0.6666666666666666	251	15924	7	21	244	15903	16175	0.0789995040525217
R1	cpdb	0	network_modules	331	TRUE	3.713241266943008e-4	258	28	7	0.25	0.027131782945736434	GO:0071692	GO:BP	protein localization to extracellular region	16175	16860		0.7	0.7142857142857143	258	15917	7	21	251	15896	16175	0.07779372421315037
R1	cpdb	0	network_modules	331	TRUE	5.366904276553446e-4	409	28	8	0.2857142857142857	0.019559902200488997	GO:0060627	GO:BP	regulation of vesicle-mediated transport	16175	14803		0.75	0.7619047619047619	409	15766	8	20	401	15746	16175	0.06907855235386445
R1	cpdb	0	network_modules	331	TRUE	6.248789651760681e-4	35	28	4	0.14285714285714285	0.11428571428571428	GO:1903307	GO:BP	positive regulation of regulated secretory pathway	16175	22894		0.8	0.8095238095238095	35	16140	4	24	31	16116	16175	0.12608546993699354
R1	cpdb	0	network_modules	331	TRUE	6.812579314407884e-4	120	11	4	0.36363636363636365	0.03333333333333333	KEGG:04152	KEGG	AMPK signaling pathway	8484	286		1	1	120	8364	4	7	116	8357	8484	0.1066395042794678
R1	cpdb	0	network_modules	331	TRUE	7.021541261267597e-4	36	28	4	0.14285714285714285	0.1111111111111111	GO:0006904	GO:BP	vesicle docking involved in exocytosis	16175	2556		0.85	0.8571428571428571	36	16139	4	24	32	16115	16175	0.12427116992879121
R1	cpdb	0	network_modules	331	TRUE	0.0020985250262133023	47	28	4	0.14285714285714285	0.0851063829787234	GO:0071985	GO:BP	multivesicular body sorting pathway	16175	17028		0.9	0.9047619047619048	47	16128	4	24	43	16104	16175	0.10827184022511491
R1	cpdb	0	network_modules	331	TRUE	0.003974669775440618	55	28	4	0.14285714285714285	0.07272727272727272	GO:0048278	GO:BP	vesicle docking	16175	12620		0.95	0.9523809523809523	55	16120	4	24	51	16096	16175	0.09975928310776035
R1	cpdb	0	network_modules	331	TRUE	0.0042753310404652365	56	28	4	0.14285714285714285	0.07142857142857142	GO:0140029	GO:BP	exocytic process	16175	19642		1	1	56	16119	4	24	52	16095	16175	0.09882379975036257
R1	cpdb	0	network_modules	332	TRUE	5.611400032210188e-112	209	74	68	0.918918918918919	0.3253588516746411	REAC:R-HSA-72172	REAC	mRNA Splicing	10916	2706		0	0.06666666666666667	209	10707	68	6	141	10701	10916	0.5424384404383953
R1	cpdb	0	network_modules	332	TRUE	4.004041653149379e-105	276	74	69	0.9324324324324325	0.25	REAC:R-HSA-72203	REAC	Processing of Capped Intron-Containing Pre-mRNA	10916	1796		0.07142857142857142	0.13333333333333333	276	10640	69	5	207	10635	10916	0.4773948076596909
R1	cpdb	0	network_modules	332	TRUE	2.0108092535691484e-98	291	80	65	0.8125	0.22336769759450173	GO:0000375	GO:BP	RNA splicing, via transesterification reactions	16175	107		0	0.03333333333333333	291	15884	65	15	226	15869	16175	0.4214211513874308
R1	cpdb	0	network_modules	332	TRUE	2.921093261863672e-98	397	80	69	0.8625	0.17380352644836272	GO:0008380	GO:BP	RNA splicing	16175	3186		0.034482758620689655	0.06666666666666667	397	15778	69	11	328	15767	16175	0.3818068821942622
R1	cpdb	0	network_modules	332	TRUE	2.111147159354823e-96	287	80	64	0.8	0.2229965156794425	GO:0000377	GO:BP	RNA splicing, via transesterification reactions with bulged adenosine as nucleophile	16175	109		0.06896551724137931	0.13333333333333333	287	15888	64	16	223	15872	16175	0.4177509508602786
R1	cpdb	0	network_modules	332	TRUE	2.111147159354823e-96	287	80	64	0.8	0.2229965156794425	GO:0000398	GO:BP	mRNA splicing, via spliceosome	16175	121		0.06896551724137931	0.13333333333333333	287	15888	64	16	223	15872	16175	0.4177509508602786
R1	cpdb	0	network_modules	332	TRUE	3.263343628441049e-94	202	74	61	0.8243243243243243	0.30198019801980197	REAC:R-HSA-72163	REAC	mRNA Splicing - Major Pathway	10916	2707		0.14285714285714285	0.2	202	10714	61	13	141	10701	10916	0.4939817294301203
R1	cpdb	0	network_modules	332	TRUE	1.8823168896713813e-92	352	80	65	0.8125	0.1846590909090909	GO:0006397	GO:BP	mRNA processing	16175	2158		0.13793103448275862	0.16666666666666666	352	15823	65	15	287	15808	16175	0.3820855982335668
R1	cpdb	0	network_modules	332	TRUE	5.4487904564202435e-84	174	54	51	0.9444444444444444	0.29310344827586204	KEGG:03040	KEGG	Spliceosome	8484	215		NA	1	174	8310	51	3	123	8307	8484	0.5217352180567701
R1	cpdb	0	network_modules	332	TRUE	8.065533416314503e-77	590	80	65	0.8125	0.11016949152542373	GO:0016071	GO:BP	mRNA metabolic process	16175	5098		0.1724137931034483	0.2	590	15585	65	15	525	15570	16175	0.2918364352474957
R1	cpdb	0	network_modules	332	TRUE	1.1127608017884594e-53	73	80	32	0.4	0.4383561643835616	GO:0000245	GO:BP	spliceosomal complex assembly	16175	69		0.20689655172413793	0.23333333333333334	73	16102	32	48	41	16054	16175	0.41598197495965183
R1	cpdb	0	network_modules	332	TRUE	7.083104118159044e-48	188	80	37	0.4625	0.19680851063829788	GO:0071826	GO:BP	protein-RNA complex organization	16175	16929		0.2413793103448276	0.26666666666666666	188	15987	37	43	151	15944	16175	0.29657844417336265
R1	cpdb	0	network_modules	332	TRUE	7.226063258618713e-47	178	80	36	0.45	0.20224719101123595	GO:0022618	GO:BP	protein-RNA complex assembly	16175	6625		0.27586206896551724	0.3	178	15997	36	44	142	15953	16175	0.2966705603476035
R1	cpdb	0	network_modules	332	TRUE	9.818283355038902e-46	48	74	27	0.36486486486486486	0.5625	REAC:R-HSA-72165	REAC	mRNA Splicing - Minor Pathway	10916	2708		0.21428571428571427	0.26666666666666666	48	10868	27	47	21	10821	10916	0.45008604399774865
R1	cpdb	0	network_modules	332	TRUE	5.316900681649345e-37	25	80	19	0.2375	0.76	GO:1903241	GO:BP	U2-type prespliceosome assembly	16175	22851		0.3103448275862069	0.3333333333333333	25	16150	19	61	6	16089	16175	0.4234631405734068
R1	cpdb	0	network_modules	332	TRUE	1.6887984135911875e-35	390	80	37	0.4625	0.09487179487179487	GO:0022613	GO:BP	ribonucleoprotein complex biogenesis	16175	6620		0.3448275862068966	0.36666666666666664	390	15785	37	43	353	15742	16175	0.20148771134987412
R1	cpdb	0	network_modules	332	TRUE	5.58525103588341e-18	39	80	13	0.1625	0.3333333333333333	GO:0000387	GO:BP	spliceosomal snRNP assembly	16175	114		0.3793103448275862	0.4	39	16136	13	67	26	16069	16175	0.23013076968730867
R1	cpdb	0	network_modules	332	TRUE	2.135602535532424e-15	65	74	14	0.1891891891891892	0.2153846153846154	REAC:R-HSA-73856	REAC	RNA Polymerase II Transcription Termination	10916	1895		0.2857142857142857	0.3333333333333333	65	10851	14	60	51	10791	10916	0.1967617488405416
R1	cpdb	0	network_modules	332	TRUE	1.0442294866180156e-13	18	80	9	0.1125	0.5	GO:0045292	GO:BP	mRNA cis splicing, via spliceosome	16175	11346		0.41379310344827586	0.43333333333333335	18	16157	9	71	9	16086	16175	0.2355387431992037
R1	cpdb	0	network_modules	332	TRUE	8.819900610584719e-13	8	80	7	0.0875	0.875	GO:0036261	GO:BP	7-methylguanosine cap hypermethylation	16175	9522		0.4482758620689655	0.4666666666666667	8	16167	7	73	1	16094	16175	0.2758864275184762
R1	cpdb	0	network_modules	332	TRUE	3.694930472121737e-10	14	80	7	0.0875	0.5	GO:0036260	GO:BP	RNA capping	16175	9521		0.4827586206896552	0.5	14	16161	7	73	7	16088	16175	0.20769993758892097
R1	cpdb	0	network_modules	332	TRUE	1.3762561906074928e-8	11	74	6	0.08108108108108109	0.5454545454545454	REAC:R-HSA-77588	REAC	SLBP Dependent Processing of Replication-Dependent Histone Pre-mRNAs	10916	2143		0.35714285714285715	0.4	11	10905	6	68	5	10837	10916	0.20849886788695504
R1	cpdb	0	network_modules	332	TRUE	2.0572675992915435e-7	30	80	7	0.0875	0.23333333333333334	GO:0006376	GO:BP	mRNA splice site recognition	16175	2146		0.5172413793103449	0.5333333333333333	30	16145	7	73	23	16072	16175	0.14033551861406227
R1	cpdb	0	network_modules	332	TRUE	6.66228177411753e-7	35	80	7	0.0875	0.2	GO:0000966	GO:BP	RNA 5'-end processing	16175	274		0.5517241379310345	0.5666666666666667	35	16140	7	73	28	16067	16175	0.12947655529888483
R1	cpdb	0	network_modules	332	TRUE	1.121433086825205e-6	80	74	9	0.12162162162162163	0.1125	REAC:R-HSA-72202	REAC	Transport of Mature Transcript to Cytoplasm	10916	2584		0.42857142857142855	0.4666666666666667	80	10836	9	65	71	10771	10916	0.11070431762502861
R1	cpdb	0	network_modules	332	TRUE	1.1874970151835662e-6	10	74	5	0.06756756756756757	0.5	REAC:R-HSA-111367	REAC	SLBP independent Processing of Histone Pre-mRNAs	10916	2144		0.5	0.5333333333333333	10	10906	5	69	5	10837	10916	0.18201272142042874
R1	cpdb	0	network_modules	332	TRUE	1.2842395640849615e-6	56	74	8	0.10810810810810811	0.14285714285714285	REAC:R-HSA-72187	REAC	mRNA 3'-end processing	10916	2701		0.5714285714285714	0.6	56	10860	8	66	48	10794	10916	0.1190858916090097
R1	cpdb	0	network_modules	332	TRUE	1.9041151245482386e-6	175	80	11	0.1375	0.06285714285714286	GO:0043484	GO:BP	regulation of RNA splicing	16175	10730		0.5862068965517241	0.6	175	16000	11	69	164	15931	16175	0.0863327734036032
R1	cpdb	0	network_modules	332	TRUE	8.870674694251802e-6	71	74	8	0.10810810810810811	0.11267605633802817	REAC:R-HSA-159236	REAC	Transport of Mature mRNA derived from an Intron-Containing Transcript	10916	2586		0.6428571428571429	0.6666666666666666	71	10845	8	66	63	10779	10916	0.10442177856486268
R1	cpdb	0	network_modules	332	TRUE	1.024630180692024e-5	28	74	6	0.08108108108108109	0.21428571428571427	REAC:R-HSA-75067	REAC	Processing of Capped Intronless Pre-mRNA	10916	1797		0.7142857142857143	0.7333333333333333	28	10888	6	68	22	10820	10916	0.12824191522804929
R1	cpdb	0	network_modules	332	TRUE	1.74193630779336e-5	51	74	7	0.0945945945945946	0.13725490196078433	REAC:R-HSA-194441	REAC	Metabolism of non-coding RNA	10916	1431		0.7857142857142857	0.9333333333333333	51	10865	7	67	44	10798	10916	0.10894150312782501
R1	cpdb	0	network_modules	332	TRUE	1.74193630779336e-5	51	74	7	0.0945945945945946	0.13725490196078433	REAC:R-HSA-191859	REAC	snRNP Assembly	10916	2736		0.7857142857142857	0.9333333333333333	51	10865	7	67	44	10798	10916	0.10894150312782501
R1	cpdb	0	network_modules	332	TRUE	1.74193630779336e-5	51	74	7	0.0945945945945946	0.13725490196078433	REAC:R-HSA-9754678	REAC	SARS-CoV-2 modulates host translation machinery	10916	2125		0.7857142857142857	0.9333333333333333	51	10865	7	67	44	10798	10916	0.10894150312782501
R1	cpdb	0	network_modules	332	TRUE	1.3889155878652102e-4	73	80	7	0.0875	0.0958904109589041	GO:0001510	GO:BP	RNA methylation	16175	324		0.6206896551724138	0.6333333333333333	73	16102	7	73	66	16029	16175	0.08728744798546625
R1	cpdb	0	network_modules	332	TRUE	1.401280667681088e-4	155	80	9	0.1125	0.05806451612903226	GO:0009451	GO:BP	RNA modification	16175	3498		0.6551724137931034	0.6666666666666666	155	16020	9	71	146	15949	16175	0.07447921944060645
R1	cpdb	0	network_modules	332	TRUE	9.287433512843341e-4	4	80	3	0.0375	0.75	GO:0000393	GO:BP	spliceosomal conformational changes to generate catalytic conformation	16175	118		0.6896551724137931	0.7	4	16171	3	77	1	16094	16175	0.1670333413894742
R1	cpdb	0	network_modules	332	TRUE	0.0010682618335098024	98	80	7	0.0875	0.07142857142857142	GO:0048024	GO:BP	regulation of mRNA splicing, via spliceosome	16175	12475		0.7241379310344828	0.7333333333333333	98	16077	7	73	91	16004	16175	0.07398995652316795
R1	cpdb	0	network_modules	332	TRUE	0.0010695443889668184	14	80	4	0.05	0.2857142857142857	GO:0000244	GO:BP	spliceosomal tri-snRNP complex assembly	16175	68		0.7586206896551724	0.7666666666666667	14	16161	4	76	10	16085	16175	0.11779636975963245
R1	cpdb	0	network_modules	332	TRUE	0.0019300470716821512	16	80	4	0.05	0.25	GO:0048025	GO:BP	negative regulation of mRNA splicing, via spliceosome	16175	12476		0.7931034482758621	0.8	16	16159	4	76	12	16083	16175	0.1099179251466924
R1	cpdb	0	network_modules	332	TRUE	0.0025144304242506283	17	80	4	0.05	0.23529411764705882	GO:0050686	GO:BP	negative regulation of mRNA processing	16175	13217		0.8275862068965517	0.8333333333333334	17	16158	4	76	13	16082	16175	0.10650483219289804
R1	cpdb	0	network_modules	332	TRUE	0.002982471693276959	114	80	7	0.0875	0.06140350877192982	GO:0043414	GO:BP	macromolecule methylation	16175	10681		0.8620689655172413	0.8666666666666667	114	16061	7	73	107	15988	16175	0.06780198174112656
R1	cpdb	0	network_modules	332	TRUE	0.003980866807365352	119	80	7	0.0875	0.058823529411764705	GO:0050684	GO:BP	regulation of mRNA processing	16175	13215		0.896551724137931	0.9	119	16056	7	73	112	15983	16175	0.06611759553008506
R1	cpdb	0	network_modules	332	TRUE	0.00461062006747396	6	80	3	0.0375	0.5	GO:0000389	GO:BP	mRNA 3'-splice site recognition	16175	116		0.9310344827586207	0.9333333333333333	6	16169	3	77	3	16092	16175	0.13593788480197586
R1	cpdb	0	network_modules	332	TRUE	0.005533912056381857	125	80	7	0.0875	0.056	GO:0032259	GO:BP	methylation	16175	7445		0.9655172413793104	0.9666666666666667	125	16050	7	73	118	15977	16175	0.06422467018022208
R1	cpdb	0	network_modules	332	TRUE	0.006228639565962842	21	80	4	0.05	0.19047619047619047	GO:0033119	GO:BP	negative regulation of RNA splicing	16175	8043		1	1	21	16154	4	76	17	16078	16175	0.0953538489930183
R1	cpdb	0	network_modules	332	TRUE	0.009813859515227338	52	74	5	0.06756756756756757	0.09615384615384616	REAC:R-HSA-6781823	REAC	Formation of TC-NER Pre-Incision Complex	10916	951		1	1	52	10864	5	69	47	10795	10916	0.07535548548335823
R1	cpdb	0	network_modules	333	TRUE	5.190503391367717e-12	67	16	8	0.5	0.11940298507462686	REAC:R-HSA-1650814	REAC	Collagen biosynthesis and modifying enzymes	10916	384		0	0.3333333333333333	67	10849	8	8	59	10841	10916	0.24226117441869247
R1	cpdb	0	network_modules	333	TRUE	5.539894815472528e-11	89	16	8	0.5	0.0898876404494382	REAC:R-HSA-1474290	REAC	Collagen formation	10916	387		0.5	0.6666666666666666	89	10827	8	8	81	10819	10916	0.2095516450836317
R1	cpdb	0	network_modules	333	TRUE	7.418644462467084e-11	8	18	5	0.2777777777777778	0.625	GO:0017185	GO:BP	peptidyl-lysine hydroxylation	16175	5290		0	0.25	8	16167	5	13	3	16154	16175	0.4162593525105982
R1	cpdb	0	network_modules	333	TRUE	8.148293784641019e-9	17	18	5	0.2777777777777778	0.29411764705882354	GO:0018126	GO:BP	protein hydroxylation	16175	5332		0.3333333333333333	0.5	17	16158	5	13	12	16145	16175	0.285057909391154
R1	cpdb	0	network_modules	333	TRUE	8.599527197988753e-7	63	12	5	0.4166666666666667	0.07936507936507936	KEGG:00310	KEGG	Lysine degradation	8484	34		0	0.5	63	8421	5	7	58	8414	8484	0.17940116443182455
R1	cpdb	0	network_modules	333	TRUE	9.584757416498403e-7	298	16	8	0.5	0.026845637583892617	REAC:R-HSA-1474244	REAC	Extracellular matrix organization	10916	889		1	1	298	10618	8	8	290	10610	10916	0.11113911941823285
R1	cpdb	0	network_modules	333	TRUE	3.233481251140166e-4	128	18	5	0.2777777777777778	0.0390625	GO:0018205	GO:BP	peptidyl-lysine modification	16175	5364		0.6666666666666666	0.75	128	16047	5	13	123	16034	16175	0.1016585133767516
R1	cpdb	0	network_modules	333	TRUE	3.420300731769091e-4	50	18	4	0.2222222222222222	0.08	GO:0030199	GO:BP	collagen fibril organization	16175	6708		1	1	50	16125	4	14	46	16111	16175	0.13175563543178095
R1	cpdb	0	network_modules	333	TRUE	0.001991431365284632	47	12	3	0.25	0.06382978723404255	KEGG:00514	KEGG	Other types of O-glycan biosynthesis	8484	67		1	1	47	8437	3	9	44	8428	8484	0.1239548282695433
R1	cpdb	0	network_modules	334	TRUE	4.7386557123671694e-29	183	16	16	1	0.08743169398907104	GO:0071805	GO:BP	potassium ion transmembrane transport	16175	16918		0	0.014925373134328358	183	15992	16	0	167	15992	16175	0.2941565996160352
R1	cpdb	0	network_modules	334	TRUE	1.7615863895535565e-28	198	16	16	1	0.08080808080808081	GO:0006813	GO:BP	potassium ion transport	16175	2493		0.015151515151515152	0.029850746268656716	198	15977	16	0	182	15977	16175	0.28266222506373534
R1	cpdb	0	network_modules	334	TRUE	1.4905301512713847e-24	43	16	12	0.75	0.27906976744186046	REAC:R-HSA-1296072	REAC	Voltage gated Potassium channels	10916	2663		0	0.125	43	10873	12	4	31	10869	10916	0.4563263901913065
R1	cpdb	0	network_modules	334	TRUE	6.805254325965828e-21	575	16	16	1	0.02782608695652174	GO:0098662	GO:BP	inorganic cation transmembrane transport	16175	18818		0.030303030303030304	0.04477611940298507	575	15600	16	0	559	15600	16175	0.16390082049959154
R1	cpdb	0	network_modules	334	TRUE	7.199324820930046e-21	577	16	16	1	0.02772963604852686	GO:0098655	GO:BP	monoatomic cation transmembrane transport	16175	18811		0.045454545454545456	0.05970149253731343	577	15598	16	0	561	15598	16175	0.16360602846651517
R1	cpdb	0	network_modules	334	TRUE	2.989915555462907e-20	630	16	16	1	0.025396825396825397	GO:0098660	GO:BP	inorganic ion transmembrane transport	16175	18816		0.06060606060606061	0.07462686567164178	630	15545	16	0	614	15545	16175	0.1563067882160961
R1	cpdb	0	network_modules	334	TRUE	8.296728655888618e-20	671	16	16	1	0.02384500745156483	GO:0034220	GO:BP	monoatomic ion transmembrane transport	16175	8508		0.07575757575757576	0.08955223880597014	671	15504	16	0	655	15504	16175	0.15125626449399163
R1	cpdb	0	network_modules	334	TRUE	9.582180465095622e-20	677	16	16	1	0.023633677991137372	GO:0030001	GO:BP	metal ion transport	16175	6646		0.09090909090909091	0.1044776119402985	677	15498	16	0	661	15498	16175	0.15055536801526115
R1	cpdb	0	network_modules	334	TRUE	1.4558993070527676e-19	103	16	12	0.75	0.11650485436893204	REAC:R-HSA-1296071	REAC	Potassium Channels	10916	1780		0.14285714285714285	0.25	103	10813	12	4	91	10809	10916	0.29348190765071785
R1	cpdb	0	network_modules	334	TRUE	4.807132846077426e-19	748	16	16	1	0.0213903743315508	GO:0006812	GO:BP	monoatomic cation transport	16175	2492		0.10606060606060606	0.11940298507462686	748	15427	16	0	732	15427	16175	0.14290344274523104
R1	cpdb	0	network_modules	334	TRUE	2.5476428585617542e-12	400	16	12	0.75	0.03	REAC:R-HSA-112316	REAC	Neuronal System	10916	1590		0.2857142857142857	0.375	400	10516	12	4	388	10512	10916	0.14546604549633668
R1	cpdb	0	network_modules	334	TRUE	2.0228062693526252e-8	23	16	5	0.3125	0.21739130434782608	GO:0099623	GO:BP	regulation of cardiac muscle cell membrane repolarization	16175	19168		0.12121212121212122	0.13432835820895522	23	16152	5	11	18	16141	16175	0.2597702071498469
R1	cpdb	0	network_modules	334	TRUE	1.0167915253705956e-7	31	16	5	0.3125	0.16129032258064516	GO:0060306	GO:BP	regulation of membrane repolarization	16175	14519		0.13636363636363635	0.14925373134328357	31	16144	5	11	26	16133	16175	0.22345441798032206
R1	cpdb	0	network_modules	334	TRUE	1.237575862374837e-7	9	16	4	0.25	0.4444444444444444	REAC:R-HSA-5576890	REAC	Phase 3 - rapid repolarisation	10916	1735		0.42857142857142855	0.5	9	10907	4	12	5	10895	10916	0.33261492672186477
R1	cpdb	0	network_modules	334	TRUE	1.4186688182060398e-7	33	16	5	0.3125	0.15151515151515152	GO:0099622	GO:BP	cardiac muscle cell membrane repolarization	16175	19167		0.15151515151515152	0.16417910447761194	33	16142	5	11	28	16131	16175	0.21650443268254144
R1	cpdb	0	network_modules	334	TRUE	3.917623825885772e-7	40	16	5	0.3125	0.125	GO:0086091	GO:BP	regulation of heart rate by cardiac conduction	16175	17929		0.16666666666666666	0.1791044776119403	40	16135	5	11	35	16124	16175	0.1964183889658297
R1	cpdb	0	network_modules	334	TRUE	7.488577661399759e-7	108	16	6	0.375	0.05555555555555555	GO:0001508	GO:BP	action potential	16175	323		0.18181818181818182	0.19402985074626866	108	16067	6	10	102	16057	16175	0.14231367691735347
R1	cpdb	0	network_modules	334	TRUE	8.133386871974421e-7	46	16	5	0.3125	0.10869565217391304	GO:0086009	GO:BP	membrane repolarization	16175	17883		0.19696969696969696	0.208955223880597	46	16129	5	11	41	16118	16175	0.18297596668413652
R1	cpdb	0	network_modules	334	TRUE	1.0148444724814111e-6	48	16	5	0.3125	0.10416666666666667	GO:0086002	GO:BP	cardiac muscle cell action potential involved in contraction	16175	17879		0.21212121212121213	0.22388059701492538	48	16127	5	11	43	16116	16175	0.17906298678609844
R1	cpdb	0	network_modules	334	TRUE	1.3336435900021015e-6	15	16	4	0.25	0.26666666666666666	REAC:R-HSA-5576893	REAC	Phase 2 - plateau phase	10916	1734		0.5714285714285714	0.625	15	10901	4	12	11	10889	10916	0.25714482363597585
R1	cpdb	0	network_modules	334	TRUE	1.47893177048649e-6	16	16	4	0.25	0.25	GO:0097623	GO:BP	potassium ion export across plasma membrane	16175	18713		0.22727272727272727	0.23880597014925373	16	16159	4	12	12	16147	16175	0.24925737978835327
R1	cpdb	0	network_modules	334	TRUE	3.144029095718591e-6	19	16	4	0.25	0.21052631578947367	GO:1901380	GO:BP	negative regulation of potassium ion transmembrane transport	16175	21430		0.24242424242424243	0.26865671641791045	19	16156	4	12	15	16144	16175	0.22858511004164594
R1	cpdb	0	network_modules	334	TRUE	3.144029095718591e-6	19	16	4	0.25	0.21052631578947367	GO:0060307	GO:BP	regulation of ventricular cardiac muscle cell membrane repolarization	16175	14520		0.24242424242424243	0.26865671641791045	19	16156	4	12	15	16144	16175	0.22858511004164594
R1	cpdb	0	network_modules	334	TRUE	3.8048375151671025e-6	62	16	5	0.3125	0.08064516129032258	GO:0086003	GO:BP	cardiac muscle cell contraction	16175	17880		0.2727272727272727	0.2835820895522388	62	16113	5	11	57	16102	16175	0.1571820998268817
R1	cpdb	0	network_modules	334	TRUE	4.848399050437315e-6	65	16	5	0.3125	0.07692307692307693	GO:1901379	GO:BP	regulation of potassium ion transmembrane transport	16175	21429		0.2878787878787879	0.29850746268656714	65	16110	5	11	60	16099	16175	0.15343401487980798
R1	cpdb	0	network_modules	334	TRUE	5.828701735617509e-6	282	16	7	0.4375	0.024822695035460994	GO:0042391	GO:BP	regulation of membrane potential	16175	10141		0.30303030303030304	0.31343283582089554	282	15893	7	9	275	15884	16175	0.10099194884250082
R1	cpdb	0	network_modules	334	TRUE	5.923018566714641e-6	22	16	4	0.25	0.18181818181818182	GO:0043267	GO:BP	negative regulation of potassium ion transport	16175	10591		0.3181818181818182	0.3283582089552239	22	16153	4	12	18	16141	16175	0.21229016979096296
R1	cpdb	0	network_modules	334	TRUE	7.16571130440333e-6	23	16	4	0.25	0.17391304347826086	GO:0099625	GO:BP	ventricular cardiac muscle cell membrane repolarization	16175	19170		0.3333333333333333	0.34328358208955223	23	16152	4	12	19	16140	16175	0.20757868218122585
R1	cpdb	0	network_modules	334	TRUE	7.616424462371024e-6	71	16	5	0.3125	0.07042253521126761	GO:0086001	GO:BP	cardiac muscle cell action potential	16175	17878		0.3484848484848485	0.3582089552238806	71	16104	5	11	66	16093	16175	0.14665858746996752
R1	cpdb	0	network_modules	334	TRUE	9.0197068341626e-6	163	16	6	0.375	0.03680981595092025	GO:0008016	GO:BP	regulation of heart contraction	16175	3097		0.36363636363636365	0.373134328358209	163	16012	6	10	157	16002	16175	0.11496915803100843
R1	cpdb	0	network_modules	334	TRUE	9.407295427204337e-6	74	16	5	0.3125	0.06756756756756757	GO:0043266	GO:BP	regulation of potassium ion transport	16175	10590		0.3787878787878788	0.3880597014925373	74	16101	5	11	69	16090	16175	0.14358192113367205
R1	cpdb	0	network_modules	334	TRUE	1.4168233501448468e-5	27	16	4	0.25	0.14814814814814814	GO:0086011	GO:BP	membrane repolarization during action potential	16175	17885		0.3939393939393939	0.40298507462686567	27	16148	4	12	23	16136	16175	0.1914195543332221
R1	cpdb	0	network_modules	334	TRUE	1.5861946022115807e-5	82	16	5	0.3125	0.06097560975609756	GO:0002027	GO:BP	regulation of heart rate	16175	629		0.4090909090909091	0.417910447761194	82	16093	5	11	77	16082	16175	0.13621297758629816
R1	cpdb	0	network_modules	334	TRUE	1.9151569236983854e-5	29	16	4	0.25	0.13793103448275862	GO:0086005	GO:BP	ventricular cardiac muscle cell action potential	16175	17882		0.42424242424242425	0.43283582089552236	29	16146	4	12	25	16134	16175	0.1846204412469024
R1	cpdb	0	network_modules	334	TRUE	1.9268586483059738e-5	185	16	6	0.375	0.032432432432432434	GO:0060047	GO:BP	heart contraction	16175	14310		0.4393939393939394	0.44776119402985076	185	15990	6	10	179	15980	16175	0.10758857135608392
R1	cpdb	0	network_modules	334	TRUE	2.0199778383047234e-5	86	16	5	0.3125	0.05813953488372093	GO:0070252	GO:BP	actin-mediated cell contraction	16175	16020		0.45454545454545453	0.4626865671641791	86	16089	5	11	81	16078	16175	0.13291704653505004
R1	cpdb	0	network_modules	334	TRUE	2.2600905408301867e-5	190	16	6	0.375	0.031578947368421054	GO:1903522	GO:BP	regulation of blood circulation	16175	23072		0.4696969696969697	0.47761194029850745	190	15985	6	10	184	15975	16175	0.10608981695781088
R1	cpdb	0	network_modules	334	TRUE	2.3321439736274157e-5	191	16	6	0.375	0.031413612565445025	GO:0003015	GO:BP	heart process	16175	1466		0.48484848484848486	0.4925373134328358	191	15984	6	10	185	15974	16175	0.10579703117855885
R1	cpdb	0	network_modules	334	TRUE	2.5433306540549483e-5	90	16	5	0.3125	0.05555555555555555	GO:0061337	GO:BP	cardiac conduction	16175	15419		0.5	0.5074626865671642	90	16085	5	11	85	16074	16175	0.12984130766706134
R1	cpdb	0	network_modules	334	TRUE	3.5547800982188e-5	7	16	3	0.1875	0.42857142857142855	GO:1902260	GO:BP	negative regulation of delayed rectifier potassium channel activity	16175	22157		0.5151515151515151	0.5373134328358209	7	16168	3	13	4	16155	16175	0.28302030409478557
R1	cpdb	0	network_modules	334	TRUE	3.5547800982188e-5	7	16	3	0.1875	0.42857142857142855	GO:0060372	GO:BP	regulation of atrial cardiac muscle cell membrane repolarization	16175	14580		0.5151515151515151	0.5373134328358209	7	16168	3	13	4	16155	16175	0.28302030409478557
R1	cpdb	0	network_modules	334	TRUE	4.6510335265942274e-5	381	16	7	0.4375	0.01837270341207349	GO:0044057	GO:BP	regulation of system process	16175	10893		0.5454545454545454	0.5522388059701493	381	15794	7	9	374	15785	16175	0.08588775767889463
R1	cpdb	0	network_modules	334	TRUE	5.6842189822400436e-5	8	16	3	0.1875	0.375	GO:0098915	GO:BP	membrane repolarization during ventricular cardiac muscle cell action potential	16175	18948		0.5606060606060606	0.5671641791044776	8	16167	3	13	5	16154	16175	0.2646619434592659
R1	cpdb	0	network_modules	334	TRUE	7.00261140199362e-5	110	16	5	0.3125	0.045454545454545456	GO:0030048	GO:BP	actin filament-based movement	16175	6667		0.5757575757575758	0.582089552238806	110	16065	5	11	105	16054	16175	0.11704554632299653
R1	cpdb	0	network_modules	334	TRUE	7.328750227342781e-5	111	16	5	0.3125	0.04504504504504504	GO:0060048	GO:BP	cardiac muscle contraction	16175	14311		0.5909090909090909	0.5970149253731343	111	16064	5	11	106	16053	16175	0.11649718305465236
R1	cpdb	0	network_modules	334	TRUE	1.2165785869635541e-4	10	16	3	0.1875	0.3	GO:0099624	GO:BP	atrial cardiac muscle cell membrane repolarization	16175	19169		0.6060606060606061	0.6268656716417911	10	16165	3	13	7	16152	16175	0.23657895320640884
R1	cpdb	0	network_modules	334	TRUE	1.2165785869635541e-4	10	16	3	0.1875	0.3	GO:1903817	GO:BP	negative regulation of voltage-gated potassium channel activity	16175	23304		0.6060606060606061	0.6268656716417911	10	16165	3	13	7	16152	16175	0.23657895320640884
R1	cpdb	0	network_modules	334	TRUE	1.3954255740048833e-4	258	16	6	0.375	0.023255813953488372	GO:0006936	GO:BP	muscle contraction	16175	2575		0.6363636363636364	0.6417910447761194	258	15917	6	10	252	15907	16175	0.09018012974671964
R1	cpdb	0	network_modules	334	TRUE	1.5513727398737512e-4	48	16	4	0.25	0.08333333333333333	GO:1901016	GO:BP	regulation of potassium ion transmembrane transporter activity	16175	21138		0.6515151515151515	0.6567164179104478	48	16127	4	12	44	16115	16175	0.14290704771379337
R1	cpdb	0	network_modules	334	TRUE	2.699298615643529e-4	144	16	5	0.3125	0.034722222222222224	GO:0006941	GO:BP	striated muscle contraction	16175	2579		0.6666666666666666	0.6716417910447762	144	16031	5	11	139	16020	16175	0.10170293721792148
R1	cpdb	0	network_modules	334	TRUE	3.605440912360901e-4	303	16	6	0.375	0.019801980198019802	GO:0003012	GO:BP	muscle system process	16175	1463		0.6818181818181818	0.6865671641791045	303	15872	6	10	297	15862	16175	0.08268675873198948
R1	cpdb	0	network_modules	334	TRUE	4.7070228814104117e-4	63	16	4	0.25	0.06349206349206349	GO:0140115	GO:BP	export across plasma membrane	16175	19670		0.696969696969697	0.7014925373134329	63	16112	4	12	59	16100	16175	0.12432906090333104
R1	cpdb	0	network_modules	334	TRUE	5.34369843078998e-4	65	16	4	0.25	0.06153846153846154	GO:1904063	GO:BP	negative regulation of cation transmembrane transport	16175	23502		0.7121212121212122	0.7164179104477612	65	16110	4	12	61	16098	16175	0.1223474589747426
R1	cpdb	0	network_modules	334	TRUE	5.656858780843739e-4	16	16	3	0.1875	0.1875	GO:1901017	GO:BP	negative regulation of potassium ion transmembrane transporter activity	16175	21139		0.7272727272727273	0.7313432835820896	16	16159	3	13	13	16146	16175	0.18669549477071604
R1	cpdb	0	network_modules	334	TRUE	6.864901007004839e-4	17	16	3	0.1875	0.17647058823529413	GO:1902259	GO:BP	regulation of delayed rectifier potassium channel activity	16175	22156		0.7424242424242424	0.746268656716418	17	16158	3	13	14	16145	16175	0.18106679952472396
R1	cpdb	0	network_modules	334	TRUE	7.215319444867612e-4	70	16	4	0.25	0.05714285714285714	GO:0034766	GO:BP	negative regulation of monoatomic ion transmembrane transport	16175	8735		0.7575757575757576	0.7611940298507462	70	16105	4	12	66	16093	16175	0.11776708005625551
R1	cpdb	0	network_modules	334	TRUE	8.64569744315949e-4	182	16	5	0.3125	0.027472527472527472	GO:0032412	GO:BP	regulation of monoatomic ion transmembrane transporter activity	16175	7550		0.7727272727272727	0.7761194029850746	182	15993	5	11	177	15982	16175	0.08987122220216688
R1	cpdb	0	network_modules	334	TRUE	9.596161392541068e-4	358	16	6	0.375	0.01675977653631285	GO:0008015	GO:BP	blood circulation	16175	3096		0.7878787878787878	0.7910447761194029	358	15817	6	10	352	15807	16175	0.07547525895611118
R1	cpdb	0	network_modules	334	TRUE	9.77069032285153e-4	19	16	3	0.1875	0.15789473684210525	GO:0086013	GO:BP	membrane repolarization during cardiac muscle cell action potential	16175	17887		0.803030303030303	0.8059701492537313	19	16156	3	13	16	16143	16175	0.17116905694947215
R1	cpdb	0	network_modules	334	TRUE	0.0010696682901933773	190	16	5	0.3125	0.02631578947368421	GO:0022898	GO:BP	regulation of transmembrane transporter activity	16175	6629		0.8181818181818182	0.8208955223880597	190	15985	5	11	185	15974	16175	0.08783640998735463
R1	cpdb	0	network_modules	334	TRUE	0.0012193950929765447	153	4	3	0.75	0.0196078431372549	KEGG:04261	KEGG	Adrenergic signaling in cardiomyocytes	8484	297		NA	1	153	8331	3	1	150	8330	8484	0.11946189155522355
R1	cpdb	0	network_modules	334	TRUE	0.0013183620864797947	78	16	4	0.25	0.05128205128205128	REAC:R-HSA-422356	REAC	Regulation of insulin secretion	10916	2040		0.7142857142857143	0.75	78	10838	4	12	74	10826	10916	0.11046751776593043
R1	cpdb	0	network_modules	334	TRUE	0.0014832825758779782	203	16	5	0.3125	0.024630541871921183	GO:0032409	GO:BP	regulation of transporter activity	16175	7547		0.8333333333333334	0.835820895522388	203	15972	5	11	198	15961	16175	0.08478478067876641
R1	cpdb	0	network_modules	334	TRUE	0.0018154849388910866	88	16	4	0.25	0.045454545454545456	GO:0043271	GO:BP	negative regulation of monoatomic ion transport	16175	10595		0.8484848484848485	0.8507462686567164	88	16087	4	12	84	16075	16175	0.10461711047089432
R1	cpdb	0	network_modules	334	TRUE	0.0018997885119271694	89	16	4	0.25	0.0449438202247191	GO:0034763	GO:BP	negative regulation of transmembrane transport	16175	8732		0.8636363636363636	0.8656716417910447	89	16086	4	12	85	16074	16175	0.10400464837921364
R1	cpdb	0	network_modules	334	TRUE	0.002468232810987628	95	16	4	0.25	0.042105263157894736	GO:2001257	GO:BP	regulation of cation channel activity	16175	26443		0.8787878787878788	0.8805970149253731	95	16080	4	12	91	16068	16175	0.10053275055331819
R1	cpdb	0	network_modules	334	TRUE	0.002684924073080593	229	16	5	0.3125	0.021834061135371178	GO:1904062	GO:BP	regulation of monoatomic cation transmembrane transport	16175	23501		0.8939393939393939	0.8955223880597015	229	15946	5	11	224	15935	16175	0.07946361611542196
R1	cpdb	0	network_modules	334	TRUE	0.003147784688538523	439	16	6	0.375	0.01366742596810934	GO:0003013	GO:BP	circulatory system process	16175	1464		0.9090909090909091	0.9104477611940298	439	15736	6	10	433	15726	16175	0.06736297962441883
R1	cpdb	0	network_modules	334	TRUE	0.0036622703357273682	29	16	3	0.1875	0.10344827586206896	GO:1901381	GO:BP	positive regulation of potassium ion transmembrane transport	16175	21431		0.9242424242424242	0.9253731343283582	29	16146	3	13	26	16133	16175	0.1381319357800513
R1	cpdb	0	network_modules	334	TRUE	0.004499741868602681	31	16	3	0.1875	0.0967741935483871	GO:2001258	GO:BP	negative regulation of cation channel activity	16175	26444		0.9393939393939394	0.9552238805970149	31	16144	3	13	28	16131	16175	0.1335210968185333
R1	cpdb	0	network_modules	334	TRUE	0.004499741868602681	31	16	3	0.1875	0.0967741935483871	GO:0086019	GO:BP	cell-cell signaling involved in cardiac conduction	16175	17893		0.9393939393939394	0.9552238805970149	31	16144	3	13	28	16131	16175	0.1335210968185333
R1	cpdb	0	network_modules	334	TRUE	0.004649041062558586	107	16	4	0.25	0.037383177570093455	REAC:R-HSA-163685	REAC	Integration of energy metabolism	10916	1213		0.8571428571428571	0.875	107	10809	4	12	103	10797	10916	0.09341030334883643
R1	cpdb	0	network_modules	334	TRUE	0.005193749458581141	262	16	5	0.3125	0.019083969465648856	GO:0034765	GO:BP	regulation of monoatomic ion transmembrane transport	16175	8734		0.9696969696969697	0.9701492537313433	262	15913	5	11	257	15902	16175	0.07385929980985488
R1	cpdb	0	network_modules	334	TRUE	0.005979481751801745	34	16	3	0.1875	0.08823529411764706	GO:0043268	GO:BP	positive regulation of potassium ion transport	16175	10592		0.9848484848484849	0.9850746268656716	34	16141	3	13	31	16128	16175	0.1273788682887789
R1	cpdb	0	network_modules	334	TRUE	0.007698276447761462	284	16	5	0.3125	0.017605633802816902	GO:0010959	GO:BP	regulation of metal ion transport	16175	4536		1	1	284	15891	5	11	279	15880	16175	0.07066411698165276
R1	cpdb	0	network_modules	334	TRUE	0.009181471299251506	42	16	3	0.1875	0.07142857142857142	REAC:R-HSA-381676	REAC	Glucagon-like Peptide-1 (GLP1) regulates insulin secretion	10916	1049		1	1	42	10874	3	13	39	10861	10916	0.11365476673863673
R1	cpdb	0	network_modules	336	TRUE	0.007612402875442795	9	10	2	0.2	0.2222222222222222	REAC:R-HSA-1483115	REAC	Hydrolysis of LPC	10916	1137		NA	1	9	10907	2	8	7	10899	10916	0.21013230935567795
R1	cpdb	0	network_modules	336	TRUE	0.009598178880787414	112	9	3	0.3333333333333333	0.026785714285714284	KEGG:04726	KEGG	Serotonergic synapse	8484	356		NA	1	112	8372	3	6	109	8366	8484	0.09140238870750496
R1	cpdb	0	network_modules	337	TRUE	9.553767531203022e-151	90	71	68	0.9577464788732394	0.7555555555555555	REAC:R-HSA-156902	REAC	Peptide chain elongation	10916	1723		0	0.05405405405405406	90	10826	68	3	22	10823	10916	0.8496076299946331
R1	cpdb	0	network_modules	337	TRUE	9.553767531203022e-151	90	71	68	0.9577464788732394	0.7555555555555555	REAC:R-HSA-192823	REAC	Viral mRNA Translation	10916	2650		0	0.05405405405405406	90	10826	68	3	22	10823	10916	0.8496076299946331
R1	cpdb	0	network_modules	337	TRUE	1.9466493448254857e-148	94	71	68	0.9577464788732394	0.723404255319149	REAC:R-HSA-156842	REAC	Eukaryotic Translation Elongation	10916	870		0.05555555555555555	0.13513513513513514	94	10822	68	3	26	10819	10916	0.8311670954577073
R1	cpdb	0	network_modules	337	TRUE	1.9466493448254857e-148	94	71	68	0.9577464788732394	0.723404255319149	REAC:R-HSA-72764	REAC	Eukaryotic Translation Termination	10916	872		0.05555555555555555	0.13513513513513514	94	10822	68	3	26	10819	10916	0.8311670954577073
R1	cpdb	0	network_modules	337	TRUE	1.9466493448254857e-148	94	71	68	0.9577464788732394	0.723404255319149	REAC:R-HSA-2408557	REAC	Selenocysteine synthesis	10916	2188		0.05555555555555555	0.13513513513513514	94	10822	68	3	26	10819	10916	0.8311670954577073
R1	cpdb	0	network_modules	337	TRUE	2.347055943754853e-147	96	71	68	0.9577464788732394	0.7083333333333334	REAC:R-HSA-975956	REAC	Nonsense Mediated Decay (NMD) independent of the Exon Junction Complex (EJC)	10916	1607		0.1388888888888889	0.16216216216216217	96	10820	68	3	28	10817	10916	0.8223807652382579
R1	cpdb	0	network_modules	337	TRUE	2.346075382736165e-144	102	71	68	0.9577464788732394	0.6666666666666666	REAC:R-HSA-72689	REAC	Formation of a pool of free 40S subunits	10916	953		0.16666666666666666	0.21621621621621623	102	10814	68	3	34	10811	10916	0.7975855873713044
R1	cpdb	0	network_modules	337	TRUE	2.346075382736165e-144	102	71	68	0.9577464788732394	0.6666666666666666	REAC:R-HSA-9633012	REAC	Response of EIF2AK4 (GCN2) to amino acid deficiency	10916	2087		0.16666666666666666	0.21621621621621623	102	10814	68	3	34	10811	10916	0.7975855873713044
R1	cpdb	0	network_modules	337	TRUE	5.336453392635892e-140	112	71	68	0.9577464788732394	0.6071428571428571	REAC:R-HSA-156827	REAC	L13a-mediated translational silencing of Ceruloplasmin expression	10916	1293		0.2222222222222222	0.24324324324324326	112	10804	68	3	44	10801	10916	0.7607633250117157
R1	cpdb	0	network_modules	337	TRUE	1.3396760595033525e-139	113	71	68	0.9577464788732394	0.6017699115044248	REAC:R-HSA-72706	REAC	GTP hydrolysis and joining of the 60S ribosomal subunit	10916	1027		0.25	0.2972972972972973	113	10803	68	3	45	10800	10916	0.7573514565404688
R1	cpdb	0	network_modules	337	TRUE	1.3396760595033525e-139	113	71	68	0.9577464788732394	0.6017699115044248	REAC:R-HSA-1799339	REAC	SRP-dependent cotranslational protein targeting to membrane	10916	2157		0.25	0.2972972972972973	113	10803	68	3	45	10800	10916	0.7573514565404688
R1	cpdb	0	network_modules	337	TRUE	1.9615840578979503e-138	116	71	68	0.9577464788732394	0.5862068965517241	REAC:R-HSA-975957	REAC	Nonsense Mediated Decay (NMD) enhanced by the Exon Junction Complex (EJC)	10916	1606		0.3055555555555556	0.35135135135135137	116	10800	68	3	48	10797	10916	0.747380911232369
R1	cpdb	0	network_modules	337	TRUE	1.9615840578979503e-138	116	71	68	0.9577464788732394	0.5862068965517241	REAC:R-HSA-927802	REAC	Nonsense-Mediated Decay (NMD)	10916	1608		0.3055555555555556	0.35135135135135137	116	10800	68	3	48	10797	10916	0.747380911232369
R1	cpdb	0	network_modules	337	TRUE	4.68250023245231e-138	117	71	68	0.9577464788732394	0.5811965811965812	REAC:R-HSA-2408522	REAC	Selenoamino acid metabolism	10916	2187		0.3611111111111111	0.3783783783783784	117	10799	68	3	49	10796	10916	0.7441425939610723
R1	cpdb	0	network_modules	337	TRUE	5.9454912055062e-137	120	71	68	0.9577464788732394	0.5666666666666667	REAC:R-HSA-72613	REAC	Eukaryotic Translation Initiation	10916	871		0.3888888888888889	0.43243243243243246	120	10796	68	3	52	10793	10916	0.734670758849316
R1	cpdb	0	network_modules	337	TRUE	5.9454912055062e-137	120	71	68	0.9577464788732394	0.5666666666666667	REAC:R-HSA-72737	REAC	Cap-dependent Translation Initiation	10916	304		0.3888888888888889	0.43243243243243246	120	10796	68	3	52	10793	10916	0.734670758849316
R1	cpdb	0	network_modules	337	TRUE	1.2881160115689686e-132	133	71	68	0.9577464788732394	0.5112781954887218	REAC:R-HSA-168273	REAC	Influenza Viral RNA Transcription and Replication	10916	1186		0.4444444444444444	0.4594594594594595	133	10783	68	3	65	10780	10916	0.6973849222293176
R1	cpdb	0	network_modules	337	TRUE	5.059574292540546e-127	153	71	68	0.9577464788732394	0.4444444444444444	REAC:R-HSA-168255	REAC	Influenza Infection	10916	1185		0.4722222222222222	0.4864864864864865	153	10763	68	3	85	10760	10916	0.6495513089724261
R1	cpdb	0	network_modules	337	TRUE	5.0422340255195415e-126	157	71	68	0.9577464788732394	0.43312101910828027	REAC:R-HSA-9711097	REAC	Cellular response to starvation	10916	337		0.5	0.5135135135135135	157	10759	68	3	89	10756	10916	0.6410935476528595
R1	cpdb	0	network_modules	337	TRUE	2.1235224552623295e-123	158	71	64	0.9014084507042254	0.4050632911392405	GO:0002181	GO:BP	cytoplasmic translation	16175	729		0	0.047619047619047616	158	16017	64	7	94	16010	16175	0.601973171081629
R1	cpdb	0	network_modules	337	TRUE	8.858865448455364e-123	171	71	68	0.9577464788732394	0.39766081871345027	REAC:R-HSA-9010553	REAC	Regulation of expression of SLITs and ROBOs	10916	2031		0.5277777777777778	0.5405405405405406	171	10745	68	3	103	10742	10916	0.6138539962562508
R1	cpdb	0	network_modules	337	TRUE	1.2566830556326835e-121	153	70	68	0.9714285714285714	0.4444444444444444	KEGG:03010	KEGG	Ribosome	8484	208		0	0.5	153	8331	68	2	85	8329	8484	0.6534717877780324
R1	cpdb	0	network_modules	337	TRUE	1.833693742516783e-120	182	71	68	0.9577464788732394	0.37362637362637363	REAC:R-HSA-6791226	REAC	Major pathway of rRNA processing in the nucleolus and cytosol	10916	1389		0.5555555555555556	0.5675675675675675	182	10734	68	3	114	10731	10916	0.5946823821705047
R1	cpdb	0	network_modules	337	TRUE	1.6565680159167502e-118	192	71	68	0.9577464788732394	0.3541666666666667	REAC:R-HSA-8868773	REAC	rRNA processing in the nucleus and cytosol	10916	2734		0.5833333333333334	0.5945945945945946	192	10724	68	3	124	10721	10916	0.5786947945552321
R1	cpdb	0	network_modules	337	TRUE	1.1261446093771862e-116	202	71	68	0.9577464788732394	0.33663366336633666	REAC:R-HSA-72312	REAC	rRNA processing	10916	2732		0.6111111111111112	0.6216216216216216	202	10714	68	3	134	10711	10916	0.563902091903871
R1	cpdb	0	network_modules	337	TRUE	3.984724487195864e-114	217	71	68	0.9577464788732394	0.31336405529953915	REAC:R-HSA-376176	REAC	Signaling by ROBO receptors	10916	2301		0.6388888888888888	0.6486486486486487	217	10699	68	3	149	10696	10916	0.5436481365247845
R1	cpdb	0	network_modules	337	TRUE	8.864713624841194e-110	231	70	69	0.9857142857142858	0.2987012987012987	KEGG:05171	KEGG	Coronavirus disease - COVID-19	8484	452		1	1	231	8253	69	1	162	8252	8484	0.5371833489249883
R1	cpdb	0	network_modules	337	TRUE	6.259861337718465e-104	292	71	68	0.9577464788732394	0.2328767123287671	REAC:R-HSA-72766	REAC	Translation	10916	2565		0.6666666666666666	0.6756756756756757	292	10624	68	3	224	10621	10916	0.4668642648992873
R1	cpdb	0	network_modules	337	TRUE	4.0733880876743755e-96	370	71	68	0.9577464788732394	0.1837837837837838	REAC:R-HSA-71291	REAC	Metabolism of amino acids and derivatives	10916	1421		0.6944444444444444	0.7027027027027027	370	10546	68	3	302	10543	10916	0.4130810213229893
R1	cpdb	0	network_modules	337	TRUE	3.9330122717818976e-88	566	71	66	0.9295774647887324	0.1166077738515901	GO:0006412	GO:BP	translation	16175	2170		0.05	0.09523809523809523	566	15609	66	5	500	15604	16175	0.3232455332213387
R1	cpdb	0	network_modules	337	TRUE	2.4553127266687048e-48	37	71	26	0.36619718309859156	0.7027027027027027	REAC:R-HSA-9735869	REAC	SARS-CoV-1 modulates host translation machinery	10916	2116		0.7222222222222222	0.7297297297297297	37	10879	26	45	11	10834	10916	0.5050786654874382
R1	cpdb	0	network_modules	337	TRUE	6.733602563879321e-43	51	71	26	0.36619718309859156	0.5098039215686274	REAC:R-HSA-9754678	REAC	SARS-CoV-2 modulates host translation machinery	10916	2125		0.75	0.7567567567567568	51	10865	26	45	25	10820	10916	0.428959682554655
R1	cpdb	0	network_modules	337	TRUE	1.3413505163367325e-42	52	71	26	0.36619718309859156	0.5	REAC:R-HSA-72695	REAC	Formation of the ternary complex, and subsequently, the 43S complex	10916	973		0.7777777777777778	0.7837837837837838	52	10864	26	45	26	10819	10916	0.42472694746840967
R1	cpdb	0	network_modules	337	TRUE	1.0415986697304157e-40	59	71	26	0.36619718309859156	0.4406779661016949	REAC:R-HSA-72702	REAC	Ribosomal scanning and start codon recognition	10916	2106		0.8055555555555556	0.8378378378378378	59	10857	26	45	33	10812	10916	0.398156881390193
R1	cpdb	0	network_modules	337	TRUE	1.0415986697304157e-40	59	71	26	0.36619718309859156	0.4406779661016949	REAC:R-HSA-72649	REAC	Translation initiation complex formation	10916	2566		0.8055555555555556	0.8378378378378378	59	10857	26	45	33	10812	10916	0.398156881390193
R1	cpdb	0	network_modules	337	TRUE	1.8307810063135163e-40	60	71	26	0.36619718309859156	0.43333333333333335	REAC:R-HSA-72662	REAC	Activation of the mRNA upon binding of the cap-binding complex and eIFs, and subsequent binding to 43S	10916	105		0.8611111111111112	0.8648648648648649	60	10856	26	45	34	10811	10916	0.39474289579433974
R1	cpdb	0	network_modules	337	TRUE	3.1605303065731496e-36	251	71	32	0.4507042253521127	0.12749003984063745	GO:0042254	GO:BP	ribosome biogenesis	16175	10060		0.1	0.14285714285714285	251	15924	32	39	219	15885	16175	0.2337862706924683
R1	cpdb	0	network_modules	337	TRUE	3.408434254146157e-34	95	71	26	0.36619718309859156	0.2736842105263158	REAC:R-HSA-9692914	REAC	SARS-CoV-1-host interactions	10916	2119		0.8888888888888888	0.8918918918918919	95	10821	26	45	69	10776	10916	0.31142367005863403
R1	cpdb	0	network_modules	337	TRUE	4.371704169109504e-33	390	71	34	0.4788732394366197	0.08717948717948718	GO:0022613	GO:BP	ribonucleoprotein complex biogenesis	16175	6620		0.15	0.19047619047619047	390	15785	34	37	356	15748	16175	0.1968503142726901
R1	cpdb	0	network_modules	337	TRUE	2.4941084668655808e-29	140	71	26	0.36619718309859156	0.18571428571428572	REAC:R-HSA-9678108	REAC	SARS-CoV-1 Infection	10916	2114		0.9166666666666666	0.918918918918919	140	10776	26	45	114	10731	10916	0.2541073426678601
R1	cpdb	0	network_modules	337	TRUE	3.0194738461010075e-25	197	71	26	0.36619718309859156	0.1319796954314721	REAC:R-HSA-9705683	REAC	SARS-CoV-2-host interactions	10916	2128		0.9444444444444444	0.9459459459459459	197	10719	26	45	171	10674	10916	0.21160914028881844
R1	cpdb	0	network_modules	337	TRUE	6.566417716101127e-24	94	71	19	0.2676056338028169	0.20212765957446807	GO:0042274	GO:BP	ribosomal small subunit biogenesis	16175	10071		0.2	0.23809523809523808	94	16081	19	52	75	16029	16175	0.22868945769895965
R1	cpdb	0	network_modules	337	TRUE	4.908771126370226e-22	169	71	21	0.29577464788732394	0.1242603550295858	GO:0006364	GO:BP	rRNA processing	16175	2140		0.25	0.2857142857142857	169	16006	21	50	148	15956	16175	0.18632186369152007
R1	cpdb	0	network_modules	337	TRUE	1.0178825345629134e-20	292	71	26	0.36619718309859156	0.08904109589041095	REAC:R-HSA-9694516	REAC	SARS-CoV-2 Infection	10916	2122		0.9722222222222222	0.972972972972973	292	10624	26	45	266	10579	10916	0.17022174060885653
R1	cpdb	0	network_modules	337	TRUE	3.2204104855463547e-20	205	71	21	0.29577464788732394	0.1024390243902439	GO:0016072	GO:BP	rRNA metabolic process	16175	5099		0.3	0.3333333333333333	205	15970	21	50	184	15920	16175	0.16804215500229217
R1	cpdb	0	network_modules	337	TRUE	1.004206181737578e-15	459	71	26	0.36619718309859156	0.05664488017429194	REAC:R-HSA-9679506	REAC	SARS-CoV Infections	10916	2112		1	1	459	10457	26	45	433	10412	10916	0.1306810041679489
R1	cpdb	0	network_modules	337	TRUE	1.593546761180367e-13	47	71	11	0.15492957746478872	0.23404255319148937	GO:0042255	GO:BP	ribosome assembly	16175	10061		0.35	0.38095238095238093	47	16128	11	60	36	16068	16175	0.18753362487791164
R1	cpdb	0	network_modules	337	TRUE	1.1520030590126105e-12	15	71	8	0.11267605633802817	0.5333333333333333	GO:0000028	GO:BP	ribosomal small subunit assembly	16175	13		0.4	0.42857142857142855	15	16160	8	63	7	16097	16175	0.24377140020659097
R1	cpdb	0	network_modules	337	TRUE	7.701242801267538e-12	65	71	11	0.15492957746478872	0.16923076923076924	GO:0042273	GO:BP	ribosomal large subunit biogenesis	16175	10070		0.45	0.47619047619047616	65	16110	11	60	54	16050	16175	0.15838830763365874
R1	cpdb	0	network_modules	337	TRUE	6.360758780976086e-11	178	71	14	0.19718309859154928	0.07865168539325842	GO:0022618	GO:BP	protein-RNA complex assembly	16175	6625		0.5	0.5238095238095238	178	15997	14	57	164	15940	16175	0.11849683401609679
R1	cpdb	0	network_modules	337	TRUE	1.3609442842209557e-10	188	71	14	0.19718309859154928	0.07446808510638298	GO:0071826	GO:BP	protein-RNA complex organization	16175	16929		0.55	0.5714285714285714	188	15987	14	57	174	15930	16175	0.11495531564113022
R1	cpdb	0	network_modules	337	TRUE	4.025029920203566e-6	28	71	6	0.08450704225352113	0.21428571428571427	GO:1901798	GO:BP	positive regulation of signal transduction by p53 class mediator	16175	21742		0.6	0.6190476190476191	28	16147	6	65	22	16082	16175	0.1322165904416119
R1	cpdb	0	network_modules	337	TRUE	5.366325973313e-6	343	71	13	0.18309859154929578	0.037900874635568516	GO:0140694	GO:BP	membraneless organelle assembly	16175	19860		0.65	0.6666666666666666	343	15832	13	58	330	15774	16175	0.07461390615934514
R1	cpdb	0	network_modules	337	TRUE	1.0695883269513648e-5	90	71	8	0.11267605633802817	0.08888888888888889	GO:1901796	GO:BP	regulation of signal transduction by p53 class mediator	16175	21740		0.7	0.7142857142857143	90	16085	8	63	82	16022	16175	0.09561203809854482
R1	cpdb	0	network_modules	337	TRUE	3.236061497175523e-5	148	71	9	0.1267605633802817	0.060810810810810814	GO:0072331	GO:BP	signal transduction by p53 class mediator	16175	17354		0.75	0.7619047619047619	148	16027	9	62	139	15965	16175	0.08201555390337405
R1	cpdb	0	network_modules	337	TRUE	1.403130834742266e-4	10	71	4	0.056338028169014086	0.4	GO:1904667	GO:BP	negative regulation of ubiquitin protein ligase activity	16175	24007		0.8	0.8095238095238095	10	16165	4	67	6	16098	16175	0.14884292650298345
R1	cpdb	0	network_modules	337	TRUE	0.0011920798758613205	16	71	4	0.056338028169014086	0.25	GO:0051444	GO:BP	negative regulation of ubiquitin-protein transferase activity	16175	13707		0.85	0.8571428571428571	16	16159	4	67	12	16092	16175	0.1169089962746086
R1	cpdb	0	network_modules	337	TRUE	0.001448215433062739	39	71	5	0.07042253521126761	0.1282051282051282	GO:0051438	GO:BP	regulation of ubiquitin-protein transferase activity	16175	13705		0.9	0.9047619047619048	39	16136	5	66	34	16070	16175	0.092078470284626
R1	cpdb	0	network_modules	337	TRUE	0.0025136048596933183	19	71	4	0.056338028169014086	0.21052631578947367	GO:1904666	GO:BP	regulation of ubiquitin protein ligase activity	16175	24006		0.95	0.9523809523809523	19	16156	4	67	15	16089	16175	0.10693347902976721
R1	cpdb	0	network_modules	337	TRUE	0.0033667681495712283	46	71	5	0.07042253521126761	0.10869565217391304	GO:0030490	GO:BP	maturation of SSU-rRNA	16175	6815		1	1	46	16129	5	66	41	16063	16175	0.08426231670791265
R1	cpdb	0	network_modules	338	TRUE	1.784610152457187e-33	45	25	16	0.64	0.35555555555555557	GO:0042073	GO:BP	intraciliary transport	16175	9956		0	0.09090909090909091	45	16130	16	9	29	16121	16175	0.47598424344766915
R1	cpdb	0	network_modules	338	TRUE	7.650880070639402e-32	18	25	13	0.52	0.7222222222222222	GO:0035720	GO:BP	intraciliary anterograde transport	16175	9190		0.1	0.18181818181818182	18	16157	13	12	5	16145	16175	0.612328324491738
R1	cpdb	0	network_modules	338	TRUE	7.65115281344754e-31	54	18	15	0.8333333333333334	0.2777777777777778	REAC:R-HSA-5620924	REAC	Intraflagellar transport	10916	1267		0	0.25	54	10862	15	3	39	10859	10916	0.4798523142515414
R1	cpdb	0	network_modules	338	TRUE	7.616123816329479e-27	144	25	17	0.68	0.11805555555555555	GO:0010970	GO:BP	transport along microtubule	16175	4546		0.2	0.2727272727272727	144	16031	17	8	127	16023	16175	0.2810942848335067
R1	cpdb	0	network_modules	338	TRUE	8.125219327104943e-27	200	18	17	0.9444444444444444	0.085	REAC:R-HSA-5617833	REAC	Cilium Assembly	10916	361		0.3333333333333333	0.5	200	10716	17	1	183	10715	10916	0.28064904173276606
R1	cpdb	0	network_modules	338	TRUE	8.684912956018873e-26	165	25	17	0.68	0.10303030303030303	GO:0099111	GO:BP	microtubule-based transport	16175	19044		0.3	0.36363636363636365	165	16010	17	8	148	16002	16175	0.26226173754637305
R1	cpdb	0	network_modules	338	TRUE	6.617364454048427e-25	185	25	17	0.68	0.0918918918918919	GO:0030705	GO:BP	cytoskeleton-dependent intracellular transport	16175	6886		0.4	0.45454545454545453	185	15990	17	8	168	15982	16175	0.24737739402195844
R1	cpdb	0	network_modules	338	TRUE	7.782879555650504e-25	137	25	16	0.64	0.11678832116788321	GO:0031503	GO:BP	protein-containing complex localization	16175	7188		0.5	0.5454545454545454	137	16038	16	9	121	16029	16175	0.27113571225136673
R1	cpdb	0	network_modules	338	TRUE	6.279131544850872e-24	292	18	17	0.9444444444444444	0.05821917808219178	REAC:R-HSA-1852241	REAC	Organelle biogenesis and maintenance	10916	1646		0.6666666666666666	0.75	292	10624	17	1	275	10623	10916	0.23114747499532465
R1	cpdb	0	network_modules	338	TRUE	8.540314369967589e-24	368	25	19	0.76	0.051630434782608696	GO:0044782	GO:BP	cilium organization	16175	11155		0.6	0.6363636363636364	368	15807	19	6	349	15801	16175	0.19453309334620797
R1	cpdb	0	network_modules	338	TRUE	3.771292190951599e-22	348	25	18	0.72	0.05172413793103448	GO:0007018	GO:BP	microtubule-based movement	16175	2626		0.7	0.7272727272727273	348	15827	18	7	330	15820	16175	0.18940715825640095
R1	cpdb	0	network_modules	338	TRUE	3.165109162369547e-20	343	25	17	0.68	0.04956268221574344	GO:0060271	GO:BP	cilium assembly	16175	14488		0.8	0.8181818181818182	343	15832	17	8	326	15824	16175	0.1799131892565511
R1	cpdb	0	network_modules	338	TRUE	2.2390918535212487e-17	503	25	17	0.68	0.033797216699801194	GO:0120031	GO:BP	plasma membrane bounded cell projection assembly	16175	19467		0.9	0.9090909090909091	503	15672	17	8	486	15664	16175	0.14708262054470123
R1	cpdb	0	network_modules	338	TRUE	3.236376070701935e-17	514	25	17	0.68	0.033073929961089495	GO:0030031	GO:BP	cell projection assembly	16175	6655		1	1	514	15661	17	8	497	15653	16175	0.1453988165021258
R1	cpdb	0	network_modules	338	TRUE	0.00919335415152018	113	18	4	0.2222222222222222	0.035398230088495575	REAC:R-HSA-5610787	REAC	Hedgehog 'off' state	10916	1112		1	1	113	10803	4	14	109	10789	10916	0.08507174609235313
R1	cpdb	0	network_modules	339	TRUE	3.0467282709290228e-27	80	24	16	0.6666666666666666	0.2	REAC:R-HSA-380287	REAC	Centrosome maturation	10916	341		0	0.14285714285714285	80	10836	16	8	64	10828	10916	0.3628640384393017
R1	cpdb	0	network_modules	339	TRUE	3.0467282709290228e-27	80	24	16	0.6666666666666666	0.2	REAC:R-HSA-380270	REAC	Recruitment of mitotic centrosome proteins and complexes	10916	1951		0	0.14285714285714285	80	10836	16	8	64	10828	10916	0.3628640384393017
R1	cpdb	0	network_modules	339	TRUE	5.1364318539811645e-26	94	24	16	0.6666666666666666	0.1702127659574468	REAC:R-HSA-380320	REAC	Recruitment of NuMA to mitotic centrosomes	10916	1950		0.15384615384615385	0.21428571428571427	94	10822	16	8	78	10814	10916	0.3343182868641486
R1	cpdb	0	network_modules	339	TRUE	1.1576429806023001e-20	195	24	16	0.6666666666666666	0.08205128205128205	REAC:R-HSA-69275	REAC	G2/M Transition	10916	1008		0.23076923076923078	0.2857142857142857	195	10721	16	8	179	10713	10916	0.22992871596476822
R1	cpdb	0	network_modules	339	TRUE	1.3700500802598852e-20	197	24	16	0.6666666666666666	0.08121827411167512	REAC:R-HSA-453274	REAC	Mitotic G2-G2/M phases	10916	1481		0.3076923076923077	0.35714285714285715	197	10719	16	8	181	10711	10916	0.2287153222868074
R1	cpdb	0	network_modules	339	TRUE	1.6185372888610306e-20	199	24	16	0.6666666666666666	0.08040201005025126	REAC:R-HSA-68877	REAC	Mitotic Prometaphase	10916	1484		0.38461538461538464	0.42857142857142855	199	10717	16	8	183	10709	10916	0.22752004322992483
R1	cpdb	0	network_modules	339	TRUE	2.8067977724686696e-19	46	26	11	0.4230769230769231	0.2391304347826087	GO:0007020	GO:BP	microtubule nucleation	16175	2628		0	0.06666666666666667	46	16129	11	15	35	16114	16175	0.31663993813437896
R1	cpdb	0	network_modules	339	TRUE	3.886934306473043e-18	88	26	12	0.46153846153846156	0.13636363636363635	GO:0046785	GO:BP	microtubule polymerization	16175	12369		0.07142857142857142	0.13333333333333333	88	16087	12	14	76	16073	16175	0.24879257522314163
R1	cpdb	0	network_modules	339	TRUE	2.927985752649263e-16	124	26	12	0.46153846153846156	0.0967741935483871	GO:0031109	GO:BP	microtubule polymerization or depolymerization	16175	7034		0.14285714285714285	0.2	124	16051	12	14	112	16037	16175	0.20879973547713546
R1	cpdb	0	network_modules	339	TRUE	1.7344793789655916e-15	406	24	16	0.6666666666666666	0.03940886699507389	REAC:R-HSA-68886	REAC	M Phase	10916	1343		0.46153846153846156	0.5	406	10510	16	8	390	10502	10916	0.1561451311194216
R1	cpdb	0	network_modules	339	TRUE	1.3304495598950131e-14	238	26	13	0.5	0.0546218487394958	GO:0051258	GO:BP	protein polymerization	16175	13605		0.21428571428571427	0.26666666666666666	238	15937	13	13	225	15924	16175	0.16172013144939965
R1	cpdb	0	network_modules	339	TRUE	5.173613290496624e-11	586	26	14	0.5384615384615384	0.023890784982935155	GO:0000226	GO:BP	microtubule cytoskeleton organization	16175	61		0.2857142857142857	0.3333333333333333	586	15589	14	12	572	15577	16175	0.1078463058850838
R1	cpdb	0	network_modules	339	TRUE	1.1416626665464117e-10	176	26	10	0.38461538461538464	0.056818181818181816	GO:0007051	GO:BP	spindle organization	16175	2650		0.35714285714285715	0.4	176	15999	10	16	166	15983	16175	0.14455012165869702
R1	cpdb	0	network_modules	339	TRUE	3.301308989114282e-8	748	26	13	0.5	0.017379679144385027	GO:0097435	GO:BP	supramolecular fiber organization	16175	18657		0.42857142857142855	0.4666666666666667	748	15427	13	13	735	15414	16175	0.08669395037141796
R1	cpdb	0	network_modules	339	TRUE	6.746125772764911e-8	792	26	13	0.5	0.016414141414141416	GO:0000278	GO:BP	mitotic cell cycle	16175	76		0.5	0.5333333333333333	792	15383	13	13	779	15370	16175	0.08386597642496445
R1	cpdb	0	network_modules	339	TRUE	1.7745997426797433e-6	68	24	6	0.25	0.08823529411764706	REAC:R-HSA-380284	REAC	Loss of proteins required for interphase microtubule organization from the centrosome	10916	1335		0.5384615384615384	0.6428571428571429	68	10848	6	18	62	10830	10916	0.14543448067558773
R1	cpdb	0	network_modules	339	TRUE	1.7745997426797433e-6	68	24	6	0.25	0.08823529411764706	REAC:R-HSA-380259	REAC	Loss of Nlp from mitotic centrosomes	10916	1331		0.5384615384615384	0.6428571428571429	68	10848	6	18	62	10830	10916	0.14543448067558773
R1	cpdb	0	network_modules	339	TRUE	2.312183772355005e-6	71	24	6	0.25	0.08450704225352113	REAC:R-HSA-8854518	REAC	AURKA Activation by TPX2	10916	41		0.6923076923076923	0.7142857142857143	71	10845	6	18	65	10827	10916	0.14218796171712705
R1	cpdb	0	network_modules	339	TRUE	3.861819616352607e-6	361	26	9	0.34615384615384615	0.024930747922437674	GO:0007059	GO:BP	chromosome segregation	16175	2658		0.5714285714285714	0.6	361	15814	9	17	352	15797	16175	0.08796462822876482
R1	cpdb	0	network_modules	339	TRUE	6.921798303867402e-6	85	24	6	0.25	0.07058823529411765	REAC:R-HSA-2565942	REAC	Regulation of PLK1 Activity at G2/M Transition	10916	1998		0.7692307692307693	0.7857142857142857	85	10831	6	18	79	10813	10916	0.12935091779787639
R1	cpdb	0	network_modules	339	TRUE	1.4444396867932576e-5	96	24	6	0.25	0.0625	REAC:R-HSA-5620912	REAC	Anchoring of the basal body to the plasma membrane	10916	147		0.8461538461538461	0.8571428571428571	96	10820	6	18	90	10802	10916	0.12127001093282319
R1	cpdb	0	network_modules	339	TRUE	2.4472337384836274e-5	52	26	5	0.19230769230769232	0.09615384615384616	GO:0031122	GO:BP	cytoplasmic microtubule organization	16175	7047		0.6428571428571429	0.6666666666666666	52	16123	5	21	47	16102	16175	0.1340320516224091
R1	cpdb	0	network_modules	339	TRUE	2.9016909873050345e-5	113	26	6	0.23076923076923078	0.05309734513274336	GO:0051225	GO:BP	spindle assembly	16175	13578		0.7142857142857143	0.7333333333333333	113	16062	6	20	107	16042	16175	0.10780688039343585
R1	cpdb	0	network_modules	339	TRUE	3.300436304727354e-5	203	26	7	0.2692307692307692	0.034482758620689655	GO:0051321	GO:BP	meiotic cell cycle	16175	13648		0.7857142857142857	0.8	203	15972	7	19	196	15953	16175	0.09251739932656648
R1	cpdb	0	network_modules	339	TRUE	5.86086461154132e-5	343	26	8	0.3076923076923077	0.023323615160349854	GO:0140694	GO:BP	membraneless organelle assembly	16175	19860		0.8571428571428571	0.8666666666666667	343	15832	8	18	335	15814	16175	0.07978986427525442
R1	cpdb	0	network_modules	339	TRUE	0.0011071278388045803	200	24	6	0.25	0.03	REAC:R-HSA-5617833	REAC	Cilium Assembly	10916	361		0.9230769230769231	0.9285714285714286	200	10716	6	18	194	10698	10916	0.08109037028750621
R1	cpdb	0	network_modules	339	TRUE	0.0024488641563113994	193	4	3	0.75	0.015544041450777202	KEGG:04814	KEGG	Motor proteins	8484	366		NA	1	193	8291	3	1	190	8290	8484	0.10593393907282753
R1	cpdb	0	network_modules	339	TRUE	0.003450794777497106	2	26	2	0.07692307692307693	1	GO:0033566	GO:BP	gamma-tubulin complex localization	16175	8292		0.9285714285714286	0.9333333333333333	2	16173	2	24	0	16149	16175	0.27714423421480233
R1	cpdb	0	network_modules	339	TRUE	0.005519345260389914	153	26	5	0.19230769230769232	0.032679738562091505	GO:1902850	GO:BP	microtubule cytoskeleton organization involved in mitosis	16175	22560		1	1	153	16022	5	21	148	16001	16175	0.07579591961800518
R1	cpdb	0	network_modules	339	TRUE	0.009627686215629112	292	24	6	0.25	0.02054794520547945	REAC:R-HSA-1852241	REAC	Organelle biogenesis and maintenance	10916	1646		1	1	292	10624	6	18	286	10606	10916	0.0649489114974987
R1	cpdb	0	network_modules	340	TRUE	1.2101226139872578e-28	20	18	12	0.6666666666666666	0.6	REAC:R-HSA-190840	REAC	Microtubule-dependent trafficking of connexons from Golgi to the plasma membrane	10916	1451		0	0.015625	20	10896	12	6	8	10890	10916	0.6318171011020474
R1	cpdb	0	network_modules	340	TRUE	2.822184290539153e-28	21	18	12	0.6666666666666666	0.5714285714285714	REAC:R-HSA-190872	REAC	Transport of connexons to the plasma membrane	10916	2592		0.015873015873015872	0.03125	21	10895	12	6	9	10889	10916	0.6165336864408811
R1	cpdb	0	network_modules	340	TRUE	2.9105808464664246e-26	28	18	12	0.6666666666666666	0.42857142857142855	REAC:R-HSA-9619483	REAC	Activation of AMPK downstream of NMDARs	10916	73		0.031746031746031744	0.046875	28	10888	12	6	16	10882	10916	0.5335902048489889
R1	cpdb	0	network_modules	340	TRUE	2.1558657367522155e-25	32	18	12	0.6666666666666666	0.375	REAC:R-HSA-5626467	REAC	RHO GTPases activate IQGAPs	10916	1854		0.047619047619047616	0.078125	32	10884	12	6	20	10878	10916	0.49894418532797014
R1	cpdb	0	network_modules	340	TRUE	2.1558657367522155e-25	32	18	12	0.6666666666666666	0.375	REAC:R-HSA-9668328	REAC	Sealing of the nuclear envelope (NE) by ESCRT-III	10916	2185		0.047619047619047616	0.078125	32	10884	12	6	20	10878	10916	0.49894418532797014
R1	cpdb	0	network_modules	340	TRUE	2.5772093004302295e-24	38	18	12	0.6666666666666666	0.3157894736842105	REAC:R-HSA-190861	REAC	Gap junction assembly	10916	1033		0.07936507936507936	0.09375	38	10878	12	6	26	10872	10916	0.45760957105449
R1	cpdb	0	network_modules	340	TRUE	3.7222069957885275e-24	24	18	11	0.6111111111111112	0.4583333333333333	REAC:R-HSA-389977	REAC	Post-chaperonin tubulin folding pathway	10916	1773		0.09523809523809523	0.109375	24	10892	11	7	13	10885	10916	0.5283501470524657
R1	cpdb	0	network_modules	340	TRUE	1.150754773649925e-23	26	18	11	0.6111111111111112	0.4230769230769231	REAC:R-HSA-389960	REAC	Formation of tubulin folding intermediates by CCT/TriC	10916	975		0.1111111111111111	0.125	26	10890	11	7	15	10883	10916	0.5075162592745024
R1	cpdb	0	network_modules	340	TRUE	1.4563554014756986e-23	43	18	12	0.6666666666666666	0.27906976744186046	REAC:R-HSA-9609736	REAC	Assembly and cell surface presentation of NMDA receptors	10916	173		0.12698412698412698	0.140625	43	10873	12	6	31	10867	10916	0.42998414768788473
R1	cpdb	0	network_modules	340	TRUE	2.0014689582569872e-23	44	18	12	0.6666666666666666	0.2727272727272727	REAC:R-HSA-9646399	REAC	Aggrephagy	10916	129		0.14285714285714285	0.15625	44	10872	12	6	32	10866	10916	0.42503067013514534
R1	cpdb	0	network_modules	340	TRUE	2.727885920237064e-23	45	18	12	0.6666666666666666	0.26666666666666666	REAC:R-HSA-8955332	REAC	Carboxyterminal post-translational modifications of tubulin	10916	305		0.15873015873015872	0.171875	45	10871	12	6	33	10865	10916	0.42024279888382327
R1	cpdb	0	network_modules	340	TRUE	6.597962977796367e-23	48	18	12	0.6666666666666666	0.25	REAC:R-HSA-437239	REAC	Recycling pathway of L1	10916	1954		0.1746031746031746	0.1875	48	10868	12	6	36	10862	10916	0.40678569023491673
R1	cpdb	0	network_modules	340	TRUE	8.368284467919866e-23	115	18	14	0.7777777777777778	0.12173913043478261	REAC:R-HSA-9648025	REAC	EML4 and NUDC in mitotic spindle formation	10916	817		0.19047619047619047	0.203125	115	10801	14	4	101	10797	10916	0.3054065075390159
R1	cpdb	0	network_modules	340	TRUE	8.733391495771231e-23	49	18	12	0.6666666666666666	0.24489795918367346	REAC:R-HSA-190828	REAC	Gap junction trafficking	10916	1035		0.20634920634920634	0.21875	49	10867	12	6	37	10861	10916	0.40257624897849803
R1	cpdb	0	network_modules	340	TRUE	1.1485450039872983e-22	50	18	12	0.6666666666666666	0.24	REAC:R-HSA-157858	REAC	Gap junction trafficking and regulation	10916	1036		0.2222222222222222	0.234375	50	10866	12	6	38	10860	10916	0.39849335483348775
R1	cpdb	0	network_modules	340	TRUE	2.520141250451282e-22	53	18	12	0.6666666666666666	0.22641509433962265	REAC:R-HSA-6811436	REAC	COPI-independent Golgi-to-ER retrograde traffic	10916	278		0.23809523809523808	0.25	53	10863	12	6	41	10857	10916	0.3869437199180836
R1	cpdb	0	network_modules	340	TRUE	2.87071792782283e-22	33	18	11	0.6111111111111112	0.3333333333333333	REAC:R-HSA-389958	REAC	Cooperation of Prefoldin and TriC/CCT  in actin and tubulin folding	10916	411		0.25396825396825395	0.265625	33	10883	11	7	22	10876	10916	0.4501544469277446
R1	cpdb	0	network_modules	340	TRUE	6.667693056611696e-22	57	18	12	0.6666666666666666	0.21052631578947367	REAC:R-HSA-3371497	REAC	HSP90 chaperone cycle for steroid hormone receptors (SHR) in the presence of ligand	10916	1111		0.2698412698412698	0.28125	57	10859	12	6	45	10853	10916	0.37298189746692806
R1	cpdb	0	network_modules	340	TRUE	1.317181056945941e-21	60	18	12	0.6666666666666666	0.2	REAC:R-HSA-983189	REAC	Kinesins	10916	1292		0.2857142857142857	0.296875	60	10856	12	6	48	10850	10916	0.3634369439505251
R1	cpdb	0	network_modules	340	TRUE	9.963153871050745e-21	70	18	12	0.6666666666666666	0.17142857142857143	REAC:R-HSA-2995410	REAC	Nuclear Envelope (NE) Reassembly	10916	1612		0.30158730158730157	0.3125	70	10846	12	6	58	10840	10916	0.3361658857833226
R1	cpdb	0	network_modules	340	TRUE	1.437278722071643e-20	72	18	12	0.6666666666666666	0.16666666666666666	REAC:R-HSA-1445148	REAC	Translocation of SLC2A4 (GLUT4) to the plasma membrane	10916	2578		0.31746031746031744	0.328125	72	10844	12	6	60	10838	10916	0.3314026104748584
R1	cpdb	0	network_modules	340	TRUE	2.440222860730091e-20	75	18	12	0.6666666666666666	0.16	REAC:R-HSA-9833482	REAC	PKR-mediated signaling	10916	1692		0.3333333333333333	0.34375	75	10841	12	6	63	10835	10916	0.32461662944276454
R1	cpdb	0	network_modules	340	TRUE	2.896285133605308e-20	76	18	12	0.6666666666666666	0.15789473684210525	REAC:R-HSA-438064	REAC	Post NMDA receptor activation events	10916	1772		0.3492063492063492	0.359375	76	10840	12	6	64	10834	10916	0.3224440203191877
R1	cpdb	0	network_modules	340	TRUE	4.7737112446358416e-20	79	18	12	0.6666666666666666	0.1518987341772152	REAC:R-HSA-8852276	REAC	The role of GTSE1 in G2/M progression after G2 checkpoint	10916	2503		0.36507936507936506	0.375	79	10837	12	6	67	10831	10916	0.3161744138514068
R1	cpdb	0	network_modules	340	TRUE	5.613262497755956e-20	80	18	12	0.6666666666666666	0.15	REAC:R-HSA-9663891	REAC	Selective autophagy	10916	2186		0.38095238095238093	0.390625	80	10836	12	6	68	10830	10916	0.31416295694414587
R1	cpdb	0	network_modules	340	TRUE	2.201532685437014e-19	89	18	12	0.6666666666666666	0.1348314606741573	REAC:R-HSA-442755	REAC	Activation of NMDA receptors and postsynaptic events	10916	89		0.3968253968253968	0.40625	89	10827	12	6	77	10821	10916	0.29760620838527896
R1	cpdb	0	network_modules	340	TRUE	2.5053664055799736e-19	199	18	14	0.7777777777777778	0.07035175879396985	REAC:R-HSA-68877	REAC	Mitotic Prometaphase	10916	1484		0.4126984126984127	0.421875	199	10717	14	4	185	10713	10916	0.23073753703043712
R1	cpdb	0	network_modules	340	TRUE	4.41760292676005e-19	94	18	12	0.6666666666666666	0.1276595744680851	REAC:R-HSA-380320	REAC	Recruitment of NuMA to mitotic centrosomes	10916	1950		0.42857142857142855	0.4375	94	10822	12	6	82	10816	10916	0.28944841713575087
R1	cpdb	0	network_modules	340	TRUE	8.529225824440469e-19	99	18	12	0.6666666666666666	0.12121212121212122	REAC:R-HSA-6811434	REAC	COPI-dependent Golgi-to-ER retrograde traffic	10916	277		0.4444444444444444	0.453125	99	10817	12	6	87	10811	10916	0.28191323161861515
R1	cpdb	0	network_modules	340	TRUE	1.2446556381791913e-18	102	18	12	0.6666666666666666	0.11764705882352941	REAC:R-HSA-6807878	REAC	COPI-mediated anterograde transport	10916	279		0.4603174603174603	0.46875	102	10814	12	6	90	10808	10916	0.2776589413663657
R1	cpdb	0	network_modules	340	TRUE	8.66595166793253e-18	119	18	12	0.6666666666666666	0.10084033613445378	REAC:R-HSA-373760	REAC	L1CAM interactions	10916	1294		0.47619047619047616	0.484375	119	10797	12	6	107	10791	10916	0.25665500462303237
R1	cpdb	0	network_modules	340	TRUE	1.310965857023627e-17	123	18	12	0.6666666666666666	0.0975609756097561	REAC:R-HSA-2500257	REAC	Resolution of Sister Chromatid Cohesion	10916	2079		0.49206349206349204	0.515625	123	10793	12	6	111	10787	10916	0.25235294498889876
R1	cpdb	0	network_modules	340	TRUE	1.310965857023627e-17	123	18	12	0.6666666666666666	0.0975609756097561	REAC:R-HSA-2132295	REAC	MHC class II antigen presentation	10916	1371		0.49206349206349204	0.515625	123	10793	12	6	111	10787	10916	0.25235294498889876
R1	cpdb	0	network_modules	340	TRUE	2.0642835633985593e-17	88	16	11	0.6875	0.125	KEGG:04540	KEGG	Gap junction	8484	318		0	0.09090909090909091	88	8396	11	5	77	8391	8484	0.2905113800399248
R1	cpdb	0	network_modules	340	TRUE	3.4783321682097594e-17	133	18	12	0.6666666666666666	0.09022556390977443	REAC:R-HSA-8856688	REAC	Golgi-to-ER retrograde transport	10916	1084		0.5238095238095238	0.53125	133	10783	12	6	121	10777	10916	0.24245376744150282
R1	cpdb	0	network_modules	340	TRUE	3.818503205418615e-17	134	18	12	0.6666666666666666	0.08955223880597014	REAC:R-HSA-1632852	REAC	Macroautophagy	10916	1388		0.5396825396825397	0.546875	134	10782	12	6	122	10776	10916	0.24152478498811003
R1	cpdb	0	network_modules	340	TRUE	4.1888898140790674e-17	135	18	12	0.6666666666666666	0.08888888888888889	REAC:R-HSA-9609690	REAC	HCMV Early Events	10916	1088		0.5555555555555556	0.5625	135	10781	12	6	123	10775	10916	0.2406060583029406
R1	cpdb	0	network_modules	340	TRUE	4.591908880344627e-17	136	18	12	0.6666666666666666	0.08823529411764706	REAC:R-HSA-5663220	REAC	RHO GTPases Activate Formins	10916	1848		0.5714285714285714	0.578125	136	10780	12	6	124	10774	10916	0.23969739880929336
R1	cpdb	0	network_modules	340	TRUE	5.012832030202291e-17	147	16	12	0.75	0.08163265306122448	KEGG:04145	KEGG	Phagosome	8484	281		0.1	0.18181818181818182	147	8337	12	4	135	8333	8484	0.24407146296778892
R1	cpdb	0	network_modules	340	TRUE	6.783195338017054e-17	91	18	11	0.6111111111111112	0.12087912087912088	REAC:R-HSA-390466	REAC	Chaperonin-mediated protein folding	10916	345		0.5873015873015873	0.59375	91	10825	11	7	80	10818	10916	0.2694305031080921
R1	cpdb	0	network_modules	340	TRUE	1.2066021139377314e-16	147	18	12	0.6666666666666666	0.08163265306122448	REAC:R-HSA-1169410	REAC	Antiviral mechanism by IFN-stimulated genes	10916	157		0.6031746031746031	0.609375	147	10769	12	6	135	10763	10916	0.23031717655544193
R1	cpdb	0	network_modules	340	TRUE	1.426613504829246e-16	149	18	12	0.6666666666666666	0.08053691275167785	REAC:R-HSA-9612973	REAC	Autophagy	10916	193		0.6190476190476191	0.625	149	10767	12	6	137	10761	10916	0.2287232744834736
R1	cpdb	0	network_modules	340	TRUE	1.59930516305859e-16	98	18	11	0.6111111111111112	0.11224489795918367	REAC:R-HSA-391251	REAC	Protein folding	10916	1812		0.6349206349206349	0.640625	98	10818	11	7	87	10811	10916	0.2594374190412198
R1	cpdb	0	network_modules	340	TRUE	2.3257195083517473e-16	155	18	12	0.6666666666666666	0.07741935483870968	REAC:R-HSA-199977	REAC	ER to Golgi Anterograde Transport	10916	823		0.6507936507936508	0.65625	155	10761	12	6	143	10755	10916	0.22412638239571175
R1	cpdb	0	network_modules	340	TRUE	3.0010294510339767e-16	586	25	17	0.68	0.02901023890784983	GO:0000226	GO:BP	microtubule cytoskeleton organization	16175	61		0	0.5	586	15589	17	8	569	15581	16175	0.13555067134437812
R1	cpdb	0	network_modules	340	TRUE	3.1867054806084235e-16	159	18	12	0.6666666666666666	0.07547169811320754	REAC:R-HSA-9609646	REAC	HCMV Infection	10916	1089		0.6666666666666666	0.671875	159	10757	12	6	147	10751	10916	0.22120606250967584
R1	cpdb	0	network_modules	340	TRUE	6.763579524341192e-16	169	18	12	0.6666666666666666	0.07100591715976332	REAC:R-HSA-983231	REAC	Factors involved in megakaryocyte development and platelet production	10916	931		0.6825396825396826	0.6875	169	10747	12	6	157	10741	10916	0.21435995595796434
R1	cpdb	0	network_modules	340	TRUE	1.4415556844946195e-15	193	16	12	0.75	0.06217616580310881	KEGG:04814	KEGG	Motor proteins	8484	366		0.2	0.2727272727272727	193	8291	12	4	181	8287	8484	0.2120179439499585
R1	cpdb	0	network_modules	340	TRUE	2.1983464160822988e-15	186	18	12	0.6666666666666666	0.06451612903225806	REAC:R-HSA-948021	REAC	Transport to the Golgi and subsequent modification	10916	2604		0.6984126984126984	0.703125	186	10730	12	6	174	10724	10916	0.20400199655552795
R1	cpdb	0	network_modules	340	TRUE	2.5066699847177753e-15	188	18	12	0.6666666666666666	0.06382978723404255	REAC:R-HSA-2467813	REAC	Separation of Sister Chromatids	10916	2204		0.7142857142857143	0.71875	188	10728	12	6	176	10722	10916	0.2028756576374868
R1	cpdb	0	network_modules	340	TRUE	3.924220376390058e-15	195	18	12	0.6666666666666666	0.06153846153846154	REAC:R-HSA-69275	REAC	G2/M Transition	10916	1008		0.7301587301587301	0.734375	195	10721	12	6	183	10715	10916	0.19906928667979698
R1	cpdb	0	network_modules	340	TRUE	4.177992193745586e-15	196	18	12	0.6666666666666666	0.061224489795918366	REAC:R-HSA-112314	REAC	Neurotransmitter receptors and postsynaptic signal transmission	10916	1594		0.746031746031746	0.75	196	10720	12	6	184	10714	10916	0.19854203110310883
R1	cpdb	0	network_modules	340	TRUE	4.4467026643107105e-15	197	18	12	0.6666666666666666	0.06091370558375635	REAC:R-HSA-453274	REAC	Mitotic G2-G2/M phases	10916	1481		0.7619047619047619	0.765625	197	10719	12	6	185	10713	10916	0.1980187462419926
R1	cpdb	0	network_modules	340	TRUE	5.350590905259828e-15	200	18	12	0.6666666666666666	0.06	REAC:R-HSA-5617833	REAC	Cilium Assembly	10916	361		0.7777777777777778	0.78125	200	10716	12	6	188	10710	10916	0.19647221948662724
R1	cpdb	0	network_modules	340	TRUE	6.043458415263806e-15	202	18	12	0.6666666666666666	0.0594059405940594	REAC:R-HSA-6811442	REAC	Intra-Golgi and retrograde Golgi-to-ER traffic	10916	1262		0.7936507936507936	0.796875	202	10714	12	6	190	10708	10916	0.19546016011710773
R1	cpdb	0	network_modules	340	TRUE	6.420088527791112e-15	406	18	14	0.7777777777777778	0.034482758620689655	REAC:R-HSA-68886	REAC	M Phase	10916	1343		0.8095238095238095	0.8125	406	10510	14	4	392	10506	10916	0.1590511153761777
R1	cpdb	0	network_modules	340	TRUE	8.280352541651323e-15	28	18	8	0.4444444444444444	0.2857142857142857	REAC:R-HSA-389957	REAC	Prefoldin mediated transfer of substrate  to CCT/TriC	10916	1788		0.8253968253968254	0.828125	28	10888	8	10	20	10878	10916	0.3550398193382427
R1	cpdb	0	network_modules	340	TRUE	1.2767141771212735e-14	54	18	9	0.5	0.16666666666666666	REAC:R-HSA-5620924	REAC	Intraflagellar transport	10916	1267		0.8412698412698413	0.84375	54	10862	9	9	45	10853	10916	0.2867651768890441
R1	cpdb	0	network_modules	340	TRUE	2.6499538611344765e-14	228	18	12	0.6666666666666666	0.05263157894736842	REAC:R-HSA-68882	REAC	Mitotic Anaphase	10916	1479		0.8571428571428571	0.859375	228	10688	12	6	216	10682	10916	0.18352500801704197
R1	cpdb	0	network_modules	340	TRUE	2.795049031704992e-14	229	18	12	0.6666666666666666	0.05240174672489083	REAC:R-HSA-2555396	REAC	Mitotic Metaphase and Anaphase	10916	1482		0.873015873015873	0.875	229	10687	12	6	217	10681	10916	0.18310644868996215
R1	cpdb	0	network_modules	340	TRUE	3.238320131964341e-14	249	16	12	0.75	0.04819277108433735	KEGG:05132	KEGG	Salmonella infection	8484	429		0.3	0.36363636363636365	249	8235	12	4	237	8231	8484	0.1855938264035937
R1	cpdb	0	network_modules	340	TRUE	4.835902545376018e-14	792	25	17	0.68	0.021464646464646464	GO:0000278	GO:BP	mitotic cell cycle	16175	76		1	1	792	15383	17	8	775	15375	16175	0.115053211300613
R1	cpdb	0	network_modules	340	TRUE	1.2479164353358772e-13	259	18	12	0.6666666666666666	0.04633204633204633	REAC:R-HSA-112315	REAC	Transmission across Chemical Synapses	10916	2580		0.8888888888888888	0.890625	259	10657	12	6	247	10651	10916	0.17168386309136502
R1	cpdb	0	network_modules	340	TRUE	1.502763631727994e-13	263	18	12	0.6666666666666666	0.045627376425855515	REAC:R-HSA-913531	REAC	Interferon Signaling	10916	1227		0.9047619047619048	0.90625	263	10653	12	6	251	10647	10916	0.1703081429812189
R1	cpdb	0	network_modules	340	TRUE	1.9864418358960005e-13	197	16	11	0.6875	0.05583756345177665	KEGG:05130	KEGG	Pathogenic Escherichia coli infection	8484	427		0.4	0.45454545454545453	197	8287	11	5	186	8282	8484	0.1917297490610789
R1	cpdb	0	network_modules	340	TRUE	5.328541947074216e-13	292	18	12	0.6666666666666666	0.0410958904109589	REAC:R-HSA-1852241	REAC	Organelle biogenesis and maintenance	10916	1646		0.9206349206349206	0.921875	292	10624	12	6	280	10618	10916	0.16118125355493768
R1	cpdb	0	network_modules	340	TRUE	9.015079733009392e-13	305	18	12	0.6666666666666666	0.03934426229508197	REAC:R-HSA-446203	REAC	Asparagine N-linked glycosylation	10916	169		0.9365079365079365	0.9375	305	10611	12	6	293	10605	10916	0.15751173507519448
R1	cpdb	0	network_modules	340	TRUE	1.4910614880462534e-12	318	18	12	0.6666666666666666	0.03773584905660377	REAC:R-HSA-195258	REAC	RHO GTPase Effectors	10916	1846		0.9523809523809523	0.953125	318	10598	12	6	306	10592	10916	0.15406534887388754
R1	cpdb	0	network_modules	340	TRUE	5.375356908011106e-12	265	16	11	0.6875	0.04150943396226415	KEGG:05012	KEGG	Parkinson disease	8484	412		0.5	0.5454545454545454	265	8219	11	5	254	8214	8484	0.16398981126941176
R1	cpdb	0	network_modules	340	TRUE	6.8859721632262355e-12	271	16	11	0.6875	0.04059040590405904	KEGG:05020	KEGG	Prion disease	8484	416		0.6	0.6363636363636364	271	8213	11	5	260	8208	8484	0.16204867087141392
R1	cpdb	0	network_modules	340	TRUE	1.3714670141096874e-11	113	18	9	0.5	0.07964601769911504	REAC:R-HSA-5610787	REAC	Hedgehog 'off' state	10916	1112		0.9682539682539683	0.96875	113	10803	9	9	104	10794	10916	0.19660707882645434
R1	cpdb	0	network_modules	340	TRUE	2.3407512197257087e-11	400	18	12	0.6666666666666666	0.03	REAC:R-HSA-112316	REAC	Neuronal System	10916	1590		0.9841269841269841	0.984375	400	10516	12	6	388	10510	10916	0.13627859291355565
R1	cpdb	0	network_modules	340	TRUE	2.5377252388305318e-11	305	16	11	0.6875	0.036065573770491806	KEGG:05016	KEGG	Huntington disease	8484	414		0.7	0.7272727272727273	305	8179	11	5	294	8174	8484	0.15213107570600953
R1	cpdb	0	network_modules	340	TRUE	1.7171010155837183e-10	363	16	11	0.6875	0.030303030303030304	KEGG:05014	KEGG	Amyotrophic lateral sclerosis	8484	413		0.8	0.8181818181818182	363	8121	11	5	352	8116	8484	0.13847742393113774
R1	cpdb	0	network_modules	340	TRUE	1.7434643100493246e-10	149	18	9	0.5	0.06040268456375839	REAC:R-HSA-5358351	REAC	Signaling by Hedgehog	10916	2258		1	1	149	10767	9	9	140	10758	10916	0.17034723370111218
R1	cpdb	0	network_modules	340	TRUE	3.0006475085246635e-10	382	16	11	0.6875	0.028795811518324606	KEGG:05010	KEGG	Alzheimer disease	8484	411		0.9	0.9090909090909091	382	8102	11	5	371	8097	8484	0.13467842511049047
R1	cpdb	0	network_modules	340	TRUE	0.006042864359410408	135	16	4	0.25	0.02962962962962963	KEGG:04210	KEGG	Apoptosis	8484	287		1	1	135	8349	4	12	131	8337	8484	0.0813138821608762
R1	cpdb	0	network_modules	341	TRUE	1.0391172477033262e-18	200	19	14	0.7368421052631579	0.07	REAC:R-HSA-5617833	REAC	Cilium Assembly	10916	361		0	0.25	200	10716	14	5	186	10711	10916	0.22371473506520978
R1	cpdb	0	network_modules	341	TRUE	1.6052794987952914e-18	96	19	12	0.631578947368421	0.125	REAC:R-HSA-5620912	REAC	Anchoring of the basal body to the plasma membrane	10916	147		0.3333333333333333	0.5	96	10820	12	7	84	10813	10916	0.27853220182093125
R1	cpdb	0	network_modules	341	TRUE	2.898306276429503e-18	343	25	16	0.64	0.04664723032069971	GO:0060271	GO:BP	cilium assembly	16175	14488		0	0.14285714285714285	343	15832	16	9	327	15823	16175	0.1689894060875394
R1	cpdb	0	network_modules	341	TRUE	9.032994147022239e-18	368	25	16	0.64	0.043478260869565216	GO:0044782	GO:BP	cilium organization	16175	11155		0.16666666666666666	0.2857142857142857	368	15807	16	9	352	15798	16175	0.16286946783803272
R1	cpdb	0	network_modules	341	TRUE	2.316775812112226e-16	292	19	14	0.7368421052631579	0.04794520547945205	REAC:R-HSA-1852241	REAC	Organelle biogenesis and maintenance	10916	1646		0.6666666666666666	0.75	292	10624	14	5	278	10619	10916	0.18376645926335114
R1	cpdb	0	network_modules	341	TRUE	1.364032751975849e-15	503	25	16	0.64	0.03180914512922465	GO:0120031	GO:BP	plasma membrane bounded cell projection assembly	16175	19467		0.3333333333333333	0.42857142857142855	503	15672	16	9	487	15663	16175	0.13801607562354826
R1	cpdb	0	network_modules	341	TRUE	1.9267872291040777e-15	514	25	16	0.64	0.0311284046692607	GO:0030031	GO:BP	cell projection assembly	16175	6655		0.5	0.5714285714285714	514	15661	16	9	498	15652	16175	0.13642666254152727
R1	cpdb	0	network_modules	341	TRUE	4.4185524136196694e-7	8	25	4	0.16	0.5	GO:1904491	GO:BP	protein localization to ciliary transition zone	16175	23859		0.6666666666666666	0.7142857142857143	8	16167	4	21	4	16146	16175	0.2822563585533348
R1	cpdb	0	network_modules	341	TRUE	3.8975773410252785e-5	59	25	5	0.2	0.0847457627118644	GO:0061512	GO:BP	protein localization to cilium	16175	15514		0.8333333333333334	0.8571428571428571	59	16116	5	20	54	16096	16175	0.12814734111234577
R1	cpdb	0	network_modules	341	TRUE	2.2050481707688185e-4	83	25	5	0.2	0.060240963855421686	GO:0007224	GO:BP	smoothened signaling pathway	16175	2777		1	1	83	16092	5	20	78	16072	16175	0.10730646587808129
R1	cpdb	0	network_modules	341	TRUE	0.009112879521845849	5	19	2	0.10526315789473684	0.4	REAC:R-HSA-5624138	REAC	Trafficking of myristoylated proteins to the cilium	10916	2534		1	1	5	10911	2	17	3	10894	10916	0.2045276598933455
R1	cpdb	0	network_modules	342	TRUE	2.862154126272179e-13	28	31	8	0.25806451612903225	0.2857142857142857	GO:1903513	GO:BP	endoplasmic reticulum to cytosol transport	16175	23063		0	0.08695652173913043	28	16147	8	23	20	16124	16175	0.2702090594015256
R1	cpdb	0	network_modules	342	TRUE	2.862154126272179e-13	28	31	8	0.25806451612903225	0.2857142857142857	GO:0030970	GO:BP	retrograde protein transport, ER to cytosol	16175	6980		0	0.08695652173913043	28	16147	8	23	20	16124	16175	0.2702090594015256
R1	cpdb	0	network_modules	342	TRUE	2.8268699397719332e-11	47	31	8	0.25806451612903225	0.1702127659574468	GO:0032527	GO:BP	protein exit from endoplasmic reticulum	16175	7621		0.09090909090909091	0.13043478260869565	47	16128	8	23	39	16105	16175	0.20772603048929442
R1	cpdb	0	network_modules	342	TRUE	7.426230964401189e-11	200	31	11	0.3548387096774194	0.055	GO:0034976	GO:BP	response to endoplasmic reticulum stress	16175	8746		0.13636363636363635	0.17391304347826086	200	15975	11	20	189	15955	16175	0.13580372185417242
R1	cpdb	0	network_modules	342	TRUE	2.4773912765068807e-10	168	22	10	0.45454545454545453	0.05952380952380952	KEGG:04141	KEGG	Protein processing in endoplasmic reticulum	8484	278		0	0.5	168	8316	10	12	158	8304	8484	0.15910970860755858
R1	cpdb	0	network_modules	342	TRUE	5.040395370171966e-10	66	31	8	0.25806451612903225	0.12121212121212122	GO:0036503	GO:BP	ERAD pathway	16175	9635		0.18181818181818182	0.21739130434782608	66	16109	8	23	58	16086	16175	0.1745902191716416
R1	cpdb	0	network_modules	342	TRUE	7.5609619205951965e-6	75	31	6	0.1935483870967742	0.08	GO:1905897	GO:BP	regulation of response to endoplasmic reticulum stress	16175	24995		0.22727272727272727	0.2608695652173913	75	16100	6	25	69	16075	16175	0.12185255022582693
R1	cpdb	0	network_modules	342	TRUE	7.817724558430998e-6	35	28	5	0.17857142857142858	0.14285714285714285	REAC:R-HSA-532668	REAC	N-glycan trimming in the ER and Calnexin/Calreticulin cycle	10916	1508		0	0.25	35	10881	5	23	30	10858	10916	0.15730527656022217
R1	cpdb	0	network_modules	342	TRUE	1.0828597104784459e-5	13	31	4	0.12903225806451613	0.3076923076923077	GO:1904152	GO:BP	regulation of retrograde protein transport, ER to cytosol	16175	23573		0.2727272727272727	0.30434782608695654	13	16162	4	27	9	16135	16175	0.1982828082598642
R1	cpdb	0	network_modules	342	TRUE	1.3894214041239949e-5	470	31	10	0.3225806451612903	0.02127659574468085	GO:0010498	GO:BP	proteasomal protein catabolic process	16175	4177		0.3181818181818182	0.34782608695652173	470	15705	10	21	460	15684	16175	0.07657631755053859
R1	cpdb	0	network_modules	342	TRUE	1.606802379629756e-5	40	31	5	0.16129032258064516	0.125	GO:1903573	GO:BP	negative regulation of response to endoplasmic reticulum stress	16175	23116		0.36363636363636365	0.391304347826087	40	16135	5	26	35	16109	16175	0.14012095302934605
R1	cpdb	0	network_modules	342	TRUE	5.482277096242839e-5	104	31	6	0.1935483870967742	0.057692307692307696	GO:0006986	GO:BP	response to unfolded protein	16175	2608		0.4090909090909091	0.43478260869565216	104	16071	6	25	98	16046	16175	0.10258849538347829
R1	cpdb	0	network_modules	342	TRUE	6.704406417267944e-5	21	28	4	0.14285714285714285	0.19047619047619047	REAC:R-HSA-901032	REAC	ER Quality Control Compartment (ERQC)	10916	822		0.3333333333333333	0.5	21	10895	4	24	17	10871	10916	0.163101904366655
R1	cpdb	0	network_modules	342	TRUE	1.2289844803352033e-4	119	31	6	0.1935483870967742	0.05042016806722689	GO:0035966	GO:BP	response to topologically incorrect protein	16175	9369		0.45454545454545453	0.4782608695652174	119	16056	6	25	113	16031	16175	0.09547439456304398
R1	cpdb	0	network_modules	342	TRUE	1.5342055915332472e-4	62	31	5	0.16129032258064516	0.08064516129032258	GO:0070972	GO:BP	protein localization to endoplasmic reticulum	16175	16407		0.5	0.5217391304347826	62	16113	5	26	57	16087	16175	0.1116601397366097
R1	cpdb	0	network_modules	342	TRUE	1.5858095051253862e-4	24	31	4	0.12903225806451613	0.16666666666666666	GO:0070861	GO:BP	regulation of protein exit from endoplasmic reticulum	16175	16345		0.5454545454545454	0.5652173913043478	24	16151	4	27	20	16124	16175	0.14520766540677896
R1	cpdb	0	network_modules	342	TRUE	1.6600189730579898e-4	26	28	4	0.14285714285714285	0.15384615384615385	REAC:R-HSA-901042	REAC	Calnexin/calreticulin cycle	10916	302		0.6666666666666666	0.75	26	10890	4	24	22	10866	10916	0.14613959405992055
R1	cpdb	0	network_modules	342	TRUE	2.1075073110937858e-4	66	31	5	0.16129032258064516	0.07575757575757576	GO:0030968	GO:BP	endoplasmic reticulum unfolded protein response	16175	6979		0.5909090909090909	0.6086956521739131	66	16109	5	26	61	16083	16175	0.10806706021861376
R1	cpdb	0	network_modules	342	TRUE	4.052732048978946e-4	673	31	10	0.3225806451612903	0.014858841010401188	GO:0051603	GO:BP	proteolysis involved in protein catabolic process	16175	13820		0.6363636363636364	0.6521739130434783	673	15502	10	21	663	15481	16175	0.06165710108347238
R1	cpdb	0	network_modules	342	TRUE	5.222874499782535e-4	79	31	5	0.16129032258064516	0.06329113924050633	GO:0034620	GO:BP	cellular response to unfolded protein	16175	8693		0.6818181818181818	0.6956521739130435	79	16096	5	26	74	16070	16175	0.09831077423307208
R1	cpdb	0	network_modules	342	TRUE	5.43640343486792e-4	524	31	9	0.2903225806451613	0.01717557251908397	GO:0006886	GO:BP	intracellular protein transport	16175	2542		0.7272727272727273	0.7391304347826086	524	15651	9	22	515	15629	16175	0.06383803713103428
R1	cpdb	0	network_modules	342	TRUE	0.0011120219248519137	20	22	3	0.13636363636363635	0.15	KEGG:00100	KEGG	Steroid biosynthesis	8484	13		1	1	20	8464	3	19	17	8445	8484	0.14089570157565345
R1	cpdb	0	network_modules	342	TRUE	0.0011199228923433125	92	31	5	0.16129032258064516	0.05434782608695652	GO:0035967	GO:BP	cellular response to topologically incorrect protein	16175	9370		0.7727272727272727	0.782608695652174	92	16083	5	26	87	16057	16175	0.09066899021501329
R1	cpdb	0	network_modules	342	TRUE	0.0017955760262242937	43	31	4	0.12903225806451613	0.09302325581395349	GO:1902653	GO:BP	secondary alcohol biosynthetic process	16175	22419		0.8181818181818182	0.8695652173913043	43	16132	4	27	39	16105	16175	0.10754702241940024
R1	cpdb	0	network_modules	342	TRUE	0.0017955760262242937	43	31	4	0.12903225806451613	0.09302325581395349	GO:0006695	GO:BP	cholesterol biosynthetic process	16175	2403		0.8181818181818182	0.8695652173913043	43	16132	4	27	39	16105	16175	0.10754702241940024
R1	cpdb	0	network_modules	342	TRUE	0.002581318450454648	47	31	4	0.12903225806451613	0.0851063829787234	GO:0016126	GO:BP	sterol biosynthetic process	16175	5144		0.9090909090909091	0.9130434782608695	47	16128	4	27	43	16101	16175	0.10268023530974299
R1	cpdb	0	network_modules	342	TRUE	0.004937290989342017	2	31	2	0.06451612903225806	1	GO:0018214	GO:BP	protein carboxylation	16175	5373		0.9545454545454546	1	2	16173	2	29	0	16144	16175	0.2537724263756736
R1	cpdb	0	network_modules	342	TRUE	0.004937290989342017	2	31	2	0.06451612903225806	1	GO:0017187	GO:BP	peptidyl-glutamic acid carboxylation	16175	5292		0.9545454545454546	1	2	16173	2	29	0	16144	16175	0.2537724263756736
R1	cpdb	0	network_modules	342	TRUE	0.0063349653657779805	3	28	2	0.07142857142857142	0.6666666666666666	REAC:R-HSA-6806664	REAC	Metabolism of vitamin K	10916	1439		1	1	3	10913	2	26	1	10887	10916	0.21768752796802934
R1	cpdb	0	network_modules	343	TRUE	1.0570784934535454e-39	205	35	26	0.7428571428571429	0.12682926829268293	GO:0016072	GO:BP	rRNA metabolic process	16175	5099		0	0.02127659574468085	205	15970	26	9	179	15961	16175	0.3039688160725111
R1	cpdb	0	network_modules	343	TRUE	2.8157470526779185e-38	182	30	25	0.8333333333333334	0.13736263736263737	REAC:R-HSA-6791226	REAC	Major pathway of rRNA processing in the nucleolus and cytosol	10916	1389		0	0.07692307692307693	182	10734	25	5	157	10729	10916	0.334822844593767
R1	cpdb	0	network_modules	343	TRUE	1.1729959325901399e-37	192	30	25	0.8333333333333334	0.13020833333333334	REAC:R-HSA-8868773	REAC	rRNA processing in the nucleus and cytosol	10916	2734		0.08333333333333333	0.15384615384615385	192	10724	25	5	167	10719	10916	0.3257730187930794
R1	cpdb	0	network_modules	343	TRUE	4.521395281953597e-37	202	30	25	0.8333333333333334	0.12376237623762376	REAC:R-HSA-72312	REAC	rRNA processing	10916	2732		0.16666666666666666	0.23076923076923078	202	10714	25	5	177	10709	10916	0.31739832745370405
R1	cpdb	0	network_modules	343	TRUE	7.78994352863654e-35	169	35	23	0.6571428571428571	0.13609467455621302	GO:0006364	GO:BP	rRNA processing	16175	2140		0.021739130434782608	0.0425531914893617	169	16006	23	12	146	15994	16175	0.2961699864619785
R1	cpdb	0	network_modules	343	TRUE	1.11336123503445e-30	251	35	23	0.6571428571428571	0.09163346613545817	GO:0042254	GO:BP	ribosome biogenesis	16175	10060		0.043478260869565216	0.06382978723404255	251	15924	23	12	228	15912	16175	0.24173800542887405
R1	cpdb	0	network_modules	343	TRUE	3.168689853872909e-28	79	25	17	0.68	0.21518987341772153	KEGG:03018	KEGG	RNA degradation	8484	211		0	0.5	79	8405	17	8	62	8397	8484	0.3796203740213353
R1	cpdb	0	network_modules	343	TRUE	4.306108362707532e-28	390	35	24	0.6857142857142857	0.06153846153846154	GO:0022613	GO:BP	ribonucleoprotein complex biogenesis	16175	6620		0.06521739130434782	0.0851063829787234	390	15785	24	11	366	15774	16175	0.2008488814369885
R1	cpdb	0	network_modules	343	TRUE	3.347715804730248e-23	17	30	11	0.36666666666666664	0.6470588235294118	REAC:R-HSA-450513	REAC	Tristetraprolin (TTP, ZFP36) binds and destabilizes mRNA	10916	2608		0.25	0.38461538461538464	17	10899	11	19	6	10880	10916	0.4860658630162392
R1	cpdb	0	network_modules	343	TRUE	3.347715804730248e-23	17	30	11	0.36666666666666664	0.6470588235294118	REAC:R-HSA-450385	REAC	Butyrate Response Factor 1 (BRF1) binds and destabilizes mRNA	10916	259		0.25	0.38461538461538464	17	10899	11	19	6	10880	10916	0.4860658630162392
R1	cpdb	0	network_modules	343	TRUE	9.686219863450788e-22	14	35	10	0.2857142857142857	0.7142857142857143	GO:0071027	GO:BP	nuclear RNA surveillance	16175	16427		0.08695652173913043	0.10638297872340426	14	16161	10	25	4	16136	16175	0.45106874466525554
R1	cpdb	0	network_modules	343	TRUE	7.727197372451239e-21	16	35	10	0.2857142857142857	0.625	GO:0071025	GO:BP	RNA surveillance	16175	16425		0.10869565217391304	0.1276595744680851	16	16159	10	25	6	16134	16175	0.421779119757364
R1	cpdb	0	network_modules	343	TRUE	1.1807150871166437e-20	16	30	10	0.3333333333333333	0.625	REAC:R-HSA-429958	REAC	mRNA decay by 3' to 5' exoribonuclease	10916	2709		0.4166666666666667	0.46153846153846156	16	10900	10	20	6	10880	10916	0.45538801554896663
R1	cpdb	0	network_modules	343	TRUE	2.8626684747051134e-20	17	30	10	0.3333333333333333	0.5882352941176471	REAC:R-HSA-450604	REAC	KSRP (KHSRP) binds and destabilizes mRNA	10916	1283		0.5	0.5384615384615384	17	10899	10	20	7	10879	10916	0.4416895774443771
R1	cpdb	0	network_modules	343	TRUE	3.6229256749611896e-19	8	35	8	0.22857142857142856	1	GO:0034475	GO:BP	U4 snRNA 3'-end processing	16175	8652		0.13043478260869565	0.14893617021276595	8	16167	8	27	0	16140	16175	0.47769205414405913
R1	cpdb	0	network_modules	343	TRUE	1.2212235386806574e-17	27	30	10	0.3333333333333333	0.37037037037037035	REAC:R-HSA-380994	REAC	ATF4 activates genes in response to endoplasmic reticulum  stress	10916	35		0.5833333333333334	0.6153846153846154	27	10889	10	20	17	10869	10916	0.3496698943549468
R1	cpdb	0	network_modules	343	TRUE	1.625479629252303e-17	10	35	8	0.22857142857142856	0.8	GO:0071028	GO:BP	nuclear mRNA surveillance	16175	16428		0.15217391304347827	0.1702127659574468	10	16165	8	27	2	16138	16175	0.4270555467763454
R1	cpdb	0	network_modules	343	TRUE	8.720314311000916e-17	33	35	10	0.2857142857142857	0.30303030303030304	GO:0000460	GO:BP	maturation of 5.8S rRNA	16175	150		0.17391304347826086	0.19148936170212766	33	16142	10	25	23	16117	16175	0.2927592264345032
R1	cpdb	0	network_modules	343	TRUE	9.261003396538385e-17	32	30	10	0.3333333333333333	0.3125	REAC:R-HSA-381042	REAC	PERK regulates gene expression	10916	1664		0.6666666666666666	0.6923076923076923	32	10884	10	20	22	10864	10916	0.3208213136028671
R1	cpdb	0	network_modules	343	TRUE	2.1576290187812934e-16	279	35	16	0.45714285714285713	0.05734767025089606	GO:0006401	GO:BP	RNA catabolic process	16175	2162		0.1956521739130435	0.2127659574468085	279	15896	16	19	263	15877	16175	0.15733616932359828
R1	cpdb	0	network_modules	343	TRUE	3.783961273879215e-16	56	30	11	0.36666666666666664	0.19642857142857142	REAC:R-HSA-429914	REAC	Deadenylation-dependent mRNA decay	10916	454		0.75	0.7692307692307693	56	10860	11	19	45	10841	10916	0.2656643695892108
R1	cpdb	0	network_modules	343	TRUE	6.580313463492663e-16	299	35	16	0.45714285714285713	0.05351170568561873	GO:0141188	GO:BP	nucleic acid catabolic process	16175	20075		0.21739130434782608	0.23404255319148937	299	15876	16	19	283	15857	16175	0.15165125409374242
R1	cpdb	0	network_modules	343	TRUE	3.933050018948312e-14	57	35	10	0.2857142857142857	0.17543859649122806	GO:0016073	GO:BP	snRNA metabolic process	16175	5100		0.2391304347826087	0.2553191489361702	57	16118	10	25	47	16093	16175	0.22175614775599511
R1	cpdb	0	network_modules	343	TRUE	5.924650728891092e-14	86	30	11	0.36666666666666664	0.12790697674418605	REAC:R-HSA-450531	REAC	Regulation of mRNA stability by proteins that bind AU-rich elements	10916	2043		0.8333333333333334	0.8461538461538461	86	10830	11	19	75	10811	10916	0.21304180625829322
R1	cpdb	0	network_modules	343	TRUE	8.621014939325478e-14	59	30	10	0.3333333333333333	0.1694915254237288	REAC:R-HSA-6790901	REAC	rRNA modification in the nucleus and cytosol	10916	2731		0.9166666666666666	0.9230769230769231	59	10857	10	20	49	10837	10916	0.23479461128056808
R1	cpdb	0	network_modules	343	TRUE	9.277990199892214e-14	94	35	11	0.3142857142857143	0.11702127659574468	GO:0042274	GO:BP	ribosomal small subunit biogenesis	16175	10071		0.2608695652173913	0.2765957446808511	94	16081	11	24	83	16057	16175	0.18898400498175394
R1	cpdb	0	network_modules	343	TRUE	1.1346509525177517e-13	22	35	8	0.22857142857142856	0.36363636363636365	GO:0034472	GO:BP	snRNA 3'-end processing	16175	8649		0.2826086956521739	0.2978723404255319	22	16153	8	27	14	16126	16175	0.28709031732393786
R1	cpdb	0	network_modules	343	TRUE	4.116996275682313e-13	448	35	16	0.45714285714285713	0.03571428571428571	GO:0034655	GO:BP	nucleobase-containing compound catabolic process	16175	8711		0.30434782608695654	0.3191489361702128	448	15727	16	19	432	15708	16175	0.12186330417425233
R1	cpdb	0	network_modules	343	TRUE	8.1521606163844e-13	7	35	6	0.17142857142857143	0.8571428571428571	GO:0071038	GO:BP	TRAMP-dependent tRNA surveillance pathway	16175	16436		0.32608695652173914	0.3617021276595745	7	16168	6	29	1	16139	16175	0.382855448193427
R1	cpdb	0	network_modules	343	TRUE	8.1521606163844e-13	7	35	6	0.17142857142857143	0.8571428571428571	GO:0071035	GO:BP	nuclear polyadenylation-dependent rRNA catabolic process	16175	16433		0.32608695652173914	0.3617021276595745	7	16168	6	29	1	16139	16175	0.382855448193427
R1	cpdb	0	network_modules	343	TRUE	3.2558511007851607e-12	8	35	6	0.17142857142857143	0.75	GO:0071051	GO:BP	poly(A)-dependent snoRNA 3'-end processing	16175	16446		0.3695652173913043	0.40425531914893614	8	16167	6	29	2	16138	16175	0.3580100687695214
R1	cpdb	0	network_modules	343	TRUE	3.2558511007851607e-12	8	35	6	0.17142857142857143	0.75	GO:0106354	GO:BP	tRNA surveillance	16175	19317		0.3695652173913043	0.40425531914893614	8	16167	6	29	2	16138	16175	0.3580100687695214
R1	cpdb	0	network_modules	343	TRUE	6.328513687674852e-12	34	35	8	0.22857142857142856	0.23529411764705882	GO:0016180	GO:BP	snRNA processing	16175	5161		0.41304347826086957	0.425531914893617	34	16141	8	27	26	16114	16175	0.23026685826543913
R1	cpdb	0	network_modules	343	TRUE	9.361724478116214e-12	92	30	10	0.3333333333333333	0.10869565217391304	REAC:R-HSA-381119	REAC	Unfolded Protein Response (UPR)	10916	2624		1	1	92	10824	10	20	82	10804	10916	0.18657739714525076
R1	cpdb	0	network_modules	343	TRUE	9.752536655598382e-12	9	35	6	0.17142857142857143	0.6666666666666666	GO:0000467	GO:BP	exonucleolytic trimming to generate mature 3'-end of 5.8S rRNA from tricistronic rRNA transcript (SSU-rRNA, 5.8S rRNA, LSU-rRNA)	16175	157		0.43478260869565216	0.44680851063829785	9	16166	6	29	3	16137	16175	0.3374234850419817
R1	cpdb	0	network_modules	343	TRUE	2.4343856913890482e-11	10	35	6	0.17142857142857143	0.6	GO:0031125	GO:BP	rRNA 3'-end processing	16175	7050		0.45652173913043476	0.46808510638297873	10	16165	6	29	4	16136	16175	0.32000210285372027
R1	cpdb	0	network_modules	343	TRUE	1.0678385432577629e-10	12	35	6	0.17142857142857143	0.5	GO:0031126	GO:BP	sno(s)RNA 3'-end processing	16175	7051		0.4782608695652174	0.48936170212765956	12	16163	6	29	6	16134	16175	0.2919272140429509
R1	cpdb	0	network_modules	343	TRUE	1.265798931429156e-10	80	35	9	0.2571428571428571	0.1125	GO:0031123	GO:BP	RNA 3'-end processing	16175	7048		0.5	0.5106382978723404	80	16095	9	26	71	16069	16175	0.16740788030607454
R1	cpdb	0	network_modules	343	TRUE	3.4598113898809164e-10	14	35	6	0.17142857142857143	0.42857142857142855	GO:0043144	GO:BP	sno(s)RNA processing	16175	10551		0.5217391304347826	0.5531914893617021	14	16161	6	29	8	16132	16175	0.2700930049911762
R1	cpdb	0	network_modules	343	TRUE	3.4598113898809164e-10	14	35	6	0.17142857142857143	0.42857142857142855	GO:0016075	GO:BP	rRNA catabolic process	16175	5102		0.5217391304347826	0.5531914893617021	14	16161	6	29	8	16132	16175	0.2700930049911762
R1	cpdb	0	network_modules	343	TRUE	9.197812841145392e-10	16	35	6	0.17142857142857143	0.375	GO:0016078	GO:BP	tRNA decay	16175	5105		0.5652173913043478	0.5957446808510638	16	16159	6	29	10	16130	16175	0.2524813404391591
R1	cpdb	0	network_modules	343	TRUE	9.197812841145392e-10	16	35	6	0.17142857142857143	0.375	GO:0016074	GO:BP	sno(s)RNA metabolic process	16175	5101		0.5652173913043478	0.5957446808510638	16	16159	6	29	10	16130	16175	0.2524813404391591
R1	cpdb	0	network_modules	343	TRUE	3.1060376688968938e-9	113	35	9	0.2571428571428571	0.07964601769911504	GO:0000956	GO:BP	nuclear-transcribed mRNA catabolic process	16175	264		0.6086956521739131	0.6170212765957447	113	16062	9	26	104	16036	16175	0.13986201155443032
R1	cpdb	0	network_modules	343	TRUE	8.491118272299952e-9	22	35	6	0.17142857142857143	0.2727272727272727	GO:0000466	GO:BP	maturation of 5.8S rRNA from tricistronic rRNA transcript (SSU-rRNA, 5.8S rRNA, LSU-rRNA)	16175	156		0.6304347826086957	0.6382978723404256	22	16153	6	29	16	16124	16175	0.21488809571599732
R1	cpdb	0	network_modules	343	TRUE	5.612451233348619e-8	226	35	10	0.2857142857142857	0.04424778761061947	GO:0006402	GO:BP	mRNA catabolic process	16175	2163		0.6521739130434783	0.6595744680851063	226	15949	10	25	216	15924	16175	0.10781086617484811
R1	cpdb	0	network_modules	343	TRUE	7.99160924095097e-8	13	35	5	0.14285714285714285	0.38461538461538464	GO:0045006	GO:BP	DNA deamination	16175	11224		0.6739130434782609	0.6808510638297872	13	16162	5	30	8	16132	16175	0.23343128138302716
R1	cpdb	0	network_modules	343	TRUE	1.6372321348301227e-7	5	35	4	0.11428571428571428	0.8	GO:0071034	GO:BP	CUT catabolic process	16175	16432		0.6956521739130435	0.723404255319149	5	16170	4	31	1	16139	16175	0.3019271820948009
R1	cpdb	0	network_modules	343	TRUE	1.6372321348301227e-7	5	35	4	0.11428571428571428	0.8	GO:0071043	GO:BP	CUT metabolic process	16175	16441		0.6956521739130435	0.723404255319149	5	16170	4	31	1	16139	16175	0.3019271820948009
R1	cpdb	0	network_modules	343	TRUE	2.3772459516262522e-7	139	25	8	0.32	0.05755395683453238	KEGG:03008	KEGG	Ribosome biogenesis in eukaryotes	8484	207		1	1	139	8345	8	17	131	8328	8484	0.1300216126692342
R1	cpdb	0	network_modules	343	TRUE	1.0272988779144902e-6	46	35	6	0.17142857142857143	0.13043478260869565	GO:0030490	GO:BP	maturation of SSU-rRNA	16175	6815		0.7391304347826086	0.7446808510638298	46	16129	6	29	40	16100	16175	0.14742190079162742
R1	cpdb	0	network_modules	343	TRUE	3.431280400142191e-6	590	35	12	0.34285714285714286	0.020338983050847456	GO:0016071	GO:BP	mRNA metabolic process	16175	5098		0.7608695652173914	0.7659574468085106	590	15585	12	23	578	15562	16175	0.0761042845738295
R1	cpdb	0	network_modules	343	TRUE	4.905484226676321e-6	27	35	5	0.14285714285714285	0.18518518518518517	GO:0006304	GO:BP	DNA modification	16175	2111		0.782608695652174	0.7872340425531915	27	16148	5	30	22	16118	16175	0.16105817481231416
R1	cpdb	0	network_modules	343	TRUE	1.657374145092999e-5	3	35	3	0.08571428571428572	1	GO:0034473	GO:BP	U1 snRNA 3'-end processing	16175	8650		0.8043478260869565	0.8297872340425532	3	16172	3	32	0	16140	16175	0.29248022223730935
R1	cpdb	0	network_modules	343	TRUE	1.657374145092999e-5	3	35	3	0.08571428571428572	1	GO:0034476	GO:BP	U5 snRNA 3'-end processing	16175	8653		0.8043478260869565	0.8297872340425532	3	16172	3	32	0	16140	16175	0.29248022223730935
R1	cpdb	0	network_modules	343	TRUE	6.619658099174301e-5	4	35	3	0.08571428571428572	0.75	GO:0071042	GO:BP	nuclear polyadenylation-dependent mRNA catabolic process	16175	16440		0.8478260869565217	0.8723404255319149	4	16171	3	32	1	16139	16175	0.25312003612333916
R1	cpdb	0	network_modules	343	TRUE	6.619658099174301e-5	4	35	3	0.08571428571428572	0.75	GO:0071047	GO:BP	polyadenylation-dependent mRNA catabolic process	16175	16445		0.8478260869565217	0.8723404255319149	4	16171	3	32	1	16139	16175	0.25312003612333916
R1	cpdb	0	network_modules	343	TRUE	0.0016373720828133634	35	35	4	0.11428571428571428	0.11428571428571428	GO:0045943	GO:BP	positive regulation of transcription by RNA polymerase I	16175	11736		0.8913043478260869	0.8936170212765957	35	16140	4	31	31	16109	16175	0.11236502035758542
R1	cpdb	0	network_modules	343	TRUE	0.001968282975880127	10	35	3	0.08571428571428572	0.3	GO:2000234	GO:BP	positive regulation of rRNA processing	16175	25562		0.9130434782608695	0.9148936170212766	10	16165	3	32	7	16133	16175	0.15942193696978257
R1	cpdb	0	network_modules	343	TRUE	0.0027023740845038605	11	35	3	0.08571428571428572	0.2727272727272727	GO:0071044	GO:BP	histone mRNA catabolic process	16175	16442		0.9347826086956522	0.9361702127659575	11	16164	3	32	8	16132	16175	0.15189711841786543
R1	cpdb	0	network_modules	343	TRUE	0.004685051737925009	186	35	6	0.17142857142857143	0.03225806451612903	GO:0006399	GO:BP	tRNA metabolic process	16175	2160		0.9565217391304348	0.9574468085106383	186	15989	6	29	180	15960	16175	0.06985340480689471
R1	cpdb	0	network_modules	343	TRUE	0.005017638695113595	46	35	4	0.11428571428571428	0.08695652173913043	GO:0006356	GO:BP	regulation of transcription by RNA polymerase I	16175	2133		0.9782608695652174	0.9787234042553191	46	16129	4	31	42	16098	16175	0.09745230218926838
R1	cpdb	0	network_modules	343	TRUE	0.009103873202138783	16	35	3	0.08571428571428572	0.1875	GO:2000232	GO:BP	regulation of rRNA processing	16175	25560		1	1	16	16159	3	32	13	16127	16175	0.1255080059505054
R1	cpdb	0	network_modules	344	TRUE	1.801610741362213e-7	6	5	3	0.6	0.5	REAC:R-HSA-1566977	REAC	Fibronectin matrix formation	10916	941		0	0.5	6	10910	3	2	3	10908	10916	0.5474966517046818
R1	cpdb	0	network_modules	344	TRUE	7.054083387307762e-5	193	5	4	0.8	0.02072538860103627	GO:0098742	GO:BP	cell-cell adhesion via plasma-membrane adhesion molecules	16175	18867		0	0.25	193	15982	4	1	189	15981	16175	0.12762735250676768
R1	cpdb	0	network_modules	344	TRUE	8.751773415129425e-5	191	5	4	0.8	0.020942408376963352	REAC:R-HSA-202733	REAC	Cell surface interactions at the vascular wall	10916	327		1	1	191	10725	4	1	187	10724	10916	0.12775761294811327
R1	cpdb	0	network_modules	344	TRUE	2.2606647187149026e-4	52	5	3	0.6	0.057692307692307696	GO:0007157	GO:BP	heterophilic cell-cell adhesion via plasma membrane cell adhesion molecules	16175	2721		0.3333333333333333	0.5	52	16123	3	2	49	16121	16175	0.18538205820065337
R1	cpdb	0	network_modules	344	TRUE	4.0579860057737155e-4	63	5	3	0.6	0.047619047619047616	GO:0007156	GO:BP	homophilic cell adhesion via plasma membrane adhesion molecules	16175	2720		0.6666666666666666	0.75	63	16112	3	2	60	16110	16175	0.16828760045065144
R1	cpdb	0	network_modules	344	TRUE	0.008459039671694205	18	5	2	0.4	0.1111111111111111	GO:2000811	GO:BP	negative regulation of anoikis	16175	26066		1	1	18	16157	2	3	16	16154	16175	0.2103815913752658
R1	cpdb	0	network_modules	345	TRUE	9.661983777228872e-29	215	24	20	0.8333333333333334	0.09302325581395349	REAC:R-HSA-6805567	REAC	Keratinization	10916	1288		NA	1	215	10701	20	4	195	10697	10916	0.2748621013451715
R1	cpdb	0	network_modules	346	TRUE	4.447537971682292e-11	275	30	12	0.4	0.04363636363636364	GO:0006605	GO:BP	protein targeting	16175	2322		0	0.05263157894736842	275	15900	12	18	263	15882	16175	0.12770797081081453
R1	cpdb	0	network_modules	346	TRUE	9.377251053070468e-10	19	30	6	0.2	0.3157894736842105	GO:0030150	GO:BP	protein import into mitochondrial matrix	16175	6684		0.05555555555555555	0.10526315789473684	19	16156	6	24	13	16132	16175	0.2502153333658911
R1	cpdb	0	network_modules	346	TRUE	1.660416810025958e-9	373	30	12	0.4	0.032171581769437	GO:0072594	GO:BP	establishment of protein localization to organelle	16175	17458		0.1111111111111111	0.15789473684210525	373	15802	12	18	361	15784	16175	0.10825484762786586
R1	cpdb	0	network_modules	346	TRUE	2.2573717754448993e-9	45	30	7	0.23333333333333334	0.15555555555555556	GO:0170036	GO:BP	import into the mitochondrion	16175	20284		0.16666666666666666	0.21052631578947367	45	16130	7	23	38	16107	16175	0.1886817761043657
R1	cpdb	0	network_modules	346	TRUE	2.3078864834898754e-9	31	19	6	0.3157894736842105	0.1935483870967742	KEGG:03060	KEGG	Protein export	8484	217		0	0.5	31	8453	6	13	25	8440	8484	0.24508736008795726
R1	cpdb	0	network_modules	346	TRUE	4.251788598714887e-9	49	30	7	0.23333333333333334	0.14285714285714285	GO:0071806	GO:BP	protein transmembrane transport	16175	16919		0.2222222222222222	0.2631578947368421	49	16126	7	23	42	16103	16175	0.1806449990427111
R1	cpdb	0	network_modules	346	TRUE	4.32831390579059e-9	88	30	8	0.26666666666666666	0.09090909090909091	GO:1990542	GO:BP	mitochondrial transmembrane transport	16175	25201		0.2777777777777778	0.3157894736842105	88	16087	8	22	80	16065	16175	0.1530818533305678
R1	cpdb	0	network_modules	346	TRUE	6.58766768988081e-8	36	30	6	0.2	0.16666666666666666	GO:0044743	GO:BP	protein transmembrane import into intracellular organelle	16175	11137		0.3333333333333333	0.3684210526315789	36	16139	6	24	30	16115	16175	0.18091154459580494
R1	cpdb	0	network_modules	346	TRUE	1.914928539110682e-7	18	30	5	0.16666666666666666	0.2777777777777778	GO:0006613	GO:BP	cotranslational protein targeting to membrane	16175	2328		0.3888888888888889	0.42105263157894735	18	16157	5	25	13	16132	16175	0.21404669720291297
R1	cpdb	0	network_modules	346	TRUE	4.493679036793755e-7	156	30	8	0.26666666666666666	0.05128205128205128	GO:0006839	GO:BP	mitochondrial transport	16175	2508		0.4444444444444444	0.47368421052631576	156	16019	8	22	148	15997	16175	0.1133643364349256
R1	cpdb	0	network_modules	346	TRUE	6.922683820307412e-7	99	30	7	0.23333333333333334	0.0707070707070707	GO:0006626	GO:BP	protein targeting to mitochondrion	16175	2340		0.5	0.5263157894736842	99	16076	7	23	92	16053	16175	0.1255775614825705
R1	cpdb	0	network_modules	346	TRUE	1.4595558738139772e-6	110	30	7	0.23333333333333334	0.06363636363636363	GO:0072655	GO:BP	establishment of protein localization to mitochondrion	16175	17476		0.5555555555555556	0.5789473684210527	110	16065	7	23	103	16042	16175	0.11881741913941546
R1	cpdb	0	network_modules	346	TRUE	2.011371296833397e-6	62	30	6	0.2	0.0967741935483871	GO:0070972	GO:BP	protein localization to endoplasmic reticulum	16175	16407		0.6111111111111112	0.631578947368421	62	16113	6	24	56	16089	16175	0.13684458803221594
R1	cpdb	0	network_modules	346	TRUE	2.2549192587645277e-6	117	30	7	0.23333333333333334	0.05982905982905983	GO:0070585	GO:BP	protein localization to mitochondrion	16175	16190		0.6666666666666666	0.6842105263157895	117	16058	7	23	110	16035	16175	0.11501320286023141
R1	cpdb	0	network_modules	346	TRUE	2.6167624894711962e-6	29	30	5	0.16666666666666666	0.1724137931034483	GO:0045047	GO:BP	protein targeting to ER	16175	11246		0.7222222222222222	0.7368421052631579	29	16146	5	25	24	16121	16175	0.1679987322572735
R1	cpdb	0	network_modules	346	TRUE	3.029062960874989e-6	65	27	6	0.2222222222222222	0.09230769230769231	REAC:R-HSA-1268020	REAC	Mitochondrial protein import	10916	1468		0	0.25	65	10851	6	21	59	10830	10916	0.13997530793103483
R1	cpdb	0	network_modules	346	TRUE	4.622929261514327e-6	11	30	4	0.13333333333333333	0.36363636363636365	GO:0006614	GO:BP	SRP-dependent cotranslational protein targeting to membrane	16175	2329		0.7777777777777778	0.7894736842105263	11	16164	4	26	7	16138	16175	0.21934770440260062
R1	cpdb	0	network_modules	346	TRUE	5.202780393442859e-6	33	30	5	0.16666666666666666	0.15151515151515152	GO:0072599	GO:BP	establishment of protein localization to endoplasmic reticulum	16175	17463		0.8333333333333334	0.8421052631578947	33	16142	5	25	28	16117	16175	0.1572714699841624
R1	cpdb	0	network_modules	346	TRUE	1.2315363089682088e-5	808	30	12	0.4	0.01485148514851485	GO:0033365	GO:BP	protein localization to organelle	16175	8175		0.8888888888888888	0.8947368421052632	808	15367	12	18	796	15349	16175	0.06926458583053462
R1	cpdb	0	network_modules	346	TRUE	2.600209778263676e-5	158	27	7	0.25925925925925924	0.04430379746835443	REAC:R-HSA-9609507	REAC	Protein localization	10916	1815		0.3333333333333333	0.5	158	10758	7	20	151	10738	10916	0.10205682729486396
R1	cpdb	0	network_modules	346	TRUE	8.556848094871924e-5	113	27	6	0.2222222222222222	0.05309734513274336	REAC:R-HSA-1799339	REAC	SRP-dependent cotranslational protein targeting to membrane	10916	2157		0.6666666666666666	0.75	113	10803	6	21	107	10782	10916	0.10423423399596277
R1	cpdb	0	network_modules	346	TRUE	1.0890635860230257e-4	292	27	8	0.2962962962962963	0.0273972602739726	REAC:R-HSA-72766	REAC	Translation	10916	2565		1	1	292	10624	8	19	284	10605	10916	0.08318590868643166
R1	cpdb	0	network_modules	346	TRUE	0.002021820772561103	106	30	5	0.16666666666666666	0.04716981132075472	GO:0006612	GO:BP	protein targeting to membrane	16175	2327		0.9444444444444444	0.9473684210526315	106	16069	5	25	101	16044	16175	0.0855393726861591
R1	cpdb	0	network_modules	346	TRUE	0.002297389697570773	30	19	3	0.15789473684210525	0.1	KEGG:00630	KEGG	Glyoxylate and dicarboxylate metabolism	8484	107		1	1	30	8454	3	16	27	8438	8484	0.12319788579475213
R1	cpdb	0	network_modules	346	TRUE	0.005274133862445459	524	30	8	0.26666666666666666	0.015267175572519083	GO:0006886	GO:BP	intracellular protein transport	16175	2542		1	1	524	15651	8	22	516	15629	16175	0.057038451112038854
R1	cpdb	0	network_modules	347	TRUE	2.0484321233063612e-18	13	20	8	0.4	0.6153846153846154	GO:0001682	GO:BP	tRNA 5'-leader removal	16175	384		0	0.125	13	16162	8	12	5	16150	16175	0.49564767771167767
R1	cpdb	0	network_modules	347	TRUE	1.0228646402582538e-17	15	20	8	0.4	0.5333333333333333	GO:0099116	GO:BP	tRNA 5'-end processing	16175	19047		0.14285714285714285	0.25	15	16160	8	12	7	16148	16175	0.4613084984966186
R1	cpdb	0	network_modules	347	TRUE	3.69200083037153e-14	35	20	8	0.4	0.22857142857142856	GO:0000966	GO:BP	RNA 5'-end processing	16175	274		0.2857142857142857	0.375	35	16140	8	12	27	16128	16175	0.3012480750784537
R1	cpdb	0	network_modules	347	TRUE	2.053651086081004e-13	139	11	9	0.8181818181818182	0.06474820143884892	KEGG:03008	KEGG	Ribosome biogenesis in eukaryotes	8484	207		NA	1	139	8345	9	2	130	8343	8484	0.22757409126688238
R1	cpdb	0	network_modules	347	TRUE	2.2529276944127528e-13	55	14	8	0.5714285714285714	0.14545454545454545	REAC:R-HSA-6784531	REAC	tRNA processing in the nucleus	10916	2745		0	0.2	55	10861	8	6	47	10855	10916	0.2866644609126465
R1	cpdb	0	network_modules	347	TRUE	4.296817897808747e-11	103	14	8	0.5714285714285714	0.07766990291262135	REAC:R-HSA-72306	REAC	tRNA processing	10916	2743		0.25	0.4	103	10813	8	6	95	10807	10916	0.2083116486674926
R1	cpdb	0	network_modules	347	TRUE	1.24595789538911e-9	120	20	8	0.4	0.06666666666666667	GO:0008033	GO:BP	tRNA processing	16175	3098		0.42857142857142855	0.5	120	16055	8	12	112	16043	16175	0.1609679688363076
R1	cpdb	0	network_modules	347	TRUE	4.328617483530923e-8	186	20	8	0.4	0.043010752688172046	GO:0006399	GO:BP	tRNA metabolic process	16175	2160		0.5714285714285714	0.625	186	15989	8	12	178	15977	16175	0.1282125593781079
R1	cpdb	0	network_modules	347	TRUE	1.6721396351245784e-5	182	14	6	0.42857142857142855	0.03296703296703297	REAC:R-HSA-6791226	REAC	Major pathway of rRNA processing in the nucleolus and cytosol	10916	1389		0.5	0.6	182	10734	6	8	176	10726	10916	0.11527850615208117
R1	cpdb	0	network_modules	347	TRUE	2.300326102744175e-5	192	14	6	0.42857142857142855	0.03125	REAC:R-HSA-8868773	REAC	rRNA processing in the nucleus and cytosol	10916	2734		0.75	0.8	192	10724	6	8	186	10716	10916	0.11203890113463244
R1	cpdb	0	network_modules	347	TRUE	3.111975582893574e-5	202	14	6	0.42857142857142855	0.0297029702970297	REAC:R-HSA-72312	REAC	rRNA processing	10916	2732		1	1	202	10714	6	8	196	10706	10916	0.10903783563924535
R1	cpdb	0	network_modules	347	TRUE	6.247984623879466e-4	251	20	6	0.3	0.02390438247011952	GO:0042254	GO:BP	ribosome biogenesis	16175	10060		0.7142857142857143	0.75	251	15924	6	14	245	15910	16175	0.08098377138138109
R1	cpdb	0	network_modules	347	TRUE	0.001612148634681136	65	20	4	0.2	0.06153846153846154	GO:0042273	GO:BP	ribosomal large subunit biogenesis	16175	10070		0.8571428571428571	0.875	65	16110	4	16	61	16094	16175	0.10899744814788868
R1	cpdb	0	network_modules	347	TRUE	0.008092586504489315	390	20	6	0.3	0.015384615384615385	GO:0022613	GO:BP	ribonucleoprotein complex biogenesis	16175	6620		1	1	390	15785	6	14	384	15771	16175	0.0632827216807319
R1	cpdb	0	network_modules	348	TRUE	8.250442034100058e-15	25	12	7	0.5833333333333334	0.28	GO:0014059	GO:BP	regulation of dopamine secretion	16175	4629		0	0.02	25	16150	7	5	18	16145	16175	0.40353594172354845
R1	cpdb	0	network_modules	348	TRUE	2.030563271880685e-14	28	12	7	0.5833333333333334	0.25	GO:0014046	GO:BP	dopamine secretion	16175	4616		0.02040816326530612	0.04	28	16147	7	5	21	16142	16175	0.3812194743321864
R1	cpdb	0	network_modules	348	TRUE	5.76600493745951e-14	32	12	7	0.5833333333333334	0.21875	GO:0017158	GO:BP	regulation of calcium ion-dependent exocytosis	16175	5288		0.04081632653061224	0.06	32	16143	7	5	25	16138	16175	0.35649069965397123
R1	cpdb	0	network_modules	348	TRUE	1.7613159294598674e-13	37	12	7	0.5833333333333334	0.1891891891891892	GO:0050433	GO:BP	regulation of catecholamine secretion	16175	13187		0.061224489795918366	0.08	37	16138	7	5	30	16133	16175	0.3314046623359009
R1	cpdb	0	network_modules	348	TRUE	3.1868871710652157e-13	40	12	7	0.5833333333333334	0.175	GO:0050432	GO:BP	catecholamine secretion	16175	13186		0.08163265306122448	0.1	40	16135	7	5	33	16130	16175	0.31866267752146116
R1	cpdb	0	network_modules	348	TRUE	3.841969354235166e-13	41	12	7	0.5833333333333334	0.17073170731707318	GO:0015872	GO:BP	dopamine transport	16175	4980		0.10204081632653061	0.12	41	16134	7	5	34	16129	16175	0.3147288104219796
R1	cpdb	0	network_modules	348	TRUE	1.7027775938380458e-12	50	12	7	0.5833333333333334	0.14	GO:0017156	GO:BP	calcium-ion regulated exocytosis	16175	5286		0.12244897959183673	0.14	50	16125	7	5	43	16120	16175	0.28480547297159164
R1	cpdb	0	network_modules	348	TRUE	3.0158448539136025e-12	54	12	7	0.5833333333333334	0.12962962962962962	GO:0051937	GO:BP	catecholamine transport	16175	14007		0.14285714285714285	0.16	54	16121	7	5	47	16116	16175	0.27397137718661546
R1	cpdb	0	network_modules	348	TRUE	5.801557451376016e-12	59	12	7	0.5833333333333334	0.11864406779661017	GO:0051952	GO:BP	regulation of amine transport	16175	14022		0.16326530612244897	0.18	59	16116	7	5	52	16111	16175	0.2620063997779957
R1	cpdb	0	network_modules	348	TRUE	6.824432126354268e-12	10	9	5	0.5555555555555556	0.5	REAC:R-HSA-168799	REAC	Neurotoxicity of clostridium toxins	10916	1592		0	0.1111111111111111	10	10906	5	4	5	10902	10916	0.5266355228033709
R1	cpdb	0	network_modules	348	TRUE	1.0550023080033004e-11	64	12	7	0.5833333333333334	0.109375	GO:0015844	GO:BP	monoamine transport	16175	4954		0.1836734693877551	0.2	64	16111	7	5	57	16106	16175	0.25146853309581235
R1	cpdb	0	network_modules	348	TRUE	1.6446057013051218e-11	68	12	7	0.5833333333333334	0.10294117647058823	GO:0015837	GO:BP	amine transport	16175	4947		0.20408163265306123	0.22	68	16107	7	5	61	16102	16175	0.24388645952068513
R1	cpdb	0	network_modules	348	TRUE	2.7603462905950623e-11	73	12	7	0.5833333333333334	0.0958904109589041	GO:0071277	GO:BP	cellular response to calcium ion	16175	16534		0.22448979591836735	0.24	73	16102	7	5	66	16097	16175	0.2352969298169371
R1	cpdb	0	network_modules	348	TRUE	9.861894409471119e-11	87	12	7	0.5833333333333334	0.08045977011494253	GO:1903305	GO:BP	regulation of regulated secretory pathway	16175	22892		0.24489795918367346	0.26	87	16088	7	5	80	16083	16175	0.21530645107175536
R1	cpdb	0	network_modules	348	TRUE	5.337118887277848e-10	110	12	7	0.5833333333333334	0.06363636363636363	GO:0051592	GO:BP	response to calcium ion	16175	13809		0.2653061224489796	0.28	110	16065	7	5	103	16060	16175	0.19114422202880285
R1	cpdb	0	network_modules	348	TRUE	1.432232921659324e-9	25	9	5	0.5555555555555556	0.2	REAC:R-HSA-5339562	REAC	Uptake and actions of bacterial toxins	10916	2626		0.125	0.2222222222222222	25	10891	5	4	20	10887	10916	0.33247707522119846
R1	cpdb	0	network_modules	348	TRUE	2.987613935955542e-9	140	12	7	0.5833333333333334	0.05	GO:0071248	GO:BP	cellular response to metal ion	16175	16509		0.2857142857142857	0.3	140	16035	7	5	133	16030	16175	0.169044092527194
R1	cpdb	0	network_modules	348	TRUE	4.435519292076742e-9	148	12	7	0.5833333333333334	0.0472972972972973	GO:0017157	GO:BP	regulation of exocytosis	16175	5287		0.30612244897959184	0.32	148	16027	7	5	141	16022	16175	0.16431136002922891
R1	cpdb	0	network_modules	348	TRUE	8.062584895647428e-9	161	12	7	0.5833333333333334	0.043478260869565216	GO:0045055	GO:BP	regulated exocytosis	16175	11253		0.32653061224489793	0.34	161	16014	7	5	154	16009	16175	0.15738139473479326
R1	cpdb	0	network_modules	348	TRUE	5.8256931306682054e-8	213	12	7	0.5833333333333334	0.03286384976525822	GO:0010038	GO:BP	response to metal ion	16175	3847		0.3469387755102041	0.36	213	15962	7	5	206	15957	16175	0.1362827602925941
R1	cpdb	0	network_modules	348	TRUE	6.859527041141135e-8	218	12	7	0.5833333333333334	0.03211009174311927	GO:0015850	GO:BP	organic hydroxy compound transport	16175	4959		0.3673469387755102	0.38	218	15957	7	5	211	15952	16175	0.1346588766370154
R1	cpdb	0	network_modules	348	TRUE	8.844398717304408e-8	409	12	8	0.6666666666666666	0.019559902200488997	GO:0060627	GO:BP	regulation of vesicle-mediated transport	16175	14803		0.3877551020408163	0.4	409	15766	8	4	401	15762	16175	0.11131851891822886
R1	cpdb	0	network_modules	348	TRUE	2.3790645928645742e-7	66	9	5	0.5555555555555556	0.07575757575757576	REAC:R-HSA-9824439	REAC	Bacterial Infection Pathways	10916	204		0.25	0.3333333333333333	66	10850	5	4	61	10846	10916	0.20361998551177604
R1	cpdb	0	network_modules	348	TRUE	2.562877206073613e-7	263	12	7	0.5833333333333334	0.026615969581749048	GO:0006887	GO:BP	exocytosis	16175	2543		0.40816326530612246	0.42	263	15912	7	5	256	15907	16175	0.12217241312078495
R1	cpdb	0	network_modules	348	TRUE	3.931139167445477e-7	16	12	4	0.3333333333333333	0.25	GO:0048791	GO:BP	calcium ion-regulated exocytosis of neurotransmitter	16175	13037		0.42857142857142855	0.44	16	16159	4	8	12	16151	16175	0.2880678133321143
R1	cpdb	0	network_modules	348	TRUE	4.3046484678401556e-7	4	9	3	0.3333333333333333	0.75	REAC:R-HSA-5250968	REAC	Toxicity of botulinum toxin type A (botA)	10916	2523		0.375	0.4444444444444444	4	10912	3	6	1	10906	10916	0.4997479392411747
R1	cpdb	0	network_modules	348	TRUE	5.138685050456018e-7	17	12	4	0.3333333333333333	0.23529411764705882	GO:1903861	GO:BP	positive regulation of dendrite extension	16175	23339		0.4489795918367347	0.46	17	16158	4	8	13	16150	16175	0.27942348745437384
R1	cpdb	0	network_modules	348	TRUE	6.604264781772455e-7	18	12	4	0.3333333333333333	0.2222222222222222	GO:1903859	GO:BP	regulation of dendrite extension	16175	23337		0.46938775510204084	0.48	18	16157	4	8	14	16149	16175	0.27150869653368737
R1	cpdb	0	network_modules	348	TRUE	8.280806127247837e-7	311	12	7	0.5833333333333334	0.022508038585209004	GO:0023061	GO:BP	signal release	16175	6645		0.4897959183673469	0.5	311	15864	7	5	304	15859	16175	0.11193043731665445
R1	cpdb	0	network_modules	348	TRUE	1.0757183387749328e-6	5	9	3	0.3333333333333333	0.6	REAC:R-HSA-5250955	REAC	Toxicity of botulinum toxin type D (botD)	10916	2526		0.5	0.6666666666666666	5	10911	3	6	2	10905	10916	0.44688564364054995
R1	cpdb	0	network_modules	348	TRUE	1.0757183387749328e-6	5	9	3	0.3333333333333333	0.6	REAC:R-HSA-5250981	REAC	Toxicity of botulinum toxin type F (botF)	10916	2528		0.5	0.6666666666666666	5	10911	3	6	2	10905	10916	0.44688564364054995
R1	cpdb	0	network_modules	348	TRUE	2.2879196939474698e-6	24	12	4	0.3333333333333333	0.16666666666666666	GO:0097484	GO:BP	dendrite extension	16175	18672		0.5102040816326531	0.52	24	16151	4	8	20	16143	16175	0.23491451141052108
R1	cpdb	0	network_modules	348	TRUE	5.118311428681744e-6	404	12	7	0.5833333333333334	0.017326732673267328	GO:1903530	GO:BP	regulation of secretion by cell	16175	23080		0.5306122448979592	0.54	404	15771	7	5	397	15766	16175	0.09749115534824611
R1	cpdb	0	network_modules	348	TRUE	9.54578861276129e-6	442	12	7	0.5833333333333334	0.01583710407239819	GO:0051046	GO:BP	regulation of secretion	16175	13456		0.5510204081632653	0.56	442	15733	7	5	435	15728	16175	0.09292604322861162
R1	cpdb	0	network_modules	348	TRUE	1.727488507680671e-5	117	12	5	0.4166666666666667	0.042735042735042736	GO:0099504	GO:BP	synaptic vesicle cycle	16175	19100		0.5714285714285714	0.58	117	16058	5	7	112	16051	16175	0.1316492564941862
R1	cpdb	0	network_modules	348	TRUE	2.0466415199672766e-5	121	12	5	0.4166666666666667	0.04132231404958678	GO:0099003	GO:BP	vesicle-mediated transport in synapse	16175	18999		0.5918367346938775	0.6	121	16054	5	7	116	16047	16175	0.1293928752386493
R1	cpdb	0	network_modules	348	TRUE	3.267555807267095e-5	9	12	3	0.25	0.3333333333333333	GO:0045956	GO:BP	positive regulation of calcium ion-dependent exocytosis	16175	11748		0.6122448979591837	0.62	9	16166	3	9	6	16157	16175	0.28821974185931526
R1	cpdb	0	network_modules	348	TRUE	4.516999483852924e-5	49	12	4	0.3333333333333333	0.08163265306122448	GO:0048488	GO:BP	synaptic vesicle endocytosis	16175	12781		0.6326530612244898	0.66	49	16126	4	8	45	16118	16175	0.16376698283078284
R1	cpdb	0	network_modules	348	TRUE	4.516999483852924e-5	49	12	4	0.3333333333333333	0.08163265306122448	GO:0140238	GO:BP	presynaptic endocytosis	16175	19709		0.6326530612244898	0.66	49	16126	4	8	45	16118	16175	0.16376698283078284
R1	cpdb	0	network_modules	348	TRUE	6.450048365146401e-5	583	12	7	0.5833333333333334	0.012006861063464836	GO:0032940	GO:BP	secretion by cell	16175	7926		0.673469387755102	0.68	583	15592	7	5	576	15587	16175	0.08000300378707008
R1	cpdb	0	network_modules	348	TRUE	9.012820259323374e-5	58	12	4	0.3333333333333333	0.06896551724137931	GO:0016079	GO:BP	synaptic vesicle exocytosis	16175	5106		0.6938775510204082	0.7	58	16117	4	8	54	16109	16175	0.1503139914737635
R1	cpdb	0	network_modules	348	TRUE	9.66446443492482e-5	59	12	4	0.3333333333333333	0.06779661016949153	GO:0036465	GO:BP	synaptic vesicle recycling	16175	9613		0.7142857142857143	0.72	59	16116	4	8	55	16108	16175	0.1490113808099532
R1	cpdb	0	network_modules	348	TRUE	1.3043922632479662e-4	646	12	7	0.5833333333333334	0.010835913312693499	GO:0140352	GO:BP	export from cell	16175	19748		0.7346938775510204	0.74	646	15529	7	5	639	15524	16175	0.07561390816343408
R1	cpdb	0	network_modules	348	TRUE	1.3464641061512725e-4	649	12	7	0.5833333333333334	0.01078582434514638	GO:0046903	GO:BP	secretion	16175	12430		0.7551020408163265	0.76	649	15526	7	5	642	15521	16175	0.07542047992534044
R1	cpdb	0	network_modules	348	TRUE	3.330572398620951e-4	80	12	4	0.3333333333333333	0.05	GO:0048639	GO:BP	positive regulation of developmental growth	16175	12897		0.7755102040816326	0.78	80	16095	4	8	76	16087	16175	0.12754691703428883
R1	cpdb	0	network_modules	348	TRUE	5.033594723185619e-4	3	9	2	0.2222222222222222	0.6666666666666666	REAC:R-HSA-5250958	REAC	Toxicity of botulinum toxin type B (botB)	10916	2524		0.75	0.8888888888888888	3	10913	2	7	1	10906	10916	0.3846355971777174
R1	cpdb	0	network_modules	348	TRUE	5.033594723185619e-4	3	9	2	0.2222222222222222	0.6666666666666666	REAC:R-HSA-5250992	REAC	Toxicity of botulinum toxin type E (botE)	10916	2527		0.75	0.8888888888888888	3	10913	2	7	1	10906	10916	0.3846355971777174
R1	cpdb	0	network_modules	348	TRUE	8.52664201994245e-4	101	12	4	0.3333333333333333	0.039603960396039604	GO:0007269	GO:BP	neurotransmitter secretion	16175	2797		0.7959183673469388	0.82	101	16074	4	8	97	16066	16175	0.11314031088717601
R1	cpdb	0	network_modules	348	TRUE	8.52664201994245e-4	101	12	4	0.3333333333333333	0.039603960396039604	GO:0099643	GO:BP	signal release from synapse	16175	19183		0.7959183673469388	0.82	101	16074	4	8	97	16066	16175	0.11314031088717601
R1	cpdb	0	network_modules	348	TRUE	0.0012913909892113356	112	12	4	0.3333333333333333	0.03571428571428571	GO:1990138	GO:BP	neuron projection extension	16175	25092		0.8367346938775511	0.84	112	16063	4	8	108	16055	16175	0.10725407448676738
R1	cpdb	0	network_modules	348	TRUE	0.0015384423417409746	117	12	4	0.3333333333333333	0.03418803418803419	GO:0030307	GO:BP	positive regulation of cell growth	16175	6762		0.8571428571428571	0.86	117	16058	4	8	113	16050	16175	0.10485424040286408
R1	cpdb	0	network_modules	348	TRUE	0.0018394608812429397	89	7	3	0.42857142857142855	0.033707865168539325	KEGG:04512	KEGG	ECM-receptor interaction	8484	314		NA	1	89	8395	3	4	86	8391	8484	0.11791899342930567
R1	cpdb	0	network_modules	348	TRUE	0.002273720557661187	129	12	4	0.3333333333333333	0.031007751937984496	GO:0048588	GO:BP	developmental cell growth	16175	12859		0.8775510204081632	0.88	129	16046	4	8	125	16038	16175	0.09966834583746793
R1	cpdb	0	network_modules	348	TRUE	0.002518474218478278	35	12	3	0.25	0.08571428571428572	GO:1903307	GO:BP	positive regulation of regulated secretory pathway	16175	22894		0.8979591836734694	0.9	35	16140	3	9	32	16131	16175	0.14532917967024894
R1	cpdb	0	network_modules	348	TRUE	0.002646679853866158	134	12	4	0.3333333333333333	0.029850746268656716	GO:0060560	GO:BP	developmental growth involved in morphogenesis	16175	14744		0.9183673469387755	0.92	134	16041	4	8	130	16033	16175	0.09771349932650822
R1	cpdb	0	network_modules	348	TRUE	0.002919748366870651	56	9	3	0.3333333333333333	0.05357142857142857	REAC:R-HSA-6794361	REAC	Neurexins and neuroligins	10916	1587		1	1	56	10860	3	6	53	10854	10916	0.13196722214161688
R1	cpdb	0	network_modules	348	TRUE	0.0036253890509466598	145	12	4	0.3333333333333333	0.027586206896551724	GO:0006836	GO:BP	neurotransmitter transport	16175	2506		0.9387755102040817	0.94	145	16030	4	8	141	16022	16175	0.09376966135315373
R1	cpdb	0	network_modules	348	TRUE	0.005498381542105197	161	12	4	0.3333333333333333	0.024844720496894408	GO:0048638	GO:BP	regulation of developmental growth	16175	12896		0.9591836734693877	0.98	161	16014	4	8	157	16006	16175	0.08876133615513557
R1	cpdb	0	network_modules	348	TRUE	0.005498381542105197	161	12	4	0.3333333333333333	0.024844720496894408	GO:0045927	GO:BP	positive regulation of growth	16175	11721		0.9591836734693877	0.98	161	16014	4	8	157	16006	16175	0.08876133615513557
R1	cpdb	0	network_modules	348	TRUE	0.009541058009608942	185	12	4	0.3333333333333333	0.021621621621621623	GO:0022604	GO:BP	regulation of cell morphogenesis	16175	6612		1	1	185	15990	4	8	181	15982	16175	0.0824858236428818
R1	cpdb	0	network_modules	350	TRUE	2.059819618691289e-15	131	12	10	0.8333333333333334	0.07633587786259542	KEGG:04142	KEGG	Lysosome	8484	279		0	0.5	131	8353	10	2	121	8351	8484	0.24965349392860503
R1	cpdb	0	network_modules	350	TRUE	5.033299281971196e-13	11	16	6	0.375	0.5454545454545454	REAC:R-HSA-2206281	REAC	Mucopolysaccharidoses	10916	1493		0	0.1111111111111111	11	10905	6	10	5	10895	10916	0.45161021659257955
R1	cpdb	0	network_modules	350	TRUE	2.829916876043902e-12	19	12	6	0.5	0.3157894736842105	KEGG:00531	KEGG	Glycosaminoglycan degradation	8484	75		1	1	19	8465	6	6	13	8459	8484	0.3963039939736256
R1	cpdb	0	network_modules	350	TRUE	1.1859444000271736e-9	33	16	6	0.375	0.18181818181818182	REAC:R-HSA-5663084	REAC	Diseases of carbohydrate metabolism	10916	763		0.125	0.2222222222222222	33	10883	6	10	27	10873	10916	0.25959419263245
R1	cpdb	0	network_modules	350	TRUE	7.338596060803259e-8	125	16	7	0.4375	0.056	REAC:R-HSA-1630316	REAC	Glycosaminoglycan metabolism	10916	1076		0.25	0.3333333333333333	125	10791	7	9	118	10782	10916	0.15342067328934184
R1	cpdb	0	network_modules	350	TRUE	7.318844763753219e-7	288	16	8	0.5	0.027777777777777776	REAC:R-HSA-71387	REAC	Metabolism of carbohydrates	10916	1422		0.375	0.4444444444444444	288	10628	8	8	280	10620	10916	0.11321794523183788
R1	cpdb	0	network_modules	350	TRUE	8.128299580512532e-6	245	16	7	0.4375	0.02857142857142857	REAC:R-HSA-5668914	REAC	Diseases of metabolism	10916	767		0.5	0.5555555555555556	245	10671	7	9	238	10662	10916	0.10735721564123175
R1	cpdb	0	network_modules	350	TRUE	1.0299939857580574e-5	24	16	4	0.25	0.16666666666666666	REAC:R-HSA-2024096	REAC	HS-GAG degradation	10916	1108		0.625	0.6666666666666666	24	10892	4	12	20	10880	10916	0.20270038548412667
R1	cpdb	0	network_modules	350	TRUE	1.80735011646004e-4	12	16	3	0.1875	0.25	REAC:R-HSA-1663150	REAC	The activation of arylsulfatases	10916	2498		0.75	0.7777777777777778	12	10904	3	13	9	10891	10916	0.21551338836944317
R1	cpdb	0	network_modules	350	TRUE	3.719126298603337e-4	57	16	4	0.25	0.07017543859649122	REAC:R-HSA-1638091	REAC	Heparan sulfate/heparin (HS-GAG) metabolism	10916	1119		0.875	0.8888888888888888	57	10859	4	12	53	10847	10916	0.13012203652653828
R1	cpdb	0	network_modules	350	TRUE	7.045556296662869e-4	16	17	3	0.17647058823529413	0.1875	GO:0006027	GO:BP	glycosaminoglycan catabolic process	16175	1900		0	0.25	16	16159	3	14	13	16145	16175	0.18106679952472396
R1	cpdb	0	network_modules	350	TRUE	0.0017957596413004033	196	17	5	0.29411764705882354	0.025510204081632654	GO:1901136	GO:BP	carbohydrate derivative catabolic process	16175	21244		0.3333333333333333	0.5	196	15979	5	12	191	15967	16175	0.08360293080349897
R1	cpdb	0	network_modules	350	TRUE	0.0019299916390394345	22	17	3	0.17647058823529413	0.13636363636363635	GO:0006026	GO:BP	aminoglycan catabolic process	16175	1899		0.6666666666666666	0.75	22	16153	3	14	19	16139	16175	0.15411649072490274
R1	cpdb	0	network_modules	350	TRUE	0.0036538445614977405	27	17	3	0.17647058823529413	0.1111111111111111	GO:0006516	GO:BP	glycoprotein catabolic process	16175	2238		1	1	27	16148	3	14	24	16134	16175	0.13889239510379298
R1	cpdb	0	network_modules	350	TRUE	0.005741148945869013	36	16	3	0.1875	0.08333333333333333	REAC:R-HSA-9840310	REAC	Glycosphingolipid catabolism	10916	1078		1	1	36	10880	3	13	33	10867	10916	0.12309463408383023
R1	cpdb	0	network_modules	351	TRUE	2.1371893853131925e-20	8	22	8	0.36363636363636365	1	REAC:R-HSA-72731	REAC	Recycling of eIF2:GDP	10916	1953		0	0.2	8	10908	8	14	0	10894	10916	0.6026355866511396
R1	cpdb	0	network_modules	351	TRUE	1.8291230812003563e-15	111	23	11	0.4782608695652174	0.0990990990990991	GO:0006413	GO:BP	translational initiation	16175	2171		0	0.043478260869565216	111	16064	11	12	100	16052	16175	0.21547398654660252
R1	cpdb	0	network_modules	351	TRUE	9.021755416328128e-13	43	23	8	0.34782608695652173	0.18604651162790697	GO:0002183	GO:BP	cytoplasmic translational initiation	16175	731		0.045454545454545456	0.08695652173913043	43	16132	8	15	35	16117	16175	0.2529570702512289
R1	cpdb	0	network_modules	351	TRUE	7.090023242824402e-10	158	23	9	0.391304347826087	0.056962025316455694	GO:0002181	GO:BP	cytoplasmic translation	16175	729		0.09090909090909091	0.13043478260869565	158	16017	9	14	149	16003	16175	0.14639008344595558
R1	cpdb	0	network_modules	351	TRUE	7.535103127503556e-10	292	22	11	0.5	0.03767123287671233	REAC:R-HSA-72766	REAC	Translation	10916	2565		0.25	0.4	292	10624	11	11	281	10613	10916	0.13180643084819574
R1	cpdb	0	network_modules	351	TRUE	4.329378593399056e-9	566	23	12	0.5217391304347826	0.02120141342756184	GO:0006412	GO:BP	translation	16175	2170		0.13636363636363635	0.17391304347826086	566	15609	12	11	554	15598	16175	0.09995452407176579
R1	cpdb	0	network_modules	351	TRUE	1.5795115755472842e-8	120	22	8	0.36363636363636365	0.06666666666666667	REAC:R-HSA-72613	REAC	Eukaryotic Translation Initiation	10916	871		0.5	0.8	120	10796	8	14	112	10782	10916	0.15198292195412766
R1	cpdb	0	network_modules	351	TRUE	1.5795115755472842e-8	120	22	8	0.36363636363636365	0.06666666666666667	REAC:R-HSA-72737	REAC	Cap-dependent Translation Initiation	10916	304		0.5	0.8	120	10796	8	14	112	10782	10916	0.15198292195412766
R1	cpdb	0	network_modules	351	TRUE	1.108535025257934e-7	21	23	5	0.21739130434782608	0.23809523809523808	GO:0014003	GO:BP	oligodendrocyte development	16175	4576		0.18181818181818182	0.21739130434782608	21	16154	5	18	16	16136	16175	0.2264571699473567
R1	cpdb	0	network_modules	351	TRUE	5.547693886873508e-6	15	22	4	0.18181818181818182	0.26666666666666666	REAC:R-HSA-9648895	REAC	Response of EIF2AK1 (HRI) to heme deficiency	10916	2086		1	1	15	10901	4	18	11	10883	10916	0.218899592836248
R1	cpdb	0	network_modules	351	TRUE	5.703229553126613e-6	290	23	8	0.34782608695652173	0.027586206896551724	GO:0006417	GO:BP	regulation of translation	16175	2174		0.22727272727272727	0.2608695652173913	290	15885	8	15	282	15870	16175	0.09381689487868644
R1	cpdb	0	network_modules	351	TRUE	6.739805166755432e-6	100	23	6	0.2608695652173913	0.06	GO:0009266	GO:BP	response to temperature stimulus	16175	3431		0.2727272727272727	0.30434782608695654	100	16075	6	17	94	16058	16175	0.12261021581520339
R1	cpdb	0	network_modules	351	TRUE	7.295952288969515e-6	46	23	5	0.21739130434782608	0.10869565217391304	GO:0048709	GO:BP	oligodendrocyte differentiation	16175	12966		0.3181818181818182	0.34782608695652173	46	16129	5	18	41	16111	16175	0.15203223939657326
R1	cpdb	0	network_modules	351	TRUE	3.12265252131469e-5	61	23	5	0.21739130434782608	0.08196721311475409	GO:0021782	GO:BP	glial cell development	16175	6360		0.36363636363636365	0.391304347826087	61	16114	5	18	56	16096	16175	0.1315135419748673
R1	cpdb	0	network_modules	351	TRUE	6.770799027514083e-5	71	23	5	0.21739130434782608	0.07042253521126761	GO:0009408	GO:BP	response to heat	16175	3473		0.4090909090909091	0.43478260869565216	71	16104	5	18	66	16086	16175	0.1215856447004075
R1	cpdb	0	network_modules	351	TRUE	8.94215777665498e-5	75	23	5	0.21739130434782608	0.06666666666666667	GO:0006446	GO:BP	regulation of translational initiation	16175	2196		0.45454545454545453	0.4782608695652174	75	16100	5	18	70	16082	16175	0.11817627008042429
R1	cpdb	0	network_modules	351	TRUE	1.3138318275737813e-4	434	23	8	0.34782608695652173	0.018433179723502304	GO:0010608	GO:BP	post-transcriptional regulation of gene expression	16175	4255		0.5	0.5217391304347826	434	15741	8	15	426	15726	16175	0.07496036597140902
R1	cpdb	0	network_modules	351	TRUE	2.373829067987285e-4	91	23	5	0.21739130434782608	0.054945054945054944	GO:0009749	GO:BP	response to glucose	16175	3646		0.5454545454545454	0.5652173913043478	91	16084	5	18	86	16066	16175	0.10683958747758243
R1	cpdb	0	network_modules	351	TRUE	2.647953490662703e-4	93	23	5	0.21739130434782608	0.053763440860215055	GO:0009746	GO:BP	response to hexose	16175	3643		0.5909090909090909	0.6521739130434783	93	16082	5	18	88	16064	16175	0.10562939042806055
R1	cpdb	0	network_modules	351	TRUE	2.647953490662703e-4	93	23	5	0.21739130434782608	0.053763440860215055	GO:0034284	GO:BP	response to monosaccharide	16175	8541		0.5909090909090909	0.6521739130434783	93	16082	5	18	88	16064	16175	0.10562939042806055
R1	cpdb	0	network_modules	351	TRUE	4.005787083698166e-4	101	23	5	0.21739130434782608	0.04950495049504951	GO:0009743	GO:BP	response to carbohydrate	16175	3640		0.6818181818181818	0.6956521739130435	101	16074	5	18	96	16056	16175	0.10114804827391051
R1	cpdb	0	network_modules	351	TRUE	7.334943002228497e-4	114	23	5	0.21739130434782608	0.043859649122807015	GO:0050852	GO:BP	T cell receptor signaling pathway	16175	13300		0.7272727272727273	0.7391304347826086	114	16061	5	18	109	16043	16175	0.09488230104520948
R1	cpdb	0	network_modules	351	TRUE	9.082999546291666e-4	119	23	5	0.21739130434782608	0.04201680672268908	GO:0010001	GO:BP	glial cell differentiation	16175	3822		0.7727272727272727	0.782608695652174	119	16056	5	18	114	16038	16175	0.09274554541125146
R1	cpdb	0	network_modules	351	TRUE	0.0011249079895029898	236	23	6	0.2608695652173913	0.025423728813559324	GO:0043434	GO:BP	response to peptide hormone	16175	10691		0.8181818181818182	0.8260869565217391	236	15939	6	17	230	15922	16175	0.07750614917817927
R1	cpdb	0	network_modules	351	TRUE	0.0034674186519793953	156	23	5	0.21739130434782608	0.03205128205128205	GO:0042063	GO:BP	gliogenesis	16175	9949		0.8636363636363636	0.8695652173913043	156	16019	5	18	151	16001	16175	0.08021385323347086
R1	cpdb	0	network_modules	351	TRUE	0.0036916346566699854	158	23	5	0.21739130434782608	0.03164556962025317	GO:0050851	GO:BP	antigen receptor-mediated signaling pathway	16175	13299		0.9090909090909091	0.9130434782608695	158	16017	5	18	153	15999	16175	0.0796620880186067
R1	cpdb	0	network_modules	351	TRUE	0.004977048109978554	21	23	3	0.13043478260869565	0.14285714285714285	GO:0045947	GO:BP	negative regulation of translational initiation	16175	11739		0.9545454545454546	0.9565217391304348	21	16154	3	20	18	16134	16175	0.13533007461701302
R1	cpdb	0	network_modules	351	TRUE	0.0066150469696928576	23	23	3	0.13043478260869565	0.13043478260869565	GO:0001541	GO:BP	ovarian follicle development	16175	332		1	1	23	16152	3	20	20	16132	16175	0.1291965458578289
R1	cpdb	0	network_modules	352	TRUE	1.6265557518142072e-13	101	24	10	0.4166666666666667	0.09900990099009901	GO:0051209	GO:BP	release of sequestered calcium ion into cytosol	16175	13568		0	0.010638297872340425	101	16074	10	14	91	16060	16175	0.20084390403759078
R1	cpdb	0	network_modules	352	TRUE	1.8019289452279525e-13	102	24	10	0.4166666666666667	0.09803921568627451	GO:0051283	GO:BP	negative regulation of sequestering of calcium ion	16175	13619		0.010752688172043012	0.02127659574468085	102	16073	10	14	92	16059	16175	0.19983306090270986
R1	cpdb	0	network_modules	352	TRUE	1.9941062006995542e-13	103	24	10	0.4166666666666667	0.0970873786407767	GO:0051282	GO:BP	regulation of sequestering of calcium ion	16175	13618		0.021505376344086023	0.031914893617021274	103	16072	10	14	93	16058	16175	0.19883685721054264
R1	cpdb	0	network_modules	352	TRUE	2.1878893287938522e-13	160	24	11	0.4583333333333333	0.06875	GO:0097553	GO:BP	calcium ion transmembrane import into cytosol	16175	18700		0.03225806451612903	0.0425531914893617	160	16015	11	13	149	16002	16175	0.17467572704699566
R1	cpdb	0	network_modules	352	TRUE	2.6861052799401204e-13	106	24	10	0.4166666666666667	0.09433962264150944	GO:0051208	GO:BP	sequestering of calcium ion	16175	13567		0.043010752688172046	0.05319148936170213	106	16069	10	14	96	16055	16175	0.1959326189459747
R1	cpdb	0	network_modules	352	TRUE	2.9905274713722554e-13	65	24	9	0.375	0.13846153846153847	GO:1901019	GO:BP	regulation of calcium ion transmembrane transporter activity	16175	21141		0.053763440860215055	0.06382978723404255	65	16110	9	15	56	16095	16175	0.2260465852500224
R1	cpdb	0	network_modules	352	TRUE	4.874673353724319e-13	249	24	12	0.5	0.04819277108433735	GO:0070588	GO:BP	calcium ion transmembrane transport	16175	16193		0.06451612903225806	0.07446808510638298	249	15926	12	12	237	15914	16175	0.1517350268021583
R1	cpdb	0	network_modules	352	TRUE	3.2101091984256187e-12	24	24	7	0.2916666666666667	0.2916666666666667	GO:0060314	GO:BP	regulation of ryanodine-sensitive calcium-release channel activity	16175	14526		0.07526881720430108	0.0851063829787234	24	16151	7	17	17	16134	16175	0.29061410026210965
R1	cpdb	0	network_modules	352	TRUE	1.1609882447300786e-11	324	24	12	0.5	0.037037037037037035	GO:0006816	GO:BP	calcium ion transport	16175	2495		0.08602150537634409	0.09574468085106383	324	15851	12	12	312	15839	16175	0.13205736627399034
R1	cpdb	0	network_modules	352	TRUE	1.4409689157361612e-11	29	24	7	0.2916666666666667	0.2413793103448276	GO:0014808	GO:BP	release of sequestered calcium ion into cytosol by sarcoplasmic reticulum	16175	4688		0.0967741935483871	0.10638297872340426	29	16146	7	17	22	16129	16175	0.26413603668509045
R1	cpdb	0	network_modules	352	TRUE	1.4473943836594845e-11	233	24	11	0.4583333333333333	0.04721030042918455	GO:0006874	GO:BP	intracellular calcium ion homeostasis	16175	2532		0.10752688172043011	0.11702127659574468	233	15942	11	13	222	15929	16175	0.14361961428237516
R1	cpdb	0	network_modules	352	TRUE	1.8777939237628195e-11	30	24	7	0.2916666666666667	0.23333333333333334	GO:1903514	GO:BP	release of sequestered calcium ion into cytosol by endoplasmic reticulum	16175	23064		0.11827956989247312	0.1276595744680851	30	16145	7	17	23	16128	16175	0.2596491125320313
R1	cpdb	0	network_modules	352	TRUE	2.42109333938729e-11	60	24	8	0.3333333333333333	0.13333333333333333	GO:0051279	GO:BP	regulation of release of sequestered calcium ion into cytosol	16175	13615		0.12903225806451613	0.13829787234042554	60	16115	8	16	52	16099	16175	0.20901532121286234
R1	cpdb	0	network_modules	352	TRUE	2.6383088450969218e-11	246	24	11	0.4583333333333333	0.044715447154471545	GO:0055074	GO:BP	calcium ion homeostasis	16175	14230		0.13978494623655913	0.14893617021276595	246	15929	11	13	235	15916	16175	0.13957715083174171
R1	cpdb	0	network_modules	352	TRUE	4.4628257013350515e-11	258	24	11	0.4583333333333333	0.04263565891472868	GO:0006936	GO:BP	muscle contraction	16175	2575		0.15053763440860216	0.1595744680851064	258	15917	11	13	247	15904	16175	0.1361156201357238
R1	cpdb	0	network_modules	352	TRUE	6.174095723145678e-11	35	24	7	0.2916666666666667	0.2	GO:0070296	GO:BP	sarcoplasmic reticulum calcium ion transport	16175	16040		0.16129032258064516	0.1702127659574468	35	16140	7	17	28	16123	16175	0.24016915668907393
R1	cpdb	0	network_modules	352	TRUE	6.78336693040411e-11	182	24	10	0.4166666666666667	0.054945054945054944	GO:0051651	GO:BP	maintenance of location in cell	16175	13864		0.17204301075268819	0.18085106382978725	182	15993	10	14	172	15979	16175	0.1481661744907858
R1	cpdb	0	network_modules	352	TRUE	1.3602090845199048e-10	125	24	9	0.375	0.072	GO:1903169	GO:BP	regulation of calcium ion transmembrane transport	16175	22802		0.1827956989247312	0.19148936170212766	125	16050	9	15	116	16035	16175	0.16167598888020068
R1	cpdb	0	network_modules	352	TRUE	2.613065110597561e-10	303	24	11	0.4583333333333333	0.036303630363036306	GO:0003012	GO:BP	muscle system process	16175	1463		0.1935483870967742	0.20212765957446807	303	15872	11	13	292	15859	16175	0.12498890297906788
R1	cpdb	0	network_modules	352	TRUE	6.84861505687925e-10	229	24	10	0.4166666666666667	0.043668122270742356	GO:1904062	GO:BP	regulation of monoatomic cation transmembrane transport	16175	23501		0.20430107526881722	0.2127659574468085	229	15946	10	14	219	15932	16175	0.13133551860969916
R1	cpdb	0	network_modules	352	TRUE	1.115179827333335e-9	95	24	8	0.3333333333333333	0.08421052631578947	GO:2001257	GO:BP	regulation of cation channel activity	16175	26443		0.21505376344086022	0.22340425531914893	95	16080	8	16	87	16064	16175	0.16519759861175287
R1	cpdb	0	network_modules	352	TRUE	1.1196668790050873e-9	24	24	6	0.25	0.25	GO:0010880	GO:BP	regulation of release of sequestered calcium ion into cytosol by sarcoplasmic reticulum	16175	4466		0.22580645161290322	0.23404255319148937	24	16151	6	18	18	16133	16175	0.2488855179245867
R1	cpdb	0	network_modules	352	TRUE	2.629507458314242e-9	262	24	10	0.4166666666666667	0.03816793893129771	GO:0034765	GO:BP	regulation of monoatomic ion transmembrane transport	16175	8734		0.23655913978494625	0.24468085106382978	262	15913	10	14	252	15899	16175	0.12229036580040155
R1	cpdb	0	network_modules	352	TRUE	3.602615791626966e-9	179	24	9	0.375	0.05027932960893855	GO:0051924	GO:BP	regulation of calcium ion transport	16175	13997		0.24731182795698925	0.2553191489361702	179	15996	9	15	170	15981	16175	0.1341034866677998
R1	cpdb	0	network_modules	352	TRUE	4.1072859474740155e-9	274	24	10	0.4166666666666667	0.0364963503649635	GO:0051235	GO:BP	maintenance of location	16175	13585		0.25806451612903225	0.26595744680851063	274	15901	10	14	264	15887	16175	0.11940599329063588
R1	cpdb	0	network_modules	352	TRUE	4.187668932585275e-9	182	24	9	0.375	0.04945054945054945	GO:0032412	GO:BP	regulation of monoatomic ion transmembrane transporter activity	16175	7550		0.26881720430107525	0.2765957446808511	182	15993	9	15	173	15978	16175	0.13293833476077563
R1	cpdb	0	network_modules	352	TRUE	5.7214214610399494e-9	116	24	8	0.3333333333333333	0.06896551724137931	GO:0006937	GO:BP	regulation of muscle contraction	16175	2576		0.27956989247311825	0.2872340425531915	116	16059	8	16	108	16043	16175	0.1490030012884502
R1	cpdb	0	network_modules	352	TRUE	5.865911152624438e-9	284	24	10	0.4166666666666667	0.035211267605633804	GO:0010959	GO:BP	regulation of metal ion transport	16175	4536		0.2903225806451613	0.2978723404255319	284	15891	10	14	274	15877	16175	0.11714037773128516
R1	cpdb	0	network_modules	352	TRUE	6.178972025145993e-9	190	24	9	0.375	0.04736842105263158	GO:0022898	GO:BP	regulation of transmembrane transporter activity	16175	6629		0.3010752688172043	0.30851063829787234	190	15985	9	15	181	15970	16175	0.1299651347874489
R1	cpdb	0	network_modules	352	TRUE	6.5082614050238335e-9	407	24	11	0.4583333333333333	0.02702702702702703	GO:0098771	GO:BP	inorganic ion homeostasis	16175	18886		0.3118279569892473	0.3191489361702128	407	15768	11	13	396	15755	16175	0.10661642380725844
R1	cpdb	0	network_modules	352	TRUE	9.628944237205003e-9	422	24	11	0.4583333333333333	0.026066350710900472	GO:0030003	GO:BP	intracellular monoatomic cation homeostasis	16175	6648		0.3225806451612903	0.32978723404255317	422	15753	11	13	411	15740	16175	0.10453001206297435
R1	cpdb	0	network_modules	352	TRUE	1.0402498698630862e-8	575	24	12	0.5	0.020869565217391306	GO:0098662	GO:BP	inorganic cation transmembrane transport	16175	18818		0.3333333333333333	0.3404255319148936	575	15600	12	12	563	15588	16175	0.09669280872743534
R1	cpdb	0	network_modules	352	TRUE	1.0662979880409333e-8	426	24	11	0.4583333333333333	0.025821596244131457	GO:0006873	GO:BP	intracellular monoatomic ion homeostasis	16175	2531		0.34408602150537637	0.35106382978723405	426	15749	11	13	415	15736	16175	0.10399178475591253
R1	cpdb	0	network_modules	352	TRUE	1.0834142704377736e-8	577	24	12	0.5	0.02079722703639515	GO:0098655	GO:BP	monoatomic cation transmembrane transport	16175	18811		0.3548387096774194	0.3617021276595745	577	15598	12	12	565	15586	16175	0.09650557399429265
R1	cpdb	0	network_modules	352	TRUE	1.1227056745504006e-8	203	24	9	0.375	0.04433497536945813	GO:0032409	GO:BP	regulation of transporter activity	16175	7547		0.3655913978494624	0.3723404255319149	203	15972	9	15	194	15957	16175	0.1255076963153265
R1	cpdb	0	network_modules	352	TRUE	1.674302840495909e-8	54	15	6	0.4	0.1111111111111111	REAC:R-HSA-5578775	REAC	Ion homeostasis	10916	1273		0	0.2	54	10862	6	9	48	10853	10916	0.20887175601658614
R1	cpdb	0	network_modules	352	TRUE	2.1417974550070434e-8	15	24	5	0.20833333333333334	0.3333333333333333	GO:0010649	GO:BP	regulation of cell communication by electrical coupling	16175	4295		0.3763440860215054	0.3829787234042553	15	16160	5	19	10	16141	16175	0.26266678601259974
R1	cpdb	0	network_modules	352	TRUE	2.2561255280120643e-8	203	15	8	0.5333333333333333	0.03940886699507389	REAC:R-HSA-397014	REAC	Muscle contraction	10916	1496		0.25	0.4	203	10713	8	7	195	10706	10916	0.14133756824787203
R1	cpdb	0	network_modules	352	TRUE	2.3313404055547896e-8	78	24	7	0.2916666666666667	0.08974358974358974	GO:0006942	GO:BP	regulation of striated muscle contraction	16175	2580		0.3870967741935484	0.39361702127659576	78	16097	7	17	71	16080	16175	0.1596161455731469
R1	cpdb	0	network_modules	352	TRUE	2.8735954737438145e-8	467	24	11	0.4583333333333333	0.023554603854389723	GO:0055080	GO:BP	monoatomic cation homeostasis	16175	14233		0.3978494623655914	0.40425531914893614	467	15708	11	13	456	15695	16175	0.0988679822064759
R1	cpdb	0	network_modules	352	TRUE	3.0249114594812514e-8	630	24	12	0.5	0.01904761904761905	GO:0098660	GO:BP	inorganic ion transmembrane transport	16175	18816		0.40860215053763443	0.4148936170212766	630	15545	12	12	618	15533	16175	0.09186150078317527
R1	cpdb	0	network_modules	352	TRUE	3.305161951071127e-8	144	24	8	0.3333333333333333	0.05555555555555555	GO:0006941	GO:BP	striated muscle contraction	16175	2579		0.41935483870967744	0.425531914893617	144	16031	8	16	136	16015	16175	0.13314062763382134
R1	cpdb	0	network_modules	352	TRUE	3.450002122766205e-8	475	24	11	0.4583333333333333	0.023157894736842106	GO:0050801	GO:BP	monoatomic ion homeostasis	16175	13267		0.43010752688172044	0.43617021276595747	475	15700	11	13	464	15687	16175	0.09794392003004493
R1	cpdb	0	network_modules	352	TRUE	3.586266301755254e-8	341	24	10	0.4166666666666667	0.02932551319648094	GO:0043269	GO:BP	regulation of monoatomic ion transport	16175	10593		0.44086021505376344	0.44680851063829785	341	15834	10	14	331	15820	16175	0.10614932404519249
R1	cpdb	0	network_modules	352	TRUE	5.185040990979787e-8	354	24	10	0.4166666666666667	0.02824858757062147	GO:0034762	GO:BP	regulation of transmembrane transport	16175	8731		0.45161290322580644	0.4574468085106383	354	15821	10	14	344	15807	16175	0.10401306471355107
R1	cpdb	0	network_modules	352	TRUE	5.399127631554328e-8	130	15	7	0.4666666666666667	0.05384615384615385	REAC:R-HSA-5576891	REAC	Cardiac conduction	10916	306		0.5	0.6	130	10786	7	8	123	10778	10916	0.1555084574390048
R1	cpdb	0	network_modules	352	TRUE	5.679201646522941e-8	154	24	8	0.3333333333333333	0.05194805194805195	GO:0090257	GO:BP	regulation of muscle system process	16175	18146		0.46236559139784944	0.46808510638297873	154	16021	8	16	146	16005	16175	0.12854008934632938
R1	cpdb	0	network_modules	352	TRUE	6.301936610791891e-8	671	24	12	0.5	0.01788375558867362	GO:0034220	GO:BP	monoatomic ion transmembrane transport	16175	8508		0.4731182795698925	0.4787234042553192	671	15504	12	12	659	15492	16175	0.08863837251809924
R1	cpdb	0	network_modules	352	TRUE	6.988746351706673e-8	677	24	12	0.5	0.01772525849335303	GO:0030001	GO:BP	metal ion transport	16175	6646		0.4838709677419355	0.48936170212765956	677	15498	12	12	665	15486	16175	0.08819038961684168
R1	cpdb	0	network_modules	352	TRUE	8.967303700667056e-8	163	24	8	0.3333333333333333	0.049079754601226995	GO:0008016	GO:BP	regulation of heart contraction	16175	3097		0.4946236559139785	0.5	163	16012	8	16	155	15996	16175	0.12476141028779222
R1	cpdb	0	network_modules	352	TRUE	1.0679404550139218e-7	381	24	10	0.4166666666666667	0.026246719160104987	GO:0044057	GO:BP	regulation of system process	16175	10893		0.5053763440860215	0.5106382978723404	381	15794	10	14	371	15780	16175	0.099921219313084
R1	cpdb	0	network_modules	352	TRUE	1.2116753827826772e-7	534	24	11	0.4583333333333333	0.020599250936329586	GO:0055082	GO:BP	intracellular chemical homeostasis	16175	14235		0.5161290322580645	0.5212765957446809	534	15641	11	13	523	15628	16175	0.09176192825478464
R1	cpdb	0	network_modules	352	TRUE	1.2465308801143513e-7	251	10	7	0.7	0.027888446215139442	KEGG:04020	KEGG	Calcium signaling pathway	8484	250		0	0.5	251	8233	7	3	244	8230	8484	0.13592025123856485
R1	cpdb	0	network_modules	352	TRUE	2.2195326787073448e-7	748	24	12	0.5	0.016042780748663103	GO:0006812	GO:BP	monoatomic cation transport	16175	2492		0.5268817204301075	0.5319148936170213	748	15427	12	12	736	15415	16175	0.08328769602171597
R1	cpdb	0	network_modules	352	TRUE	2.3411691227237978e-7	55	24	6	0.25	0.10909090909090909	GO:0086065	GO:BP	cell communication involved in cardiac conduction	16175	17919		0.5376344086021505	0.5425531914893617	55	16120	6	18	49	16102	16175	0.16329724809262328
R1	cpdb	0	network_modules	352	TRUE	2.472862168180617e-7	185	24	8	0.3333333333333333	0.043243243243243246	GO:0060047	GO:BP	heart contraction	16175	14310		0.5483870967741935	0.5531914893617021	185	15990	8	16	177	15974	16175	0.11669589818574219
R1	cpdb	0	network_modules	352	TRUE	3.0598898277842583e-7	190	24	8	0.3333333333333333	0.042105263157894736	GO:1903522	GO:BP	regulation of blood circulation	16175	23072		0.5591397849462365	0.5638297872340425	190	15985	8	16	182	15969	16175	0.11505759973666006
R1	cpdb	0	network_modules	352	TRUE	3.190823125885625e-7	191	24	8	0.3333333333333333	0.041884816753926704	GO:0003015	GO:BP	heart process	16175	1466		0.5698924731182796	0.574468085106383	191	15984	8	16	183	15968	16175	0.11473753413490588
R1	cpdb	0	network_modules	352	TRUE	4.458501487914449e-7	61	24	6	0.25	0.09836065573770492	GO:0055117	GO:BP	regulation of cardiac muscle contraction	16175	14257		0.5806451612903226	0.5851063829787234	61	16114	6	18	55	16096	16175	0.15485397626076833
R1	cpdb	0	network_modules	352	TRUE	6.264742456179052e-7	623	24	11	0.4583333333333333	0.01765650080256822	GO:0019725	GO:BP	cellular homeostasis	16175	6020		0.5913978494623656	0.5957446808510638	623	15552	11	13	612	15539	16175	0.08409558258377774
R1	cpdb	0	network_modules	352	TRUE	1.0015476137738731e-6	30	24	5	0.20833333333333334	0.16666666666666666	GO:0010644	GO:BP	cell communication by electrical coupling	16175	4290		0.6021505376344086	0.6063829787234043	30	16145	5	19	25	16126	16175	0.18498888596066815
R1	cpdb	0	network_modules	352	TRUE	1.0061537249967463e-6	105	15	6	0.4	0.05714285714285714	REAC:R-HSA-2672351	REAC	Stimuli-sensing channels	10916	2354		0.75	0.8	105	10811	6	9	99	10802	10916	0.14836695311275183
R1	cpdb	0	network_modules	352	TRUE	1.9084881868647577e-6	11	24	4	0.16666666666666666	0.36363636363636365	GO:0060315	GO:BP	negative regulation of ryanodine-sensitive calcium-release channel activity	16175	14527		0.6129032258064516	0.6382978723404256	11	16164	4	20	7	16144	16175	0.24544403387133423
R1	cpdb	0	network_modules	352	TRUE	1.9084881868647577e-6	11	24	4	0.16666666666666666	0.36363636363636365	GO:1901844	GO:BP	regulation of cell communication by electrical coupling involved in cardiac conduction	16175	21788		0.6129032258064516	0.6382978723404256	11	16164	4	20	7	16144	16175	0.24544403387133423
R1	cpdb	0	network_modules	352	TRUE	1.9084881868647577e-6	11	24	4	0.16666666666666666	0.36363636363636365	GO:0051280	GO:BP	negative regulation of release of sequestered calcium ion into cytosol	16175	13616		0.6129032258064516	0.6382978723404256	11	16164	4	20	7	16144	16175	0.24544403387133423
R1	cpdb	0	network_modules	352	TRUE	2.7557525207937187e-6	82	24	6	0.25	0.07317073170731707	GO:0002027	GO:BP	regulation of heart rate	16175	629		0.6451612903225806	0.648936170212766	82	16093	6	18	76	16075	16175	0.13294363432417433
R1	cpdb	0	network_modules	352	TRUE	4.126878497071776e-6	13	24	4	0.16666666666666666	0.3076923076923077	GO:0051284	GO:BP	positive regulation of sequestering of calcium ion	16175	13620		0.6559139784946236	0.6595744680851063	13	16162	4	20	9	16142	16175	0.22562144616358287
R1	cpdb	0	network_modules	352	TRUE	4.862559473508524e-6	90	24	6	0.25	0.06666666666666667	GO:0061337	GO:BP	cardiac conduction	16175	15419		0.6666666666666666	0.6702127659574468	90	16085	6	18	84	16067	16175	0.12667278818425615
R1	cpdb	0	network_modules	352	TRUE	5.320299448474535e-6	763	24	11	0.4583333333333333	0.014416775884665793	GO:0048878	GO:BP	chemical homeostasis	16175	13119		0.6774193548387096	0.6808510638297872	763	15412	11	13	752	15399	16175	0.0747603217603354
R1	cpdb	0	network_modules	352	TRUE	1.3154433062148297e-5	49	24	5	0.20833333333333334	0.10204081632653061	GO:0051926	GO:BP	negative regulation of calcium ion transport	16175	13998		0.6881720430107527	0.6914893617021277	49	16126	5	19	44	16107	16175	0.14400785283410297
R1	cpdb	0	network_modules	352	TRUE	1.4601709373514066e-5	50	24	5	0.20833333333333334	0.1	GO:0032413	GO:BP	negative regulation of ion transmembrane transporter activity	16175	7551		0.6989247311827957	0.7021276595744681	50	16125	5	19	45	16106	16175	0.14252199040414432
R1	cpdb	0	network_modules	352	TRUE	1.7331417656854445e-5	111	24	6	0.25	0.05405405405405406	GO:0060048	GO:BP	cardiac muscle contraction	16175	14311		0.7096774193548387	0.7127659574468085	111	16064	6	18	105	16046	16175	0.11353085666214015
R1	cpdb	0	network_modules	352	TRUE	2.2239223453534354e-5	19	24	4	0.16666666666666666	0.21052631578947367	GO:0071312	GO:BP	cellular response to alkaloid	16175	16568		0.7204301075268817	0.723404255319149	19	16156	4	20	15	16136	16175	0.186244527810873
R1	cpdb	0	network_modules	352	TRUE	2.748430092888446e-5	182	15	6	0.4	0.03296703296703297	REAC:R-HSA-983712	REAC	Ion channel transport	10916	1272		1	1	182	10734	6	9	176	10725	10916	0.11105271067379276
R1	cpdb	0	network_modules	352	TRUE	2.8658543627238297e-5	57	24	5	0.20833333333333334	0.08771929824561403	GO:0032410	GO:BP	negative regulation of transporter activity	16175	7548		0.7311827956989247	0.7340425531914894	57	16118	5	19	52	16099	16175	0.1332315356761813
R1	cpdb	0	network_modules	352	TRUE	4.491765019767914e-5	358	24	8	0.3333333333333333	0.0223463687150838	GO:0008015	GO:BP	blood circulation	16175	3096		0.7419354838709677	0.7446808510638298	358	15817	8	16	350	15801	16175	0.08154302050720964
R1	cpdb	0	network_modules	352	TRUE	5.6092648933920635e-5	65	24	5	0.20833333333333334	0.07692307692307693	GO:1904063	GO:BP	negative regulation of cation transmembrane transport	16175	23502		0.7526881720430108	0.7553191489361702	65	16110	5	19	60	16091	16175	0.12449317716283392
R1	cpdb	0	network_modules	352	TRUE	6.066744668659922e-5	24	24	4	0.16666666666666666	0.16666666666666666	GO:1901020	GO:BP	negative regulation of calcium ion transmembrane transporter activity	16175	21142		0.7634408602150538	0.7659574468085106	24	16151	4	20	20	16131	16175	0.1654283532495408
R1	cpdb	0	network_modules	352	TRUE	7.215167692518026e-5	25	24	4	0.16666666666666666	0.16	GO:0086064	GO:BP	cell communication by electrical coupling involved in cardiac conduction	16175	17918		0.7741935483870968	0.7872340425531915	25	16150	4	20	21	16130	16175	0.16203037324710862
R1	cpdb	0	network_modules	352	TRUE	7.215167692518026e-5	25	24	4	0.16666666666666666	0.16	GO:0043279	GO:BP	response to alkaloid	16175	10600		0.7741935483870968	0.7872340425531915	25	16150	4	20	21	16130	16175	0.16203037324710862
R1	cpdb	0	network_modules	352	TRUE	8.178897320957461e-5	70	24	5	0.20833333333333334	0.07142857142857142	GO:0034766	GO:BP	negative regulation of monoatomic ion transmembrane transport	16175	8735		0.7956989247311828	0.7978723404255319	70	16105	5	19	65	16086	16175	0.11980171885442137
R1	cpdb	0	network_modules	352	TRUE	1.268177695996958e-4	87	10	4	0.4	0.04597701149425287	KEGG:04260	KEGG	Cardiac muscle contraction	8484	296		1	1	87	8397	4	6	83	8391	8484	0.13289716871060162
R1	cpdb	0	network_modules	352	TRUE	1.5635251887141397e-4	7	24	3	0.125	0.42857142857142855	GO:0031000	GO:BP	response to caffeine	16175	6991		0.8064516129032258	0.8191489361702128	7	16168	3	21	4	16147	16175	0.23087496910088323
R1	cpdb	0	network_modules	352	TRUE	1.5635251887141397e-4	7	24	3	0.125	0.42857142857142855	GO:0071313	GO:BP	cellular response to caffeine	16175	16569		0.8064516129032258	0.8191489361702128	7	16168	3	21	4	16147	16175	0.23087496910088323
R1	cpdb	0	network_modules	352	TRUE	1.7840356932660563e-4	31	24	4	0.16666666666666666	0.12903225806451613	GO:2001258	GO:BP	negative regulation of cation channel activity	16175	26444		0.8279569892473119	0.8404255319148937	31	16144	4	20	27	16124	16175	0.14520766540677896
R1	cpdb	0	network_modules	352	TRUE	1.7840356932660563e-4	31	24	4	0.16666666666666666	0.12903225806451613	GO:1901021	GO:BP	positive regulation of calcium ion transmembrane transporter activity	16175	21143		0.8279569892473119	0.8404255319148937	31	16144	4	20	27	16124	16175	0.14520766540677896
R1	cpdb	0	network_modules	352	TRUE	2.1672782642451527e-4	439	24	8	0.3333333333333333	0.018223234624145785	GO:0003013	GO:BP	circulatory system process	16175	1464		0.8494623655913979	0.851063829787234	439	15736	8	16	431	15720	16175	0.07263828435174925
R1	cpdb	0	network_modules	352	TRUE	2.601035927679577e-4	88	24	5	0.20833333333333334	0.056818181818181816	GO:0043271	GO:BP	negative regulation of monoatomic ion transport	16175	10595		0.8602150537634409	0.8617021276595744	88	16087	5	19	83	16068	16175	0.10632565167258048
R1	cpdb	0	network_modules	352	TRUE	2.7531554853923155e-4	89	24	5	0.20833333333333334	0.056179775280898875	GO:0034763	GO:BP	negative regulation of transmembrane transport	16175	8732		0.8709677419354839	0.8723404255319149	89	16086	5	19	84	16067	16175	0.10569769826025002
R1	cpdb	0	network_modules	352	TRUE	3.3233628618444287e-4	36	24	4	0.16666666666666666	0.1111111111111111	GO:0051281	GO:BP	positive regulation of release of sequestered calcium ion into cytosol	16175	13617		0.8817204301075269	0.8829787234042553	36	16139	4	20	32	16119	16175	0.13451501842518168
R1	cpdb	0	network_modules	352	TRUE	3.7225067479315904e-4	37	24	4	0.16666666666666666	0.10810810810810811	GO:1903170	GO:BP	negative regulation of calcium ion transmembrane transport	16175	22803		0.8924731182795699	0.8936170212765957	37	16138	4	20	33	16118	16175	0.13263902154438909
R1	cpdb	0	network_modules	352	TRUE	3.7451554401581413e-4	9	24	3	0.125	0.3333333333333333	GO:0060316	GO:BP	positive regulation of ryanodine-sensitive calcium-release channel activity	16175	14528		0.9032258064516129	0.9042553191489362	9	16166	3	21	6	16145	16175	0.2034230568890601
R1	cpdb	0	network_modules	352	TRUE	5.34501193424152e-4	10	24	3	0.125	0.3	GO:0071415	GO:BP	cellular response to purine-containing compound	16175	16667		0.9139784946236559	0.9148936170212766	10	16165	3	21	7	16144	16175	0.19289414781169373
R1	cpdb	0	network_modules	352	TRUE	0.001084833005377294	48	24	4	0.16666666666666666	0.08333333333333333	GO:2001259	GO:BP	positive regulation of cation channel activity	16175	26445		0.9247311827956989	0.925531914893617	48	16127	4	20	44	16107	16175	0.11601099343237364
R1	cpdb	0	network_modules	352	TRUE	0.0036063909603417355	18	24	3	0.125	0.16666666666666666	GO:0010881	GO:BP	regulation of cardiac muscle contraction by regulation of the release of sequestered calcium ion	16175	4467		0.9354838709677419	0.9361702127659575	18	16157	3	21	15	16136	16175	0.1432385527576149
R1	cpdb	0	network_modules	352	TRUE	0.004299986598605333	282	24	6	0.25	0.02127659574468085	GO:0042391	GO:BP	regulation of membrane potential	16175	10141		0.946236559139785	0.9468085106382979	282	15893	6	18	276	15875	16175	0.06849649453987665
R1	cpdb	0	network_modules	352	TRUE	0.00472059961142502	69	24	4	0.16666666666666666	0.057971014492753624	GO:1904427	GO:BP	positive regulation of calcium ion transmembrane transport	16175	23809		0.956989247311828	0.9574468085106383	69	16106	4	20	65	16086	16175	0.09605501368088011
R1	cpdb	0	network_modules	352	TRUE	0.005558913048152552	163	24	5	0.20833333333333334	0.03067484662576687	GO:0043270	GO:BP	positive regulation of monoatomic ion transport	16175	10594		0.967741935483871	0.9680851063829787	163	16012	5	19	158	15993	16175	0.07651737552578217
R1	cpdb	0	network_modules	352	TRUE	0.0060785703325781665	166	24	5	0.20833333333333334	0.030120481927710843	GO:0019722	GO:BP	calcium-mediated signaling	16175	6018		0.978494623655914	0.9787234042553191	166	16009	5	19	161	15990	16175	0.07575896509727265
R1	cpdb	0	network_modules	352	TRUE	0.006779710287488683	22	24	3	0.125	0.13636363636363635	GO:0010882	GO:BP	regulation of cardiac muscle contraction by calcium ion signaling	16175	4468		0.989247311827957	0.9893617021276596	22	16153	3	21	19	16132	16175	0.1293215278126346
R1	cpdb	0	network_modules	352	TRUE	0.008542609148804024	80	24	4	0.16666666666666666	0.05	GO:0032414	GO:BP	positive regulation of ion transmembrane transporter activity	16175	7552		1	1	80	16095	4	20	76	16075	16175	0.08886392631018665
R1	cpdb	0	network_modules	353	TRUE	1.1871441642676017e-4	36	19	4	0.21052631578947367	0.1111111111111111	REAC:R-HSA-3299685	REAC	Detoxification of Reactive Oxygen Species	10916	735		0	0.3333333333333333	36	10880	4	15	32	10865	10916	0.15092821549008953
R1	cpdb	0	network_modules	353	TRUE	2.4209692893432898e-4	44	19	4	0.21052631578947367	0.09090909090909091	GO:1990748	GO:BP	cellular detoxification	16175	25271		0	0.1	44	16131	4	15	40	16116	16175	0.13682183467984477
R1	cpdb	0	network_modules	353	TRUE	3.4598220615455344e-4	48	19	4	0.21052631578947367	0.08333333333333333	GO:0097237	GO:BP	cellular response to toxic substance	16175	18553		0.1111111111111111	0.2	48	16127	4	15	44	16112	16175	0.130857268658302
R1	cpdb	0	network_modules	353	TRUE	0.001249644959466613	17	19	3	0.15789473684210525	0.17647058823529413	GO:0019430	GO:BP	removal of superoxide radicals	16175	5782		0.2222222222222222	0.3	17	16158	3	16	14	16142	16175	0.16599808314375786
R1	cpdb	0	network_modules	353	TRUE	0.001343767847849446	67	19	4	0.21052631578947367	0.05970149253731343	GO:0098754	GO:BP	detoxification	16175	18873		0.3333333333333333	0.4	67	16108	4	15	63	16093	16175	0.11019762531858675
R1	cpdb	0	network_modules	353	TRUE	0.0014984612348917467	18	19	3	0.15789473684210525	0.16666666666666666	GO:0071450	GO:BP	cellular response to oxygen radical	16175	16684		0.4444444444444444	0.7	18	16157	3	16	15	16141	16175	0.16126254114621588
R1	cpdb	0	network_modules	353	TRUE	0.0014984612348917467	18	19	3	0.15789473684210525	0.16666666666666666	GO:0000303	GO:BP	response to superoxide	16175	89		0.4444444444444444	0.7	18	16157	3	16	15	16141	16175	0.16126254114621588
R1	cpdb	0	network_modules	353	TRUE	0.0014984612348917467	18	19	3	0.15789473684210525	0.16666666666666666	GO:0071451	GO:BP	cellular response to superoxide	16175	16685		0.4444444444444444	0.7	18	16157	3	16	15	16141	16175	0.16126254114621588
R1	cpdb	0	network_modules	353	TRUE	0.001778102346443505	19	19	3	0.15789473684210525	0.15789473684210525	GO:0000305	GO:BP	response to oxygen radical	16175	91		0.7777777777777778	0.8	19	16156	3	16	16	16140	16175	0.15690439269751502
R1	cpdb	0	network_modules	353	TRUE	0.003240127037893117	23	19	3	0.15789473684210525	0.13043478260869565	GO:0098869	GO:BP	cellular oxidant detoxification	16175	18920		0.8888888888888888	0.9	23	16152	3	16	20	16136	16175	0.14240194503174
R1	cpdb	0	network_modules	353	TRUE	0.005473410724453834	4	19	2	0.10526315789473684	0.5	REAC:R-HSA-6803544	REAC	Ion influx/efflux at host-pathogen interface	10916	1274		0.5	0.6666666666666666	4	10912	2	17	2	10895	10916	0.22885826432368842
R1	cpdb	0	network_modules	353	TRUE	0.0059404522446590575	97	19	4	0.21052631578947367	0.041237113402061855	GO:0009636	GO:BP	response to toxic substance	16175	3554		1	1	97	16078	4	15	93	16063	16175	0.09084646805947554
R1	cpdb	0	network_modules	353	TRUE	0.007641159964497453	211	19	5	0.2631578947368421	0.023696682464454975	REAC:R-HSA-9711123	REAC	Cellular response to chemical stress	10916	333		1	1	211	10705	5	14	206	10691	10916	0.07394974864083925
R1	cpdb	0	network_modules	354	TRUE	7.194741941882513e-5	107	15	5	0.3333333333333333	0.04672897196261682	REAC:R-HSA-8957275	REAC	Post-translational protein phosphorylation	10916	1777		0	0.25	107	10809	5	10	102	10799	10916	0.12181689310042886
R1	cpdb	0	network_modules	354	TRUE	1.5039825097925972e-4	124	15	5	0.3333333333333333	0.04032258064516129	REAC:R-HSA-381426	REAC	Regulation of Insulin-like Growth Factor (IGF) transport and uptake by Insulin-like Growth Factor Binding Proteins (IGFBPs)	10916	1981		0.3333333333333333	0.5	124	10792	5	10	119	10782	10916	0.11270282218434521
R1	cpdb	0	network_modules	354	TRUE	0.003033184681012954	86	8	3	0.375	0.03488372093023256	KEGG:04610	KEGG	Complement and coagulation cascades	8484	320		NA	1	86	8398	3	5	83	8393	8484	0.11190337036915476
R1	cpdb	0	network_modules	354	TRUE	0.006583267455030395	126	15	4	0.26666666666666666	0.031746031746031744	REAC:R-HSA-114608	REAC	Platelet degranulation 	10916	1764		0.6666666666666666	0.75	126	10790	4	11	122	10779	10916	0.08859949941754974
R1	cpdb	0	network_modules	354	TRUE	0.007675159156928076	131	15	4	0.26666666666666666	0.030534351145038167	REAC:R-HSA-76005	REAC	Response to elevated platelet cytosolic Ca2+	10916	2090		1	1	131	10785	4	11	127	10774	10916	0.08675631924863797
R1	cpdb	0	network_modules	356	TRUE	6.647926140092617e-15	83	12	9	0.75	0.10843373493975904	KEGG:04146	KEGG	Peroxisome	8484	282		NA	1	83	8401	9	3	74	8398	8484	0.2830432189488865
R1	cpdb	0	network_modules	356	TRUE	2.0651948953475956e-10	60	15	7	0.4666666666666667	0.11666666666666667	REAC:R-HSA-9033241	REAC	Peroxisomal protein import	10916	1728		0	0.5	60	10856	7	8	53	10848	10916	0.2313804339310344
R1	cpdb	0	network_modules	356	TRUE	7.665689470108025e-9	14	22	5	0.22727272727272727	0.35714285714285715	GO:0016558	GO:BP	protein import into peroxisome matrix	16175	5249		0	0.1111111111111111	14	16161	5	17	9	16144	16175	0.28413263740160094
R1	cpdb	0	network_modules	356	TRUE	5.90535814317906e-8	20	22	5	0.22727272727272727	0.25	GO:0072663	GO:BP	establishment of protein localization to peroxisome	16175	17483		0.125	0.3333333333333333	20	16155	5	17	15	16138	16175	0.23737700728276429
R1	cpdb	0	network_modules	356	TRUE	5.90535814317906e-8	20	22	5	0.22727272727272727	0.25	GO:0072662	GO:BP	protein localization to peroxisome	16175	17482		0.125	0.3333333333333333	20	16155	5	17	15	16138	16175	0.23737700728276429
R1	cpdb	0	network_modules	356	TRUE	7.743989197411734e-8	21	22	5	0.22727272727272727	0.23809523809523808	GO:0043574	GO:BP	peroxisomal transport	16175	10779		0.375	0.5555555555555556	21	16154	5	17	16	16137	16175	0.23160004595479577
R1	cpdb	0	network_modules	356	TRUE	7.743989197411734e-8	21	22	5	0.22727272727272727	0.23809523809523808	GO:0015919	GO:BP	peroxisomal membrane transport	16175	5014		0.375	0.5555555555555556	21	16154	5	17	16	16137	16175	0.23160004595479577
R1	cpdb	0	network_modules	356	TRUE	2.0148286430195853e-7	25	22	5	0.22727272727272727	0.2	GO:0065002	GO:BP	intracellular protein transmembrane transport	16175	15886		0.625	0.6666666666666666	25	16150	5	17	20	16133	16175	0.21205891236253072
R1	cpdb	0	network_modules	356	TRUE	2.1392494571822278e-7	158	15	7	0.4666666666666667	0.04430379746835443	REAC:R-HSA-9609507	REAC	Protein localization	10916	1815		1	1	158	10758	7	8	151	10750	10916	0.14044459448336283
R1	cpdb	0	network_modules	356	TRUE	1.4159251724087066e-6	36	22	5	0.22727272727272727	0.1388888888888889	GO:0044743	GO:BP	protein transmembrane import into intracellular organelle	16175	11137		0.75	0.7777777777777778	36	16139	5	17	31	16122	16175	0.17624338920373095
R1	cpdb	0	network_modules	356	TRUE	1.6357279096118625e-6	37	22	5	0.22727272727272727	0.13513513513513514	GO:0007031	GO:BP	peroxisome organization	16175	2636		0.875	0.8888888888888888	37	16138	5	17	32	16121	16175	0.1738030349375756
R1	cpdb	0	network_modules	356	TRUE	7.080742795605772e-6	49	22	5	0.22727272727272727	0.10204081632653061	GO:0071806	GO:BP	protein transmembrane transport	16175	16919		1	1	49	16126	5	17	44	16109	16175	0.15058692307352758
R1	cpdb	0	network_modules	357	TRUE	1.3952785237257665e-7	76	15	6	0.4	0.07894736842105263	REAC:R-HSA-3000178	REAC	ECM proteoglycans	10916	812		0	0.25	76	10840	6	9	70	10831	10916	0.17534315085959187
R1	cpdb	0	network_modules	357	TRUE	2.3032058780379602e-7	330	9	7	0.7777777777777778	0.021212121212121213	KEGG:05165	KEGG	Human papillomavirus infection	8484	446		0	0.06666666666666667	330	8154	7	2	323	8152	8484	0.12453294392921677
R1	cpdb	0	network_modules	357	TRUE	2.948690651124168e-6	59	16	5	0.3125	0.0847457627118644	GO:0002062	GO:BP	chondrocyte differentiation	16175	653		0	0.09090909090909091	59	16116	5	11	54	16105	16175	0.16121052020432936
R1	cpdb	0	network_modules	357	TRUE	5.973581952320897e-6	283	16	7	0.4375	0.024734982332155476	GO:0001501	GO:BP	skeletal system development	16175	318		0.1	0.18181818181818182	283	15892	7	9	276	15883	16175	0.10080169388589724
R1	cpdb	0	network_modules	357	TRUE	1.0661806705518441e-5	26	15	4	0.26666666666666666	0.15384615384615385	REAC:R-HSA-3238698	REAC	WNT ligand biogenesis and trafficking	10916	2668		0.3333333333333333	0.5	26	10890	4	11	22	10879	10916	0.20111646530644461
R1	cpdb	0	network_modules	357	TRUE	1.8289410842797026e-5	63	9	4	0.4444444444444444	0.06349206349206349	KEGG:05217	KEGG	Basal cell carcinoma	8484	468		0.07142857142857142	0.13333333333333333	63	8421	4	5	59	8416	8484	0.1658822721337868
R1	cpdb	0	network_modules	357	TRUE	3.0024340412733842e-5	93	16	5	0.3125	0.053763440860215055	GO:0051216	GO:BP	cartilage development	16175	13573		0.2	0.2727272727272727	93	16082	5	11	88	16071	16175	0.12766464898799798
R1	cpdb	0	network_modules	357	TRUE	8.226026641748852e-5	236	16	6	0.375	0.025423728813559324	GO:0030198	GO:BP	extracellular matrix organization	16175	6707		0.3	0.36363636363636365	236	15939	6	10	230	15929	16175	0.09458163843616907
R1	cpdb	0	network_modules	357	TRUE	8.43517115982494e-5	237	16	6	0.375	0.02531645569620253	GO:0043062	GO:BP	extracellular structure organization	16175	10509		0.4	0.45454545454545453	237	15938	6	10	231	15928	16175	0.09436865849350048
R1	cpdb	0	network_modules	357	TRUE	8.648689050943934e-5	238	16	6	0.375	0.025210084033613446	GO:0045229	GO:BP	external encapsulating structure organization	16175	11340		0.5	0.5454545454545454	238	15937	6	10	232	15927	16175	0.09415699371689472
R1	cpdb	0	network_modules	357	TRUE	1.2312182454205179e-4	101	9	4	0.4444444444444444	0.039603960396039604	KEGG:04916	KEGG	Melanogenesis	8484	373		0.14285714285714285	0.2	101	8383	4	5	97	8378	8484	0.1299623627446706
R1	cpdb	0	network_modules	357	TRUE	1.557803545017835e-4	129	16	5	0.3125	0.03875968992248062	GO:0061448	GO:BP	connective tissue development	16175	15483		0.6	0.6363636363636364	129	16046	5	11	124	16035	16175	0.10773116522956604
R1	cpdb	0	network_modules	357	TRUE	4.5989707565052026e-4	15	16	3	0.1875	0.2	GO:0032331	GO:BP	negative regulation of chondrocyte differentiation	16175	7490		0.7	0.7272727272727273	15	16160	3	13	12	16147	16175	0.19287622447182098
R1	cpdb	0	network_modules	357	TRUE	4.936714076919344e-4	143	9	4	0.4444444444444444	0.027972027972027972	KEGG:04550	KEGG	Signaling pathways regulating pluripotency of stem cells	8484	319		0.21428571428571427	0.26666666666666666	143	8341	4	5	139	8336	8484	0.10824346757163081
R1	cpdb	0	network_modules	357	TRUE	5.03423659688108e-4	298	15	6	0.4	0.020134228187919462	REAC:R-HSA-1474244	REAC	Extracellular matrix organization	10916	889		0.6666666666666666	0.75	298	10618	6	9	292	10609	10916	0.08484116292677679
R1	cpdb	0	network_modules	357	TRUE	5.508563939196378e-4	147	9	4	0.4444444444444444	0.027210884353741496	KEGG:05224	KEGG	Breast cancer	8484	475		0.2857142857142857	0.3333333333333333	147	8337	4	5	143	8332	8484	0.10666847205170227
R1	cpdb	0	network_modules	357	TRUE	5.656858780843739e-4	16	16	3	0.1875	0.1875	GO:0061037	GO:BP	negative regulation of cartilage development	16175	15154		0.8	0.8181818181818182	16	16159	3	13	13	16146	16175	0.18669549477071604
R1	cpdb	0	network_modules	357	TRUE	5.658878814539095e-4	148	9	4	0.4444444444444444	0.02702702702702703	KEGG:05226	KEGG	Gastric cancer	8484	477		0.35714285714285715	0.4	148	8336	4	5	144	8331	8484	0.10628453226203623
R1	cpdb	0	network_modules	357	TRUE	6.456502789063093e-4	153	9	4	0.4444444444444444	0.026143790849673203	KEGG:04934	KEGG	Cushing syndrome	8484	391		0.42857142857142855	0.4666666666666667	153	8331	4	5	149	8326	8484	0.10442047559635673
R1	cpdb	0	network_modules	357	TRUE	6.797776697119503e-4	155	9	4	0.4444444444444444	0.025806451612903226	KEGG:04150	KEGG	mTOR signaling pathway	8484	284		0.5	0.5333333333333333	155	8329	4	5	151	8324	8484	0.10369970157622524
R1	cpdb	0	network_modules	357	TRUE	7.152228803289476e-4	157	9	4	0.4444444444444444	0.025477707006369428	KEGG:04390	KEGG	Hippo signaling pathway	8484	310		0.5714285714285714	0.6	157	8327	4	5	153	8322	8484	0.10299244836807693
R1	cpdb	0	network_modules	357	TRUE	8.919102060335371e-4	166	9	4	0.4444444444444444	0.024096385542168676	KEGG:05225	KEGG	Hepatocellular carcinoma	8484	476		0.6428571428571429	0.6666666666666666	166	8318	4	5	162	8313	8484	0.09996615997522547
R1	cpdb	0	network_modules	357	TRUE	0.0010571143538303672	382	9	5	0.5555555555555556	0.013089005235602094	KEGG:05010	KEGG	Alzheimer disease	8484	411		0.7142857142857143	0.7333333333333333	382	8102	5	4	377	8098	8484	0.08023155473993357
R1	cpdb	0	network_modules	357	TRUE	0.0010743772835824035	174	9	4	0.4444444444444444	0.022988505747126436	KEGG:04310	KEGG	Wnt signaling pathway	8484	299		0.7857142857142857	0.8	174	8310	4	5	170	8305	8484	0.09747123195342264
R1	cpdb	0	network_modules	357	TRUE	0.0019348466664288098	202	9	4	0.4444444444444444	0.019801980198019802	KEGG:04510	KEGG	Focal adhesion	8484	313		0.8571428571428571	0.8666666666666667	202	8282	4	5	198	8277	8484	0.08991126082226358
R1	cpdb	0	network_modules	357	TRUE	0.001972435259606196	93	15	4	0.26666666666666666	0.043010752688172046	REAC:R-HSA-373080	REAC	Class B/2 (Secretin family receptors)	10916	366		1	1	93	10823	4	11	89	10812	10916	0.10419043963680978
R1	cpdb	0	network_modules	357	TRUE	0.0020503266860508315	205	9	4	0.4444444444444444	0.01951219512195122	KEGG:05205	KEGG	Proteoglycans in cancer	8484	457		0.9285714285714286	0.9333333333333333	205	8279	4	5	201	8274	8484	0.08919207559560936
R1	cpdb	0	network_modules	357	TRUE	0.0032853959805731895	28	16	3	0.1875	0.10714285714285714	GO:0032330	GO:BP	regulation of chondrocyte differentiation	16175	7489		0.9	0.9090909090909091	28	16147	3	13	25	16134	16175	0.14061938357001555
R1	cpdb	0	network_modules	357	TRUE	0.004841486910532068	89	9	3	0.3333333333333333	0.033707865168539325	KEGG:04512	KEGG	ECM-receptor interaction	8484	314		1	1	89	8395	3	6	86	8389	8484	0.10326141691407467
R1	cpdb	0	network_modules	357	TRUE	0.007126006216376415	36	16	3	0.1875	0.08333333333333333	GO:0061035	GO:BP	regulation of cartilage development	16175	15152		1	1	36	16139	3	13	33	16126	16175	0.12371511443697349
R1	cpdb	0	network_modules	358	TRUE	5.618396588022047e-9	63	6	5	0.8333333333333334	0.07936507936507936	KEGG:05416	KEGG	Viral myocarditis	8484	493		0	0.25	63	8421	5	1	58	8420	8484	0.25592277026156673
R1	cpdb	0	network_modules	358	TRUE	2.4625829395920686e-8	84	6	5	0.8333333333333334	0.05952380952380952	KEGG:05412	KEGG	Arrhythmogenic right ventricular cardiomyopathy	8484	490		0.3333333333333333	0.5	84	8400	5	1	79	8399	8484	0.22124741963852415
R1	cpdb	0	network_modules	358	TRUE	5.134077482481627e-8	97	6	5	0.8333333333333334	0.05154639175257732	KEGG:05410	KEGG	Hypertrophic cardiomyopathy	8484	489		0.6666666666666666	0.75	97	8387	5	1	92	8386	8484	0.20566452915936784
R1	cpdb	0	network_modules	358	TRUE	6.632121018271869e-8	102	6	5	0.8333333333333334	0.049019607843137254	KEGG:05414	KEGG	Dilated cardiomyopathy	8484	491		1	1	102	8382	5	1	97	8381	8484	0.2004763501223738
R1	cpdb	0	network_modules	361	TRUE	1.4919517172708578e-9	11	21	5	0.23809523809523808	0.45454545454545453	GO:0044571	GO:BP	[2Fe-2S] cluster assembly	16175	11083		0	0.2	11	16164	5	16	6	16148	16175	0.3283610311802352
R1	cpdb	0	network_modules	361	TRUE	1.54225092839061e-8	5	21	4	0.19047619047619047	0.8	GO:0044572	GO:BP	[4Fe-4S] cluster assembly	16175	11084		0.25	0.4	5	16170	4	17	1	16153	16175	0.39004005033238803
R1	cpdb	0	network_modules	361	TRUE	4.7370873724843214e-8	26	15	5	0.3333333333333333	0.19230769230769232	REAC:R-HSA-211976	REAC	Endogenous sterols	10916	840		0	0.07692307692307693	26	10890	5	10	21	10880	10916	0.25184871412294296
R1	cpdb	0	network_modules	361	TRUE	1.9916077254597633e-7	34	15	5	0.3333333333333333	0.14705882352941177	REAC:R-HSA-5579029	REAC	Metabolic disorders of biological oxidation enzymes	10916	1416		0.08333333333333333	0.15384615384615385	34	10882	5	10	29	10872	10916	0.21982837569089375
R1	cpdb	0	network_modules	361	TRUE	2.3217648098349747e-7	35	15	5	0.3333333333333333	0.14285714285714285	REAC:R-HSA-196071	REAC	Metabolism of steroid hormones	10916	1437		0.16666666666666666	0.23076923076923078	35	10881	5	10	30	10871	10916	0.21661505883846321
R1	cpdb	0	network_modules	361	TRUE	2.3821130884417455e-7	11	15	4	0.26666666666666666	0.36363636363636365	REAC:R-HSA-1362409	REAC	Mitochondrial iron-sulfur cluster biogenesis	10916	1466		0.25	0.3076923076923077	11	10905	4	11	7	10894	10916	0.31059273724498043
R1	cpdb	0	network_modules	361	TRUE	3.7784472179691345e-7	29	21	5	0.23809523809523808	0.1724137931034483	GO:0031163	GO:BP	metallo-sulfur cluster assembly	16175	7078		0.5	0.8	29	16146	5	16	24	16130	16175	0.20139582400029488
R1	cpdb	0	network_modules	361	TRUE	3.7784472179691345e-7	29	21	5	0.23809523809523808	0.1724137931034483	GO:0016226	GO:BP	iron-sulfur cluster assembly	16175	5177		0.5	0.8	29	16146	5	16	24	16130	16175	0.20139582400029488
R1	cpdb	0	network_modules	361	TRUE	6.601829600208044e-7	3	15	3	0.2	1	REAC:R-HSA-2395516	REAC	Electron transport from NADPH to Ferredoxin	10916	838		0.3333333333333333	0.38461538461538464	3	10913	3	12	0	10901	10916	0.44696764849941306
R1	cpdb	0	network_modules	361	TRUE	2.6385540167018596e-6	4	15	3	0.2	0.75	REAC:R-HSA-5579026	REAC	Defective CYP11A1 causes AICSR	10916	514		0.4166666666666667	0.46153846153846156	4	10912	3	12	1	10900	10916	0.386925520617172
R1	cpdb	0	network_modules	361	TRUE	5.333251990549359e-6	64	15	5	0.3333333333333333	0.078125	REAC:R-HSA-211897	REAC	Cytochrome P450 - arranged by substrate type	10916	423		0.5	0.5384615384615384	64	10852	5	10	59	10842	10916	0.15911207181149586
R1	cpdb	0	network_modules	361	TRUE	5.9428457723236945e-5	103	15	5	0.3333333333333333	0.04854368932038835	REAC:R-HSA-211945	REAC	Phase I - Functionalization of compounds	10916	1737		0.5833333333333334	0.6153846153846154	103	10813	5	10	98	10803	10916	0.12427737171632108
R1	cpdb	0	network_modules	361	TRUE	1.4416569993232393e-4	12	15	3	0.2	0.25	REAC:R-HSA-196108	REAC	Pregnenolone biosynthesis	10916	1789		0.6666666666666666	0.6923076923076923	12	10904	3	12	9	10892	10916	0.22265309968803057
R1	cpdb	0	network_modules	361	TRUE	4.136075593347101e-4	152	15	5	0.3333333333333333	0.03289473684210526	REAC:R-HSA-8957322	REAC	Metabolism of steroids	10916	1438		0.75	0.7692307692307693	152	10764	5	10	147	10754	10916	0.10111468913250354
R1	cpdb	0	network_modules	361	TRUE	0.002274903425965219	215	15	5	0.3333333333333333	0.023255813953488372	REAC:R-HSA-211859	REAC	Biological oxidations	10916	227		0.8333333333333334	0.8461538461538461	215	10701	5	10	210	10691	10916	0.08372834795416058
R1	cpdb	0	network_modules	361	TRUE	0.002899738316776353	31	15	3	0.2	0.0967741935483871	REAC:R-HSA-389661	REAC	Glyoxylate metabolism and glycine degradation	10916	1081		0.9166666666666666	0.9230769230769231	31	10885	3	12	28	10873	10916	0.13743584695889785
R1	cpdb	0	network_modules	361	TRUE	0.004295621161060542	245	15	5	0.3333333333333333	0.02040816326530612	REAC:R-HSA-5668914	REAC	Diseases of metabolism	10916	767		1	1	245	10671	5	10	240	10661	10916	0.0778567086661631
R1	cpdb	0	network_modules	361	TRUE	0.00846626937273213	372	21	6	0.2857142857142857	0.016129032258064516	GO:0006091	GO:BP	generation of precursor metabolites and energy	16175	1954		1	1	372	15803	6	15	366	15788	16175	0.06319153451280492
R1	cpdb	0	network_modules	366	TRUE	5.869045488116374e-8	44	10	5	0.5	0.11363636363636363	REAC:R-HSA-8948216	REAC	Collagen chain trimerization	10916	385		0	0.14285714285714285	44	10872	5	5	39	10867	10916	0.23703061571775702
R1	cpdb	0	network_modules	366	TRUE	6.969802871337568e-8	103	6	5	0.8333333333333334	0.04854368932038835	KEGG:04974	KEGG	Protein digestion and absorption	8484	405		NA	1	103	8381	5	1	98	8380	8484	0.19948405922546955
R1	cpdb	0	network_modules	366	TRUE	5.173419135054535e-7	67	10	5	0.5	0.07462686567164178	REAC:R-HSA-1650814	REAC	Collagen biosynthesis and modifying enzymes	10916	384		0.16666666666666666	0.2857142857142857	67	10849	5	5	62	10844	10916	0.1914715835967124
R1	cpdb	0	network_modules	366	TRUE	2.2047890683947137e-6	89	10	5	0.5	0.056179775280898875	REAC:R-HSA-1474290	REAC	Collagen formation	10916	387		0.3333333333333333	0.42857142857142855	89	10827	5	5	84	10822	10916	0.16561954438524906
R1	cpdb	0	network_modules	366	TRUE	4.746160529059777e-5	60	10	4	0.4	0.06666666666666667	REAC:R-HSA-2022090	REAC	Assembly of collagen fibrils and other multimeric structures	10916	177		0.5	0.5714285714285714	60	10856	4	6	56	10850	10916	0.16157385152341414
R1	cpdb	0	network_modules	366	TRUE	6.173216134411137e-5	64	10	4	0.4	0.0625	REAC:R-HSA-1442490	REAC	Collagen degradation	10916	386		0.6666666666666666	0.7142857142857143	64	10852	4	6	60	10846	10916	0.15632669945397779
R1	cpdb	0	network_modules	366	TRUE	9.276345487672582e-4	298	10	5	0.5	0.016778523489932886	REAC:R-HSA-1474244	REAC	Extracellular matrix organization	10916	889		0.8333333333333334	0.8571428571428571	298	10618	5	5	293	10613	10916	0.08783901607682146
R1	cpdb	0	network_modules	366	TRUE	0.0014401488872684439	140	10	4	0.4	0.02857142857142857	REAC:R-HSA-1474228	REAC	Degradation of the extracellular matrix	10916	726		1	1	140	10776	4	6	136	10770	10916	0.104194559226226
R1	cpdb	0	network_modules	369	TRUE	3.355655245340525e-9	4	3	3	1	0.75	REAC:R-HSA-1296061	REAC	HCN channels	10916	1091		0	0.3333333333333333	4	10912	3	0	1	10912	10916	0.865985724262584
R1	cpdb	0	network_modules	369	TRUE	3.349356051810046e-6	32	3	3	1	0.09375	GO:0071320	GO:BP	cellular response to cAMP	16175	16576		0	0.05	32	16143	3	0	29	16143	16175	0.3059115646022684
R1	cpdb	0	network_modules	369	TRUE	4.0408360108934126e-6	34	3	3	1	0.08823529411764706	GO:0003254	GO:BP	regulation of membrane depolarization	16175	1684		0.05263157894736842	0.1	34	16141	3	0	31	16141	16175	0.2967594252337395
R1	cpdb	0	network_modules	369	TRUE	6.171323580139506e-6	39	3	3	1	0.07692307692307693	GO:0051591	GO:BP	response to cAMP	16175	13808		0.10526315789473684	0.15	39	16136	3	0	36	16136	16175	0.2770412257922045
R1	cpdb	0	network_modules	369	TRUE	2.0836235954566695e-5	58	3	3	1	0.05172413793103448	GO:0051899	GO:BP	membrane depolarization	16175	13983		0.15789473684210525	0.2	58	16117	3	0	55	16117	16175	0.2270423468138765
R1	cpdb	0	network_modules	369	TRUE	3.234897210926619e-5	67	3	3	1	0.04477611940298507	GO:0046683	GO:BP	response to organophosphorus	16175	12314		0.21052631578947367	0.25	67	16108	3	0	64	16108	16175	0.2111845634057583
R1	cpdb	0	network_modules	369	TRUE	4.559783616904682e-5	75	3	3	1	0.04	GO:0014074	GO:BP	response to purine-containing compound	16175	4639		0.2631578947368421	0.3	75	16100	3	0	72	16100	16175	0.19955428940512696
R1	cpdb	0	network_modules	369	TRUE	1.0919846111657282e-4	5	3	2	0.6666666666666666	0.4	GO:0071321	GO:BP	cellular response to cGMP	16175	16577		0.3157894736842105	0.35	5	16170	2	1	3	16169	16175	0.5162860129823625
R1	cpdb	0	network_modules	369	TRUE	1.483627464484293e-4	103	3	3	1	0.02912621359223301	REAC:R-HSA-1296071	REAC	Potassium Channels	10916	1780		0.5	0.6666666666666666	103	10813	3	0	100	10813	10916	0.16988030768226756
R1	cpdb	0	network_modules	369	TRUE	1.637909389408838e-4	6	3	2	0.6666666666666666	0.3333333333333333	GO:0070305	GO:BP	response to cGMP	16175	16048		0.3684210526315789	0.4	6	16169	2	1	4	16168	16175	0.47127333823288325
R1	cpdb	0	network_modules	369	TRUE	1.756588689026906e-4	117	3	3	1	0.02564102564102564	GO:0035725	GO:BP	sodium ion transmembrane transport	16175	9195		0.42105263157894735	0.45	117	16058	3	0	114	16058	16175	0.15956276629529037
R1	cpdb	0	network_modules	369	TRUE	4.438970453350398e-4	159	3	3	1	0.018867924528301886	GO:0006814	GO:BP	sodium ion transport	16175	2494		0.47368421052631576	0.5	159	16016	3	0	156	16016	16175	0.1366964477426408
R1	cpdb	0	network_modules	369	TRUE	6.784681159861183e-4	183	3	3	1	0.01639344262295082	GO:0071805	GO:BP	potassium ion transmembrane transport	16175	16918		0.5263157894736842	0.55	183	15992	3	0	180	15992	16175	0.12732233853228214
R1	cpdb	0	network_modules	369	TRUE	8.604306620548711e-4	198	3	3	1	0.015151515151515152	GO:0006813	GO:BP	potassium ion transport	16175	2493		0.5789473684210527	0.6	198	15977	3	0	195	15977	16175	0.1223471292394256
R1	cpdb	0	network_modules	369	TRUE	0.0022916550710375388	21	3	2	0.6666666666666666	0.09523809523809523	GO:0086012	GO:BP	membrane depolarization during cardiac muscle cell action potential	16175	17886		0.631578947368421	0.65	21	16154	2	1	19	16153	16175	0.25167235521278336
R1	cpdb	0	network_modules	369	TRUE	0.0024971340131756913	282	3	3	1	0.010638297872340425	GO:0042391	GO:BP	regulation of membrane potential	16175	10141		0.6842105263157895	0.7	282	15893	3	0	279	15893	16175	0.10224854779367558
R1	cpdb	0	network_modules	369	TRUE	0.00252071658603807	22	3	2	0.6666666666666666	0.09090909090909091	GO:0098719	GO:BP	sodium ion import across plasma membrane	16175	18849		0.7368421052631579	0.75	22	16153	2	1	20	16152	16175	0.2458707737811223
R1	cpdb	0	network_modules	369	TRUE	0.0038293896777411626	27	3	2	0.6666666666666666	0.07407407407407407	GO:0086010	GO:BP	membrane depolarization during action potential	16175	17884		0.7894736842105263	0.8	27	16148	2	1	25	16147	16175	0.22187162332806412
R1	cpdb	0	network_modules	369	TRUE	0.00458141937656194	345	3	3	1	0.008695652173913044	GO:0071407	GO:BP	cellular response to organic cyclic compound	16175	16659		0.8421052631578947	0.85	345	15830	3	0	342	15830	16175	0.09225919713188198
R1	cpdb	0	network_modules	369	TRUE	0.008279779353066069	64	3	2	0.6666666666666666	0.03125	KEGG:04929	KEGG	GnRH secretion	8484	386		NA	1	64	8420	2	1	62	8419	8484	0.1432709780855199
R1	cpdb	0	network_modules	369	TRUE	0.008881412737842752	400	3	3	1	0.0075	REAC:R-HSA-112316	REAC	Neuronal System	10916	1590		1	1	400	10516	3	0	397	10516	10916	0.08501270650656163
R1	cpdb	0	network_modules	369	TRUE	0.008948111941806405	431	3	3	1	0.0069605568445475635	GO:1901699	GO:BP	cellular response to nitrogen compound	16175	21652		0.8947368421052632	0.9	431	15744	3	0	428	15744	16175	0.08231854138518924
R1	cpdb	0	network_modules	369	TRUE	0.009327936346089036	437	3	3	1	0.006864988558352402	GO:0014070	GO:BP	response to organic cyclic compound	16175	4635		0.9473684210526315	0.95	437	15738	3	0	434	15738	16175	0.08173589322395253
R1	cpdb	0	network_modules	369	TRUE	0.009845173484584356	43	3	2	0.6666666666666666	0.046511627906976744	GO:1990573	GO:BP	potassium ion import across plasma membrane	16175	25222		1	1	43	16132	2	1	41	16131	16175	0.1756378801439702
